,Result,WhiteElo,BlackElo,EloDiff,Event,ECO_enc,Termination,TimeControl_enc
0,1,2460,2218,242,0,200,1,6
1,1,2428,2424,4,0,483,0,6
2,1,2441,2300,141,4,106,0,13
3,2,2280,2667,-387,0,464,0,6
4,1,2557,2682,-125,0,41,0,6
5,2,2554,2552,2,0,429,0,6
6,1,2558,2377,181,0,101,0,6
7,1,2412,2362,50,0,10,0,6
8,2,2437,2445,-8,0,291,0,6
9,1,2539,2331,208,0,140,0,6
10,3,2309,2425,-116,0,213,0,6
11,1,2743,2685,58,0,410,0,6
12,2,2386,2418,-32,0,43,0,6
13,2,2235,2443,-208,0,45,1,6
14,2,2281,2409,-128,0,100,1,6
15,1,2431,2367,64,0,123,0,6
16,1,2347,2493,-146,0,319,0,6
17,2,2463,2492,-29,0,102,0,6
18,1,2425,2499,-74,0,35,1,6
19,1,2400,2376,24,0,301,0,6
20,1,2393,2429,-36,0,112,0,6
21,2,2487,2370,117,0,345,0,6
22,2,2497,2458,39,0,1,1,6
23,2,2442,2435,7,0,11,0,6
24,1,2403,2371,32,0,151,0,6
25,2,2444,2557,-113,0,121,1,6
26,1,2378,2416,-38,0,0,0,6
27,1,2420,2287,133,0,115,0,6
28,2,2240,2404,-164,0,194,1,6
29,2,2407,2361,46,0,338,1,6
30,3,2471,2373,98,0,13,0,6
31,1,2423,2381,42,0,31,1,6
32,1,2321,2461,-140,0,4,0,6
33,1,2492,2508,-16,0,300,0,6
34,2,2286,2431,-145,0,4,0,6
35,1,2451,2389,62,0,242,0,6
36,2,2319,2432,-113,0,460,0,6
37,1,2463,2310,153,0,195,1,6
38,3,2558,2549,9,0,45,0,6
39,1,2673,2630,43,0,314,1,6
40,2,2399,2569,-170,0,101,1,6
41,1,2675,2565,110,0,408,0,6
42,2,2345,2427,-82,4,120,0,13
43,2,2489,2256,233,0,266,0,6
44,1,2405,2357,48,0,301,0,6
45,2,2377,2479,-102,0,49,0,6
46,1,2680,2418,262,0,352,1,6
47,1,2423,2388,35,0,130,1,6
48,3,2413,2324,89,0,0,0,6
49,2,2435,2315,120,0,10,0,6
50,2,2484,2455,29,0,337,0,6
51,3,2403,2322,81,0,140,0,6
52,1,2427,2436,-9,0,202,0,6
53,2,2323,2424,-101,0,301,0,6
54,1,2409,2492,-83,0,117,0,6
55,3,2407,2342,65,0,406,0,6
56,2,2441,2442,-1,0,105,1,6
57,2,2222,2450,-228,4,468,0,13
58,2,2336,2456,-120,0,296,0,6
59,2,2366,2469,-103,0,121,0,6
60,2,2464,2491,-27,0,102,1,6
61,2,2542,2282,260,0,138,0,6
62,1,2252,2432,-180,0,45,0,6
63,2,2561,2748,-187,0,228,1,6
64,1,2436,2349,87,0,456,0,6
65,2,2222,2446,-224,4,302,0,13
66,2,2338,2453,-115,0,460,1,6
67,2,2424,2410,14,0,10,0,6
68,1,2376,2428,-52,0,43,0,6
69,1,2410,2384,26,0,458,1,6
70,1,2502,2498,4,0,43,0,6
71,3,2407,2480,-73,0,302,0,6
72,2,2288,2400,-112,0,269,0,6
73,2,2463,2467,-4,0,301,0,6
74,2,2461,2477,-16,0,41,0,6
75,2,2549,2558,-9,0,483,0,6
76,3,2352,2485,-133,0,394,0,6
77,1,2572,2504,68,0,256,0,6
78,1,2436,2343,93,0,135,0,6
79,2,2529,2396,133,0,46,1,6
80,1,2416,2483,-67,0,245,0,6
81,2,2306,2428,-122,0,302,1,6
82,2,2292,2412,-120,0,4,0,6
83,3,2533,2433,100,0,154,0,6
84,2,2430,2213,217,0,211,1,6
85,2,2392,2400,-8,4,380,1,13
86,2,2422,2383,39,0,150,0,6
87,2,2203,2418,-215,0,302,0,6
88,1,2344,2441,-97,0,460,0,6
89,1,2435,2315,120,0,121,0,6
90,2,2416,2418,-2,0,301,1,6
91,2,2407,2278,129,0,243,1,6
92,1,2460,2272,188,0,107,0,6
93,2,2342,2428,-86,0,314,0,6
94,2,2456,2682,-226,0,80,0,6
95,2,2436,2435,1,0,11,0,6
96,1,2496,2459,37,0,1,1,6
97,1,2448,2456,-8,0,302,1,6
98,2,2577,2677,-100,0,106,0,6
99,2,2500,2558,-58,0,125,1,6
100,2,2302,2404,-102,0,253,0,6
101,2,2282,2408,-126,0,133,0,6
102,2,2432,2324,108,0,41,1,6
103,2,2416,2282,134,0,0,0,6
104,1,2473,2426,47,0,245,0,6
105,2,2287,2420,-133,0,302,0,6
106,2,2457,2458,-1,0,41,0,6
107,1,2414,2206,208,0,100,0,8
108,1,2421,2211,210,0,15,0,6
109,1,2379,2415,-36,0,14,0,6
110,1,2579,2573,6,0,45,0,6
111,1,2424,2250,174,0,45,0,6
112,1,2366,2403,-37,0,40,0,6
113,1,2483,2399,84,0,453,0,6
114,1,2563,2543,20,0,200,0,6
115,1,2312,2477,-165,0,229,0,6
116,2,2221,2421,-200,0,302,0,6
117,2,2222,2441,-219,0,45,0,6
118,1,2302,2401,-99,0,302,0,6
119,1,2533,2336,197,0,154,0,6
120,1,2409,2385,24,0,152,0,6
121,2,2415,2389,26,0,2,0,6
122,2,2404,2521,-117,0,221,0,6
123,1,2433,2567,-134,0,455,0,6
124,2,2432,2441,-9,0,131,0,6
125,2,2432,2486,-54,4,133,0,13
126,1,2685,2579,106,0,20,0,6
127,1,2468,2320,148,0,241,0,6
128,2,2248,2401,-153,0,226,1,6
129,2,2290,2410,-120,0,127,0,6
130,1,2296,2440,-144,0,301,1,6
131,2,2445,2311,134,0,45,0,6
132,2,2269,2480,-211,0,40,0,6
133,1,2525,2400,125,0,46,0,6
134,1,2452,2465,-13,0,335,0,6
135,2,2482,2220,262,4,45,1,13
136,1,2338,2463,-125,0,296,0,6
137,1,2454,2481,-27,0,15,1,6
138,1,2412,2424,-12,0,302,0,6
139,2,2421,2454,-33,0,343,0,6
140,1,2237,2406,-169,0,200,0,6
141,2,2424,2383,41,0,41,0,6
142,1,2384,2478,-94,0,301,0,6
143,1,2376,2437,-61,0,478,0,6
144,1,2424,2283,141,0,317,0,6
145,2,2475,2475,0,0,109,1,6
146,1,2312,2409,-97,4,106,0,13
147,1,2495,2538,-43,0,211,0,6
148,1,2423,2363,60,0,30,0,6
149,2,2464,2569,-105,0,45,0,6
150,1,2425,2536,-111,0,306,1,6
151,1,2488,2431,57,0,411,0,6
152,1,2406,2367,39,0,102,0,6
153,2,2414,2450,-36,0,45,0,6
154,2,2424,2346,78,0,331,1,6
155,2,2339,2432,-93,0,46,1,6
156,1,2446,2426,20,0,132,0,6
157,2,2283,2410,-127,0,100,0,6
158,2,2207,2441,-234,0,389,0,6
159,2,2387,2409,-22,0,110,0,6
160,1,2279,2428,-149,0,31,0,6
161,1,2380,2414,-34,0,0,1,6
162,1,2222,2414,-192,0,4,0,6
163,1,2492,2448,44,0,40,0,6
164,2,2581,2426,155,0,193,0,6
165,2,2470,2316,154,0,107,0,6
166,2,2559,2441,118,0,122,1,6
167,3,2366,2472,-106,0,48,0,6
168,1,2362,2411,-49,0,133,0,6
169,2,2338,2418,-80,0,211,0,6
170,1,2445,2290,155,0,100,0,6
171,2,2409,2244,165,0,106,0,6
172,1,2689,2532,157,0,10,0,6
173,1,2455,2439,16,0,4,0,6
174,2,2532,2501,31,0,300,0,6
175,1,2403,2389,14,0,172,1,6
176,1,2455,2483,-28,0,48,1,6
177,2,2404,2304,100,0,302,0,6
178,1,2356,2460,-104,0,302,0,6
179,1,2421,2314,107,0,101,1,6
180,3,2563,2459,104,0,37,0,6
181,3,2432,2452,-20,0,310,0,6
182,1,2396,2458,-62,0,106,0,6
183,2,2361,2401,-40,0,41,0,6
184,2,2422,2408,14,0,6,0,6
185,1,2415,2488,-73,0,40,0,6
186,2,2462,2469,-7,0,114,1,6
187,1,2459,2604,-145,0,45,1,6
188,2,2242,2416,-174,0,296,0,6
189,1,2459,2377,82,0,48,0,6
190,1,2417,2341,76,0,122,1,6
191,2,2431,2439,-8,0,40,0,6
192,1,2437,2445,-8,0,48,0,6
193,2,2529,2692,-163,0,0,0,6
194,2,2423,2497,-74,0,112,1,6
195,2,2399,2436,-37,0,200,0,6
196,2,2299,2428,-129,0,337,0,6
197,1,2239,2417,-178,0,148,0,6
198,1,2393,2405,-12,0,0,0,6
199,1,2443,2475,-32,0,247,1,6
200,1,2508,2525,-17,0,211,0,6
201,1,2408,2386,22,0,152,0,6
202,2,2405,2300,105,0,140,0,6
203,1,2369,2405,-36,0,132,0,6
204,3,2453,2363,90,0,243,0,6
205,2,2275,2449,-174,0,130,0,6
207,1,2476,2333,143,0,138,0,6
208,1,2409,2247,162,0,16,0,6
209,2,2246,2406,-160,0,40,0,6
210,1,2477,2433,44,0,245,0,6
211,2,2432,2409,23,0,466,1,6
212,2,2460,2542,-82,0,242,1,6
213,1,2483,2422,61,0,60,1,6
214,2,2406,2386,20,4,67,0,13
215,2,2481,2452,29,0,140,0,6
216,1,2451,2328,123,0,312,0,6
217,1,2360,2459,-99,0,306,1,6
218,1,2284,2401,-117,0,405,1,6
219,1,2450,2298,152,4,40,0,13
220,2,2575,2574,1,0,123,0,6
221,2,2373,2463,-90,0,103,0,6
222,2,2419,2403,16,0,338,0,6
223,1,2526,2382,144,0,0,1,6
224,3,2475,2367,108,0,107,0,6
225,2,2446,2443,3,0,141,0,6
226,1,2669,2285,384,0,190,0,6
227,3,2468,2695,-227,0,80,0,6
228,3,2399,2502,-103,0,0,0,6
229,1,2520,2418,102,0,302,0,6
230,2,2462,2398,64,0,106,0,6
231,2,2491,2427,64,4,196,0,13
232,2,2409,2443,-34,0,0,0,6
233,2,2461,2450,11,0,200,1,6
234,2,2381,2413,-32,0,0,1,6
235,1,2452,2313,139,0,40,0,6
236,2,2528,2514,14,0,245,0,6
237,1,2427,2498,-71,0,255,1,6
238,1,2365,2452,-87,0,321,1,6
239,3,2550,2415,135,0,121,0,6
240,3,2458,2470,-12,0,264,0,6
241,1,2439,2299,140,0,245,0,6
243,2,2206,2417,-211,0,487,0,8
244,2,2253,2422,-169,0,300,0,6
245,1,2417,2346,71,0,45,0,6
246,2,2222,2454,-232,4,300,0,13
247,1,2500,2456,44,0,453,0,6
248,1,2404,2316,88,0,0,0,6
249,1,2410,2409,1,0,338,1,6
250,1,2441,2323,118,0,8,1,6
251,1,2227,2472,-245,0,264,0,6
252,2,2445,2413,32,0,409,0,6
253,2,2414,2524,-110,0,202,1,6
254,2,2378,2529,-151,0,106,1,6
255,2,2405,2375,30,0,264,0,6
256,1,2692,2522,170,0,20,0,6
257,1,2307,2456,-149,0,125,0,6
258,1,2435,2479,-44,0,153,0,6
259,2,2456,2561,-105,0,145,0,6
260,1,2359,2428,-69,0,21,0,6
261,1,2275,2456,-181,0,133,0,6
262,2,2312,2408,-96,0,106,0,6
263,1,2523,2371,152,0,211,0,6
264,1,2417,2548,-131,0,101,0,6
265,2,2519,2401,118,0,100,0,6
266,1,2368,2436,-68,0,491,0,6
267,3,2520,2512,8,0,111,0,6
268,3,2356,2426,-70,0,103,0,6
269,2,2395,2409,-14,0,100,0,6
270,2,2451,2471,-20,0,241,0,6
271,2,2419,2376,43,0,4,0,6
272,3,2307,2402,-95,0,369,0,6
273,2,2506,2695,-189,0,80,0,6
274,2,2470,2435,35,0,298,0,6
275,1,2445,2372,73,0,17,0,6
276,1,2458,2302,156,0,143,0,6
277,2,2491,2422,69,0,110,1,6
278,1,2413,2307,106,0,0,0,6
279,3,2419,2341,78,0,310,0,6
280,2,2439,2426,13,0,405,0,6
281,2,2489,2315,174,0,307,0,6
282,2,2388,2427,-39,0,58,0,6
283,1,2528,2452,76,0,335,0,6
284,2,2328,2445,-117,0,112,1,6
285,2,2319,2443,-124,0,337,0,6
286,2,2448,2455,-7,0,195,0,6
287,1,2533,2375,158,0,0,0,6
288,2,2382,2433,-51,0,211,0,6
289,1,2447,2503,-56,0,63,0,6
290,2,2468,2354,114,0,313,0,6
291,3,2239,2402,-163,0,106,0,6
292,2,2488,2413,75,0,337,0,6
293,1,2382,2412,-30,0,0,0,6
294,1,2429,2311,118,0,2,1,6
295,1,2312,2442,-130,0,62,0,6
296,1,2566,2448,118,0,213,1,6
298,1,2403,2267,136,0,315,0,6
299,1,2425,2246,179,0,106,1,6
300,2,2421,2368,53,0,30,0,6
301,1,2540,2446,94,0,122,0,6
302,1,2512,2698,-186,0,155,0,6
303,1,2414,2432,-18,0,0,1,6
304,2,2447,2532,-85,0,200,0,6
305,1,2309,2442,-133,0,455,0,6
306,1,2367,2449,-82,0,400,0,6
307,1,2402,2283,119,0,251,0,6
308,1,2464,2270,194,0,121,0,6
309,2,2438,2377,61,0,338,0,6
310,1,2400,2381,19,0,45,0,6
311,1,2442,2404,38,0,106,1,6
312,2,2461,2298,163,0,145,1,6
313,2,2342,2418,-76,0,296,0,6
314,2,2282,2433,-151,4,247,0,13
315,1,2377,2480,-103,0,200,0,6
316,1,2475,2323,152,0,140,1,6
317,2,2435,2484,-49,4,101,0,13
318,1,2465,2464,1,0,107,1,6
319,1,2401,2286,115,0,4,0,6
320,2,2442,2597,-155,0,107,1,6
321,1,2372,2536,-164,0,108,0,6
322,2,2420,2481,-61,0,100,0,6
323,2,2383,2496,-113,0,394,0,6
324,2,2376,2434,-58,0,108,1,6
325,2,2408,2321,87,0,335,0,6
326,2,2389,2460,-71,0,102,1,6
327,2,2443,2449,-6,0,48,0,6
328,2,2447,2325,122,0,156,0,6
330,2,2406,2388,18,0,338,0,6
331,2,2460,2255,205,0,338,0,6
332,1,2467,2454,13,0,122,0,6
333,2,2428,2290,138,0,136,1,6
334,1,2407,2399,8,0,320,1,6
335,2,2472,2461,11,0,50,1,6
336,2,2307,2433,-126,0,110,0,6
337,2,2428,2544,-116,0,101,0,6
338,1,2418,2520,-102,0,306,0,6
339,2,2422,2431,-9,0,211,0,6
340,2,2442,2424,18,0,125,0,6
341,1,2415,2385,30,0,229,1,6
342,2,2331,2483,-152,0,40,0,6
343,2,2448,2484,-36,0,122,0,6
344,2,2422,2479,-57,0,40,0,6
345,2,2458,2453,5,0,120,1,6
346,1,2395,2400,-5,0,0,0,6
347,1,2690,2528,162,0,106,0,6
348,2,2384,2439,-55,0,101,0,6
349,3,2548,2424,124,0,121,0,6
350,2,2261,2426,-165,0,13,0,6
351,3,2500,2472,28,0,324,0,6
352,1,2439,2449,-10,0,133,1,6
353,2,2444,2535,-91,0,200,0,6
354,3,2394,2465,-71,0,1,0,6
355,2,2520,2600,-80,0,143,0,6
356,2,2331,2405,-74,0,15,0,6
357,1,2487,2318,169,0,186,0,6
358,1,2436,2303,133,0,2,0,6
359,1,2542,2385,157,0,152,0,6
360,1,2402,2335,67,0,113,0,6
361,1,2442,2569,-127,0,133,0,6
362,1,2489,2442,47,0,253,0,6
363,1,2467,2436,31,0,130,0,6
364,2,2413,2273,140,0,84,0,6
365,1,2379,2420,-41,0,101,0,6
366,1,2217,2427,-210,0,123,0,6
367,1,2513,2375,138,0,115,1,6
368,1,2526,2310,216,4,122,0,13
369,1,2444,2379,65,0,265,0,6
370,2,2525,2693,-168,0,0,0,6
371,1,2413,2418,-5,0,244,0,6
372,1,2430,2281,149,0,212,0,6
373,1,2566,2426,140,0,118,0,6
374,2,2338,2401,-63,0,123,0,6
375,2,2387,2453,-66,0,25,0,6
376,2,2290,2459,-169,0,6,0,6
377,2,2426,2546,-120,0,0,1,6
378,1,2464,2395,69,0,4,0,6
379,1,2394,2400,-6,0,45,0,6
380,2,2438,2457,-19,0,302,1,6
381,1,2430,2366,64,0,138,1,6
382,2,2458,2500,-42,0,110,0,6
383,2,2417,2472,-55,0,0,1,6
384,1,2545,2396,149,0,242,0,6
385,2,2300,2440,-140,0,100,1,6
386,1,2445,2350,95,0,110,0,6
387,1,2327,2407,-80,0,127,0,6
388,1,2409,2274,135,0,485,1,6
389,2,2414,2386,28,0,229,0,6
390,1,2484,2307,177,0,131,0,6
391,1,2437,2494,-57,0,112,1,6
392,1,2418,2500,-82,0,203,0,6
393,2,2326,2410,-84,0,331,1,6
394,3,2374,2448,-74,0,250,0,6
395,3,2666,2517,149,0,115,0,6
396,1,2522,2474,48,0,0,1,6
397,1,2400,2393,7,4,45,0,13
398,1,2515,2696,-181,0,110,0,6
399,2,2573,2412,161,0,45,1,6
400,2,2430,2505,-75,0,117,1,6
401,2,2462,2376,86,0,218,1,6
402,1,2298,2430,-132,4,88,0,13
403,1,2395,2400,-5,0,0,0,6
404,1,2550,2422,128,0,190,0,6
405,3,2446,2419,27,0,270,0,6
406,1,2325,2412,-87,0,10,0,6
407,1,2493,2393,100,0,50,0,6
408,1,2444,2296,148,0,2,0,6
409,1,2413,2383,30,0,326,0,6
410,2,2435,2367,68,0,6,0,6
411,1,2477,2410,67,0,8,0,6
412,2,2297,2433,-136,0,315,1,6
413,1,2394,2401,-7,0,65,0,6
414,1,2490,2498,-8,0,84,1,6
415,2,2539,2487,52,0,15,1,6
416,2,2443,2434,9,0,398,1,6
417,3,2447,2375,72,0,265,0,6
418,2,2469,2527,-58,0,106,0,6
419,2,2541,2457,84,0,264,1,6
420,2,2293,2447,-154,0,140,0,6
421,3,2524,2663,-139,0,123,0,6
422,1,2509,2392,117,0,302,0,6
423,1,2519,2426,93,0,136,1,6
424,2,2419,2554,-135,0,101,0,6
425,2,2455,2384,71,0,190,0,6
426,1,2378,2418,-40,0,34,0,6
427,2,2405,2383,22,0,0,0,6
428,2,2349,2531,-182,4,474,0,13
429,1,2688,2335,353,0,210,0,6
431,2,2377,2446,-69,0,210,0,6
432,1,2395,2400,-5,0,0,0,6
433,1,2532,2464,68,0,0,0,6
434,1,2406,2495,-89,0,202,0,6
435,2,2492,2365,127,0,311,0,6
436,1,2451,2289,162,0,2,0,6
437,2,2342,2513,-171,0,114,0,6
438,1,2356,2413,-57,0,145,0,6
439,2,2399,2437,-38,0,135,1,6
440,1,2493,2341,152,0,255,0,6
441,1,2388,2484,-96,0,200,0,6
442,1,2448,2333,115,0,107,0,6
443,1,2412,2384,28,0,311,0,6
444,1,2661,2481,180,0,270,0,6
445,2,2319,2464,-145,0,300,1,6
446,2,2523,2533,-10,0,103,0,6
447,1,2395,2401,-6,0,125,0,6
448,2,2464,2333,131,0,335,1,6
449,2,2447,2518,-71,0,306,0,6
450,1,2689,2539,150,0,103,0,6
451,1,2451,2372,79,0,6,0,6
452,2,2422,2440,-18,0,123,0,6
453,1,2413,2452,-39,0,133,0,6
454,2,2460,2536,-76,0,4,1,6
455,2,2432,2556,-124,0,101,0,6
456,1,2393,2429,-36,0,113,0,6
457,1,2535,2693,-158,0,0,0,6
458,2,2368,2455,-87,0,119,0,6
459,2,2286,2454,-168,0,100,0,6
461,2,2477,2353,124,0,353,1,6
462,2,2291,2463,-172,0,200,1,6
463,2,2478,2516,-38,0,110,1,6
464,2,2379,2417,-38,0,34,0,6
465,2,2523,2442,81,0,101,0,6
466,2,2396,2400,-4,0,112,1,6
467,1,2489,2290,199,0,248,0,8
468,1,2435,2275,160,4,202,0,13
469,1,2442,2246,196,0,140,0,6
470,1,2457,2283,174,0,2,0,6
471,1,2604,2497,107,0,200,0,6
472,2,2395,2400,-5,0,0,0,6
473,1,2497,2419,78,0,257,1,6
474,1,2559,2429,130,0,121,0,6
475,1,2501,2316,185,0,34,1,6
476,1,2415,2416,-1,0,138,1,6
477,1,2460,2363,97,0,264,0,6
478,2,2440,2446,-6,0,310,1,6
479,1,2466,2423,43,0,485,1,6
480,2,2428,2254,174,0,455,0,6
481,2,2422,2374,48,0,326,1,6
482,2,2425,2563,-138,0,101,0,6
483,2,2685,2543,142,0,103,0,6
484,2,2503,2469,34,0,202,0,6
485,1,2541,2455,86,0,0,1,6
486,2,2522,2398,124,0,49,0,6
487,1,2301,2405,-104,0,113,0,6
488,2,2604,2662,-58,0,276,0,6
489,2,2280,2460,-180,0,100,0,6
490,2,2406,2311,95,0,127,0,6
492,2,2202,2519,-317,0,327,0,6
493,1,2634,2209,425,0,196,1,6
494,3,2516,2449,67,0,107,0,6
495,1,2551,2677,-126,0,0,0,6
496,3,2406,2411,-5,0,131,0,6
497,2,2514,2536,-22,0,311,0,6
498,2,2443,2371,72,0,102,0,6
499,3,2359,2464,-105,0,119,0,6
500,1,2390,2489,-99,0,300,0,6
501,2,2559,2567,-8,0,101,1,6
502,1,2463,2277,186,0,2,0,6
503,2,2283,2427,-144,0,108,0,6
504,1,2443,2390,53,0,464,1,8
505,1,2403,2421,-18,0,247,1,6
506,2,2452,2473,-21,0,190,0,6
507,2,2380,2416,-36,0,34,0,6
508,2,2476,2419,57,0,311,1,6
509,1,2471,2497,-26,0,85,0,6
510,3,2418,2441,-23,0,140,0,6
511,1,2669,2559,110,0,104,0,6
512,2,2467,2370,97,0,1,1,6
513,2,2451,2545,-94,0,1,1,6
514,3,2599,2609,-10,0,101,0,6
515,2,2421,2375,46,0,324,0,6
516,1,2432,2279,153,0,46,0,6
517,2,2529,2349,180,0,300,1,6
518,2,2555,2673,-118,0,0,0,6
519,2,2400,2457,-57,0,106,1,6
520,1,2462,2361,101,0,265,0,6
521,1,2274,2466,-192,0,100,1,6
522,2,2390,2406,-16,0,0,0,6
523,1,2313,2509,-196,0,112,0,6
524,2,2403,2470,-67,0,61,1,6
525,2,2608,2424,184,0,0,0,6
526,1,2406,2296,110,0,210,0,6
527,1,2469,2435,34,0,57,1,6
528,2,2652,2599,53,0,101,0,6
529,2,2411,2514,-103,0,115,0,6
530,1,2208,2411,-203,0,125,1,6
531,1,2446,2355,91,0,5,0,6
532,1,2358,2495,-137,0,132,0,6
533,1,2521,2370,151,0,117,0,6
534,1,2677,2551,126,0,138,0,6
535,1,2572,2426,146,0,115,1,6
536,2,2415,2446,-31,0,9,0,6
537,2,2479,2477,2,0,200,1,6
538,1,2409,2491,-82,0,123,0,6
539,2,2383,2418,-35,0,49,1,6
540,2,2549,2447,102,0,0,1,6
541,2,2474,2301,173,0,45,0,6
542,2,2421,2500,-79,0,117,0,6
543,1,2357,2466,-109,0,112,0,6
544,1,2443,2330,113,0,107,0,6
545,2,2411,2384,27,0,405,0,6
546,1,2484,2416,68,0,335,0,6
547,1,2458,2283,175,0,110,1,6
548,1,2357,2461,-104,0,106,1,6
549,2,2548,2681,-133,0,0,0,6
550,1,2450,2460,-10,0,302,0,6
551,1,2433,2266,167,0,107,0,6
552,2,2456,2474,-18,0,193,0,6
553,2,2365,2519,-154,0,113,0,6
554,2,2407,2474,-67,0,216,0,6
555,1,2410,2275,135,0,218,0,6
556,2,2246,2452,-206,0,345,1,6
557,1,2483,2410,73,0,347,0,6
558,2,2284,2635,-351,0,267,0,6
559,2,2355,2524,-169,0,123,1,6
560,2,2451,2336,115,0,8,0,6
561,2,2423,2522,-99,0,112,1,6
562,2,2310,2466,-156,0,43,0,6
563,1,2553,2576,-23,0,101,0,6
564,1,2459,2364,95,0,264,0,6
565,1,2685,2544,141,0,253,0,6
566,1,2505,2423,82,0,459,0,6
567,2,2454,2479,-25,0,96,0,6
568,1,2390,2405,-15,0,0,1,6
569,2,2417,2542,-125,0,40,1,6
570,2,2360,2463,-103,0,241,0,6
571,2,2489,2415,74,0,331,1,6
572,2,2456,2401,55,0,456,1,6
573,1,2455,2365,90,0,180,0,6
574,1,2509,2328,181,0,43,0,6
575,1,2541,2688,-147,0,0,0,6
576,3,2331,2488,-157,0,4,0,6
577,1,2406,2415,-9,0,4,1,6
578,2,2288,2470,-182,0,121,0,6
579,1,2467,2356,111,0,264,0,6
580,1,2419,2526,-107,0,112,0,6
581,1,2570,2559,11,0,121,0,6
582,1,2419,2484,-65,0,201,0,6
583,2,2313,2448,-135,0,5,1,8
584,2,2283,2412,-129,0,311,0,6
585,1,2637,2527,110,0,320,0,6
586,1,2449,2512,-63,0,39,0,6
587,3,2424,2388,36,0,0,0,6
588,2,2346,2443,-97,0,485,0,6
589,2,2450,2480,-30,0,1,0,6
590,3,2543,2463,80,0,114,0,6
591,1,2448,2464,-16,0,474,1,6
592,3,2372,2442,-70,0,10,0,6
593,2,2554,2575,-21,0,176,1,6
594,2,2450,2377,73,0,132,0,6
595,2,2352,2471,-119,0,250,0,6
596,3,2463,2326,137,0,331,0,6
597,3,2358,2483,-125,0,7,0,6
598,3,2414,2487,-73,0,123,0,6
599,2,2400,2410,-10,0,45,0,6
600,2,2364,2546,-182,0,455,1,6
601,3,2471,2307,164,0,380,0,6
602,1,2680,2549,131,0,103,1,6
603,2,2408,2430,-22,0,241,0,6
604,1,2486,2385,101,0,8,0,6
605,1,2459,2309,150,0,133,1,6
606,2,2353,2402,-49,0,4,0,6
607,1,2465,2325,140,0,46,0,6
608,2,2291,2542,-251,0,128,0,6
609,1,2485,2332,153,0,41,0,6
610,1,2478,2473,5,0,50,0,6
611,1,2342,2420,-78,4,476,1,13
612,3,2477,2444,33,0,40,0,6
613,3,2505,2332,173,0,46,0,6
614,2,2482,2456,26,0,101,0,6
615,1,2519,2382,137,0,101,0,6
616,2,2345,2448,-103,0,3,1,6
617,2,2485,2240,245,0,288,0,6
618,3,2354,2409,-55,0,45,0,6
619,1,2419,2342,77,0,107,0,6
620,1,2475,2348,127,0,264,0,6
621,2,2422,2461,-39,0,112,0,6
622,2,2461,2389,72,0,106,0,6
623,2,2581,2443,138,0,121,0,6
624,1,2523,2386,137,0,247,0,6
625,1,2641,2348,293,0,101,0,6
626,1,2516,2426,90,0,310,0,6
627,3,2328,2417,-89,0,312,0,6
628,1,2328,2489,-161,0,226,1,6
629,2,2580,2407,173,0,4,0,6
630,2,2207,2404,-197,0,37,0,8
631,2,2402,2394,8,0,0,0,6
632,1,2239,2424,-185,0,100,0,6
633,2,2237,2432,-195,0,40,0,6
634,1,2468,2462,6,0,454,1,6
635,2,2243,2492,-249,0,106,1,6
636,2,2545,2684,-139,0,0,1,6
637,2,2378,2523,-145,0,21,0,6
638,2,2483,2353,130,0,418,1,6
639,2,2467,2462,5,0,302,0,6
640,2,2436,2275,161,0,40,0,6
641,1,2476,2200,276,0,0,1,6
642,2,2544,2468,76,0,114,0,6
643,2,2454,2503,-49,0,117,0,6
644,3,2409,2257,152,0,49,0,6
645,1,2415,2329,86,0,152,0,6
646,2,2408,2369,39,0,13,1,6
647,1,2549,2368,181,0,0,0,6
648,2,2345,2479,-134,0,250,0,6
649,1,2268,2477,-209,0,4,0,6
650,2,2494,2285,209,0,40,0,6
651,1,2435,2460,-25,0,5,0,6
652,2,2466,2573,-107,0,58,0,6
653,2,2451,2480,-29,0,269,0,6
654,2,2400,2396,4,0,45,1,6
655,2,2526,2422,104,0,115,1,6
656,2,2417,2476,-59,0,216,0,6
657,2,2315,2537,-222,0,1,0,6
658,1,2435,2392,43,0,16,0,6
659,2,2284,2445,-161,0,121,1,6
660,1,2688,2541,147,0,104,0,6
661,2,2483,2341,142,0,265,0,6
662,1,2346,2527,-181,0,107,1,6
663,2,2300,2468,-168,0,133,0,6
664,1,2456,2474,-18,0,45,0,6
665,2,2540,2292,248,0,201,0,6
666,1,2508,2486,22,0,302,1,6
667,2,2325,2450,-125,0,172,0,6
668,3,2361,2461,-100,0,132,0,6
669,1,2579,2402,177,0,453,0,6
670,1,2479,2330,149,0,48,0,6
671,2,2360,2552,-192,0,106,0,6
672,2,2231,2441,-210,0,40,0,6
673,2,2275,2448,-173,0,143,0,6
674,1,2414,2311,103,0,110,0,6
675,3,2498,2572,-74,0,105,0,6
676,1,2314,2454,-140,0,106,0,6
677,2,2273,2445,-172,0,250,0,6
678,1,2485,2314,171,0,4,0,6
679,2,2307,2495,-188,0,128,0,6
680,1,2538,2691,-153,0,301,0,6
681,2,2471,2453,18,0,260,0,6
682,2,2372,2462,-90,0,113,0,6
683,2,2349,2475,-126,0,101,0,6
684,2,2453,2283,170,0,202,0,6
685,2,2579,2577,2,0,104,0,6
686,1,2464,2283,181,0,56,0,6
687,1,2287,2436,-149,0,307,0,6
688,1,2460,2363,97,0,45,0,6
689,1,2402,2394,8,0,0,0,6
690,3,2571,2499,72,0,130,0,6
691,2,2281,2531,-250,0,123,1,6
692,2,2347,2402,-55,0,101,0,6
693,2,2468,2462,6,0,106,1,6
694,3,2500,2325,175,0,45,0,6
695,2,2325,2519,-194,0,302,0,6
696,1,2452,2272,180,0,1,0,6
697,1,2429,2401,28,0,133,0,6
698,2,2370,2513,-143,0,211,1,6
699,2,2403,2449,-46,0,466,1,6
700,2,2643,2375,268,0,112,0,6
701,2,2479,2345,134,0,20,0,6
702,1,2555,2480,75,0,0,1,6
704,2,2305,2498,-193,0,2,1,6
705,2,2208,2420,-212,0,29,1,6
706,2,2364,2440,-76,0,46,1,6
707,1,2468,2273,195,0,43,0,6
708,1,2446,2322,124,0,45,1,6
709,2,2380,2465,-85,0,348,0,6
710,1,2683,2546,137,0,103,0,6
711,3,2407,2382,25,0,41,0,6
712,2,2467,2574,-107,0,485,0,6
713,1,2388,2408,-20,0,45,0,6
714,3,2360,2583,-223,0,101,0,6
715,1,2473,2360,113,0,41,0,6
716,1,2454,2470,-16,0,45,0,6
717,3,2269,2477,-208,0,4,0,6
718,2,2455,2464,-9,0,1,0,6
719,1,2517,2367,150,0,455,1,6
720,2,2284,2474,-190,0,113,0,6
721,2,2244,2407,-163,0,245,0,8
722,2,2543,2687,-144,0,110,0,6
723,1,2448,2320,128,0,57,1,6
724,1,2468,2522,-54,0,15,0,6
725,1,2472,2292,180,0,314,0,6
726,1,2402,2394,8,0,0,1,6
727,1,2559,2392,167,0,0,0,6
728,2,2353,2471,-118,0,250,0,6
729,2,2570,2398,172,0,46,1,6
730,1,2477,2449,28,0,43,0,6
731,2,2355,2634,-279,0,124,0,6
732,2,2470,2435,35,0,180,0,6
733,2,2295,2445,-150,0,15,1,6
734,1,2463,2463,0,0,50,0,6
735,1,2515,2475,40,0,101,0,6
736,1,2412,2272,140,0,29,0,6
737,3,2477,2281,196,0,387,0,6
738,2,2690,2539,151,0,102,0,6
739,1,2490,2502,-12,0,4,1,6
740,1,2580,2403,177,0,121,0,6
741,2,2476,2413,63,0,337,1,6
742,1,2408,2213,195,0,225,1,6
743,2,2464,2460,4,0,241,0,6
744,1,2498,2241,257,0,277,0,6
745,3,2500,2570,-70,0,105,0,6
746,1,2456,2272,184,0,454,0,6
747,2,2474,2533,-59,0,48,0,6
748,1,2444,2375,69,0,28,1,6
749,2,2370,2563,-193,0,40,1,6
750,3,2389,2520,-131,0,117,0,6
751,1,2433,2298,135,0,107,0,6
752,3,2256,2479,-223,0,109,0,6
753,2,2326,2560,-234,0,190,0,6
754,3,2568,2406,162,0,336,0,6
755,1,2499,2298,201,0,45,0,6
756,2,2371,2538,-167,0,1,0,6
757,1,2482,2385,97,0,107,0,6
758,1,2471,2470,1,0,315,0,6
759,1,2475,2349,126,0,253,0,6
760,2,2415,2565,-150,0,22,0,6
761,1,2399,2459,-60,0,45,0,6
762,3,2520,2364,156,0,154,0,6
763,2,2294,2469,-175,0,45,1,6
764,1,2389,2408,-19,0,65,0,6
765,2,2441,2457,-16,0,132,0,6
766,1,2355,2464,-109,0,343,1,6
767,1,2547,2682,-135,0,0,0,6
768,2,2496,2303,193,0,14,1,6
769,2,2497,2229,268,0,455,0,6
770,2,2337,2486,-149,0,115,0,6
772,2,2337,2500,-163,0,1,0,6
773,1,2445,2207,238,0,1,0,6
774,1,2295,2436,-141,0,45,0,6
775,2,2465,2458,7,0,150,1,6
776,1,2482,2307,175,0,106,0,6
777,1,2379,2408,-29,0,260,0,6
778,3,2639,2583,56,0,101,0,6
779,2,2219,2501,-282,0,13,0,6
780,1,2393,2412,-19,0,8,0,6
781,2,2392,2459,-67,0,131,1,8
782,3,2432,2483,-51,0,7,0,6
783,2,2464,2275,189,0,46,0,6
784,3,2429,2362,67,0,108,0,6
785,2,2346,2479,-133,0,250,0,6
786,1,2450,2420,30,0,300,0,6
787,1,2475,2542,-67,0,52,0,6
788,2,2206,2413,-207,0,122,0,6
789,1,2584,2565,19,0,244,1,6
790,2,2366,2518,-152,0,117,0,6
791,1,2442,2200,242,0,201,1,6
792,2,2368,2500,-132,0,394,0,6
793,1,2331,2404,-73,0,106,1,6
794,1,2363,2406,-43,0,147,0,6
795,1,2566,2436,130,0,0,0,6
796,1,2463,2315,148,0,45,0,6
797,3,2490,2373,117,0,100,0,6
798,1,2333,2405,-72,0,118,0,6
799,2,2402,2395,7,0,0,1,6
800,3,2482,2342,140,0,253,0,6
801,1,2568,2452,116,0,268,0,6
802,1,2674,2555,119,0,103,0,6
803,1,2268,2402,-134,0,302,0,6
804,2,2455,2366,89,0,25,0,6
805,3,2503,2450,53,0,177,0,6
806,2,2456,2472,-16,0,115,0,6
807,1,2488,2456,32,0,112,0,6
808,3,2400,2562,-162,0,12,0,6
809,1,2415,2408,7,0,190,0,6
810,2,2291,2449,-158,0,45,0,6
811,1,2365,2488,-123,0,205,1,6
812,3,2516,2432,84,0,311,0,6
813,1,2391,2569,-178,0,106,0,6
814,1,2401,2292,109,0,268,0,6
816,1,2535,2299,236,0,131,0,6
817,2,2481,2484,-3,0,484,1,6
818,1,2429,2308,121,0,106,0,6
819,1,2503,2234,269,0,45,0,6
820,1,2450,2241,209,0,1,1,6
821,2,2411,2336,75,0,25,0,8
822,2,2450,2298,152,0,46,0,6
823,3,2372,2493,-121,0,8,0,6
824,2,2484,2367,117,0,254,0,6
825,1,2400,2439,-39,0,18,0,6
826,2,2521,2363,158,0,344,0,6
827,1,2477,2370,107,0,484,0,6
828,3,2278,2451,-173,0,133,0,6
829,2,2480,2589,-109,0,0,0,6
830,1,2537,2438,99,0,100,0,6
831,2,2551,2678,-127,0,49,0,6
832,3,2491,2402,89,0,101,0,6
833,1,2420,2286,134,0,4,0,6
834,1,2557,2466,91,0,45,0,6
835,2,2230,2433,-203,0,20,1,6
836,1,2348,2420,-72,0,352,0,6
837,3,2420,2448,-28,0,113,0,6
838,1,2405,2436,-31,0,106,0,6
839,2,2402,2514,-112,0,301,0,6
840,1,2291,2502,-211,0,45,0,6
841,2,2374,2558,-184,0,135,0,6
842,2,2306,2419,-113,0,122,0,6
843,3,2448,2572,-124,0,414,0,6
844,2,2453,2358,95,0,1,0,6
845,2,2313,2442,-129,0,110,0,6
846,3,2402,2413,-11,0,464,0,6
847,1,2283,2476,-193,0,40,1,6
848,2,2306,2470,-164,0,122,0,6
849,2,2491,2299,192,0,365,1,6
850,2,2272,2445,-173,0,250,1,6
851,2,2433,2421,12,0,106,1,6
852,1,2568,2480,88,0,11,0,6
853,1,2682,2548,134,0,104,0,6
854,2,2481,2365,116,0,331,0,6
855,1,2462,2563,-101,0,106,0,6
856,1,2593,2476,117,0,118,1,6
857,2,2319,2541,-222,0,176,0,6
858,2,2279,2434,-155,0,40,0,6
859,2,2615,2653,-38,0,353,0,6
860,1,2448,2319,129,0,190,0,6
861,2,2402,2513,-111,0,15,1,6
862,3,2507,2327,180,0,45,0,6
863,2,2412,2401,11,0,123,1,6
864,2,2258,2430,-172,0,106,0,6
865,1,2494,2336,158,0,138,0,6
866,1,2350,2404,-54,0,223,0,8
867,2,2424,2216,208,0,106,0,6
868,2,2502,2667,-165,0,463,0,6
869,2,2312,2445,-133,0,1,0,6
870,1,2420,2421,-1,0,0,1,6
871,1,2368,2491,-123,0,45,0,6
872,2,2303,2403,-100,0,12,1,6
873,1,2448,2334,114,0,45,1,6
874,1,2403,2518,-115,0,117,0,6
875,1,2671,2582,89,0,110,1,6
876,1,2554,2470,84,0,0,1,6
877,2,2437,2544,-107,0,5,1,6
878,1,2476,2406,70,0,315,0,6
879,1,2371,2476,-105,0,216,1,6
880,2,2226,2446,-220,0,110,0,6
881,2,2544,2686,-142,0,123,0,6
882,1,2563,2452,111,0,345,1,6
883,1,2568,2572,-4,0,88,0,6
884,1,2427,2402,25,0,106,0,6
885,1,2433,2474,-41,0,453,0,6
886,3,2441,2396,45,0,242,0,6
887,1,2449,2262,187,0,1,0,6
888,2,2468,2380,88,0,254,0,6
889,3,2597,2472,125,0,268,0,6
890,3,2570,2450,120,0,268,0,6
891,1,2372,2406,-34,0,40,0,6
892,3,2373,2402,-29,0,312,0,6
893,3,2426,2223,203,0,110,0,6
894,2,2407,2316,91,0,470,0,6
895,3,2517,2398,119,0,139,0,6
896,3,2608,2658,-50,0,330,0,6
897,2,2511,2467,44,0,455,1,6
898,3,2302,2485,-183,0,6,0,6
899,2,2297,2439,-142,0,3,1,6
900,2,2566,2452,114,0,25,0,6
901,2,2400,2515,-115,0,21,0,6
902,2,2420,2389,31,0,242,0,6
903,1,2330,2426,-96,0,4,0,6
904,2,2465,2559,-94,0,300,1,6
905,1,2433,2422,11,0,241,0,6
906,1,2415,2419,-4,0,114,0,6
907,1,2689,2541,148,0,100,0,6
908,2,2469,2675,-206,0,82,0,6
909,2,2410,2448,-38,0,128,0,6
910,1,2400,2379,21,0,246,0,6
911,2,2360,2448,-88,0,106,0,6
912,3,2349,2463,-114,0,100,0,6
913,2,2296,2401,-105,0,10,0,6
914,2,2287,2461,-174,0,40,1,6
915,2,2445,2474,-29,0,101,0,6
916,1,2419,2371,48,0,0,0,6
917,1,2413,2224,189,0,107,0,6
918,2,2342,2449,-107,0,13,0,5
919,1,2519,2396,123,0,453,0,6
920,2,2532,2565,-33,0,28,0,6
921,2,2453,2365,88,0,113,1,6
922,2,2537,2693,-156,0,0,0,6
923,2,2413,2445,-32,0,25,0,6
924,2,2406,2292,114,0,5,0,6
925,1,2466,2456,10,0,466,0,6
926,1,2678,2553,125,0,132,1,6
927,1,2505,2421,84,0,302,1,6
928,1,2302,2483,-181,4,0,0,13
929,2,2407,2302,105,0,0,1,6
930,2,2395,2424,-29,0,40,0,6
931,1,2459,2293,166,0,110,0,6
932,2,2369,2414,-45,0,205,0,6
933,1,2696,2534,162,0,135,0,6
935,2,2240,2400,-160,0,145,1,6
936,1,2521,2559,-38,0,92,0,6
937,1,2401,2275,126,0,57,1,6
938,1,2574,2438,136,0,345,0,6
939,1,2523,2356,167,0,109,0,6
940,1,2416,2484,-68,0,234,0,6
941,1,2472,2366,106,0,310,0,6
942,2,2398,2429,-31,0,10,0,6
943,2,2412,2374,38,0,107,0,6
944,2,2464,2382,82,0,245,1,6
945,1,2400,2284,116,0,104,1,6
946,1,2443,2294,149,0,343,0,6
947,1,2290,2463,-173,0,110,0,6
948,1,2509,2408,101,0,455,1,6
949,2,2290,2476,-186,0,245,0,8
950,1,2446,2300,146,0,295,0,6
951,1,2450,2339,111,0,107,0,6
952,2,2304,2476,-172,0,84,0,6
953,1,2578,2582,-4,0,106,0,6
954,2,2463,2563,-100,0,40,0,6
955,1,2407,2372,35,0,6,0,6
956,1,2531,2552,-21,0,4,0,6
957,2,2452,2399,53,0,414,0,6
958,2,2334,2482,-148,0,317,0,6
959,1,2435,2477,-42,0,250,0,6
960,1,2570,2527,43,0,103,0,6
961,2,2434,2447,-13,0,0,0,6
962,1,2478,2549,-71,0,464,0,6
963,1,2470,2319,151,0,212,1,6
964,2,2479,2454,25,0,106,1,6
965,1,2280,2457,-177,0,40,0,6
966,1,2673,2578,95,0,45,1,6
967,2,2405,2314,91,0,41,0,6
968,3,2513,2330,183,0,404,0,6
969,1,2389,2404,-15,0,101,1,6
970,1,2314,2403,-89,0,265,0,6
971,2,2400,2288,112,0,0,0,6
972,1,2537,2486,51,0,9,0,6
973,1,2450,2520,-70,0,145,1,6
974,2,2452,2429,23,0,40,0,6
975,1,2576,2549,27,0,337,0,6
976,1,2406,2445,-39,0,15,0,6
977,1,2405,2508,-103,0,395,0,6
978,3,2418,2385,33,0,248,0,6
979,2,2402,2348,54,0,10,0,6
980,1,2542,2405,137,0,255,0,6
981,2,2263,2418,-155,0,4,0,6
982,2,2325,2510,-185,0,201,0,6
983,2,2474,2423,51,0,45,0,6
984,2,2372,2473,-101,0,203,0,6
985,2,2461,2462,-1,0,29,1,6
986,2,2481,2435,46,0,100,0,6
987,2,2439,2412,27,0,414,0,6
988,2,2448,2395,53,0,245,0,6
989,1,2544,2582,-38,0,107,0,6
990,1,2315,2457,-142,0,140,0,6
991,2,2514,2678,-164,0,331,0,6
992,1,2475,2345,130,4,205,0,13
993,1,2369,2501,-132,0,150,0,6
994,3,2546,2560,-14,0,151,0,6
995,1,2477,2380,97,0,41,0,6
996,1,2352,2513,-161,0,202,0,6
997,2,2277,2429,-152,0,49,0,6
998,1,2430,2510,-80,0,115,0,6
999,1,2681,2615,66,0,81,0,6
1000,2,2474,2481,-7,0,203,0,6
1001,3,2468,2390,78,0,254,0,6
1002,1,2506,2378,128,0,474,1,6
1003,1,2442,2449,-7,0,0,1,6
1004,2,2285,2442,-157,0,40,0,6
1005,2,2402,2402,0,0,101,1,6
1006,2,2420,2256,164,0,40,1,6
1007,2,2359,2493,-134,0,300,1,6
1008,1,2575,2550,25,0,330,0,6
1009,2,2243,2417,-174,0,128,1,6
1010,1,2505,2391,114,0,64,1,6
1011,2,2353,2469,-116,0,200,1,6
1012,2,2330,2441,-111,0,210,1,6
1013,2,2545,2581,-36,0,106,0,6
1014,1,2483,2454,29,0,464,0,6
1015,1,2487,2503,-16,0,306,0,6
1016,1,2546,2389,157,0,107,1,6
1017,2,2610,2686,-76,0,101,1,6
1018,2,2375,2442,-67,0,102,1,6
1019,1,2448,2509,-61,0,0,1,6
1020,2,2443,2322,121,0,4,1,6
1021,1,2466,2412,54,0,258,0,6
1022,2,2407,2282,125,0,140,0,6
1023,1,2497,2405,92,0,190,0,6
1024,1,2445,2396,49,0,254,0,6
1025,3,2417,2586,-169,0,106,0,6
1026,1,2241,2402,-161,0,154,0,6
1027,2,2509,2690,-181,0,302,0,6
1028,2,2274,2447,-173,0,200,0,6
1029,1,2449,2473,-24,0,207,0,6
1030,2,2419,2218,201,4,475,0,13
1031,1,2617,2622,-5,0,80,0,6
1032,2,2497,2506,-9,0,394,0,6
1033,1,2447,2549,-102,0,453,0,6
1034,2,2503,2693,-190,0,302,1,6
1035,2,2428,2337,91,0,251,0,6
1036,3,2420,2393,27,0,248,0,6
1037,1,2435,2471,-36,0,218,0,6
1038,2,2394,2501,-107,0,0,0,6
1039,1,2329,2407,-78,0,248,1,6
1040,1,2452,2462,-10,0,43,1,6
1041,2,2467,2583,-116,0,108,0,6
1042,2,2299,2455,-156,0,49,0,6
1043,1,2579,2512,67,0,112,0,6
1044,2,2411,2245,166,0,107,0,6
1045,1,2384,2460,-76,0,210,0,6
1046,3,2489,2402,87,0,404,0,6
1047,3,2616,2623,-7,0,8,0,6
1048,2,2432,2454,-22,0,15,1,6
1049,2,2467,2218,249,0,0,1,6
1050,1,2507,2542,-35,0,459,0,6
1051,1,2379,2492,-113,0,3,1,6
1052,1,2400,2360,40,0,410,0,6
1053,3,2294,2442,-148,0,130,0,6
1054,2,2464,2500,-36,0,102,0,6
1055,2,2505,2390,115,0,154,0,6
1056,2,2514,2584,-70,0,453,1,6
1057,2,2398,2498,-100,0,0,0,6
1058,1,2422,2387,35,0,129,0,6
1059,2,2378,2536,-158,0,195,0,6
1060,2,2458,2462,-4,0,132,1,6
1061,1,2696,2587,109,0,108,0,6
1062,2,2463,2365,98,0,112,0,6
1063,1,2460,2375,85,0,341,0,6
1064,2,2355,2405,-50,0,403,0,6
1065,2,2505,2606,-101,0,80,1,6
1066,1,2439,2403,36,0,135,0,6
1067,2,2330,2487,-157,0,143,1,6
1068,3,2396,2405,-9,0,241,0,6
1069,1,2341,2493,-152,0,466,0,6
1070,1,2502,2394,108,0,157,0,6
1071,2,2505,2561,-56,0,45,1,6
1072,1,2426,2509,-83,0,39,0,6
1073,2,2404,2256,148,0,107,0,6
1074,2,2379,2445,-66,0,145,0,6
1075,1,2398,2464,-66,0,103,0,6
1076,1,2453,2377,76,0,249,0,6
1077,1,2410,2350,60,0,43,1,6
1078,2,2583,2502,81,0,1,1,6
1079,2,2348,2552,-204,0,106,0,8
1080,3,2501,2602,-101,0,302,0,6
1081,2,2242,2484,-242,0,343,0,6
1082,2,2485,2407,78,0,433,1,6
1083,2,2390,2491,-101,0,7,0,6
1084,2,2506,2433,73,0,143,0,6
1085,1,2487,2240,247,0,343,1,6
1086,1,2566,2391,175,0,123,0,6
1087,1,2500,2380,120,0,300,0,6
1088,2,2373,2457,-84,0,120,1,6
1089,1,2437,2484,-47,0,107,0,6
1090,2,2457,2600,-143,0,330,0,6
1091,2,2449,2358,91,0,113,0,6
1092,2,2317,2479,-162,4,140,0,13
1093,1,2363,2494,-131,0,101,1,6
1094,1,2362,2402,-40,0,34,1,6
1095,2,2377,2504,-127,0,13,0,6
1096,2,2345,2415,-70,0,255,1,6
1097,1,2496,2386,110,0,405,1,6
1098,1,2401,2414,-13,0,200,1,6
1099,1,2509,2499,10,0,311,0,6
1100,2,2388,2569,-181,0,301,1,6
1101,1,2454,2318,136,0,343,0,6
1102,2,2238,2489,-251,0,343,0,6
1103,2,2436,2353,83,0,241,0,6
1104,2,2468,2436,32,0,400,1,6
1105,1,2478,2443,35,0,205,0,6
1106,2,2368,2478,-110,0,6,0,6
1107,2,2494,2440,54,0,143,0,6
1108,1,2604,2508,96,0,117,0,6
1109,2,2539,2442,97,0,140,0,6
1110,1,2366,2462,-96,0,194,0,6
1111,1,2420,2340,80,0,43,1,6
1112,1,2486,2600,-114,0,40,0,6
1113,1,2438,2483,-45,0,107,1,6
1114,1,2408,2474,-66,0,323,1,6
1115,1,2491,2235,256,0,346,0,6
1116,2,2462,2457,5,0,57,1,6
1117,2,2443,2473,-30,0,9,0,6
1118,1,2442,2385,57,0,463,0,6
1119,2,2463,2374,89,0,338,0,6
1120,2,2487,2608,-121,0,256,1,6
1121,1,2389,2450,-61,0,302,1,6
1122,2,2233,2494,-261,0,343,0,6
1123,1,2454,2459,-5,0,190,0,6
1124,1,2373,2504,-131,0,210,0,6
1125,2,2519,2379,140,0,45,0,6
1126,2,2390,2532,-142,0,113,0,6
1127,1,2746,2385,361,0,140,0,6
1128,2,2328,2456,-128,0,16,0,6
1129,1,2439,2381,58,0,302,0,6
1130,1,2496,2231,265,0,315,0,6
1131,1,2336,2424,-88,0,6,0,6
1132,2,2592,2493,99,0,45,0,6
1133,1,2467,2447,20,0,476,0,6
1134,3,2496,2380,116,0,45,0,6
1135,2,2229,2498,-269,0,352,0,6
1136,2,2415,2381,34,0,466,0,6
1137,1,2368,2460,-92,0,4,0,6
1138,1,2612,2483,129,0,151,0,6
1139,2,2533,2365,168,0,4,0,6
1140,2,2272,2447,-175,0,80,1,6
1141,2,2443,2396,47,0,9,0,6
1142,3,2366,2408,-42,0,17,0,6
1143,1,2500,2227,273,0,343,0,6
1144,2,2445,2438,7,0,106,0,6
1145,2,2225,2502,-277,0,343,0,6
1146,1,2460,2307,153,0,43,0,6
1147,3,2376,2444,-68,0,123,0,6
1148,2,2442,2572,-130,0,15,0,6
1149,1,2379,2429,-50,0,122,1,6
1150,1,2374,2405,-31,0,40,0,6
1151,1,2398,2408,-10,0,14,1,6
1152,2,2387,2494,-107,0,448,0,6
1153,1,2386,2443,-57,0,106,1,6
1154,2,2382,2453,-71,0,301,0,6
1155,1,2402,2589,-187,0,464,0,6
1156,2,2585,2405,180,0,1,0,6
1157,2,2480,2616,-136,0,256,0,6
1158,1,2340,2401,-61,0,40,0,6
1159,1,2417,2315,102,0,352,1,6
1160,2,2436,2333,103,0,216,1,6
1161,1,2504,2223,281,0,343,0,6
1162,2,2321,2480,-159,0,51,0,8
1163,1,2498,2383,115,0,45,0,6
1164,1,2466,2283,183,0,84,0,6
1165,1,2444,2369,75,0,9,0,6
1166,1,2362,2439,-77,0,455,0,6
1167,2,2381,2463,-82,0,4,0,6
1168,1,2421,2367,54,0,80,1,6
1169,2,2221,2506,-285,0,346,0,6
1170,3,2502,2538,-36,0,45,0,6
1171,1,2576,2379,197,0,152,1,6
1172,2,2395,2440,-45,0,125,0,6
1173,2,2452,2584,-132,0,28,0,6
1174,1,2437,2381,56,0,103,0,6
1175,2,2308,2404,-96,0,45,0,6
1176,1,2458,2403,55,0,203,0,6
1177,2,2326,2443,-117,0,152,0,6
1178,1,2619,2476,143,0,122,1,6
1179,1,2508,2219,289,0,331,0,6
1180,2,2217,2510,-293,0,343,0,6
1181,2,2403,2444,-41,0,45,0,6
1182,1,2341,2495,-154,0,474,1,6
1183,1,2405,2357,48,0,335,0,6
1184,1,2414,2468,-54,0,103,0,6
1185,3,2376,2457,-81,0,120,0,6
1186,1,2401,2284,117,0,101,1,6
1187,1,2484,2333,151,0,237,0,8
1188,1,2334,2432,-98,0,45,1,6
1189,1,2512,2216,296,0,311,0,6
1190,1,2588,2503,85,0,327,0,6
1191,2,2461,2416,45,0,352,0,6
1192,2,2671,2779,-108,0,337,0,6
1193,1,2448,2426,22,0,348,1,6
1194,1,2427,2420,7,0,131,1,6
1195,3,2361,2506,-145,0,119,0,6
1196,3,2423,2455,-32,0,45,0,6
1197,1,2398,2421,-23,0,306,0,6
1198,2,2449,2302,147,0,45,1,6
1199,1,2446,2438,8,0,385,0,6
1200,2,2214,2513,-299,0,302,0,6
1201,2,2408,2447,-39,0,14,0,6
1202,1,2376,2405,-29,0,455,0,6
1203,1,2387,2442,-55,0,106,0,6
1204,1,2390,2411,-21,0,405,1,6
1205,1,2580,2387,193,0,205,1,6
1206,2,2499,2592,-93,0,45,1,6
1207,2,2783,2667,116,0,310,0,6
1208,2,2425,2579,-154,0,337,0,6
1209,1,2638,2434,204,0,103,0,6
1210,2,2454,2423,31,0,352,0,6
1211,2,2391,2454,-63,0,100,1,6
1212,1,2421,2330,91,0,386,1,6
1213,2,2265,2410,-145,0,234,0,6
1214,1,2515,2212,303,0,343,0,6
1215,1,2504,2403,101,0,5,1,6
1216,1,2452,2304,148,0,460,0,6
1217,2,2415,2432,-17,0,143,0,6
1218,2,2435,2382,53,0,241,1,6
1219,2,2433,2331,102,0,130,1,6
1220,1,2317,2427,-110,0,150,0,8
1221,1,2485,2341,144,0,462,1,6
1222,1,2461,2437,24,0,485,0,6
1223,1,2674,2776,-102,0,112,0,6
1224,2,2430,2448,-18,0,301,0,6
1225,3,2494,2421,73,0,45,0,6
1226,2,2210,2517,-307,0,343,0,6
1227,2,2438,2449,-11,0,15,0,6
1228,2,2420,2351,69,0,312,0,8
1229,2,2568,2641,-73,0,483,1,6
1230,1,2582,2291,291,0,140,0,6
1231,2,2541,2583,-42,0,183,0,6
1232,1,2409,2597,-188,0,242,0,6
1233,1,2519,2209,310,0,306,0,6
1234,1,2768,2682,86,0,352,1,6
1235,2,2485,2458,27,0,100,1,6
1236,1,2431,2444,-13,0,40,1,6
1237,2,2350,2508,-158,0,41,0,6
1238,1,2404,2367,37,0,15,0,6
1239,2,2207,2520,-313,0,315,0,6
1240,1,2468,2445,23,0,135,0,6
1241,1,2371,2426,-55,0,106,0,6
1242,1,2584,2237,347,0,264,0,6
1243,1,2389,2405,-16,0,389,0,6
1244,1,2388,2428,-40,0,104,0,6
1245,1,2454,2424,30,0,40,1,6
1246,1,2588,2493,95,0,302,0,6
1247,1,2423,2365,58,0,306,0,6
1248,1,2380,2413,-33,0,150,0,8
1249,1,2409,2335,74,0,15,0,6
1250,1,2467,2418,49,0,404,0,6
1251,2,2345,2466,-121,0,145,0,6
1252,2,2257,2585,-328,0,418,0,6
1253,1,2440,2394,46,0,101,0,6
1254,2,2510,2562,-52,0,254,0,6
1255,2,2454,2512,-58,0,21,1,6
1256,2,2330,2413,-83,0,242,0,6
1257,1,2678,2773,-95,0,131,1,6
1258,1,2482,2380,102,0,358,0,6
1259,1,2465,2353,112,0,4,0,6
1260,2,2418,2479,-61,0,125,1,6
1261,1,2522,2205,317,0,343,0,6
1262,2,2419,2378,41,0,250,0,6
1263,2,2432,2592,-160,0,4,0,6
1264,2,2317,2456,-139,0,211,0,6
1265,1,2489,2459,30,0,113,0,6
1267,1,2436,2380,56,0,0,1,6
1268,2,2204,2524,-320,0,331,0,6
1269,2,2438,2413,25,0,122,1,6
1270,1,2525,2504,21,0,224,0,6
1271,1,2469,2399,70,0,128,1,6
1272,1,2418,2326,92,0,9,1,6
1273,2,2484,2472,12,0,348,1,6
1274,2,2445,2460,-15,0,140,0,6
1275,2,2401,2393,8,0,455,0,6
1276,1,2516,2568,-52,0,107,0,6
1277,2,2385,2469,-84,0,100,0,6
1278,2,2321,2536,-215,0,196,0,6
1279,1,2400,2416,-16,0,104,0,6
1280,2,2396,2427,-31,0,200,0,6
1281,2,2294,2450,-156,0,46,0,6
1282,1,2384,2413,-29,0,106,0,6
1283,2,2291,2439,-148,0,253,0,6
1284,1,2494,2333,161,0,45,0,6
1285,1,2454,2428,26,0,31,0,6
1286,3,2372,2408,-36,0,107,0,6
1287,1,2596,2429,167,0,410,0,6
1288,2,2766,2685,81,0,405,0,6
1289,1,2459,2378,81,0,416,1,6
1290,3,2414,2213,201,0,4,0,6
1291,2,2535,2437,98,0,105,0,6
1292,2,2469,2351,118,0,44,0,6
1293,2,2249,2432,-183,0,302,1,6
1294,1,2436,2223,213,0,0,0,6
1295,2,2404,2365,39,0,338,0,6
1296,2,2497,2459,38,0,102,0,6
1297,1,2560,2523,37,0,15,0,6
1298,2,2407,2390,17,0,277,0,6
1299,3,2466,2490,-24,0,453,0,6
1300,1,2419,2400,19,0,128,0,6
1301,3,2588,2419,169,0,123,0,6
1302,2,2322,2422,-100,0,120,0,6
1303,2,2426,2599,-173,0,385,0,6
1304,1,2453,2432,21,0,335,1,6
1305,2,2302,2478,-176,0,140,0,6
1306,2,2407,2329,78,0,126,0,6
1307,1,2453,2438,15,0,0,0,5
1308,2,2425,2425,0,0,218,0,6
1309,2,2692,2759,-67,0,107,0,6
1310,1,2518,2443,75,0,135,0,6
1311,3,2473,2371,102,0,4,0,6
1312,2,2566,2528,38,0,483,1,6
1313,3,2486,2498,-12,0,327,0,6
1314,1,2489,2466,23,0,246,1,6
1315,1,2434,2464,-30,0,18,0,6
1316,1,2541,2538,3,0,154,0,6
1317,1,2503,2385,118,0,253,1,6
1318,1,2416,2374,42,0,15,1,6
1319,2,2458,2340,118,0,4,0,6
1320,2,2425,2423,2,0,45,0,6
1321,2,2377,2401,-24,0,36,0,6
1322,2,2427,2419,8,0,122,0,6
1323,1,2431,2379,52,0,334,1,6
1324,2,2433,2371,62,0,485,0,6
1325,1,2403,2386,17,0,201,0,6
1326,1,2763,2687,76,0,316,1,6
1327,1,2523,2486,37,0,138,0,6
1328,1,2458,2498,-40,0,13,1,6
1329,1,2561,2444,117,0,0,0,6
1330,2,2438,2401,37,0,106,0,6
1331,2,2533,2481,52,0,216,0,6
1332,1,2628,2559,69,0,294,1,6
1333,1,2488,2496,-8,0,15,0,6
1334,1,2422,2398,24,0,140,1,6
1335,1,2352,2408,-56,4,8,0,13
1336,2,2440,2471,-31,0,10,0,6
1337,1,2317,2423,-106,0,15,0,6
1338,1,2535,2426,109,0,201,1,6
1339,3,2452,2586,-134,0,140,0,6
1340,2,2372,2494,-122,0,130,1,6
1341,2,2429,2481,-52,0,9,0,6
1342,2,2435,2528,-93,0,21,0,6
1343,2,2340,2519,-179,0,227,0,6
1344,1,2498,2380,118,0,12,1,6
1345,1,2458,2353,105,0,0,1,5
1346,1,2425,2473,-48,0,125,0,6
1347,2,2683,2768,-85,0,131,0,6
1348,1,2491,2421,70,0,40,1,6
1349,1,2565,2380,185,0,0,0,6
1350,2,2488,2526,-38,0,485,0,6
1351,2,2351,2419,-68,0,475,0,6
1352,3,2670,2611,59,0,398,0,6
1353,1,2477,2436,41,0,4,0,6
1354,1,2414,2532,-118,0,55,0,6
1355,1,2422,2402,20,0,380,0,6
1356,2,2257,2427,-170,0,156,0,6
1357,1,2286,2451,-165,0,121,0,6
1358,2,2454,2584,-130,0,45,1,6
1359,1,2467,2413,54,0,135,0,6
1360,2,2440,2432,8,0,48,1,6
1361,1,2502,2355,147,0,15,0,6
1362,1,2424,2302,122,0,45,0,6
1363,2,2511,2654,-143,0,108,1,6
1364,2,2256,2403,-147,0,40,1,6
1365,1,2612,2669,-57,0,5,1,6
1366,2,2468,2372,96,0,104,0,8
1367,2,2772,2679,93,0,110,0,6
1368,1,2525,2411,114,0,40,0,6
1369,2,2424,2568,-144,0,454,1,6
1370,2,2458,2623,-165,0,337,1,6
1371,1,2416,2496,-80,0,112,0,6
1372,2,2431,2372,59,0,154,0,6
1373,2,2393,2413,-20,0,112,0,6
1374,2,2345,2489,-144,0,51,0,8
1375,2,2532,2483,49,0,216,0,6
1376,2,2323,2465,-142,0,0,0,6
1377,2,2633,2584,49,0,190,0,6
1378,1,2352,2506,-154,0,130,0,6
1379,2,2381,2415,-34,0,110,0,6
1380,1,2472,2283,189,0,101,0,6
1381,2,2407,2529,-122,0,114,0,6
1382,1,2377,2425,-48,0,284,0,6
1383,1,2424,2427,-3,0,202,0,6
1384,2,2438,2489,-51,0,117,0,6
1385,1,2686,2765,-79,0,474,0,6
1386,1,2663,2657,6,0,461,0,6
1388,2,2626,2485,141,0,248,0,6
1389,1,2403,2260,143,0,150,1,6
1390,2,2405,2532,-127,0,118,0,6
1391,2,2382,2461,-79,0,122,1,8
1392,1,2415,2255,160,0,485,0,6
1393,2,2384,2571,-187,0,483,0,6
1394,2,2587,2721,-134,0,125,0,6
1395,1,2669,2634,35,0,462,0,6
1396,1,2490,2525,-35,0,485,0,6
1397,1,2422,2298,124,0,410,1,6
1398,2,2548,2429,119,0,355,0,6
1399,2,2418,2390,28,0,200,1,6
1400,2,2313,2494,-181,0,320,1,6
1401,2,2628,2654,-26,0,113,0,6
1402,1,2420,2375,45,0,15,0,6
1403,1,2758,2693,65,0,110,0,6
1404,1,2433,2420,13,0,143,1,6
1405,2,2536,2619,-83,0,265,0,6
1406,1,2442,2263,179,0,49,0,6
1407,2,2363,2419,-56,0,115,0,6
1408,1,2407,2441,-34,0,114,0,6
1409,2,2573,2476,97,0,253,0,6
1410,1,2342,2526,-184,0,0,0,6
1411,1,2540,2382,158,0,10,0,6
1412,2,2679,2574,105,0,466,0,6
1413,1,2452,2283,169,0,52,0,6
1414,1,2688,2763,-75,0,442,0,6
1415,2,2497,2575,-78,0,45,1,6
1416,2,2302,2451,-149,0,40,0,6
1417,1,2456,2410,46,0,152,0,6
1418,1,2532,2349,183,0,354,0,6
1419,1,2481,2412,69,0,437,0,6
1420,2,2519,2496,23,0,216,0,6
1421,1,2582,2371,211,0,5,0,6
1422,1,2419,2371,48,0,484,1,6
1423,1,2363,2507,-144,0,123,1,6
1424,1,2371,2425,-54,0,253,1,6
1425,1,2414,2250,164,0,464,0,6
1426,2,2435,2413,22,0,202,0,6
1427,1,2484,2566,-82,0,125,1,6
1428,2,2671,2646,25,0,466,0,6
1429,1,2437,2438,-1,0,112,0,6
1430,1,2485,2415,70,0,435,0,6
1431,2,2756,2695,61,0,352,1,6
1432,2,2460,2535,-75,0,32,0,6
1433,2,2432,2316,116,0,102,0,6
1434,1,2260,2445,-185,0,312,0,6
1435,1,2493,2373,120,0,80,0,6
1436,1,2349,2425,-76,0,50,1,6
1437,1,2584,2391,193,0,226,1,6
1438,2,2443,2461,-18,0,112,0,6
1439,1,2428,2433,-5,0,337,0,6
1440,1,2382,2406,-24,0,15,1,6
1441,2,2358,2401,-43,0,127,0,6
1442,3,2424,2324,100,0,106,0,6
1443,2,2424,2416,8,0,424,0,6
1444,1,2465,2298,167,0,113,0,8
1445,2,2396,2585,-189,0,108,1,6
1446,2,2306,2419,-113,0,331,0,6
1447,1,2652,2665,-13,0,112,1,6
1448,3,2559,2491,68,0,250,0,6
1449,1,2429,2410,19,0,103,0,6
1450,1,2539,2371,168,0,265,0,6
1451,1,2580,2499,81,0,13,1,6
1452,2,2410,2443,-33,0,37,1,6
1453,1,2406,2308,98,0,140,1,8
1454,1,2482,2371,111,0,4,0,6
1455,1,2496,2367,129,0,45,0,6
1456,1,2571,2536,35,0,101,0,6
1457,1,2363,2424,-61,0,317,0,6
1458,2,2427,2542,-115,0,119,0,6
1459,1,2423,2317,106,0,113,0,6
1460,2,2404,2434,-30,0,300,0,6
1461,1,2407,2437,-30,0,250,0,6
1462,1,2425,2466,-41,0,33,1,6
1463,3,2419,2269,150,0,57,0,6
1464,2,2303,2472,-169,0,268,1,6
1465,2,2369,2418,-49,0,201,0,6
1466,3,2501,2406,95,0,127,0,6
1467,2,2493,2558,-65,0,255,0,6
1468,2,2290,2469,-179,0,131,1,8
1469,1,2400,2350,50,0,43,0,6
1470,2,2588,2521,67,0,0,0,6
1471,1,2751,2659,92,0,112,0,6
1472,3,2413,2367,46,0,250,0,6
1473,2,2431,2474,-43,0,202,0,6
1474,3,2448,2427,21,0,213,0,6
1475,1,2422,2382,40,0,456,1,6
1476,1,2563,2488,75,0,254,1,6
1477,2,2367,2466,-99,0,200,0,6
1478,2,2367,2413,-46,0,41,1,6
1479,1,2495,2398,97,0,40,0,6
1480,2,2326,2422,-96,0,320,0,6
1481,1,2405,2440,-35,0,4,1,6
1482,2,2667,2637,30,0,113,0,6
1483,1,2676,2749,-73,0,113,0,6
1484,1,2584,2423,161,0,130,1,6
1485,1,2304,2408,-104,0,40,0,6
1486,1,2460,2297,163,0,4,0,6
1487,1,2376,2431,-55,0,150,0,6
1488,1,2655,2755,-100,0,113,1,6
1489,2,2475,2500,-25,0,309,1,6
1490,1,2474,2363,111,0,240,0,6
1491,3,2479,2490,-11,0,305,0,6
1492,1,2428,2448,-20,0,241,0,6
1493,1,2421,2426,-5,0,226,1,6
1494,2,2279,2556,-277,0,127,0,8
1495,1,2483,2567,-84,0,125,0,6
1496,2,2418,2363,55,0,250,0,6
1497,1,2547,2442,105,0,300,0,6
1498,2,2364,2454,-90,0,131,0,6
1499,1,2403,2314,89,0,300,1,6
1500,1,2427,2307,120,0,140,0,6
1501,1,2748,2662,86,0,107,1,6
1502,1,2360,2458,-98,0,100,0,6
1503,1,2416,2463,-47,0,358,0,6
1504,1,2436,2405,31,0,57,1,6
1505,1,2643,2742,-99,0,455,0,6
1506,1,2743,2683,60,0,13,0,6
1507,3,2359,2434,-75,0,200,0,6
1508,2,2434,2412,22,0,143,1,6
1509,1,2426,2322,104,0,260,1,6
1510,2,2398,2478,-80,0,45,0,6
1511,2,2541,2588,-47,0,191,0,6
1512,2,2486,2369,117,0,426,0,6
1513,1,2560,2491,69,0,277,1,6
1514,2,2652,2654,-2,0,101,1,6
1516,2,2479,2372,107,0,344,0,6
1517,2,2382,2428,-46,0,43,0,6
1518,2,2490,2421,69,0,354,0,6
1519,1,2662,2458,204,0,65,0,6
1520,2,2282,2402,-120,0,263,0,8
1521,2,2240,2451,-211,0,100,0,6
1522,1,2593,2527,66,0,101,0,6
1523,1,2432,2360,72,0,240,1,6
1524,2,2377,2455,-78,0,312,0,6
1525,1,2540,2735,-195,0,10,0,6
1526,3,2658,2752,-94,0,300,0,6
1527,2,2678,2747,-69,0,113,0,6
1528,1,2457,2486,-29,0,4,0,6
1529,2,2418,2431,-13,0,13,1,6
1530,1,2435,2427,8,0,110,1,6
1531,1,2368,2483,-115,0,145,0,6
1532,1,2350,2421,-71,0,44,1,6
1533,1,2471,2377,94,0,380,0,6
1534,1,2390,2441,-51,0,101,0,6
1535,2,2554,2466,88,0,49,0,6
1536,1,2400,2268,132,0,302,0,6
1537,1,2322,2433,-111,0,130,0,6
1538,2,2515,2660,-145,0,101,0,6
1539,2,2460,2577,-117,0,40,0,6
1540,2,2480,2478,2,0,41,0,6
1541,1,2372,2565,-193,0,345,0,6
1542,1,2355,2437,-82,0,200,0,6
1543,1,2751,2660,91,0,101,0,6
1544,2,2373,2483,-110,0,385,0,6
1545,1,2348,2476,-128,0,125,0,6
1546,2,2376,2443,-67,0,106,0,6
1547,1,2549,2480,69,0,100,0,6
1548,1,2431,2375,56,0,111,0,6
1549,1,2393,2463,-70,0,104,0,6
1550,2,2455,2665,-210,0,245,0,6
1551,1,2752,2674,78,0,130,0,6
1552,2,2663,2726,-63,0,122,0,6
1553,1,2430,2363,67,0,242,0,6
1554,2,2597,2437,160,0,107,0,6
1555,1,2454,2297,157,0,0,1,6
1556,2,2440,2422,18,0,111,0,6
1557,2,2376,2473,-97,0,107,0,6
1558,2,2339,2475,-136,0,353,0,6
1559,1,2581,2420,161,0,45,1,6
1560,1,2376,2406,-30,0,221,0,8
1561,1,2414,2356,58,0,45,1,6
1563,2,2655,2755,-100,0,45,1,6
1564,2,2348,2404,-56,0,1,0,6
1565,2,2427,2412,15,0,121,0,6
1566,2,2473,2581,-108,0,255,1,6
1567,1,2757,2833,-76,0,409,0,6
1568,1,2400,2384,16,0,102,0,8
1569,3,2556,2381,175,0,254,0,6
1570,1,2445,2468,-23,0,343,0,6
1571,3,2391,2402,-11,0,409,0,6
1572,1,2504,2667,-163,0,245,0,6
1573,3,2456,2357,99,0,0,0,6
1574,1,2428,2435,-7,0,140,0,6
1575,2,2453,2319,134,0,122,1,6
1576,1,2731,2650,81,0,115,0,6
1577,3,2553,2589,-36,0,153,0,6
1578,2,2477,2346,131,0,112,1,6
1579,2,2358,2435,-77,0,123,0,6
1580,1,2462,2409,53,0,44,1,6
1581,1,2439,2354,85,0,240,0,6
1582,3,2466,2554,-88,0,9,0,6
1583,1,2403,2451,-48,0,485,1,6
1584,2,2475,2407,68,0,4,1,6
1585,2,2343,2474,-131,0,123,1,6
1586,2,2242,2457,-215,0,100,0,6
1587,2,2581,2422,159,0,0,0,6
1588,1,2419,2375,44,0,45,0,6
1589,2,2478,2562,-84,0,123,1,6
1590,1,2362,2435,-73,0,8,0,6
1591,2,2371,2404,-33,0,211,0,6
1592,3,2402,2391,11,0,260,0,6
1593,2,2349,2444,-95,0,230,1,6
1594,3,2429,2434,-5,0,110,0,6
1595,2,2418,2411,7,0,9,0,6
1596,2,2448,2384,64,0,277,1,6
1597,3,2826,2764,62,0,288,0,6
1598,3,2304,2402,-98,0,400,0,6
1599,1,2374,2455,-81,0,70,0,6
1600,3,2585,2469,116,0,352,0,6
1601,2,2377,2524,-147,0,121,1,8
1602,2,2406,2312,94,0,27,0,6
1603,2,2409,2325,84,0,404,1,6
1604,2,2355,2541,-186,0,250,1,8
1605,1,2410,2238,172,0,255,0,8
1606,1,2490,2285,205,0,398,0,6
1607,2,2345,2513,-168,0,121,0,6
1608,2,2553,2535,18,0,20,0,6
1609,2,2427,2467,-40,0,104,0,6
1610,1,2478,2371,107,0,404,0,6
1611,1,2646,2674,-28,0,380,1,6
1612,1,2414,2467,-53,0,463,1,6
1613,2,2404,2468,-64,0,40,0,6
1614,2,2285,2424,-139,0,101,1,6
1615,3,2370,2503,-133,0,385,0,6
1616,2,2445,2388,57,0,315,1,6
1617,2,2417,2357,60,0,215,0,6
1618,3,2548,2370,178,0,381,0,6
1619,1,2349,2448,-99,0,1,1,6
1620,2,2554,2736,-182,0,175,0,6
1621,1,2445,2287,158,0,114,0,6
1622,2,2542,2472,70,0,461,0,6
1623,1,2448,2345,103,0,45,0,6
1624,2,2345,2475,-130,0,469,0,6
1625,1,2434,2429,5,0,140,0,6
1626,2,2430,2589,-159,0,202,1,6
1627,2,2573,2413,160,0,0,0,6
1628,3,2765,2825,-60,0,395,0,6
1629,1,2568,2473,95,0,335,0,6
1630,2,2513,2429,84,0,115,1,6
1631,2,2486,2547,-61,0,123,1,6
1632,1,2455,2612,-157,0,41,0,6
1633,3,2259,2404,-145,0,310,0,8
1634,2,2473,2507,-34,0,4,0,6
1635,2,2341,2452,-111,0,121,1,6
1636,2,2421,2399,22,0,131,0,6
1637,2,2668,2686,-18,0,404,0,6
1638,2,2403,2291,112,0,158,1,6
1639,2,2319,2438,-119,0,0,0,6
1640,1,2651,2660,-9,0,405,0,6
1641,1,2342,2409,-67,0,5,0,6
1642,1,2441,2402,39,0,211,1,6
1643,3,2373,2479,-106,0,15,0,6
1644,1,2423,2440,-17,0,111,1,6
1645,2,2341,2464,-123,0,426,0,6
1646,1,2592,2430,162,0,107,0,6
1647,1,2448,2287,161,0,101,0,6
1648,2,2440,2390,50,0,447,0,6
1649,1,2419,2508,-89,0,409,0,6
1650,1,2739,2605,134,0,15,0,6
1651,1,2544,2352,192,0,334,0,8
1652,3,2468,2425,43,0,4,0,6
1653,1,2528,2513,15,0,150,1,6
1654,2,2824,2766,58,0,113,1,6
1655,2,2427,2421,6,0,121,1,6
1656,2,2348,2400,-52,0,300,1,6
1657,1,2604,2463,141,0,46,1,6
1658,2,2434,2256,178,0,2,1,6
1659,1,2583,2481,102,0,302,0,6
1660,2,2403,2371,32,0,10,0,6
1661,2,2551,2460,91,0,45,0,6
1662,1,2459,2442,17,0,107,1,6
1663,1,2456,2337,119,0,2,0,6
1664,1,2402,2415,-13,0,101,0,6
1665,2,2655,2657,-2,0,115,1,6
1666,1,2477,2357,120,0,211,0,6
1667,3,2436,2506,-70,0,151,0,6
1668,1,2553,2366,187,0,380,0,6
1669,1,2616,2662,-46,0,2,0,6
1670,1,2409,2405,4,0,18,1,6
1671,3,2434,2429,5,0,140,0,6
1672,2,2338,2468,-130,0,341,0,6
1673,3,2534,2426,108,0,190,0,6
1674,1,2426,2337,89,0,17,0,6
1675,2,2242,2535,-293,4,404,0,11
1676,2,2507,2467,40,0,100,0,6
1677,2,2574,2467,107,0,263,0,6
1678,1,2460,2306,154,0,7,0,6
1679,2,2772,2818,-46,0,395,0,6
1680,1,2595,2477,118,0,13,0,6
1681,1,2481,2426,55,0,133,0,6
1682,1,2397,2497,-100,0,306,1,6
1683,2,2333,2460,-127,0,200,0,6
1684,1,2360,2421,-61,0,135,0,6
1685,1,2742,2544,198,0,150,0,6
1686,1,2437,2473,-36,0,400,0,6
1687,2,2405,2317,88,0,344,0,6
1688,1,2599,2421,178,0,253,0,6
1689,1,2334,2451,-117,0,22,0,6
1690,2,2427,2533,-106,0,406,0,6
1691,2,2419,2608,-189,0,241,1,6
1692,2,2293,2404,-111,0,43,0,6
1693,2,2370,2517,-147,0,453,0,6
1694,1,2474,2479,-5,0,241,0,6
1695,1,2429,2434,-5,0,110,0,6
1696,3,2656,2622,34,0,80,0,6
1697,2,2455,2482,-27,0,122,1,6
1698,2,2464,2329,135,0,16,1,6
1699,1,2745,2556,189,0,277,1,6
1700,2,2421,2486,-65,0,490,0,6
1701,1,2428,2532,-104,0,455,0,6
1702,1,2381,2497,-116,0,0,0,6
1703,2,2443,2468,-25,0,456,1,6
1704,1,2823,2767,56,0,130,0,6
1705,2,2400,2416,-16,0,192,1,6
1706,3,2291,2430,-139,0,122,0,6
1707,1,2416,2463,-47,0,458,1,6
1708,2,2284,2431,-147,0,121,1,6
1709,2,2474,2501,-27,0,4,0,6
1710,3,2505,2437,68,0,115,0,6
1711,2,2474,2480,-6,0,244,0,6
1712,1,2595,2490,105,0,210,1,6
1713,1,2427,2423,4,0,301,0,6
1714,1,2401,2544,-143,0,106,1,6
1715,1,2652,2655,-3,0,0,1,6
1716,2,2428,2418,10,0,255,0,6
1717,1,2541,2384,157,0,4,1,6
1718,2,2463,2369,94,0,13,1,6
1719,2,2444,2341,103,0,122,0,6
1720,1,2491,2449,42,0,202,0,6
1721,1,2416,2354,62,0,6,0,6
1722,2,2337,2456,-119,0,101,0,6
1723,1,2396,2423,-27,0,205,0,6
1724,2,2435,2553,-118,0,330,0,6
1725,3,2763,2828,-65,0,395,0,6
1726,2,2325,2438,-113,0,16,0,6
1727,2,2460,2334,126,0,242,0,6
1728,2,2473,2322,151,0,487,0,6
1729,2,2448,2375,73,0,303,0,6
1730,2,2486,2468,18,0,80,1,6
1731,2,2394,2496,-102,0,0,1,6
1732,1,2428,2293,135,0,487,0,6
1733,1,2457,2423,34,0,15,0,6
1734,1,2480,2468,12,0,4,0,6
1735,1,2438,2505,-67,0,4,0,6
1736,1,2503,2388,115,0,460,1,6
1737,1,2485,2396,89,0,310,0,6
1738,2,2350,2538,-188,0,415,0,6
1739,2,2418,2515,-97,0,253,0,6
1740,1,2469,2377,92,0,224,0,6
1741,2,2417,2258,159,0,40,0,6
1742,1,2413,2255,158,0,133,0,6
1743,1,2650,2748,-98,0,323,1,6
1744,1,2487,2370,117,0,40,0,6
1745,2,2331,2421,-90,0,100,0,6
1746,1,2442,2381,61,0,30,0,6
1747,1,2422,2409,13,0,194,0,6
1748,1,2341,2452,-111,0,200,0,6
1749,1,2349,2437,-88,0,22,0,6
1750,1,2827,2764,63,0,130,0,6
1751,2,2424,2417,7,0,121,0,6
1752,1,2425,2350,75,0,6,0,6
1753,2,2557,2563,-6,0,70,0,6
1754,2,2486,2499,-13,0,4,1,6
1755,1,2465,2333,132,0,426,0,6
1756,2,2344,2444,-100,0,113,0,6
1757,1,2414,2223,191,0,112,1,6
1758,1,2519,2234,285,0,36,0,6
1759,1,2400,2297,103,4,4,0,13
1760,1,2464,2437,27,0,484,0,6
1761,1,2438,2504,-66,0,151,1,6
1762,3,2490,2469,21,0,50,0,6
1763,1,2413,2447,-34,0,123,1,6
1764,1,2445,2349,96,0,240,0,6
1765,1,2491,2356,135,0,360,1,6
1766,1,2456,2433,23,0,20,1,6
1767,1,2331,2507,-176,0,456,0,6
1768,1,2382,2441,-59,0,7,0,6
1769,1,2431,2376,55,0,311,1,6
1770,2,2345,2409,-64,0,211,0,6
1771,2,2289,2474,-185,0,130,0,6
1772,1,2640,2499,141,0,145,1,6
1773,1,2376,2430,-54,0,110,1,6
1774,1,2421,2428,-7,0,7,0,6
1775,2,2408,2430,-22,0,205,0,6
1776,2,2657,2741,-84,0,40,0,6
1777,1,2411,2292,119,0,107,0,6
1778,3,2387,2400,-13,0,45,0,6
1779,1,2450,2423,27,0,258,0,6
1780,2,2358,2469,-111,0,487,0,6
1781,1,2423,2552,-129,0,13,0,6
1782,2,2449,2374,75,0,100,0,6
1783,2,2435,2490,-55,0,200,0,6
1784,1,2470,2361,109,0,106,0,6
1785,2,2440,2381,59,0,5,1,6
1786,2,2345,2449,-104,0,300,0,6
1787,2,2349,2430,-81,0,49,0,6
1788,1,2477,2232,245,0,141,1,6
1789,1,2442,2565,-123,0,122,0,6
1790,1,2412,2418,-6,0,13,0,6
1791,1,2505,2480,25,0,267,0,6
1792,2,2473,2474,-1,0,40,0,6
1793,2,2245,2417,-172,0,300,1,6
1794,1,2329,2521,-192,0,245,1,6
1795,2,2356,2516,-160,0,130,0,6
1796,1,2544,2353,191,0,405,0,6
1797,1,2422,2413,9,0,212,1,6
1798,1,2540,2403,137,0,252,0,6
1799,1,2427,2340,87,0,8,0,6
1800,1,2369,2423,-54,0,133,0,6
1801,2,2431,2503,-72,0,4,1,6
1802,1,2560,2297,263,4,231,1,13
1803,1,2497,2445,52,0,115,0,6
1804,1,2644,2653,-9,0,180,0,6
1805,1,2403,2436,-33,0,113,1,6
1806,2,2335,2518,-183,0,120,0,6
1807,2,2400,2348,52,0,45,0,6
1808,2,2453,2341,112,0,0,0,6
1809,3,2449,2308,141,0,122,0,6
1810,1,2745,2759,-14,0,122,0,6
1811,1,2431,2474,-43,0,123,0,6
1812,2,2463,2417,46,0,347,1,6
1813,2,2434,2347,87,0,401,1,6
1814,2,2402,2227,175,0,330,0,8
1815,2,2387,2547,-160,0,305,1,6
1816,2,2480,2412,68,0,246,0,6
1817,2,2356,2467,-111,0,250,0,8
1818,2,2467,2343,124,0,310,0,6
1819,2,2417,2375,42,0,335,1,6
1820,1,2475,2510,-35,0,4,1,6
1821,1,2404,2410,-6,0,7,0,6
1822,1,2386,2479,-93,0,131,0,6
1823,2,2520,2341,179,0,312,0,6
1825,3,2434,2344,90,0,213,0,6
1826,1,2339,2408,-69,0,211,0,6
1827,1,2543,2421,122,0,191,0,6
1828,1,2428,2283,145,0,107,0,6
1829,3,2400,2538,-138,0,104,0,6
1830,1,2432,2280,152,0,4,1,6
1831,1,2336,2416,-80,0,253,0,6
1832,1,2647,2626,21,0,398,1,6
1833,2,2329,2522,-193,0,315,0,6
1834,2,2366,2544,-178,0,242,0,6
1835,1,2348,2446,-98,0,200,0,6
1836,2,2499,2480,19,0,310,1,6
1837,1,2467,2447,20,0,115,0,6
1838,2,2551,2459,92,0,138,1,6
1839,1,2401,2384,17,0,343,0,6
1840,2,2753,2751,2,0,337,0,6
1841,1,2298,2479,-181,0,130,0,6
1842,1,2419,2473,-54,0,100,1,6
1843,2,2551,2405,146,0,41,0,6
1844,1,2524,2359,165,0,4,0,6
1845,2,2402,2427,-25,0,104,0,6
1846,1,2531,2317,214,0,129,1,6
1847,2,2352,2535,-183,0,40,0,6
1848,1,2378,2402,-24,0,250,0,6
1849,2,2439,2356,83,0,221,0,6
1850,2,2382,2410,-28,0,4,1,6
1851,1,2481,2495,-14,0,14,0,6
1852,2,2457,2507,-50,0,4,0,6
1853,2,2393,2422,-29,0,101,0,6
1854,1,2471,2307,164,0,109,0,8
1855,1,2279,2432,-153,0,142,0,6
1856,2,2325,2472,-147,0,148,0,6
1857,2,2277,2410,-133,0,31,1,8
1858,2,2504,2435,69,0,198,1,6
1859,1,2528,2355,173,0,337,0,6
1860,2,2535,2424,111,0,267,1,6
1861,2,2397,2432,-35,0,5,0,6
1862,2,2405,2486,-81,0,315,0,6
1863,1,2559,2277,282,0,250,0,5
1864,1,2461,2396,65,0,353,0,6
1865,3,2396,2467,-71,0,300,0,6
1866,2,2663,2652,11,0,453,0,6
1867,2,2467,2456,11,0,346,0,6
1868,1,2514,2323,191,0,25,0,6
1869,2,2543,2481,62,0,313,0,6
1870,1,2424,2287,137,0,107,0,6
1871,2,2432,2531,-99,0,150,0,6
1872,1,2475,2315,160,0,112,0,6
1873,1,2426,2401,25,0,121,1,6
1874,2,2284,2427,-143,0,142,0,6
1875,1,2490,2416,74,0,0,0,6
1876,1,2242,2533,-291,0,277,0,6
1877,2,2407,2536,-129,0,341,0,6
1878,2,2237,2412,-175,0,202,0,6
1879,2,2494,2442,52,0,463,0,6
1880,1,2402,2346,56,0,336,1,6
1881,2,2409,2383,26,0,102,1,6
1882,1,2431,2526,-95,0,469,0,6
1883,2,2488,2497,-9,0,4,1,6
1884,1,2431,2280,151,0,45,0,6
1885,1,2517,2382,135,0,15,0,6
1886,2,2437,2374,63,0,39,1,6
1887,2,2290,2435,-145,0,116,1,6
1888,2,2352,2433,-81,0,41,0,6
1889,2,2363,2428,-65,0,211,1,6
1890,1,2535,2498,37,0,4,0,6
1891,2,2411,2495,-84,0,311,1,6
1892,2,2245,2417,-172,0,300,0,6
1893,2,2441,2402,39,0,10,0,6
1894,2,2302,2461,-159,0,45,0,6
1895,1,2547,2462,85,0,150,0,6
1896,2,2236,2401,-165,0,45,1,6
1897,1,2518,2439,79,0,267,0,6
1898,1,2392,2466,-74,0,141,1,6
1899,1,2475,2404,71,0,250,0,8
1900,2,2495,2436,59,0,84,0,6
1901,1,2458,2464,-6,0,42,0,6
1902,1,2488,2381,107,0,345,0,6
1903,2,2403,2540,-137,0,13,1,6
1904,1,2403,2347,56,0,338,0,6
1905,1,2373,2401,-28,0,330,0,6
1906,1,2470,2470,0,0,9,1,6
1907,2,2509,2540,-31,0,302,0,6
1908,2,2429,2479,-50,0,4,1,6
1909,1,2431,2485,-54,0,202,0,6
1910,1,2420,2242,178,0,70,0,6
1911,2,2342,2408,-66,0,211,0,6
1912,2,2381,2515,-134,0,385,0,6
1913,2,2396,2431,-35,0,67,0,6
1914,2,2503,2482,21,0,251,1,6
1915,2,2341,2407,-66,0,312,0,6
1916,1,2432,2359,73,0,136,0,6
1917,3,2458,2293,165,0,41,0,6
1918,2,2473,2565,-92,0,480,1,6
1919,3,2459,2399,60,0,337,0,6
1920,2,2368,2426,-58,0,293,0,6
1921,1,2464,2492,-28,0,216,1,6
1922,2,2407,2445,-38,0,130,1,6
1923,1,2409,2378,31,0,49,0,6
1924,1,2434,2523,-89,0,43,0,6
1925,1,2444,2439,5,0,200,1,6
1926,2,2519,2363,156,0,131,0,6
1927,1,2467,2385,82,0,398,0,6
1928,2,2404,2206,198,0,300,1,6
1929,2,2239,2424,-185,0,315,0,6
1930,2,2658,2628,30,0,40,0,6
1931,2,2258,2525,-267,0,0,1,6
1932,2,2399,2479,-80,0,331,0,8
1933,1,2543,2315,228,0,106,0,6
1934,1,2431,2400,31,0,107,0,6
1935,3,2401,2438,-37,0,277,0,6
1936,2,2444,2323,121,0,126,0,6
1937,1,2526,2552,-26,0,1,0,6
1938,1,2456,2470,-14,0,490,0,6
1939,1,2432,2351,81,0,302,0,6
1940,1,2515,2435,80,0,105,0,6
1941,2,2436,2308,128,0,9,1,6
1942,1,2489,2471,18,0,7,0,6
1943,1,2522,2376,146,0,453,0,6
1944,2,2497,2569,-72,0,109,0,6
1945,1,2459,2320,139,0,40,0,6
1946,2,2357,2419,-62,0,50,0,6
1947,1,2374,2414,-40,0,1,1,6
1948,1,2550,2292,258,0,216,1,5
1949,1,2400,2458,-58,0,141,1,6
1950,3,2540,2518,22,0,211,0,6
1951,2,2402,2437,-35,0,0,1,6
1952,1,2468,2470,-2,0,23,0,6
1953,1,2347,2403,-56,0,153,1,6
1954,1,2444,2458,-14,0,133,0,6
1955,2,2408,2383,25,0,122,0,6
1956,1,2335,2511,-176,0,200,0,6
1957,1,2421,2546,-125,0,228,0,6
1958,1,2399,2473,-74,0,101,0,6
1959,2,2275,2527,-252,0,245,0,6
1960,2,2464,2520,-56,0,140,0,6
1961,1,2413,2271,142,0,9,0,8
1962,2,2426,2525,-99,0,250,1,6
1963,2,2411,2437,-26,0,400,0,6
1964,1,2435,2378,57,0,101,0,6
1965,2,2277,2401,-124,0,268,1,6
1966,2,2623,2652,-29,0,36,0,6
1967,2,2505,2361,144,0,28,0,6
1968,2,2299,2462,-163,0,126,1,6
1969,2,2428,2441,-13,0,4,0,6
1970,3,2251,2518,-267,0,124,0,8
1971,2,2399,2479,-80,0,131,0,6
1972,2,2403,2337,66,0,440,0,6
1973,1,2546,2494,52,0,251,0,6
1974,2,2274,2468,-194,4,0,0,23
1975,2,2466,2402,64,0,303,0,6
1976,3,2465,2482,-17,0,216,0,6
1977,1,2389,2408,-19,0,20,0,6
1978,2,2574,2381,193,0,0,0,6
1979,1,2384,2400,-16,0,107,0,6
1980,2,2373,2497,-124,0,180,0,6
1981,2,2451,2406,45,0,337,1,6
1982,1,2747,2658,89,0,110,0,6
1983,2,2452,2450,2,0,352,1,6
1984,2,2503,2352,151,0,106,0,6
1985,2,2538,2493,45,0,415,0,6
1986,2,2440,2423,17,0,123,0,6
1987,2,2553,2533,20,0,21,1,6
1988,2,2330,2484,-154,0,5,0,8
1989,2,2290,2552,-262,0,405,0,5
1990,1,2525,2459,66,0,108,0,6
1991,1,2587,2422,165,0,40,1,6
1992,1,2501,2369,132,0,20,0,6
1993,2,2465,2532,-67,0,245,0,6
1994,2,2499,2456,43,0,106,0,6
1995,1,2429,2333,96,0,205,0,6
1996,2,2467,2450,17,0,100,1,6
1997,1,2484,2324,160,0,491,1,6
1998,2,2459,2452,7,0,100,0,6
1999,1,2654,2657,-3,0,380,0,6
2000,2,2752,2618,134,0,190,0,6
2001,1,2394,2435,-41,0,17,1,6
2002,2,2406,2380,26,0,44,0,6
2003,2,2495,2408,87,0,253,0,6
2004,1,2529,2314,215,0,16,0,6
2005,2,2255,2422,-167,0,311,1,6
2006,1,2506,2539,-33,0,46,1,6
2007,1,2604,2395,209,0,290,1,6
2008,1,2314,2404,-90,0,100,0,6
2009,3,2481,2489,-8,0,311,0,6
2010,2,2442,2465,-23,0,121,1,6
2011,1,2402,2290,112,0,41,0,6
2012,3,2413,2445,-32,0,100,0,6
2013,1,2366,2402,-36,0,115,0,6
2014,1,2458,2565,-107,0,484,1,6
2015,1,2350,2453,-103,0,43,0,6
2016,1,2456,2446,10,0,43,0,6
2018,1,2429,2493,-64,0,4,0,6
2019,2,2356,2472,-116,0,255,0,6
2020,2,2373,2493,-120,0,40,0,6
2021,2,2276,2534,-258,0,245,0,6
2022,1,2389,2515,-126,0,38,0,6
2023,2,2346,2466,-120,0,101,0,6
2024,2,2402,2493,-91,0,409,0,6
2025,2,2401,2379,22,0,302,1,6
2026,1,2530,2591,-61,0,201,0,6
2027,1,2431,2400,31,0,45,0,6
2028,1,2567,2233,334,4,235,0,13
2029,1,2406,2330,76,0,49,0,6
2030,3,2501,2469,32,0,300,0,6
2031,1,2547,2462,85,0,10,0,6
2032,2,2252,2430,-178,0,9,0,6
2033,2,2298,2461,-163,0,147,1,6
2034,2,2626,2744,-118,0,29,1,6
2035,2,2321,2536,-215,0,257,0,6
2036,1,2500,2481,19,0,301,0,6
2037,1,2489,2483,6,0,7,0,6
2038,2,2353,2429,-76,0,190,1,6
2039,2,2360,2487,-127,0,4,0,6
2040,2,2537,2401,136,0,415,0,6
2041,1,2472,2403,69,0,202,0,8
2042,1,2440,2396,44,0,330,0,6
2043,1,2466,2343,123,0,206,0,6
2044,1,2375,2425,-50,0,130,1,6
2045,1,2438,2372,66,0,110,0,6
2046,1,2465,2489,-24,0,264,0,6
2047,1,2201,2401,-200,0,45,0,5
2048,2,2360,2450,-90,0,123,1,6
2049,3,2471,2397,74,0,57,0,6
2050,2,2366,2532,-166,0,49,0,6
2051,2,2477,2584,-107,0,211,0,6
2052,2,2391,2445,-54,0,131,0,6
2053,1,2407,2494,-87,0,226,0,8
2054,1,2652,2731,-79,0,400,0,6
2055,1,2497,2495,2,0,250,1,6
2056,2,2518,2533,-15,0,4,0,6
2057,1,2437,2436,1,0,122,1,6
2058,1,2375,2406,-31,0,4,1,6
2059,1,2444,2414,30,0,255,0,6
2060,2,2437,2374,63,0,303,0,6
2061,1,2491,2465,26,0,100,0,6
2064,2,2487,2454,33,0,491,0,6
2065,2,2284,2435,-151,0,246,0,6
2066,1,2458,2497,-39,0,153,1,6
2067,1,2535,2390,145,0,4,0,6
2068,2,2450,2274,176,0,380,0,6
2069,2,2386,2473,-87,0,12,0,6
2070,1,2588,2529,59,0,302,0,6
2071,1,2416,2284,132,0,103,1,6
2072,2,2364,2430,-66,0,373,0,6
2073,1,2539,2248,291,0,106,1,6
2074,1,2450,2408,42,0,200,0,6
2075,1,2442,2380,62,0,389,0,6
2076,3,2408,2409,-1,0,148,0,6
2077,3,2524,2571,-47,0,313,0,6
2078,1,2476,2358,118,0,106,1,6
2079,1,2441,2352,89,0,373,0,6
2080,2,2482,2471,11,0,111,0,6
2081,1,2593,2513,80,0,48,1,6
2082,1,2338,2463,-125,0,300,1,6
2083,1,2488,2497,-9,0,140,1,6
2084,2,2476,2397,79,0,122,0,6
2085,1,2469,2362,107,0,315,0,6
2086,1,2538,2551,-13,0,130,0,6
2087,1,2477,2476,1,0,140,0,6
2088,1,2385,2433,-48,0,330,0,6
2089,2,2496,2376,120,0,35,1,6
2090,2,2397,2491,-94,0,301,0,6
2091,2,2398,2404,-6,0,1,0,6
2092,2,2505,2507,-2,0,301,0,6
2093,1,2464,2392,72,0,263,0,6
2094,2,2390,2500,-110,0,255,0,6
2095,3,2596,2494,102,0,5,0,6
2096,3,2339,2419,-80,0,331,0,6
2097,2,2478,2569,-91,0,311,0,6
2098,2,2435,2360,75,0,40,1,6
2099,2,2525,2443,82,0,355,0,6
2100,1,2415,2211,204,0,133,0,8
2101,2,2473,2460,13,0,453,1,6
2102,2,2489,2460,29,0,4,0,6
2103,2,2423,2445,-22,0,375,1,6
2104,3,2483,2411,72,0,4,0,6
2105,1,2609,2748,-139,0,218,1,6
2106,2,2348,2502,-154,0,187,0,6
2107,1,2537,2555,-18,0,106,0,6
2108,1,2421,2391,30,0,156,0,6
2109,1,2487,2427,60,0,18,0,6
2110,1,2495,2331,164,0,131,0,6
2111,2,2408,2587,-179,0,200,0,6
2112,2,2343,2442,-99,0,132,0,6
2113,1,2502,2393,109,0,200,0,6
2114,2,2504,2439,65,0,11,1,6
2115,1,2376,2447,-71,0,112,0,6
2116,2,2483,2491,-8,0,7,1,6
2117,2,2466,2463,3,0,4,0,6
2118,1,2501,2392,109,0,380,0,6
2119,1,2403,2421,-18,0,101,1,6
2120,1,2427,2380,47,0,110,0,6
2121,2,2491,2455,36,0,142,1,6
2122,1,2428,2420,8,0,301,0,6
2123,2,2545,2544,1,0,18,0,6
2124,2,2388,2434,-46,0,13,0,6
2125,2,2541,2539,2,0,246,0,6
2126,1,2269,2471,-202,4,480,0,23
2127,1,2556,2349,207,0,106,0,5
2128,2,2448,2536,-88,0,162,0,6
2129,2,2401,2398,3,0,45,1,6
2130,1,2419,2408,11,0,290,0,6
2131,2,2464,2475,-11,0,40,0,6
2132,2,2438,2498,-60,0,45,0,6
2133,2,2505,2336,169,0,104,0,6
2135,1,2495,2229,266,0,141,0,6
2136,1,2357,2415,-58,0,190,0,6
2137,2,2384,2508,-124,0,301,0,6
2138,2,2409,2597,-188,0,13,1,6
2139,2,2387,2469,-82,0,406,0,6
2140,2,2422,2492,-70,0,4,0,6
2141,1,2339,2432,-93,0,107,1,6
2142,1,2498,2320,178,0,332,0,6
2143,2,2389,2469,-80,0,45,0,6
2144,1,2428,2428,0,0,45,0,6
2145,1,2539,2543,-4,0,300,1,6
2146,1,2513,2370,143,0,101,0,6
2147,2,2275,2454,-179,0,100,0,6
2148,2,2389,2482,-93,0,46,0,6
2149,1,2426,2401,25,0,45,0,6
2150,2,2740,2625,115,0,101,0,6
2151,2,2357,2412,-55,0,109,0,6
2152,1,2507,2340,167,0,106,1,6
2153,1,2342,2518,-176,0,101,0,6
2154,2,2428,2299,129,0,106,0,6
2155,2,2439,2394,45,0,311,0,6
2156,2,2415,2318,97,0,106,0,6
2157,1,2403,2434,-31,0,101,0,6
2158,1,2497,2477,20,0,265,1,6
2159,1,2411,2287,124,0,382,0,6
2160,2,2461,2403,58,0,354,1,6
2161,1,2450,2484,-34,0,121,1,6
2162,1,2446,2349,97,0,248,0,6
2163,2,2383,2503,-120,0,211,0,6
2164,1,2334,2473,-139,0,201,0,6
2165,1,2320,2544,-224,0,0,0,6
2166,1,2388,2400,-12,0,130,0,6
2167,2,2374,2463,-89,0,331,0,6
2168,1,2497,2460,37,0,10,0,6
2169,1,2535,2410,125,0,100,0,6
2170,1,2354,2415,-61,0,8,0,6
2171,3,2417,2297,120,0,40,0,6
2172,1,2353,2425,-72,0,13,0,6
2173,1,2409,2341,68,0,352,0,6
2174,2,2474,2378,96,0,41,0,6
2175,1,2459,2352,107,0,201,0,6
2176,1,2406,2201,205,0,151,0,6
2177,2,2497,2539,-42,0,16,0,6
2178,1,2461,2408,53,0,190,0,6
2179,1,2470,2403,67,0,244,0,6
2180,1,2675,2589,86,0,107,0,6
2181,2,2422,2360,62,0,45,0,6
2182,1,2470,2434,36,0,45,1,6
2183,2,2408,2501,-93,0,190,0,6
2184,2,2622,2659,-37,0,369,1,6
2185,2,2486,2385,101,0,200,0,6
2186,2,2474,2335,139,0,106,0,6
2187,3,2425,2347,78,0,288,0,6
2188,2,2466,2516,-50,0,490,0,6
2189,2,2432,2352,80,0,4,0,6
2190,2,2394,2439,-45,0,153,1,6
2191,1,2367,2463,-96,0,106,0,6
2192,1,2567,2431,136,0,310,0,6
2193,1,2640,2733,-93,0,112,0,6
2194,2,2409,2267,142,0,200,0,6
2195,1,2443,2364,79,0,176,0,6
2196,1,2386,2470,-84,0,129,0,6
2197,1,2392,2479,-87,0,25,1,6
2198,2,2436,2399,37,0,112,0,6
2199,1,2537,2446,91,0,10,0,6
2200,2,2344,2497,-153,0,121,0,6
2201,3,2461,2304,157,0,45,0,6
2202,1,2329,2492,-163,0,123,0,6
2203,3,2536,2544,-8,0,455,0,6
2204,1,2602,2415,187,0,4,0,6
2205,1,2410,2454,-44,0,100,1,6
2206,2,2403,2391,12,0,122,0,6
2207,2,2466,2456,10,0,40,0,6
2208,2,2408,2204,204,0,210,1,6
2209,2,2418,2374,44,0,122,0,6
2210,1,2297,2558,-261,0,405,0,5
2212,2,2507,2381,126,0,103,0,6
2213,1,2321,2413,-92,0,120,1,6
2214,1,2450,2394,56,0,150,0,6
2215,1,2544,2252,292,0,218,1,6
2216,1,2455,2502,-47,0,4,0,6
2217,1,2478,2456,22,0,298,1,6
2218,1,2572,2575,-3,0,136,1,6
2219,2,2523,2462,61,0,448,0,6
2220,2,2584,2679,-95,0,135,0,6
2221,1,2726,2653,73,0,409,0,6
2222,1,2402,2451,-49,0,254,0,6
2223,2,2428,2403,25,0,256,0,6
2224,1,2399,2536,-137,0,5,0,6
2225,2,2372,2466,-94,0,217,0,6
2226,1,2414,2322,92,0,21,0,6
2227,1,2468,2369,99,0,201,0,6
2228,2,2348,2424,-76,0,277,1,6
2229,1,2439,2353,86,0,40,1,6
2230,2,2542,2550,-8,0,405,1,6
2231,1,2289,2400,-111,0,107,0,5
2232,2,2462,2617,-155,0,153,0,6
2233,1,2449,2398,51,0,38,0,8
2234,2,2381,2412,-31,0,412,0,6
2235,1,2495,2462,33,0,106,0,6
2236,2,2524,2747,-223,0,385,0,6
2237,2,2476,2447,29,0,45,1,6
2238,2,2413,2377,36,0,300,0,6
2239,1,2472,2399,73,0,200,0,6
2240,2,2449,2359,90,0,457,1,6
2241,1,2645,2730,-85,0,131,1,6
2242,3,2511,2329,182,0,335,0,6
2243,2,2448,2416,32,0,255,0,6
2244,3,2466,2408,58,0,265,0,6
2245,1,2425,2257,168,0,138,0,6
2246,2,2467,2470,-3,0,490,1,6
2247,2,2397,2499,-102,0,380,0,6
2248,2,2418,2398,20,0,484,0,6
2249,1,2406,2316,90,0,43,1,6
2250,1,2683,2580,103,0,301,1,6
2251,1,2433,2281,152,0,125,0,6
2252,3,2304,2436,-132,0,45,0,6
2253,1,2450,2367,83,0,4,0,6
2254,1,2567,2579,-12,0,46,0,6
2255,2,2323,2495,-172,0,3,0,6
2256,2,2576,2410,166,0,470,1,6
2257,2,2379,2421,-42,0,112,0,6
2258,2,2451,2484,-33,0,121,0,6
2259,2,2505,2397,108,0,380,0,6
2260,2,2408,2472,-64,0,302,1,6
2261,2,2664,2621,43,0,404,0,6
2262,1,2343,2458,-115,0,4,0,6
2263,1,2417,2375,42,0,113,0,6
2264,1,2407,2521,-114,0,40,1,6
2265,1,2343,2458,-115,0,260,0,6
2266,1,2428,2263,165,0,202,0,6
2267,2,2466,2284,182,2,101,0,25
2268,1,2310,2455,-145,0,40,1,6
2269,1,2457,2501,-44,0,43,0,6
2270,2,2487,2313,174,0,88,1,8
2271,2,2404,2412,-8,0,122,1,6
2272,2,2506,2572,-66,0,277,0,6
2273,2,2390,2440,-50,0,5,0,7
2274,1,2349,2430,-81,0,67,0,6
2275,2,2422,2442,-20,0,40,1,6
2276,1,2517,2242,275,0,80,0,6
2277,1,2459,2298,161,4,125,0,13
2278,1,2540,2504,36,0,15,0,6
2279,2,2405,2449,-44,0,121,0,6
2280,1,2415,2469,-54,0,104,1,6
2281,3,2393,2453,-60,0,335,0,6
2282,2,2539,2476,63,0,120,0,6
2283,2,2333,2451,-118,0,40,0,6
2284,2,2494,2463,31,0,43,1,6
2285,2,2508,2616,-108,0,40,1,6
2286,2,2723,2658,65,0,20,0,6
2287,2,2434,2436,-2,0,245,1,6
2288,1,2370,2442,-72,0,101,0,6
2290,1,2455,2344,111,0,127,0,6
2291,1,2290,2411,-121,0,45,0,6
2292,1,2367,2432,-65,0,218,0,6
2293,2,2498,2312,186,0,151,0,6
2294,2,2625,2712,-87,0,199,1,6
2295,2,2465,2319,146,0,336,1,6
2296,2,2235,2463,-228,4,466,1,23
2297,3,2265,2403,-138,0,14,0,8
2298,1,2409,2422,-13,0,255,0,6
2299,3,2364,2461,-97,0,120,0,6
2300,2,2407,2369,38,0,319,0,6
2301,1,2418,2497,-79,0,113,0,6
2302,1,2424,2278,146,0,284,1,6
2303,2,2489,2446,43,0,298,0,6
2304,1,2401,2300,101,0,10,0,6
2305,3,2383,2429,-46,0,330,0,6
2306,2,2427,2418,9,0,120,0,6
2307,1,2627,2453,174,0,344,0,6
2308,2,2409,2465,-56,0,258,0,6
2309,1,2455,2394,61,0,131,1,6
2310,1,2447,2318,129,0,45,0,6
2311,2,2577,2494,83,0,101,0,6
2312,1,2478,2364,114,0,107,1,6
2313,2,2447,2417,30,0,0,0,6
2314,1,2445,2385,60,0,106,0,7
2315,2,2400,2387,13,0,310,0,6
2316,1,2452,2483,-31,0,121,0,6
2317,2,2279,2440,-161,0,101,0,6
2318,2,2393,2408,-15,0,302,0,8
2319,1,2514,2563,-49,0,200,0,6
2320,1,2483,2346,137,0,7,0,6
2321,3,2442,2357,85,0,202,0,6
2322,1,2429,2251,178,0,203,0,6
2323,1,2442,2490,-48,0,386,1,6
2324,1,2470,2488,-18,0,4,0,6
2325,2,2463,2576,-113,4,302,1,13
2326,2,2403,2334,69,0,43,0,6
2327,2,2451,2321,130,0,300,1,6
2328,1,2476,2385,91,0,20,0,6
2329,1,2620,2658,-38,0,120,0,6
2330,2,2476,2435,41,0,43,1,6
2331,1,2504,2488,16,0,463,0,6
2332,2,2233,2401,-168,4,112,0,13
2333,3,2411,2512,-101,0,103,0,6
2334,3,2470,2460,10,0,6,0,6
2335,2,2563,2600,-37,0,13,0,6
2336,1,2717,2621,96,0,20,0,6
2337,1,2557,2400,157,0,40,0,6
2338,2,2421,2418,3,0,300,0,6
2339,1,2460,2492,-32,0,50,0,6
2340,1,2482,2476,6,0,10,0,6
2341,1,2373,2465,-92,0,10,0,6
2342,1,2405,2364,41,0,15,0,6
2343,2,2449,2521,-72,0,143,0,6
2344,2,2418,2347,71,0,5,0,6
2345,2,2341,2510,-169,0,4,1,6
2346,1,2350,2416,-66,0,297,0,6
2347,1,2423,2441,-18,0,40,1,6
2348,2,2380,2559,-179,0,101,0,6
2349,2,2419,2432,-13,0,301,0,6
2350,2,2491,2550,-59,0,380,0,6
2351,2,2470,2404,66,0,265,0,6
2352,1,2616,2722,-106,0,0,0,6
2353,2,2396,2560,-164,0,40,0,6
2354,1,2581,2216,365,0,8,0,6
2355,3,2450,2397,53,0,101,0,6
2356,2,2378,2428,-50,0,202,0,6
2357,3,2376,2457,-81,0,300,0,6
2358,1,2333,2439,-106,0,112,0,6
2359,2,2347,2440,-93,0,310,0,6
2360,3,2476,2459,17,0,298,0,6
2361,2,2382,2415,-33,0,38,0,6
2362,2,2483,2510,-27,0,106,0,6
2363,1,2401,2367,34,4,434,0,13
2364,2,2470,2453,17,0,204,0,6
2365,2,2470,2488,-18,0,4,0,6
2366,1,2381,2481,-100,0,16,0,6
2367,2,2460,2415,45,0,487,0,6
2368,1,2562,2443,119,0,10,0,6
2369,2,2442,2483,-41,0,373,0,6
2370,1,2427,2413,14,0,107,0,6
2371,2,2374,2401,-27,0,225,0,6
2372,1,2445,2401,44,0,109,1,6
2373,2,2384,2411,-27,0,0,1,6
2374,1,2525,2513,12,0,102,0,6
2375,1,2410,2291,119,0,103,1,6
2376,2,2393,2434,-41,0,250,0,6
2377,3,2485,2348,137,0,141,0,6
2378,1,2437,2414,23,0,14,1,6
2379,1,2411,2463,-52,0,258,0,6
2380,2,2364,2428,-64,0,304,1,6
2381,2,2411,2381,30,0,4,1,6
2382,2,2626,2577,49,0,244,0,6
2383,1,2384,2459,-75,0,320,1,6
2384,1,2413,2252,161,0,337,0,8
2385,2,2435,2429,6,0,0,1,6
2386,1,2385,2486,-101,0,111,1,6
2387,1,2445,2443,2,0,151,1,6
2388,2,2556,2535,21,0,245,0,6
2389,1,2432,2297,135,0,42,0,6
2390,2,2366,2436,-70,0,110,0,6
2391,1,2557,2501,56,0,140,0,6
2392,1,2368,2405,-37,0,140,0,6
2393,2,2493,2465,28,0,10,1,6
2394,1,2489,2437,52,0,101,0,6
2395,3,2433,2274,159,0,112,0,6
2396,1,2373,2456,-83,0,147,0,6
2397,2,2473,2515,-42,0,36,0,6
2398,2,2455,2285,170,0,59,1,6
2399,2,2287,2415,-128,0,4,0,6
2400,3,2439,2338,101,0,263,0,6
2401,1,2265,2417,-152,0,337,0,8
2402,1,2405,2311,94,4,241,1,13
2403,3,2453,2373,80,0,40,0,6
2404,1,2428,2505,-77,0,300,0,6
2405,2,2459,2476,-17,0,121,0,6
2406,1,2407,2433,-26,0,101,0,6
2407,2,2398,2432,-34,0,101,0,6
2408,1,2494,2331,163,0,210,0,6
2409,3,2362,2450,-88,0,301,0,6
2410,2,2584,2620,-36,0,240,1,6
2411,2,2456,2418,38,0,265,0,6
2412,2,2710,2651,59,0,193,0,6
2413,2,2387,2413,-26,0,302,0,6
2414,1,2435,2429,6,0,0,1,6
2415,1,2525,2350,175,0,206,0,6
2416,1,2440,2377,63,0,132,1,6
2417,1,2437,2319,118,0,190,0,6
2418,1,2450,2566,-116,0,101,1,6
2419,1,2345,2498,-153,0,153,1,6
2420,1,2396,2458,-62,0,190,0,6
2421,1,2392,2405,-13,0,306,0,6
2422,1,2370,2497,-127,0,100,0,6
2423,1,2422,2397,25,0,120,0,6
2424,2,2479,2388,91,0,112,1,6
2425,2,2423,2352,71,0,131,0,6
2426,2,2497,2375,122,0,103,0,6
2427,1,2372,2411,-39,0,41,0,6
2428,1,2437,2382,55,0,302,0,6
2429,1,2520,2468,52,0,107,0,6
2430,1,2343,2427,-84,0,44,1,6
2431,2,2471,2487,-16,0,9,0,6
2432,1,2447,2406,41,0,40,0,6
2433,2,2484,2413,71,0,128,0,6
2434,2,2400,2393,7,0,395,0,6
2435,3,2352,2424,-72,0,453,0,8
2436,2,2460,2507,-47,0,131,0,6
2437,3,2482,2454,28,0,285,0,6
2438,2,2372,2417,-45,0,56,1,8
2439,2,2369,2528,-159,0,49,1,6
2440,2,2449,2574,-125,0,103,0,6
2441,2,2384,2413,-29,0,49,0,6
2442,2,2428,2404,24,0,241,0,6
2443,1,2346,2441,-95,0,113,1,6
2444,2,2433,2391,42,0,245,1,6
2445,2,2625,2578,47,0,220,0,6
2446,2,2333,2445,-112,0,45,0,6
2447,2,2424,2450,-26,0,258,1,6
2448,1,2658,2703,-45,0,398,0,6
2449,1,2510,2347,163,0,40,0,6
2450,2,2401,2508,-107,0,130,1,6
2451,2,2396,2532,-136,0,226,1,6
2452,1,2424,2441,-17,0,2,0,6
2453,1,2446,2460,-14,0,405,0,6
2454,1,2493,2466,27,0,10,0,6
2455,2,2446,2424,22,0,167,0,6
2456,2,2477,2458,19,0,254,0,6
2457,3,2450,2388,62,0,110,0,6
2458,2,2409,2234,175,0,49,1,8
2459,1,2256,2405,-149,0,0,0,6
2460,2,2480,2415,65,4,236,0,13
2461,1,2466,2475,-9,0,255,0,6
2462,1,2366,2411,-45,0,45,0,6
2463,1,2439,2389,50,0,25,0,6
2464,2,2442,2382,60,0,457,1,6
2465,1,2489,2263,226,0,106,0,6
2466,1,2401,2360,41,0,4,0,6
2467,2,2464,2452,12,0,202,0,6
2468,2,2383,2418,-35,0,212,1,6
2469,1,2424,2383,41,0,107,1,6
2470,1,2525,2562,-37,0,432,0,6
2471,2,2427,2471,-44,0,300,0,6
2472,1,2762,2506,256,4,254,0,11
2473,1,2534,2506,28,0,101,0,6
2474,2,2492,2455,37,0,106,1,6
2475,1,2514,2430,84,0,378,0,6
2476,1,2419,2335,84,0,302,0,6
2477,2,2585,2619,-34,0,240,1,6
2478,2,2407,2246,161,0,398,1,6
2479,1,2416,2406,10,0,200,0,6
2480,1,2577,2472,105,0,303,0,6
2481,2,2251,2418,-167,0,304,0,6
2482,2,2454,2481,-27,0,121,0,6
2483,2,2374,2460,-86,0,163,0,6
2484,3,2430,2399,31,0,28,0,6
2485,2,2312,2434,-122,0,2,0,6
2486,1,2500,2447,53,0,386,1,6
2487,2,2344,2440,-96,0,102,0,6
2488,1,2435,2372,63,0,106,0,6
2489,1,2463,2454,9,0,45,0,6
2490,1,2311,2445,-134,0,250,1,6
2491,2,2460,2498,-38,0,4,0,6
2492,1,2535,2393,142,0,109,1,6
2493,1,2665,2621,44,0,462,0,6
2494,1,2414,2307,107,0,110,0,6
2495,1,2367,2423,-56,0,40,0,8
2496,1,2435,2430,5,0,100,1,6
2497,2,2456,2419,37,0,265,0,6
2498,1,2556,2532,24,0,270,1,6
2499,3,2431,2287,144,0,122,0,6
2500,3,2473,2405,68,0,106,0,6
2501,1,2444,2303,141,0,54,0,6
2502,2,2443,2422,21,0,60,1,6
2503,1,2397,2426,-29,0,70,0,6
2504,2,2386,2458,-72,0,45,1,6
2505,1,2563,2389,174,0,44,1,6
2506,3,2444,2388,56,0,491,0,6
2507,2,2276,2418,-142,0,0,0,6
2508,2,2364,2430,-66,0,100,0,6
2509,2,2432,2518,-86,0,102,0,6
2510,1,2558,2476,82,0,306,1,6
2511,2,2340,2435,-95,0,101,0,6
2512,3,2422,2365,57,0,484,0,6
2513,2,2305,2451,-146,0,120,0,6
2514,1,2432,2328,104,0,250,0,6
2515,1,2624,2580,44,0,268,1,6
2516,2,2400,2355,45,0,463,0,6
2517,2,2429,2359,70,0,354,0,6
2518,3,2378,2409,-31,0,0,0,6
2519,1,2423,2410,13,0,334,1,6
2520,2,2400,2461,-61,0,40,1,6
2521,2,2464,2386,78,0,315,0,6
2522,2,2332,2485,-153,0,373,0,6
2523,3,2392,2408,-16,0,122,0,6
2524,2,2329,2423,-94,0,133,0,6
2525,1,2417,2348,69,0,110,1,8
2526,3,2699,2697,2,0,113,0,6
2527,1,2512,2438,74,0,109,0,6
2528,1,2406,2397,9,0,4,0,6
2529,1,2389,2422,-33,0,188,0,6
2530,1,2438,2308,130,0,107,0,6
2531,2,2251,2401,-150,0,421,1,6
2532,2,2486,2449,37,0,288,1,6
2533,1,2442,2402,40,0,415,0,6
2534,1,2624,2545,79,0,45,1,6
2535,3,2503,2455,48,0,130,0,6
2536,2,2499,2469,30,0,5,0,6
2537,1,2402,2231,171,0,4,1,6
2538,1,2336,2400,-64,0,197,0,8
2539,2,2468,2559,-91,0,101,1,6
2540,2,2401,2393,8,0,133,0,6
2541,1,2376,2421,-45,0,199,1,6
2542,1,2452,2347,105,0,106,0,6
2543,1,2314,2409,-95,4,113,1,13
2544,2,2479,2310,169,0,335,1,8
2545,2,2448,2540,-92,0,455,1,6
2546,2,2492,2340,152,0,315,0,6
2547,1,2379,2562,-183,0,338,1,6
2548,1,2489,2319,170,0,151,0,6
2549,2,2472,2526,-54,0,106,0,6
2550,2,2414,2329,85,0,135,0,6
2551,1,2482,2463,19,0,22,0,6
2552,2,2441,2424,17,0,141,0,6
2553,2,2567,2428,139,0,325,0,6
2554,1,2421,2306,115,0,485,0,6
2555,2,2316,2482,-166,0,345,0,6
2556,1,2443,2335,108,0,438,0,6
2557,3,2440,2336,104,0,400,0,6
2558,2,2304,2492,-188,0,211,0,6
2559,1,2417,2374,43,0,45,1,8
2560,2,2348,2444,-96,0,50,1,6
2561,1,2408,2256,152,0,117,0,6
2562,2,2301,2579,-278,0,127,0,6
2563,2,2538,2547,-9,0,278,0,6
2564,3,2447,2629,-182,0,40,0,6
2565,3,2466,2395,71,0,201,0,6
2566,1,2427,2416,11,0,90,0,6
2567,1,2462,2393,69,0,484,0,6
2568,1,2697,2699,-2,0,50,0,6
2569,1,2468,2223,245,4,225,0,23
2570,2,2420,2403,17,0,245,0,6
2571,1,2390,2429,-39,0,14,1,6
2572,1,2520,2396,124,0,483,0,6
2573,1,2456,2502,-46,0,4,1,6
2574,1,2434,2492,-58,0,200,0,6
2575,2,2563,2486,77,0,343,1,6
2576,1,2526,2332,194,0,40,0,6
2577,1,2335,2495,-160,0,5,0,6
2578,1,2455,2480,-25,0,121,0,6
2579,1,2318,2429,-111,0,212,0,6
2580,2,2241,2405,-164,0,13,0,6
2581,1,2391,2473,-82,0,13,0,6
2582,2,2388,2467,-79,0,487,0,6
2583,2,2435,2490,-55,0,36,1,6
2584,3,2354,2425,-71,0,11,0,6
2585,1,2430,2463,-33,0,463,0,6
2586,1,2386,2456,-70,0,43,0,6
2587,2,2368,2623,-255,0,200,0,6
2588,2,2426,2523,-97,0,102,0,6
2589,1,2408,2301,107,0,45,0,6
2590,2,2241,2405,-164,4,330,0,13
2591,2,2404,2581,-177,0,103,1,6
2592,2,2252,2411,-159,0,305,0,6
2593,2,2405,2467,-62,0,45,0,6
2594,2,2427,2467,-40,0,9,0,6
2595,1,2355,2405,-50,0,0,0,6
2596,1,2494,2531,-37,0,36,1,6
2597,2,2225,2436,-211,0,100,0,6
2598,1,2436,2559,-123,0,211,0,6
2599,1,2474,2402,72,0,0,0,6
2600,2,2415,2383,32,0,250,0,6
2601,1,2344,2422,-78,0,373,1,8
2602,3,2365,2471,-106,0,45,0,6
2603,1,2393,2516,-123,0,4,1,6
2604,2,2529,2452,77,0,303,0,6
2605,1,2346,2447,-101,0,119,0,6
2606,2,2626,2450,176,0,220,0,6
2607,2,2486,2498,-12,0,102,0,6
2608,2,2391,2457,-66,0,46,1,6
2609,1,2408,2393,15,0,36,1,6
2610,1,2433,2344,89,0,302,0,6
2611,1,2552,2533,19,0,62,0,6
2612,2,2396,2465,-69,0,40,1,6
2613,2,2411,2538,-127,0,88,0,6
2614,1,2478,2389,89,0,453,0,6
2615,1,2408,2267,141,0,46,0,6
2616,2,2337,2438,-101,0,101,1,6
2617,1,2544,2473,71,0,211,1,6
2618,1,2510,2400,110,0,0,1,6
2619,2,2364,2529,-165,0,113,1,6
2620,2,2703,2701,2,0,320,0,6
2621,2,2355,2412,-57,0,16,0,6
2622,1,2469,2389,80,0,4,0,6
2623,1,2366,2412,-46,0,385,1,6
2624,3,2392,2422,-30,0,113,0,6
2625,2,2494,2524,-30,0,58,0,6
2626,1,2496,2392,104,0,122,0,6
2627,3,2480,2421,59,0,200,0,6
2628,2,2320,2421,-101,0,49,0,6
2630,2,2250,2437,-187,0,123,0,6
2631,2,2360,2625,-265,0,200,1,6
2632,2,2322,2505,-183,0,16,0,6
2633,2,2474,2422,52,0,12,0,6
2634,2,2421,2419,2,0,326,0,6
2635,2,2474,2487,-13,0,201,1,6
2636,3,2317,2407,-90,0,331,0,6
2637,1,2347,2437,-90,0,380,0,6
2638,2,2369,2417,-48,0,303,0,6
2639,1,2585,2527,58,0,46,0,6
2640,1,2423,2323,100,0,122,0,6
2641,3,2707,2697,10,0,301,0,6
2642,2,2429,2412,17,0,300,0,6
2643,2,2522,2461,61,0,355,0,6
2644,3,2377,2421,-44,0,50,0,6
2645,3,2469,2392,77,0,201,0,6
2646,1,2570,2401,169,0,107,1,6
2647,2,2387,2420,-33,0,44,0,6
2648,1,2453,2373,80,0,222,1,6
2649,2,2245,2419,-174,0,473,0,6
2650,1,2442,2354,88,0,104,0,6
2651,1,2500,2396,104,0,214,0,6
2652,1,2570,2541,29,0,277,0,6
2653,2,2424,2396,28,0,131,1,6
2654,2,2346,2419,-73,0,404,0,6
2655,1,2442,2333,109,0,4,0,6
2656,2,2385,2462,-77,0,250,0,6
2657,2,2433,2391,42,0,310,1,6
2658,1,2403,2515,-112,0,100,1,6
2659,1,2488,2305,183,0,58,0,6
2660,3,2417,2430,-13,0,131,0,6
2661,1,2260,2476,-216,4,40,0,0
2662,1,2472,2426,46,0,113,0,6
2663,1,2472,2530,-58,0,6,0,6
2664,3,2417,2300,117,0,4,0,6
2665,2,2362,2415,-53,0,242,0,8
2666,1,2474,2508,-34,0,132,0,6
2667,3,2404,2483,-79,0,106,0,6
2668,1,2419,2250,169,0,102,1,6
2669,1,2422,2479,-57,0,241,0,6
2670,2,2500,2456,44,0,107,0,6
2671,2,2297,2438,-141,0,43,1,6
2672,2,2357,2414,-57,0,15,0,6
2673,1,2392,2504,-112,0,190,0,6
2674,2,2387,2467,-80,0,487,0,6
2675,1,2421,2378,43,0,13,0,6
2676,2,2353,2627,-274,0,200,0,6
2677,1,2400,2413,-13,0,119,0,6
2678,1,2405,2318,87,0,16,0,6
2679,1,2469,2429,40,0,140,1,6
2680,1,2508,2523,-15,0,394,0,6
2681,1,2244,2422,-178,0,390,1,6
2682,2,2379,2423,-44,0,459,0,6
2683,1,2453,2402,51,0,104,1,6
2684,3,2381,2427,-46,0,140,0,6
2685,1,2402,2419,-17,0,304,0,6
2686,1,2493,2293,200,0,216,0,6
2687,3,2403,2362,41,0,15,0,6
2688,2,2468,2433,35,0,250,1,6
2689,1,2350,2446,-96,0,146,0,6
2690,1,2697,2706,-9,0,320,0,6
2691,1,2468,2515,-47,0,122,0,6
2692,1,2473,2429,44,0,106,0,6
2693,2,2548,2574,-26,0,106,0,6
2694,1,2549,2427,122,0,278,1,6
2695,1,2425,2402,23,0,301,1,6
2696,1,2439,2357,82,0,404,0,6
2697,1,2382,2492,-110,0,343,0,6
2698,2,2517,2583,-66,0,133,0,6
2699,1,2503,2369,134,0,10,0,6
2700,1,2382,2573,-191,0,385,1,6
2701,2,2414,2397,17,0,107,0,6
2702,2,2509,2618,-109,0,40,0,6
2703,3,2302,2458,-156,0,245,0,6
2704,1,2423,2369,54,0,300,0,6
2705,3,2514,2536,-22,0,320,0,6
2706,1,2497,2400,97,0,218,0,6
2707,2,2256,2471,-215,0,186,1,6
2708,1,2495,2472,23,0,151,0,6
2709,1,2467,2217,250,4,119,0,13
2710,2,2329,2446,-117,0,0,0,6
2711,1,2387,2523,-136,0,1,0,6
2712,2,2451,2419,32,0,190,0,6
2713,1,2422,2282,140,0,109,1,6
2714,3,2417,2428,-11,0,205,0,6
2715,1,2441,2443,-2,0,107,0,6
2716,2,2613,2746,-133,0,320,1,6
2717,1,2420,2357,63,0,170,0,8
2719,1,2780,2443,337,4,200,0,11
2720,1,2462,2400,62,0,334,0,6
2721,2,2421,2300,121,0,23,0,6
2722,1,2436,2379,57,0,268,0,6
2723,1,2527,2371,156,0,353,0,6
2724,1,2481,2474,7,0,400,0,6
2725,2,2302,2415,-113,0,125,0,6
2726,2,2343,2406,-63,0,20,1,6
2727,2,2424,2478,-54,0,40,0,6
2728,2,2378,2408,-30,0,153,0,6
2729,2,2413,2309,104,0,302,1,6
2730,1,2587,2512,75,0,70,0,6
2731,1,2363,2459,-96,0,265,0,6
2732,1,2561,2514,47,0,10,0,6
2733,1,2424,2509,-85,0,124,1,6
2734,2,2364,2403,-39,0,44,0,6
2735,1,2414,2253,161,0,133,1,6
2736,2,2701,2703,-2,0,303,0,6
2737,1,2530,2595,-65,0,378,0,6
2738,2,2410,2436,-26,0,0,0,6
2739,2,2304,2428,-124,0,226,1,6
2740,2,2352,2443,-91,0,146,0,6
2741,2,2439,2458,-19,0,111,0,6
2742,2,2395,2501,-106,0,453,0,6
2743,3,2425,2291,134,0,15,0,6
2744,1,2489,2314,175,4,300,1,13
2745,1,2404,2483,-79,0,6,0,6
2746,3,2514,2390,124,0,44,0,6
2747,1,2622,2430,192,0,43,0,6
2748,1,2536,2515,21,0,133,1,6
2749,3,2605,2575,30,0,302,0,6
2750,1,2481,2405,76,0,453,0,6
2751,1,2413,2390,23,0,106,0,6
2752,2,2390,2455,-65,0,80,0,6
2753,1,2405,2447,-42,0,0,0,6
2754,2,2348,2467,-119,0,190,0,6
2755,1,2709,2695,14,0,320,0,6
2756,2,2483,2441,42,0,4,0,6
2757,1,2460,2395,65,0,101,0,6
2758,1,2515,2508,7,0,87,0,6
2759,2,2344,2437,-93,0,45,0,6
2760,1,2366,2428,-62,0,218,0,6
2761,1,2505,2391,114,0,119,0,6
2763,2,2534,2359,175,0,43,0,6
2764,2,2348,2501,-153,0,205,0,6
2765,3,2442,2218,224,0,130,0,6
2766,1,2377,2476,-99,0,300,0,6
2767,1,2511,2532,-21,0,101,0,6
2768,2,2411,2468,-57,0,4,0,6
2769,2,2346,2629,-283,0,200,0,8
2770,2,2532,2398,134,0,22,0,8
2771,1,2352,2425,-73,0,242,0,8
2772,2,2411,2417,-6,0,100,0,6
2773,2,2432,2300,132,0,470,1,6
2774,1,2464,2315,149,0,56,0,6
2775,1,2447,2476,-29,0,203,0,6
2776,2,2388,2570,-182,0,395,0,6
2777,1,2525,2366,159,0,335,0,6
2778,2,2690,2459,231,0,380,0,6
2779,1,2604,2431,173,0,46,0,6
2780,2,2405,2411,-6,0,40,0,6
2781,1,2440,2517,-77,0,192,0,6
2782,3,2439,2792,-353,4,313,0,11
2783,1,2310,2417,-107,0,242,0,6
2784,1,2471,2344,127,0,8,0,6
2785,2,2339,2463,-124,0,405,0,6
2786,1,2473,2446,27,0,200,0,6
2787,1,2296,2404,-108,0,150,1,6
2788,1,2408,2406,2,0,46,0,6
2789,2,2403,2368,35,0,0,0,6
2790,2,2417,2392,25,0,0,1,6
2791,1,2333,2423,-90,0,50,0,6
2792,1,2541,2592,-51,0,145,0,6
2793,1,2428,2434,-6,0,45,1,6
2794,1,2509,2455,54,0,89,0,6
2795,2,2340,2631,-291,0,200,0,8
2796,2,2616,2774,-158,0,386,0,6
2797,1,2421,2512,-91,0,83,1,6
2798,1,2504,2284,220,0,253,0,6
2799,3,2467,2382,85,0,310,0,6
2800,1,2341,2474,-133,0,190,0,6
2801,1,2467,2456,11,4,47,0,0
2802,2,2396,2452,-56,0,42,1,6
2803,2,2327,2521,-194,0,207,0,6
2804,2,2542,2625,-83,0,240,0,6
2805,2,2573,2422,151,0,398,0,6
2806,2,2478,2491,-13,0,241,1,6
2807,2,2470,2607,-137,0,200,1,6
2808,1,2428,2552,-124,0,249,0,6
2809,1,2467,2298,169,0,336,0,6
2810,1,2395,2400,-5,0,300,0,6
2811,1,2450,2514,-64,0,190,1,6
2812,2,2388,2509,-121,0,120,0,6
2813,2,2406,2263,143,0,406,1,8
2814,2,2334,2633,-299,0,200,0,6
2815,2,2312,2440,-128,0,131,1,6
2816,2,2507,2442,65,0,462,0,6
2817,2,2510,2447,63,0,291,1,6
2818,1,2410,2318,92,0,234,1,6
2819,1,2467,2347,120,0,405,0,6
2820,1,2596,2484,112,0,243,0,6
2821,1,2433,2425,8,0,212,1,6
2822,1,2777,2613,164,0,142,0,6
2823,1,2751,2548,203,0,21,0,6
2824,1,2524,2324,200,0,52,1,6
2825,2,2410,2411,-1,0,200,0,6
2826,2,2291,2413,-122,0,101,1,6
2827,1,2400,2404,-4,0,4,0,6
2828,2,2398,2507,-109,0,380,1,6
2829,2,2580,2743,-163,0,48,0,6
2830,1,2445,2295,150,4,44,0,13
2831,2,2329,2426,-97,0,49,0,6
2832,1,2500,2462,38,0,13,0,6
2833,1,2450,2349,101,0,1,0,6
2834,1,2457,2565,-108,0,354,0,6
2835,1,2392,2435,-43,0,250,1,6
2836,2,2415,2340,75,0,15,0,6
2837,2,2418,2384,34,0,118,0,6
2838,1,2507,2457,50,0,50,0,6
2839,2,2342,2445,-103,4,422,1,18
2840,1,2578,2390,188,0,107,0,8
2841,1,2556,2435,121,0,45,0,6
2842,2,2298,2470,-172,0,115,0,6
2843,2,2639,2468,171,0,151,1,6
2844,1,2466,2473,-7,0,14,1,6
2845,1,2496,2578,-82,0,311,0,6
2846,1,2439,2466,-27,0,404,0,6
2847,2,2457,2402,55,0,122,0,6
2848,2,2440,2406,34,0,414,1,6
2849,2,2508,2545,-37,0,324,1,6
2850,1,2387,2419,-32,0,301,1,6
2851,1,2326,2420,-94,0,267,0,5
2852,2,2391,2472,-81,0,129,1,5
2853,2,2392,2536,-144,0,253,0,6
2854,1,2329,2635,-306,0,200,0,6
2855,1,2345,2454,-109,0,147,1,6
2856,1,2324,2416,-92,0,200,0,6
2857,2,2414,2437,-23,0,205,0,6
2858,2,2444,2568,-124,0,277,0,6
2859,2,2454,2504,-50,0,128,0,6
2860,2,2441,2404,37,0,140,1,6
2861,2,2477,2379,98,0,131,1,6
2862,2,2378,2439,-61,0,44,0,6
2863,1,2538,2451,87,0,110,1,6
2864,2,2349,2420,-71,0,218,0,6
2865,1,2321,2527,-206,0,200,0,6
2866,2,2452,2762,-310,4,120,0,11
2867,1,2507,2479,28,0,300,1,6
2868,1,2405,2308,97,0,164,0,6
2869,2,2298,2511,-213,0,385,0,6
2870,1,2513,2384,129,0,211,0,6
2871,1,2452,2512,-60,0,190,1,6
2872,1,2385,2456,-71,0,45,1,6
2873,1,2471,2356,115,0,106,1,6
2874,1,2509,2449,60,0,357,0,6
2875,2,2319,2409,-90,0,200,1,6
2876,2,2359,2626,-267,0,200,0,6
2877,3,2422,2356,66,0,9,0,8
2878,1,2419,2352,67,0,8,0,6
2879,2,2432,2560,-128,0,40,0,6
2880,3,2412,2537,-125,0,88,0,6
2881,2,2354,2467,-113,0,112,1,8
2882,3,2410,2401,9,0,332,0,6
2883,2,2509,2631,-122,0,45,0,6
2884,2,2391,2536,-145,0,111,0,6
2885,1,2503,2508,-5,0,46,0,6
2886,2,2467,2472,-5,0,241,1,6
2887,1,2442,2409,33,0,247,1,6
2888,2,2476,2611,-135,0,84,1,6
2889,2,2443,2375,68,0,45,0,6
2890,2,2510,2550,-40,0,344,0,6
2891,3,2339,2434,-95,0,1,0,6
2892,1,2447,2379,68,0,315,0,6
2893,2,2502,2509,-7,0,140,0,6
2894,2,2320,2406,-86,4,46,0,13
2895,2,2412,2465,-53,0,127,1,6
2896,1,2513,2379,134,0,211,0,6
2897,1,2409,2324,85,0,15,0,6
2898,2,2359,2453,-94,0,343,0,6
2899,1,2635,2505,130,0,107,0,6
2900,1,2445,2513,-68,0,205,1,6
2901,3,2321,2581,-260,0,406,0,8
2902,2,2518,2410,108,0,485,1,6
2903,1,2606,2424,182,0,210,0,6
2904,1,2563,2428,135,0,45,0,6
2905,2,2505,2459,46,0,380,1,6
2906,2,2386,2540,-154,0,112,0,6
2907,2,2474,2573,-99,0,106,0,6
2908,2,2318,2409,-91,0,130,1,6
2909,2,2353,2628,-275,0,200,0,6
2910,2,2501,2639,-138,0,45,0,6
2911,2,2280,2402,-122,0,11,0,6
2912,1,2380,2517,-137,0,121,0,6
2913,2,2413,2348,65,0,373,1,6
2914,2,2413,2446,-33,0,201,0,6
2915,2,2436,2393,43,0,101,0,6
2916,2,2514,2496,18,0,389,0,6
2917,1,2414,2392,22,0,0,0,6
2918,1,2406,2414,-8,0,15,0,6
2919,2,2392,2423,-31,0,463,0,6
2920,2,2358,2402,-44,0,330,1,8
2921,1,2449,2467,-18,0,218,0,6
2922,1,2406,2284,122,0,302,0,6
2923,1,2394,2459,-65,0,153,0,6
2924,1,2472,2347,125,0,395,0,6
2925,1,2615,2470,145,0,48,0,6
2926,1,2417,2321,96,4,200,0,13
2927,1,2402,2300,102,0,125,0,8
2928,3,2430,2413,17,0,242,0,6
2929,2,2431,2505,-74,0,324,0,6
2930,2,2424,2567,-143,0,101,0,6
2932,1,2432,2341,91,0,45,0,6
2933,2,2478,2462,16,0,123,0,6
2934,2,2404,2448,-44,0,210,0,6
2935,2,2347,2630,-283,0,200,0,6
2936,2,2555,2555,0,0,103,0,6
2937,2,2398,2459,-61,0,13,0,6
2938,1,2507,2451,56,0,291,0,6
2939,1,2477,2375,102,0,15,0,5
2940,1,2478,2332,146,0,54,0,8
2941,2,2642,2498,144,0,107,1,6
2942,1,2330,2430,-100,0,120,1,6
2943,3,2471,2350,121,0,45,0,8
2944,1,2408,2571,-163,0,6,0,6
2945,1,2517,2511,6,0,101,0,6
2946,3,2465,2498,-33,0,190,0,6
2947,1,2543,2535,8,0,4,1,6
2948,1,2422,2295,127,0,13,0,6
2949,3,2413,2399,14,0,101,0,6
2950,1,2508,2469,39,0,130,0,6
2951,3,2509,2386,123,0,380,0,6
2952,1,2453,2354,99,0,409,0,6
2953,1,2412,2295,117,4,4,1,13
2954,2,2461,2577,-116,0,386,0,6
2955,2,2449,2470,-21,0,127,0,6
2956,2,2399,2505,-106,0,122,0,6
2957,1,2405,2281,124,0,100,0,8
2958,1,2558,2384,174,0,315,0,6
2959,1,2418,2352,66,0,240,1,6
2960,3,2417,2361,56,0,101,0,5
2961,1,2355,2406,-51,0,152,0,6
2962,1,2451,2408,43,0,326,0,6
2963,2,2337,2437,-100,0,106,0,6
2964,2,2509,2388,121,0,280,0,6
2965,3,2519,2504,15,0,300,0,6
2966,2,2221,2410,-189,0,102,0,6
2967,2,2307,2476,-169,0,130,1,6
2968,2,2344,2428,-84,0,103,0,6
2969,1,2408,2304,104,0,106,1,6
2970,1,2454,2569,-115,0,310,0,6
2971,1,2446,2468,-22,0,3,1,6
2972,3,2550,2581,-31,0,456,0,6
2973,1,2561,2498,63,0,456,0,6
2974,2,2447,2512,-65,0,192,0,6
2975,2,2541,2561,-20,0,353,0,6
2976,2,2632,2342,290,0,125,0,6
2977,1,2441,2332,109,0,200,0,6
2978,3,2506,2634,-128,0,300,0,6
2979,1,2498,2466,32,0,90,1,6
2980,2,2530,2507,23,0,325,1,6
2981,1,2549,2563,-14,0,355,0,6
2982,3,2388,2458,-70,0,253,0,6
2983,1,2401,2467,-66,0,302,1,6
2984,1,2256,2407,-151,0,192,0,8
2986,3,2509,2395,114,0,101,0,6
2987,2,2464,2514,-50,0,147,0,6
2988,1,2415,2257,158,0,40,0,6
2989,1,2441,2368,73,0,109,0,6
2990,2,2376,2421,-45,0,191,1,6
2991,2,2328,2445,-117,0,200,0,6
2992,2,2319,2475,-156,0,4,0,6
2993,1,2488,2566,-78,0,277,1,6
2994,2,2350,2457,-107,0,414,1,6
2995,1,2358,2480,-122,0,58,0,6
2996,1,2407,2377,30,0,302,0,6
2997,2,2362,2425,-63,0,210,0,6
2998,2,2557,2554,3,0,255,0,6
2999,3,2618,2609,9,0,48,0,6
3000,1,2555,2386,169,0,315,0,6
3001,2,2233,2401,-168,0,202,1,6
3002,3,2404,2474,-70,0,210,0,6
3003,1,2456,2395,61,0,415,0,6
3004,1,2461,2503,-42,0,190,1,6
3005,1,2449,2325,124,0,100,0,6
3006,1,2446,2344,102,0,0,1,6
3007,2,2462,2452,10,0,135,1,6
3008,2,2519,2459,60,0,347,1,6
3009,1,2566,2536,30,0,404,0,6
3010,1,2396,2502,-106,0,120,1,6
3011,1,2388,2412,-24,0,440,0,6
3012,1,2580,2413,167,0,123,1,6
3013,1,2479,2455,24,0,454,0,6
3014,1,2481,2257,224,0,400,0,5
3015,1,2516,2442,74,0,357,0,6
3016,2,2272,2409,-137,0,230,0,8
3017,2,2323,2466,-143,0,40,0,6
3018,2,2397,2418,-21,0,113,0,6
3019,1,2529,2377,152,0,302,0,6
3020,1,2774,2562,212,4,143,0,11
3021,2,2487,2352,135,0,278,0,6
3022,2,2369,2513,-144,0,277,0,6
3023,2,2540,2487,53,0,331,1,6
3024,1,2350,2454,-104,0,375,0,8
3025,1,2521,2259,262,0,151,1,6
3026,1,2571,2550,21,0,325,0,6
3027,1,2531,2407,124,0,122,0,6
3028,2,2395,2406,-11,0,148,0,6
3029,2,2309,2413,-104,0,225,0,8
3030,1,2478,2559,-81,0,359,0,6
3031,1,2417,2330,87,0,0,0,5
3032,3,2405,2341,64,0,203,0,6
3033,1,2517,2534,-17,0,344,1,6
3034,1,2366,2402,-36,0,7,0,6
3035,2,2525,2430,95,0,112,1,6
3036,1,2497,2467,30,0,380,1,6
3037,2,2502,2479,23,0,45,0,6
3038,1,2269,2416,-147,0,190,0,6
3039,2,2328,2450,-122,0,4,0,6
3040,2,2374,2532,-158,0,45,0,6
3041,3,2421,2202,219,0,112,0,5
3042,2,2391,2461,-70,0,354,1,6
3043,2,2438,2429,9,0,139,0,6
3044,2,2456,2521,-65,0,199,0,6
3045,1,2393,2485,-92,0,15,0,6
3046,1,2552,2545,7,0,7,0,6
3047,3,2372,2430,-58,0,201,0,6
3048,2,2450,2466,-16,0,134,0,6
3049,1,2575,2454,121,0,49,0,6
3050,1,2410,2396,14,0,429,0,6
3051,1,2416,2389,27,0,131,1,6
3052,1,2406,2323,83,0,48,0,6
3053,1,2507,2362,145,0,49,0,6
3054,1,2410,2406,4,0,16,0,8
3055,2,2494,2403,91,0,265,0,6
3056,2,2551,2477,74,0,11,0,6
3057,1,2577,2533,44,0,409,0,6
3058,1,2493,2458,35,0,487,0,6
3059,1,2586,2468,118,0,311,0,6
3060,1,2465,2454,11,0,354,0,6
3061,2,2472,2508,-36,0,241,0,6
3062,1,2528,2553,-25,0,255,1,6
3063,2,2432,2432,0,0,335,0,6
3064,3,2446,2329,117,0,40,0,6
3065,2,2781,2609,172,0,265,0,6
3066,1,2435,2385,50,0,106,1,6
3067,1,2342,2404,-62,0,201,0,6
3068,2,2444,2528,-84,0,106,1,6
3069,1,2462,2502,-40,0,190,0,6
3070,1,2403,2327,76,0,201,0,6
3071,3,2322,2427,-105,0,46,0,6
3072,1,2556,2402,154,0,109,0,6
3073,2,2319,2410,-91,0,123,0,6
3074,2,2618,2544,74,0,302,0,6
3075,2,2371,2528,-157,0,205,1,6
3076,2,2539,2557,-18,0,103,1,6
3077,1,2478,2399,79,0,40,1,6
3078,2,2485,2496,-11,0,122,0,6
3079,1,2550,2582,-32,0,8,0,6
3080,2,2401,2396,5,0,30,0,6
3081,2,2526,2451,75,0,190,0,6
3082,1,2394,2450,-56,0,45,0,6
3083,2,2336,2462,-126,0,109,0,6
3084,1,2451,2305,146,0,306,0,8
3085,1,2417,2401,16,0,113,0,8
3086,3,2437,2791,-354,4,145,0,11
3087,2,2384,2488,-104,0,200,0,6
3088,2,2376,2451,-75,0,3,0,6
3089,2,2433,2422,11,0,301,0,6
3090,1,2401,2287,114,0,308,0,8
3091,2,2276,2437,-161,0,101,0,6
3092,1,2408,2437,-29,0,268,0,6
3093,2,2754,2688,66,0,334,1,6
3094,2,2410,2487,-77,0,123,0,6
3095,2,2484,2425,59,0,436,0,6
3096,3,2589,2534,55,0,455,0,6
3097,1,2346,2525,-179,0,456,1,6
3098,2,2327,2429,-102,0,201,0,6
3099,2,2467,2681,-214,0,200,0,6
3100,3,2472,2464,8,0,317,0,6
3101,2,2393,2414,-21,0,300,0,6
3102,2,2485,2315,170,0,31,1,6
3103,2,2446,2355,91,0,15,0,8
3104,1,2518,2314,204,0,338,0,6
3105,2,2496,2468,28,0,415,0,6
3106,2,2431,2436,-5,0,38,0,6
3107,2,2418,2361,57,0,148,0,5
3108,1,2441,2408,33,0,123,0,6
3109,1,2425,2324,101,0,0,0,6
3110,2,2362,2410,-48,0,112,0,6
3111,1,2512,2476,36,0,1,0,6
3112,1,2432,2349,83,0,250,1,6
3113,2,2492,2372,120,0,331,1,6
3114,1,2420,2380,40,0,131,0,6
3115,1,2687,2862,-175,0,111,0,6
3116,1,2533,2373,160,0,40,0,6
3117,1,2444,2388,56,0,205,0,6
3118,1,2440,2273,167,0,300,0,6
3119,2,2501,2479,22,0,40,0,6
3120,1,2430,2312,118,0,90,0,6
3121,1,2362,2439,-77,0,151,0,8
3122,1,2683,2464,219,0,0,0,6
3123,2,2563,2534,29,0,7,0,6
3124,2,2531,2511,20,0,56,0,6
3125,1,2458,2519,-61,0,199,1,6
3126,1,2411,2319,92,0,207,0,5
3127,2,2402,2479,-77,0,335,0,6
3128,1,2664,2547,117,0,447,0,6
3129,2,2427,2406,21,0,150,0,6
3130,1,2431,2403,28,0,136,0,6
3131,2,2425,2446,-21,0,131,0,6
3133,3,2408,2449,-41,0,45,0,6
3134,2,2374,2449,-75,0,108,0,6
3135,1,2502,2547,-45,0,456,0,6
3136,2,2343,2442,-99,0,176,1,6
3137,3,2462,2309,153,0,80,0,8
3138,2,2536,2516,20,0,106,1,6
3139,3,2540,2517,23,0,80,0,6
3140,2,2313,2472,-159,0,6,0,6
3141,2,2475,2489,-14,0,30,0,6
3142,1,2434,2372,62,0,49,1,6
3143,1,2481,2315,166,0,306,0,5
3144,2,2423,2359,64,0,107,0,6
3145,2,2849,2696,153,0,141,0,6
3146,2,2374,2443,-69,4,52,0,13
3147,1,2435,2406,29,0,300,0,6
3148,2,2282,2405,-123,0,45,1,8
3149,2,2323,2590,-267,0,118,0,6
3150,1,2492,2406,86,0,265,0,6
3151,1,2379,2539,-160,0,3,0,6
3152,1,2495,2375,120,0,36,0,6
3153,2,2618,2746,-128,0,468,0,6
3154,2,2443,2435,8,0,45,0,6
3155,2,2358,2436,-78,0,190,0,6
3156,3,2256,2418,-162,0,244,0,5
3157,1,2320,2429,-109,0,28,1,6
3158,1,2518,2525,-7,0,206,1,6
3159,2,2326,2402,-76,0,242,0,6
3160,2,2416,2352,64,0,255,0,6
3161,2,2486,2495,-9,0,122,0,6
3162,1,2464,2425,39,0,50,0,6
3163,1,2581,2460,121,4,8,0,13
3164,2,2461,2686,-225,0,110,0,6
3165,3,2540,2509,31,0,260,0,6
3166,1,2452,2397,55,0,123,0,6
3167,2,2347,2420,-73,0,337,0,6
3168,2,2491,2609,-118,0,150,0,6
3169,2,2371,2427,-56,0,46,0,6
3170,2,2477,2523,-46,0,85,1,6
3171,1,2593,2321,272,0,59,0,6
3172,3,2446,2421,25,0,487,0,6
3173,3,2476,2668,-192,0,338,0,6
3174,2,2312,2459,-147,0,269,0,8
3175,1,2441,2487,-46,0,45,1,6
3176,1,2345,2436,-91,0,107,1,8
3177,1,2495,2469,26,0,80,0,6
3178,2,2551,2540,11,0,250,0,6
3179,1,2613,2487,126,0,147,0,6
3180,1,2694,2568,126,0,301,0,6
3181,2,2704,2837,-133,0,190,0,6
3182,2,2402,2496,-94,0,121,0,6
3183,1,2522,2437,85,0,337,0,6
3184,2,2376,2530,-154,0,106,1,6
3185,2,2453,2329,124,0,107,0,6
3186,1,2371,2419,-48,0,200,0,6
3187,1,2388,2439,-51,0,2,0,6
3188,1,2583,2517,66,0,123,0,6
3189,2,2379,2503,-124,0,131,0,6
3190,1,2750,2614,136,0,48,1,6
3191,1,2389,2468,-79,0,106,1,6
3192,1,2383,2453,-70,0,253,0,6
3193,1,2688,2459,229,0,4,0,6
3194,2,2501,2480,21,0,43,1,6
3195,2,2357,2415,-58,0,119,0,6
3196,3,2432,2354,78,0,20,0,8
3197,3,2424,2469,-45,0,242,0,6
3198,3,2544,2576,-32,0,338,0,6
3199,1,2504,2409,95,0,242,0,6
3200,2,2381,2527,-146,0,106,1,6
3201,2,2509,2540,-31,0,334,0,6
3202,1,2406,2322,84,0,110,1,6
3203,3,2453,2586,-133,4,302,0,13
3204,1,2413,2392,21,0,0,0,6
3205,1,2566,2432,134,0,295,0,6
3206,2,2319,2595,-276,0,123,0,6
3207,2,2457,2545,-88,0,302,0,6
3208,1,2422,2328,94,0,0,0,6
3209,1,2546,2506,40,0,103,0,6
3210,2,2440,2446,-6,0,46,0,6
3211,3,2421,2393,28,0,2,0,6
3212,2,2310,2513,-203,0,190,0,8
3213,1,2481,2378,103,0,211,0,6
3214,1,2415,2315,100,0,131,0,6
3215,2,2361,2472,-111,0,267,0,6
3216,1,2843,2624,219,0,253,1,6
3217,3,2463,2308,155,0,80,0,8
3218,2,2464,2500,-36,0,190,1,6
3219,1,2666,2457,209,0,107,0,6
3220,2,2463,2499,-36,0,4,0,6
3221,1,2512,2394,118,0,203,0,6
3223,1,2673,2511,162,0,30,0,6
3224,1,2317,2406,-89,0,36,1,5
3225,1,2565,2602,-37,0,200,0,6
3226,2,2453,2372,81,0,16,0,6
3227,2,2502,2473,29,0,461,0,6
3228,2,2457,2691,-234,0,250,1,6
3229,1,2504,2551,-47,0,411,0,6
3230,1,2446,2416,30,0,424,0,6
3231,1,2461,2396,65,0,253,0,6
3232,1,2597,2317,280,0,123,0,6
3233,3,2575,2479,96,0,382,0,6
3234,1,2274,2434,-160,0,312,0,6
3235,3,2421,2367,54,0,4,0,6
3236,2,2383,2530,-147,0,40,0,6
3237,1,2377,2425,-48,0,432,0,6
3238,3,2519,2418,101,0,40,0,6
3239,2,2485,2271,214,0,400,0,5
3240,2,2440,2340,100,0,41,0,6
3241,1,2512,2473,39,0,291,0,6
3242,1,2500,2398,102,0,265,1,6
3243,1,2576,2698,-122,0,130,0,6
3244,3,2545,2511,34,0,315,0,6
3245,3,2504,2495,9,0,131,0,6
3246,2,2363,2476,-113,0,112,0,6
3247,2,2393,2421,-28,0,454,1,6
3248,1,2290,2455,-165,0,201,1,8
3249,1,2470,2369,101,0,470,1,6
3250,1,2557,2520,37,0,368,1,6
3251,3,2311,2411,-100,0,311,0,6
3252,2,2429,2420,9,0,105,0,6
3253,2,2676,2473,203,0,1,0,6
3254,1,2419,2457,-38,0,100,0,6
3255,2,2336,2446,-110,0,438,0,6
3256,2,2323,2426,-103,0,46,0,6
3257,1,2391,2466,-75,0,10,1,6
3258,1,2472,2373,99,0,33,1,6
3259,2,2534,2373,161,0,34,0,6
3260,1,2451,2524,-73,0,122,0,6
3261,1,2328,2423,-95,0,150,1,6
3262,2,2846,2622,224,0,404,0,6
3263,2,2562,2571,-9,0,7,0,6
3264,3,2311,2461,-150,0,107,0,8
3265,2,2468,2596,-128,0,331,0,6
3266,1,2451,2460,-9,0,45,0,6
3267,3,2469,2385,84,4,110,0,13
3268,1,2516,2391,125,0,40,0,6
3269,3,2391,2431,-40,0,369,0,8
3270,2,2670,2693,-23,0,302,0,6
3271,2,2528,2411,117,0,409,1,6
3272,2,2383,2509,-126,0,128,0,6
3273,1,2419,2384,35,0,244,0,6
3274,3,2511,2544,-33,0,411,0,6
3275,1,2480,2329,151,0,200,0,6
3276,1,2388,2483,-95,0,304,0,6
3277,1,2420,2378,42,0,352,0,6
3278,3,2472,2306,166,0,150,0,6
3279,2,2371,2409,-38,0,278,0,6
3280,1,2651,2574,77,0,211,0,6
3281,1,2467,2517,-50,0,57,0,6
3282,1,2391,2425,-34,0,45,0,6
3283,1,2336,2413,-77,0,45,0,6
3284,1,2484,2362,122,0,120,0,6
3285,2,2518,2540,-22,0,343,0,6
3286,2,2467,2495,-28,0,13,1,6
3287,1,2691,2610,81,0,301,0,6
3288,2,2643,2589,54,0,131,0,6
3289,2,2233,2401,-168,0,14,0,6
3290,1,2423,2432,-9,0,133,0,6
3291,2,2366,2425,-59,0,302,1,6
3292,1,2489,2358,131,0,471,0,6
3293,2,2463,2446,17,0,113,0,6
3294,2,2293,2432,-139,4,49,0,13
3295,1,2507,2341,166,0,49,0,6
3296,1,2402,2409,-7,0,4,0,6
3297,2,2380,2400,-20,0,16,0,6
3298,1,2426,2388,38,0,4,0,6
3299,1,2543,2512,31,0,260,0,6
3300,2,2426,2331,95,0,303,0,6
3301,1,2459,2387,72,0,210,1,6
3302,1,2328,2476,-148,0,129,0,5
3303,2,2404,2260,144,0,122,0,6
3305,3,2406,2480,-74,0,167,0,6
3306,3,2512,2379,133,0,17,0,6
3307,3,2343,2457,-114,0,301,0,6
3308,1,2476,2395,81,0,261,0,6
3309,1,2699,2664,35,0,380,0,6
3310,2,2454,2458,-4,0,200,0,6
3311,1,2430,2319,111,0,0,0,6
3312,1,2373,2424,-51,0,40,1,6
3313,1,2402,2200,202,0,343,0,5
3314,3,2631,2833,-202,0,113,0,6
3315,1,2541,2375,166,0,0,1,6
3316,3,2346,2457,-111,0,152,0,6
3317,1,2289,2415,-126,0,278,0,6
3318,3,2452,2318,134,0,46,0,6
3319,1,2450,2332,118,0,107,0,6
3320,2,2595,2521,74,0,102,1,6
3321,1,2484,2354,130,0,400,0,6
3322,1,2545,2513,32,0,205,1,6
3323,3,2481,2636,-155,0,343,0,6
3324,2,2458,2313,145,0,246,0,8
3325,1,2425,2366,59,0,310,0,6
3326,2,2659,2704,-45,0,325,1,6
3327,2,2211,2442,-231,0,45,0,6
3328,1,2383,2431,-48,0,454,0,6
3329,2,2393,2504,-111,0,121,0,6
3330,2,2407,2550,-143,0,129,0,6
3331,2,2507,2549,-42,0,344,0,6
3332,1,2511,2474,37,0,327,1,6
3333,2,2605,2695,-90,0,330,0,6
3334,1,2451,2429,22,0,4,0,6
3335,3,2420,2303,117,0,8,0,6
3336,1,2402,2286,116,4,122,0,13
3337,2,2554,2502,52,0,260,0,6
3338,2,2350,2488,-138,0,113,1,6
3339,3,2501,2425,76,0,45,0,6
3340,2,2397,2461,-64,0,88,0,6
3341,1,2309,2470,-161,0,237,1,6
3342,1,2404,2257,147,0,100,1,6
3343,1,2408,2284,124,0,8,1,6
3344,2,2345,2526,-181,0,140,0,6
3345,2,2421,2407,14,0,110,1,6
3346,2,2430,2361,69,0,131,0,6
3347,1,2480,2461,19,0,128,1,6
3348,1,2401,2215,186,0,48,0,6
3349,1,2404,2358,46,0,386,0,6
3350,2,2345,2424,-79,0,335,0,6
3351,1,2485,2591,-106,0,43,0,6
3352,3,2425,2463,-38,0,6,0,6
3353,1,2457,2308,149,0,190,0,8
3354,2,2399,2458,-59,0,106,1,6
3355,2,2610,2634,-24,0,58,0,6
3356,2,2389,2452,-63,0,462,1,6
3357,3,2508,2547,-39,0,302,0,6
3358,2,2416,2409,7,0,106,0,6
3359,2,2382,2450,-68,0,3,0,6
3361,2,2432,2407,25,0,302,0,6
3362,2,2320,2523,-203,0,4,1,6
3363,2,2478,2588,-110,0,57,1,6
3364,1,2528,2342,186,0,404,0,6
3365,1,2358,2419,-61,0,255,1,6
3366,2,2329,2454,-125,0,50,0,6
3367,2,2455,2430,25,0,320,0,6
3368,1,2709,2654,55,0,380,0,6
3369,2,2374,2507,-133,0,211,0,6
3370,1,2416,2276,140,0,44,0,6
3371,1,2626,2424,202,0,253,0,6
3372,3,2500,2577,-77,0,106,0,6
3373,2,2457,2404,53,0,4,0,6
3374,2,2420,2442,-22,0,46,1,6
3375,2,2272,2472,-200,0,5,0,6
3376,1,2402,2511,-109,0,200,0,6
3377,1,2420,2380,40,0,124,0,6
3378,1,2508,2390,118,0,265,1,6
3379,2,2699,2601,98,0,45,0,6
3380,1,2461,2330,131,4,400,0,13
3381,1,2455,2378,77,0,201,0,6
3382,3,2405,2236,169,0,7,0,6
3383,2,2412,2378,34,0,8,1,6
3384,1,2413,2311,102,0,45,0,6
3385,1,2621,2484,137,0,380,1,6
3386,1,2406,2272,134,4,106,0,13
3387,2,2415,2491,-76,0,45,0,6
3388,2,2319,2432,-113,0,48,0,6
3389,3,2426,2499,-73,0,131,0,6
3390,1,2297,2417,-120,0,110,0,8
3391,2,2205,2480,-275,0,463,1,6
3392,1,2584,2590,-6,0,45,0,6
3393,3,2254,2407,-153,0,247,0,6
3394,1,2429,2425,4,0,470,0,6
3395,2,2547,2509,38,0,260,0,6
3396,2,2424,2531,-107,0,88,0,6
3397,3,2502,2589,-87,0,88,0,6
3398,3,2421,2403,18,0,265,0,6
3399,2,2407,2430,-23,0,1,1,6
3400,3,2445,2462,-17,4,270,0,13
3401,1,2410,2385,25,0,130,0,6
3402,2,2592,2577,15,0,112,0,6
3403,1,2475,2449,26,0,315,0,6
3404,2,2349,2411,-62,0,375,1,6
3405,3,2608,2692,-84,0,330,0,6
3406,2,2526,2520,6,0,131,0,6
3407,1,2415,2350,65,0,5,1,6
3408,2,2400,2237,163,0,400,0,6
3409,2,2584,2541,43,0,201,0,6
3410,2,2329,2460,-131,0,46,0,8
3411,2,2377,2418,-41,0,36,0,6
3412,3,2397,2459,-62,0,381,0,6
3413,3,2412,2373,39,0,40,0,6
3414,2,2430,2461,-31,0,140,0,6
3415,1,2409,2436,-27,0,135,0,6
3416,1,2411,2465,-54,0,303,1,6
3418,1,2269,2410,-141,4,110,0,13
3419,2,2414,2310,104,0,313,0,6
3420,2,2515,2540,-25,0,327,0,6
3421,2,2447,2496,-49,0,386,0,6
3422,2,2409,2286,123,0,58,0,6
3423,2,2401,2410,-9,0,244,0,6
3424,2,2409,2305,104,0,121,0,8
3425,2,2405,2256,149,0,100,1,6
3426,2,2590,2529,61,0,0,0,6
3427,2,2323,2447,-124,4,302,0,13
3428,2,2480,2625,-145,0,150,1,6
3429,2,2563,2212,351,0,45,1,6
3430,1,2587,2503,84,0,58,0,6
3431,1,2365,2416,-51,0,127,1,6
3432,2,2575,2406,169,0,198,1,6
3433,1,2457,2325,132,0,107,0,6
3434,2,2444,2379,65,0,43,0,6
3435,2,2413,2524,-111,0,138,0,6
3436,1,2546,2510,36,0,302,0,6
3437,1,2475,2269,206,0,319,1,6
3438,2,2535,2587,-52,0,378,1,6
3439,2,2458,2378,80,0,241,0,6
3440,2,2569,2623,-54,0,92,0,6
3441,1,2385,2529,-144,0,122,0,6
3442,1,2388,2577,-189,0,4,0,6
3443,1,2476,2287,189,0,4,0,6
3444,1,2464,2326,138,0,200,0,8
3445,3,2452,2421,31,0,357,0,6
3446,1,2416,2369,47,0,302,0,6
3447,1,2416,2396,20,0,302,0,6
3448,2,2426,2553,-127,0,344,1,6
3449,2,2423,2345,78,0,45,0,6
3450,1,2408,2344,64,0,43,1,6
3451,1,2245,2418,-173,0,124,0,6
3452,1,2480,2335,145,0,60,0,6
3453,3,2386,2512,-126,0,4,0,6
3454,3,2367,2407,-40,0,302,0,6
3455,1,2505,2520,-15,0,373,0,6
3456,1,2374,2415,-41,0,2,1,6
3457,1,2592,2691,-99,0,332,0,6
3458,2,2583,2499,84,0,120,0,6
3459,1,2535,2583,-48,0,43,0,6
3460,2,2254,2546,-292,0,4,0,6
3461,3,2453,2398,55,0,426,0,6
3462,2,2468,2276,192,0,107,0,8
3463,3,2435,2444,-9,0,389,0,6
3464,3,2498,2393,105,0,338,0,8
3465,1,2253,2403,-150,0,16,0,6
3466,2,2307,2489,-182,0,43,0,6
3467,2,2548,2628,-80,0,302,1,6
3468,2,2270,2431,-161,0,110,1,6
3469,2,2401,2316,85,0,41,0,6
3470,2,2390,2421,-31,0,140,1,6
3471,1,2463,2521,-58,0,122,0,6
3472,2,2478,2481,-3,0,122,0,6
3473,2,2442,2558,-116,0,414,0,6
3474,1,2763,2519,244,0,405,0,6
3475,1,2412,2346,66,0,310,0,6
3476,2,2409,2365,44,0,101,1,6
3477,1,2346,2461,-115,0,113,0,6
3478,2,2386,2437,-51,0,315,0,6
3479,1,2414,2251,163,0,7,0,6
3480,3,2628,2564,64,0,3,0,6
3481,2,2352,2500,-148,0,103,1,6
3482,1,2401,2317,84,0,106,0,6
3483,2,2409,2455,-46,0,250,0,6
3484,1,2467,2401,66,0,241,0,6
3485,1,2473,2223,250,0,122,0,6
3486,2,2349,2421,-72,0,301,0,6
3487,3,2473,2530,-57,0,80,0,6
3488,1,2591,2406,185,0,112,0,6
3489,1,2422,2413,9,0,352,0,6
3490,1,2339,2417,-78,0,344,1,6
3491,1,2545,2372,173,0,338,0,6
3492,1,2421,2412,9,0,113,0,6
3493,1,2380,2514,-134,0,3,0,6
3494,2,2684,2599,85,0,80,0,6
3495,1,2321,2461,-140,0,41,0,6
3496,1,2592,2419,173,0,123,0,6
3497,1,2557,2248,309,0,4,0,6
3498,1,2562,2483,79,0,110,0,6
3499,2,2576,2542,34,0,45,0,6
3500,3,2594,2465,129,0,200,0,6
3501,2,2313,2475,-162,0,179,0,6
3502,2,2403,2452,-49,0,302,0,6
3503,1,2539,2506,33,0,46,1,6
3504,1,2473,2412,61,0,133,0,6
3505,1,2566,2627,-61,0,306,0,6
3506,1,2514,2490,24,0,21,0,6
3507,1,2435,2439,-4,0,411,1,6
3508,1,2396,2471,-75,0,245,0,6
3509,1,2510,2388,122,0,280,0,6
3510,2,2426,2564,-138,0,265,0,6
3511,2,2245,2421,-176,0,121,1,8
3512,1,2427,2385,42,0,125,0,6
3513,2,2460,2306,154,0,0,0,6
3514,3,2405,2342,63,0,241,0,6
3515,1,2413,2312,101,0,129,0,6
3516,1,2426,2283,143,0,41,0,6
3517,1,2406,2261,145,0,200,0,6
3518,2,2633,2469,164,0,331,0,6
3519,1,2453,2354,99,0,14,0,6
3520,1,2308,2403,-95,0,4,0,6
3521,3,2410,2410,0,0,478,0,6
3522,2,2284,2459,-175,0,40,1,8
3523,1,2450,2526,-76,0,38,0,6
3524,1,2475,2435,40,0,45,1,6
3525,1,2479,2368,111,0,448,0,6
3526,1,2548,2570,-22,0,43,0,6
3527,3,2479,2330,149,0,341,0,6
3528,1,2529,2511,18,0,302,0,6
3529,2,2474,2428,46,0,50,1,6
3530,1,2533,2592,-59,0,80,1,6
3531,1,2493,2223,270,0,31,0,6
3532,2,2606,2677,-71,0,333,0,6
3533,2,2243,2567,-324,0,4,0,6
3534,2,2467,2596,-129,0,300,0,6
3535,1,2396,2539,-143,0,102,0,6
3536,2,2462,2346,116,0,30,0,6
3537,1,2655,2477,178,0,331,0,6
3538,1,2520,2361,159,0,13,0,6
3539,2,2467,2313,154,4,200,0,13
3540,1,2506,2432,74,0,140,0,6
3541,2,2629,2545,84,0,200,0,6
3542,1,2388,2486,-98,0,2,0,6
3543,1,2426,2426,0,0,13,0,6
3544,2,2457,2484,-27,0,21,0,6
3545,1,2572,2700,-128,0,81,0,6
3546,2,2289,2409,-120,0,256,0,6
3547,1,2557,2423,134,0,250,0,6
3548,1,2375,2483,-108,0,84,1,6
3549,1,2371,2417,-46,0,268,0,6
3550,2,2305,2429,-124,0,388,1,6
3551,2,2410,2364,46,0,4,0,6
3552,1,2420,2315,105,0,4,1,6
3553,1,2478,2624,-146,0,122,0,6
3554,1,2640,2649,-9,0,0,0,6
3555,2,2478,2305,173,0,122,0,6
3556,2,2567,2457,110,0,25,0,6
3557,1,2681,2580,101,0,301,0,6
3558,2,2463,2433,30,0,201,0,6
3559,2,2402,2377,25,0,315,0,6
3560,1,2371,2474,-103,0,191,0,6
3561,2,2354,2404,-50,0,248,1,6
3562,1,2453,2329,124,0,41,0,6
3563,1,2692,2396,296,0,210,0,6
3564,2,2442,2452,-10,0,200,1,6
3565,2,2343,2490,-147,0,41,0,6
3566,2,2389,2426,-37,0,241,0,6
3567,1,2500,2464,36,0,337,0,6
3568,2,2314,2479,-165,0,0,0,6
3569,1,2564,2554,10,0,45,0,6
3570,1,2375,2403,-28,0,311,0,6
3571,1,2399,2424,-25,0,104,0,6
3572,2,2430,2341,89,0,310,0,6
3573,2,2569,2506,63,0,260,0,6
3574,1,2469,2332,137,0,300,1,6
3575,2,2223,2554,-331,0,45,0,6
3576,1,2456,2410,46,0,277,0,6
3577,3,2586,2540,46,0,106,0,6
3578,1,2408,2425,-17,0,40,0,6
3579,2,2485,2464,21,0,210,1,6
3580,3,2420,2383,37,0,122,0,6
3581,1,2531,2387,144,0,4,1,6
3582,2,2424,2242,182,0,15,1,8
3583,1,2404,2455,-51,0,107,0,6
3584,2,2435,2310,125,0,157,0,6
3585,2,2523,2622,-99,0,28,0,6
3586,1,2427,2419,8,0,249,0,6
3587,2,2325,2457,-132,0,320,0,6
3588,1,2410,2416,-6,0,242,0,6
3589,2,2576,2685,-109,0,330,1,6
3590,3,2499,2279,220,0,412,0,6
3591,2,2549,2570,-21,0,121,0,6
3592,2,2379,2423,-44,0,203,1,6
3593,2,2348,2511,-163,0,211,0,6
3594,1,2467,2354,113,0,133,1,6
3595,2,2433,2434,-1,0,303,0,6
3596,3,2423,2477,-54,0,327,0,6
3597,2,2616,2486,130,0,300,0,6
3598,1,2448,2411,37,0,30,0,6
3599,3,2462,2239,223,0,107,0,8
3600,3,2560,2694,-134,0,380,0,6
3601,1,2465,2498,-33,0,112,0,6
3602,3,2461,2446,15,4,121,0,13
3603,2,2465,2476,-11,0,110,1,6
3604,1,2644,2646,-2,0,61,0,6
3605,1,2494,2394,100,0,202,0,6
3606,1,2418,2405,13,0,112,1,6
3607,1,2433,2268,165,0,56,1,6
3608,1,2339,2464,-125,0,300,1,6
3609,2,2413,2404,9,0,192,0,6
3610,1,2541,2585,-44,0,59,0,6
3611,2,2461,2322,139,0,107,0,6
3612,1,2435,2374,61,0,150,0,6
3614,3,2326,2450,-124,0,426,0,6
3615,2,2575,2544,31,0,45,0,6
3616,1,2419,2427,-8,0,112,0,6
3617,1,2457,2423,34,0,335,0,6
3618,2,2277,2413,-136,0,43,0,6
3619,1,2402,2264,138,0,312,0,8
3621,2,2439,2419,20,0,414,1,6
3622,1,2451,2260,191,0,123,0,6
3623,1,2418,2462,-44,0,202,0,6
3624,1,2390,2547,-157,0,316,0,8
3625,2,2329,2414,-85,0,201,0,6
3626,2,2420,2268,152,4,270,1,13
3627,1,2397,2401,-4,0,300,0,6
3628,1,2373,2423,-50,0,103,0,6
3629,2,2541,2626,-85,0,100,0,6
3630,1,2470,2493,-23,0,122,0,6
3631,1,2351,2437,-86,0,212,1,6
3632,1,2299,2402,-103,4,16,0,13
3633,1,2504,2464,40,0,386,0,6
3634,2,2269,2402,-133,0,7,0,8
3635,2,2363,2422,-59,0,106,0,6
3636,1,2452,2329,123,0,245,0,6
3637,1,2418,2416,2,0,7,0,6
3638,1,2534,2406,128,0,4,0,6
3640,2,2689,2572,117,0,301,0,6
3641,2,2347,2471,-124,0,184,1,6
3642,2,2350,2498,-148,0,41,0,6
3643,2,2371,2523,-152,0,476,0,6
3644,2,2461,2507,-46,0,13,0,6
3645,3,2408,2448,-40,0,207,0,6
3646,2,2509,2630,-121,0,441,1,6
3647,3,2390,2421,-31,0,2,0,6
3648,1,2378,2428,-50,0,335,0,6
3649,2,2379,2609,-230,0,224,0,6
3650,1,2347,2458,-111,0,45,0,6
3651,2,2579,2547,32,0,106,0,6
3652,2,2410,2328,82,0,28,0,6
3653,2,2399,2456,-57,0,330,0,6
3654,2,2291,2459,-168,0,112,0,8
3655,1,2349,2424,-75,0,4,1,6
3656,1,2405,2461,-56,0,479,0,6
3657,1,2550,2569,-19,0,36,0,6
3658,2,2440,2320,120,0,17,1,6
3659,2,2322,2459,-137,4,280,0,13
3660,1,2629,2692,-63,0,4,0,6
3661,1,2417,2433,-16,0,140,0,6
3662,2,2418,2245,173,0,45,0,6
3663,1,2611,2562,49,0,382,0,6
3664,1,2500,2427,73,0,106,0,6
3665,2,2358,2403,-45,0,100,0,6
3666,2,2416,2391,25,0,196,0,6
3667,1,2452,2289,163,0,146,0,6
3668,1,2410,2376,34,0,4,1,6
3669,1,2514,2501,13,0,131,0,6
3670,1,2471,2424,47,0,202,0,6
3671,2,2292,2406,-114,0,150,0,8
3672,1,2509,2454,55,0,41,0,6
3673,2,2425,2307,118,0,100,0,6
3674,1,2600,2610,-10,0,462,0,6
3675,1,2384,2430,-46,0,211,0,8
3676,3,2502,2512,-10,0,246,0,6
3677,1,2428,2319,109,0,36,1,6
3678,1,2461,2368,93,0,463,0,6
3679,2,2339,2401,-62,0,17,0,6
3680,2,2330,2453,-123,0,50,0,6
3681,3,2292,2422,-130,0,330,0,6
3682,1,2539,2381,158,0,15,0,8
3683,1,2512,2409,103,0,37,0,6
3684,1,2393,2403,-10,0,150,0,6
3685,1,2321,2401,-80,0,8,1,6
3686,2,2649,2682,-33,0,330,1,6
3687,1,2447,2336,111,0,191,0,6
3688,3,2338,2646,-308,4,297,0,18
3689,1,2338,2402,-64,0,1,1,6
3690,2,2554,2573,-19,0,59,0,6
3691,2,2625,2636,-11,0,37,1,6
3692,1,2527,2381,146,0,178,0,6
3693,1,2475,2425,50,0,200,0,6
3694,1,2563,2556,7,0,300,0,6
3695,1,2423,2450,-27,0,330,0,6
3696,2,2421,2350,71,0,45,0,6
3697,2,2253,2410,-157,0,201,0,6
3698,1,2390,2408,-18,0,2,1,6
3699,1,2427,2423,4,0,102,0,6
3700,1,2634,2685,-51,0,7,0,6
3701,1,2405,2242,163,0,227,0,8
3702,1,2332,2451,-119,0,56,0,6
3703,1,2432,2408,24,0,13,0,6
3704,2,2455,2411,44,0,277,0,6
3705,1,2495,2561,-66,0,345,0,6
3706,1,2440,2263,177,4,127,0,13
3707,1,2502,2543,-41,0,107,0,6
3708,3,2444,2374,70,0,151,0,6
3709,1,2358,2409,-51,0,110,0,8
3710,1,2424,2397,27,0,8,0,6
3711,1,2448,2431,17,0,130,0,6
3712,1,2387,2420,-33,0,302,0,6
3713,1,2413,2250,163,0,45,0,6
3714,1,2462,2358,104,0,106,1,8
3715,2,2367,2514,-147,0,65,0,6
3716,2,2405,2334,71,0,241,0,6
3717,1,2444,2315,129,0,123,1,6
3718,2,2465,2364,101,0,306,0,6
3719,3,2354,2433,-79,0,0,0,6
3720,2,2504,2545,-41,0,25,0,6
3721,2,2420,2480,-60,0,45,0,6
3722,1,2578,2548,30,0,106,0,6
3723,1,2476,2427,49,0,131,0,6
3724,1,2339,2421,-82,0,40,0,6
3725,2,2410,2395,15,0,41,0,6
3726,1,2320,2470,-150,0,218,0,6
3727,1,2433,2271,162,0,127,0,6
3728,2,2424,2400,24,0,485,1,6
3729,1,2456,2229,227,0,101,0,6
3730,1,2550,2495,55,0,202,1,6
3731,1,2641,2473,168,0,11,0,6
3732,2,2333,2449,-116,0,246,1,6
3733,1,2687,2644,43,0,107,1,6
3734,2,2417,2432,-15,0,49,0,6
3735,1,2368,2446,-78,0,455,0,6
3736,1,2375,2414,-39,0,113,0,6
3737,1,2531,2400,131,0,101,1,6
3738,1,2492,2226,266,0,0,0,6
3739,2,2402,2396,6,0,210,0,6
3740,1,2678,2667,11,0,120,0,6
3741,1,2580,2569,11,0,43,1,6
3742,1,2455,2333,122,0,45,0,6
3743,2,2554,2700,-146,0,440,0,6
3744,2,2402,2345,57,0,81,1,6
3745,3,2482,2641,-159,0,40,0,6
3746,2,2247,2416,-169,0,201,0,6
3747,1,2458,2321,137,0,110,0,6
3748,1,2620,2403,217,0,15,0,6
3749,1,2517,2363,154,0,302,0,6
3750,1,2438,2412,26,0,123,0,6
3751,2,2308,2421,-113,0,200,0,8
3752,1,2417,2325,92,0,6,0,6
3753,2,2502,2580,-78,0,338,0,6
3754,1,2437,2500,-63,0,45,0,6
3755,2,2485,2416,69,0,211,1,6
3756,1,2354,2443,-89,0,300,0,6
3757,1,2402,2449,-47,0,122,0,6
3758,1,2418,2413,5,0,330,0,6
3759,2,2408,2375,33,0,46,0,6
3760,2,2417,2380,37,0,200,1,6
3761,2,2400,2348,52,0,341,1,6
3762,1,2550,2444,106,0,28,0,6
3763,1,2493,2433,60,0,203,1,6
3764,2,2402,2365,37,0,200,0,8
3765,3,2413,2458,-45,0,310,0,6
3766,3,2703,2662,41,0,106,0,6
3767,2,2455,2448,7,0,100,0,6
3768,2,2358,2508,-150,0,88,1,6
3769,1,2422,2453,-31,0,36,1,6
3770,2,2290,2408,-118,0,101,1,6
3771,2,2458,2447,11,0,405,1,6
3772,1,2543,2583,-40,0,31,0,6
3773,1,2449,2356,93,0,404,0,6
3774,2,2462,2496,-34,0,90,0,6
3775,2,2369,2401,-32,0,247,0,6
3776,1,2598,2684,-86,0,153,0,6
3777,2,2360,2521,-161,0,394,0,6
3778,2,2470,2555,-85,0,124,1,6
3779,2,2389,2404,-15,0,296,0,6
3780,3,2302,2463,-161,4,293,0,13
3781,1,2438,2473,-35,0,418,0,6
3782,2,2437,2422,15,0,131,1,6
3783,2,2519,2476,43,0,254,0,6
3784,1,2396,2453,-57,0,110,1,6
3785,2,2407,2370,37,0,112,0,6
3786,1,2309,2459,-150,0,36,0,6
3787,2,2290,2453,-163,0,255,0,6
3788,3,2639,2692,-53,0,334,0,6
3789,3,2443,2382,61,0,300,0,6
3790,2,2235,2403,-168,0,118,0,6
3791,1,2586,2415,171,0,45,0,6
3792,2,2400,2457,-57,0,241,0,6
3793,2,2393,2420,-27,0,4,0,6
3794,1,2407,2443,-36,0,3,0,6
3795,2,2318,2504,-186,0,145,0,6
3796,2,2410,2440,-30,0,43,0,6
3797,1,2414,2297,117,0,330,0,6
3798,1,2402,2364,38,0,46,0,6
3799,1,2584,2498,86,0,57,0,6
3800,1,2467,2207,260,0,265,0,8
3801,1,2406,2381,25,0,46,0,6
3802,2,2366,2505,-139,0,145,0,6
3803,2,2286,2457,-171,0,101,0,6
3804,2,2391,2501,-110,0,270,0,6
3805,1,2382,2553,-171,0,110,1,6
3806,2,2372,2506,-134,0,338,1,8
3807,2,2376,2444,-68,0,4,0,6
3808,2,2462,2484,-22,0,330,0,6
3809,1,2663,2396,267,0,13,0,6
3810,1,2613,2703,-90,0,45,0,6
3811,2,2484,2453,31,0,483,1,6
3812,2,2447,2428,19,0,107,0,6
3813,1,2563,2471,92,0,300,0,6
3814,1,2365,2439,-74,0,4,1,6
3815,2,2245,2460,-215,4,52,1,11
3816,1,2677,2512,165,0,232,0,6
3817,2,2259,2425,-166,0,40,0,6
3818,1,2414,2332,82,0,4,0,6
3819,2,2407,2419,-12,0,46,0,6
3820,2,2411,2424,-13,0,411,1,6
3821,1,2524,2443,81,0,53,0,6
3822,2,2386,2472,-86,0,250,0,6
3823,1,2691,2640,51,0,301,1,6
3824,1,2365,2407,-42,0,45,0,6
3825,3,2362,2460,-98,0,101,0,6
3826,2,2415,2373,42,0,463,0,6
3827,1,2453,2572,-119,0,135,0,6
3828,2,2400,2238,162,0,263,0,6
3829,2,2316,2493,-177,0,405,0,6
3830,1,2394,2406,-12,0,113,1,6
3831,1,2562,2390,172,0,241,0,6
3832,1,2446,2403,43,0,107,0,6
3833,1,2437,2505,-68,0,4,0,6
3834,2,2459,2228,231,0,101,0,6
3835,1,2403,2264,139,0,310,1,6
3836,3,2449,2622,-173,0,385,0,6
3837,1,2413,2364,49,0,2,1,6
3838,1,2451,2317,134,0,140,1,6
3839,2,2412,2589,-177,0,457,0,6
3840,2,2428,2494,-66,0,313,0,6
3841,1,2346,2411,-65,0,308,0,6
3842,2,2387,2456,-69,0,255,0,6
3843,3,2428,2277,151,0,131,0,6
3844,1,2589,2680,-91,0,387,0,6
3845,1,2428,2256,172,0,300,1,6
3846,3,2365,2434,-69,0,41,0,6
3847,2,2493,2512,-19,0,56,0,6
3848,2,2418,2347,71,0,96,0,6
3849,1,2509,2599,-90,0,174,0,6
3850,2,2498,2444,54,0,140,0,6
3851,2,2457,2286,171,0,260,0,6
3852,1,2316,2431,-115,0,62,0,6
3853,1,2334,2400,-66,0,213,1,6
3854,1,2445,2280,165,0,45,1,6
3855,1,2448,2339,109,0,131,1,6
3856,1,2628,2503,125,0,101,1,6
3857,2,2396,2405,-9,0,30,1,6
3858,1,2370,2551,-181,0,241,0,6
3859,1,2714,2621,93,0,10,1,6
3860,1,2400,2520,-120,0,48,0,6
3861,2,2422,2395,27,0,333,0,6
3862,2,2353,2481,-128,0,0,1,6
3863,2,2269,2418,-149,0,102,1,6
3864,1,2466,2568,-102,0,10,1,6
3865,2,2312,2478,-166,0,110,0,6
3866,1,2364,2402,-38,0,242,0,6
3867,2,2459,2454,5,0,311,0,6
3868,1,2438,2528,-90,0,45,0,6
3869,2,2673,2696,-23,0,130,0,6
3870,2,2398,2451,-53,0,115,0,6
3871,1,2565,2364,201,0,306,1,6
3872,2,2461,2408,53,0,135,0,6
3873,1,2452,2565,-113,0,311,0,6
3874,2,2241,2418,-177,0,118,0,6
3875,2,2465,2481,-16,4,40,0,13
3876,2,2592,2505,87,0,300,1,6
3877,2,2635,2696,-61,0,334,0,6
3878,1,2416,2444,-28,0,335,0,6
3879,2,2531,2420,111,0,140,1,6
3880,2,2383,2409,-26,0,152,0,6
3881,2,2405,2353,52,0,302,1,6
3882,2,2405,2382,23,0,201,1,6
3883,2,2462,2387,75,0,241,0,6
3884,1,2596,2523,73,0,79,0,6
3885,2,2282,2455,-173,0,256,1,6
3886,1,2314,2400,-86,0,463,0,6
3887,2,2455,2400,55,0,245,0,6
3888,1,2400,2443,-43,0,41,0,6
3889,1,2481,2322,159,0,40,0,6
3890,3,2432,2402,30,0,277,0,6
3891,2,2512,2665,-153,0,106,0,6
3892,2,2433,2451,-18,0,4,0,6
3893,1,2498,2551,-53,0,255,0,6
3894,1,2437,2424,13,0,141,0,6
3895,2,2252,2431,-179,0,300,0,6
3896,2,2451,2492,-41,0,102,0,6
3897,1,2668,2488,180,0,57,0,6
3898,1,2430,2424,6,0,406,1,6
3899,2,2429,2405,24,0,43,0,6
3900,1,2577,2460,117,0,121,1,6
3901,1,2560,2512,48,0,110,1,6
3902,3,2357,2453,-96,0,101,0,6
3903,2,2701,2620,81,0,4,0,6
3905,1,2415,2387,28,0,335,0,6
3906,1,2434,2249,185,0,106,0,6
3907,3,2423,2356,67,0,150,0,6
3908,1,2415,2412,3,0,365,1,6
3909,1,2296,2448,-152,0,255,0,6
3910,1,2460,2459,1,0,190,0,6
3911,1,2473,2452,21,0,242,0,6
3912,1,2445,2408,37,0,45,0,6
3913,2,2402,2421,-19,0,484,0,6
3914,1,2560,2475,85,0,300,1,6
3915,3,2347,2417,-70,0,130,0,6
3916,2,2668,2660,8,0,14,0,6
3917,2,2383,2400,-17,0,242,0,6
3918,1,2450,2387,63,0,123,0,6
3919,2,2394,2459,-65,0,106,0,6
3920,2,2420,2578,-158,0,0,1,6
3921,3,2348,2456,-108,0,9,0,6
3922,3,2462,2452,10,0,110,0,6
3923,2,2592,2806,-214,0,125,0,6
3924,1,2401,2223,178,0,241,0,6
3925,1,2507,2238,269,0,16,0,6
3926,1,2406,2244,162,0,40,0,6
3927,2,2521,2694,-173,0,130,0,6
3928,1,2436,2382,54,0,123,0,6
3929,1,2393,2457,-64,0,102,0,6
3930,2,2519,2671,-152,0,110,0,6
3931,1,2567,2485,82,0,458,0,6
3932,2,2428,2406,22,0,284,0,6
3933,2,2507,2585,-78,0,110,0,6
3934,2,2404,2360,44,0,194,0,6
3935,2,2359,2451,-92,0,54,0,6
3936,2,2577,2512,65,0,466,0,8
3937,1,2523,2403,120,0,119,0,6
3938,1,2430,2373,57,4,306,0,11
3939,1,2496,2471,25,4,1,0,13
3940,2,2497,2446,51,0,123,0,6
3941,2,2384,2487,-103,0,5,0,8
3942,1,2412,2410,2,0,113,0,6
3943,2,2365,2401,-36,0,242,1,6
3944,3,2509,2458,51,0,36,0,6
3945,2,2291,2401,-110,0,244,1,6
3946,2,2471,2451,20,0,448,0,6
3947,1,2411,2423,-12,0,40,1,6
3948,1,2350,2470,-120,0,40,1,8
3949,2,2697,2717,-20,0,115,0,6
3950,1,2438,2422,16,0,70,0,6
3951,2,2293,2432,-139,0,106,0,6
3952,1,2427,2421,6,0,4,0,6
3953,1,2246,2437,-191,0,300,0,6
3954,2,2421,2390,31,0,302,0,6
3955,2,2345,2418,-73,0,302,0,6
3956,2,2464,2389,75,0,241,0,6
3957,1,2466,2485,-19,0,112,0,6
3958,1,2507,2662,-155,0,106,0,6
3959,1,2454,2400,54,0,201,0,6
3960,1,2544,2633,-89,0,40,1,6
3961,1,2479,2481,-2,0,101,0,6
3962,2,2399,2423,-24,0,302,0,6
3963,1,2422,2416,6,0,40,0,6
3964,2,2407,2388,19,0,100,0,6
3965,2,2483,2527,-44,0,85,0,6
3966,1,2459,2420,39,0,3,0,6
3967,2,2550,2565,-15,0,313,0,6
3968,1,2420,2398,22,0,5,0,6
3969,1,2590,2485,105,0,45,0,6
3970,1,2674,2556,118,0,337,0,6
3971,2,2376,2515,-139,0,101,0,6
3972,1,2481,2572,-91,0,490,0,6
3973,3,2404,2432,-28,0,46,0,6
3974,2,2496,2503,-7,0,472,0,6
3975,1,2418,2425,-7,0,140,1,6
3976,1,2459,2363,96,0,140,0,6
3977,2,2457,2465,-8,0,485,0,6
3978,2,2394,2437,-43,0,303,1,6
3979,2,2419,2534,-115,0,492,0,6
3980,2,2455,2433,22,0,45,0,6
3981,1,2429,2255,174,0,106,0,6
3982,2,2495,2553,-58,0,245,1,6
3983,2,2452,2491,-39,0,108,0,6
3984,2,2401,2428,-27,0,122,0,6
3985,1,2631,2519,112,0,455,1,6
3986,2,2415,2381,34,0,335,0,6
3987,1,2491,2570,-79,0,140,0,8
3988,3,2359,2464,-105,0,40,0,6
3989,1,2440,2305,135,0,110,0,6
3990,1,2519,2380,139,0,58,1,8
3991,1,2722,2692,30,0,47,0,6
3992,1,2430,2277,153,0,260,0,6
3993,2,2337,2431,-94,0,125,0,6
3994,2,2228,2401,-173,0,123,1,6
3995,2,2654,2430,224,0,1,0,6
3996,1,2478,2401,77,0,302,0,6
3997,2,2334,2406,-72,0,249,1,6
3998,2,2512,2381,131,0,211,1,6
3999,1,2406,2232,174,0,128,0,6
4000,2,2516,2555,-39,0,320,1,6
4001,2,2339,2461,-122,0,246,1,6
4002,2,2553,2678,-125,0,4,0,6
4003,1,2461,2351,110,4,176,0,13
4004,2,2450,2436,14,0,15,0,6
4005,2,2396,2565,-169,0,311,0,6
4006,3,2479,2472,7,0,400,0,6
4007,2,2391,2535,-144,0,81,0,6
4008,2,2439,2466,-27,0,46,1,6
4009,2,2462,2361,101,0,140,0,6
4010,1,2604,2645,-41,0,40,0,6
4011,1,2422,2229,193,0,226,0,6
4012,1,2405,2312,93,0,154,1,6
4013,2,2429,2396,33,0,457,1,6
4014,1,2315,2422,-107,0,8,1,6
4015,1,2570,2545,25,0,300,0,6
4016,2,2452,2440,12,0,40,0,6
4017,2,2386,2478,-92,0,48,0,6
4018,1,2496,2447,49,0,13,0,6
4019,2,2594,2471,123,0,45,0,6
4020,2,2687,2728,-41,0,206,0,6
4021,1,2405,2374,31,0,41,0,6
4022,2,2257,2432,-175,0,13,0,6
4023,3,2402,2417,-15,0,43,0,6
4024,3,2459,2435,24,0,106,0,6
4025,1,2509,2417,92,0,438,0,6
4026,1,2481,2455,26,0,130,1,6
4027,1,2409,2464,-55,0,490,0,6
4028,1,2387,2548,-161,0,127,1,8
4029,1,2435,2307,128,0,253,0,6
4030,2,2252,2432,-180,0,40,0,6
4031,2,2464,2639,-175,0,2,1,6
4032,1,2303,2410,-107,0,337,1,6
4033,2,2260,2416,-156,0,204,0,6
4035,2,2289,2444,-155,0,11,1,6
4036,1,2610,2635,-25,0,386,0,6
4037,2,2439,2449,-10,0,2,0,6
4038,2,2413,2424,-11,0,253,1,6
4039,1,2335,2428,-93,0,315,0,6
4040,1,2733,2682,51,0,46,0,6
4041,1,2396,2444,-48,0,291,0,6
4042,1,2321,2428,-107,0,61,1,6
4043,2,2552,2682,-130,0,46,0,6
4044,1,2526,2402,124,0,13,0,6
4045,2,2442,2389,53,0,45,0,6
4046,3,2463,2357,106,0,190,0,8
4047,3,2415,2456,-41,0,57,0,6
4048,1,2683,2538,145,0,102,0,6
4049,1,2402,2341,61,0,218,0,6
4050,1,2404,2269,135,0,380,0,6
4051,2,2396,2483,-87,0,220,0,6
4052,2,2334,2527,-193,4,46,0,13
4053,1,2549,2421,128,0,30,0,6
4054,2,2581,2586,-5,0,110,1,6
4055,2,2282,2423,-141,0,16,0,6
4056,1,2466,2344,122,0,127,0,6
4057,2,2511,2565,-54,0,380,1,6
4058,1,2459,2315,144,0,123,0,6
4059,1,2568,2393,175,0,337,0,6
4060,1,2430,2504,-74,0,16,0,6
4061,1,2420,2427,-7,0,121,1,6
4062,2,2371,2476,-105,0,211,0,6
4063,1,2273,2433,-160,0,312,0,6
4064,1,2576,2472,104,0,45,0,6
4065,2,2308,2421,-113,0,40,1,6
4066,2,2435,2369,66,0,462,0,6
4067,1,2461,2291,170,4,106,1,13
4068,2,2479,2540,-61,0,80,1,6
4069,1,2488,2392,96,0,133,0,6
4070,2,2301,2444,-143,0,101,1,6
4071,2,2373,2416,-43,0,122,0,6
4072,3,2439,2367,72,0,153,0,6
4073,1,2434,2454,-20,0,55,0,6
4074,2,2563,2227,336,0,469,1,8
4075,2,2433,2382,51,0,233,0,6
4076,1,2535,2488,47,0,31,1,6
4077,1,2446,2392,54,0,440,1,6
4078,3,2305,2411,-106,0,12,0,6
4079,1,2446,2377,69,0,315,0,6
4080,1,2558,2687,-129,0,278,0,6
4081,1,2442,2501,-59,0,45,0,6
4082,1,2536,2686,-150,0,265,0,6
4083,1,2448,2377,71,0,15,0,6
4084,1,2422,2399,23,0,123,0,6
4085,2,2387,2492,-105,0,136,1,6
4086,3,2498,2334,164,0,0,0,8
4087,1,2482,2439,43,0,70,1,6
4088,2,2415,2260,155,0,58,0,6
4089,1,2414,2332,82,0,45,1,6
4090,1,2642,2629,13,0,4,1,6
4091,2,2347,2465,-118,4,245,0,13
4092,2,2627,2617,10,0,45,0,6
4093,1,2448,2440,8,0,45,0,6
4094,2,2396,2435,-39,0,303,0,6
4095,2,2430,2448,-18,0,128,1,6
4096,1,2398,2451,-53,0,3,0,6
4097,2,2298,2402,-104,0,212,1,6
4098,1,2509,2529,-20,0,40,0,6
4099,2,2281,2443,-162,0,102,0,6
4100,1,2411,2461,-50,0,4,0,6
4101,1,2553,2428,125,0,30,0,6
4102,1,2640,2607,33,0,228,0,6
4103,1,2362,2469,-107,0,469,0,6
4104,1,2413,2455,-42,0,58,0,6
4105,1,2475,2592,-117,0,115,0,6
4106,1,2425,2282,143,0,231,0,6
4107,1,2571,2468,103,0,369,1,6
4108,2,2428,2329,99,0,45,0,6
4109,1,2580,2688,-108,0,45,1,6
4110,1,2408,2260,148,0,21,0,8
4111,1,2498,2381,117,0,218,1,6
4112,2,2462,2385,77,0,101,0,6
4113,2,2428,2325,103,0,395,0,6
4114,2,2437,2403,34,0,414,0,6
4115,2,2312,2411,-99,0,242,1,6
4116,2,2224,2402,-178,0,332,0,6
4117,1,2570,2471,99,0,110,0,6
4118,2,2242,2417,-175,0,6,1,6
4119,1,2435,2304,131,0,400,1,6
4120,1,2623,2506,117,0,342,0,6
4122,3,2401,2275,126,0,136,0,6
4123,1,2422,2519,-97,0,140,0,6
4124,1,2359,2461,-102,0,50,0,8
4125,2,2372,2452,-80,0,113,0,6
4126,3,2454,2418,36,0,2,0,6
4127,2,2678,2572,106,0,333,0,6
4128,2,2450,2421,29,0,408,1,6
4129,1,2449,2454,-5,0,46,0,6
4130,1,2447,2424,23,0,415,0,6
4131,1,2457,2370,87,0,153,0,6
4132,2,2459,2321,138,0,101,0,6
4133,2,2444,2548,-104,0,331,0,6
4134,1,2436,2256,180,0,193,0,6
4135,1,2457,2312,145,0,42,1,6
4136,1,2523,2399,124,0,28,0,6
4137,2,2265,2517,-252,0,45,0,6
4138,2,2262,2419,-157,0,100,1,6
4139,1,2447,2349,98,0,18,0,6
4140,2,2567,2370,197,0,200,0,6
4141,1,2600,2645,-45,0,152,0,6
4142,1,2522,2409,113,0,247,1,6
4143,3,2423,2551,-128,0,4,0,6
4144,1,2670,2515,155,0,11,1,6
4145,1,2584,2454,130,0,45,0,6
4146,2,2454,2424,30,0,4,0,6
4147,1,2278,2448,-170,0,234,1,6
4148,2,2270,2440,-170,0,448,0,6
4149,1,2623,2552,71,0,330,0,6
4150,2,2400,2373,27,0,122,1,6
4151,1,2321,2421,-100,0,200,0,6
4152,1,2487,2331,156,0,315,1,6
4153,1,2680,2587,93,0,43,0,6
4154,1,2445,2419,26,0,13,0,6
4155,2,2512,2435,77,0,415,0,6
4156,2,2600,2621,-21,0,302,0,6
4157,2,2439,2259,180,0,143,1,6
4158,2,2467,2574,-107,0,49,0,6
4159,2,2278,2428,-150,0,312,1,6
4160,2,2464,2512,-48,0,30,0,6
4161,2,2421,2358,63,0,400,1,6
4162,2,2395,2502,-107,0,202,0,6
4163,1,2405,2358,47,0,386,0,6
4164,2,2438,2588,-150,0,394,1,6
4165,1,2407,2402,5,0,112,0,6
4166,1,2420,2450,-30,0,40,0,6
4167,2,2347,2451,-104,0,375,1,6
4168,2,2300,2461,-161,0,106,1,6
4169,1,2355,2478,-123,0,40,0,6
4170,1,2323,2490,-167,0,394,0,6
4171,1,2436,2279,157,4,101,1,13
4172,2,2448,2284,164,0,263,0,6
4173,2,2519,2483,36,0,122,1,6
4174,1,2408,2375,33,0,241,0,6
4175,1,2457,2320,137,0,46,1,6
4176,2,2313,2539,-226,0,176,0,6
4177,1,2448,2380,68,0,45,1,6
4178,1,2554,2319,235,0,40,0,8
4179,2,2351,2422,-71,0,115,0,6
4180,2,2427,2422,5,0,100,0,6
4181,3,2540,2544,-4,0,302,0,6
4182,1,2300,2467,-167,4,301,0,13
4183,3,2387,2423,-36,0,45,0,6
4184,1,2461,2441,20,0,132,0,6
4185,1,2455,2330,125,0,45,0,6
4186,2,2548,2628,-80,0,45,0,6
4187,1,2409,2431,-22,0,291,0,6
4188,2,2292,2444,-152,0,101,0,6
4189,2,2488,2329,159,0,40,0,6
4190,2,2348,2410,-62,0,332,0,6
4191,2,2372,2440,-68,0,100,1,6
4192,3,2639,2608,31,0,113,0,6
4193,3,2553,2648,-95,0,40,0,6
4194,1,2431,2405,26,0,203,0,6
4195,2,2448,2348,100,0,4,0,6
4196,1,2509,2674,-165,0,265,0,6
4197,2,2414,2329,85,0,45,0,6
4198,3,2454,2367,87,0,151,0,8
4199,1,2578,2463,115,0,117,0,6
4200,2,2583,2684,-101,0,45,0,6
4201,2,2397,2491,-94,0,487,0,6
4202,3,2480,2367,113,0,470,0,6
4203,2,2517,2512,5,0,13,0,6
4204,1,2470,2459,11,0,1,0,6
4205,3,2447,2288,159,0,100,0,6
4206,2,2269,2451,-182,0,302,0,6
4207,1,2439,2287,152,0,260,0,6
4208,2,2418,2581,-163,0,386,0,6
4209,1,2537,2395,142,0,253,0,8
4210,1,2455,2365,90,0,28,0,6
4211,1,2396,2407,-11,0,353,1,6
4212,1,2458,2344,114,4,381,1,13
4213,3,2411,2310,101,0,0,0,6
4214,2,2436,2466,-30,0,302,1,6
4215,2,2532,2506,26,0,200,0,6
4216,2,2241,2414,-173,0,414,0,6
4217,2,2343,2410,-67,0,300,1,6
4218,2,2297,2440,-143,0,46,1,6
4219,2,2591,2435,156,0,45,1,6
4220,2,2396,2459,-63,0,22,1,6
4221,2,2689,2579,110,0,487,0,6
4222,3,2459,2582,-123,0,46,0,6
4223,2,2460,2426,34,0,413,0,6
4224,1,2414,2431,-17,0,477,0,6
4225,1,2632,2646,-14,0,461,0,6
4226,3,2447,2377,70,0,210,0,6
4227,1,2464,2540,-76,0,103,1,6
4228,2,2336,2407,-71,0,200,0,6
4229,2,2544,2565,-21,0,128,0,6
4230,2,2344,2427,-83,0,230,1,6
4231,2,2459,2287,172,0,28,0,6
4232,1,2444,2367,77,0,335,0,6
4233,2,2666,2626,40,0,463,0,6
4234,2,2436,2510,-74,0,128,1,6
4235,3,2421,2495,-74,0,42,0,6
4236,1,2275,2415,-140,0,242,0,6
4237,2,2361,2428,-67,0,59,0,6
4238,1,2646,2400,246,0,0,0,6
4239,1,2494,2476,18,0,127,0,6
4240,1,2605,2640,-35,0,466,0,6
4241,1,2368,2408,-40,0,106,1,6
4242,1,2415,2441,-26,0,45,0,6
4243,2,2371,2515,-144,0,300,0,6
4244,2,2482,2412,70,0,31,0,6
4245,2,2441,2429,12,0,123,0,6
4246,2,2337,2451,-114,0,102,0,6
4247,1,2541,2452,89,0,178,0,6
4248,1,2346,2416,-70,0,1,0,6
4249,2,2584,2638,-54,0,122,0,6
4250,2,2587,2681,-94,0,440,0,6
4251,2,2443,2272,171,0,210,0,6
4252,3,2434,2369,65,0,153,0,6
4253,2,2414,2284,130,0,131,0,6
4254,2,2489,2511,-22,0,55,0,6
4255,1,2415,2443,-28,0,426,0,6
4256,1,2445,2285,160,0,398,0,6
4257,1,2425,2415,10,0,414,0,6
4258,1,2433,2443,-10,0,415,1,6
4259,2,2293,2454,-161,0,43,1,6
4260,1,2416,2392,24,0,4,0,8
4261,1,2648,2658,-10,0,36,0,6
4262,2,2454,2274,180,0,140,0,6
4263,1,2450,2580,-130,0,4,0,6
4264,2,2471,2431,40,0,45,0,6
4265,1,2379,2409,-30,0,200,0,6
4266,2,2398,2519,-121,0,3,0,6
4267,1,2461,2659,-198,0,45,0,6
4268,1,2415,2343,72,0,466,0,6
4269,1,2512,2526,-14,0,211,0,6
4270,1,2425,2278,147,0,131,1,6
4271,1,2464,2338,126,0,32,1,6
4273,1,2500,2376,124,0,101,1,6
4274,1,2488,2348,140,0,240,0,6
4275,2,2409,2420,-11,0,413,0,6
4276,1,2455,2333,122,0,200,1,6
4277,1,2448,2356,92,0,306,1,6
4278,1,2494,2486,8,0,428,0,6
4279,1,2433,2357,76,0,45,0,6
4280,2,2443,2431,12,0,242,0,6
4281,2,2231,2402,-171,0,13,0,6
4282,2,2371,2442,-71,0,301,0,6
4283,1,2423,2431,-8,0,253,0,6
4284,1,2448,2267,181,0,200,0,6
4285,1,2515,2651,-136,0,151,0,6
4286,1,2535,2388,147,0,48,1,6
4287,2,2274,2402,-128,0,106,0,6
4288,3,2471,2331,140,0,140,0,6
4289,2,2435,2397,38,0,123,0,6
4290,2,2313,2416,-103,0,380,1,6
4291,1,2685,2582,103,0,466,0,6
4292,2,2426,2343,83,0,200,0,6
4293,1,2407,2283,124,0,113,0,6
4294,2,2533,2516,17,0,107,0,6
4295,2,2455,2579,-124,0,101,0,6
4296,3,2270,2518,-248,0,200,0,6
4297,2,2437,2445,-8,0,300,0,6
4298,1,2530,2457,73,0,35,0,6
4299,1,2493,2334,159,0,353,0,6
4300,1,2472,2421,51,0,203,0,6
4301,1,2523,2394,129,0,202,1,6
4302,1,2390,2546,-156,0,130,0,6
4303,1,2567,2435,132,0,141,0,6
4304,2,2491,2395,96,0,127,0,6
4305,2,2437,2465,-28,0,302,1,6
4306,1,2378,2446,-68,0,253,1,6
4307,2,2437,2263,174,0,180,0,6
4308,2,2415,2408,7,0,432,1,6
4309,1,2743,2644,99,0,312,0,6
4310,1,2572,2455,117,0,107,0,6
4311,2,2523,2366,157,0,36,1,6
4312,2,2643,2526,117,0,236,0,6
4313,2,2551,2401,150,0,101,1,6
4314,3,2468,2335,133,0,300,0,6
4315,1,2447,2366,81,0,267,0,6
4316,1,2560,2582,-22,0,394,0,6
4317,2,2260,2439,-179,0,200,1,6
4318,2,2393,2437,-44,0,255,1,6
4319,1,2443,2322,121,0,13,1,6
4320,1,2458,2218,240,0,241,1,6
4321,1,2544,2352,192,0,122,0,6
4322,2,2372,2401,-29,0,4,1,6
4323,1,2256,2406,-150,0,28,0,6
4324,2,2522,2527,-5,0,21,0,6
4325,2,2542,2388,154,0,130,1,8
4326,1,2426,2404,22,0,138,1,6
4327,2,2452,2429,23,0,331,0,6
4328,2,2426,2403,23,0,474,0,6
4329,1,2517,2547,-30,0,402,0,6
4330,2,2398,2499,-101,0,0,0,6
4331,2,2437,2339,98,0,460,1,6
4332,2,2410,2431,-21,0,291,0,6
4333,2,2333,2469,-136,0,106,0,6
4334,1,2514,2480,34,0,258,0,6
4335,2,2365,2476,-111,0,330,0,6
4336,1,2583,2451,132,0,121,0,6
4337,1,2406,2408,-2,0,302,0,6
4338,2,2484,2539,-55,0,345,0,6
4339,1,2350,2419,-69,0,123,0,6
4340,2,2337,2451,-114,0,40,0,6
4341,2,2380,2409,-29,0,106,0,6
4342,1,2229,2528,-299,0,113,0,6
4343,1,2635,2665,-30,0,112,0,6
4344,2,2294,2429,-135,0,10,0,6
4345,1,2402,2484,-82,0,31,0,6
4346,1,2453,2429,24,0,20,0,6
4347,2,2430,2329,101,0,248,0,6
4348,1,2537,2399,138,0,246,0,6
4349,2,2257,2576,-319,0,4,1,6
4350,1,2456,2440,16,0,46,1,6
4351,3,2503,2640,-137,0,344,0,6
4352,2,2715,2747,-32,0,57,0,6
4353,1,2470,2432,38,0,130,0,6
4354,1,2416,2496,-80,0,96,1,6
4355,1,2642,2570,72,0,253,0,6
4356,3,2362,2451,-89,0,305,0,6
4357,2,2469,2414,55,0,151,0,6
4358,1,2390,2534,-144,0,3,1,6
4359,1,2576,2566,10,0,101,0,6
4360,2,2576,2391,185,0,45,0,6
4361,1,2409,2267,142,0,56,0,6
4362,2,2401,2354,47,0,241,0,6
4363,2,2210,2403,-193,4,338,1,13
4364,1,2421,2293,128,0,4,1,8
4365,3,2659,2629,30,0,308,0,6
4366,2,2412,2384,28,0,302,1,6
4367,2,2382,2402,-20,0,300,1,6
4368,2,2290,2447,-157,0,302,1,6
4369,1,2403,2392,11,0,0,0,6
4370,1,2774,2446,328,4,145,1,11
4371,2,2452,2587,-135,0,382,1,6
4372,1,2434,2341,93,4,112,0,13
4374,1,2443,2314,129,0,315,0,6
4375,2,2330,2446,-116,0,101,1,6
4376,1,2448,2435,13,0,330,1,6
4377,1,2406,2339,67,0,0,0,6
4378,2,2224,2451,-227,0,131,0,6
4379,1,2517,2646,-129,0,469,0,6
4380,3,2409,2450,-41,0,337,0,6
4381,2,2524,2566,-42,0,302,1,6
4382,1,2439,2385,54,0,211,0,6
4383,2,2435,2450,-15,0,40,0,6
4384,2,2427,2476,-49,0,302,1,6
4385,1,2463,2307,156,4,112,1,13
4386,1,2421,2398,23,0,460,0,6
4387,1,2520,2431,89,0,253,0,6
4388,2,2450,2363,87,0,289,0,6
4389,3,2347,2400,-53,0,315,0,6
4391,1,2415,2297,118,0,106,1,6
4392,2,2458,2280,178,0,40,0,6
4393,2,2632,2753,-121,0,101,0,6
4394,2,2425,2312,113,0,8,1,6
4395,2,2275,2409,-134,0,200,0,6
4396,1,2442,2411,31,0,242,0,6
4397,3,2255,2409,-154,0,123,0,6
4398,1,2584,2253,331,0,4,0,6
4399,1,2480,2313,167,0,143,0,6
4400,2,2638,2506,132,0,337,0,6
4401,2,2358,2437,-79,0,124,1,6
4402,2,2338,2582,-244,0,138,0,6
4403,2,2525,2515,10,0,487,1,6
4404,2,2244,2447,-203,0,304,1,6
4405,1,2513,2272,241,0,5,0,6
4406,1,2462,2582,-120,0,303,0,6
4407,1,2266,2413,-147,0,35,1,6
4408,1,2435,2459,-24,0,102,0,6
4409,2,2522,2479,43,0,45,0,6
4410,1,2558,2489,69,0,203,0,6
4411,2,2402,2567,-165,0,16,1,6
4412,1,2286,2408,-122,0,30,1,6
4413,3,2451,2447,4,0,246,0,6
4414,2,2395,2541,-146,0,176,0,6
4415,1,2411,2426,-15,0,0,1,6
4416,2,2381,2538,-157,0,305,1,6
4417,3,2339,2468,-129,4,127,0,13
4418,2,2409,2420,-11,0,205,1,6
4419,2,2526,2400,126,0,202,1,6
4420,2,2370,2443,-73,0,0,0,6
4421,1,2436,2404,32,0,414,0,6
4422,1,2455,2515,-60,0,2,0,6
4423,1,2427,2406,21,0,138,1,6
4424,3,2571,2398,173,0,210,0,6
4425,2,2268,2475,-207,0,46,0,6
4426,2,2384,2454,-70,0,389,1,6
4427,1,2591,2450,141,0,101,0,6
4428,1,2456,2429,27,0,100,0,6
4429,3,2524,2527,-3,0,131,0,6
4430,1,2461,2361,100,0,110,0,6
4431,2,2639,2565,74,0,140,0,6
4432,1,2400,2348,52,0,211,1,6
4433,1,2470,2402,68,0,41,0,6
4434,1,2408,2327,81,0,118,0,6
4435,2,2611,2757,-146,0,58,0,6
4436,3,2300,2419,-119,0,106,0,6
4437,1,2405,2273,132,4,310,1,13
4438,2,2380,2432,-52,0,200,0,6
4439,2,2479,2473,6,0,106,1,6
4440,2,2399,2441,-42,0,291,0,6
4441,1,2513,2519,-6,0,101,1,6
4442,1,2405,2444,-39,0,45,0,6
4443,2,2441,2516,-75,0,120,0,6
4444,1,2417,2403,14,0,49,0,6
4446,1,2561,2632,-71,0,45,0,6
4447,1,2659,2440,219,0,113,0,6
4448,3,2486,2572,-86,0,405,0,6
4449,2,2406,2447,-41,0,260,0,6
4450,3,2447,2366,81,0,267,0,6
4451,1,2541,2461,80,0,152,1,6
4452,2,2424,2420,4,0,245,0,6
4453,1,2391,2475,-84,0,22,0,6
4454,2,2403,2327,76,0,150,1,6
4455,2,2249,2592,-343,0,4,0,6
4456,2,2447,2450,-3,0,307,0,6
4457,1,2570,2520,50,0,45,0,6
4458,3,2475,2397,78,0,1,0,6
4459,1,2420,2447,-27,0,454,0,6
4460,1,2297,2425,-128,0,120,0,8
4461,3,2290,2473,-183,4,40,0,0
4462,2,2485,2481,4,0,40,0,6
4463,3,2501,2465,36,0,300,0,6
4464,1,2314,2400,-86,0,106,1,6
4465,3,2515,2435,80,0,306,0,6
4466,1,2459,2449,10,0,111,0,6
4467,2,2408,2469,-61,0,113,0,6
4468,1,2558,2401,157,0,200,0,6
4469,1,2533,2625,-92,0,377,0,6
4470,2,2520,2426,94,0,48,1,6
4471,2,2365,2548,-183,0,200,0,6
4472,1,2397,2568,-171,0,101,0,6
4473,1,2379,2422,-43,0,73,0,6
4474,2,2375,2420,-45,0,201,0,6
4475,1,2594,2679,-85,0,121,0,6
4476,3,2761,2590,171,0,455,0,6
4477,2,2366,2479,-113,0,41,0,6
4478,2,2486,2393,93,0,41,0,6
4479,1,2453,2436,17,0,58,0,6
4480,1,2527,2410,117,0,16,0,6
4481,2,2364,2524,-160,0,211,0,6
4482,2,2400,2378,22,0,40,1,6
4483,2,2389,2411,-22,0,211,0,6
4484,2,2277,2444,-167,0,0,0,6
4485,2,2618,2608,10,0,253,0,6
4486,1,2418,2377,41,0,140,0,6
4487,2,2322,2400,-78,0,125,0,8
4488,2,2474,2559,-85,0,302,0,6
4489,2,2405,2333,72,0,426,1,6
4490,2,2462,2324,138,0,4,1,6
4491,1,2442,2232,210,0,200,0,6
4492,2,2246,2450,-204,0,300,0,6
4493,1,2416,2516,-100,0,409,0,6
4494,2,2336,2409,-73,0,123,1,6
4495,2,2405,2376,29,0,101,0,6
4496,1,2429,2280,149,0,45,0,8
4497,2,2257,2404,-147,0,245,1,6
4498,2,2425,2462,-37,0,44,0,6
4499,1,2418,2566,-148,0,113,0,6
4500,1,2457,2448,9,0,133,0,6
4501,2,2443,2464,-21,0,45,0,6
4502,2,2347,2456,-109,0,1,0,6
4503,2,2487,2504,-17,0,330,1,6
4504,1,2316,2470,-154,0,300,1,6
4505,1,2643,2638,5,0,302,0,6
4506,2,2564,2672,-108,0,45,0,6
4507,2,2403,2514,-111,0,120,0,6
4508,2,2407,2286,121,0,28,1,6
4509,1,2440,2340,100,0,41,0,6
4510,2,2397,2575,-178,0,3,0,6
4511,2,2438,2379,59,0,152,0,6
4512,2,2425,2445,-20,0,55,0,6
4513,1,2402,2331,71,0,122,0,6
4514,2,2426,2601,-175,0,101,1,6
4515,2,2558,2612,-54,0,151,0,6
4516,1,2338,2513,-175,0,320,0,6
4517,3,2313,2416,-103,0,45,0,6
4518,2,2614,2617,-3,0,440,0,6
4519,2,2404,2553,-149,0,106,0,6
4520,1,2571,2549,22,0,142,1,6
4521,2,2297,2454,-157,0,25,0,6
4522,1,2295,2423,-128,0,30,1,6
4523,2,2442,2407,35,0,43,0,6
4524,1,2462,2479,-17,0,216,0,6
4525,1,2432,2340,92,0,45,1,8
4526,1,2468,2313,155,0,81,0,6
4527,1,2433,2513,-80,0,140,1,6
4528,2,2298,2481,-183,0,13,0,6
4529,2,2378,2547,-169,0,41,0,6
4530,2,2338,2419,-81,0,68,0,6
4531,3,2384,2431,-47,0,44,0,6
4532,1,2460,2398,62,0,106,0,6
4533,2,2413,2500,-87,0,202,1,6
4534,2,2483,2468,15,0,45,1,6
4535,1,2483,2579,-96,0,424,0,6
4536,1,2418,2350,68,0,45,0,6
4537,1,2649,2602,47,0,83,0,6
4538,3,2427,2386,41,0,302,0,6
4539,3,2231,2457,-226,0,0,0,6
4540,3,2340,2478,-138,0,14,0,6
4541,2,2394,2654,-260,0,2,0,6
4542,1,2401,2343,58,0,191,0,6
4543,1,2470,2325,145,0,122,0,6
4544,1,2676,2623,53,0,410,0,6
4545,2,2425,2234,191,0,250,1,6
4546,2,2420,2560,-140,0,101,0,6
4547,3,2690,2500,190,0,343,0,6
4548,1,2509,2560,-51,0,315,0,6
4549,1,2556,2399,157,0,0,0,6
4550,1,2441,2346,95,0,402,1,6
4551,1,2266,2423,-157,0,80,0,6
4552,2,2518,2399,119,0,469,1,6
4553,1,2403,2303,100,0,4,0,6
4554,1,2247,2414,-167,0,100,0,6
4555,2,2605,2454,151,0,200,1,6
4556,1,2560,2423,137,0,4,0,6
4557,1,2544,2387,157,0,312,0,6
4558,2,2332,2406,-74,0,4,0,6
4559,1,2407,2411,-4,0,334,1,6
4560,1,2520,2390,130,0,415,0,6
4561,2,2227,2454,-227,0,102,1,6
4562,2,2445,2585,-140,0,4,1,6
4563,3,2347,2521,-174,0,4,0,6
4564,1,2423,2350,73,0,142,1,6
4565,1,2430,2385,45,0,244,0,6
4566,1,2445,2331,114,0,331,0,6
4567,1,2563,2498,65,0,340,0,6
4568,2,2384,2473,-89,0,101,0,6
4569,3,2385,2431,-46,0,324,0,6
4570,2,2354,2465,-111,0,113,0,6
4571,2,2356,2405,-49,0,120,0,8
4572,3,2484,2295,189,0,176,0,6
4573,2,2618,2681,-63,0,120,0,6
4574,2,2656,2417,239,0,10,0,6
4575,1,2727,2608,119,0,49,0,6
4576,1,2450,2346,104,0,9,0,6
4577,1,2513,2392,121,0,40,0,6
4578,2,2402,2349,53,0,100,0,6
4579,1,2415,2297,118,0,45,0,6
4580,2,2436,2506,-70,0,141,0,6
4581,2,2410,2394,16,0,0,0,6
4582,2,2613,2441,172,0,253,0,6
4583,1,2406,2409,-3,0,43,1,6
4584,2,2665,2685,-20,0,128,1,6
4585,2,2457,2420,37,0,46,0,6
4586,3,2473,2494,-21,0,4,0,6
4587,2,2341,2568,-227,0,101,1,6
4588,1,2571,2505,66,0,45,0,6
4589,2,2258,2425,-167,0,200,0,6
4590,1,2558,2317,241,0,123,0,6
4591,1,2438,2321,117,0,206,0,6
4592,2,2417,2783,-366,4,52,0,11
4593,1,2501,2576,-75,0,310,0,6
4594,2,2474,2564,-90,0,115,0,6
4595,1,2420,2449,-29,0,114,0,6
4596,2,2355,2478,-123,0,484,1,6
4597,2,2406,2380,26,0,0,0,6
4598,3,2402,2373,29,0,0,0,6
4599,2,2328,2441,-113,4,0,0,13
4600,2,2492,2451,41,0,200,0,6
4601,1,2403,2336,67,0,263,0,6
4602,2,2445,2322,123,0,45,1,6
4603,1,2543,2389,154,0,40,0,6
4604,1,2449,2386,63,0,414,1,6
4605,1,2416,2283,133,0,242,1,6
4606,1,2605,2538,67,0,104,0,6
4607,1,2493,2336,157,0,121,0,8
4608,2,2435,2361,74,0,241,0,6
4609,3,2307,2561,-254,0,270,0,6
4610,2,2449,2597,-148,0,101,0,6
4611,2,2511,2517,-6,0,45,1,6
4612,2,2378,2406,-28,0,311,0,6
4613,2,2550,2431,119,0,302,0,6
4614,1,2406,2241,165,0,20,0,6
4615,1,2516,2407,109,0,491,0,6
4616,1,2349,2531,-182,0,40,1,6
4617,2,2604,2731,-127,0,335,0,6
4618,1,2747,2647,100,0,10,0,6
4619,2,2335,2442,-107,0,448,0,6
4620,1,2403,2426,-23,0,135,0,6
4621,1,2266,2424,-158,0,127,0,6
4622,2,2403,2246,157,0,49,1,6
4623,2,2462,2569,-107,0,110,0,6
4624,1,2416,2250,166,0,145,1,8
4625,2,2503,2685,-182,0,289,0,6
4626,1,2426,2418,8,0,121,1,6
4627,2,2317,2436,-119,0,53,1,8
4628,1,2520,2384,136,0,300,0,6
4629,2,2331,2412,-81,0,405,1,6
4630,3,2610,2533,77,0,210,0,6
4631,3,2355,2442,-87,0,246,0,6
4632,2,2344,2404,-60,0,25,0,6
4633,1,2643,2539,104,0,0,0,6
4634,3,2428,2291,137,0,150,0,6
4635,1,2509,2338,171,0,5,0,6
4636,1,2456,2257,199,0,150,0,6
4637,2,2229,2441,-212,0,121,0,6
4638,2,2588,2454,134,0,112,0,6
4639,1,2519,2365,154,0,196,0,6
4640,1,2288,2428,-140,0,426,0,6
4641,2,2493,2434,59,0,1,0,6
4642,1,2571,2391,180,0,310,0,6
4643,2,2573,2735,-162,0,45,0,6
4644,1,2353,2433,-80,0,345,0,6
4645,1,2481,2470,11,0,395,1,6
4646,3,2400,2407,-7,0,0,0,6
4647,1,2430,2386,44,0,152,0,6
4648,1,2428,2386,42,0,106,0,6
4649,1,2215,2452,-237,4,245,0,18
4650,1,2432,2286,146,0,300,1,6
4651,1,2600,2457,143,0,101,0,6
4652,1,2380,2454,-74,0,106,0,6
4653,2,2361,2485,-124,0,13,0,6
4654,1,2447,2446,1,0,453,1,6
4655,2,2454,2505,-51,0,4,0,6
4656,2,2551,2405,146,0,200,0,6
4657,2,2306,2457,-151,0,404,0,6
4658,2,2505,2420,85,0,46,0,6
4659,2,2439,2412,27,0,152,1,6
4660,3,2508,2608,-100,0,491,0,6
4661,3,2404,2402,2,0,330,0,6
4662,1,2385,2535,-150,0,3,0,6
4663,1,2508,2401,107,0,302,1,6
4664,2,2366,2454,-88,0,127,0,6
4665,1,2382,2466,-84,0,415,1,6
4666,1,2505,2437,68,0,130,1,6
4667,1,2473,2363,110,0,300,0,6
4669,2,2331,2402,-71,0,278,0,6
4670,2,2253,2426,-173,4,110,0,13
4671,1,2545,2389,156,0,211,0,6
4672,1,2498,2375,123,0,221,0,6
4673,1,2280,2409,-129,0,138,1,6
4674,2,2498,2653,-155,0,106,0,6
4675,1,2384,2574,-190,0,320,0,6
4676,1,2576,2455,121,0,205,1,6
4677,2,2441,2487,-46,0,46,0,6
4678,2,2372,2400,-28,0,106,0,6
4679,2,2247,2416,-169,0,151,1,6
4680,2,2514,2633,-119,0,42,0,6
4681,2,2298,2405,-107,0,40,0,6
4682,2,2351,2497,-146,0,120,0,8
4683,1,2637,2570,67,0,46,0,6
4684,1,2479,2322,157,0,113,0,6
4685,2,2607,2509,98,0,265,0,6
4686,1,2493,2603,-110,0,101,1,6
4687,1,2331,2438,-107,0,253,1,6
4688,1,2475,2363,112,0,354,0,6
4689,1,2407,2279,128,0,110,1,6
4690,1,2304,2400,-96,0,31,0,6
4691,2,2427,2487,-60,0,109,0,6
4692,1,2488,2351,137,0,106,0,6
4693,2,2247,2403,-156,0,112,0,6
4694,2,2498,2433,65,0,45,1,6
4695,2,2515,2403,112,0,211,0,6
4696,1,2366,2435,-69,0,16,0,6
4697,1,2455,2427,28,0,255,0,6
4698,2,2290,2411,-121,0,250,0,6
4699,1,2405,2426,-21,0,302,0,6
4700,1,2527,2402,125,0,6,0,6
4701,1,2440,2452,-12,0,101,0,6
4702,1,2402,2330,72,0,40,0,6
4703,2,2510,2449,61,0,8,0,6
4704,1,2465,2451,14,0,145,0,6
4705,1,2465,2289,176,0,123,0,6
4706,1,2433,2510,-77,0,400,0,6
4707,1,2393,2545,-152,0,3,0,6
4708,1,2440,2300,140,0,80,0,8
4709,3,2343,2513,-170,0,122,0,6
4710,2,2565,2548,17,0,300,0,6
4711,1,2467,2324,143,0,200,1,6
4712,2,2370,2459,-89,0,426,0,6
4713,1,2738,2522,216,0,80,1,6
4714,2,2565,2433,132,0,310,0,6
4715,2,2505,2420,85,0,152,1,6
4716,1,2441,2352,89,0,132,0,6
4717,2,2381,2435,-54,0,324,1,6
4718,3,2467,2336,131,0,131,0,6
4719,2,2230,2512,-282,0,113,1,6
4720,1,2444,2289,155,0,101,1,6
4721,2,2420,2227,193,0,31,0,6
4722,2,2384,2581,-197,0,102,0,6
4723,1,2282,2525,-243,0,300,1,6
4724,2,2344,2459,-115,0,112,0,6
4725,1,2462,2342,120,0,4,1,6
4726,1,2296,2522,-226,0,483,0,6
4727,2,2386,2488,-102,0,300,0,6
4728,2,2319,2482,-163,0,106,0,6
4729,2,2433,2298,135,0,200,0,6
4730,2,2353,2482,-129,0,120,0,6
4731,1,2600,2502,98,0,213,0,6
4732,3,2456,2503,-47,0,374,0,6
4733,2,2447,2426,21,0,4,1,6
4734,1,2460,2621,-161,0,278,1,6
4735,2,2294,2409,-115,0,113,0,6
4736,2,2355,2469,-114,4,229,0,13
4737,2,2405,2387,18,0,304,0,6
4738,1,2630,2544,86,0,337,0,6
4739,2,2401,2362,39,0,46,0,6
4740,1,2458,2436,22,0,112,1,6
4741,2,2461,2397,64,0,46,1,6
4742,3,2420,2495,-75,0,148,0,6
4743,1,2350,2436,-86,0,141,0,6
4744,2,2348,2423,-75,0,131,0,6
4745,1,2415,2422,-7,0,330,0,6
4746,1,2371,2486,-115,0,133,0,6
4747,1,2446,2474,-28,0,40,0,6
4748,1,2548,2492,56,0,265,0,6
4750,2,2436,2389,47,0,250,0,6
4751,2,2446,2517,-71,0,153,1,6
4752,1,2429,2373,56,0,40,0,6
4753,1,2360,2411,-51,0,107,0,6
4754,1,2596,2393,203,0,202,0,6
4755,3,2356,2466,-110,0,101,0,6
4756,2,2338,2430,-92,0,300,0,6
4757,3,2440,2324,116,4,250,0,13
4759,3,2502,2457,45,0,4,0,6
4760,2,2365,2440,-75,0,241,0,6
4761,1,2604,2491,113,0,141,0,6
4762,2,2463,2557,-94,0,311,1,6
4763,2,2452,2481,-29,0,335,0,6
4764,1,2421,2461,-40,0,44,0,6
4765,2,2338,2465,-127,0,158,0,6
4766,2,2409,2470,-61,0,0,0,6
4767,2,2425,2368,57,0,122,0,6
4768,1,2501,2390,111,0,210,0,8
4769,2,2447,2359,88,0,40,0,6
4770,1,2599,2599,0,0,102,0,6
4771,1,2435,2421,14,0,35,1,6
4772,2,2410,2494,-84,0,125,0,6
4773,1,2430,2221,209,4,58,0,13
4774,1,2406,2406,0,0,13,1,6
4775,1,2468,2520,-52,0,110,0,6
4776,2,2307,2446,-139,4,192,0,13
4777,1,2451,2613,-162,0,278,0,6
4778,3,2370,2445,-75,0,250,0,6
4779,1,2634,2420,214,0,41,0,6
4780,1,2409,2334,75,0,6,0,6
4781,1,2469,2457,12,0,124,0,6
4782,1,2404,2535,-131,0,3,0,6
4783,2,2286,2405,-119,0,302,1,6
4784,2,2417,2608,-191,0,0,0,6
4785,2,2488,2622,-134,0,445,1,6
4786,3,2510,2519,-9,0,439,0,6
4787,2,2543,2370,173,0,13,0,6
4788,1,2528,2475,53,0,152,1,6
4789,1,2554,2412,142,0,203,0,6
4790,2,2390,2576,-186,0,404,0,6
4791,1,2521,2441,80,0,269,0,6
4792,2,2440,2454,-14,0,151,0,6
4793,3,2407,2471,-64,0,0,0,6
4794,2,2372,2459,-87,0,46,0,6
4795,2,2245,2599,-354,0,4,0,6
4796,1,2486,2330,156,0,337,0,6
4797,1,2421,2337,84,0,335,0,6
4798,3,2457,2502,-45,0,4,0,6
4799,1,2433,2288,145,0,45,0,6
4800,1,2516,2257,259,0,354,0,6
4801,2,2233,2412,-179,0,230,1,6
4802,1,2583,2376,207,0,218,1,6
4803,3,2513,2234,279,0,142,0,6
4804,3,2514,2447,67,0,13,0,6
4805,2,2463,2291,172,0,150,0,6
4806,1,2466,2306,160,0,268,0,6
4807,2,2303,2432,-129,0,1,0,6
4808,1,2441,2269,172,0,334,0,6
4809,3,2487,2553,-66,0,153,0,6
4810,1,2450,2446,4,0,20,0,6
4811,2,2522,2540,-18,0,45,1,6
4812,1,2493,2395,98,0,0,0,6
4813,1,2386,2432,-46,0,153,0,6
4814,2,2468,2334,134,0,136,0,6
4815,3,2374,2555,-181,0,222,0,6
4816,2,2445,2385,60,0,300,0,6
4817,2,2379,2474,-95,0,142,0,6
4818,2,2307,2403,-96,0,110,0,8
4819,1,2741,2482,259,0,49,0,6
4820,2,2303,2403,-100,0,0,0,6
4821,1,2498,2415,83,0,45,1,6
4822,1,2440,2290,150,0,27,0,6
4823,1,2543,2382,161,0,333,0,6
4824,1,2519,2480,39,0,140,0,6
4825,2,2436,2428,8,0,255,1,6
4826,1,2513,2475,38,0,4,0,6
4827,3,2605,2605,0,0,101,0,6
4828,2,2404,2315,89,0,452,1,6
4829,2,2429,2437,-8,0,104,0,6
4830,2,2287,2444,-157,0,247,0,6
4831,3,2453,2313,140,0,210,0,6
4832,1,2389,2489,-100,0,225,0,6
4833,1,2444,2294,150,0,466,0,6
4834,1,2611,2414,197,0,135,0,6
4835,1,2647,2595,52,0,0,0,6
4836,2,2454,2603,-149,0,3,0,6
4837,1,2534,2455,79,0,354,1,6
4838,1,2606,2242,364,0,4,0,6
4839,1,2407,2299,108,0,102,1,6
4840,1,2524,2441,83,0,202,0,6
4841,1,2381,2456,-75,0,244,0,6
4842,1,2459,2363,96,0,240,0,6
4843,1,2375,2425,-50,0,13,0,6
4844,1,2437,2526,-89,0,246,0,6
4845,1,2558,2484,74,0,394,1,6
4846,2,2391,2497,-106,0,75,1,6
4847,2,2278,2409,-131,4,60,0,13
4848,1,2409,2379,30,0,103,1,6
4849,1,2743,2652,91,0,106,0,6
4850,2,2501,2458,43,0,46,0,6
4852,2,2500,2408,92,0,13,0,6
4853,2,2397,2510,-113,0,123,1,6
4854,2,2426,2372,54,0,315,0,6
4855,1,2443,2422,21,0,341,0,6
4856,1,2533,2613,-80,0,151,0,6
4857,1,2400,2282,118,0,372,1,6
4858,1,2494,2518,-24,0,462,0,6
4859,2,2417,2413,4,0,400,0,6
4860,2,2352,2505,-153,0,130,0,8
4861,2,2297,2400,-103,0,49,0,6
4862,2,2343,2461,-118,0,158,0,6
4863,2,2492,2553,-61,0,101,1,6
4864,2,2448,2470,-22,0,61,1,6
4865,3,2403,2427,-24,0,352,0,6
4866,1,2627,2517,110,0,315,1,6
4867,1,2465,2495,-30,0,134,0,6
4868,2,2400,2435,-35,0,45,1,6
4869,3,2411,2411,0,0,21,0,6
4870,1,2402,2317,85,0,44,0,6
4871,1,2389,2449,-60,0,228,0,6
4872,1,2614,2391,223,0,214,1,6
4873,2,2503,2480,23,0,45,1,6
4874,1,2510,2348,162,0,80,0,6
4875,1,2446,2278,168,0,115,0,6
4876,2,2408,2444,-36,0,270,0,6
4877,3,2607,2450,157,0,80,0,6
4878,2,2488,2471,17,0,45,0,6
4879,2,2545,2528,17,0,101,0,6
4880,2,2436,2605,-169,0,392,0,6
4881,1,2368,2419,-51,0,45,0,6
4882,3,2292,2444,-152,0,106,0,6
4883,1,2284,2402,-118,0,125,0,6
4884,1,2549,2648,-99,0,4,1,6
4885,1,2444,2371,73,0,113,0,6
4886,2,2285,2518,-233,0,8,1,6
4887,2,2346,2455,-109,0,4,0,6
4888,1,2513,2390,123,0,14,0,6
4889,3,2389,2509,-120,0,3,0,6
4890,2,2448,2390,58,0,250,0,6
4891,2,2415,2221,194,0,140,0,6
4892,2,2302,2586,-284,0,320,0,6
4893,2,2328,2469,-141,0,110,0,6
4894,2,2326,2438,-112,4,124,0,13
4895,1,2451,2452,-1,0,132,1,6
4896,2,2427,2316,111,0,112,0,6
4897,1,2387,2475,-88,0,409,0,6
4898,2,2295,2411,-116,0,0,1,6
4899,1,2411,2291,120,0,40,0,6
4900,2,2419,2320,99,0,424,0,6
4901,1,2358,2465,-107,0,80,0,6
4902,1,2451,2479,-28,0,112,1,6
4903,2,2425,2488,-63,0,41,0,6
4904,2,2441,2562,-121,0,250,0,6
4905,2,2448,2463,-15,0,45,0,6
4906,2,2460,2434,26,0,46,0,6
4907,2,2456,2430,26,0,394,1,6
4908,1,2463,2450,13,0,159,1,6
4909,2,2480,2588,-108,0,123,1,6
4910,2,2437,2540,-103,0,272,1,6
4911,2,2335,2431,-96,0,131,0,6
4912,1,2338,2410,-72,0,311,0,6
4913,1,2606,2539,67,0,487,0,6
4914,2,2513,2518,-5,0,302,0,6
4915,1,2408,2265,143,0,343,0,6
4916,2,2420,2263,157,0,415,0,6
4917,1,2557,2487,70,0,7,0,6
4918,1,2404,2336,68,0,0,0,6
4919,1,2340,2454,-114,0,112,0,8
4920,1,2493,2470,23,0,15,0,6
4921,2,2433,2631,-198,0,448,0,6
4922,1,2278,2402,-124,0,46,0,6
4923,2,2418,2487,-69,0,4,1,6
4924,1,2404,2288,116,0,40,1,6
4925,2,2513,2511,2,0,13,0,6
4926,1,2411,2557,-146,0,0,0,6
4927,2,2411,2427,-16,0,460,0,6
4928,3,2486,2496,-10,0,405,0,6
4929,1,2608,2453,155,0,121,0,6
4930,2,2477,2482,-5,0,115,0,6
4931,2,2440,2388,52,0,200,0,6
4932,1,2534,2531,3,0,241,0,6
4933,1,2470,2423,47,0,241,1,6
4934,3,2313,2407,-94,0,387,0,6
4935,3,2493,2420,73,0,153,0,6
4936,2,2437,2616,-179,0,151,0,6
4937,1,2375,2471,-96,0,46,0,8
4938,2,2490,2394,96,0,216,1,6
4939,3,2641,2580,61,0,0,0,6
4940,2,2469,2326,143,0,45,0,6
4941,1,2634,2462,172,0,241,1,6
4942,2,2440,2355,85,0,278,0,6
4943,2,2486,2604,-118,0,414,1,6
4944,2,2396,2534,-138,0,122,1,6
4945,2,2483,2562,-79,0,224,1,6
4946,1,2425,2449,-24,0,258,0,6
4947,2,2426,2286,140,0,301,1,6
4948,2,2482,2527,-45,0,45,0,6
4949,1,2468,2347,121,0,394,1,6
4950,2,2468,2286,182,0,43,0,6
4951,1,2415,2291,124,0,102,1,6
4952,2,2427,2453,-26,0,15,0,6
4953,1,2282,2402,-120,0,211,0,6
4954,2,2508,2458,50,0,43,0,6
4955,2,2395,2412,-17,0,338,0,6
4956,3,2610,2507,103,0,404,0,6
4957,1,2443,2432,11,0,234,0,6
4958,1,2442,2265,177,0,8,0,6
4959,2,2524,2457,67,0,4,0,6
4960,2,2473,2453,20,0,101,0,6
4961,2,2440,2442,-2,0,41,0,6
4962,1,2275,2443,-168,0,106,1,6
4963,1,2433,2406,27,0,171,0,6
4964,2,2619,2592,27,0,140,0,6
4965,1,2445,2549,-104,0,130,0,6
4966,1,2501,2434,67,0,110,1,6
4967,2,2274,2403,-129,0,255,0,6
4968,1,2517,2501,16,0,484,1,6
4969,1,2544,2430,114,0,151,0,6
4970,1,2390,2408,-18,0,100,0,6
4971,1,2294,2426,-132,0,46,0,6
4972,1,2459,2255,204,0,255,0,6
4973,2,2200,2442,-242,0,6,0,6
4974,1,2520,2246,274,0,359,0,6
4975,3,2588,2517,71,0,4,0,6
4976,1,2473,2306,167,0,15,0,6
4977,2,2539,2527,12,0,148,0,6
4978,1,2311,2461,-150,0,20,0,6
4979,1,2488,2471,17,0,39,0,6
4980,1,2419,2328,91,0,202,0,6
4981,1,2332,2444,-112,0,107,0,8
4982,1,2473,2351,122,0,10,0,6
4983,2,2496,2486,10,0,45,1,6
4984,3,2450,2486,-36,0,10,0,6
4985,1,2525,2540,-15,0,101,0,6
4986,2,2438,2613,-175,0,304,0,6
4987,1,2473,2381,92,0,50,0,6
4988,2,2257,2430,-173,0,264,0,5
4989,1,2405,2314,91,0,110,0,6
4990,1,2640,2586,54,0,1,0,6
4991,2,2475,2480,-5,0,292,0,6
4992,2,2401,2397,4,0,415,0,6
4993,1,2453,2284,169,0,40,0,6
4994,2,2608,2609,-1,0,301,0,6
4995,1,2581,2392,189,0,132,0,6
4996,2,2261,2412,-151,0,31,0,6
4997,2,2456,2532,-76,0,414,0,6
4998,1,2459,2376,83,0,150,0,6
4999,1,2637,2450,187,0,128,0,6
5000,2,2567,2478,89,0,101,0,6
5001,1,2360,2412,-52,0,25,0,6
5002,2,2427,2548,-121,0,331,1,6
5003,2,2474,2501,-27,0,483,0,6
5004,1,2465,2469,-4,0,215,1,6
5005,2,2331,2472,-141,0,408,1,6
5006,1,2454,2412,42,0,103,0,6
5007,1,2542,2545,-3,0,302,1,6
5008,1,2483,2302,181,0,120,1,6
5009,1,2250,2417,-167,0,250,0,6
5010,1,2408,2389,19,0,337,0,6
5011,2,2407,2416,-9,0,131,0,6
5012,1,2452,2581,-129,0,463,0,6
5013,1,2410,2249,161,0,121,0,6
5014,1,2426,2448,-22,0,254,0,6
5015,1,2504,2474,30,0,37,0,6
5016,2,2459,2452,7,0,409,0,6
5017,3,2536,2467,69,0,100,0,6
5018,2,2294,2459,-165,0,220,1,6
5019,1,2281,2448,-167,0,125,1,6
5020,1,2433,2305,128,0,152,0,6
5021,1,2407,2284,123,0,315,1,6
5022,1,2634,2534,100,0,337,0,6
5023,1,2472,2505,-33,0,37,0,6
5024,2,2334,2457,-123,0,40,0,6
5025,1,2556,2429,127,0,6,0,6
5026,2,2402,2314,88,0,70,0,6
5027,2,2457,2616,-159,0,430,0,6
5028,2,2367,2427,-60,0,311,0,6
5029,2,2401,2312,89,0,106,0,6
5030,2,2464,2611,-147,0,101,1,6
5031,2,2232,2402,-170,0,45,1,6
5032,1,2406,2396,10,0,127,1,6
5033,2,2366,2405,-39,0,92,0,6
5034,2,2422,2492,-70,0,302,0,6
5035,3,2347,2418,-71,0,1,0,6
5036,1,2437,2343,94,0,300,1,8
5037,3,2479,2370,109,0,36,0,6
5038,3,2466,2494,-28,0,134,0,6
5039,1,2435,2464,-29,0,241,0,6
5040,1,2492,2490,2,0,405,1,6
5041,1,2466,2448,18,0,8,0,6
5042,2,2374,2422,-48,0,216,0,6
5043,2,2458,2620,-162,0,45,0,6
5044,2,2454,2453,1,0,28,0,6
5045,2,2362,2476,-114,0,40,0,6
5046,1,2507,2413,94,0,46,1,6
5047,2,2377,2470,-93,0,112,0,6
5048,3,2413,2387,26,0,372,0,6
5049,1,2584,2478,106,0,200,0,6
5050,1,2441,2470,-29,0,380,0,6
5051,1,2552,2423,129,0,201,1,6
5052,1,2416,2258,158,0,343,0,6
5053,2,2389,2454,-65,0,201,0,6
5054,2,2447,2317,130,0,27,1,6
5055,1,2383,2538,-155,0,112,0,6
5056,2,2623,2472,151,0,253,0,6
5057,1,2625,2517,108,0,255,0,6
5058,1,2401,2411,-10,0,15,0,6
5059,1,2446,2441,5,0,4,0,6
5061,1,2515,2515,0,0,0,1,6
5062,1,2407,2283,124,0,492,0,6
5063,2,2659,2426,233,0,244,0,6
5064,3,2385,2560,-175,0,152,0,6
5065,2,2448,2445,3,0,466,0,6
5066,1,2463,2615,-152,0,196,0,6
5067,1,2436,2299,137,0,190,1,6
5068,1,2603,2573,30,0,45,0,6
5069,1,2440,2289,151,0,40,0,6
5070,2,2394,2444,-50,0,3,1,6
5071,1,2409,2248,161,0,291,0,6
5072,2,2303,2587,-284,0,300,1,6
5073,1,2305,2522,-217,0,331,0,6
5074,1,2518,2462,56,0,373,0,6
5075,2,2355,2476,-121,0,113,0,6
5076,2,2324,2441,-117,0,255,1,6
5077,1,2449,2546,-97,0,246,1,6
5078,2,2409,2345,64,0,424,0,6
5079,2,2542,2477,65,0,106,0,6
5080,2,2211,2419,-208,0,125,1,6
5082,2,2430,2548,-118,0,89,1,6
5083,1,2434,2459,-25,0,478,0,6
5084,1,2330,2485,-155,0,40,0,6
5085,2,2540,2468,72,0,327,0,6
5086,3,2410,2371,39,0,205,0,6
5087,2,2323,2471,-148,0,2,0,6
5088,3,2607,2645,-38,0,40,0,6
5089,1,2410,2384,26,0,245,0,6
5090,1,2447,2485,-38,0,463,0,6
5091,2,2332,2477,-145,0,336,0,6
5092,2,2302,2413,-111,0,200,1,6
5093,1,2404,2258,146,0,389,0,6
5094,2,2480,2615,-135,0,49,1,6
5095,1,2433,2297,136,0,289,0,5
5096,2,2451,2475,-24,0,205,0,6
5097,2,2299,2411,-112,0,224,1,6
5098,1,2389,2421,-32,0,57,0,6
5099,1,2480,2305,175,0,123,0,6
5100,2,2414,2588,-174,0,43,1,6
5101,2,2463,2406,57,0,100,0,6
5102,2,2416,2268,148,0,256,1,6
5103,2,2379,2415,-36,0,405,0,6
5104,2,2615,2601,14,0,122,0,6
5105,1,2460,2460,0,0,112,0,6
5106,1,2374,2437,-63,0,60,1,6
5107,1,2615,2474,141,0,218,1,6
5108,1,2304,2432,-128,0,15,1,6
5109,1,2391,2550,-159,0,106,1,6
5110,2,2295,2472,-177,0,151,0,6
5111,1,2443,2470,-27,0,386,0,6
5112,3,2344,2505,-161,0,327,0,6
5113,2,2414,2475,-61,0,265,0,6
5114,1,2373,2448,-75,0,207,1,6
5117,1,2485,2498,-13,0,45,0,6
5118,3,2355,2406,-51,0,1,0,6
5119,2,2409,2385,24,0,103,0,6
5120,2,2459,2511,-52,0,45,0,6
5121,2,2405,2376,29,0,200,0,6
5122,1,2208,2403,-195,0,3,0,8
5123,1,2484,2535,-51,0,49,0,6
5124,1,2634,2530,104,0,110,1,6
5125,1,2418,2443,-25,0,125,0,6
5126,3,2558,2608,-50,0,176,0,6
5127,1,2464,2408,56,0,49,0,6
5128,2,2476,2449,27,0,311,1,6
5129,2,2547,2519,28,0,107,0,6
5130,1,2372,2415,-43,0,46,1,6
5131,2,2375,2439,-64,0,300,0,6
5132,1,2417,2392,25,0,45,0,6
5133,1,2442,2303,139,0,311,0,6
5135,3,2407,2257,150,0,32,0,6
5136,2,2477,2338,139,0,140,0,6
5137,1,2452,2413,39,0,265,1,6
5138,3,2445,2449,-4,0,242,0,6
5139,2,2255,2419,-164,0,46,0,6
5140,2,2391,2403,-12,0,226,1,6
5141,1,2475,2457,18,0,49,1,6
5142,2,2302,2437,-135,0,115,1,6
5143,1,2413,2411,2,0,241,0,6
5144,1,2480,2445,35,0,476,0,6
5145,1,2403,2483,-80,0,142,0,6
5146,2,2455,2644,-189,0,100,1,6
5147,3,2629,2372,257,0,125,0,6
5148,1,2305,2404,-99,0,292,0,6
5149,1,2607,2534,73,0,307,0,6
5150,1,2477,2619,-142,0,4,0,6
5151,3,2479,2395,84,0,241,0,6
5152,3,2347,2489,-142,0,332,0,6
5153,1,2410,2395,15,0,7,0,6
5154,2,2415,2399,16,0,484,0,6
5155,2,2291,2459,-168,4,302,0,13
5156,1,2593,2609,-16,0,404,0,6
5157,1,2340,2423,-83,0,382,1,6
5158,2,2552,2747,-195,0,110,0,6
5159,1,2466,2381,85,0,150,1,6
5160,2,2446,2419,27,0,332,0,6
5161,1,2453,2441,12,0,277,1,6
5162,1,2483,2457,26,0,418,1,6
5163,2,2412,2449,-37,0,0,1,6
5164,2,2405,2373,32,0,252,0,6
5165,1,2415,2298,117,0,80,0,6
5166,2,2387,2639,-252,0,404,0,6
5167,1,2497,2453,44,0,128,0,6
5168,1,2611,2524,87,0,207,0,6
5169,2,2432,2409,23,0,21,0,6
5171,2,2268,2410,-142,0,34,0,6
5172,2,2487,2497,-10,0,102,0,6
5173,1,2435,2411,24,0,133,1,6
5174,1,2464,2242,222,0,106,0,6
5175,1,2406,2469,-63,0,221,0,6
5176,2,2463,2379,84,0,107,0,6
5177,2,2235,2408,-173,0,45,0,6
5178,2,2492,2491,1,0,122,0,6
5179,2,2542,2458,84,0,469,0,6
5180,1,2303,2441,-138,0,107,0,8
5181,3,2626,2411,215,0,247,0,6
5182,2,2399,2441,-42,0,217,0,6
5183,3,2467,2493,-26,0,4,0,6
5184,2,2318,2442,-124,0,453,1,6
5185,1,2516,2356,160,0,302,0,6
5186,2,2638,2527,111,0,206,1,6
5187,1,2509,2503,6,0,0,1,6
5188,3,2690,2558,132,0,336,0,6
5189,1,2437,2612,-175,0,402,0,6
5190,3,2529,2491,38,0,374,0,6
5191,2,2426,2499,-73,0,112,0,6
5192,3,2430,2381,49,0,7,0,6
5193,1,2414,2265,149,0,57,0,6
5194,1,2425,2417,8,0,190,0,6
5195,1,2470,2431,39,0,45,0,6
5196,2,2425,2409,16,0,441,0,6
5197,2,2406,2370,36,0,241,0,6
5198,1,2455,2476,-21,0,50,0,6
5199,1,2615,2600,15,0,106,1,6
5200,3,2419,2445,-26,0,485,0,6
5201,2,2263,2459,-196,0,230,1,6
5202,3,2433,2519,-86,0,6,0,6
5203,2,2440,2485,-45,0,205,0,6
5204,1,2422,2300,122,0,300,0,6
5205,3,2344,2540,-196,0,132,0,6
5206,1,2451,2378,73,0,4,0,6
5207,1,2451,2421,30,0,153,0,6
5208,2,2525,2617,-92,0,485,1,6
5209,1,2369,2444,-75,0,300,0,6
5210,1,2433,2271,162,0,129,0,6
5211,1,2385,2549,-164,0,201,1,6
5212,1,2427,2305,122,4,121,0,13
5213,1,2364,2519,-155,0,16,1,6
5214,1,2481,2406,75,0,343,0,6
5215,2,2329,2418,-89,0,42,0,6
5216,1,2437,2324,113,0,130,0,5
5217,2,2433,2257,176,0,40,0,8
5218,1,2647,2385,262,0,1,0,6
5219,2,2299,2420,-121,0,292,0,6
5220,1,2497,2486,11,0,241,0,6
5221,1,2603,2452,151,0,112,0,6
5222,1,2485,2350,135,0,80,0,6
5223,1,2254,2402,-148,0,107,0,6
5224,1,2407,2396,11,0,0,0,6
5225,2,2368,2519,-151,0,106,0,6
5226,2,2488,2339,149,0,57,0,6
5227,2,2452,2419,33,0,167,1,6
5228,1,2497,2414,83,0,1,0,6
5229,1,2485,2576,-91,0,8,0,6
5230,1,2480,2371,109,0,111,0,6
5231,2,2513,2461,52,0,344,0,6
5232,1,2408,2281,127,0,319,0,6
5233,2,2427,2457,-30,0,15,0,6
5234,1,2446,2394,52,0,466,0,6
5235,2,2491,2528,-37,0,101,0,6
5236,2,2422,2382,40,0,324,1,6
5237,2,2498,2618,-120,0,327,0,6
5238,1,2492,2467,25,0,434,0,6
5239,1,2477,2298,179,0,119,0,6
5240,1,2445,2516,-71,0,264,0,6
5241,3,2404,2270,134,0,77,0,6
5242,1,2426,2471,-45,0,4,1,6
5243,1,2263,2404,-141,0,200,0,6
5244,2,2367,2484,-117,0,77,0,6
5245,1,2641,2535,106,0,311,1,6
5246,2,2326,2425,-99,0,300,1,6
5247,2,2286,2446,-160,0,125,0,6
5248,1,2470,2308,162,0,118,0,6
5249,1,2386,2436,-50,0,0,0,6
5250,1,2481,2504,-23,0,115,0,6
5251,1,2446,2560,-114,0,6,1,6
5252,1,2454,2423,31,0,300,1,6
5253,3,2407,2451,-44,0,52,0,6
5254,2,2448,2558,-110,0,463,0,6
5255,1,2607,2444,163,0,265,1,6
5256,2,2401,2269,132,0,302,0,6
5257,1,2490,2435,55,0,455,0,6
5258,1,2404,2345,59,0,103,0,6
5259,1,2448,2453,-5,0,330,0,6
5260,1,2415,2413,2,0,70,0,6
5261,2,2630,2621,9,0,190,0,6
5262,1,2365,2417,-52,0,202,1,6
5263,1,2445,2604,-159,0,190,1,6
5264,2,2522,2485,37,0,37,0,6
5265,2,2414,2480,-66,0,216,0,6
5266,3,2419,2351,68,0,466,0,6
5267,2,2408,2260,148,0,143,0,6
5268,1,2516,2503,13,0,0,0,6
5269,1,2353,2442,-89,0,115,0,6
5270,3,2533,2489,44,0,14,0,6
5271,2,2408,2394,14,0,200,0,6
5272,2,2434,2518,-84,0,358,0,6
5273,1,2481,2502,-21,0,405,0,6
5274,2,2465,2649,-184,0,40,0,6
5275,1,2468,2475,-7,0,414,1,6
5276,3,2417,2313,104,0,1,0,6
5277,2,2507,2679,-172,0,331,0,6
5278,1,2281,2446,-165,0,466,0,6
5279,1,2535,2513,22,0,218,0,6
5280,2,2401,2303,98,0,224,0,6
5281,2,2473,2407,66,0,4,0,6
5282,2,2464,2467,-3,0,140,0,6
5283,2,2357,2485,-128,0,203,0,6
5284,2,2569,2492,77,0,267,0,6
5285,1,2414,2394,20,0,120,1,6
5286,1,2374,2417,-43,0,45,0,8
5287,2,2371,2425,-54,0,45,0,6
5288,2,2365,2488,-123,0,154,0,6
5289,2,2448,2346,102,0,15,0,6
5290,2,2411,2435,-24,0,277,0,6
5291,2,2425,2627,-202,0,347,1,6
5292,1,2400,2445,-45,0,196,1,6
5293,1,2442,2325,117,0,57,0,6
5294,2,2398,2506,-108,0,140,1,6
5295,2,2429,2340,89,0,176,0,6
5296,2,2404,2399,5,0,40,0,6
5297,1,2403,2393,10,0,56,0,6
5298,2,2400,2376,24,0,300,1,6
5299,2,2433,2403,30,0,121,0,6
5300,2,2470,2528,-58,0,300,0,6
5301,1,2426,2348,78,0,300,0,6
5302,1,2500,2395,105,0,453,1,6
5303,3,2382,2429,-47,0,1,0,6
5304,1,2433,2201,232,0,4,0,6
5305,1,2488,2362,126,0,111,0,6
5306,2,2478,2393,85,0,242,1,6
5307,2,2526,2418,108,0,46,0,6
5308,2,2407,2389,18,0,0,1,6
5309,1,2462,2498,-36,0,337,0,6
5310,2,2368,2462,-94,0,469,1,6
5311,2,2492,2652,-160,0,106,1,6
5312,2,2347,2506,-159,0,464,1,8
5313,1,2474,2365,109,0,226,0,6
5314,3,2537,2430,107,0,253,0,6
5315,1,2449,2282,167,0,40,0,6
5316,1,2455,2622,-167,0,150,0,6
5317,3,2346,2623,-277,0,312,0,6
5318,1,2531,2361,170,0,335,1,6
5319,3,2463,2273,190,0,106,0,6
5320,1,2450,2561,-111,0,306,0,6
5321,1,2422,2412,10,0,15,0,6
5322,1,2367,2421,-54,0,244,0,6
5323,2,2682,2504,178,0,345,1,6
5324,2,2459,2285,174,0,101,1,6
5325,2,2423,2264,159,0,406,0,6
5326,3,2491,2400,91,0,268,0,6
5327,1,2464,2255,209,0,0,0,8
5328,1,2591,2610,-19,0,101,1,6
5329,1,2417,2467,-50,0,112,0,6
5330,2,2462,2645,-183,0,338,1,6
5331,2,2422,2446,-24,0,278,0,6
5332,2,2266,2425,-159,0,107,1,8
5333,1,2546,2440,106,0,245,0,6
5334,3,2543,2444,99,0,128,0,6
5335,2,2516,2523,-7,0,265,0,6
5336,1,2411,2321,90,0,46,0,6
5337,1,2595,2430,165,0,412,0,6
5338,1,2411,2216,195,0,122,0,6
5339,2,2521,2435,86,0,0,1,6
5340,3,2496,2487,9,0,241,0,6
5341,1,2562,2448,114,0,400,0,6
5342,1,2375,2420,-45,0,219,0,6
5343,1,2419,2353,66,0,46,0,6
5344,2,2432,2394,38,0,8,0,6
5345,2,2492,2468,24,0,311,0,6
5346,2,2489,2408,81,0,455,0,6
5347,2,2429,2296,133,0,303,0,6
5349,2,2489,2363,126,0,51,1,6
5350,1,2474,2507,-33,0,53,0,6
5351,2,2358,2491,-133,0,43,0,6
5352,2,2473,2407,66,0,474,0,6
5353,1,2426,2405,21,0,40,1,6
5354,2,2562,2460,102,0,112,0,6
5355,1,2465,2499,-34,0,225,1,6
5356,2,2414,2310,104,0,404,0,6
5357,1,2540,2465,75,0,210,0,6
5359,1,2374,2406,-32,0,120,1,6
5360,1,2240,2417,-177,0,417,0,6
5361,2,2629,2451,178,0,253,0,6
5362,2,2409,2401,8,0,311,0,6
5363,1,2298,2404,-106,0,210,1,6
5364,1,2423,2433,-10,0,406,0,6
5365,1,2279,2452,-173,0,125,0,6
5366,3,2299,2499,-200,0,327,0,6
5367,3,2279,2416,-137,0,15,0,6
5368,2,2399,2428,-29,0,107,0,8
5369,1,2466,2328,138,0,335,0,6
5370,1,2409,2386,23,0,176,0,6
5371,1,2576,2688,-112,0,28,1,6
5372,1,2439,2427,12,0,132,0,6
5373,2,2441,2219,222,0,22,0,5
5374,2,2438,2456,-18,0,106,1,6
5375,2,2518,2502,16,0,0,1,6
5376,2,2277,2424,-147,0,7,0,6
5377,1,2489,2515,-26,0,140,0,6
5378,3,2614,2655,-41,0,106,0,6
5379,2,2375,2409,-34,0,1,0,6
5380,2,2461,2463,-2,0,45,0,6
5381,2,2498,2496,2,0,8,0,6
5382,1,2458,2545,-87,0,15,1,6
5383,2,2466,2317,149,0,45,0,6
5384,2,2248,2401,-153,0,100,0,6
5385,2,2341,2416,-75,0,106,1,6
5386,2,2400,2395,5,0,487,0,6
5387,2,2423,2280,143,0,106,0,6
5388,1,2480,2616,-136,0,197,0,6
5389,1,2457,2478,-21,0,40,0,6
5390,1,2405,2340,65,0,335,0,6
5391,2,2441,2353,88,0,172,0,6
5392,2,2501,2534,-33,0,106,1,6
5393,2,2344,2467,-123,0,326,1,6
5394,2,2416,2482,-66,0,302,1,6
5395,1,2594,2599,-5,0,330,0,6
5396,1,2475,2485,-10,0,200,0,6
5397,1,2436,2621,-185,0,190,0,6
5398,3,2460,2308,152,0,110,0,6
5399,2,2350,2404,-54,0,218,1,6
5400,2,2524,2451,73,0,300,0,6
5401,1,2510,2252,258,0,44,0,8
5402,2,2414,2381,33,0,129,0,6
5403,2,2441,2422,19,0,332,1,6
5404,2,2401,2395,6,0,0,0,6
5405,2,2353,2486,-133,0,101,0,6
5406,1,2459,2345,114,0,48,0,6
5407,1,2349,2414,-65,0,40,0,6
5408,2,2487,2496,-9,0,337,0,6
5409,1,2481,2400,81,0,308,0,6
5410,1,2415,2442,-27,0,194,0,6
5411,2,2528,2512,16,0,345,0,6
5412,1,2415,2280,135,0,45,0,6
5413,3,2502,2271,231,0,30,0,6
5414,1,2492,2499,-7,0,1,0,6
5415,1,2444,2566,-122,0,194,0,6
5416,2,2383,2555,-172,0,45,0,6
5417,1,2433,2393,40,0,300,0,8
5418,2,2613,2709,-96,0,112,0,6
5419,1,2458,2372,86,0,41,1,6
5420,1,2325,2407,-82,0,247,0,6
5421,2,2434,2495,-61,0,250,0,6
5422,1,2400,2395,5,0,45,0,6
5423,2,2401,2403,-2,0,405,0,6
5424,3,2498,2406,92,0,13,0,6
5425,1,2267,2411,-144,0,123,1,8
5426,3,2432,2415,17,0,254,0,6
5427,3,2407,2442,-35,0,40,0,6
5428,1,2400,2223,177,0,0,0,6
5429,2,2433,2469,-36,0,101,0,6
5430,1,2402,2270,132,0,350,0,6
5431,1,2568,2468,100,0,4,0,6
5432,1,2493,2498,-5,0,7,0,6
5433,2,2472,2436,36,0,107,1,6
5434,1,2388,2471,-83,0,122,0,6
5435,1,2487,2368,119,0,199,0,6
5436,2,2445,2604,-159,0,101,1,6
5437,3,2380,2536,-156,0,344,0,6
5438,2,2247,2418,-171,0,203,0,6
5439,1,2390,2406,-16,0,0,0,6
5441,1,2351,2400,-49,0,45,1,6
5442,2,2246,2400,-154,0,100,0,6
5443,2,2357,2405,-48,0,65,0,6
5444,1,2550,2429,121,0,201,0,6
5445,1,2458,2407,51,0,324,0,6
5446,2,2470,2463,7,0,365,0,6
5447,2,2276,2460,-184,0,45,1,6
5448,3,2409,2502,-93,0,65,0,6
5449,1,2409,2498,-89,0,100,0,6
5450,3,2493,2497,-4,0,327,0,6
5451,1,2674,2656,18,0,80,1,6
5452,1,2444,2288,156,0,40,1,6
5453,3,2415,2495,-80,0,46,0,6
5454,1,2408,2313,95,0,190,0,6
5455,2,2356,2493,-137,0,57,0,6
5456,1,2277,2491,-214,0,154,0,6
5457,1,2583,2608,-25,0,10,0,6
5458,1,2559,2368,191,0,113,0,6
5459,2,2655,2597,58,0,0,0,6
5460,1,2714,2602,112,0,380,0,6
5461,2,2250,2512,-262,0,101,0,8
5462,2,2422,2435,-13,0,125,0,6
5463,2,2538,2465,73,0,152,0,6
5464,2,2469,2455,14,0,110,0,6
5465,2,2593,2680,-87,0,398,0,6
5466,1,2432,2207,225,0,244,0,8
5467,2,2353,2411,-58,0,1,0,6
5468,3,2371,2477,-106,0,112,0,6
5469,2,2515,2609,-94,0,491,1,6
5470,2,2466,2528,-62,0,180,0,6
5471,1,2496,2486,10,0,40,0,6
5472,1,2558,2379,179,0,241,0,6
5473,1,2352,2419,-67,0,190,0,6
5474,2,2336,2429,-93,0,190,0,6
5475,1,2500,2428,72,0,248,0,6
5476,2,2251,2414,-163,0,0,0,6
5477,1,2411,2406,5,0,118,1,6
5478,1,2539,2425,114,0,426,0,6
5479,3,2410,2251,159,0,330,0,8
5480,1,2413,2466,-53,0,61,1,6
5481,2,2480,2481,-1,0,109,0,6
5482,2,2446,2461,-15,0,484,0,6
5483,1,2444,2502,-58,0,147,0,6
5484,3,2600,2582,18,0,303,0,6
5485,2,2293,2432,-139,0,20,0,5
5486,1,2410,2360,50,0,0,0,6
5487,1,2295,2403,-108,0,302,1,6
5488,1,2400,2354,46,0,394,0,6
5489,2,2332,2406,-74,0,112,0,6
5490,2,2518,2598,-80,0,80,0,6
5491,2,2461,2572,-111,0,5,0,6
5492,1,2412,2339,73,0,176,0,6
5493,2,2360,2407,-47,0,75,0,6
5494,2,2416,2498,-82,0,103,0,6
5495,1,2522,2413,109,0,474,0,6
5496,1,2598,2615,-17,0,101,0,6
5497,2,2426,2333,93,0,45,0,6
5498,2,2526,2408,118,0,118,0,6
5499,1,2497,2304,193,0,302,0,6
5500,1,2395,2463,-68,0,226,0,6
5501,2,2356,2401,-45,0,0,0,6
5502,1,2410,2365,45,0,426,0,6
5503,2,2442,2409,33,0,415,0,6
5504,2,2466,2322,144,0,70,0,6
5505,1,2492,2401,91,0,234,0,6
5506,2,2435,2394,41,0,106,1,6
5507,2,2531,2426,105,0,151,0,6
5508,1,2499,2472,27,0,4,1,6
5509,2,2400,2396,4,0,48,0,6
5510,3,2420,2386,34,0,50,0,6
5511,2,2607,2600,7,0,106,1,6
5512,2,2410,2327,83,0,57,0,6
5513,3,2403,2429,-26,0,484,0,6
5514,1,2492,2201,291,0,43,0,6
5515,2,2464,2388,76,0,486,0,6
5516,2,2337,2426,-89,0,5,0,6
5517,2,2299,2403,-104,0,228,0,6
5518,2,2469,2493,-24,0,46,0,6
5519,1,2530,2442,88,0,251,0,6
5520,1,2635,2525,110,0,490,0,6
5521,1,2420,2324,96,0,487,0,6
5522,1,2609,2543,66,0,142,1,6
5523,2,2443,2508,-65,0,484,1,6
5524,2,2416,2432,-16,0,406,0,6
5525,1,2604,2495,109,0,131,0,6
5526,1,2278,2440,-162,4,394,0,13
5527,2,2415,2513,-98,0,3,0,6
5528,2,2421,2252,169,0,466,0,6
5529,1,2474,2367,107,0,284,0,6
5530,3,2376,2561,-185,0,45,0,6
5531,2,2469,2416,53,0,45,0,6
5532,1,2341,2437,-96,0,0,0,6
5533,1,2284,2447,-163,0,125,1,6
5534,1,2386,2428,-42,0,101,0,6
5535,1,2650,2505,145,0,241,0,6
5536,2,2532,2576,-44,0,326,1,6
5537,1,2483,2500,-17,0,115,0,6
5538,3,2412,2301,111,0,41,0,6
5539,1,2648,2648,0,0,0,0,6
5540,2,2239,2415,-176,0,100,0,6
5541,1,2454,2416,38,0,0,0,6
5542,1,2589,2392,197,0,211,0,6
5543,1,2375,2409,-34,0,200,0,6
5544,2,2461,2464,-3,0,45,0,6
5545,1,2305,2435,-130,0,43,1,5
5546,2,2512,2357,155,0,46,0,6
5547,2,2287,2494,-207,0,115,0,6
5548,1,2435,2314,121,0,244,0,8
5549,1,2502,2543,-41,0,106,0,6
5550,1,2480,2461,19,0,353,0,6
5551,3,2401,2435,-34,0,114,0,6
5552,1,2224,2408,-184,4,36,0,13
5553,1,2390,2602,-212,0,242,0,6
5554,1,2558,2452,106,0,244,0,6
5555,1,2396,2405,-9,0,458,0,6
5556,1,2403,2275,128,0,4,0,8
5557,3,2463,2273,190,0,202,0,6
5558,1,2427,2297,130,0,114,0,6
5559,3,2349,2405,-56,0,22,0,6
5560,3,2331,2457,-126,0,45,0,6
5561,1,2395,2527,-132,0,22,0,6
5562,2,2417,2338,79,0,100,0,6
5563,1,2654,2654,0,0,106,0,6
5564,1,2491,2412,79,0,5,0,6
5565,1,2603,2514,89,0,331,1,6
5566,1,2608,2586,22,0,140,0,6
5567,2,2491,2413,78,0,320,1,6
5568,2,2365,2484,-119,0,106,0,6
5569,1,2614,2504,110,0,107,0,6
5570,1,2415,2366,49,0,65,0,6
5571,2,2386,2454,-68,0,485,0,6
5572,1,2334,2417,-83,0,215,0,6
5573,1,2561,2519,42,0,112,0,6
5574,2,2533,2568,-35,0,141,0,6
5575,2,2400,2415,-15,0,111,1,6
5576,2,2312,2436,-124,0,101,0,6
5577,1,2469,2209,260,0,134,0,6
5578,1,2401,2251,150,0,40,0,6
5579,2,2439,2478,-39,0,463,0,6
5580,1,2303,2403,-100,0,40,0,6
5581,2,2394,2524,-130,0,48,0,6
5582,2,2402,2436,-34,0,190,1,6
5583,1,2718,2601,117,0,56,0,6
5584,1,2514,2248,266,0,352,0,8
5585,1,2514,2437,77,0,245,0,6
5586,1,2501,2486,15,0,249,0,6
5587,2,2560,2601,-41,0,226,1,6
5588,3,2488,2618,-130,0,1,0,6
5589,1,2496,2500,-4,0,41,0,6
5590,1,2467,2367,100,0,5,0,6
5591,2,2433,2410,23,0,140,1,6
5592,1,2417,2247,170,0,40,0,6
5593,2,2438,2463,-25,0,484,0,6
5594,2,2404,2411,-7,0,40,0,6
5595,1,2391,2429,-38,0,458,0,6
5596,2,2470,2455,15,0,46,0,6
5597,2,2411,2521,-110,0,2,0,6
5598,1,2430,2302,128,0,11,0,6
5599,1,2361,2415,-54,0,107,0,6
5600,2,2408,2478,-70,0,152,0,6
5601,1,2475,2648,-173,0,107,0,6
5602,1,2397,2496,-99,0,46,0,6
5603,2,2418,2423,-5,0,0,0,6
5604,2,2411,2591,-180,0,122,0,6
5605,1,2425,2440,-15,0,44,0,6
5606,1,2642,2463,179,0,487,0,6
5607,2,2567,2508,59,0,207,0,6
5608,1,2447,2462,-15,0,45,0,6
5609,1,2347,2455,-108,0,485,0,6
5610,3,2496,2292,204,0,30,0,6
5611,2,2509,2537,-28,0,39,0,6
5612,2,2410,2342,68,0,190,0,6
5613,1,2389,2402,-13,0,200,1,6
5614,3,2423,2537,-114,0,40,0,6
5615,2,2394,2462,-68,0,129,0,6
5616,3,2409,2435,-26,0,343,0,6
5617,2,2295,2504,-209,0,115,0,6
5618,2,2640,2533,107,0,1,0,6
5619,2,2407,2394,13,0,4,0,8
5620,2,2494,2473,21,4,45,0,13
5621,3,2437,2410,27,0,254,0,6
5622,2,2421,2392,29,0,303,0,6
5623,3,2420,2382,38,0,345,0,6
5624,2,2525,2396,129,0,332,0,6
5625,2,2409,2463,-54,0,117,0,6
5626,2,2387,2431,-44,0,204,0,6
5627,1,2458,2456,2,0,426,0,6
5628,1,2417,2428,-11,0,112,0,6
5629,1,2613,2453,160,0,101,0,6
5630,3,2407,2554,-147,0,3,0,6
5631,2,2341,2456,-115,0,300,1,6
5632,2,2519,2382,137,0,426,0,6
5633,1,2513,2595,-82,0,196,1,6
5634,2,2337,2404,-67,0,409,0,6
5635,1,2333,2420,-87,0,245,1,6
5636,2,2303,2496,-193,0,277,0,8
5637,2,2400,2399,1,0,245,0,6
5638,2,2358,2416,-58,0,331,0,6
5639,2,2330,2451,-121,0,61,0,6
5640,1,2408,2510,-102,0,100,0,6
5641,1,2627,2261,366,0,123,0,6
5642,1,2413,2342,71,0,4,0,6
5643,3,2518,2423,95,0,245,0,6
5644,2,2412,2310,102,0,0,0,6
5645,1,2286,2408,-122,0,150,0,6
5646,2,2458,2429,29,0,0,0,6
5647,1,2433,2598,-165,0,101,0,6
5648,3,2507,2484,23,0,302,0,6
5649,3,2495,2292,203,0,4,0,6
5650,1,2421,2481,-60,0,300,0,6
5651,2,2442,2397,45,0,127,0,6
5652,1,2507,2464,43,0,247,1,6
5653,2,2448,2563,-115,0,242,0,6
5654,3,2402,2430,-28,0,331,0,6
5655,2,2448,2420,28,0,321,0,6
5656,2,2468,2433,35,0,45,0,6
5657,3,2461,2517,-56,0,300,0,6
5658,1,2416,2243,173,0,102,0,6
5659,1,2490,2506,-16,0,0,0,6
5660,2,2246,2516,-270,0,101,0,8
5661,2,2407,2322,85,0,140,1,6
5662,2,2536,2606,-70,0,21,0,6
5663,1,2535,2499,36,0,314,0,6
5664,1,2555,2409,146,0,210,0,6
5665,2,2492,2616,-124,0,39,0,6
5666,2,2275,2460,-185,0,45,1,6
5667,2,2425,2402,23,0,132,1,6
5668,2,2372,2440,-68,0,40,0,8
5669,1,2382,2427,-45,0,203,0,6
5670,1,2633,2494,139,0,0,0,6
5671,1,2381,2405,-24,0,67,0,6
5672,1,2317,2410,-93,0,302,1,6
5673,1,2380,2515,-135,0,53,1,6
5674,2,2244,2420,-176,0,0,0,6
5675,1,2441,2552,-111,0,260,0,6
5676,1,2421,2405,16,0,13,0,6
5677,1,2589,2502,87,0,256,1,6
5678,1,2409,2386,23,0,311,0,6
5679,2,2338,2518,-180,0,107,1,8
5680,1,2373,2517,-144,0,40,0,6
5681,2,2535,2404,131,0,334,0,6
5682,1,2450,2617,-167,0,45,0,6
5683,1,2253,2404,-151,0,106,0,6
5684,3,2485,2359,126,0,249,0,6
5685,1,2434,2420,14,0,41,0,6
5686,3,2593,2606,-13,0,338,0,6
5687,2,2451,2379,72,0,312,1,6
5688,2,2464,2419,45,0,426,0,6
5689,1,2483,2434,49,0,246,1,6
5690,1,2431,2324,107,0,1,0,6
5691,1,2434,2471,-37,0,55,0,6
5692,1,2540,2421,119,0,325,0,6
5693,2,2496,2488,8,0,302,0,6
5694,2,2306,2424,-118,0,484,0,6
5695,2,2620,2500,120,0,110,0,6
5696,2,2364,2409,-45,0,132,1,6
5697,1,2611,2640,-29,0,344,0,6
5698,1,2404,2483,-79,0,152,1,6
5699,2,2457,2399,58,0,106,1,6
5700,1,2491,2516,-25,0,123,0,6
5701,2,2460,2462,-2,0,204,1,6
5702,2,2260,2631,-371,0,453,0,6
5703,2,2435,2339,96,0,344,0,6
5704,3,2567,2444,123,0,303,0,6
5705,3,2588,2636,-48,0,40,0,6
5706,1,2399,2422,-23,0,129,0,6
5707,1,2402,2251,151,0,46,0,6
5708,3,2442,2349,93,0,57,0,6
5709,2,2541,2559,-18,0,253,0,6
5710,2,2406,2512,-106,0,2,0,6
5711,2,2435,2459,-24,0,242,1,6
5712,3,2279,2400,-121,0,167,0,8
5713,1,2403,2539,-136,0,115,0,6
5714,2,2499,2680,-181,0,130,0,6
5715,1,2388,2419,-31,0,315,0,6
5716,1,2399,2429,-30,0,60,1,6
5717,2,2494,2427,67,0,37,0,6
5718,2,2428,2416,12,0,45,0,6
5720,1,2542,2590,-48,0,40,0,6
5721,1,2546,2383,163,0,45,0,6
5722,2,2440,2520,-80,0,484,1,6
5723,2,2414,2406,8,0,272,0,6
5724,1,2411,2437,-26,0,406,0,6
5725,2,2326,2435,-109,0,56,1,6
5726,1,2324,2409,-85,0,454,0,6
5727,2,2422,2609,-187,0,45,0,6
5728,2,2414,2422,-8,0,132,1,6
5729,2,2317,2474,-157,0,100,0,6
5730,2,2564,2536,28,0,203,0,6
5731,3,2362,2613,-251,0,43,0,6
5732,2,2288,2488,-200,0,104,0,6
5733,1,2426,2294,132,0,353,0,6
5734,1,2544,2449,95,0,245,0,6
5735,1,2443,2544,-101,0,400,0,6
5736,1,2417,2439,-22,0,447,0,6
5737,2,2411,2527,-116,0,106,0,6
5738,3,2433,2503,-70,0,311,0,6
5739,2,2274,2427,-153,0,45,0,6
5740,1,2516,2374,142,0,246,0,6
5741,2,2594,2462,132,0,200,0,6
5742,1,2465,2414,51,0,46,0,6
5743,2,2498,2507,-9,0,54,0,6
5744,2,2413,2305,108,0,242,0,6
5745,2,2403,2394,9,0,44,0,6
5746,1,2353,2494,-141,0,207,0,6
5747,3,2510,2594,-84,0,132,0,6
5748,1,2411,2419,-8,0,216,0,6
5749,2,2607,2497,110,0,373,1,6
5750,3,2531,2634,-103,0,250,0,6
5751,1,2617,2540,77,0,80,0,6
5752,1,2468,2470,-2,0,0,1,6
5753,2,2290,2412,-122,0,57,0,6
5754,2,2444,2419,25,0,111,0,6
5755,2,2513,2612,-99,0,48,1,6
5756,1,2493,2386,107,0,354,0,6
5757,1,2518,2244,274,0,43,0,8
5758,1,2405,2463,-58,0,260,0,6
5759,2,2388,2402,-14,0,113,1,6
5760,1,2423,2241,182,0,40,0,6
5761,2,2445,2403,42,0,0,1,6
5762,2,2346,2440,-94,0,101,0,6
5764,1,2408,2316,92,0,180,0,6
5765,2,2635,2613,22,0,1,0,6
5766,2,2291,2407,-116,4,1,0,13
5767,2,2414,2476,-62,0,30,0,6
5768,1,2423,2308,115,0,111,0,6
5769,2,2293,2464,-171,0,247,0,6
5770,1,2342,2406,-64,0,316,0,6
5771,1,2521,2400,121,0,58,0,8
5772,1,2306,2409,-103,0,130,0,6
5773,1,2406,2333,73,0,130,0,6
5774,2,2398,2519,-121,0,137,0,6
5775,1,2413,2388,25,0,263,0,6
5776,2,2470,2562,-92,0,300,0,6
5777,2,2325,2413,-88,0,40,1,6
5778,1,2451,2629,-178,0,106,0,6
5779,1,2319,2444,-125,0,463,0,6
5780,1,2498,2341,157,0,10,0,6
5781,2,2474,2517,-43,0,161,0,6
5782,2,2543,2417,126,0,1,0,6
5783,1,2431,2382,49,0,101,0,6
5784,3,2583,2445,138,0,21,0,6
5785,1,2428,2413,15,0,337,0,6
5786,1,2428,2408,20,0,104,0,6
5787,1,2446,2565,-119,0,241,0,6
5788,1,2313,2411,-98,0,40,0,6
5789,1,2477,2313,164,0,205,0,6
5790,2,2536,2621,-85,0,463,1,6
5791,2,2537,2531,6,0,311,0,6
5792,3,2408,2436,-28,0,310,0,6
5793,3,2350,2429,-79,0,255,0,6
5794,1,2350,2409,-59,0,176,0,6
5795,2,2423,2531,-108,0,445,1,6
5796,2,2416,2315,101,0,41,0,6
5797,1,2635,2258,377,0,123,0,6
5798,1,2537,2426,111,0,463,1,6
5799,2,2297,2458,-161,0,123,0,6
5800,2,2404,2374,30,0,48,1,6
5801,2,2452,2586,-134,0,49,0,6
5802,2,2367,2499,-132,0,306,0,8
5803,1,2448,2441,7,0,128,0,6
5804,3,2592,2511,81,0,306,0,6
5805,1,2425,2294,131,0,32,1,6
5806,2,2470,2523,-53,0,4,0,6
5807,3,2402,2382,20,0,395,0,6
5808,1,2632,2539,93,0,107,0,6
5809,1,2313,2427,-114,0,184,1,6
5810,1,2431,2417,14,0,253,0,6
5811,1,2497,2490,7,0,306,1,6
5812,2,2509,2502,7,0,48,1,6
5813,2,2616,2502,114,0,115,1,6
5814,2,2400,2438,-38,0,43,0,6
5815,2,2413,2425,-12,0,113,1,6
5816,1,2396,2525,-129,0,302,0,8
5817,3,2410,2377,33,0,15,0,6
5818,2,2394,2484,-90,0,4,0,6
5819,2,2548,2264,284,0,110,0,6
5820,1,2338,2436,-98,0,120,0,6
5821,2,2425,2535,-110,0,171,1,6
5822,2,2281,2429,-148,0,46,1,6
5823,2,2289,2466,-177,0,123,0,6
5824,3,2439,2291,148,0,83,0,6
5825,2,2567,2558,9,0,400,0,6
5826,1,2464,2339,125,0,40,0,6
5827,2,2469,2430,39,0,208,1,6
5828,2,2437,2329,108,0,306,0,6
5829,3,2402,2331,71,0,241,0,6
5830,3,2522,2559,-37,0,15,0,6
5831,1,2521,2395,126,0,84,0,6
5832,2,2409,2399,10,0,4,0,6
5833,1,2476,2305,171,0,405,0,6
5834,3,2682,2605,77,0,9,0,6
5835,2,2257,2640,-383,0,4,0,6
5836,1,2486,2361,125,0,31,1,6
5837,1,2413,2227,186,0,57,0,6
5838,2,2402,2357,45,0,196,0,6
5839,1,2435,2438,-3,0,409,1,6
5840,1,2432,2319,113,4,477,1,13
5841,1,2560,2581,-21,0,36,0,6
5842,2,2475,2449,26,0,484,1,6
5843,2,2528,2590,-62,0,101,0,6
5844,1,2417,2358,59,0,111,1,6
5845,1,2621,2477,144,0,0,0,6
5846,2,2309,2481,-172,0,258,1,6
5847,1,2408,2465,-57,0,200,0,6
5848,1,2411,2436,-25,0,406,0,6
5849,1,2420,2395,25,0,44,1,6
5850,3,2415,2320,95,0,0,0,6
5851,2,2542,2548,-6,0,46,1,6
5853,2,2447,2531,-84,0,102,1,6
5854,1,2428,2290,138,0,205,0,6
5855,2,2250,2400,-150,0,0,0,6
5856,1,2266,2456,-190,0,258,0,6
5857,2,2422,2358,64,0,315,0,6
5858,1,2564,2561,3,0,131,0,6
5859,2,2435,2534,-99,0,404,1,6
5860,1,2459,2314,145,0,46,0,6
5861,2,2400,2397,3,0,45,1,6
5862,3,2491,2414,77,0,16,0,6
5863,3,2596,2442,154,0,311,0,6
5864,1,2408,2397,11,0,338,1,6
5865,2,2327,2402,-75,0,130,0,6
5866,2,2409,2340,69,0,331,0,6
5867,1,2681,2513,168,0,15,0,6
5868,1,2539,2421,118,0,107,0,6
5869,2,2295,2539,-244,0,305,0,6
5870,1,2291,2468,-177,0,302,0,6
5871,1,2503,2409,94,0,315,0,6
5872,2,2481,2526,-45,0,345,1,6
5873,2,2525,2378,147,0,426,1,6
5874,2,2435,2428,7,0,106,0,6
5875,2,2508,2502,6,0,14,0,6
5876,2,2509,2625,-116,0,40,0,6
5877,1,2643,2256,387,0,123,1,6
5878,1,2390,2432,-42,0,15,0,6
5879,2,2422,2363,59,0,45,0,8
5880,1,2606,2383,223,0,8,0,6
5881,2,2234,2407,-173,0,250,1,6
5882,2,2368,2533,-165,0,190,1,6
5883,1,2559,2523,36,0,300,0,6
5884,3,2429,2313,116,0,331,0,6
5885,2,2484,2463,21,0,253,0,6
5886,2,2224,2420,-196,0,200,0,6
5887,1,2404,2247,157,0,2,0,6
5888,2,2486,2350,136,0,44,0,6
5889,2,2459,2631,-172,0,8,0,6
5890,1,2557,2454,103,0,400,0,6
5891,2,2352,2404,-52,0,324,0,6
5892,1,2332,2401,-69,0,454,0,6
5893,2,2350,2455,-105,0,124,1,6
5894,1,2405,2322,83,0,14,0,6
5895,1,2416,2419,-3,0,38,1,6
5896,1,2508,2502,6,0,380,0,6
5897,2,2455,2441,14,0,117,0,6
5898,2,2575,2469,106,0,15,0,6
5899,1,2594,2566,28,0,121,0,6
5900,1,2541,2293,248,0,122,0,6
5901,2,2375,2424,-49,0,129,0,6
5902,2,2413,2381,32,0,212,0,8
5903,2,2426,2419,7,0,138,0,8
5904,1,2485,2481,4,0,45,0,6
5905,2,2282,2432,-150,0,45,0,6
5906,1,2412,2387,25,0,244,0,8
5907,2,2287,2415,-128,0,120,0,6
5908,1,2484,2306,178,0,122,0,6
5909,1,2443,2299,144,0,394,0,6
5910,3,2330,2421,-91,0,37,0,6
5911,1,2432,2378,54,0,386,1,6
5912,1,2419,2454,-35,0,184,1,6
5913,2,2306,2437,-131,0,15,0,6
5914,1,2619,2570,49,0,4,0,6
5915,2,2430,2368,62,0,257,0,6
5916,2,2416,2249,167,0,13,0,8
5917,1,2417,2543,-126,0,200,0,6
5918,1,2340,2557,-217,0,405,0,8
5919,3,2518,2463,55,0,45,0,6
5920,1,2457,2391,66,0,101,0,6
5921,2,2554,2620,-66,0,40,0,6
5922,1,2403,2401,2,0,113,0,6
5923,2,2372,2403,-31,0,106,1,6
5924,2,2403,2432,-29,0,110,1,6
5925,1,2541,2486,55,0,469,0,6
5926,2,2538,2593,-55,0,251,1,6
5927,2,2385,2490,-105,0,3,0,6
5928,2,2386,2570,-184,0,300,1,6
5929,3,2413,2287,126,4,10,0,13
5930,2,2564,2348,216,0,45,0,6
5931,1,2509,2456,53,0,140,0,6
5932,1,2450,2432,18,0,335,0,6
5933,2,2599,2684,-85,0,107,1,6
5934,2,2405,2367,38,0,110,0,6
5935,3,2302,2462,-160,0,121,0,6
5936,2,2303,2517,-214,0,3,0,8
5937,1,2476,2549,-73,0,103,0,6
5938,1,2546,2426,120,0,50,1,6
5939,1,2476,2517,-41,0,45,0,6
5940,1,2353,2478,-125,0,4,0,6
5941,1,2429,2317,112,0,4,0,6
5942,1,2426,2221,205,0,57,0,6
5943,2,2336,2428,-92,0,380,0,6
5944,2,2348,2428,-80,0,485,0,6
5945,2,2524,2414,110,0,487,0,6
5946,1,2401,2358,43,0,123,0,6
5947,2,2565,2624,-59,0,100,0,6
5948,1,2467,2568,-101,0,484,0,6
5949,1,2356,2447,-91,0,28,0,6
5950,2,2330,2413,-83,0,107,0,6
5951,1,2403,2387,16,0,38,0,6
5952,2,2308,2410,-102,0,315,0,6
5953,2,2318,2410,-92,0,81,1,6
5954,2,2303,2487,-184,0,100,1,6
5955,1,2343,2422,-79,0,250,0,6
5956,2,2478,2474,4,0,113,0,6
5957,1,2331,2410,-79,0,302,0,6
5958,2,2450,2561,-111,0,107,1,6
5959,2,2496,2514,-18,0,244,0,6
5960,1,2542,2430,112,0,123,0,6
5961,1,2471,2384,87,0,404,1,6
5962,1,2405,2429,-24,0,100,0,6
5963,1,2447,2478,-31,0,352,0,6
5964,2,2290,2543,-253,0,3,0,6
5965,1,2425,2288,137,0,354,1,8
5966,3,2625,2600,25,0,2,0,6
5967,3,2290,2440,-150,0,58,0,6
5968,1,2475,2469,6,0,331,1,6
5969,1,2304,2433,-129,0,123,1,6
5970,1,2436,2303,133,0,107,1,8
5971,2,2402,2426,-24,0,424,1,6
5972,2,2218,2431,-213,0,202,0,6
5973,1,2511,2482,29,0,335,0,6
5974,1,2545,2469,76,0,127,0,6
5975,3,2448,2402,46,0,265,0,6
5976,1,2445,2530,-85,0,40,1,6
5978,1,2436,2331,105,0,45,0,6
5979,2,2370,2415,-45,0,491,1,8
5980,2,2409,2472,-63,0,200,0,6
5981,1,2373,2437,-64,0,269,1,6
5982,3,2381,2421,-40,0,129,0,6
5983,1,2464,2517,-53,0,110,0,6
5984,1,2349,2432,-83,0,469,0,6
5985,1,2640,2533,107,0,45,0,6
5986,1,2451,2598,-147,0,125,0,6
5987,2,2383,2555,-172,0,45,0,6
5988,2,2430,2438,-8,0,195,0,6
5989,1,2459,2409,50,0,394,0,6
5990,2,2555,2559,-4,0,45,0,6
5991,1,2425,2595,-170,0,169,0,6
5992,1,2688,2550,138,0,491,0,6
5993,1,2662,2494,168,0,201,0,6
5994,1,2573,2398,175,0,130,1,6
5995,1,2353,2406,-53,0,140,0,6
5996,2,2415,2383,32,0,241,0,6
5997,2,2559,2543,16,0,7,0,6
5998,3,2418,2422,-4,0,4,0,6
5999,2,2410,2380,30,0,200,1,6
6000,2,2490,2381,109,0,112,0,6
6001,2,2327,2474,-147,0,1,0,6
6002,1,2435,2491,-56,0,255,0,6
6003,2,2510,2550,-40,0,10,1,6
6004,1,2414,2313,101,0,455,0,6
6005,2,2421,2313,108,0,141,0,6
6006,3,2426,2586,-160,0,405,0,6
6007,2,2435,2472,-37,0,306,0,6
6008,1,2490,2300,190,0,122,1,6
6009,1,2439,2377,62,0,153,0,6
6010,2,2403,2338,65,0,113,1,6
6011,2,2289,2410,-121,4,120,0,13
6012,2,2416,2527,-111,0,415,0,6
6013,1,2546,2288,258,0,122,0,6
6014,2,2517,2450,67,0,221,0,6
6015,1,2435,2469,-34,0,398,0,6
6016,1,2468,2425,43,0,205,0,6
6017,1,2437,2216,221,0,57,0,6
6018,1,2465,2352,113,0,41,0,6
6019,2,2470,2550,-80,0,414,1,6
6020,1,2309,2425,-116,0,303,0,6
6021,3,2471,2565,-94,0,245,0,6
6022,2,2377,2529,-152,0,101,1,6
6023,1,2675,2625,50,0,84,0,6
6024,1,2464,2438,26,0,247,0,6
6025,1,2472,2453,19,0,117,0,6
6026,3,2325,2465,-140,0,142,0,6
6027,1,2433,2374,59,0,405,0,6
6028,1,2478,2354,124,0,317,0,6
6029,2,2406,2516,-110,0,394,0,6
6030,1,2400,2257,143,0,145,0,6
6031,1,2443,2424,19,0,196,0,6
6032,1,2431,2403,28,0,170,0,6
6033,1,2523,2397,126,0,13,0,6
6034,2,2404,2404,0,0,152,0,6
6035,2,2590,2608,-18,0,386,0,6
6036,1,2477,2395,82,0,49,0,6
6037,2,2351,2428,-77,0,200,0,6
6038,1,2459,2459,0,0,454,0,6
6039,1,2224,2427,-203,0,35,0,6
6040,2,2424,2436,-12,0,167,0,6
6041,1,2565,2412,153,0,315,0,6
6042,2,2414,2360,54,0,152,0,6
6043,1,2293,2549,-256,0,310,1,8
6044,2,2390,2469,-79,0,41,0,6
6045,2,2286,2548,-262,0,320,0,6
6047,1,2400,2285,115,0,145,0,6
6048,1,2549,2628,-79,0,300,0,6
6049,1,2418,2481,-63,0,4,0,6
6050,1,2438,2469,-31,0,54,1,6
6051,2,2313,2409,-96,0,436,0,6
6052,1,2418,2252,166,0,485,0,6
6053,1,2434,2384,50,0,28,1,6
6054,2,2213,2442,-229,0,211,0,6
6055,3,2350,2482,-132,0,45,0,6
6056,2,2520,2473,47,0,335,0,6
6057,1,2488,2334,154,0,154,0,6
6058,2,2564,2472,92,0,265,0,6
6059,1,2614,2585,29,0,203,0,6
6060,2,2553,2403,150,0,67,1,6
6061,2,2321,2504,-183,0,40,0,6
6062,2,2268,2440,-172,0,40,0,8
6063,2,2477,2555,-78,0,106,0,6
6064,1,2294,2464,-170,0,124,0,6
6065,2,2422,2484,-62,0,15,1,6
6066,1,2404,2412,-8,0,135,0,6
6067,1,2400,2342,58,0,56,1,6
6068,2,2403,2447,-44,0,56,0,6
6069,3,2327,2429,-102,0,135,0,6
6070,1,2591,2442,149,0,490,0,6
6071,1,2419,2288,131,0,213,1,6
6072,2,2297,2493,-196,0,40,1,6
6073,1,2481,2457,24,0,461,0,6
6074,1,2390,2531,-141,0,226,0,6
6075,1,2404,2309,95,0,140,1,6
6076,1,2620,2554,66,0,3,0,6
6077,1,2430,2417,13,0,45,0,6
6078,1,2680,2465,215,0,320,0,6
6079,2,2584,2466,118,0,330,0,6
6080,1,2413,2413,0,0,215,0,6
6081,2,2449,2430,19,0,291,1,6
6082,2,2308,2418,-110,0,123,0,6
6083,2,2487,2378,109,0,394,0,6
6084,1,2442,2430,12,0,490,0,6
6085,2,2386,2429,-43,0,45,0,6
6086,2,2485,2477,8,0,4,0,6
6087,1,2512,2533,-21,0,414,0,6
6088,1,2418,2374,44,0,180,0,6
6089,2,2290,2437,-147,4,310,1,13
6090,1,2387,2463,-76,0,43,0,6
6091,1,2386,2413,-27,0,212,1,6
6092,3,2460,2491,-31,0,302,0,6
6093,2,2401,2418,-17,0,107,1,6
6094,1,2453,2465,-12,0,46,0,6
6095,2,2536,2593,-57,0,405,0,6
6096,1,2420,2259,161,0,313,0,6
6097,2,2579,2619,-40,0,2,0,6
6098,1,2576,2604,-28,0,11,0,6
6099,3,2421,2365,56,0,317,0,6
6100,3,2446,2211,235,0,57,0,6
6101,1,2402,2312,90,0,110,0,6
6102,1,2391,2402,-11,0,151,0,6
6103,1,2612,2371,241,0,311,0,6
6104,1,2413,2300,113,4,485,1,13
6105,2,2480,2514,-34,0,211,1,6
6106,1,2474,2385,89,0,241,0,6
6107,1,2338,2430,-92,0,302,0,8
6108,1,2412,2367,45,0,190,0,6
6109,1,2417,2350,67,0,7,1,6
6110,2,2410,2349,61,0,40,0,6
6111,1,2474,2483,-9,0,350,0,6
6112,2,2436,2248,188,0,127,1,6
6113,2,2283,2404,-121,0,118,0,6
6114,1,2559,2473,86,0,335,0,6
6115,2,2523,2452,71,0,112,0,6
6116,3,2323,2491,-168,0,112,0,6
6117,2,2508,2683,-175,0,47,0,6
6118,2,2478,2398,80,0,202,0,6
6119,2,2665,2569,96,0,242,0,6
6120,2,2408,2471,-63,0,46,0,6
6121,2,2380,2549,-169,0,405,0,6
6122,2,2506,2448,58,0,21,1,6
6123,2,2438,2594,-156,0,242,0,6
6124,1,2540,2215,325,0,110,0,8
6125,1,2411,2545,-134,0,253,0,6
6126,1,2424,2480,-56,0,331,0,6
6127,1,2423,2335,88,0,145,1,6
6128,2,2489,2417,72,0,123,1,6
6129,1,2307,2620,-313,0,45,0,8
6130,3,2298,2474,-176,0,40,0,6
6131,1,2576,2318,258,0,330,0,6
6132,3,2411,2436,-25,0,107,0,6
6133,2,2436,2353,83,0,315,0,6
6134,2,2465,2531,-66,0,102,0,6
6135,1,2624,2574,50,0,116,0,6
6136,1,2429,2260,169,0,222,0,6
6137,2,2407,2419,-12,0,106,0,6
6138,2,2456,2459,-3,0,123,1,6
6139,1,2489,2330,159,0,41,0,6
6140,2,2269,2444,-175,0,106,0,6
6141,2,2348,2407,-59,0,45,0,6
6142,1,2261,2443,-182,0,140,1,8
6143,1,2369,2406,-37,0,139,1,6
6144,2,2301,2420,-119,0,464,1,8
6145,1,2446,2314,132,0,141,0,6
6146,2,2582,2381,201,0,11,0,6
6147,1,2686,2598,88,0,312,0,6
6148,1,2305,2438,-133,4,140,0,13
6149,2,2452,2398,54,0,106,0,6
6150,1,2437,2460,-23,0,338,0,6
6151,1,2490,2408,82,0,4,0,6
6152,2,2518,2614,-96,0,35,1,6
6153,2,2214,2440,-226,0,203,0,6
6154,3,2362,2420,-58,0,101,0,6
6155,1,2570,2629,-59,0,123,0,6
6156,1,2505,2456,49,0,45,0,6
6157,1,2335,2419,-84,0,46,1,6
6158,2,2560,2435,125,0,456,0,6
6159,2,2434,2406,28,0,40,1,6
6160,1,2617,2221,396,0,101,0,8
6161,1,2514,2384,130,0,242,0,6
6162,2,2468,2564,-96,0,106,0,6
6163,1,2434,2356,78,0,40,0,6
6164,2,2533,2537,-4,0,131,0,6
6165,2,2438,2279,159,0,45,0,6
6166,1,2519,2475,44,0,45,0,6
6167,2,2527,2346,181,0,140,1,6
6168,1,2519,2376,143,0,45,1,6
6169,1,2416,2259,157,4,21,0,13
6170,1,2553,2443,110,0,45,0,6
6171,2,2426,2510,-84,0,140,0,6
6172,2,2473,2329,144,0,80,0,6
6173,1,2463,2431,32,0,485,0,6
6174,2,2406,2459,-53,0,228,0,6
6175,1,2522,2212,310,0,40,0,8
6176,1,2482,2454,28,0,21,1,6
6177,1,2410,2353,57,0,109,0,8
6178,1,2451,2510,-59,0,106,0,6
6179,2,2327,2471,-144,0,40,1,6
6180,1,2470,2524,-54,0,414,1,6
6181,2,2241,2425,-184,0,38,1,6
6182,3,2303,2479,-176,0,312,0,6
6183,2,2536,2600,-64,0,80,0,6
6184,3,2411,2424,-13,0,107,0,6
6185,2,2230,2423,-193,0,127,0,8
6186,2,2414,2429,-15,0,22,0,6
6187,2,2394,2573,-179,0,106,0,6
6188,1,2390,2441,-51,0,331,0,6
6189,2,2313,2493,-180,0,41,0,6
6190,1,2400,2269,131,0,107,0,6
6191,2,2560,2460,100,0,41,0,6
6192,1,2349,2476,-127,0,240,0,6
6193,1,2336,2496,-160,0,176,0,6
6194,2,2445,2211,234,0,57,0,6
6195,1,2387,2451,-64,0,0,0,6
6196,1,2465,2419,46,0,454,0,6
6197,1,2354,2461,-107,0,1,0,6
6198,2,2430,2418,12,4,260,0,13
6199,2,2274,2611,-337,0,46,0,8
6200,1,2363,2422,-59,0,112,1,6
6201,3,2447,2404,43,0,315,0,6
6202,2,2250,2420,-170,0,22,0,8
6203,2,2250,2403,-153,0,103,0,8
6204,1,2531,2247,284,4,473,0,13
6205,1,2459,2593,-134,0,326,0,6
6206,2,2452,2623,-171,0,190,0,6
6207,1,2412,2302,110,0,246,0,6
6208,1,2428,2330,98,0,308,0,6
6209,2,2411,2543,-132,0,330,0,6
6210,2,2364,2438,-74,0,200,0,6
6211,1,2568,2464,104,0,320,0,6
6212,2,2401,2511,-110,0,0,1,6
6213,1,2464,2618,-154,0,4,0,6
6214,1,2428,2322,106,0,374,0,6
6215,2,2397,2413,-16,0,45,0,6
6216,1,2412,2342,70,0,200,0,6
6217,2,2398,2465,-67,0,25,0,6
6218,2,2454,2289,165,0,302,0,6
6219,1,2518,2397,121,0,110,0,6
6220,2,2557,2552,5,0,300,0,6
6221,1,2424,2365,59,0,300,0,8
6222,2,2522,2376,146,0,454,0,6
6223,1,2464,2391,73,0,129,1,6
6224,1,2537,2527,10,0,453,1,6
6225,2,2488,2345,143,0,241,0,6
6226,1,2577,2422,155,0,28,0,6
6227,2,2464,2432,32,0,123,0,6
6228,3,2436,2411,25,0,120,0,6
6229,1,2449,2426,23,0,490,0,6
6230,2,2412,2488,-76,0,380,0,6
6231,2,2531,2443,88,0,474,0,6
6232,1,2626,2449,177,0,100,0,6
6233,2,2433,2518,-85,0,302,1,6
6234,2,2314,2521,-207,0,40,1,6
6235,1,2426,2272,154,0,463,0,8
6236,1,2307,2489,-182,0,112,0,6
6237,2,2379,2468,-89,0,40,0,6
6238,1,2518,2477,41,0,4,0,6
6239,2,2659,2644,15,0,352,0,6
6240,3,2391,2502,-111,0,121,0,6
6241,2,2398,2447,-49,0,246,0,6
6242,1,2522,2380,142,0,157,0,6
6243,1,2405,2446,-41,0,25,0,6
6244,1,2475,2381,94,0,335,0,6
6245,1,2435,2400,35,0,200,0,8
6246,1,2503,2458,45,0,301,0,6
6247,1,2587,2527,60,0,326,1,6
6248,1,2467,2524,-57,0,21,1,6
6249,2,2414,2285,129,0,317,0,6
6250,2,2338,2417,-79,0,305,0,6
6251,1,2470,2450,20,0,123,1,6
6252,1,2418,2391,27,0,11,0,6
6253,2,2366,2488,-122,0,131,0,6
6254,2,2286,2415,-129,0,130,1,8
6255,2,2460,2572,-112,0,106,1,6
6256,2,2435,2412,23,0,132,1,6
6257,1,2394,2470,-76,0,0,1,6
6258,2,2415,2369,46,0,4,1,6
6259,1,2455,2454,1,0,405,0,6
6260,3,2492,2420,72,0,45,0,6
6261,2,2419,2428,-9,0,54,0,6
6262,2,2506,2580,-74,0,103,1,6
6263,3,2401,2276,125,0,312,0,6
6264,2,2407,2395,12,0,278,0,6
6265,1,2469,2453,16,0,404,0,6
6266,1,2401,2358,43,0,310,0,6
6267,2,2269,2417,-148,4,60,0,13
6268,1,2558,2551,7,0,8,0,6
6269,1,2268,2400,-132,0,130,0,6
6270,1,2260,2432,-172,0,129,0,6
6271,1,2585,2542,43,0,302,0,6
6272,2,2405,2344,61,0,335,1,6
6273,1,2629,2479,150,0,210,0,6
6274,2,2275,2416,-141,0,40,1,6
6275,2,2335,2427,-92,0,313,0,6
6276,3,2453,2508,-55,0,133,0,6
6277,2,2537,2591,-54,0,302,0,6
6278,1,2610,2429,181,0,311,0,6
6279,1,2492,2321,171,0,40,0,6
6280,1,2454,2496,-42,0,382,0,6
6282,1,2449,2543,-94,0,123,0,6
6283,1,2438,2523,-85,0,200,1,6
6284,3,2329,2480,-151,0,469,0,6
6285,1,2464,2424,40,0,47,0,6
6286,2,2408,2397,11,0,202,1,6
6287,2,2475,2632,-157,0,380,0,6
6288,1,2492,2521,-29,0,112,1,6
6289,1,2277,2407,-130,0,200,1,6
6290,1,2595,2533,62,0,302,0,6
6291,2,2330,2447,-117,0,55,1,6
6292,2,2440,2265,175,4,310,0,13
6293,2,2433,2353,80,0,13,0,6
6294,2,2515,2472,43,0,110,0,6
6295,1,2463,2507,-44,0,188,0,6
6296,2,2400,2307,93,0,457,1,6
6297,1,2544,2367,177,0,200,0,8
6298,1,2385,2530,-145,0,277,0,6
6299,2,2391,2434,-43,0,277,1,6
6300,2,2517,2377,140,0,43,0,6
6301,1,2364,2526,-162,0,101,1,6
6302,2,2261,2400,-139,0,331,0,6
6303,1,2388,2522,-134,0,0,0,6
6304,2,2434,2341,93,0,300,0,6
6305,1,2480,2474,6,0,300,0,6
6306,2,2545,2563,-18,0,337,0,6
6307,2,2449,2461,-12,0,392,0,6
6308,2,2443,2298,145,0,316,1,6
6309,2,2463,2456,7,0,56,0,6
6310,2,2349,2504,-155,0,40,1,6
6311,2,2309,2426,-117,0,241,0,6
6312,1,2288,2613,-325,0,108,0,8
6313,1,2421,2333,88,0,202,0,6
6314,2,2361,2446,-85,0,0,1,6
6315,2,2408,2456,-48,0,122,1,6
6316,1,2420,2262,158,0,110,0,6
6317,1,2439,2411,28,0,106,1,6
6318,2,2500,2372,128,0,409,1,6
6319,1,2376,2409,-33,0,112,0,6
6320,1,2467,2501,-34,0,466,0,6
6321,1,2584,2510,74,0,21,0,6
6322,1,2418,2429,-11,0,108,1,6
6323,2,2426,2465,-39,0,300,0,6
6324,1,2406,2420,-14,0,40,0,6
6325,1,2579,2536,43,0,150,0,6
6326,3,2402,2367,35,0,101,0,6
6327,2,2472,2393,79,0,10,0,6
6328,2,2421,2395,26,4,424,0,13
6329,2,2636,2653,-17,0,112,0,6
6330,1,2515,2380,135,0,40,0,6
6331,1,2539,2479,60,0,245,0,6
6332,1,2405,2385,20,0,31,0,6
6333,2,2546,2496,50,0,120,1,6
6334,1,2452,2456,-4,0,150,0,6
6335,1,2444,2318,126,0,124,0,6
6336,3,2317,2425,-108,0,129,0,6
6337,2,2237,2412,-175,0,336,0,6
6338,2,2431,2387,44,0,61,1,8
6339,2,2462,2613,-151,0,113,0,6
6340,1,2629,2457,172,0,200,0,6
6341,1,2419,2469,-50,0,4,0,6
6342,1,2528,2600,-72,0,302,0,6
6343,3,2419,2289,130,0,302,0,8
6344,1,2402,2396,6,0,200,0,6
6345,1,2355,2517,-162,0,101,0,6
6346,1,2479,2508,-29,0,143,0,6
6347,2,2348,2427,-79,0,331,0,6
6348,3,2515,2394,121,0,154,0,6
6349,2,2335,2547,-212,0,16,0,8
6350,3,2370,2498,-128,0,46,0,6
6351,3,2495,2560,-65,0,190,0,6
6352,2,2360,2412,-52,0,101,0,6
6353,2,2507,2454,53,0,245,0,6
6354,1,2414,2399,15,0,200,1,6
6355,1,2501,2403,98,0,122,1,6
6356,2,2400,2515,-115,0,15,1,6
6357,2,2593,2535,58,0,302,0,6
6358,1,2430,2305,125,0,311,0,6
6359,2,2479,2477,2,0,434,1,6
6360,2,2477,2372,105,0,479,0,6
6361,1,2476,2331,145,0,138,0,6
6362,3,2518,2503,15,0,212,0,6
6363,2,2439,2343,96,0,102,0,6
6364,1,2410,2269,141,0,40,0,8
6365,2,2314,2448,-134,0,310,0,6
6366,1,2377,2505,-128,0,300,0,6
6367,1,2589,2630,-41,0,10,0,6
6368,2,2522,2617,-95,0,151,0,6
6369,1,2431,2584,-153,0,45,1,6
6370,1,2272,2519,-247,0,117,0,6
6371,2,2393,2579,-186,0,169,1,6
6372,1,2403,2382,21,0,313,1,6
6373,2,2301,2404,-103,0,330,0,6
6374,1,2451,2474,-23,0,1,0,6
6375,1,2461,2501,-40,0,265,0,6
6376,2,2360,2540,-180,0,113,0,6
6377,1,2380,2492,-112,0,196,0,6
6378,2,2461,2403,58,0,243,0,6
6379,1,2418,2300,118,0,310,0,6
6380,2,2301,2434,-133,0,241,0,6
6381,3,2360,2424,-64,0,129,0,6
6382,3,2316,2416,-100,0,151,0,6
6383,2,2404,2243,161,0,302,1,6
6384,1,2518,2551,-33,0,130,0,6
6385,1,2387,2460,-73,0,153,0,6
6386,1,2390,2400,-10,0,0,0,6
6387,1,2506,2691,-185,0,47,1,6
6388,1,2421,2591,-170,0,45,1,6
6389,1,2287,2413,-126,0,57,1,6
6390,1,2305,2436,-131,0,45,0,6
6391,3,2471,2469,2,0,150,0,6
6392,2,2380,2470,-90,0,265,0,6
6393,1,2617,2459,158,0,474,0,6
6394,1,2493,2507,-14,0,15,1,6
6395,2,2472,2425,47,0,474,1,6
6396,1,2496,2367,129,0,101,1,6
6397,3,2406,2377,29,0,410,0,6
6398,1,2525,2219,306,0,40,1,6
6399,1,2309,2445,-136,0,28,1,6
6400,2,2380,2497,-117,0,103,0,6
6401,2,2327,2480,-153,0,177,0,6
6402,2,2624,2502,122,0,140,0,6
6403,2,2408,2385,23,0,40,0,6
6404,1,2437,2474,-37,0,277,0,6
6405,2,2352,2410,-58,0,130,0,6
6406,2,2603,2596,7,0,107,0,6
6407,1,2546,2513,33,0,112,1,6
6408,3,2417,2414,3,0,335,0,6
6409,1,2423,2303,120,0,4,0,6
6410,2,2542,2587,-45,0,302,1,6
6411,1,2423,2424,-1,0,194,0,6
6412,2,2452,2311,141,0,142,0,6
6413,2,2458,2380,78,0,218,0,6
6414,1,2419,2330,89,0,0,0,6
6415,1,2544,2524,20,0,307,0,6
6416,1,2495,2467,28,0,301,0,6
6417,1,2460,2470,-10,0,485,0,6
6418,2,2421,2486,-65,0,383,0,6
6419,3,2404,2391,13,0,112,0,6
6420,3,2415,2505,-90,0,385,0,6
6421,3,2399,2400,-1,0,227,0,6
6422,1,2272,2509,-237,0,117,0,6
6423,2,2543,2540,3,0,388,0,6
6424,2,2415,2523,-108,4,320,0,13
6425,1,2413,2301,112,0,143,1,6
6426,1,2604,2305,299,0,190,0,8
6427,2,2490,2616,-126,0,191,0,6
6428,2,2480,2351,129,0,53,0,6
6429,2,2365,2510,-145,0,101,1,6
6430,2,2407,2357,50,0,5,0,6
6431,1,2483,2473,10,0,110,0,6
6432,2,2518,2510,8,0,143,0,6
6433,1,2296,2486,-190,0,216,0,6
6434,1,2455,2317,138,0,101,0,6
6435,2,2335,2452,-117,0,330,0,6
6436,1,2377,2408,-31,0,49,0,6
6437,3,2428,2204,224,0,1,0,6
6438,1,2636,2439,197,0,110,1,6
6439,2,2483,2323,160,0,130,0,6
6440,2,2408,2412,-4,0,125,1,6
6441,2,2300,2426,-126,0,123,0,6
6442,2,2462,2303,159,0,5,0,6
6443,1,2448,2484,-36,0,190,0,6
6444,3,2414,2316,98,0,40,0,8
6445,2,2360,2532,-172,0,127,0,8
6446,1,2468,2453,15,0,157,0,6
6447,1,2417,2369,48,0,45,0,6
6448,2,2319,2429,-110,0,28,0,6
6449,2,2469,2512,-43,0,231,0,6
6450,1,2519,2473,46,0,110,0,6
6451,2,2456,2483,-27,0,101,0,6
6452,1,2583,2467,116,0,352,0,6
6453,2,2430,2593,-163,0,45,0,6
6454,1,2474,2376,98,0,43,0,6
6455,1,2400,2501,-101,0,200,0,6
6456,2,2464,2499,-35,0,147,0,6
6457,2,2459,2359,100,0,101,0,6
6458,2,2239,2409,-170,0,422,0,6
6459,2,2427,2503,-76,0,400,1,6
6460,1,2417,2323,94,0,484,0,6
6461,1,2659,2682,-23,0,248,1,6
6462,1,2402,2383,19,0,313,0,6
6463,2,2367,2408,-41,0,200,0,6
6464,2,2430,2329,101,0,374,0,6
6465,1,2390,2480,-90,0,160,0,6
6466,2,2450,2598,-148,0,437,0,6
6467,1,2414,2321,93,0,107,1,6
6468,2,2418,2429,-11,0,15,1,6
6469,1,2457,2287,170,0,106,1,6
6470,2,2410,2293,117,0,301,0,8
6471,2,2326,2401,-75,0,1,0,6
6472,2,2370,2458,-88,0,37,0,6
6473,2,2333,2475,-142,0,415,0,6
6474,1,2516,2500,16,0,222,0,6
6475,2,2490,2312,178,0,171,1,6
6476,1,2592,2537,55,0,302,0,6
6477,1,2620,2483,137,0,101,0,6
6478,1,2508,2402,106,0,133,0,6
6479,2,2606,2309,297,0,4,0,8
6480,2,2484,2551,-67,0,45,1,6
6481,1,2415,2274,141,0,119,0,6
6482,2,2386,2456,-70,0,341,0,6
6483,2,2401,2241,160,0,4,0,8
6484,1,2517,2328,189,0,133,0,6
6485,1,2373,2422,-49,0,4,0,6
6486,1,2347,2477,-130,0,91,0,6
6487,1,2371,2478,-107,0,40,0,6
6488,2,2450,2587,-137,0,125,0,6
6489,3,2423,2448,-25,0,426,0,6
6490,3,2357,2406,-49,0,41,0,6
6491,1,2463,2426,37,0,101,0,6
6492,1,2399,2422,-23,0,101,0,6
6493,3,2454,2495,-41,0,7,0,6
6494,1,2464,2406,58,0,344,0,6
6495,1,2350,2534,-184,0,181,1,6
6496,1,2402,2321,81,0,82,0,6
6497,2,2438,2378,60,0,62,0,6
6498,2,2598,2459,139,0,250,0,6
6499,2,2416,2473,-57,0,44,0,6
6500,1,2494,2389,105,0,43,1,6
6501,1,2429,2291,138,0,311,0,6
6502,3,2510,2397,113,0,45,0,6
6503,2,2546,2534,12,0,107,0,6
6504,1,2436,2420,16,0,106,0,6
6505,2,2380,2400,-20,0,42,1,6
6506,1,2450,2440,10,0,140,1,6
6507,1,2485,2472,13,0,4,0,6
6508,2,2556,2567,-11,0,112,0,6
6509,1,2404,2402,2,0,45,1,6
6510,2,2436,2430,6,0,45,1,6
6511,1,2405,2325,80,0,115,0,6
6512,1,2418,2344,74,0,106,0,6
6513,2,2437,2288,149,0,102,1,6
6514,1,2520,2402,118,0,241,1,6
6515,2,2464,2639,-175,0,288,0,6
6516,3,2462,2500,-38,0,106,0,6
6517,2,2478,2455,23,0,330,0,6
6518,2,2468,2524,-56,0,307,0,6
6519,2,2326,2418,-92,0,46,0,6
6520,1,2400,2382,18,0,106,0,6
6522,1,2479,2329,150,0,130,0,6
6523,1,2551,2252,299,0,133,0,8
6524,1,2441,2561,-120,0,315,0,6
6525,2,2476,2624,-148,0,112,0,6
6526,1,2527,2407,120,0,13,0,6
6527,2,2373,2420,-47,0,394,0,6
6528,1,2250,2423,-173,0,129,0,6
6529,1,2508,2225,283,0,211,0,6
6530,2,2290,2416,-126,0,15,0,6
6531,2,2448,2447,1,0,409,0,6
6532,2,2676,2511,165,0,404,0,6
6533,1,2403,2276,127,0,45,0,8
6534,2,2461,2482,-21,0,128,0,6
6535,2,2495,2458,37,0,28,0,6
6536,2,2411,2471,-60,0,267,1,6
6537,1,2456,2446,10,0,261,0,6
6538,1,2532,2597,-65,0,302,0,6
6539,2,2228,2426,-198,0,33,1,6
6540,2,2556,2480,76,0,140,0,6
6541,1,2367,2411,-44,4,4,0,13
6542,3,2665,2529,136,0,101,0,6
6543,1,2470,2423,47,0,380,1,6
6544,2,2324,2407,-83,0,406,0,8
6545,2,2512,2379,133,0,128,0,6
6546,1,2451,2297,154,0,41,1,6
6547,3,2325,2482,-157,0,310,0,6
6548,1,2473,2425,48,0,129,0,6
6549,1,2422,2310,112,0,8,0,6
6550,2,2287,2433,-146,0,103,0,6
6551,2,2357,2426,-69,0,200,0,6
6552,1,2412,2257,155,0,58,0,8
6553,2,2501,2447,54,0,31,0,6
6554,2,2540,2449,91,0,45,0,6
6555,2,2441,2491,-50,0,46,1,6
6556,1,2553,2414,139,0,80,0,6
6557,1,2433,2423,10,0,10,0,6
6558,2,2319,2415,-96,0,42,0,8
6559,1,2536,2357,179,0,255,1,8
6560,1,2627,2470,157,0,101,0,6
6561,2,2392,2468,-76,0,240,0,6
6562,1,2401,2385,16,0,7,0,6
6563,2,2421,2472,-51,0,45,0,6
6564,3,2417,2214,203,0,310,0,6
6565,2,2468,2498,-30,0,215,1,6
6566,1,2444,2346,98,0,214,0,6
6567,2,2232,2402,-170,0,51,0,6
6568,2,2596,2463,133,0,300,1,6
6569,3,2499,2462,37,0,40,0,6
6570,2,2501,2461,40,0,31,1,6
6571,1,2475,2383,92,0,345,0,6
6572,1,2482,2405,77,0,380,0,6
6573,1,2436,2241,195,0,42,0,6
6574,1,2478,2399,79,0,5,0,6
6575,2,2456,2313,143,0,106,1,6
6576,1,2504,2412,92,0,109,0,6
6577,2,2379,2407,-28,0,112,0,6
6578,1,2510,2531,-21,0,103,0,6
6579,1,2314,2515,-201,0,46,0,6
6580,1,2405,2409,-4,0,30,0,6
6581,1,2488,2524,-36,0,244,1,6
6582,2,2362,2597,-235,0,48,1,8
6583,1,2387,2417,-30,0,190,0,6
6584,1,2415,2240,175,0,0,1,6
6585,1,2355,2460,-105,0,104,0,6
6586,2,2456,2262,194,0,335,0,6
6587,1,2436,2295,141,0,226,0,6
6588,2,2462,2392,70,0,0,0,5
6589,1,2466,2430,36,0,313,0,6
6590,2,2465,2631,-166,0,112,0,6
6591,2,2419,2286,133,0,336,0,6
6592,1,2407,2378,29,0,337,0,6
6593,1,2479,2231,248,0,269,0,6
6594,1,2431,2401,30,0,170,0,6
6595,2,2668,2422,246,0,411,0,6
6596,2,2590,2539,51,0,47,0,6
6597,1,2287,2455,-168,0,106,0,6
6598,1,2517,2553,-36,0,44,0,6
6599,1,2519,2487,32,0,148,1,6
6600,1,2440,2462,-22,0,1,0,6
6601,1,2573,2317,256,0,14,0,6
6602,1,2443,2461,-18,0,406,0,6
6603,1,2476,2407,69,0,45,0,6
6604,2,2453,2463,-10,0,437,1,6
6605,2,2381,2403,-22,0,111,0,6
6606,2,2335,2456,-121,0,332,0,6
6607,1,2326,2448,-122,0,28,0,6
6608,2,2480,2454,26,0,45,0,6
6609,3,2426,2495,-69,0,341,0,6
6610,1,2381,2429,-48,0,2,0,6
6611,1,2590,2531,59,0,311,1,6
6612,2,2349,2475,-126,0,0,0,6
6613,2,2405,2373,32,0,491,1,6
6614,1,2418,2407,11,0,426,0,6
6615,2,2263,2402,-139,0,100,0,8
6616,3,2467,2488,-21,0,45,0,6
6617,1,2412,2312,100,0,302,0,6
6618,2,2432,2354,78,0,253,0,6
6619,2,2256,2539,-283,0,120,0,6
6620,1,2480,2477,3,0,196,0,6
6621,3,2473,2298,175,0,31,0,6
6622,1,2418,2259,159,0,0,0,6
6623,2,2313,2516,-203,0,3,0,8
6624,2,2400,2363,37,0,13,0,6
6625,1,2496,2411,85,0,127,1,6
6626,2,2407,2508,-101,0,113,0,6
6627,3,2459,2416,43,0,101,0,6
6628,1,2503,2459,44,0,48,1,6
6629,1,2463,2487,-24,0,113,0,6
6630,1,2544,2372,172,0,0,0,6
6631,1,2460,2483,-23,0,125,0,6
6632,2,2242,2415,-173,0,190,1,8
6633,1,2439,2400,39,0,372,0,6
6634,2,2432,2376,56,0,211,0,6
6635,1,2248,2420,-172,0,125,1,8
6636,1,2495,2588,-93,0,405,0,6
6637,1,2297,2541,-244,0,4,0,6
6638,2,2393,2449,-56,0,190,1,6
6639,2,2455,2467,-12,0,260,0,6
6640,2,2449,2499,-50,0,60,0,6
6641,3,2478,2468,10,0,311,0,6
6642,1,2355,2409,-54,0,102,0,6
6643,2,2381,2400,-19,0,142,0,6
6644,1,2518,2380,138,0,208,0,6
6645,2,2425,2495,-70,0,45,0,6
6646,2,2525,2438,87,0,13,0,6
6647,1,2467,2287,180,0,385,0,6
6648,2,2575,2376,199,0,244,1,6
6649,2,2373,2412,-39,0,112,0,6
6650,1,2423,2330,93,0,453,0,6
6651,1,2471,2404,67,0,476,1,6
6652,1,2525,2516,9,0,14,0,6
6653,2,2362,2433,-71,0,106,0,6
6654,1,2361,2407,-46,0,455,0,6
6655,1,2547,2497,50,0,80,0,6
6656,2,2374,2540,-166,0,121,1,8
6657,1,2418,2306,112,0,277,0,6
6658,2,2404,2430,-26,0,337,0,6
6659,3,2456,2494,-38,0,242,0,6
6660,1,2519,2216,303,0,13,0,8
6661,1,2524,2659,-135,0,414,0,6
6662,2,2481,2525,-44,0,45,0,6
6663,3,2423,2424,-1,0,288,0,6
6664,2,2304,2447,-143,0,54,0,6
6665,2,2417,2368,49,0,4,0,6
6666,2,2373,2508,-135,0,218,0,6
6667,2,2399,2518,-119,0,241,0,6
6668,1,2334,2553,-219,0,277,0,8
6669,1,2390,2442,-52,0,125,0,6
6670,2,2349,2427,-78,0,40,0,6
6671,1,2471,2486,-15,0,405,0,6
6672,1,2332,2472,-140,0,195,0,6
6673,2,2297,2601,-304,0,130,0,8
6674,2,2303,2459,-156,0,120,1,6
6675,2,2323,2435,-112,0,335,0,6
6676,1,2469,2376,93,0,375,0,6
6677,1,2397,2420,-23,0,212,0,8
6678,2,2579,2466,113,0,120,1,6
6679,1,2401,2243,158,0,53,1,8
6680,2,2382,2439,-57,0,105,0,6
6681,1,2400,2425,-25,0,300,0,6
6682,1,2444,2518,-74,0,45,0,6
6683,1,2492,2552,-60,0,44,0,6
6684,2,2381,2431,-50,0,45,0,6
6685,1,2419,2239,180,0,44,0,8
6686,2,2451,2522,-71,0,301,0,6
6687,2,2395,2512,-117,0,115,0,6
6688,1,2432,2345,87,0,302,0,6
6690,2,2265,2419,-154,0,45,0,6
6691,2,2580,2504,76,0,45,0,6
6692,2,2325,2603,-278,0,45,0,8
6693,1,2277,2453,-176,0,4,0,6
6694,1,2247,2420,-173,0,61,0,6
6695,2,2473,2468,5,0,112,0,6
6696,2,2454,2285,169,0,101,1,6
6697,2,2371,2478,-107,0,200,0,6
6698,1,2477,2445,32,0,405,1,6
6699,3,2381,2480,-99,0,115,0,6
6700,3,2494,2392,102,0,4,0,6
6701,3,2436,2400,36,0,172,0,6
6702,3,2544,2361,183,0,140,0,8
6703,1,2429,2321,108,0,5,0,6
6704,2,2512,2504,8,0,302,1,6
6705,1,2424,2420,4,0,315,0,6
6706,2,2374,2451,-77,0,49,0,6
6707,1,2446,2340,106,0,140,0,6
6708,2,2651,2476,175,0,210,0,6
6709,2,2423,2396,27,0,242,0,6
6710,1,2328,2505,-177,0,405,0,6
6711,1,2401,2282,119,0,157,1,6
6712,2,2502,2296,206,0,0,0,8
6713,2,2389,2422,-33,0,122,0,8
6714,1,2530,2448,82,0,143,0,6
6715,2,2476,2456,20,0,345,1,6
6716,1,2375,2411,-36,0,49,0,6
6717,3,2440,2493,-53,0,302,0,6
6718,1,2208,2536,-328,4,200,0,13
6719,1,2387,2401,-14,0,200,0,6
6720,3,2283,2402,-119,0,140,0,6
6721,1,2403,2370,33,0,303,0,6
6722,2,2578,2546,32,0,300,1,6
6723,2,2424,2341,83,0,215,1,6
6724,2,2439,2522,-83,0,46,1,6
6725,2,2345,2407,-62,0,200,0,6
6726,1,2422,2262,160,0,101,1,6
6727,1,2301,2464,-163,0,195,1,6
6728,1,2436,2294,142,0,4,0,6
6729,2,2402,2416,-14,0,45,1,6
6730,1,2491,2376,115,0,4,0,6
6731,3,2405,2381,24,0,327,0,6
6732,1,2411,2448,-37,0,58,1,6
6733,1,2408,2364,44,0,107,1,6
6734,1,2462,2341,121,0,193,1,6
6735,1,2405,2299,106,0,314,0,8
6736,2,2381,2419,-38,0,250,0,6
6737,1,2402,2291,111,0,100,0,6
6738,2,2511,2572,-61,0,20,0,6
6739,1,2526,2447,79,0,101,0,6
6740,1,2470,2313,157,0,201,0,6
6741,1,2474,2545,-71,0,205,0,6
6742,3,2588,2299,289,0,152,0,6
6743,2,2571,2514,57,0,115,0,6
6744,2,2562,2526,36,0,8,0,6
6745,2,2402,2293,109,0,315,0,6
6746,2,2482,2435,47,0,50,0,6
6747,2,2497,2404,93,0,34,0,6
6748,1,2474,2467,7,0,45,0,6
6749,1,2402,2440,-38,0,45,0,6
6750,2,2210,2530,-320,0,380,0,6
6751,2,2381,2501,-120,0,157,1,6
6752,2,2234,2510,-276,0,190,0,8
6753,2,2551,2516,35,0,2,0,6
6754,1,2426,2404,22,0,212,0,8
6755,1,2511,2533,-22,0,140,1,6
6756,1,2418,2426,-8,0,203,0,6
6757,2,2502,2530,-28,0,44,0,6
6758,3,2483,2429,54,0,380,0,6
6759,1,2415,2409,6,0,40,0,6
6760,2,2543,2370,173,0,104,0,8
6761,1,2469,2480,-11,0,187,0,6
6762,1,2473,2322,151,0,474,1,6
6763,3,2434,2380,54,0,39,0,6
6764,1,2502,2439,63,0,373,0,6
6765,2,2534,2482,52,0,15,0,6
6766,1,2381,2404,-23,0,49,1,6
6767,1,2391,2456,-65,0,122,1,6
6768,1,2510,2506,4,0,54,0,6
6769,1,2444,2480,-36,0,331,0,6
6770,1,2442,2531,-89,0,44,1,6
6771,1,2403,2423,-20,0,122,0,6
6772,1,2440,2306,134,0,302,1,6
6773,1,2463,2470,-7,0,144,0,6
6774,2,2672,2643,29,0,267,0,6
6775,1,2444,2416,28,0,123,0,6
6776,1,2480,2535,-55,0,404,0,6
6777,2,2270,2437,-167,0,120,0,6
6778,1,2532,2235,297,0,112,0,6
6779,1,2305,2406,-101,0,229,0,8
6780,2,2492,2480,12,0,31,1,6
6781,1,2427,2304,123,0,200,0,6
6782,2,2376,2536,-160,0,112,0,6
6783,1,2539,2484,55,0,40,0,6
6784,1,2430,2482,-52,0,463,0,6
6785,3,2512,2214,298,0,13,0,8
6786,1,2451,2461,-10,0,247,0,6
6787,2,2372,2425,-53,0,200,0,6
6788,2,2456,2505,-49,0,485,1,6
6789,1,2406,2297,109,0,248,0,6
6790,1,2438,2281,157,0,108,0,6
6791,2,2490,2449,41,0,11,0,6
6792,2,2349,2523,-174,0,4,0,6
6793,3,2427,2281,146,0,457,0,8
6794,1,2526,2545,-19,0,98,1,6
6795,1,2440,2279,161,4,31,0,10
6796,1,2527,2309,218,0,4,0,6
6797,1,2435,2352,83,0,40,0,6
6798,1,2424,2363,61,0,149,0,6
6799,2,2342,2425,-83,4,0,0,13
6800,1,2527,2437,90,0,43,1,6
6801,2,2302,2450,-148,0,201,0,6
6802,2,2467,2339,128,0,119,0,6
6803,1,2473,2497,-24,0,105,0,6
6804,1,2414,2250,164,0,153,0,6
6805,2,2334,2422,-88,0,45,1,6
6806,1,2435,2628,-193,0,347,0,6
6807,1,2285,2405,-120,0,117,0,8
6808,2,2473,2405,68,0,458,0,6
6809,2,2412,2406,6,0,218,1,6
6810,2,2392,2562,-170,0,3,1,6
6811,3,2441,2271,170,0,200,0,6
6812,2,2456,2463,-7,0,102,0,6
6813,2,2400,2323,77,4,241,0,13
6814,1,2458,2421,37,0,112,0,6
6815,1,2535,2565,-30,0,7,0,6
6816,2,2476,2537,-61,0,371,0,6
6817,1,2532,2555,-23,0,132,0,6
6818,2,2336,2403,-67,0,453,1,6
6819,3,2305,2473,-168,0,240,0,6
6820,1,2376,2412,-36,0,312,0,6
6821,2,2441,2479,-38,0,337,0,6
6822,2,2499,2468,31,0,343,1,6
6823,1,2433,2368,65,0,25,0,6
6824,1,2395,2478,-83,0,45,1,6
6825,2,2294,2400,-106,0,302,1,6
6826,1,2337,2444,-107,0,41,0,6
6827,1,2465,2501,-36,0,45,0,6
6828,2,2649,2665,-16,0,463,0,6
6829,1,2539,2530,9,0,45,1,6
6830,2,2619,2510,109,0,250,0,6
6831,1,2427,2475,-48,0,466,0,6
6832,2,2524,2450,74,0,101,0,6
6833,1,2455,2348,107,0,215,0,6
6834,2,2420,2476,-56,0,122,0,6
6835,1,2407,2424,-17,0,413,1,6
6836,1,2482,2378,104,0,117,0,6
6837,3,2382,2439,-57,0,200,0,6
6838,2,2453,2208,245,0,269,1,6
6839,1,2461,2443,18,0,340,0,6
6840,1,2383,2451,-68,0,102,0,6
6841,2,2449,2306,143,0,45,1,6
6842,1,2486,2462,24,0,200,1,6
6843,2,2399,2514,-115,0,302,0,8
6844,1,2398,2439,-41,0,201,1,6
6845,1,2338,2489,-151,0,176,0,6
6846,1,2415,2410,5,0,45,0,6
6847,1,2473,2321,152,0,400,0,6
6848,1,2398,2491,-93,0,102,0,6
6849,2,2490,2506,-16,0,269,0,6
6850,2,2410,2451,-41,0,190,0,6
6851,1,2526,2511,15,0,109,0,6
6852,2,2403,2269,134,0,40,1,6
6853,2,2351,2434,-83,0,8,0,8
6854,1,2532,2669,-137,0,13,0,6
6855,1,2411,2388,23,0,126,0,6
6856,1,2291,2440,-149,0,200,0,6
6857,1,2297,2412,-115,0,135,1,6
6858,1,2432,2224,208,0,217,1,6
6859,2,2530,2517,13,0,15,0,6
6860,3,2436,2351,85,0,427,0,6
6861,1,2545,2212,333,0,106,0,6
6862,2,2412,2358,54,0,218,0,6
6863,2,2312,2502,-190,0,140,1,6
6864,2,2539,2553,-14,0,2,1,6
6865,2,2408,2344,64,0,124,0,6
6866,2,2296,2401,-105,0,45,1,6
6867,2,2281,2441,-160,0,46,1,6
6868,1,2522,2471,51,0,40,1,6
6869,2,2649,2710,-61,0,15,1,6
6870,1,2471,2289,182,0,315,0,6
6871,2,2406,2355,51,0,52,1,6
6872,1,2426,2387,39,0,101,0,6
6873,3,2459,2463,-4,0,215,0,6
6874,2,2549,2539,10,0,101,1,6
6875,1,2558,2540,18,0,107,0,6
6876,1,2406,2383,23,0,292,0,6
6877,2,2438,2351,87,0,345,1,6
6878,1,2475,2521,-46,0,288,0,6
6879,2,2384,2514,-130,0,112,0,6
6880,2,2374,2471,-97,0,120,0,6
6881,1,2469,2434,35,0,327,1,6
6882,1,2494,2350,144,0,106,0,6
6883,1,2523,2644,-121,0,102,0,6
6884,1,2415,2324,91,0,46,0,6
6885,1,2565,2447,118,0,0,1,6
6886,1,2612,2523,89,0,337,0,6
6887,1,2258,2425,-167,0,354,0,8
6888,2,2517,2559,-42,0,7,0,6
6889,2,2351,2401,-50,0,40,0,6
6890,1,2398,2405,-7,0,335,0,6
6891,2,2385,2525,-140,0,5,0,6
6892,2,2344,2456,-112,0,45,0,6
6893,1,2438,2336,102,0,140,0,6
6894,1,2369,2427,-58,0,101,0,6
6895,2,2383,2417,-34,0,210,0,6
6896,2,2371,2444,-73,0,201,0,6
6897,2,2606,2289,317,0,398,1,6
6898,1,2438,2466,-28,0,58,0,6
6899,2,2401,2248,153,0,200,0,6
6900,2,2438,2484,-46,0,81,0,6
6901,2,2505,2531,-26,0,111,0,6
6902,1,2556,2492,64,0,15,0,6
6903,1,2666,2636,30,0,265,0,6
6904,2,2374,2531,-157,0,241,0,6
6905,1,2415,2413,2,0,113,0,6
6906,2,2481,2366,115,0,31,1,6
6907,2,2268,2527,-259,0,101,0,6
6908,2,2209,2406,-197,0,43,0,6
6909,1,2441,2405,36,0,45,1,6
6910,2,2498,2421,77,0,315,0,6
6911,2,2523,2542,-19,0,107,0,6
6912,1,2304,2525,-221,0,142,1,6
6913,2,2297,2479,-182,0,45,0,6
6914,1,2381,2445,-64,0,143,1,6
6915,1,2433,2227,206,0,40,1,6
6916,2,2419,2394,25,0,470,0,6
6917,1,2468,2525,-57,0,40,1,6
6918,2,2384,2419,-35,0,132,0,8
6919,1,2323,2433,-110,0,4,0,6
6920,1,2404,2316,88,0,210,0,6
6921,2,2411,2413,-2,0,42,0,6
6922,2,2319,2513,-194,0,45,1,6
6923,2,2405,2559,-154,0,140,1,6
6924,2,2454,2373,81,0,455,1,6
6925,1,2466,2269,197,0,84,0,6
6926,1,2231,2528,-297,0,265,0,6
6927,1,2466,2410,56,0,353,0,6
6928,1,2559,2533,26,0,10,0,6
6929,2,2477,2280,197,0,64,0,6
6930,3,2484,2564,-80,0,335,0,6
6931,2,2422,2463,-41,0,204,0,6
6932,2,2312,2409,-97,0,131,0,6
6933,1,2481,2517,-36,0,132,1,6
6934,2,2406,2346,60,0,190,0,6
6935,2,2516,2393,123,0,341,0,6
6936,2,2545,2543,2,0,102,1,6
6937,1,2412,2385,27,0,50,0,6
6938,3,2422,2340,82,0,106,0,6
6939,3,2601,2515,86,0,140,0,6
6940,2,2229,2405,-176,0,370,0,6
6941,1,2491,2355,136,0,343,0,6
6942,2,2362,2505,-143,0,122,1,6
6943,1,2473,2227,246,0,40,0,6
6944,1,2547,2266,281,0,45,0,6
6945,1,2382,2432,-50,0,45,0,6
6946,2,2428,2482,-54,0,45,0,6
6947,1,2407,2237,170,0,140,0,6
6948,2,2368,2430,-62,0,112,1,6
6949,2,2429,2302,127,4,151,1,13
6950,3,2418,2421,-3,0,205,0,6
6951,1,2535,2512,23,0,110,0,6
6952,1,2405,2307,98,0,250,0,6
6953,2,2444,2411,33,0,335,1,6
6954,1,2487,2474,13,0,125,0,6
6955,1,2644,2561,83,0,6,0,6
6956,1,2438,2381,57,0,46,0,6
6957,2,2535,2518,17,0,248,0,6
6958,1,2422,2400,22,0,170,0,6
6959,1,2489,2378,111,0,40,0,6
6960,3,2405,2433,-28,0,7,0,6
6961,1,2382,2516,-134,0,0,1,6
6962,1,2463,2395,68,0,16,0,8
6963,1,2403,2372,31,0,245,0,8
6964,1,2631,2348,283,0,45,0,6
6965,1,2500,2547,-47,0,134,1,6
6966,2,2358,2704,-346,0,144,1,6
6967,3,2444,2266,178,0,303,0,6
6968,2,2417,2368,49,0,454,0,6
6969,3,2620,2616,4,0,310,0,6
6970,2,2209,2406,-197,0,458,0,6
6971,1,2404,2272,132,0,101,0,6
6972,2,2549,2372,177,0,300,0,6
6973,1,2382,2404,-22,0,130,0,6
6974,1,2528,2685,-157,0,398,0,6
6975,1,2428,2304,124,0,113,0,6
6976,2,2318,2407,-89,0,212,0,6
6977,2,2421,2364,57,0,300,0,6
6978,2,2423,2378,45,0,207,0,6
6979,3,2493,2405,88,0,330,0,6
6980,2,2407,2519,-112,0,315,0,6
6981,3,2475,2296,179,0,464,0,6
6982,2,2404,2400,4,0,463,0,6
6983,2,2374,2447,-73,0,133,0,6
6984,1,2513,2397,116,0,394,0,6
6986,1,2221,2469,-248,0,16,0,6
6987,2,2372,2440,-68,0,192,0,6
6989,2,2487,2564,-77,0,255,1,6
6990,1,2463,2423,40,0,246,0,8
6991,2,2276,2444,-168,4,52,1,10
6992,1,2438,2278,160,0,315,1,6
6993,2,2409,2323,86,0,335,0,6
6994,2,2528,2423,105,0,3,1,6
6995,2,2569,2410,159,0,0,0,6
6996,1,2399,2448,-49,0,228,0,6
6997,2,2518,2493,25,0,4,0,6
6998,2,2406,2388,18,0,4,0,6
6999,1,2384,2410,-26,0,45,0,6
7000,2,2409,2300,109,0,211,0,6
7001,2,2443,2395,48,0,49,0,6
7002,1,2562,2402,160,0,133,0,6
7003,2,2556,2649,-93,0,228,0,6
7004,2,2400,2508,-108,0,200,1,6
7005,1,2380,2447,-67,0,211,0,6
7006,1,2469,2469,0,0,394,0,6
7007,1,2408,2282,126,0,4,0,6
7008,2,2383,2540,-157,0,241,0,6
7009,2,2507,2516,-9,0,5,0,6
7010,1,2413,2516,-103,0,45,0,6
7011,2,2486,2353,133,0,414,1,6
7012,1,2427,2340,87,0,152,1,6
7013,2,2413,2245,168,0,261,1,6
7014,1,2524,2529,-5,0,241,0,6
7015,1,2457,2563,-106,0,112,0,6
7016,2,2416,2286,130,0,456,0,8
7017,2,2369,2545,-176,0,113,1,6
7018,2,2445,2452,-7,0,110,1,6
7019,2,2249,2418,-169,0,45,0,6
7020,1,2279,2495,-216,0,46,0,6
7021,3,2503,2633,-130,0,250,0,6
7022,1,2405,2488,-83,0,121,0,6
7023,2,2549,2492,57,0,110,0,6
7024,3,2412,2341,71,0,131,0,6
7025,1,2451,2369,82,0,40,0,6
7026,2,2438,2440,-2,0,205,1,6
7027,1,2400,2351,49,0,247,0,6
7028,1,2509,2369,140,0,398,0,6
7029,1,2444,2216,228,0,247,0,6
7030,2,2316,2520,-204,0,203,0,6
7031,3,2443,2419,24,0,321,0,6
7032,2,2357,2435,-78,0,40,0,6
7033,1,2294,2474,-180,0,121,1,6
7034,2,2476,2414,62,0,398,1,6
7035,2,2369,2541,-172,0,0,0,6
7036,1,2481,2413,68,0,110,1,6
7037,1,2523,2529,-6,0,331,0,6
7038,1,2406,2269,137,0,101,0,6
7039,2,2201,2705,-504,0,389,0,6
7040,1,2523,2221,302,0,40,0,6
7041,2,2300,2432,-132,0,250,1,6
7042,1,2616,2552,64,0,103,0,6
7043,1,2522,2431,91,0,6,0,6
7044,3,2565,2506,59,0,109,0,6
7045,2,2425,2388,37,0,101,0,6
7046,2,2384,2468,-84,0,255,0,6
7047,1,2460,2260,200,0,461,0,6
7048,2,2283,2404,-121,0,7,1,6
7049,1,2600,2346,254,0,101,0,6
7050,2,2463,2474,-11,0,0,0,6
7051,2,2394,2463,-69,0,4,1,6
7052,2,2233,2492,-259,0,253,0,8
7053,2,2468,2499,-31,0,136,0,6
7054,2,2287,2424,-137,0,121,0,8
7055,2,2676,2512,164,0,40,0,6
7056,1,2458,2305,153,0,454,1,6
7057,2,2402,2474,-72,0,113,0,6
7058,2,2366,2402,-36,0,278,0,6
7059,2,2321,2400,-79,0,222,0,6
7060,1,2526,2399,127,0,214,0,6
7061,1,2286,2418,-132,0,256,1,6
7062,1,2491,2536,-45,0,409,0,6
7063,3,2361,2407,-46,0,337,0,6
7064,1,2440,2405,35,0,131,1,6
7065,2,2279,2412,-133,0,386,1,6
7066,3,2431,2483,-52,0,128,0,6
7067,2,2469,2468,1,0,249,1,8
7068,3,2544,2337,207,0,40,0,6
7069,1,2403,2483,-80,0,454,0,6
7070,2,2365,2456,-91,0,133,0,6
7071,1,2421,2421,0,0,354,0,6
7072,2,2431,2498,-67,0,80,0,6
7073,2,2543,2486,57,0,473,0,6
7074,2,2457,2469,-12,0,247,0,6
7075,2,2441,2402,39,0,487,1,6
7076,1,2512,2396,116,0,57,0,6
7077,2,2401,2480,-79,0,196,1,6
7078,1,2418,2380,38,0,470,0,6
7079,3,2555,2631,-76,0,247,0,6
7080,2,2310,2465,-155,0,200,0,6
7082,1,2405,2436,-31,0,404,0,6
7085,2,2582,2529,53,0,404,0,6
7086,1,2408,2312,96,0,474,0,6
7087,2,2253,2461,-208,0,121,0,6
7088,1,2404,2390,14,0,103,0,6
7089,2,2602,2516,86,0,121,0,6
7090,1,2376,2424,-48,0,7,0,6
7091,1,2405,2252,153,0,241,0,6
7092,1,2524,2268,256,0,45,0,6
7093,1,2581,2569,12,0,265,0,6
7094,1,2545,2389,156,0,46,0,6
7095,1,2379,2441,-62,0,244,0,6
7096,1,2425,2463,-38,0,4,0,6
7097,1,2547,2621,-74,0,125,0,6
7098,1,2445,2368,77,0,190,0,6
7099,1,2539,2384,155,0,101,1,6
7100,2,2357,2421,-64,0,205,1,6
7101,1,2230,2449,-219,0,201,0,6
7102,2,2290,2452,-162,0,7,0,6
7103,3,2406,2426,-20,0,7,0,6
7104,1,2446,2406,40,0,370,0,6
7105,1,2475,2313,162,0,400,0,6
7106,2,2375,2423,-48,0,14,1,6
7107,2,2440,2367,73,0,7,0,6
7108,2,2408,2485,-77,0,121,1,6
7109,1,2590,2402,188,0,311,0,6
7110,2,2507,2564,-57,0,144,1,6
7111,1,2381,2431,-50,0,110,0,6
7112,1,2498,2457,41,0,46,0,6
7113,3,2478,2397,81,0,6,0,6
7114,1,2288,2451,-163,0,200,0,6
7115,3,2523,2212,311,0,45,0,6
7116,1,2630,2538,92,0,331,0,6
7117,2,2456,2478,-22,0,249,0,6
7118,1,2415,2398,17,0,112,0,6
7119,1,2435,2297,138,0,110,0,6
7120,1,2428,2342,86,0,106,0,8
7121,2,2288,2427,-139,0,16,0,6
7122,3,2557,2475,82,0,120,0,6
7123,3,2386,2407,-21,0,245,0,6
7124,1,2489,2324,165,0,40,0,6
7125,2,2541,2532,9,0,20,0,6
7126,2,2482,2405,77,0,120,0,6
7127,1,2405,2432,-27,0,426,1,6
7128,1,2409,2231,178,0,44,0,8
7129,1,2361,2465,-104,0,211,1,6
7130,1,2706,2510,196,0,157,1,6
7131,2,2459,2653,-194,0,251,0,6
7132,2,2330,2410,-80,0,446,0,6
7133,1,2497,2319,178,0,0,0,8
7134,1,2446,2482,-36,0,151,1,6
7135,1,2436,2384,52,0,309,0,6
7136,1,2468,2338,130,0,40,0,6
7137,1,2522,2440,82,0,128,1,6
7138,2,2418,2360,58,0,151,1,6
7139,1,2403,2432,-29,0,469,0,6
7140,1,2323,2438,-115,0,373,0,6
7141,1,2371,2411,-40,0,46,1,6
7142,1,2384,2452,-68,0,204,0,6
7143,2,2668,2537,131,0,41,0,6
7144,1,2493,2385,108,0,46,0,6
7145,2,2259,2428,-169,0,115,0,6
7147,1,2406,2266,140,0,237,0,6
7148,1,2546,2462,84,0,57,0,6
7149,2,2500,2338,162,0,380,0,6
7150,2,2362,2408,-46,0,469,0,6
7151,3,2456,2631,-175,0,46,0,6
7152,1,2476,2477,-1,0,201,0,6
7153,2,2355,2407,-52,0,344,1,6
7154,1,2365,2541,-176,0,112,0,6
7155,2,2393,2516,-123,0,201,1,6
7156,3,2640,2671,-31,0,469,0,6
7157,1,2460,2361,99,0,455,0,6
7158,1,2614,2554,60,0,103,0,6
7159,2,2535,2549,-14,0,341,0,6
7160,2,2448,2464,-16,0,112,0,6
7161,1,2407,2443,-36,0,56,0,6
7162,2,2523,2385,138,0,152,1,6
7163,1,2466,2340,126,0,40,0,6
7164,1,2458,2502,-44,0,15,1,6
7166,2,2307,2445,-138,0,200,1,6
7167,1,2468,2361,107,0,200,1,6
7168,1,2415,2383,32,0,40,0,6
7169,2,2535,2661,-126,0,122,0,6
7170,1,2420,2239,181,0,302,0,6
7171,1,2440,2402,38,0,247,1,6
7172,2,2402,2405,-3,0,244,0,6
7173,1,2470,2575,-105,0,151,0,6
7174,2,2452,2595,-143,0,28,0,6
7175,2,2409,2261,148,0,320,0,8
7176,2,2451,2252,199,0,84,0,6
7177,2,2238,2519,-281,0,335,0,6
7178,1,2420,2215,205,0,106,0,6
7179,1,2410,2321,89,0,110,1,6
7180,1,2563,2493,70,0,302,1,6
7181,2,2421,2453,-32,0,122,1,6
7182,1,2598,2285,313,0,3,0,8
7183,1,2393,2469,-76,0,3,0,6
7184,2,2293,2439,-146,0,210,0,6
7185,2,2358,2497,-139,0,15,0,6
7186,2,2398,2477,-79,0,43,0,6
7187,1,2490,2404,86,0,132,1,6
7188,3,2634,2621,13,0,61,0,6
7189,2,2430,2268,162,0,281,1,6
7190,3,2426,2409,17,0,247,0,6
7191,2,2263,2412,-149,0,0,1,6
7192,1,2410,2436,-26,0,143,1,6
7193,2,2414,2451,-37,0,247,0,6
7194,2,2542,2503,39,0,194,1,6
7195,2,2363,2443,-80,0,28,1,6
7196,3,2353,2422,-69,0,406,0,6
7197,1,2413,2428,-15,0,110,0,6
7198,2,2403,2392,11,0,484,0,6
7199,1,2457,2410,47,0,302,0,6
7200,2,2524,2405,119,0,49,0,6
7201,2,2475,2317,158,0,108,0,6
7202,1,2426,2482,-56,0,45,0,6
7203,1,2350,2463,-113,0,132,0,8
7204,2,2443,2357,86,0,202,1,6
7205,2,2470,2210,260,0,406,1,6
7206,1,2362,2406,-44,0,45,0,6
7207,1,2533,2550,-17,0,398,1,6
7208,1,2717,2210,507,0,1,0,6
7209,2,2446,2568,-122,0,156,0,6
7210,2,2457,2418,39,0,46,0,6
7211,1,2503,2555,-52,0,110,0,6
7213,2,2477,2477,0,0,111,0,6
7214,2,2328,2423,-95,0,57,0,6
7215,1,2388,2508,-120,0,5,0,6
7216,1,2411,2374,37,0,247,1,6
7217,2,2431,2426,5,0,46,0,6
7218,1,2511,2526,-15,0,140,0,6
7219,1,2430,2276,154,0,352,0,6
7220,1,2363,2450,-87,0,0,0,6
7221,1,2476,2354,122,0,112,0,6
7223,1,2482,2453,29,0,4,1,6
7224,2,2378,2422,-44,0,7,0,6
7225,2,2375,2423,-48,0,398,1,6
7226,1,2413,2214,199,0,43,0,6
7228,1,2412,2464,-52,0,468,1,6
7229,2,2521,2314,207,0,176,0,6
7230,1,2447,2272,175,4,21,0,10
7231,2,2357,2458,-101,0,101,1,6
7232,1,2533,2237,296,0,300,1,6
7233,1,2418,2263,155,0,310,0,6
7234,2,2433,2350,83,0,320,1,6
7235,1,2412,2277,135,0,108,1,6
7236,3,2268,2517,-249,0,101,0,6
7237,2,2656,2454,202,0,483,1,6
7238,2,2530,2628,-98,0,406,0,6
7239,1,2464,2433,31,0,310,0,6
7240,3,2492,2323,169,0,130,0,8
7241,1,2445,2278,167,0,156,0,6
7242,1,2393,2475,-82,0,152,0,6
7243,1,2520,2388,132,0,62,1,6
7244,2,2496,2472,24,0,8,0,6
7245,1,2417,2320,97,0,0,0,6
7246,2,2391,2442,-51,0,245,0,6
7247,3,2459,2444,15,0,211,0,6
7248,1,2554,2484,70,0,22,0,6
7249,3,2395,2435,-40,0,106,0,6
7250,1,2432,2450,-18,0,330,0,6
7251,1,2500,2471,29,0,40,0,6
7252,2,2427,2283,144,0,107,0,6
7253,1,2403,2323,80,0,150,0,6
7254,1,2482,2448,34,0,454,0,6
7255,1,2438,2247,191,0,45,1,6
7256,1,2471,2414,57,0,474,0,6
7257,1,2599,2634,-35,0,256,0,6
7258,2,2622,2568,54,0,41,0,6
7259,2,2488,2512,-24,0,463,0,6
7260,1,2409,2426,-17,0,469,1,6
7261,1,2430,2422,8,0,43,0,6
7262,2,2276,2416,-140,0,170,0,6
7263,3,2462,2394,68,0,11,0,6
7264,2,2422,2277,145,0,4,1,6
7265,1,2419,2375,44,0,263,0,6
7266,2,2435,2468,-33,0,2,0,6
7267,1,2403,2325,78,0,265,1,6
7268,1,2510,2536,-26,0,302,1,6
7269,1,2474,2430,44,0,20,0,6
7270,1,2445,2459,-14,0,440,1,6
7271,1,2628,2523,105,0,331,0,6
7272,2,2461,2310,151,0,414,1,6
7273,2,2415,2400,15,0,195,1,6
7274,1,2401,2256,145,0,192,1,6
7275,2,2324,2447,-123,0,200,0,6
7276,2,2443,2371,72,0,131,0,6
7277,2,2512,2436,76,0,201,0,6
7278,1,2433,2448,-15,0,335,0,6
7279,1,2509,2471,38,0,140,1,6
7280,2,2432,2434,-2,0,58,1,6
7281,1,2317,2424,-107,0,45,0,6
7282,1,2370,2462,-92,0,103,0,6
7283,1,2415,2271,144,0,40,1,6
7284,3,2299,2732,-433,0,7,0,6
7285,1,2500,2534,-34,0,113,0,6
7286,3,2304,2434,-130,0,140,0,6
7287,2,2296,2430,-134,0,121,0,6
7288,1,2421,2351,70,0,102,0,6
7289,2,2369,2453,-84,0,343,0,6
7290,2,2271,2587,-316,0,45,0,6
7291,2,2544,2605,-61,0,101,0,6
7292,1,2718,2202,516,0,1,0,6
7293,1,2350,2422,-72,4,306,0,13
7294,1,2316,2416,-100,0,485,1,6
7295,2,2468,2289,179,0,39,1,6
7296,1,2409,2285,124,0,121,0,6
7297,2,2397,2416,-19,0,300,1,6
7298,1,2327,2467,-140,0,143,0,6
7299,1,2479,2320,159,0,405,0,6
7300,2,2410,2397,13,0,67,1,6
7301,1,2559,2451,108,0,80,1,6
7302,2,2416,2488,-72,0,389,0,6
7303,1,2493,2201,292,0,466,0,6
7304,1,2304,2456,-152,0,40,0,6
7305,1,2480,2550,-70,0,120,1,6
7306,2,2483,2506,-23,0,201,0,6
7307,1,2610,2398,212,0,121,0,6
7308,1,2455,2249,206,0,265,0,6
7309,1,2348,2438,-90,0,222,0,6
7310,1,2385,2416,-31,0,224,0,6
7311,1,2463,2427,36,0,302,0,6
7312,1,2632,2490,142,0,311,1,6
7313,1,2478,2353,125,0,150,0,6
7314,3,2425,2479,-54,0,121,0,6
7315,2,2519,2469,50,0,49,1,6
7316,1,2400,2412,-12,0,3,0,6
7317,1,2513,2219,294,0,123,0,6
7318,2,2432,2526,-94,0,300,1,6
7319,2,2633,2544,89,0,381,1,6
7320,2,2369,2436,-67,0,36,0,6
7321,3,2384,2524,-140,0,200,0,6
7322,1,2422,2231,191,0,38,0,6
7323,2,2544,2320,224,0,80,1,6
7324,1,2401,2295,106,0,15,0,6
7325,1,2408,2426,-18,0,122,0,6
7326,1,2462,2232,230,0,70,0,6
7327,2,2483,2413,70,0,318,0,6
7328,2,2442,2291,151,0,151,0,6
7329,1,2443,2404,39,0,260,1,6
7330,3,2390,2474,-84,0,310,0,6
7331,2,2420,2415,5,0,247,0,6
7332,3,2366,2494,-128,0,409,0,6
7333,2,2210,2727,-517,0,101,0,6
7334,1,2574,2615,-41,0,10,0,6
7335,1,2353,2487,-134,0,100,0,6
7336,2,2447,2486,-39,0,140,0,6
7337,2,2378,2436,-58,0,4,0,6
7338,1,2503,2212,291,0,10,0,6
7339,2,2236,2505,-269,0,40,1,6
7340,2,2213,2443,-230,0,415,0,6
7341,1,2395,2465,-70,0,30,1,6
7342,3,2489,2398,91,0,101,0,8
7343,1,2515,2369,146,0,8,0,6
7344,3,2341,2453,-112,0,123,0,6
7345,1,2371,2426,-55,0,112,1,6
7346,2,2226,2413,-187,0,60,1,6
7347,2,2285,2414,-129,0,110,0,6
7348,2,2455,2443,12,0,453,0,6
7349,1,2710,2420,290,0,176,0,6
7351,1,2434,2442,-8,0,40,0,6
7352,2,2403,2273,130,0,39,0,6
7353,2,2551,2539,12,0,300,0,6
7354,1,2446,2262,184,0,131,0,6
7355,3,2361,2533,-172,0,115,0,6
7356,1,2516,2520,-4,0,48,1,6
7357,2,2351,2454,-103,0,359,0,6
7358,2,2457,2482,-25,0,277,0,6
7359,2,2440,2427,13,0,123,0,6
7360,2,2388,2405,-17,0,454,1,6
7361,2,2360,2476,-116,0,15,0,6
7362,1,2466,2447,19,0,83,0,6
7363,2,2395,2431,-36,0,247,0,6
7364,2,2506,2515,-9,0,101,0,6
7365,2,2528,2464,64,0,45,0,6
7366,1,2288,2419,-131,0,139,1,6
7367,1,2432,2268,164,0,140,0,6
7368,2,2404,2449,-45,0,217,1,6
7369,2,2429,2364,65,0,311,1,6
7370,1,2727,2303,424,0,251,0,6
7371,2,2348,2530,-182,0,1,0,6
7372,2,2305,2453,-148,0,122,0,6
7373,2,2447,2478,-31,0,352,0,6
7374,1,2512,2511,1,0,200,1,6
7375,1,2319,2409,-90,0,3,0,6
7376,2,2437,2521,-84,0,110,0,6
7377,3,2471,2440,31,0,58,0,6
7378,1,2507,2392,115,0,112,0,6
7379,1,2461,2414,47,0,483,1,6
7380,3,2413,2409,4,0,105,0,6
7381,2,2476,2486,-10,0,310,0,6
7382,1,2434,2335,99,0,365,0,6
7383,2,2492,2354,138,0,106,0,6
7384,2,2478,2404,74,0,337,0,6
7385,1,2609,2626,-17,0,13,0,6
7386,1,2460,2263,197,0,30,1,6
7387,3,2330,2526,-196,0,115,0,6
7388,1,2581,2422,159,0,311,0,6
7389,2,2312,2446,-134,0,45,1,6
7390,1,2533,2345,188,0,102,0,6
7391,1,2440,2348,92,0,345,0,6
7392,1,2393,2482,-89,0,201,1,6
7393,2,2395,2473,-78,0,459,0,6
7394,2,2329,2535,-206,0,120,0,6
7395,2,2307,2712,-405,0,48,0,6
7396,2,2207,2720,-513,0,16,0,6
7397,2,2425,2409,16,0,30,1,6
7398,1,2309,2421,-112,0,400,0,6
7399,1,2552,2442,110,0,85,0,6
7401,1,2526,2265,261,0,335,0,6
7402,2,2418,2471,-53,0,145,0,6
7403,2,2435,2291,144,0,153,0,6
7404,2,2491,2471,20,0,331,0,6
7405,1,2418,2281,137,0,41,0,6
7406,2,2545,2545,0,0,0,0,6
7407,2,2521,2383,138,0,330,1,6
7408,1,2521,2230,291,0,45,0,6
7409,2,2274,2501,-227,0,220,0,6
7410,1,2466,2457,9,0,45,0,6
7411,1,2449,2449,0,0,16,1,6
7412,3,2405,2363,42,0,476,0,6
7413,2,2419,2351,68,0,307,0,6
7414,2,2483,2452,31,0,253,1,6
7415,1,2454,2437,17,0,318,0,6
7416,1,2409,2470,-61,0,228,0,6
7417,2,2433,2434,-1,0,459,0,6
7418,2,2364,2416,-52,0,323,0,6
7419,2,2457,2380,77,0,300,0,6
7420,1,2402,2339,63,0,101,0,6
7421,2,2358,2409,-51,0,331,0,6
7423,2,2422,2226,196,0,247,0,6
7424,3,2600,2202,398,0,3,0,8
7425,2,2261,2413,-152,0,373,0,6
7426,3,2500,2471,29,0,311,0,6
7427,2,2441,2373,68,0,265,1,6
7428,1,2419,2236,183,0,200,0,6
7429,1,2515,2584,-69,0,106,0,6
7430,2,2419,2439,-20,0,300,0,6
7431,2,2536,2414,122,0,258,1,6
7432,2,2523,2411,112,0,45,0,6
7433,1,2342,2406,-64,0,204,0,6
7435,2,2269,2450,-181,4,50,0,10
7436,1,2436,2480,-44,0,253,1,6
7437,2,2471,2409,62,0,20,0,6
7438,2,2351,2505,-154,0,484,0,6
7439,3,2411,2511,-100,0,36,0,6
7440,1,2523,2485,38,0,45,0,6
7441,2,2323,2425,-102,0,211,0,6
7442,1,2713,2394,319,0,218,0,6
7443,3,2531,2306,225,0,343,0,6
7445,2,2469,2400,69,0,153,1,6
7446,1,2366,2423,-57,0,144,0,6
7447,1,2453,2522,-69,0,115,1,6
7448,2,2362,2413,-51,0,225,0,6
7449,2,2410,2406,4,0,101,0,6
7450,1,2510,2442,68,0,113,0,6
7451,1,2538,2327,211,0,80,0,6
7452,3,2327,2411,-84,0,106,0,6
7453,2,2306,2539,-233,4,151,0,11
7454,2,2503,2416,87,0,106,1,6
7455,2,2438,2390,48,0,120,0,6
7456,1,2410,2226,184,0,435,0,6
7457,2,2478,2557,-79,0,0,1,6
7458,1,2337,2472,-135,0,40,0,6
7459,1,2403,2271,132,0,382,0,6
7460,1,2451,2468,-17,0,211,0,6
7461,1,2265,2422,-157,0,9,0,6
7462,2,2230,2416,-186,0,10,0,6
7463,2,2401,2373,28,0,3,1,6
7464,1,2500,2615,-115,0,63,0,6
7465,1,2427,2362,65,0,128,0,6
7466,1,2488,2401,87,0,200,0,8
7467,2,2393,2400,-7,0,104,1,6
7468,2,2323,2505,-182,0,100,0,6
7469,2,2279,2442,-163,0,45,1,6
7470,2,2414,2385,29,0,102,0,6
7471,1,2509,2522,-13,0,48,0,6
7472,1,2420,2464,-44,0,484,0,6
7473,1,2417,2240,177,0,202,0,6
7474,1,2324,2540,-216,0,1,0,6
7475,3,2368,2456,-88,0,210,0,5
7476,1,2404,2373,31,0,45,0,6
7477,3,2435,2311,124,0,410,0,6
7478,1,2472,2515,-43,0,335,0,6
7479,1,2449,2423,26,0,334,0,6
7480,3,2438,2336,102,0,352,0,6
7481,1,2359,2413,-54,0,40,0,6
7482,2,2414,2478,-64,0,45,0,6
7483,2,2444,2512,-68,0,132,0,6
7484,2,2244,2516,-272,0,111,1,6
7485,2,2443,2427,16,0,332,0,6
7486,2,2431,2324,107,0,326,1,6
7487,2,2416,2477,-61,0,115,0,6
7488,1,2261,2463,-202,0,335,0,6
7489,2,2232,2414,-182,0,210,0,6
7490,2,2341,2458,-117,0,45,0,6
7491,1,2418,2427,-9,0,409,0,6
7492,1,2555,2447,108,0,45,0,8
7493,1,2488,2348,140,0,70,1,6
7494,1,2309,2405,-96,4,245,0,13
7495,2,2348,2417,-69,0,4,0,6
7496,2,2421,2290,131,0,21,1,6
7497,3,2455,2460,-5,0,18,0,6
7498,2,2409,2387,22,0,113,0,6
7499,1,2444,2240,204,0,62,1,6
7500,1,2400,2264,136,0,221,0,8
7501,1,2396,2528,-132,0,101,0,6
7502,2,2485,2510,-25,0,331,1,6
7503,1,2422,2277,145,0,106,1,6
7504,2,2444,2509,-65,0,100,1,6
7505,1,2513,2410,103,0,57,1,6
7506,2,2307,2440,-133,0,5,0,6
7507,2,2407,2390,17,0,52,0,6
7508,2,2441,2600,-159,0,45,0,6
7509,2,2374,2528,-154,0,311,0,6
7510,1,2417,2208,209,0,107,1,6
7511,1,2460,2220,240,0,106,0,6
7513,2,2454,2269,185,0,15,0,6
7514,1,2465,2404,61,0,458,1,6
7515,1,2431,2266,165,0,250,0,6
7516,2,2332,2462,-130,0,0,0,6
7517,1,2475,2540,-65,0,102,0,6
7518,1,2403,2288,115,0,145,0,6
7519,2,2460,2457,3,0,60,0,6
7520,2,2242,2401,-159,4,300,0,11
7521,2,2540,2663,-123,0,326,0,6
7522,3,2421,2399,22,0,413,0,6
7523,1,2333,2527,-194,0,300,0,6
7524,1,2433,2409,24,0,40,0,6
7525,1,2410,2393,17,0,409,0,6
7526,2,2418,2424,-6,0,404,0,6
7527,2,2413,2439,-26,0,132,0,6
7528,2,2515,2460,55,0,302,0,6
7529,2,2332,2507,-175,0,113,0,6
7530,1,2324,2404,-80,0,255,0,6
7531,1,2482,2526,-44,0,106,0,6
7532,1,2380,2434,-54,0,40,0,6
7533,2,2457,2429,28,0,310,0,6
7534,2,2404,2411,-7,0,124,0,6
7535,2,2419,2295,124,0,203,0,6
7536,1,2462,2422,40,0,112,0,6
7537,2,2562,2513,49,0,45,1,6
7538,3,2394,2417,-23,0,202,0,6
7539,2,2347,2421,-74,0,45,1,6
7540,2,2423,2368,55,0,117,1,6
7541,2,2607,2526,81,0,30,0,6
7542,1,2443,2405,38,0,201,1,6
7543,1,2527,2395,132,0,257,0,6
7544,1,2515,2379,136,0,315,0,6
7545,2,2396,2469,-73,0,46,0,8
7546,2,2521,2558,-37,0,210,1,6
7547,1,2473,2300,173,0,290,0,6
7548,2,2481,2409,72,0,7,1,6
7549,1,2485,2464,21,0,96,1,6
7550,2,2460,2455,5,0,102,1,6
7551,3,2406,2322,84,0,122,0,6
7552,2,2418,2455,-37,0,0,0,6
7554,2,2426,2438,-12,0,46,0,6
7555,2,2340,2462,-122,0,268,0,6
7556,2,2333,2412,-79,0,1,0,6
7557,1,2263,2435,-172,0,200,0,6
7558,2,2416,2531,-115,0,101,0,6
7559,1,2396,2412,-16,0,315,1,6
7560,1,2308,2402,-94,0,58,0,6
7561,1,2410,2311,99,0,200,1,8
7562,1,2444,2440,4,0,426,1,6
7563,2,2514,2419,95,0,414,0,6
7564,2,2285,2518,-233,0,318,0,6
7565,2,2335,2424,-89,0,60,0,6
7566,2,2440,2401,39,0,48,0,6
7567,1,2404,2337,67,0,10,0,6
7568,2,2429,2359,70,0,277,1,6
7569,2,2520,2482,38,0,251,0,6
7570,1,2549,2417,132,0,127,1,6
7571,3,2260,2403,-143,0,44,0,8
7572,2,2313,2413,-100,0,46,1,6
7573,1,2430,2248,182,0,49,0,6
7574,2,2467,2509,-42,0,16,1,6
7575,1,2451,2398,53,0,41,0,6
7576,2,2407,2505,-98,0,337,0,6
7577,2,2403,2488,-85,0,115,1,6
7578,1,2381,2417,-36,0,219,0,6
7579,2,2463,2451,12,0,211,1,6
7580,3,2268,2432,-164,0,0,0,6
7581,2,2482,2420,62,0,303,0,6
7582,1,2447,2206,241,0,337,0,6
7583,1,2729,2202,527,0,240,0,6
7584,2,2445,2292,153,0,46,1,6
7585,1,2516,2438,78,0,190,1,6
7586,1,2413,2358,55,0,414,1,6
7587,3,2519,2600,-81,0,312,0,6
7588,2,2388,2425,-37,0,456,1,6
7589,1,2295,2408,-113,0,211,0,6
7590,2,2426,2517,-91,0,132,0,6
7591,1,2348,2416,-68,0,300,0,6
7592,2,2496,2388,108,0,311,0,6
7593,1,2474,2420,54,0,343,1,6
7594,3,2406,2305,101,4,245,0,13
7595,1,2511,2515,-4,0,40,0,6
7596,2,2290,2413,-123,0,1,0,6
7597,2,2202,2566,-364,0,382,0,6
7598,1,2535,2399,136,0,45,0,6
7599,2,2667,2536,131,0,122,0,6
7600,2,2468,2531,-63,0,200,0,6
7601,1,2420,2361,59,4,28,0,13
7602,1,2455,2420,35,0,127,0,6
7603,1,2349,2470,-121,0,143,0,6
7604,2,2393,2403,-10,0,115,0,6
7605,2,2294,2414,-120,0,200,0,6
7606,1,2444,2410,34,0,484,0,6
7607,1,2436,2496,-60,0,245,1,6
7608,1,2460,2413,47,0,100,0,6
7609,2,2447,2299,148,0,50,1,6
7610,1,2462,2315,147,0,201,0,6
7611,1,2408,2329,79,0,100,0,6
7612,1,2278,2446,-168,0,335,0,6
7613,2,2425,2322,103,0,415,1,6
7614,1,2416,2404,12,0,112,0,6
7615,1,2404,2534,-130,0,121,0,6
7616,1,2428,2334,94,0,311,1,6
7617,3,2520,2555,-35,0,380,0,6
7618,1,2596,2239,357,0,2,0,8
7619,2,2299,2401,-102,0,245,0,6
7620,2,2274,2426,-152,0,8,0,6
7621,1,2355,2448,-93,0,207,1,6
7622,3,2411,2266,145,0,57,0,6
7623,1,2468,2422,46,0,130,0,6
7624,1,2458,2391,67,0,41,0,6
7625,1,2427,2386,41,0,110,0,6
7626,2,2342,2417,-75,0,311,0,6
7627,2,2519,2264,255,0,415,0,6
7628,2,2545,2563,-18,0,21,0,6
7629,1,2446,2260,186,0,190,0,6
7630,1,2509,2516,-7,0,122,0,6
7631,2,2398,2521,-123,0,0,0,6
7632,2,2399,2437,-38,0,105,0,6
7633,1,2520,2205,315,0,45,0,6
7634,1,2434,2407,27,0,109,0,6
7635,1,2434,2463,-29,0,140,0,6
7636,2,2408,2411,-3,0,0,0,6
7637,1,2509,2544,-35,0,1,0,6
7638,1,2400,2397,3,0,270,0,6
7639,1,2399,2402,-3,0,132,0,6
7640,2,2460,2415,45,0,34,1,6
7641,2,2421,2514,-93,0,307,0,6
7642,2,2413,2553,-140,0,247,1,6
7643,1,2417,2449,-32,0,144,0,6
7644,1,2460,2457,3,0,60,0,6
7645,1,2408,2366,42,0,4,0,6
7646,2,2422,2302,120,0,200,0,6
7647,3,2599,2521,78,0,441,0,6
7648,1,2408,2277,131,0,10,1,6
7649,2,2339,2407,-68,0,1,0,6
7650,1,2416,2402,14,0,100,0,6
7651,2,2409,2418,-9,0,203,0,6
7652,1,2314,2479,-165,0,46,0,6
7653,2,2355,2433,-78,0,45,0,6
7654,1,2415,2245,170,0,121,0,6
7655,3,2476,2493,-17,0,6,0,6
7656,2,2393,2526,-133,0,124,0,6
7657,1,2324,2412,-88,0,1,1,6
7658,2,2461,2252,209,0,153,1,6
7659,1,2514,2417,97,0,48,0,6
7660,1,2430,2286,144,0,43,0,6
7661,3,2529,2489,40,0,313,0,6
7662,1,2395,2437,-42,0,122,1,6
7663,1,2544,2237,307,4,302,0,13
7664,2,2311,2488,-177,0,100,0,6
7665,2,2544,2750,-206,0,395,1,6
7666,1,2409,2368,41,0,247,0,6
7667,2,2338,2477,-139,0,410,0,6
7668,2,2520,2509,11,0,200,0,6
7669,1,2530,2355,175,0,426,1,6
7670,2,2307,2402,-95,0,124,0,6
7671,3,2419,2202,217,0,213,0,6
7672,1,2487,2390,97,0,40,0,6
7673,1,2405,2278,127,4,260,0,11
7674,1,2409,2295,114,0,245,0,6
7675,2,2415,2422,-7,0,15,1,6
7676,2,2427,2449,-22,0,125,0,6
7677,1,2510,2515,-5,0,200,1,6
7678,1,2426,2509,-83,0,121,1,6
7679,1,2404,2378,26,0,45,1,6
7680,2,2404,2439,-35,0,150,0,6
7681,3,2257,2449,-192,0,331,0,6
7682,1,2395,2465,-70,0,85,0,6
7683,2,2318,2434,-116,0,40,0,6
7684,1,2355,2444,-89,0,160,0,6
7685,1,2559,2414,145,0,45,1,8
7686,1,2489,2355,134,0,107,0,6
7687,1,2443,2351,92,0,0,0,8
7688,2,2554,2520,34,0,45,1,6
7689,3,2429,2353,76,0,128,0,6
7690,1,2443,2439,4,0,60,1,6
7691,1,2490,2423,67,0,264,1,6
7692,2,2430,2342,88,0,250,1,6
7693,1,2730,2528,202,0,101,0,6
7694,2,2491,2463,28,0,0,0,6
7695,1,2473,2447,26,0,45,0,6
7696,1,2373,2539,-166,0,107,0,6
7697,2,2204,2418,-214,0,139,0,6
7698,1,2330,2522,-192,0,110,0,6
7700,2,2330,2432,-102,0,301,1,6
7701,2,2442,2569,-127,0,106,0,6
7702,1,2417,2462,-45,0,43,0,6
7703,2,2463,2316,147,0,350,0,6
7704,1,2437,2286,151,0,15,0,6
7705,2,2375,2514,-139,0,106,0,6
7706,3,2425,2413,12,0,110,0,6
7707,1,2514,2518,-4,0,101,0,6
7708,1,2421,2454,-33,0,107,0,6
7709,1,2245,2417,-172,0,226,0,6
7710,2,2444,2399,45,0,162,0,6
7711,2,2381,2432,-51,0,20,0,6
7712,1,2556,2410,146,0,122,1,6
7713,2,2310,2471,-161,0,5,0,6
7714,1,2738,2581,157,0,301,0,6
7715,2,2317,2491,-174,0,200,0,6
7716,2,2415,2478,-63,0,21,1,6
7717,1,2525,2473,52,0,301,0,6
7718,1,2425,2402,23,0,247,0,6
7719,1,2456,2286,170,0,432,0,6
7720,2,2413,2440,-27,0,219,0,6
7721,1,2522,2598,-76,0,7,0,6
7722,2,2451,2468,-17,0,40,1,6
7723,1,2523,2516,7,0,106,0,6
7724,1,2442,2394,48,0,415,0,6
7725,1,2234,2453,-219,0,292,1,6
7726,1,2412,2422,-10,0,122,0,6
7727,1,2386,2405,-19,0,0,1,6
7728,2,2406,2387,19,0,113,0,6
7729,2,2397,2422,-25,0,0,0,6
7730,2,2416,2336,80,0,302,0,6
7731,1,2492,2455,37,0,125,1,6
7732,2,2464,2476,-12,0,140,0,6
7733,1,2386,2412,-26,0,124,0,6
7734,2,2391,2441,-50,0,394,0,6
7735,2,2369,2437,-68,0,202,0,6
7736,2,2340,2438,-98,0,45,0,6
7737,1,2510,2541,-31,0,1,0,6
7738,1,2438,2286,152,0,460,1,6
7739,1,2469,2343,126,0,147,0,6
7740,2,2351,2493,-142,0,100,1,6
7741,1,2480,2388,92,0,311,0,6
7742,3,2446,2260,186,0,278,0,6
7743,2,2352,2402,-50,0,483,0,6
7744,1,2450,2290,160,0,13,0,6
7745,2,2350,2485,-135,0,40,0,6
7746,2,2421,2246,175,0,338,1,6
7747,1,2416,2418,-2,0,121,1,6
7748,1,2456,2357,99,0,410,0,6
7749,3,2400,2381,19,0,144,0,6
7750,2,2474,2353,121,0,4,0,6
7751,1,2591,2529,62,0,452,1,6
7752,1,2413,2398,15,0,12,0,6
7753,2,2293,2443,-150,0,123,0,6
7754,3,2396,2441,-45,0,462,0,6
7755,1,2458,2518,-60,0,112,1,6
7756,3,2753,2541,212,0,398,0,6
7757,1,2401,2324,77,0,300,0,8
7758,1,2609,2311,298,0,46,0,6
7759,2,2329,2733,-404,0,133,0,6
7760,1,2510,2516,-6,0,150,0,6
7761,2,2489,2402,87,0,120,0,6
7762,1,2455,2314,141,0,300,0,6
7763,1,2297,2410,-113,0,100,0,6
7764,1,2428,2375,53,0,8,0,6
7765,2,2339,2449,-110,0,146,0,6
7766,1,2513,2526,-13,0,300,1,6
7767,1,2502,2513,-11,0,10,0,6
7768,2,2531,2494,37,0,13,0,6
7769,2,2329,2408,-79,0,120,0,6
7770,1,2572,2520,52,0,330,0,6
7771,1,2418,2313,105,0,202,0,6
7772,1,2494,2409,85,0,200,0,6
7773,2,2239,2598,-359,0,302,0,8
7774,1,2455,2517,-62,0,106,0,6
7775,1,2423,2424,-1,0,120,0,6
7776,3,2334,2412,-78,0,81,0,6
7777,1,2413,2347,66,0,112,0,6
7778,2,2363,2400,-37,0,136,0,6
7779,2,2517,2595,-78,0,406,0,6
7780,3,2342,2437,-95,0,12,0,6
7781,1,2580,2633,-53,0,121,1,6
7782,1,2430,2343,87,0,45,0,6
7783,2,2224,2421,-197,0,101,0,6
7784,2,2363,2455,-92,0,130,0,8
7785,2,2274,2429,-155,0,207,0,6
7786,1,2483,2389,94,0,195,0,6
7787,1,2578,2741,-163,0,8,0,6
7788,2,2263,2443,-180,0,331,0,6
7789,2,2409,2377,32,0,395,0,6
7790,2,2312,2418,-106,0,107,1,6
7791,1,2442,2460,-18,0,49,0,6
7792,1,2458,2428,30,0,3,0,6
7793,2,2406,2438,-32,0,190,1,6
7794,2,2406,2448,-42,0,150,0,6
7795,2,2392,2513,-121,0,107,0,6
7796,2,2425,2347,78,0,338,1,6
7797,1,2475,2446,29,0,310,1,6
7798,1,2454,2348,106,0,27,0,6
7799,2,2427,2391,36,0,100,1,6
7800,3,2361,2408,-47,0,201,0,6
7801,1,2446,2466,-20,0,113,0,6
7802,3,2433,2404,29,0,200,0,6
7803,2,2399,2512,-113,0,122,1,6
7804,2,2523,2516,7,0,204,0,6
7805,2,2450,2584,-134,0,332,0,6
7806,2,2404,2499,-95,0,122,1,6
7807,2,2405,2432,-27,0,210,0,6
7808,2,2412,2220,192,0,343,0,6
7809,1,2734,2424,310,0,202,0,6
7810,2,2368,2506,-138,0,133,0,6
7811,2,2459,2459,0,0,394,1,6
7812,2,2340,2473,-133,0,49,0,6
7813,1,2460,2441,19,0,330,0,6
7815,2,2201,2519,-318,0,310,0,6
7816,1,2521,2255,266,0,45,0,6
7817,3,2381,2419,-38,0,129,0,6
7818,1,2365,2428,-63,0,241,1,6
7819,1,2482,2400,82,0,4,1,6
7820,2,2396,2459,-63,0,203,0,6
7821,1,2386,2437,-51,0,469,1,6
7822,1,2520,2508,12,0,192,1,6
7823,2,2348,2402,-54,0,246,0,6
7824,3,2412,2422,-10,0,122,0,6
7825,3,2388,2472,-84,0,250,0,6
7826,2,2489,2525,-36,0,241,0,6
7827,2,2323,2459,-136,0,2,0,6
7828,1,2360,2447,-87,0,55,0,6
7829,2,2511,2465,46,0,80,0,6
7830,2,2524,2596,-72,0,6,1,6
7831,2,2425,2353,72,0,108,0,6
7832,2,2670,2835,-165,0,110,0,6
7833,2,2427,2387,40,4,13,0,13
7834,2,2424,2309,115,0,200,1,6
7835,2,2423,2435,-12,0,4,1,6
7836,1,2510,2515,-5,0,311,0,6
7837,2,2411,2468,-57,0,295,0,8
7838,1,2251,2430,-179,0,1,0,6
7839,2,2306,2462,-156,0,447,0,6
7840,3,2423,2464,-41,0,80,0,6
7841,1,2410,2401,9,0,380,0,6
7842,1,2249,2446,-197,0,7,0,6
7843,2,2634,2544,90,0,148,0,6
7844,2,2319,2406,-87,0,330,1,8
7845,1,2439,2513,-74,0,200,0,6
7846,2,2252,2406,-154,0,308,0,6
7847,1,2410,2482,-72,0,6,0,6
7848,1,2446,2260,186,0,103,0,6
7849,2,2453,2454,-1,0,380,1,6
7850,2,2422,2286,136,0,406,0,6
7851,1,2735,2448,287,0,128,0,6
7852,2,2404,2402,2,0,265,0,6
7853,1,2361,2495,-134,0,131,0,6
7854,2,2442,2278,164,0,4,0,6
7855,2,2352,2429,-77,0,200,0,6
7856,2,2319,2505,-186,0,125,0,6
7857,1,2519,2442,77,0,15,0,8
7858,2,2435,2418,17,0,52,0,6
7859,1,2308,2404,-96,0,139,0,6
7860,3,2422,2437,-15,0,210,0,6
7861,2,2202,2499,-297,0,110,0,6
7862,2,2453,2401,52,0,484,1,6
7863,2,2440,2396,44,0,15,0,6
7864,1,2442,2296,146,0,190,0,8
7865,2,2368,2487,-119,0,317,0,6
7866,1,2408,2458,-50,0,108,0,6
7868,1,2374,2460,-86,0,306,0,8
7869,2,2383,2405,-22,0,209,0,6
7870,2,2421,2315,106,0,345,0,6
7871,3,2362,2530,-168,0,301,0,6
7872,1,2518,2341,177,0,7,1,6
7873,1,2436,2388,48,0,106,0,6
7874,1,2443,2400,43,0,216,0,6
7875,1,2521,2388,133,0,45,1,6
7876,3,2407,2318,89,0,110,0,6
7877,1,2625,2486,139,0,45,1,6
7878,2,2453,2270,183,0,215,0,8
7879,1,2471,2505,-34,0,112,0,6
7880,1,2537,2487,50,0,300,0,6
7881,2,2466,2357,109,0,123,0,6
7882,1,2429,2445,-16,0,90,0,6
7883,2,2365,2505,-140,0,143,1,6
7884,2,2416,2508,-92,0,306,1,6
7885,2,2461,2335,126,0,415,0,6
7886,2,2422,2412,10,0,200,1,6
7887,2,2477,2336,141,0,147,0,6
7888,2,2424,2434,-10,0,201,0,6
7889,1,2522,2506,16,0,219,0,6
7890,2,2395,2516,-121,0,45,0,6
7891,1,2354,2533,-179,0,382,0,6
7892,1,2264,2414,-150,0,4,0,6
7893,1,2415,2417,-2,0,428,0,6
7894,1,2294,2422,-128,0,57,1,6
7895,2,2491,2349,142,0,199,0,6
7896,2,2437,2503,-66,0,156,0,6
7897,2,2307,2409,-102,0,395,0,6
7898,1,2518,2453,65,0,16,0,6
7899,3,2257,2449,-192,0,331,0,6
7900,1,2530,2482,48,0,28,0,6
7901,1,2403,2400,3,0,218,0,6
7902,3,2445,2267,178,0,100,0,6
7903,1,2503,2331,172,0,13,0,6
7904,1,2505,2325,180,0,131,0,6
7905,1,2434,2474,-40,0,240,0,6
7906,1,2839,2667,172,0,191,0,6
7907,1,2421,2371,50,0,0,0,6
7908,1,2510,2359,151,0,455,0,6
7909,1,2519,2418,101,0,129,0,6
7910,2,2319,2417,-98,0,45,0,6
7911,1,2499,2477,22,0,80,0,6
7912,1,2401,2388,13,0,125,0,6
7913,3,2600,2520,80,0,10,0,6
7914,2,2316,2446,-130,0,123,0,6
7915,2,2417,2737,-320,0,415,1,6
7916,3,2463,2423,40,0,3,0,6
7917,1,2310,2438,-128,0,190,1,6
7918,1,2270,2433,-163,0,484,0,6
7919,2,2446,2433,13,0,106,0,6
7920,3,2474,2441,33,0,300,0,8
7921,2,2408,2399,9,0,315,0,6
7922,2,2453,2348,105,0,335,0,6
7923,1,2465,2335,130,0,335,0,6
7924,2,2322,2453,-131,0,142,1,6
7925,2,2552,2627,-75,0,194,0,6
7926,1,2458,2450,8,0,123,0,6
7927,1,2438,2309,129,0,44,1,6
7928,2,2493,2395,98,0,0,0,6
7929,1,2431,2440,-9,0,110,0,6
7930,1,2459,2508,-49,0,56,0,6
7931,3,2524,2433,91,0,40,0,6
7933,2,2343,2500,-157,0,139,0,6
7934,1,2448,2433,15,0,210,0,6
7935,1,2527,2364,163,0,190,0,6
7936,2,2299,2468,-169,0,240,0,6
7937,2,2411,2441,-30,0,6,0,6
7938,1,2408,2446,-38,0,190,0,6
7939,1,2447,2362,85,0,106,0,6
7940,2,2421,2222,199,0,456,0,6
7941,2,2421,2542,-121,0,429,1,6
7942,2,2445,2494,-49,0,244,0,8
7943,2,2413,2389,24,0,110,0,6
7944,1,2354,2416,-62,0,448,0,6
7945,2,2588,2731,-143,0,4,0,6
7946,3,2436,2424,12,0,394,0,6
7947,2,2415,2249,166,0,176,0,6
7948,3,2301,2525,-224,0,302,0,6
7949,2,2664,2842,-178,0,111,1,6
7950,1,2447,2260,187,0,190,0,6
7951,1,2435,2435,0,0,284,1,6
7952,1,2442,2400,42,0,42,0,6
7953,1,2385,2483,-98,0,21,0,6
7954,1,2479,2482,-3,0,215,1,6
7955,2,2275,2408,-133,0,110,0,6
7956,1,2436,2348,88,0,57,0,6
7957,3,2482,2419,63,0,4,0,6
7958,2,2367,2426,-59,0,136,0,6
7959,1,2457,2241,216,0,13,1,6
7960,1,2418,2416,2,0,22,0,6
7961,2,2446,2508,-62,0,101,0,6
7962,1,2410,2314,96,0,322,1,8
7963,2,2437,2562,-125,0,200,0,8
7964,1,2543,2406,137,0,0,0,6
7965,1,2499,2523,-24,0,9,1,6
7966,2,2406,2380,26,0,31,0,6
7967,1,2603,2294,309,0,326,0,8
7968,3,2471,2401,70,0,32,0,6
7969,2,2428,2342,86,0,200,0,6
7970,2,2476,2535,-59,0,41,0,6
7971,1,2525,2454,71,0,432,1,6
7972,2,2407,2395,12,0,40,0,6
7973,2,2513,2739,-226,0,120,1,6
7974,2,2349,2415,-66,0,43,0,6
7975,2,2441,2629,-188,0,125,0,6
7976,1,2439,2319,120,0,487,1,6
7977,1,2406,2348,58,0,117,1,6
7978,1,2441,2339,102,0,40,0,6
7979,1,2521,2599,-78,0,211,0,6
7980,1,2422,2620,-198,0,440,1,6
7981,2,2318,2441,-123,0,226,0,6
7982,1,2450,2203,247,0,330,0,6
7983,1,2410,2406,4,0,107,0,6
7984,2,2275,2470,-195,0,459,0,6
7985,2,2424,2462,-38,0,10,0,6
7986,2,2631,2547,84,0,130,0,6
7987,2,2380,2506,-126,0,40,0,6
7988,2,2324,2472,-148,0,3,0,6
7989,3,2481,2344,137,0,148,0,6
7990,1,2440,2414,26,0,485,0,6
7991,1,2407,2309,98,0,8,0,6
7992,1,2431,2268,163,0,45,0,6
7993,2,2425,2377,48,0,247,0,6
7994,2,2451,2369,82,0,5,1,6
7995,1,2430,2318,112,0,405,0,6
7996,1,2513,2375,138,0,140,0,6
7997,2,2286,2465,-179,0,312,0,6
7998,1,2501,2452,49,0,123,0,6
7999,3,2257,2450,-193,0,289,0,6
8000,2,2585,2523,62,0,5,1,6
8001,1,2499,2440,59,0,0,0,8
8002,2,2341,2485,-144,0,122,1,6
8003,2,2411,2413,-2,0,123,0,6
8004,1,2734,2665,69,0,310,1,6
8005,3,2512,2384,128,0,0,0,6
8006,1,2409,2315,94,0,245,1,8
8007,2,2476,2416,60,0,52,0,6
8008,1,2404,2404,0,0,147,0,6
8009,1,2201,2415,-214,0,43,0,6
8010,2,2452,2460,-8,0,46,1,6
8011,2,2401,2420,-19,0,143,0,6
8012,2,2389,2546,-157,0,111,0,6
8013,2,2367,2406,-39,0,46,0,6
8014,1,2418,2511,-93,0,100,0,6
8015,1,2487,2417,70,0,57,1,6
8016,2,2424,2412,12,0,5,0,6
8017,1,2421,2275,146,0,120,1,6
8018,1,2845,2661,184,0,191,0,6
8019,2,2517,2521,-4,0,300,0,6
8020,1,2332,2447,-115,0,254,1,6
8021,2,2395,2505,-110,0,415,0,6
8022,1,2332,2424,-92,0,46,0,6
8023,1,2410,2424,-14,0,121,0,6
8024,2,2290,2407,-117,0,40,0,6
8025,3,2434,2271,163,0,45,0,6
8026,1,2470,2444,26,0,394,0,6
8027,1,2445,2315,130,0,123,0,6
8028,3,2514,2372,142,0,367,0,6
8029,3,2404,2373,31,0,4,0,6
8030,2,2343,2441,-98,0,107,1,6
8031,2,2403,2374,29,0,0,0,6
8032,2,2270,2406,-136,0,110,0,6
8033,2,2265,2741,-476,0,102,1,6
8034,1,2503,2356,147,0,228,0,6
8035,2,2476,2551,-75,0,102,1,6
8036,2,2420,2481,-61,0,123,0,6
8037,2,2386,2400,-14,0,320,0,6
8038,1,2396,2485,-89,0,45,1,6
8039,2,2334,2601,-267,0,310,0,8
8040,1,2412,2395,17,0,107,0,6
8041,2,2412,2284,128,0,400,1,6
8042,2,2409,2445,-36,0,190,1,6
8043,3,2447,2260,187,0,278,0,6
8044,1,2394,2419,-25,4,138,0,13
8045,2,2281,2401,-120,0,40,0,6
8046,2,2281,2401,-120,0,6,0,6
8047,1,2475,2470,5,0,257,0,6
8048,1,2411,2437,-26,0,120,0,6
8049,1,2407,2339,68,0,206,0,6
8050,3,2425,2274,151,0,335,0,6
8051,2,2403,2306,97,0,4,0,6
8052,2,2305,2419,-114,0,142,1,6
8053,1,2355,2412,-57,0,49,0,6
8054,1,2346,2405,-59,0,300,0,6
8055,1,2418,2227,191,0,123,0,6
8056,1,2624,2592,32,0,152,1,6
8057,1,2290,2464,-174,0,115,1,6
8058,2,2418,2467,-49,0,372,0,6
8059,1,2510,2449,61,0,18,1,6
8060,1,2506,2449,57,0,483,0,6
8061,2,2527,2324,203,0,330,0,6
8062,2,2633,2554,79,0,331,0,6
8063,2,2410,2302,108,0,455,0,8
8064,1,2470,2410,60,0,310,0,6
8065,2,2476,2353,123,0,222,0,6
8066,2,2362,2547,-185,0,0,0,6
8067,2,2317,2464,-147,0,2,0,6
8068,1,2447,2252,195,0,57,0,6
8069,2,2388,2402,-14,0,106,0,6
8070,2,2658,2848,-190,0,110,0,6
8071,2,2335,2457,-122,0,40,0,6
8072,2,2622,2801,-179,0,211,0,6
8073,1,2414,2301,113,0,213,1,6
8074,1,2572,2475,97,0,335,0,6
8075,2,2611,2539,72,0,347,0,6
8076,2,2406,2255,151,0,121,0,6
8077,1,2465,2425,40,0,40,0,6
8078,1,2210,2446,-236,0,395,0,6
8079,1,2559,2471,88,0,333,0,6
8080,1,2473,2230,243,0,101,0,6
8081,2,2489,2401,88,0,0,0,6
8082,1,2516,2338,178,0,176,0,6
8083,1,2541,2578,-37,0,300,0,6
8084,1,2522,2431,91,0,314,1,6
8085,1,2297,2422,-125,0,10,0,6
8086,2,2521,2506,15,0,10,0,6
8087,2,2418,2416,2,0,100,1,6
8088,2,2349,2476,-127,0,46,0,6
8089,2,2661,2739,-78,0,210,0,6
8090,2,2323,2411,-88,0,133,1,6
8091,1,2357,2432,-75,0,1,0,6
8092,2,2233,2400,-167,0,426,0,6
8093,2,2370,2403,-33,0,267,0,6
8094,2,2373,2532,-159,0,113,0,6
8095,1,2405,2450,-45,0,0,0,6
8096,2,2338,2476,-138,0,101,0,7
8097,3,2550,2468,82,0,90,0,6
8098,2,2442,2620,-178,0,320,0,6
8099,1,2246,2470,-224,0,140,1,6
8100,1,2742,2420,322,0,202,0,6
8101,2,2335,2520,-185,0,101,0,6
8102,2,2486,2492,-6,0,246,1,6
8103,2,2415,2413,2,0,0,0,6
8104,2,2409,2424,-15,0,108,0,6
8105,2,2431,2418,13,0,110,0,6
8106,2,2250,2404,-154,0,123,0,6
8107,1,2390,2421,-31,0,213,1,6
8108,1,2314,2434,-120,0,190,0,6
8109,2,2617,2313,304,0,45,0,6
8110,1,2411,2445,-34,0,2,0,6
8111,2,2511,2472,39,0,45,0,6
8112,2,2223,2404,-181,0,218,0,6
8113,2,2300,2414,-114,0,49,0,6
8114,2,2447,2414,33,0,101,0,8
8115,1,2322,2435,-113,0,197,0,6
8116,1,2430,2262,168,0,250,0,6
8117,1,2405,2392,13,0,469,1,6
8118,1,2374,2404,-30,0,4,0,6
8119,1,2468,2311,157,0,200,0,6
8120,2,2409,2279,130,0,112,1,6
8121,1,2478,2349,129,0,115,0,6
8122,1,2434,2337,97,0,53,1,6
8123,1,2501,2535,-34,0,241,0,6
8124,1,2471,2392,79,0,241,0,6
8125,1,2405,2404,1,0,5,0,6
8126,3,2495,2518,-23,0,311,0,6
8127,1,2408,2409,-1,0,0,1,6
8128,1,2409,2418,-9,0,122,1,6
8129,2,2436,2267,169,0,0,0,6
8130,2,2402,2399,3,0,7,0,8
8131,2,2420,2402,18,0,9,1,6
8132,1,2510,2219,291,0,315,1,6
8133,1,2401,2437,-36,0,45,1,6
8134,2,2265,2423,-158,0,100,0,6
8135,1,2404,2339,65,0,62,0,6
8136,2,2437,2380,57,0,440,0,6
8137,2,2410,2451,-41,0,207,0,6
8138,1,2472,2523,-51,0,101,1,6
8139,1,2466,2563,-97,0,206,0,6
8140,3,2301,2482,-181,0,255,0,6
8141,1,2450,2207,243,0,315,0,6
8142,2,2236,2412,-176,0,28,0,6
8143,2,2219,2604,-385,0,305,0,8
8144,2,2555,2593,-38,0,200,0,6
8145,1,2423,2375,48,0,301,1,6
8146,2,2386,2510,-124,0,130,0,6
8147,1,2851,2655,196,0,159,0,6
8148,1,2319,2400,-81,0,41,0,6
8149,1,2444,2266,178,0,101,0,6
8150,1,2427,2269,158,0,337,0,6
8151,3,2414,2334,80,0,190,0,6
8152,3,2416,2406,10,0,306,0,6
8153,2,2623,2630,-7,0,80,0,6
8154,1,2385,2441,-56,0,48,1,6
8155,2,2587,2514,73,0,131,0,6
8156,2,2561,2625,-64,0,400,1,6
8157,1,2258,2433,-175,0,403,1,6
8158,1,2444,2451,-7,0,267,0,6
8159,2,2509,2511,-2,0,330,0,6
8160,3,2348,2407,-59,0,345,0,6
8161,2,2462,2744,-282,0,45,0,6
8162,3,2419,2255,164,0,200,0,6
8163,2,2487,2444,43,0,190,0,6
8164,1,2481,2529,-48,0,380,1,6
8165,1,2461,2331,130,0,115,0,6
8166,2,2444,2411,33,0,2,0,6
8167,1,2469,2439,30,0,112,0,6
8168,2,2400,2375,25,0,58,0,6
8169,2,2743,2656,87,0,303,0,6
8170,2,2367,2484,-117,0,107,0,6
8171,1,2401,2505,-104,0,101,0,6
8172,1,2422,2412,10,0,249,1,6
8173,1,2369,2439,-70,0,394,1,8
8174,1,2605,2330,275,0,4,0,8
8175,2,2526,2510,16,0,331,1,6
8176,1,2391,2412,-21,0,245,1,6
8177,2,2475,2418,57,0,31,0,6
8178,2,2441,2407,34,0,103,0,6
8179,2,2592,2481,111,0,123,0,6
8180,1,2418,2364,54,0,4,0,6
8181,2,2297,2452,-155,0,388,0,6
8182,3,2447,2275,172,0,106,0,6
8183,1,2804,2611,193,0,250,0,6
8184,2,2492,2504,-12,0,244,0,6
8185,2,2434,2346,88,0,200,0,8
8186,1,2471,2431,40,0,148,0,6
8187,1,2498,2416,82,0,40,0,6
8188,2,2420,2408,12,0,110,0,6
8189,2,2516,2406,110,0,321,1,6
8190,1,2415,2305,110,0,345,0,6
8191,2,2546,2576,-30,0,157,0,6
8192,1,2457,2285,172,0,250,0,6
8193,1,2368,2427,-59,0,456,0,6
8194,1,2496,2460,36,0,140,1,6
8195,2,2479,2746,-267,0,426,0,6
8196,2,2258,2518,-260,0,115,0,6
8197,2,2413,2346,67,0,206,0,6
8198,1,2536,2446,90,0,151,0,6
8199,3,2435,2416,19,0,133,0,6
8200,2,2426,2426,0,0,46,0,6
8201,1,2429,2481,-52,0,4,0,6
8202,1,2381,2561,-180,0,101,0,6
8203,1,2439,2417,22,0,37,0,6
8204,3,2333,2409,-76,0,414,0,6
8205,2,2309,2405,-96,0,202,1,8
8206,3,2404,2524,-120,0,101,0,6
8207,2,2431,2268,163,0,80,0,6
8208,1,2407,2422,-15,0,45,0,6
8209,2,2398,2415,-17,0,247,1,6
8210,1,2507,2527,-20,0,145,1,6
8211,1,2319,2466,-147,0,4,0,6
8212,2,2512,2515,-3,0,0,0,6
8213,2,2652,2854,-202,0,111,0,6
8214,1,2433,2475,-42,0,85,1,6
8215,1,2335,2400,-65,0,245,1,6
8216,1,2350,2512,-162,0,45,0,6
8217,1,2550,2520,30,0,9,0,6
8218,2,2414,2320,94,0,0,0,6
8219,1,2548,2516,32,0,300,0,6
8220,2,2256,2589,-333,0,58,1,6
8221,2,2429,2207,222,0,306,0,6
8222,1,2408,2342,66,0,1,0,6
8223,2,2260,2502,-242,0,101,0,6
8224,3,2412,2214,198,0,190,0,6
8225,1,2421,2276,145,0,310,0,8
8226,2,2408,2416,-8,0,47,0,6
8227,1,2428,2307,121,0,440,0,6
8228,3,2456,2283,173,0,40,0,6
8229,2,2384,2460,-76,0,195,1,6
8230,2,2273,2406,-133,0,0,0,6
8231,2,2404,2207,197,0,241,0,6
8232,2,2425,2267,158,0,250,1,6
8233,2,2630,2557,73,0,132,0,6
8234,2,2284,2411,-127,0,256,0,6
8235,2,2663,2736,-73,0,210,1,6
8236,1,2521,2580,-59,0,470,0,6
8237,1,2417,2437,-20,0,0,0,6
8238,1,2504,2455,49,0,15,0,6
8239,1,2479,2296,183,0,122,0,6
8240,1,2514,2382,132,0,1,1,6
8241,2,2445,2413,32,0,58,0,6
8242,3,2418,2363,55,0,50,0,6
8243,2,2227,2455,-228,0,121,1,6
8244,1,2486,2245,241,0,0,1,6
8245,2,2432,2423,9,4,107,0,11
8246,1,2474,2287,187,0,30,0,8
8247,3,2425,2476,-51,0,466,0,6
8248,2,2247,2414,-167,0,372,1,6
8249,2,2259,2420,-161,0,302,1,6
8250,1,2458,2427,31,0,118,0,6
8251,1,2407,2327,80,0,110,1,6
8252,1,2623,2617,6,0,133,0,6
8253,1,2406,2424,-18,0,113,0,6
8254,1,2304,2432,-128,0,140,1,6
8255,1,2425,2303,122,0,143,0,6
8256,1,2352,2411,-59,0,45,0,6
8257,2,2414,2468,-54,0,13,0,6
8258,1,2297,2419,-122,0,3,0,6
8259,1,2408,2241,167,0,409,1,6
8260,3,2388,2520,-132,0,127,0,6
8261,1,2414,2364,50,0,221,1,6
8262,2,2748,2520,228,0,112,1,6
8263,2,2255,2477,-222,0,140,0,6
8264,2,2383,2414,-31,0,46,1,6
8265,2,2522,2435,87,0,37,0,6
8266,1,2437,2394,43,0,4,0,6
8267,2,2380,2482,-102,0,330,1,6
8268,2,2422,2397,25,0,310,0,6
8269,1,2305,2413,-108,0,202,0,6
8270,2,2409,2509,-100,0,250,0,6
8271,1,2377,2500,-123,0,48,1,6
8272,1,2445,2265,180,0,302,1,6
8273,2,2509,2540,-31,0,41,0,6
8274,1,2293,2475,-182,0,301,1,6
8275,2,2369,2608,-239,0,92,0,8
8276,3,2521,2507,14,0,4,0,6
8277,1,2442,2405,37,0,52,0,6
8278,3,2413,2290,123,0,306,0,6
8279,1,2432,2505,-73,0,315,1,6
8280,1,2540,2553,-13,0,112,0,6
8281,2,2420,2522,-102,0,101,0,6
8282,1,2516,2540,-24,0,214,0,6
8283,2,2359,2409,-50,0,305,0,6
8284,2,2408,2334,74,0,107,0,6
8285,1,2329,2414,-85,0,440,0,6
8286,1,2411,2311,100,0,101,1,6
8287,1,2436,2474,-38,0,333,1,6
8288,2,2278,2420,-142,0,255,0,6
8289,2,2276,2402,-126,0,374,0,6
8290,2,2556,2573,-17,0,426,0,6
8291,1,2471,2475,-4,0,120,0,6
8292,2,2515,2489,26,0,15,0,6
8293,2,2564,2623,-59,0,196,0,6
8294,2,2268,2432,-164,0,0,0,8
8295,2,2450,2332,118,0,334,1,6
8296,2,2529,2509,20,0,45,0,6
8297,1,2739,2253,486,0,202,0,6
8298,1,2857,2555,302,0,46,1,6
8299,2,2426,2447,-21,0,440,0,6
8300,1,2419,2400,19,0,351,0,6
8301,3,2378,2416,-38,0,300,0,6
8302,1,2457,2501,-44,0,45,1,6
8303,2,2406,2224,182,0,284,0,6
8304,2,2412,2445,-33,0,45,0,6
8305,1,2353,2435,-82,0,7,0,6
8306,2,2275,2417,-142,0,84,0,6
8307,1,2431,2424,7,0,200,0,6
8308,3,2315,2477,-162,0,292,0,8
8309,1,2601,2807,-206,0,101,0,6
8310,2,2439,2416,23,0,395,0,6
8311,2,2389,2741,-352,0,302,0,6
8312,2,2420,2363,57,0,123,0,6
8313,1,2465,2386,79,0,154,0,6
8314,2,2371,2402,-31,0,220,1,6
8315,2,2323,2411,-88,0,200,0,6
8316,1,2468,2341,127,0,176,0,6
8317,1,2628,2393,235,0,127,0,6
8318,1,2415,2463,-48,0,349,0,6
8319,2,2579,2551,28,0,435,0,6
8320,1,2424,2277,147,0,442,1,8
8321,1,2417,2515,-98,0,101,0,6
8322,1,2458,2448,10,0,258,0,6
8323,1,2473,2286,187,0,307,0,6
8324,3,2363,2426,-63,4,415,0,11
8325,1,2406,2322,84,0,213,1,6
8326,2,2293,2420,-127,0,195,0,6
8327,2,2465,2442,23,0,4,0,6
8328,2,2318,2415,-97,0,88,0,6
8329,2,2526,2518,8,0,45,1,6
8330,2,2345,2463,-118,0,40,0,6
8331,2,2291,2468,-177,0,310,0,6
8332,1,2408,2439,-31,0,37,1,6
8333,2,2419,2369,50,0,100,0,6
8334,1,2498,2414,84,0,40,0,6
8335,1,2420,2354,66,0,111,0,6
8336,3,2492,2280,212,0,127,0,8
8337,2,2362,2514,-152,0,335,0,6
8338,2,2378,2518,-140,0,101,0,6
8339,1,2545,2384,161,0,13,0,6
8340,1,2495,2272,223,0,5,1,6
8341,2,2464,2277,187,0,40,0,6
8342,1,2370,2548,-178,0,0,0,6
8343,1,2413,2364,49,0,1,0,6
8344,1,2742,2387,355,0,100,0,6
8345,2,2472,2292,180,0,134,0,6
8346,2,2337,2492,-155,0,291,1,6
8347,1,2400,2239,161,0,484,0,6
8348,1,2424,2403,21,0,50,0,6
8349,2,2395,2469,-74,0,0,1,6
8350,1,2408,2336,72,0,334,0,6
8351,1,2233,2424,-191,0,105,0,6
8352,2,2402,2417,-15,0,29,0,6
8353,2,2466,2509,-43,0,102,0,6
8354,2,2402,2351,51,0,44,0,6
8355,1,2453,2328,125,0,40,0,6
8356,1,2424,2322,102,0,210,0,6
8357,1,2274,2411,-137,0,200,0,6
8358,2,2337,2508,-171,0,0,0,6
8359,3,2386,2744,-358,0,303,0,6
8361,2,2496,2522,-26,0,337,0,6
8362,2,2358,2418,-60,0,112,1,6
8363,2,2523,2502,21,0,300,0,6
8364,3,2507,2521,-14,0,102,0,6
8365,1,2429,2412,17,0,200,1,6
8366,2,2416,2362,54,0,196,0,6
8367,2,2448,2459,-11,0,246,0,6
8368,1,2419,2437,-18,0,150,1,6
8369,1,2422,2390,32,0,105,0,6
8370,2,2628,2559,69,0,132,0,6
8371,2,2508,2442,66,0,190,0,6
8372,2,2858,2654,204,0,380,0,6
8373,1,2416,2318,98,0,122,0,6
8374,2,2330,2458,-128,0,300,0,6
8375,1,2554,2478,76,0,15,0,6
8376,3,2424,2293,131,0,42,0,6
8377,1,2467,2534,-67,0,380,0,6
8378,1,2310,2442,-132,0,48,0,6
8379,1,2369,2401,-32,0,43,0,6
8380,1,2424,2430,-6,0,301,0,6
8381,1,2471,2502,-31,0,201,0,6
8382,1,2573,2546,27,0,16,1,6
8383,1,2411,2455,-44,0,45,0,6
8384,3,2414,2391,23,0,20,0,6
8385,1,2470,2304,166,0,133,0,6
8386,1,2403,2390,13,0,120,0,6
8387,1,2557,2452,105,0,426,0,6
8388,2,2407,2396,11,0,320,0,6
8389,2,2386,2476,-90,0,240,0,6
8390,2,2290,2401,-111,0,15,0,6
8391,1,2319,2409,-90,0,112,0,8
8392,2,2423,2426,-3,0,337,0,6
8393,2,2258,2411,-153,0,133,0,6
8394,2,2380,2428,-48,0,335,0,8
8395,1,2428,2464,-36,0,245,0,6
8396,1,2215,2413,-198,0,101,0,6
8397,1,2508,2497,11,0,46,0,6
8398,1,2376,2517,-141,0,1,0,6
8399,1,2450,2407,43,0,1,1,6
8400,1,2524,2349,175,0,18,0,6
8401,3,2410,2253,157,0,213,0,6
8402,1,2486,2548,-62,0,107,0,6
8403,1,2387,2576,-189,0,113,0,6
8404,1,2422,2517,-95,0,354,0,6
8405,1,2403,2279,124,0,6,0,6
8406,3,2433,2281,152,0,100,0,6
8407,1,2377,2421,-44,0,14,0,6
8408,1,2539,2381,158,0,41,0,6
8409,2,2404,2282,122,0,41,1,6
8410,3,2739,2602,137,0,46,0,6
8411,2,2450,2401,49,0,295,1,6
8412,1,2495,2328,167,0,107,1,6
8413,1,2342,2409,-67,0,109,0,6
8414,3,2511,2395,116,0,201,0,6
8415,3,2461,2293,168,0,1,0,6
8416,2,2402,2286,116,0,27,0,6
8417,1,2364,2425,-61,4,46,0,11
8418,1,2423,2402,21,0,120,0,8
8419,1,2520,2474,46,0,200,0,6
8420,2,2308,2412,-104,0,90,0,6
8421,1,2492,2384,108,0,100,0,6
8422,1,2509,2514,-5,0,300,0,6
8423,2,2527,2490,37,0,211,0,6
8424,2,2530,2558,-28,0,317,1,6
8425,2,2369,2474,-105,0,151,0,6
8426,2,2391,2474,-83,0,0,0,6
8427,2,2449,2296,153,0,406,0,6
8428,1,2410,2237,173,0,150,1,6
8429,1,2411,2367,44,0,490,0,6
8430,2,2446,2489,-43,0,0,0,8
8431,1,2274,2418,-144,0,88,0,6
8432,2,2541,2647,-106,0,265,0,6
8433,2,2527,2392,135,0,106,0,6
8434,1,2566,2621,-55,0,409,0,6
8435,2,2799,2631,168,0,336,0,6
8436,2,2471,2543,-72,0,15,0,6
8437,1,2413,2255,158,0,305,0,6
8438,2,2361,2457,-96,0,427,0,6
8439,2,2223,2408,-185,0,107,1,6
8440,3,2378,2527,-149,0,48,0,6
8441,2,2232,2457,-225,0,211,0,6
8442,3,2604,2737,-133,0,201,0,6
8443,2,2511,2561,-50,0,202,1,6
8444,3,2443,2427,16,0,127,0,6
8445,2,2368,2740,-372,0,409,1,6
8446,1,2417,2324,93,0,46,1,6
8447,1,2612,2504,108,0,4,0,6
8448,2,2480,2422,58,0,17,0,6
8449,2,2424,2416,8,0,426,1,6
8450,3,2521,2375,146,0,0,0,6
8451,1,2431,2542,-111,0,2,0,6
8452,2,2326,2501,-175,0,300,1,6
8453,1,2314,2420,-106,0,100,0,6
8454,1,2385,2457,-72,0,80,0,6
8455,3,2419,2372,47,4,110,0,11
8456,2,2381,2508,-127,0,315,0,6
8457,1,2368,2430,-62,0,400,0,6
8458,1,2406,2434,-28,0,106,0,6
8459,2,2496,2477,19,0,129,0,6
8460,1,2497,2335,162,0,310,0,6
8461,1,2400,2318,82,0,315,1,6
8462,2,2298,2434,-136,0,301,0,6
8463,2,2530,2735,-205,0,40,0,6
8464,1,2397,2402,-5,0,41,0,6
8465,2,2449,2493,-44,0,28,0,6
8466,2,2391,2585,-194,0,171,0,6
8467,2,2478,2352,126,0,10,0,6
8468,3,2496,2258,238,0,200,0,6
8469,2,2416,2380,36,0,4,1,6
8470,1,2386,2413,-27,0,253,0,6
8471,1,2588,2388,200,0,123,0,6
8472,1,2478,2365,113,0,115,0,6
8473,2,2313,2446,-133,0,140,0,6
8474,1,2413,2322,91,0,122,0,6
8475,1,2307,2474,-167,0,278,0,8
8476,1,2422,2381,41,0,107,0,6
8477,2,2275,2406,-131,0,409,0,6
8478,2,2424,2268,156,0,2,1,6
8479,1,2418,2335,83,0,466,0,6
8480,2,2441,2301,140,0,302,0,6
8481,1,2510,2385,125,0,485,0,6
8483,1,2469,2457,12,0,0,1,6
8484,1,2459,2338,121,0,115,1,6
8485,1,2401,2244,157,0,11,0,6
8486,1,2504,2499,5,0,48,0,6
8487,1,2520,2507,13,0,4,0,6
8488,2,2403,2370,33,0,0,0,6
8489,1,2343,2430,-87,0,141,0,6
8490,3,2433,2346,87,0,106,0,6
8491,1,2514,2561,-47,0,406,1,6
8492,1,2461,2357,104,0,15,0,6
8493,1,2433,2487,-54,0,106,0,6
8494,1,2428,2413,15,0,200,0,6
8496,1,2547,2444,103,0,45,0,6
8497,1,2429,2473,-44,0,52,0,6
8498,2,2381,2458,-77,0,135,0,6
8499,2,2510,2422,88,0,120,0,6
8500,1,2741,2403,338,0,202,0,6
8501,2,2411,2413,-2,0,210,0,6
8502,1,2405,2455,-50,0,34,0,6
8503,2,2317,2467,-150,0,300,0,6
8504,2,2269,2522,-253,4,203,0,13
8505,2,2512,2517,-5,0,300,0,6
8506,1,2566,2506,60,0,307,1,6
8507,2,2567,2422,145,0,15,1,6
8508,1,2377,2417,-40,0,302,1,6
8509,2,2525,2356,169,0,460,0,6
8510,1,2738,2527,211,0,46,0,6
8511,1,2427,2442,-15,0,258,0,6
8512,2,2490,2525,-35,0,485,0,6
8513,1,2520,2410,110,0,152,0,6
8514,1,2309,2493,-184,0,101,0,6
8515,1,2464,2506,-42,0,236,1,6
8516,1,2534,2483,51,0,16,0,6
8517,1,2422,2418,4,0,176,1,6
8518,2,2451,2440,11,0,128,0,6
8519,1,2427,2419,8,0,175,1,6
8520,1,2460,2299,161,0,302,0,6
8521,3,2448,2439,9,0,85,0,6
8522,2,2318,2417,-99,0,123,0,6
8523,1,2631,2573,58,0,132,0,6
8524,1,2406,2392,14,0,44,0,6
8525,2,2335,2432,-97,4,113,0,13
8526,2,2260,2433,-173,0,101,0,8
8527,1,2408,2380,28,0,241,0,6
8528,2,2392,2463,-71,0,106,1,6
8529,1,2438,2294,144,0,100,0,6
8530,1,2657,2791,-134,0,267,0,6
8531,1,2385,2590,-205,0,171,0,6
8532,1,2484,2396,88,0,5,0,6
8533,1,2475,2295,180,0,43,0,6
8534,2,2425,2448,-23,0,7,0,6
8535,1,2404,2388,16,0,151,0,6
8536,1,2428,2260,168,0,220,0,6
8537,1,2404,2278,126,0,52,0,6
8538,1,2407,2417,-10,0,58,0,6
8539,3,2404,2368,36,0,434,0,6
8540,1,2360,2410,-50,0,45,0,6
8541,1,2498,2391,107,0,107,0,6
8542,2,2377,2519,-142,0,111,0,6
8543,2,2413,2444,-31,0,88,0,6
8544,2,2588,2480,108,0,40,0,6
8545,1,2408,2303,105,0,100,0,6
8546,3,2423,2233,190,0,386,0,6
8547,1,2500,2402,98,0,127,1,6
8548,1,2506,2489,17,0,46,1,6
8549,3,2522,2392,130,0,45,0,6
8550,1,2549,2482,67,0,120,0,6
8551,1,2462,2325,137,0,46,1,6
8552,2,2298,2402,-104,0,15,0,6
8553,1,2419,2429,-10,0,130,0,6
8554,1,2308,2503,-195,0,40,1,6
8555,1,2287,2405,-118,0,4,0,6
8556,1,2367,2524,-157,0,392,0,6
8557,1,2353,2416,-63,0,337,1,6
8558,2,2401,2256,145,0,200,0,6
8559,2,2330,2421,-91,0,40,1,6
8560,1,2576,2442,134,0,352,0,6
8561,2,2557,2750,-193,0,113,0,6
8562,1,2422,2389,33,0,360,0,6
8563,2,2300,2462,-162,0,103,0,6
8564,2,2374,2742,-368,0,409,0,6
8565,1,2413,2305,108,0,40,0,6
8566,1,2420,2289,131,0,14,0,6
8567,2,2375,2496,-121,0,80,0,6
8568,1,2419,2417,2,0,7,1,6
8569,3,2451,2387,64,0,133,0,6
8570,1,2248,2400,-152,0,122,0,6
8571,1,2409,2277,132,0,108,0,8
8572,1,2351,2410,-59,0,344,1,6
8573,2,2468,2520,-52,0,0,1,6
8574,1,2555,2740,-185,0,200,0,6
8575,1,2441,2551,-110,0,113,0,6
8576,1,2440,2445,-5,0,263,0,6
8577,2,2565,2650,-85,0,9,0,6
8578,2,2470,2568,-98,0,487,1,6
8579,1,2501,2571,-70,0,202,0,6
8580,1,2377,2412,-35,0,15,0,6
8581,3,2435,2463,-28,0,207,0,6
8582,2,2411,2319,92,0,322,1,6
8583,1,2539,2333,206,0,41,0,6
8584,2,2520,2366,154,0,45,0,6
8585,2,2403,2312,91,0,404,0,6
8586,2,2566,2343,223,0,211,0,8
8587,1,2413,2428,-15,0,426,0,6
8588,1,2436,2433,3,0,45,0,6
8589,2,2517,2479,38,0,16,1,6
8590,1,2448,2453,-5,0,310,0,6
8591,2,2420,2252,168,4,313,0,13
8592,1,2439,2479,-40,0,109,1,6
8593,1,2295,2471,-176,0,9,0,6
8594,2,2553,2485,68,0,200,0,6
8595,1,2425,2393,32,0,101,0,6
8596,1,2423,2313,110,0,45,0,6
8597,1,2478,2354,124,0,242,1,6
8598,1,2407,2434,-27,0,106,0,6
8599,2,2488,2636,-148,0,1,1,6
8600,2,2394,2554,-160,0,144,1,6
8601,1,2412,2350,62,0,207,0,6
8602,1,2436,2257,179,0,306,1,8
8603,1,2400,2388,12,0,20,0,6
8604,1,2365,2439,-74,0,80,0,6
8605,2,2392,2430,-38,0,1,0,6
8606,1,2413,2258,155,0,127,0,6
8607,2,2560,2526,34,0,96,1,6
8608,2,2537,2753,-216,0,110,0,6
8609,1,2506,2340,166,0,45,1,6
8610,2,2304,2408,-104,0,211,0,6
8611,1,2483,2317,166,0,4,1,6
8612,1,2494,2338,156,0,241,0,6
8613,1,2744,2512,232,0,101,0,6
8614,1,2313,2404,-91,0,41,0,6
8615,1,2432,2262,170,0,44,0,6
8616,1,2421,2387,34,0,57,0,6
8617,3,2236,2403,-167,0,109,0,6
8618,1,2400,2580,-180,0,337,0,6
8619,2,2438,2446,-8,0,453,0,6
8620,2,2484,2502,-18,0,45,0,6
8621,2,2342,2417,-75,0,15,0,6
8622,3,2376,2427,-51,0,300,0,6
8623,1,2466,2439,27,0,300,0,6
8624,2,2355,2452,-97,0,57,1,6
8625,2,2426,2326,100,0,110,0,6
8626,2,2404,2272,132,0,40,0,6
8627,1,2523,2374,149,0,0,0,6
8628,3,2404,2370,34,0,46,0,6
8629,2,2516,2506,10,0,101,0,6
8630,1,2542,2360,182,0,28,0,6
8631,2,2371,2403,-32,0,228,0,6
8632,3,2282,2538,-256,0,110,0,6
8633,2,2403,2500,-97,0,167,1,6
8634,1,2411,2393,18,0,352,0,6
8635,1,2544,2616,-72,0,300,0,6
8636,1,2448,2454,-6,0,405,1,6
8637,2,2298,2429,-131,0,311,0,6
8638,1,2564,2508,56,0,307,0,6
8639,1,2432,2419,13,0,176,0,6
8640,1,2320,2512,-192,0,112,0,6
8641,2,2406,2422,-16,0,29,0,6
8642,2,2397,2472,-75,0,145,0,6
8643,1,2563,2562,1,0,101,0,6
8644,2,2333,2418,-85,0,40,0,6
8645,1,2525,2525,0,0,56,0,6
8646,1,2655,2561,94,0,487,1,6
8647,1,2431,2379,52,0,120,0,6
8648,2,2428,2442,-14,0,270,0,6
8649,1,2572,2441,131,0,202,0,6
8650,2,2530,2417,113,0,332,0,6
8651,1,2318,2427,-109,0,125,0,6
8652,2,2207,2499,-292,0,426,1,6
8653,3,2510,2510,0,0,42,0,6
8654,2,2406,2485,-79,0,386,0,6
8655,1,2472,2445,27,0,101,0,6
8656,2,2462,2450,12,0,46,0,6
8657,2,2340,2406,-66,0,45,0,6
8658,2,2407,2229,178,0,106,0,6
8659,2,2746,2497,249,0,100,1,6
8660,1,2403,2278,125,0,409,0,6
8661,2,2435,2424,11,0,109,0,6
8662,3,2353,2435,-82,0,202,0,6
8663,2,2463,2547,-84,0,112,0,6
8664,1,2427,2413,14,0,200,0,6
8665,1,2314,2400,-86,0,40,0,6
8666,1,2463,2262,201,0,200,0,6
8667,2,2509,2486,23,0,40,0,6
8668,2,2444,2393,51,0,4,0,6
8669,2,2481,2492,-11,0,204,0,6
8670,3,2513,2502,11,0,0,0,6
8671,3,2506,2639,-133,0,320,0,6
8672,2,2558,2391,167,0,127,0,6
8673,2,2349,2605,-256,0,338,1,6
8674,2,2387,2503,-116,0,306,1,6
8675,2,2484,2551,-67,0,1,0,6
8676,1,2569,2609,-40,0,326,0,6
8677,2,2755,2700,55,0,40,1,6
8678,2,2361,2545,-184,0,37,0,6
8679,2,2311,2412,-101,0,375,0,8
8680,2,2357,2404,-47,0,331,0,6
8681,1,2535,2426,109,0,46,1,6
8682,2,2310,2471,-161,0,130,0,6
8683,1,2477,2370,107,0,48,1,6
8684,1,2272,2409,-137,0,216,0,6
8685,2,2556,2433,123,0,330,0,6
8686,1,2478,2307,171,0,0,0,6
8687,2,2473,2411,62,0,190,1,6
8688,1,2452,2432,20,0,112,0,6
8689,2,2317,2418,-101,4,192,1,11
8690,2,2504,2379,125,0,45,0,6
8691,1,2412,2299,113,0,38,0,6
8692,2,2408,2366,42,0,263,0,6
8693,1,2572,2410,162,0,46,0,6
8694,3,2489,2401,88,0,46,0,6
8695,1,2318,2402,-84,0,101,0,6
8696,2,2448,2422,26,0,127,1,6
8698,2,2420,2293,127,0,45,0,6
8699,2,2532,2553,-21,0,30,0,6
8700,3,2299,2421,-122,0,16,0,6
8701,1,2504,2399,105,0,172,1,6
8702,2,2440,2478,-38,0,218,1,6
8703,2,2352,2557,-205,0,7,0,8
8704,1,2413,2438,-25,0,85,0,6
8705,2,2416,2392,24,0,211,0,8
8706,3,2521,2526,-5,0,338,0,6
8707,1,2466,2303,163,0,120,0,6
8708,2,2359,2510,-151,0,45,0,6
8709,1,2548,2373,175,0,454,0,6
8710,1,2531,2372,159,0,485,0,6
8711,1,2387,2737,-350,0,130,0,6
8712,1,2507,2238,269,0,106,1,6
8713,2,2437,2423,14,0,140,0,6
8714,2,2294,2408,-114,0,102,0,6
8715,3,2292,2430,-138,0,107,0,6
8716,1,2556,2480,76,0,40,0,6
8717,3,2320,2421,-101,2,110,0,25
8718,2,2576,2510,66,0,264,0,6
8719,2,2448,2454,-6,0,310,0,6
8720,1,2414,2264,150,0,7,0,6
8721,1,2408,2433,-25,0,44,1,6
8722,2,2412,2444,-32,0,37,1,8
8723,2,2436,2551,-115,0,338,0,6
8724,1,2302,2474,-172,0,133,1,6
8725,3,2493,2321,172,0,374,0,6
8726,2,2393,2503,-110,0,101,0,6
8727,2,2500,2637,-137,0,323,0,6
8728,3,2430,2330,100,0,200,0,6
8729,1,2560,2349,211,0,211,0,8
8730,2,2556,2548,8,0,41,0,6
8731,2,2386,2552,-166,0,101,0,6
8732,2,2575,2445,130,0,112,1,6
8733,1,2523,2578,-55,0,15,0,6
8734,2,2297,2462,-165,0,134,0,6
8735,3,2257,2407,-150,0,0,0,6
8736,1,2387,2428,-41,0,40,0,6
8737,2,2332,2496,-164,0,112,0,6
8738,2,2409,2352,57,0,414,0,6
8739,1,2428,2502,-74,0,58,1,6
8740,1,2513,2537,-24,0,0,0,6
8741,1,2497,2573,-76,0,107,1,6
8742,2,2425,2268,157,0,107,1,6
8743,2,2444,2457,-13,0,410,1,6
8744,1,2471,2266,205,0,110,0,6
8745,1,2546,2507,39,0,307,0,6
8746,2,2433,2396,37,0,210,1,6
8747,1,2603,2508,95,0,202,0,6
8748,2,2247,2424,-177,0,4,0,6
8749,1,2517,2459,58,0,28,0,6
8750,2,2513,2356,157,0,112,0,6
8751,2,2507,2539,-32,0,40,0,6
8752,1,2422,2386,36,0,56,0,6
8753,1,2749,2575,174,0,46,0,6
8754,1,2411,2399,12,0,107,1,6
8755,2,2383,2412,-29,0,41,1,6
8756,1,2416,2345,71,0,15,1,6
8757,1,2424,2427,-3,0,110,1,6
8758,2,2428,2442,-14,0,65,0,6
8759,1,2481,2307,174,0,43,1,6
8760,1,2439,2436,3,4,110,1,13
8761,2,2560,2569,-9,0,45,1,6
8762,2,2399,2534,-135,0,225,0,6
8763,1,2483,2435,48,0,21,0,6
8764,2,2429,2431,-2,0,101,0,6
8765,1,2417,2427,-10,0,334,0,6
8766,2,2282,2403,-121,0,395,0,6
8767,2,2551,2475,76,0,100,0,6
8768,2,2330,2508,-178,0,190,0,6
8769,1,2432,2260,172,0,101,0,6
8770,1,2234,2410,-176,0,150,1,8
8771,1,2419,2607,-188,0,344,0,6
8772,2,2641,2555,86,0,101,0,6
8773,2,2459,2443,16,0,46,0,6
8774,2,2332,2497,-165,0,106,0,6
8775,1,2326,2401,-75,0,40,0,6
8776,1,2390,2490,-100,0,106,0,6
8778,3,2526,2522,4,0,211,0,6
8779,3,2303,2419,-116,0,146,0,6
8780,1,2402,2290,112,0,438,0,6
8781,2,2482,2544,-62,0,1,0,6
8782,1,2454,2616,-162,0,112,0,6
8783,2,2550,2378,172,0,122,0,6
8784,1,2550,2395,155,0,0,0,6
8785,1,2471,2458,13,0,46,0,6
8786,1,2446,2302,144,0,234,1,6
8787,1,2375,2410,-35,0,146,0,6
8788,2,2281,2427,-146,0,0,0,6
8789,1,2522,2526,-4,0,7,0,6
8790,3,2416,2466,-50,0,400,0,6
8791,2,2476,2429,47,0,245,1,6
8792,2,2398,2504,-106,0,132,1,6
8793,1,2499,2502,-3,0,300,0,6
8794,1,2333,2509,-176,0,40,1,6
8795,1,2505,2432,73,0,112,1,6
8796,1,2572,2538,34,0,13,1,6
8797,3,2562,2530,32,0,330,0,6
8798,1,2418,2240,178,0,51,0,6
8799,3,2428,2280,148,0,4,0,6
8800,1,2447,2395,52,0,334,1,6
8801,2,2431,2292,139,0,40,1,6
8802,1,2422,2225,197,0,156,1,6
8803,3,2599,2634,-35,0,122,0,6
8804,1,2328,2464,-136,0,40,1,6
8805,1,2448,2335,113,0,223,1,6
8806,3,2502,2555,-53,0,110,0,6
8807,1,2449,2453,-4,0,192,1,6
8808,2,2405,2567,-162,0,133,1,6
8809,1,2450,2368,82,0,151,0,6
8810,1,2450,2292,158,0,12,1,6
8811,1,2234,2545,-311,0,40,0,6
8812,1,2496,2446,50,0,123,1,6
8813,2,2366,2481,-115,0,310,0,6
8814,1,2466,2381,85,0,241,0,6
8815,1,2402,2286,116,0,335,0,6
8816,2,2380,2450,-70,0,221,0,8
8817,2,2376,2435,-59,0,255,0,6
8818,1,2727,2414,313,0,130,0,6
8819,2,2293,2474,-181,0,101,0,6
8820,1,2417,2382,35,0,131,0,6
8821,2,2404,2328,76,4,207,0,13
8822,2,2430,2488,-58,0,101,0,6
8823,1,2500,2328,172,0,311,0,6
8824,2,2394,2417,-23,0,135,1,6
8825,1,2465,2452,13,0,10,1,6
8826,1,2437,2423,14,0,30,1,6
8827,2,2447,2423,24,0,130,1,6
8828,1,2335,2438,-103,0,5,1,6
8829,1,2589,2257,332,0,0,1,6
8830,1,2642,2569,73,0,151,0,6
8831,2,2466,2389,77,0,45,0,6
8832,1,2427,2414,13,0,110,0,6
8833,1,2407,2386,21,0,313,0,6
8834,1,2389,2476,-87,0,150,0,6
8835,3,2572,2752,-180,0,335,0,6
8836,2,2235,2489,-254,0,200,0,6
8837,1,2497,2265,232,0,45,0,6
8838,2,2421,2430,-9,0,43,0,6
8839,2,2403,2559,-156,0,49,0,6
8840,1,2511,2393,118,0,295,0,6
8841,2,2373,2427,-54,0,385,0,6
8842,1,2474,2377,97,0,43,1,6
8843,1,2520,2527,-7,0,211,1,6
8844,2,2308,2421,-113,0,45,0,6
8845,2,2413,2313,100,0,45,0,6
8846,2,2397,2729,-332,0,45,0,6
8847,2,2339,2525,-186,4,200,0,13
8848,1,2566,2575,-9,0,190,0,6
8849,2,2327,2404,-77,0,190,1,6
8850,2,2331,2469,-138,0,101,0,7
8851,2,2278,2436,-158,0,300,0,6
8852,1,2339,2484,-145,0,359,0,6
8853,1,2452,2476,-24,0,40,0,6
8854,2,2403,2299,104,0,190,0,6
8855,1,2501,2255,246,0,120,0,6
8856,1,2423,2245,178,0,45,0,6
8857,1,2418,2321,97,0,455,0,6
8858,1,2435,2416,19,0,110,0,6
8859,1,2535,2348,187,0,302,0,6
8860,1,2549,2477,72,0,100,0,6
8861,1,2235,2404,-169,0,106,1,6
8862,1,2396,2555,-159,0,103,1,6
8863,1,2544,2391,153,0,100,0,6
8864,1,2732,2576,156,0,48,1,6
8865,1,2459,2406,53,0,91,1,6
8866,2,2398,2452,-54,0,46,0,8
8867,1,2499,2484,15,0,41,0,6
8868,2,2562,2520,42,0,380,0,6
8869,2,2387,2542,-155,0,327,1,6
8870,1,2476,2350,126,0,302,0,6
8871,1,2406,2361,45,0,152,0,6
8872,3,2565,2647,-82,0,289,0,6
8873,2,2343,2401,-58,0,140,0,6
8874,1,2418,2283,135,0,89,0,6
8875,3,2610,2553,57,0,409,0,6
8876,1,2730,2495,235,0,112,0,6
8877,2,2403,2396,7,0,176,0,6
8878,1,2305,2490,-185,0,177,0,6
8879,1,2435,2396,39,0,146,0,6
8880,1,2533,2327,206,0,41,1,6
8881,2,2503,2577,-74,0,195,0,6
8882,1,2473,2555,-82,0,1,0,6
8883,1,2526,2529,-3,0,459,0,6
8884,1,2456,2282,174,0,41,0,6
8885,3,2425,2327,98,0,200,0,6
8886,1,2554,2458,96,0,200,0,6
8887,1,2508,2400,108,0,190,1,6
8888,2,2571,2451,120,0,324,0,6
8889,1,2409,2390,19,0,334,0,6
8890,2,2433,2441,-8,0,403,0,6
8891,1,2569,2504,65,0,132,0,6
8892,2,2325,2503,-178,0,106,0,6
8893,2,2448,2455,-7,0,46,0,6
8894,2,2423,2505,-82,0,101,0,6
8895,1,2479,2503,-24,0,4,0,6
8896,3,2421,2261,160,0,331,0,6
8897,2,2749,2575,174,0,46,1,6
8898,1,2493,2425,68,0,197,0,6
8899,1,2454,2350,104,0,7,1,6
8900,1,2477,2397,80,0,120,1,6
8901,1,2404,2288,116,0,225,0,6
8902,1,2470,2470,0,0,45,0,6
8903,1,2421,2399,22,0,341,1,6
8904,1,2409,2433,-24,0,106,0,6
8905,1,2485,2429,56,0,6,0,6
8906,1,2402,2351,51,0,400,0,8
8907,1,2501,2478,23,0,115,0,6
8908,1,2387,2515,-128,0,211,0,6
8909,2,2242,2440,-198,0,1,1,6
8910,2,2429,2441,-12,0,225,0,6
8911,2,2418,2443,-25,0,4,1,6
8912,1,2404,2381,23,0,9,0,6
8913,1,2272,2510,-238,0,200,0,6
8914,2,2548,2572,-24,0,45,0,6
8915,2,2396,2478,-82,0,45,1,6
8916,2,2356,2411,-55,0,331,0,6
8917,2,2304,2471,-167,0,45,0,6
8918,1,2405,2419,-14,0,40,0,6
8919,1,2424,2260,164,0,335,0,6
8920,1,2509,2321,188,0,45,0,6
8921,1,2441,2543,-102,0,101,0,6
8922,1,2298,2426,-128,0,352,0,6
8923,2,2578,2480,98,0,100,0,6
8924,1,2442,2359,83,0,334,0,6
8925,2,2449,2260,189,0,153,0,8
8926,1,2366,2401,-35,0,380,0,6
8927,2,2263,2404,-141,0,70,1,6
8928,1,2345,2480,-135,0,44,0,6
8929,1,2522,2526,-4,0,331,0,6
8930,1,2475,2399,76,0,45,0,6
8931,1,2607,2558,49,0,113,1,6
8932,2,2364,2416,-52,0,40,0,6
8933,1,2414,2422,-8,0,4,0,6
8934,1,2497,2273,224,0,100,1,6
8935,1,2733,2485,248,0,153,0,6
8936,2,2358,2418,-60,0,133,0,6
8937,1,2405,2395,10,0,16,0,6
8938,2,2268,2426,-158,0,474,0,6
8939,2,2410,2441,-31,0,70,0,6
8940,1,2423,2409,14,0,463,0,6
8941,1,2499,2460,39,0,301,1,6
8942,1,2373,2404,-31,0,57,0,6
8943,3,2432,2368,64,0,411,0,6
8944,2,2345,2402,-57,0,474,0,6
8945,3,2382,2538,-156,0,1,0,6
8946,2,2547,2646,-99,0,344,0,6
8947,2,2331,2446,-115,0,300,0,6
8948,1,2455,2375,80,0,46,0,8
8949,2,2573,2735,-162,0,112,1,6
8950,2,2408,2275,133,0,250,0,6
8951,1,2562,2399,163,0,200,0,6
8952,1,2608,2278,330,0,488,0,8
8953,2,2554,2526,28,0,107,0,6
8954,1,2609,2506,103,0,57,0,6
8955,2,2545,2383,162,0,122,0,6
8956,1,2431,2343,88,0,455,1,6
8957,3,2536,2459,77,0,96,0,6
8958,1,2581,2499,82,0,10,0,6
8959,1,2536,2417,119,0,40,1,6
8960,1,2483,2315,168,0,8,0,6
8961,2,2499,2735,-236,0,120,0,6
8962,1,2460,2442,18,0,310,0,6
8963,1,2388,2484,-96,0,152,1,6
8964,1,2409,2346,63,0,458,0,6
8965,1,2421,2497,-76,0,233,1,6
8966,3,2271,2428,-157,0,0,0,6
8967,1,2618,2548,70,0,45,0,6
8968,1,2348,2494,-146,0,41,0,8
8969,2,2533,2524,9,0,487,0,6
8970,3,2375,2465,-90,0,45,0,6
8971,2,2437,2555,-118,0,40,0,6
8972,2,2508,2464,44,0,133,0,6
8973,2,2265,2423,-158,0,301,0,6
8974,3,2333,2512,-179,0,315,0,6
8975,1,2415,2319,96,0,321,0,6
8976,2,2583,2741,-158,0,335,0,6
8977,1,2474,2301,173,0,114,0,6
8978,1,2501,2442,59,0,242,0,6
8979,1,2458,2427,31,0,7,1,6
8980,3,2446,2289,157,0,380,0,6
8981,1,2406,2481,-75,0,300,0,6
8982,1,2472,2356,116,0,45,0,6
8983,2,2386,2434,-48,0,15,0,6
8984,2,2421,2409,12,0,217,0,6
8985,1,2421,2358,63,0,375,0,6
8986,2,2465,2395,70,0,115,1,6
8987,1,2446,2405,41,0,335,0,6
8988,2,2294,2417,-123,0,125,0,6
8989,1,2408,2244,164,0,107,0,6
8990,1,2333,2417,-84,0,162,1,6
8991,3,2520,2528,-8,0,40,0,6
8992,1,2429,2355,74,0,4,0,6
8993,2,2331,2497,-166,0,0,0,6
8994,1,2236,2411,-175,0,132,0,6
8995,2,2422,2250,172,0,0,0,6
8996,1,2412,2286,126,0,125,0,6
8997,1,2394,2426,-32,0,15,1,6
8998,2,2382,2422,-40,0,106,0,6
8999,1,2442,2273,169,0,142,1,6
9000,1,2448,2542,-94,0,113,0,6
9001,2,2481,2543,-62,0,77,0,6
9002,3,2385,2443,-58,0,300,0,6
9003,1,2274,2407,-133,0,122,0,8
9004,2,2393,2405,-12,0,367,0,6
9005,1,2473,2300,173,0,343,0,6
9006,2,2390,2411,-21,0,147,0,6
9007,2,2466,2494,-28,0,307,1,6
9008,1,2266,2437,-171,0,122,0,6
9009,2,2362,2419,-57,0,20,0,6
9010,2,2486,2738,-252,0,103,1,6
9011,1,2396,2565,-169,0,107,1,6
9012,2,2744,2580,164,0,46,0,6
9013,1,2586,2571,15,0,130,0,6
9014,2,2476,2455,21,0,45,0,6
9015,2,2406,2504,-98,0,302,0,6
9016,2,2502,2614,-112,0,123,0,6
9017,1,2426,2415,11,0,142,1,6
9018,1,2301,2424,-123,0,101,0,6
9019,1,2480,2333,147,0,45,1,6
9020,3,2373,2490,-117,0,202,0,6
9021,1,2398,2540,-142,0,0,0,6
9022,1,2450,2369,81,0,263,0,6
9023,1,2554,2487,67,0,100,0,6
9024,1,2254,2425,-171,0,142,0,6
9025,2,2543,2622,-79,0,125,0,6
9026,2,2392,2537,-145,0,245,0,6
9027,3,2453,2661,-208,0,345,0,6
9028,1,2739,2570,169,0,303,0,6
9029,1,2365,2455,-90,0,295,0,6
9030,1,2389,2455,-66,0,106,0,6
9031,1,2547,2535,12,0,118,0,6
9032,1,2380,2534,-154,0,335,0,6
9033,2,2501,2428,73,0,400,0,6
9034,2,2431,2463,-32,4,335,0,13
9035,1,2463,2414,49,0,1,0,6
9036,1,2532,2477,55,0,57,0,6
9037,2,2341,2471,-130,0,45,1,6
9038,1,2400,2519,-119,0,46,1,6
9039,2,2307,2459,-152,0,320,0,6
9040,2,2329,2400,-71,0,45,0,6
9041,2,2406,2535,-129,0,151,0,6
9042,1,2426,2393,33,0,46,0,6
9043,1,2283,2426,-143,0,469,1,6
9044,2,2377,2506,-129,0,45,0,6
9045,2,2438,2558,-120,0,112,0,6
9046,2,2298,2477,-179,0,45,0,6
9047,2,2351,2476,-125,0,354,0,6
9048,1,2368,2426,-58,0,215,0,6
9049,1,2483,2553,-70,0,1,0,6
9051,1,2316,2428,-112,0,354,0,6
9052,3,2367,2444,-77,0,264,0,6
9053,2,2424,2357,67,0,375,0,6
9054,2,2329,2416,-87,0,211,0,6
9055,2,2422,2447,-25,4,100,0,11
9056,1,2415,2330,85,0,113,0,6
9057,1,2439,2381,58,0,153,0,6
9058,3,2339,2435,-96,0,5,0,6
9059,1,2403,2391,12,0,7,0,6
9060,1,2413,2359,54,0,211,0,6
9061,1,2537,2403,134,0,40,0,6
9062,1,2562,2506,56,0,107,0,6
9063,1,2407,2210,197,0,309,0,6
9064,2,2448,2539,-91,0,40,0,6
9065,2,2258,2412,-154,0,130,1,6
9066,1,2428,2275,153,0,400,1,6
9067,1,2527,2520,7,0,0,0,6
9068,2,2264,2431,-167,0,110,0,6
9069,1,2412,2395,17,0,127,1,6
9070,2,2276,2609,-333,0,123,0,8
9071,1,2440,2295,145,0,343,0,6
9072,2,2500,2461,39,0,189,1,6
9073,2,2472,2539,-67,0,50,1,6
9074,1,2382,2424,-42,0,0,0,6
9075,2,2509,2402,107,0,40,0,6
9076,2,2278,2416,-138,0,4,1,6
9077,1,2589,2736,-147,0,335,0,6
9078,3,2509,2470,39,0,302,0,6
9079,2,2446,2412,34,0,222,0,6
9080,2,2416,2354,62,0,18,0,6
9081,2,2468,2509,-41,0,213,0,6
9082,1,2618,2498,120,0,317,0,6
9083,1,2409,2526,-117,0,400,0,6
9084,1,2657,2542,115,0,113,0,6
9085,2,2463,2483,-20,0,147,0,6
9086,1,2514,2254,260,0,211,0,6
9087,2,2526,2386,140,0,1,0,6
9088,2,2421,2325,96,0,122,1,6
9089,1,2448,2372,76,0,295,0,6
9090,1,2565,2456,109,0,101,0,6
9091,1,2566,2742,-176,0,206,0,6
9092,1,2541,2388,153,0,133,0,6
9093,1,2407,2388,19,0,133,0,6
9094,1,2390,2419,-29,0,300,0,6
9095,2,2380,2473,-93,0,112,0,6
9096,3,2515,2533,-18,0,301,0,6
9097,1,2562,2458,104,0,0,1,6
9098,2,2289,2444,-155,0,3,0,6
9099,2,2581,2591,-10,0,463,0,6
9100,2,2228,2486,-258,0,184,1,8
9101,2,2443,2417,26,0,65,1,6
9102,1,2416,2270,146,0,43,0,6
9103,1,2418,2432,-14,0,301,1,6
9104,2,2252,2517,-265,0,205,0,6
9105,1,2420,2366,54,0,107,1,6
9106,1,2432,2520,-88,0,48,0,6
9107,3,2400,2277,123,0,15,0,6
9108,2,2439,2300,139,0,454,0,8
9109,3,2474,2321,153,0,300,0,6
9110,1,2441,2340,101,0,45,0,6
9111,2,2407,2457,-50,0,410,1,6
9112,1,2529,2439,90,0,301,0,6
9113,2,2410,2297,113,0,13,0,6
9114,1,2295,2418,-123,0,45,0,6
9115,2,2439,2399,40,0,190,0,6
9116,1,2409,2432,-23,0,106,0,6
9117,3,2418,2443,-25,0,40,0,6
9118,1,2480,2461,19,0,46,1,6
9119,2,2417,2354,63,0,200,0,6
9120,1,2530,2389,141,0,52,0,6
9121,2,2490,2662,-172,0,1,0,6
9122,1,2346,2444,-98,0,40,0,6
9123,2,2543,2527,16,0,1,0,6
9124,1,2425,2340,85,0,454,0,6
9125,3,2633,2533,100,0,118,0,6
9126,1,2501,2393,108,0,200,0,8
9127,3,2419,2291,128,0,405,0,6
9128,2,2414,2352,62,0,190,1,6
9129,2,2367,2452,-85,0,295,0,6
9130,1,2476,2382,94,0,43,0,6
9131,2,2409,2501,-92,0,4,0,6
9132,2,2519,2434,85,0,485,0,6
9133,1,2415,2323,92,0,213,0,6
9134,2,2279,2519,-240,0,202,0,6
9135,1,2447,2284,163,0,4,0,6
9136,1,2488,2334,154,0,45,0,6
9137,2,2279,2417,-138,0,469,1,6
9138,2,2423,2367,56,0,106,0,6
9139,1,2728,2597,131,0,413,0,6
9140,1,2463,2411,52,0,130,0,6
9141,1,2508,2621,-113,0,302,0,6
9142,2,2485,2494,-9,0,101,0,6
9143,2,2415,2444,-29,0,404,1,6
9144,1,2417,2466,-49,4,140,0,11
9145,2,2404,2430,-26,0,150,0,6
9146,1,2435,2385,50,0,131,0,6
9147,1,2471,2493,-22,0,101,1,6
9148,1,2374,2458,-84,0,102,0,6
9149,1,2593,2732,-139,0,335,0,6
9150,1,2389,2505,-116,0,40,1,8
9151,2,2439,2467,-28,0,46,0,6
9152,2,2734,2575,159,0,0,0,6
9153,1,2544,2597,-53,0,301,0,6
9154,1,2576,2467,109,0,57,0,6
9155,1,2513,2391,122,0,398,0,6
9156,1,2297,2404,-107,0,212,0,6
9157,1,2569,2455,114,0,251,1,6
9158,1,2407,2232,175,0,4,0,8
9159,1,2434,2261,173,0,6,1,6
9160,2,2385,2544,-159,0,327,0,6
9161,2,2480,2487,-7,0,20,0,6
9162,2,2229,2412,-183,4,218,1,8
9163,2,2533,2515,18,0,7,0,6
9164,2,2434,2382,52,0,52,0,6
9165,2,2404,2390,14,0,56,0,6
9166,1,2413,2433,-20,0,4,0,6
9167,1,2404,2405,-1,0,466,0,6
9168,3,2530,2567,-37,0,9,0,6
9169,3,2489,2392,97,0,317,0,6
9170,2,2271,2424,-153,0,200,0,6
9171,2,2280,2451,-171,0,3,0,6
9172,2,2423,2437,-14,0,321,0,6
9173,2,2386,2518,-132,0,40,1,6
9174,1,2443,2464,-21,0,4,0,6
9175,1,2419,2316,103,0,43,0,6
9176,1,2257,2420,-163,0,101,0,6
9177,2,2397,2411,-14,0,127,0,6
9178,2,2361,2472,-111,0,49,0,6
9179,1,2454,2323,131,0,190,0,6
9180,1,2468,2314,154,4,135,0,13
9181,1,2462,2512,-50,0,246,0,6
9182,2,2452,2665,-213,0,14,0,6
9183,2,2422,2472,-50,0,126,0,6
9184,2,2349,2437,-88,0,106,0,6
9185,1,2517,2614,-97,0,311,0,6
9186,2,2385,2486,-101,0,0,0,6
9187,2,2378,2434,-56,0,315,0,6
9188,1,2376,2402,-26,0,163,1,6
9189,2,2538,2480,58,0,48,0,6
9190,1,2456,2451,5,0,432,1,6
9191,2,2269,2544,-275,0,16,0,6
9192,1,2632,2487,145,0,100,0,6
9193,1,2535,2448,87,0,80,0,6
9194,2,2423,2272,151,0,45,0,6
9195,1,2506,2405,101,0,40,0,6
9196,2,2472,2435,37,0,100,1,6
9197,3,2411,2255,156,0,101,0,6
9198,1,2377,2449,-72,0,123,0,6
9199,2,2457,2417,40,0,101,1,6
9200,1,2724,2601,123,0,46,0,6
9201,1,2449,2408,41,0,6,1,6
9202,1,2441,2468,-27,0,50,0,6
9203,2,2380,2440,-60,0,101,0,6
9204,1,2345,2419,-74,0,125,0,6
9205,1,2454,2275,179,0,4,0,6
9206,2,2463,2505,-42,0,341,0,6
9207,2,2290,2423,-133,0,46,1,6
9208,1,2487,2477,10,0,189,0,6
9209,1,2480,2363,117,0,15,0,6
9210,1,2293,2467,-174,0,45,0,6
9211,2,2475,2382,93,0,14,0,6
9212,2,2521,2521,0,0,258,0,6
9213,2,2270,2420,-150,0,491,1,6
9214,2,2550,2483,67,0,40,0,6
9215,2,2583,2516,67,0,101,0,6
9216,2,2271,2457,-186,0,3,1,6
9217,1,2225,2436,-211,0,112,0,8
9218,2,2488,2348,140,0,106,1,8
9219,2,2303,2475,-172,0,459,1,6
9220,2,2426,2416,10,0,106,0,6
9221,2,2490,2400,90,0,45,0,6
9222,2,2400,2539,-139,0,440,0,6
9223,1,2410,2389,21,0,11,0,6
9224,1,2449,2490,-41,0,145,0,6
9225,2,2487,2381,106,0,52,0,6
9226,2,2583,2725,-142,0,112,0,6
9227,2,2396,2428,-32,0,8,1,6
9228,1,2319,2403,-84,0,45,0,6
9229,1,2308,2431,-123,0,101,0,8
9230,2,2574,2573,1,0,414,1,6
9231,1,2318,2421,-103,0,300,1,6
9232,2,2297,2480,-183,0,240,1,6
9233,2,2254,2427,-173,0,255,0,6
9234,1,2279,2419,-140,0,84,0,6
9235,2,2444,2461,-17,0,135,1,6
9236,1,2368,2487,-119,0,424,0,6
9237,3,2566,2483,83,0,247,0,6
9238,2,2442,2418,24,0,56,1,6
9239,1,2406,2317,89,0,7,0,6
9240,1,2460,2416,44,0,339,0,6
9241,2,2383,2416,-33,0,106,0,6
9242,2,2597,2728,-131,0,335,0,6
9243,2,2458,2301,157,0,17,0,6
9244,2,2527,2668,-141,0,103,1,6
9245,2,2335,2427,-92,0,210,1,6
9246,2,2382,2480,-98,0,133,0,6
9247,2,2524,2389,135,0,52,1,6
9248,2,2515,2444,71,0,253,0,6
9249,1,2447,2389,58,0,45,0,6
9250,2,2442,2543,-101,0,15,0,6
9251,1,2484,2544,-60,0,25,0,6
9252,2,2439,2373,66,0,44,0,6
9253,2,2476,2359,117,0,45,0,6
9254,1,2433,2382,51,0,241,1,6
9255,1,2445,2287,158,0,156,1,6
9256,2,2256,2414,-158,0,0,0,6
9257,1,2389,2468,-79,0,112,1,6
9258,1,2490,2629,-139,0,1,0,6
9259,1,2530,2402,128,0,94,0,6
9260,1,2434,2311,123,4,31,0,13
9261,3,2411,2465,-54,0,466,0,6
9262,1,2268,2530,-262,4,204,0,13
9263,1,2444,2375,69,0,162,0,6
9264,3,2412,2447,-35,0,106,0,6
9265,2,2472,2493,-21,0,101,0,6
9266,1,2477,2577,-100,0,45,0,6
9267,3,2729,2580,149,0,48,0,6
9268,2,2455,2462,-7,0,56,0,6
9269,2,2462,2403,59,0,110,1,6
9270,2,2424,2326,98,0,300,0,6
9271,2,2319,2510,-191,0,344,0,6
9272,3,2427,2357,70,0,337,0,6
9273,2,2485,2378,107,0,278,0,6
9274,2,2422,2326,96,0,219,0,6
9275,2,2313,2410,-97,0,135,0,6
9276,2,2430,2318,112,0,112,0,6
9277,1,2437,2350,87,0,4,1,6
9278,3,2483,2428,55,0,43,0,6
9279,1,2547,2395,152,0,300,0,6
9280,1,2418,2253,165,0,40,0,6
9281,1,2412,2301,111,0,110,0,6
9282,2,2424,2580,-156,0,13,1,6
9283,3,2433,2391,42,0,45,0,6
9284,2,2417,2325,92,0,107,0,6
9285,3,2579,2565,14,0,110,0,6
9286,1,2484,2313,171,0,486,0,6
9287,1,2732,2594,138,0,80,0,6
9288,2,2424,2436,-12,0,302,1,6
9289,3,2311,2472,-161,4,131,0,13
9290,1,2440,2345,95,0,202,1,6
9291,3,2414,2489,-75,0,330,0,6
9292,2,2480,2376,104,0,45,0,6
9293,2,2460,2400,60,0,353,1,6
9294,1,2380,2432,-52,0,315,0,6
9295,2,2338,2469,-131,0,463,0,6
9296,2,2422,2420,2,0,44,0,6
9297,1,2621,2498,123,0,100,0,6
9298,2,2402,2439,-37,0,409,0,6
9299,1,2469,2509,-40,0,200,0,6
9300,2,2442,2450,-8,0,310,0,6
9301,2,2326,2411,-85,0,101,0,6
9302,1,2469,2354,115,0,42,0,6
9303,1,2367,2469,-102,0,133,0,6
9304,1,2287,2440,-153,0,127,0,6
9305,1,2415,2350,65,0,302,0,6
9306,1,2410,2416,-6,0,84,1,6
9307,1,2396,2426,-30,0,246,0,6
9308,1,2513,2484,29,0,359,0,6
9309,1,2550,2524,26,0,331,0,6
9311,2,2467,2537,-70,0,103,0,6
9312,2,2269,2413,-144,0,4,0,6
9313,2,2582,2727,-145,0,112,0,6
9314,2,2494,2625,-131,0,1,0,6
9315,2,2446,2458,-12,0,147,0,6
9316,2,2435,2405,30,0,453,1,6
9317,2,2386,2477,-91,0,144,1,6
9318,1,2424,2315,109,0,463,0,8
9319,1,2498,2466,32,0,251,0,6
9320,1,2421,2256,165,0,300,1,6
9321,1,2671,2510,161,0,132,0,6
9322,2,2546,2413,133,0,46,0,6
9323,1,2287,2417,-130,0,101,0,6
9324,2,2423,2477,-54,0,190,0,6
9325,1,2448,2491,-43,0,1,1,6
9326,2,2463,2543,-80,0,123,1,6
9327,1,2590,2735,-145,0,335,0,6
9328,3,2390,2442,-52,0,40,0,6
9329,2,2329,2480,-151,0,41,0,8
9330,2,2410,2455,-45,0,359,0,6
9331,1,2550,2398,152,0,40,0,6
9332,1,2396,2414,-18,0,40,0,6
9333,1,2368,2438,-70,0,48,1,6
9334,2,2384,2454,-70,0,300,0,6
9335,2,2200,2547,-347,0,228,0,6
9336,1,2429,2307,122,0,200,1,8
9337,1,2325,2502,-177,0,16,0,6
9338,2,2377,2419,-42,0,354,1,6
9339,2,2286,2418,-132,0,80,0,6
9340,2,2310,2431,-121,0,135,0,6
9341,2,2330,2482,-152,0,300,0,6
9342,1,2456,2429,27,0,123,0,6
9343,2,2425,2387,38,0,44,1,6
9344,2,2394,2419,-25,0,385,1,6
9345,1,2444,2280,164,0,50,0,6
9346,1,2377,2402,-25,0,302,0,6
9347,2,2340,2454,-114,0,343,0,6
9348,1,2461,2374,87,0,45,0,6
9349,2,2488,2415,73,0,16,0,6
9350,2,2463,2635,-172,0,153,0,6
9351,1,2522,2416,106,0,101,0,6
9352,1,2542,2534,8,0,45,1,6
9353,2,2331,2512,-181,0,45,0,6
9354,2,2340,2409,-69,0,125,0,6
9355,2,2442,2579,-137,0,466,0,6
9356,2,2395,2554,-159,0,3,0,6
9357,2,2310,2448,-138,0,108,1,6
9358,2,2472,2479,-7,0,45,0,6
9359,3,2519,2531,-12,0,41,0,6
9360,1,2506,2392,114,0,308,0,6
9361,1,2470,2465,5,0,45,0,6
9362,1,2416,2377,39,0,125,0,6
9363,2,2628,2491,137,0,106,0,6
9364,1,2410,2288,122,0,115,0,6
9365,2,2360,2534,-174,0,46,0,6
9366,1,2730,2579,151,0,380,0,6
9367,1,2409,2234,175,0,311,0,6
9368,2,2518,2547,-29,0,125,1,6
9369,1,2435,2311,124,0,31,0,6
9370,2,2324,2424,-100,0,120,1,6
9371,1,2482,2382,100,0,121,0,6
9372,1,2426,2416,10,0,145,0,6
9373,2,2461,2504,-43,0,101,1,6
9374,1,2441,2391,50,0,9,0,6
9375,3,2519,2440,79,0,313,0,6
9376,1,2727,2598,129,0,302,0,6
9377,1,2557,2392,165,0,210,1,6
9378,2,2414,2428,-14,0,103,1,6
9379,3,2531,2675,-144,0,244,0,6
9380,1,2460,2405,55,0,14,0,6
9381,1,2410,2386,24,0,487,0,6
9382,1,2422,2318,104,0,205,1,6
9383,1,2483,2259,224,0,331,0,6
9384,2,2484,2603,-119,0,129,1,6
9385,3,2383,2455,-72,0,341,0,6
9386,1,2414,2428,-14,0,254,1,8
9387,3,2413,2425,-12,0,277,0,6
9388,2,2549,2423,126,0,122,0,6
9389,1,2507,2785,-278,0,378,0,6
9390,1,2461,2460,1,0,124,1,6
9391,2,2417,2246,171,0,301,1,6
9392,1,2594,2731,-137,0,335,0,6
9393,1,2407,2324,83,0,107,0,6
9394,1,2486,2339,147,0,48,0,6
9395,2,2346,2414,-68,0,200,0,6
9396,2,2387,2455,-68,0,101,1,6
9397,1,2377,2486,-109,0,231,0,6
9398,1,2281,2425,-144,0,337,0,6
9399,2,2386,2494,-108,0,200,0,6
9400,2,2294,2403,-109,0,310,0,6
9401,2,2393,2419,-26,0,315,1,6
9402,1,2330,2441,-111,0,146,0,6
9403,2,2266,2438,-172,0,8,1,6
9404,3,2459,2283,176,0,373,0,6
9405,2,2583,2582,1,0,481,0,6
9406,1,2387,2458,-71,0,302,0,6
9407,1,2400,2465,-65,0,453,0,6
9408,2,2441,2296,145,0,1,0,6
9409,2,2466,2518,-52,0,300,1,6
9410,1,2414,2464,-50,0,30,0,6
9411,1,2379,2407,-28,0,145,0,6
9412,2,2214,2402,-188,0,222,0,6
9413,2,2433,2418,15,0,120,0,6
9414,1,2451,2547,-96,0,414,0,6
9415,1,2444,2421,23,0,133,0,6
9416,1,2446,2412,34,0,4,0,6
9417,1,2412,2380,32,0,45,1,6
9418,1,2638,2528,110,0,115,1,6
9419,1,2575,2734,-159,0,206,0,6
9420,2,2485,2467,18,0,45,0,6
9421,2,2378,2540,-162,0,101,0,6
9422,2,2384,2526,-142,0,45,1,6
9423,2,2256,2408,-152,0,3,1,6
9424,1,2421,2229,192,0,335,0,6
9425,1,2552,2513,39,0,255,0,6
9426,3,2431,2375,56,0,172,0,6
9427,1,2511,2549,-38,0,202,0,6
9428,2,2484,2433,51,0,113,0,8
9429,1,2429,2283,146,0,110,1,6
9430,1,2509,2456,53,0,251,0,6
9431,2,2390,2466,-76,0,211,0,6
9432,2,2353,2412,-59,0,151,0,6
9433,1,2672,2499,173,0,100,0,6
9434,2,2516,2560,-44,0,405,1,6
9435,3,2434,2406,28,0,49,0,6
9436,2,2425,2320,105,0,4,0,6
9437,1,2478,2385,93,0,278,0,6
9438,2,2410,2432,-22,0,44,0,6
9439,1,2588,2533,55,0,107,0,6
9440,2,2388,2577,-189,0,2,0,6
9441,1,2425,2454,-29,0,105,0,6
9442,2,2278,2414,-136,0,327,1,6
9443,2,2295,2449,-154,0,106,0,6
9444,1,2521,2523,-2,0,101,1,6
9445,1,2318,2426,-108,0,0,0,6
9446,1,2406,2385,21,0,36,0,6
9447,1,2284,2401,-117,0,313,1,6
9448,1,2643,2434,209,0,28,0,6
9449,2,2723,2602,121,0,49,0,6
9450,3,2360,2480,-120,0,245,0,6
9451,2,2459,2407,52,0,14,0,6
9452,3,2403,2329,74,0,43,0,6
9453,2,2418,2383,35,0,262,1,6
9454,2,2775,2479,296,0,84,0,6
9455,2,2407,2467,-60,0,302,0,6
9456,2,2327,2451,-124,0,40,0,6
9457,1,2451,2382,69,0,30,1,6
9458,1,2277,2422,-145,0,263,0,6
9459,1,2417,2341,76,0,107,0,6
9460,2,2424,2388,36,0,43,0,6
9461,1,2489,2366,123,0,46,0,6
9462,2,2498,2459,39,0,101,0,6
9463,2,2374,2441,-67,0,264,0,6
9464,2,2529,2454,75,0,7,0,6
9465,2,2424,2242,182,0,253,1,6
9466,1,2394,2433,-39,0,150,0,6
9467,2,2254,2461,-207,4,47,0,11
9468,2,2495,2580,-85,0,1,0,6
9469,1,2468,2375,93,0,300,0,6
9470,2,2593,2544,49,0,101,0,6
9471,2,2400,2304,96,0,122,1,6
9472,1,2542,2518,24,0,34,0,6
9473,1,2642,2386,256,0,200,0,6
9474,1,2479,2473,6,0,21,0,6
9475,1,2457,2420,37,0,190,0,6
9476,2,2540,2525,15,0,110,1,6
9477,2,2280,2649,-369,0,1,0,6
9478,1,2245,2417,-172,0,101,0,6
9479,1,2451,2514,-63,0,307,0,6
9480,1,2416,2376,40,0,4,0,6
9481,2,2448,2327,121,0,140,0,6
9482,2,2432,2300,132,0,192,0,6
9483,2,2417,2337,80,0,112,0,6
9484,3,2675,2751,-76,0,254,0,6
9485,1,2412,2319,93,0,130,0,6
9486,1,2508,2558,-50,0,103,1,6
9487,2,2431,2565,-134,0,112,0,6
9488,1,2424,2341,83,0,114,0,6
9489,2,2489,2336,153,0,15,0,6
9490,2,2398,2550,-152,0,311,1,6
9491,2,2381,2483,-102,0,234,0,6
9492,1,2446,2369,77,0,415,0,6
9493,2,2450,2587,-137,0,354,1,6
9494,2,2216,2458,-242,0,127,0,6
9495,1,2492,2402,90,0,483,0,6
9496,1,2471,2463,8,0,124,0,6
9497,1,2565,2511,54,0,300,0,6
9498,2,2411,2294,117,0,20,0,6
9499,1,2472,2251,221,0,200,0,6
9500,1,2419,2400,19,0,205,0,6
9501,2,2395,2418,-23,0,315,0,6
9502,3,2569,2455,114,0,100,0,6
9503,1,2413,2452,-39,0,46,1,6
9504,1,2393,2402,-9,0,485,0,6
9505,2,2414,2527,-113,0,315,0,6
9506,2,2477,2424,53,0,107,1,8
9507,2,2355,2418,-63,0,250,0,6
9508,2,2470,2277,193,4,145,0,13
9509,1,2439,2428,11,0,101,1,8
9510,1,2389,2412,-23,0,214,0,6
9511,2,2517,2517,0,0,302,0,6
9512,2,2383,2522,-139,0,2,0,6
9513,1,2507,2449,58,0,195,0,6
9514,2,2491,2645,-154,0,1,0,6
9515,1,2492,2395,97,0,218,1,6
9516,1,2405,2407,-2,0,45,1,6
9517,2,2451,2396,55,0,311,1,6
9518,2,2458,2726,-268,0,44,1,6
9519,2,2466,2765,-299,0,200,0,6
9520,2,2487,2377,110,0,253,1,6
9521,2,2288,2448,-160,0,302,1,6
9522,1,2437,2405,32,0,148,0,6
9523,1,2398,2416,-18,0,41,1,6
9524,3,2506,2570,-64,0,302,0,6
9525,2,2510,2677,-167,0,300,0,6
9526,2,2376,2430,-54,0,385,0,6
9527,2,2372,2416,-44,0,40,0,6
9528,2,2345,2497,-152,0,190,0,6
9529,2,2421,2440,-19,0,4,1,6
9530,1,2554,2525,29,0,454,0,6
9531,2,2371,2484,-113,0,315,0,6
9532,1,2460,2217,243,0,13,0,6
9533,3,2222,2424,-202,0,190,0,6
9534,1,2531,2534,-3,0,4,1,6
9535,2,2468,2467,1,0,122,1,6
9536,1,2457,2477,-20,0,4,1,6
9537,2,2356,2461,-105,4,241,0,13
9538,1,2458,2481,-23,0,13,0,6
9539,3,2421,2334,87,0,101,0,6
9540,3,2252,2415,-163,0,49,0,6
9541,3,2567,2750,-183,0,106,0,6
9542,1,2434,2512,-78,0,101,1,6
9543,2,2424,2389,35,0,43,0,6
9544,1,2551,2515,36,0,21,1,6
9545,1,2424,2444,-20,0,152,1,6
9546,2,2421,2350,71,0,487,0,6
9547,2,2406,2395,11,0,110,0,6
9548,2,2285,2461,-176,0,338,0,6
9549,1,2419,2243,176,0,214,0,6
9550,2,2590,2517,73,0,190,1,6
9551,1,2424,2364,60,0,101,0,6
9552,2,2435,2353,82,0,245,0,6
9553,1,2507,2569,-62,0,53,0,6
9554,2,2504,2507,-3,0,45,0,6
9555,1,2509,2380,129,0,52,0,6
9556,3,2523,2680,-157,0,14,0,6
9557,2,2402,2446,-44,0,410,0,6
9558,1,2462,2410,52,0,311,0,6
9559,2,2728,2464,264,0,4,0,6
9560,1,2525,2380,145,0,200,0,6
9561,1,2456,2444,12,0,324,0,6
9562,1,2362,2472,-110,0,40,0,6
9563,2,2513,2499,14,0,484,1,6
9564,2,2370,2563,-193,0,118,0,6
9565,1,2648,2514,134,0,131,0,6
9566,2,2335,2504,-169,0,6,0,6
9567,1,2463,2464,-1,0,4,0,6
9568,1,2559,2488,71,0,40,0,6
9569,1,2404,2230,174,0,300,0,6
9570,2,2410,2414,-4,0,106,0,6
9571,2,2211,2423,-212,0,123,0,6
9572,2,2331,2496,-165,0,365,1,6
9573,2,2590,2446,144,0,102,0,6
9574,2,2488,2415,73,0,36,0,6
9575,3,2452,2520,-68,0,140,0,6
9576,2,2566,2464,102,0,461,0,6
9577,2,2407,2414,-7,0,277,1,6
9578,1,2396,2417,-21,0,315,0,6
9579,2,2473,2462,11,0,335,0,6
9580,1,2433,2297,136,0,45,0,6
9581,2,2379,2507,-128,0,65,0,6
9582,3,2403,2250,153,0,200,0,6
9583,2,2401,2400,1,0,1,0,6
9584,2,2463,2372,91,0,154,0,6
9585,2,2430,2359,71,0,333,0,6
9586,2,2422,2445,-23,0,40,1,8
9587,1,2537,2469,68,0,100,0,6
9588,2,2458,2564,-106,0,7,0,6
9589,1,2465,2425,40,0,40,0,6
9590,1,2441,2298,143,0,205,0,6
9591,1,2283,2432,-149,0,319,0,6
9592,2,2330,2471,-141,0,107,0,8
9593,2,2376,2529,-153,0,2,0,6
9594,1,2510,2556,-46,0,215,0,6
9595,2,2748,2678,70,0,344,0,6
9596,2,2468,2467,1,0,122,0,6
9597,1,2429,2361,68,0,222,0,6
9598,2,2204,2402,-198,0,245,0,6
9599,1,2465,2307,158,4,110,0,13
9600,1,2378,2424,-46,0,229,1,6
9601,2,2525,2555,-30,0,9,1,6
9602,2,2438,2407,31,0,101,1,6
9603,1,2401,2227,174,0,310,0,6
9604,1,2462,2479,-17,0,52,0,6
9605,1,2406,2396,10,0,17,0,6
9606,1,2395,2438,-43,0,264,1,6
9607,2,2565,2367,198,0,45,0,6
9608,3,2406,2285,121,0,300,0,6
9609,2,2316,2423,-107,0,70,1,6
9610,2,2583,2652,-69,0,190,0,6
9611,1,2411,2402,9,0,44,1,6
9612,2,2511,2535,-24,0,43,0,6
9613,2,2366,2429,-63,0,389,0,6
9614,1,2421,2243,178,0,321,0,6
9615,1,2468,2275,193,0,4,0,6
9616,1,2477,2344,133,0,223,0,6
9617,1,2420,2582,-162,0,463,0,6
9618,3,2454,2304,150,0,0,0,6
9619,2,2422,2481,-59,0,6,0,6
9620,3,2499,2395,104,0,112,0,6
9621,1,2489,2559,-70,0,46,0,6
9622,2,2386,2464,-78,0,107,0,6
9623,1,2544,2679,-135,0,135,0,6
9624,2,2519,2401,118,0,200,0,6
9625,1,2422,2454,-32,0,106,1,6
9626,1,2516,2541,-25,0,111,0,6
9627,2,2376,2557,-181,0,101,0,6
9628,2,2550,2516,34,0,40,0,6
9629,1,2511,2325,186,0,10,0,6
9630,2,2470,2322,148,0,43,0,6
9631,2,2250,2420,-170,0,134,0,6
9632,2,2323,2473,-150,0,5,1,8
9633,2,2568,2390,178,0,330,0,6
9634,2,2684,2600,84,0,487,0,6
9635,2,2360,2428,-68,0,196,1,6
9636,2,2376,2454,-78,0,487,0,6
9637,1,2370,2471,-101,0,127,0,6
9639,1,2473,2462,11,0,333,0,6
9640,1,2532,2468,64,0,120,0,6
9641,3,2450,2603,-153,0,345,0,6
9642,2,2560,2559,1,0,101,0,6
9643,2,2407,2274,133,0,122,0,6
9644,1,2560,2373,187,0,0,0,6
9645,2,2410,2279,131,0,35,1,6
9646,1,2390,2412,-22,0,1,0,6
9647,1,2425,2260,165,4,246,0,13
9648,2,2656,2579,77,0,140,0,6
9649,1,2427,2255,172,0,53,1,6
9650,2,2417,2327,90,0,322,0,6
9651,1,2414,2238,176,0,325,1,6
9652,1,2379,2467,-88,0,101,1,6
9653,2,2432,2402,30,0,415,0,6
9654,2,2469,2432,37,0,4,0,6
9655,2,2394,2429,-35,0,200,0,6
9656,2,2247,2462,-215,0,50,1,6
9657,3,2415,2479,-64,0,101,0,6
9659,1,2512,2373,139,0,210,0,6
9660,1,2451,2311,140,0,182,0,6
9661,1,2498,2253,245,0,210,0,6
9662,1,2427,2417,10,0,463,0,6
9663,2,2505,2520,-15,0,313,0,6
9664,2,2306,2411,-105,0,127,0,6
9665,2,2486,2418,68,0,15,1,6
9666,1,2450,2417,33,0,101,0,8
9668,2,2475,2305,170,0,140,0,8
9669,1,2408,2586,-178,0,70,1,6
9670,2,2522,2544,-22,0,100,0,6
9671,1,2677,2523,154,0,455,0,6
9672,1,2552,2671,-119,0,330,1,6
9673,2,2332,2461,-129,0,8,0,6
9674,1,2463,2249,214,0,412,0,6
9676,1,2563,2463,100,0,45,1,6
9677,1,2514,2537,-23,0,10,0,6
9678,1,2565,2511,54,0,45,1,6
9680,1,2554,2496,58,0,250,0,6
9681,2,2459,2430,29,0,7,1,6
9682,1,2407,2227,180,0,200,0,6
9683,1,2479,2374,105,0,44,0,6
9684,1,2474,2439,35,0,153,0,6
9685,1,2396,2447,-51,0,106,0,6
9686,2,2406,2396,10,0,105,0,6
9687,2,2506,2586,-80,0,130,1,6
9688,3,2600,2650,-50,0,387,0,6
9689,1,2569,2452,117,0,120,0,6
9690,1,2489,2285,204,0,128,0,6
9691,1,2257,2417,-160,0,411,1,6
9692,1,2369,2502,-133,0,3,0,6
9693,3,2336,2436,-100,0,38,0,6
9694,1,2426,2201,225,0,143,0,6
9695,3,2332,2413,-81,0,40,0,6
9696,1,2406,2246,160,0,13,0,6
9697,1,2415,2302,113,0,46,0,6
9698,1,2433,2356,77,0,228,0,6
9699,2,2528,2500,28,0,16,0,6
9700,1,2402,2396,6,0,1,1,6
9701,2,2243,2417,-174,0,106,1,6
9702,2,2520,2455,65,0,105,0,6
9703,1,2424,2208,216,0,313,0,6
9704,1,2412,2456,-44,0,112,1,8
9705,1,2478,2681,-203,0,45,0,6
9706,2,2416,2369,47,0,4,0,6
9707,1,2326,2416,-90,0,23,0,6
9708,2,2275,2456,-181,0,45,1,6
9709,2,2351,2464,-113,0,45,0,6
9710,3,2469,2373,96,4,101,0,11
9711,2,2434,2483,-49,0,0,1,6
9712,2,2419,2376,43,0,40,1,6
9713,2,2466,2410,56,0,13,0,6
9714,3,2585,2500,85,0,331,0,6
9715,2,2328,2472,-144,0,326,1,6
9716,2,2441,2403,38,0,110,0,6
9717,2,2424,2479,-55,0,318,0,6
9718,1,2381,2520,-139,0,487,0,6
9719,1,2549,2517,32,0,1,1,6
9720,1,2243,2429,-186,0,176,0,6
9721,1,2448,2491,-43,0,337,0,6
9722,2,2294,2427,-133,0,311,0,6
9723,3,2573,2402,171,0,250,0,6
9724,2,2364,2536,-172,0,20,0,6
9725,1,2400,2386,14,0,49,0,6
9726,1,2412,2428,-16,0,106,0,6
9727,1,2473,2567,-94,0,45,0,6
9728,2,2460,2506,-46,0,0,0,6
9729,1,2494,2336,158,0,321,0,6
9730,2,2522,2377,145,0,13,0,6
9731,2,2312,2437,-125,0,40,0,8
9732,1,2664,2560,104,0,335,0,6
9733,2,2405,2338,67,0,302,0,6
9734,1,2400,2208,192,0,343,1,6
9735,3,2649,2570,79,0,101,0,6
9736,2,2399,2453,-54,0,487,0,6
9737,1,2434,2341,93,0,307,0,6
9738,1,2412,2435,-23,0,250,0,6
9739,1,2401,2257,144,0,40,0,6
9740,2,2507,2516,-9,0,130,0,6
9741,2,2411,2433,-22,0,61,0,6
9742,1,2607,2341,266,0,320,0,6
9743,1,2420,2365,55,0,125,0,6
9744,1,2626,2590,36,0,140,1,6
9745,1,2420,2338,82,0,335,0,6
9746,2,2459,2601,-142,0,205,1,6
9747,1,2455,2356,99,0,1,0,6
9748,1,2583,2457,126,0,473,0,6
9749,2,2320,2466,-146,0,41,0,8
9750,2,2277,2414,-137,0,122,0,6
9751,1,2417,2249,168,0,112,0,6
9752,1,2247,2460,-213,0,40,1,6
9753,1,2420,2422,-2,0,491,0,6
9754,1,2511,2501,10,0,131,0,6
9755,1,2390,2408,-18,0,15,0,6
9756,1,2360,2438,-78,0,14,1,6
9757,3,2672,2513,159,0,415,0,6
9758,1,2462,2487,-25,0,265,0,6
9759,1,2553,2304,249,0,20,1,6
9760,2,2497,2468,29,0,4,1,6
9761,2,2589,2418,171,0,104,0,6
9762,2,2375,2410,-35,0,101,0,6
9763,1,2409,2329,80,0,110,0,6
9764,2,2488,2413,75,0,106,0,6
9765,2,2380,2405,-25,0,140,0,6
9766,2,2351,2437,-86,0,194,0,6
9767,1,2791,2444,347,4,202,0,11
9768,1,2560,2523,37,0,300,1,6
9769,2,2420,2291,129,0,112,1,6
9770,1,2539,2513,26,0,101,0,6
9771,1,2492,2426,66,0,436,0,6
9772,1,2480,2484,-4,0,300,0,6
9773,2,2427,2416,11,0,45,0,6
9774,2,2244,2425,-181,0,453,0,6
9775,2,2512,2554,-42,0,215,1,6
9776,1,2295,2407,-112,0,440,0,6
9777,1,2488,2485,3,0,250,1,6
9778,1,2352,2459,-107,0,107,0,6
9779,2,2556,2668,-112,0,323,1,6
9780,1,2435,2363,72,0,192,0,6
9781,2,2254,2404,-150,0,40,0,6
9782,2,2255,2414,-159,0,127,0,6
9783,1,2643,2647,-4,0,190,0,6
9784,1,2421,2313,108,0,140,0,8
9785,1,2455,2426,29,0,122,0,6
9786,1,2405,2285,120,0,380,1,6
9787,2,2387,2475,-88,0,125,1,6
9788,2,2449,2418,31,0,110,0,8
9790,1,2403,2201,202,0,49,1,6
9791,2,2357,2424,-67,0,490,0,6
9792,1,2444,2456,-12,0,46,0,6
9793,1,2451,2200,251,0,13,0,6
9794,2,2454,2385,69,0,4,0,6
9795,1,2481,2411,70,0,201,0,8
9796,2,2354,2517,-163,0,384,0,6
9797,1,2399,2477,-78,0,119,1,8
9798,2,2496,2559,-63,0,344,0,6
9799,1,2424,2377,47,0,20,1,6
9800,1,2477,2455,22,0,15,1,6
9801,2,2388,2402,-14,0,15,1,6
9802,1,2415,2376,39,0,25,1,6
9803,1,2670,2514,156,0,138,1,6
9804,2,2370,2455,-85,4,320,0,11
9805,2,2554,2631,-77,0,20,0,6
9806,2,2642,2649,-7,0,224,0,6
9807,2,2417,2458,-41,0,4,0,6
9808,1,2408,2481,-73,0,436,0,6
9809,1,2475,2339,136,0,311,0,6
9810,1,2507,2581,-74,0,200,0,6
9811,2,2440,2491,-51,0,112,1,6
9812,2,2420,2333,87,0,40,0,6
9813,2,2468,2432,36,0,145,1,6
9814,3,2459,2399,60,0,115,0,6
9815,2,2585,2501,84,0,140,1,6
9816,2,2426,2522,-96,0,131,0,6
9817,2,2516,2520,-4,0,206,0,6
9818,1,2434,2440,-6,0,320,1,6
9819,2,2480,2429,51,0,101,0,6
9820,2,2400,2230,170,0,176,0,6
9821,1,2421,2636,-215,0,4,0,6
9822,2,2636,2547,89,0,215,0,6
9823,1,2429,2410,19,0,2,0,6
9824,2,2382,2430,-48,0,136,0,6
9825,2,2352,2467,-115,4,448,0,13
9826,2,2412,2409,3,0,127,0,6
9827,1,2344,2421,-77,0,331,1,6
9828,1,2517,2514,3,0,404,0,6
9829,1,2345,2414,-69,0,253,1,6
9830,1,2299,2453,-154,0,40,0,6
9831,2,2370,2565,-195,0,118,0,6
9832,2,2452,2361,91,0,9,0,6
9833,2,2421,2497,-76,0,313,0,6
9834,2,2438,2406,32,0,20,0,6
9835,1,2450,2422,28,0,40,0,6
9836,2,2470,2407,63,0,200,0,8
9837,1,2629,2479,150,0,355,0,6
9838,2,2672,2552,120,0,335,0,6
9839,1,2507,2521,-14,0,125,0,6
9840,1,2447,2443,4,0,138,0,6
9841,2,2439,2571,-132,0,101,0,6
9842,1,2441,2347,94,0,228,0,6
9843,2,2307,2412,-105,0,40,0,6
9844,3,2463,2406,57,0,45,0,6
9845,2,2479,2486,-7,0,360,1,6
9846,1,2296,2409,-113,0,289,0,6
9847,2,2491,2613,-122,0,302,0,6
9848,2,2510,2627,-117,0,88,1,6
9849,2,2215,2684,-469,0,200,0,6
9850,2,2392,2624,-232,0,3,0,6
9851,1,2404,2306,98,0,40,0,6
9852,3,2445,2333,112,0,39,0,6
9853,1,2501,2246,255,0,253,1,6
9854,3,2386,2478,-92,0,16,0,6
9855,1,2474,2494,-20,0,355,1,6
9856,1,2205,2415,-210,0,100,1,6
9857,2,2424,2443,-19,0,110,0,8
9858,2,2511,2485,26,0,332,0,6
9859,1,2328,2429,-101,0,414,1,6
9860,2,2449,2455,-6,0,21,0,6
9861,1,2509,2523,-14,0,335,0,6
9862,2,2458,2673,-215,0,343,0,6
9863,2,2407,2574,-167,0,29,0,6
9864,2,2436,2473,-37,0,337,0,6
9865,2,2496,2435,61,0,107,0,6
9866,2,2383,2436,-53,0,315,1,6
9867,2,2259,2462,-203,0,101,0,6
9868,2,2246,2407,-161,0,51,0,6
9869,2,2296,2415,-119,0,139,0,6
9870,1,2343,2446,-103,0,194,1,6
9871,1,2557,2629,-72,0,15,0,6
9872,2,2416,2386,30,0,117,0,6
9873,2,2575,2394,181,0,100,0,6
9874,1,2417,2353,64,0,44,0,6
9875,1,2434,2462,-28,0,105,0,6
9876,2,2568,2370,198,0,45,0,6
9877,2,2239,2413,-174,0,106,0,6
9878,1,2480,2323,157,0,324,0,6
9879,2,2342,2419,-77,0,20,0,6
9880,2,2401,2475,-74,0,330,1,6
9881,2,2415,2386,29,0,40,0,6
9882,1,2626,2622,4,0,487,1,6
9883,3,2416,2208,208,0,15,0,6
9884,2,2560,2664,-104,0,320,0,6
9885,3,2517,2550,-33,0,313,0,6
9886,2,2274,2443,-169,0,106,0,6
9887,2,2422,2453,-31,0,10,1,6
9888,2,2515,2566,-51,0,332,0,6
9889,2,2430,2473,-43,0,300,0,6
9890,2,2390,2476,-86,0,2,0,6
9891,2,2621,2587,34,0,151,0,6
9892,1,2676,2487,189,0,141,0,6
9893,1,2432,2435,-3,0,325,0,6
9894,1,2465,2308,157,0,300,0,6
9896,2,2257,2412,-155,0,15,0,6
9897,2,2336,2491,-155,0,46,0,6
9898,2,2431,2444,-13,0,50,0,6
9899,2,2440,2363,77,4,345,0,11
9900,2,2577,2513,64,0,248,1,6
9901,2,2461,2478,-17,0,331,1,6
9902,1,2409,2316,93,0,122,1,6
9903,2,2413,2414,-1,0,107,0,6
9904,1,2519,2432,87,0,426,0,6
9905,2,2355,2463,-108,0,41,0,8
9906,2,2508,2505,3,0,130,0,6
9907,1,2494,2368,126,0,22,0,6
9908,1,2460,2506,-46,0,153,0,6
9909,2,2302,2416,-114,0,127,0,6
9910,1,2631,2502,129,0,205,0,6
9911,3,2480,2386,94,0,331,0,6
9912,1,2510,2376,134,0,474,1,6
9913,1,2407,2253,154,0,115,1,6
9914,1,2488,2480,8,0,122,1,6
9915,2,2422,2259,163,0,20,0,6
9916,1,2449,2419,30,0,244,0,8
9917,1,2440,2378,62,0,110,0,6
9918,2,2425,2493,-68,0,4,0,6
9919,3,2367,2422,-55,0,297,0,6
9920,2,2347,2430,-83,0,136,0,6
9921,1,2516,2456,60,0,123,1,6
9922,2,2403,2336,67,0,335,0,6
9923,3,2470,2289,181,4,46,0,0
9924,1,2573,2679,-106,0,409,0,6
9925,1,2484,2567,-83,0,311,0,6
9926,2,2294,2446,-152,0,40,0,6
9927,3,2403,2329,74,0,13,0,6
9929,1,2382,2419,-37,0,134,0,6
9930,2,2409,2420,-11,0,40,1,6
9931,2,2315,2425,-110,0,101,1,6
9932,1,2559,2492,67,0,45,1,6
9933,1,2517,2449,68,0,50,0,6
9934,1,2420,2408,12,0,140,1,6
9935,1,2431,2343,88,0,27,0,6
9936,2,2266,2471,-205,4,40,0,13
9937,1,2480,2379,101,0,185,0,6
9938,1,2799,2471,328,4,132,0,11
9939,2,2616,2632,-16,0,110,1,6
9940,2,2500,2556,-56,0,13,0,6
9941,1,2420,2309,111,0,46,0,6
9942,1,2376,2449,-73,0,453,1,6
9943,1,2483,2390,93,0,344,1,6
9944,1,2441,2400,41,0,484,0,6
9945,2,2330,2518,-188,0,335,0,6
9946,1,2458,2404,54,0,4,0,6
9947,2,2550,2671,-121,0,300,0,6
9948,2,2415,2468,-53,0,40,0,6
9949,1,2397,2478,-81,0,112,1,6
9950,1,2404,2352,52,0,110,0,6
9951,2,2414,2454,-40,0,112,1,8
9952,3,2560,2582,-22,0,40,0,6
9953,1,2516,2503,13,0,118,1,6
9954,1,2354,2495,-141,0,229,1,6
9955,3,2387,2479,-92,0,3,0,6
9956,2,2454,2296,158,0,141,0,6
9957,1,2434,2271,163,0,225,0,6
9958,1,2445,2373,72,0,110,1,6
9959,1,2421,2340,81,0,491,0,6
9960,1,2500,2492,8,0,7,0,6
9961,2,2484,2635,-151,0,151,0,6
9962,1,2232,2409,-177,0,200,0,6
9963,1,2400,2348,52,0,300,0,6
9964,2,2570,2467,103,0,107,0,6
9965,2,2450,2455,-5,0,156,0,6
9966,1,2452,2209,243,0,4,0,6
9967,2,2312,2486,-174,0,40,1,6
9968,1,2520,2514,6,0,123,0,6
9969,1,2413,2317,96,0,404,0,6
9971,2,2424,2461,-37,0,83,0,6
9972,2,2546,2389,157,0,300,0,6
9973,3,2484,2675,-191,0,345,0,6
9974,1,2475,2493,-18,0,355,0,6
9975,1,2482,2293,189,4,101,1,13
9976,3,2428,2410,18,0,253,0,6
9977,1,2560,2520,40,0,400,0,6
9978,1,2405,2345,60,0,211,0,6
9979,3,2402,2526,-124,0,101,0,6
9980,1,2363,2446,-83,0,45,1,6
9981,1,2429,2350,79,0,293,1,6
9982,3,2487,2564,-77,0,380,0,6
9983,2,2473,2454,19,0,43,0,6
9984,1,2504,2411,93,0,106,1,6
9985,2,2479,2429,50,0,485,1,6
9986,2,2426,2339,87,0,334,0,6
9987,2,2521,2448,73,0,40,0,6
9988,2,2388,2404,-16,0,331,1,6
9989,1,2477,2389,88,0,331,0,6
9990,2,2242,2531,-289,0,15,0,6
9991,3,2416,2435,-19,0,134,0,6
9992,2,2445,2560,-115,0,10,0,6
9993,1,2611,2582,29,0,200,0,6
9994,2,2508,2526,-18,0,331,0,6
9995,1,2422,2446,-24,0,5,0,6
9996,1,2638,2523,115,0,207,0,6
9997,1,2340,2480,-140,0,265,1,6
9998,2,2409,2375,34,0,45,0,6
9999,2,2465,2417,48,0,405,0,6
10000,2,2538,2538,0,0,345,0,6
10001,1,2638,2461,177,0,394,1,6
10002,1,2406,2437,-31,0,454,0,6
10003,2,2358,2441,-83,0,331,1,6
10004,1,2362,2419,-57,0,106,1,6
10005,1,2487,2347,140,0,330,0,6
10006,1,2467,2264,203,0,201,0,6
10007,2,2510,2566,-56,0,336,0,6
10008,2,2347,2440,-93,0,45,1,6
10009,2,2401,2336,65,0,480,0,6
10010,3,2431,2460,-29,0,106,0,6
10011,1,2474,2563,-89,0,200,0,6
10012,2,2396,2428,-32,0,474,1,6
10013,2,2486,2505,-19,0,108,0,6
10014,1,2404,2404,0,0,200,0,6
10015,2,2522,2514,8,0,262,1,6
10016,2,2278,2413,-135,0,106,1,6
10017,2,2564,2369,195,0,45,0,6
10018,3,2472,2441,31,0,47,0,6
10019,1,2410,2284,126,0,45,1,6
10020,1,2400,2351,49,0,424,0,6
10021,3,2383,2405,-22,0,114,0,6
10022,1,2467,2313,154,0,313,0,6
10023,2,2384,2482,-98,0,3,0,6
10024,1,2364,2487,-123,0,292,0,6
10025,2,2410,2345,65,0,117,0,6
10026,1,2480,2563,-83,0,440,0,6
10027,2,2672,2642,30,0,194,0,6
10028,3,2409,2371,38,0,45,0,6
10029,2,2488,2481,7,0,122,0,6
10030,1,2543,2488,55,0,45,0,6
10031,1,2436,2329,107,0,46,1,6
10032,2,2339,2424,-85,0,30,0,6
10033,1,2576,2616,-40,0,24,0,6
10034,3,2384,2403,-19,0,414,0,6
10035,1,2523,2383,140,0,52,0,6
10036,2,2445,2532,-87,0,119,0,6
10037,3,2459,2409,50,0,101,0,8
10038,2,2555,2503,52,0,45,0,6
10039,1,2617,2531,86,0,269,0,6
10040,2,2314,2419,-105,0,177,1,6
10041,2,2431,2807,-376,4,145,1,11
10042,1,2486,2380,106,0,13,0,6
10043,1,2536,2240,296,0,101,0,6
10044,1,2411,2427,-16,0,181,0,6
10045,1,2518,2602,-84,0,315,0,6
10046,2,2378,2412,-34,0,127,1,6
10047,1,2416,2470,-54,0,101,0,6
10048,2,2497,2403,94,0,222,0,6
10049,3,2458,2463,-5,0,484,0,6
10050,1,2556,2511,45,0,40,1,6
10051,3,2428,2405,23,0,100,0,6
10052,1,2549,2573,-24,0,45,0,6
10053,2,2509,2410,99,0,426,0,6
10054,3,2460,2361,99,0,13,0,6
10055,2,2432,2243,189,0,250,1,6
10056,2,2334,2462,-128,0,10,0,6
10057,1,2556,2481,75,0,175,0,6
10058,1,2444,2305,139,0,193,0,6
10059,2,2446,2394,52,0,27,0,6
10060,3,2471,2343,128,0,326,0,6
10061,1,2610,2583,27,0,8,0,6
10062,3,2520,2516,4,0,56,0,6
10063,1,2481,2506,-25,0,40,1,6
10064,1,2471,2441,30,0,47,0,6
10065,2,2520,2433,87,0,485,0,6
10066,3,2666,2516,150,0,56,0,6
10067,3,2346,2433,-87,0,110,0,6
10068,3,2466,2410,56,0,152,0,6
10069,1,2487,2482,5,0,355,0,6
10070,1,2526,2548,-22,0,202,0,6
10071,2,2242,2414,-172,0,101,0,6
10072,2,2564,2416,148,0,115,0,6
10073,2,2649,2886,-237,0,190,0,6
10074,3,2595,2409,186,0,45,0,6
10075,2,2373,2409,-36,0,201,0,6
10076,2,2362,2423,-61,0,40,0,6
10077,1,2463,2458,5,0,43,0,6
10078,2,2479,2391,88,0,253,0,6
10079,2,2268,2439,-171,0,45,0,6
10080,1,2421,2417,4,0,253,1,6
10081,1,2402,2431,-29,0,259,0,6
10082,2,2238,2541,-303,0,15,0,6
10083,1,2484,2660,-176,0,80,0,6
10084,1,2447,2440,7,0,265,0,6
10085,2,2578,2537,41,0,112,0,6
10086,1,2462,2376,86,0,4,0,6
10087,2,2418,2322,96,0,46,1,6
10088,1,2473,2263,210,4,302,0,13
10089,2,2395,2435,-40,0,122,1,6
10090,1,2458,2466,-8,0,406,0,6
10091,2,2380,2473,-93,0,1,1,6
10092,2,2383,2409,-26,0,418,0,6
10093,3,2526,2527,-1,0,331,0,6
10094,3,2545,2237,308,0,101,0,6
10095,2,2404,2330,74,0,4,0,6
10096,1,2490,2467,23,0,196,0,6
10097,2,2404,2312,92,0,302,1,6
10098,1,2497,2372,125,0,203,0,6
10099,2,2453,2423,30,0,4,0,6
10100,2,2428,2469,-41,0,49,0,6
10101,1,2476,2405,71,0,338,0,6
10102,2,2417,2502,-85,0,123,1,6
10103,2,2436,2561,-125,0,18,0,6
10104,3,2890,2646,244,0,49,0,6
10105,2,2287,2428,-141,0,40,0,6
10106,2,2441,2567,-126,0,7,1,6
10107,1,2577,2615,-38,0,23,0,6
10108,1,2414,2358,56,0,45,0,6
10109,1,2402,2333,69,0,335,0,6
10110,2,2410,2458,-48,0,40,0,8
10111,1,2542,2487,55,0,300,1,6
10112,2,2476,2492,-16,0,241,0,6
10113,1,2435,2453,-18,0,102,1,6
10114,3,2353,2500,-147,0,40,0,6
10115,3,2592,2664,-72,0,400,0,6
10116,1,2368,2417,-49,0,101,0,6
10117,2,2472,2492,-20,0,14,0,6
10118,2,2518,2651,-133,0,215,0,6
10119,1,2609,2585,24,0,215,0,6
10120,2,2426,2388,38,0,7,0,6
10121,1,2412,2593,-181,0,100,0,6
10122,1,2345,2418,-73,0,10,0,6
10123,2,2241,2535,-294,0,406,0,6
10124,2,2524,2663,-139,0,46,1,6
10125,2,2410,2337,73,0,80,1,6
10126,1,2412,2532,-120,0,120,0,6
10127,1,2343,2527,-184,0,405,0,6
10128,1,2401,2276,125,0,310,1,6
10129,1,2565,2481,84,0,45,0,6
10130,2,2368,2501,-133,0,3,0,6
10131,3,2650,2884,-234,0,151,0,6
10132,2,2474,2377,97,0,46,0,6
10133,1,2503,2364,139,0,219,0,8
10134,2,2464,2421,43,0,490,0,6
10135,2,2462,2495,-33,0,4,1,6
10136,2,2429,2338,91,0,338,1,6
10137,2,2256,2464,-208,0,112,0,6
10138,2,2408,2236,172,0,106,0,6
10139,1,2498,2467,31,0,210,0,6
10140,1,2507,2413,94,0,426,0,6
10141,1,2411,2427,-16,0,132,0,6
10142,1,2432,2347,85,0,278,1,6
10143,2,2579,2614,-35,0,23,0,6
10144,2,2437,2365,72,0,7,0,6
10145,1,2571,2505,66,0,120,0,6
10146,1,2498,2471,27,0,355,0,6
10147,1,2477,2438,39,0,102,0,6
10148,1,2402,2331,71,0,106,0,6
10149,1,2367,2410,-43,0,270,0,6
10150,1,2526,2547,-21,0,345,0,6
10151,1,2412,2363,49,0,45,0,6
10152,2,2263,2424,-161,0,21,1,6
10153,2,2269,2447,-178,0,102,0,6
10154,2,2365,2497,-132,0,2,0,6
10155,1,2441,2355,86,0,117,0,6
10156,3,2540,2239,301,0,101,0,6
10158,2,2620,2573,47,0,207,0,6
10159,1,2344,2413,-69,0,1,0,6
10160,1,2515,2564,-49,0,350,0,6
10161,1,2301,2463,-162,0,113,0,8
10162,2,2385,2431,-46,0,45,1,6
10163,1,2467,2445,22,0,314,0,6
10164,3,2404,2454,-50,0,100,0,6
10165,2,2482,2524,-42,0,301,0,6
10166,1,2409,2459,-50,0,2,1,6
10167,2,2666,2570,96,0,245,0,6
10168,1,2404,2450,-46,0,335,0,6
10169,2,2569,2477,92,0,13,0,6
10170,2,2503,2813,-310,4,122,0,11
10171,2,2500,2458,42,0,189,1,6
10172,2,2356,2407,-51,0,264,0,6
10173,1,2557,2511,46,0,193,1,6
10174,2,2878,2653,225,0,151,0,6
10175,2,2243,2530,-287,0,15,0,6
10176,1,2409,2413,-4,0,120,0,6
10177,1,2351,2462,-111,0,1,0,6
10178,1,2501,2521,-20,0,198,1,6
10179,2,2245,2403,-158,0,302,1,6
10180,1,2278,2456,-178,0,5,0,6
10181,2,2459,2543,-84,0,485,1,6
10182,1,2346,2405,-59,0,13,0,6
10183,1,2541,2361,180,0,201,0,6
10184,3,2455,2309,146,0,102,0,8
10185,2,2406,2544,-138,0,201,1,6
10186,1,2375,2529,-154,0,278,0,6
10187,1,2580,2613,-33,0,11,1,6
10188,1,2351,2417,-66,0,36,0,6
10189,1,2432,2432,0,0,16,0,6
10190,1,2421,2417,4,0,253,0,6
10191,2,2448,2472,-24,0,15,1,6
10192,1,2578,2482,96,0,308,1,6
10193,1,2376,2440,-64,0,300,1,6
10194,1,2270,2405,-135,0,123,0,6
10195,1,2412,2379,33,0,13,0,6
10196,1,2534,2241,293,0,140,0,6
10197,1,2435,2454,-19,0,297,0,6
10198,2,2659,2532,127,0,406,0,6
10199,3,2419,2317,102,0,7,0,6
10200,2,2484,2359,125,0,96,0,6
10201,3,2518,2552,-34,0,432,0,6
10202,2,2402,2344,58,0,46,1,6
10203,1,2662,2862,-200,0,151,0,6
10204,1,2507,2336,171,0,242,0,8
10205,2,2452,2438,14,0,45,1,6
10206,1,2405,2447,-42,0,101,0,6
10207,2,2261,2476,-215,4,300,0,13
10208,2,2563,2363,200,0,45,0,8
10209,1,2317,2436,-119,0,487,1,6
10210,1,2444,2380,64,0,280,0,6
10211,1,2411,2411,0,0,332,1,6
10212,2,2413,2464,-51,0,3,1,6
10213,1,2295,2435,-140,0,190,1,6
10214,2,2523,2358,165,0,40,0,6
10215,2,2385,2404,-19,0,144,0,6
10216,2,2411,2427,-16,0,132,0,6
10217,2,2407,2353,54,0,13,0,6
10218,1,2343,2436,-93,0,110,1,6
10219,2,2506,2494,12,0,65,1,6
10220,1,2515,2507,8,0,484,0,6
10221,1,2459,2415,44,0,0,1,6
10222,2,2847,2671,176,0,150,0,6
10223,1,2521,2383,138,0,341,0,6
10224,1,2501,2377,124,0,28,0,6
10225,1,2385,2449,-64,0,102,0,6
10226,1,2406,2403,3,0,302,1,6
10228,1,2607,2587,20,0,215,0,6
10229,2,2410,2562,-152,0,347,1,6
10230,2,2380,2477,-97,0,242,1,6
10231,1,2427,2352,75,0,31,0,6
10232,1,2432,2406,26,0,253,1,6
10233,1,2448,2478,-30,0,170,0,6
10234,1,2410,2439,-29,0,300,0,6
10235,1,2453,2298,155,0,265,0,8
10236,1,2379,2525,-146,0,195,0,6
10237,1,2440,2348,92,0,6,0,6
10238,2,2476,2375,101,0,343,0,6
10239,1,2652,2503,149,0,133,0,6
10240,1,2433,2374,59,0,156,1,6
10241,2,2444,2447,-3,0,30,0,6
10242,2,2431,2324,107,0,6,0,6
10243,2,2367,2481,-114,0,1,0,6
10244,2,2242,2417,-175,0,1,0,6
10245,1,2400,2310,90,0,426,0,6
10246,1,2431,2405,26,0,332,0,6
10247,2,2347,2478,-131,4,132,0,18
10248,1,2469,2441,28,0,391,0,6
10249,1,2472,2454,18,0,112,0,6
10250,1,2466,2292,174,0,15,1,8
10251,2,2320,2406,-86,4,193,1,13
10252,2,2429,2350,79,0,278,0,6
10253,1,2401,2393,8,0,46,0,6
10254,1,2505,2540,-35,0,34,0,6
10255,1,2344,2442,-98,0,101,1,6
10256,1,2420,2390,30,0,40,0,6
10257,3,2410,2500,-90,0,341,0,6
10258,1,2442,2427,15,0,156,1,6
10259,3,2581,2612,-31,0,461,0,6
10260,3,2428,2406,22,0,7,0,6
10261,1,2449,2477,-28,0,0,0,6
10262,2,2338,2400,-62,0,135,1,6
10264,2,2366,2545,-179,0,2,0,6
10265,2,2482,2408,74,0,46,0,6
10267,3,2452,2383,69,0,45,0,6
10268,1,2433,2363,70,0,10,0,6
10269,2,2212,2510,-298,0,307,0,8
10270,1,2655,2477,178,0,331,0,6
10271,1,2417,2304,113,0,200,1,6
10272,1,2425,2405,20,0,130,0,6
10273,2,2306,2485,-179,0,337,0,6
10274,1,2449,2474,-25,0,153,1,6
10275,1,2471,2455,16,0,2,0,6
10276,2,2419,2438,-19,0,4,0,6
10277,1,2276,2407,-131,0,202,0,6
10278,1,2418,2554,-136,0,7,0,6
10279,1,2447,2387,60,0,46,0,6
10280,2,2519,2393,126,0,345,0,6
10281,1,2410,2232,178,0,320,0,6
10282,1,2458,2501,-43,0,80,0,6
10283,2,2303,2400,-97,0,250,0,6
10284,2,2437,2355,82,0,337,0,6
10285,1,2499,2474,25,0,331,0,6
10286,1,2612,2582,30,0,300,0,6
10287,1,2382,2447,-65,0,409,0,6
10288,3,2377,2418,-41,0,242,0,8
10289,1,2420,2338,82,0,153,0,6
10290,1,2534,2658,-124,0,345,0,6
10291,2,2576,2617,-41,0,175,0,6
10292,2,2366,2422,-56,0,121,1,6
10293,1,2352,2425,-73,0,1,1,6
10294,1,2548,2428,120,0,45,0,6
10295,1,2405,2475,-70,0,302,0,6
10296,1,2422,2389,33,0,404,0,6
10297,1,2438,2260,178,0,28,1,6
10298,2,2477,2475,2,0,242,0,6
10299,1,2363,2451,-88,0,2,0,6
10300,2,2384,2511,-127,0,40,0,6
10301,2,2487,2472,15,0,215,1,6
10302,2,2462,2403,59,0,176,0,6
10303,3,2595,2550,45,0,4,0,6
10304,1,2358,2411,-53,0,1,0,6
10305,2,2450,2476,-26,0,136,0,6
10306,1,2297,2414,-117,0,6,1,6
10307,1,2465,2439,26,0,57,0,6
10308,1,2417,2399,18,0,49,1,6
10309,1,2556,2651,-95,0,45,0,6
10310,1,2444,2419,25,0,106,1,6
10311,1,2468,2424,44,0,312,1,6
10312,1,2440,2276,164,0,346,0,6
10313,2,2256,2413,-157,0,1,0,6
10314,1,2441,2455,-14,0,132,0,6
10315,1,2434,2294,140,0,120,0,6
10316,1,2468,2424,44,0,85,0,6
10317,3,2357,2422,-65,0,110,0,6
10318,1,2504,2336,168,0,122,0,6
10319,2,2362,2430,-68,0,57,0,6
10320,1,2469,2504,-35,0,8,0,6
10321,2,2404,2433,-29,0,105,1,6
10322,3,2482,2445,37,0,3,0,6
10323,2,2296,2470,-174,0,258,0,6
10324,2,2380,2431,-51,0,302,0,6
10325,1,2481,2318,163,0,46,1,6
10326,2,2367,2515,-148,0,37,0,6
10327,1,2400,2316,84,0,202,1,6
10328,2,2403,2547,-144,0,112,0,6
10329,1,2622,2571,51,0,40,0,6
10330,2,2280,2403,-123,0,202,0,6
10331,1,2365,2427,-62,0,220,0,6
10332,1,2489,2359,130,0,4,0,6
10333,1,2629,2471,158,0,45,0,6
10334,1,2443,2413,30,0,140,1,6
10335,3,2412,2323,89,0,40,0,6
10336,1,2419,2346,73,0,200,0,6
10337,2,2204,2590,-386,0,140,0,6
10338,1,2444,2370,74,0,200,0,6
10339,1,2405,2473,-68,0,125,1,6
10340,2,2326,2546,-220,0,40,0,8
10341,2,2498,2475,23,0,347,0,6
10342,1,2447,2353,94,0,193,0,6
10343,1,2468,2473,-5,0,335,1,6
10344,2,2488,2385,103,0,224,0,6
10345,2,2449,2413,36,0,112,1,6
10346,1,2426,2261,165,0,321,0,6
10347,1,2417,2375,42,0,354,0,6
10348,2,2481,2244,237,0,210,1,6
10349,1,2366,2449,-83,0,2,0,6
10350,1,2458,2291,167,0,140,0,8
10351,2,2285,2458,-173,0,1,0,6
10352,1,2295,2438,-143,0,409,1,6
10353,1,2519,2363,156,0,11,1,6
10354,2,2434,2357,77,0,332,0,6
10355,3,2407,2276,131,0,115,0,6
10356,1,2370,2422,-52,0,278,0,6
10357,2,2567,2627,-60,0,468,0,6
10358,1,2551,2309,242,0,423,0,6
10359,1,2467,2633,-166,0,152,0,6
10360,1,2473,2484,-11,0,380,0,6
10361,1,2436,2281,155,0,365,1,6
10362,1,2445,2481,-36,0,36,0,6
10363,1,2417,2244,173,0,145,1,8
10364,2,2345,2438,-93,0,101,1,6
10365,2,2258,2405,-147,0,49,0,6
10366,2,2389,2425,-36,0,490,0,6
10367,1,2542,2583,-41,0,392,0,6
10368,2,2392,2478,-86,0,242,0,6
10369,2,2408,2445,-37,0,4,0,6
10370,1,2424,2282,142,0,100,0,6
10371,1,2500,2492,8,0,341,0,6
10372,2,2204,2476,-272,0,40,0,6
10373,1,2333,2451,-118,0,13,0,6
10375,1,2553,2308,245,0,52,0,6
10376,1,2424,2420,4,0,8,1,6
10377,2,2293,2591,-298,0,142,1,6
10378,1,2421,2358,63,0,106,0,6
10379,3,2551,2540,11,0,457,0,6
10380,1,2442,2414,28,0,300,0,6
10381,2,2227,2467,-240,0,456,1,6
10382,1,2345,2410,-65,4,190,0,13
10383,1,2416,2377,39,0,350,0,6
10384,1,2467,2467,0,0,348,1,6
10385,2,2418,2386,32,0,240,0,6
10387,2,2394,2420,-26,0,120,0,6
10388,1,2394,2493,-99,0,122,1,6
10389,2,2384,2512,-128,0,307,0,6
10390,3,2522,2373,149,0,13,0,6
10391,2,2278,2405,-127,0,202,0,6
10392,2,2418,2474,-56,0,352,1,6
10393,1,2481,2360,121,0,405,0,6
10394,1,2632,2563,69,0,213,0,6
10395,1,2354,2426,-72,0,302,0,6
10396,1,2475,2452,23,0,102,0,6
10397,2,2274,2425,-151,0,45,1,6
10398,1,2486,2506,-20,0,426,0,6
10399,1,2444,2356,88,0,1,0,6
10400,1,2483,2515,-32,0,302,1,6
10401,1,2446,2310,136,0,45,0,6
10402,2,2320,2412,-92,0,404,0,6
10403,1,2431,2382,49,0,455,0,6
10404,2,2401,2357,44,0,122,0,6
10405,1,2441,2270,171,0,17,0,6
10406,1,2366,2446,-80,0,201,0,6
10407,1,2457,2240,217,0,300,0,6
10408,1,2478,2329,149,0,190,0,6
10409,1,2266,2547,-281,0,202,1,6
10410,2,2295,2427,-132,0,198,0,6
10411,2,2323,2430,-107,0,212,0,6
10412,1,2430,2275,155,0,4,1,6
10413,2,2309,2556,-247,0,4,0,6
10414,1,2304,2470,-166,0,200,0,6
10415,2,2372,2421,-49,0,250,0,6
10416,1,2551,2436,115,0,457,0,6
10417,2,2319,2410,-91,0,4,1,6
10418,2,2356,2485,-129,0,344,0,6
10419,2,2541,2516,25,0,5,0,6
10420,1,2372,2420,-48,0,120,1,6
10421,1,2409,2224,185,0,46,1,6
10422,2,2655,2548,107,0,218,0,6
10423,1,2447,2274,173,0,52,0,6
10424,2,2461,2375,86,0,40,0,6
10425,2,2559,2637,-78,0,45,0,6
10426,1,2415,2472,-57,0,405,1,6
10427,2,2425,2295,130,0,4,0,6
10428,1,2354,2448,-94,0,102,0,6
10429,2,2582,2446,136,0,220,0,6
10430,2,2411,2595,-184,0,110,0,6
10431,2,2505,2479,26,0,110,0,6
10432,2,2396,2413,-17,0,3,1,6
10433,2,2396,2431,-35,0,120,0,6
10435,2,2312,2456,-144,0,110,0,6
10436,1,2480,2489,-9,0,234,0,6
10437,3,2380,2450,-70,0,132,0,6
10438,1,2489,2353,136,0,40,0,6
10439,2,2276,2412,-136,0,101,0,6
10440,3,2537,2408,129,0,45,0,6
10441,2,2443,2497,-54,0,215,0,6
10442,1,2664,2641,23,0,460,0,6
10443,2,2559,2598,-39,0,335,0,6
10444,1,2482,2204,278,0,106,0,6
10445,1,2509,2329,180,0,258,0,6
10446,2,2423,2402,21,0,115,0,6
10447,2,2426,2367,59,0,345,1,6
10448,1,2421,2286,135,0,90,0,6
10450,2,2337,2433,-96,0,140,0,6
10451,2,2510,2528,-18,0,389,0,6
10452,2,2263,2459,-196,0,310,0,6
10453,1,2434,2419,15,0,325,0,6
10454,2,2294,2463,-169,0,40,1,8
10455,1,2450,2379,71,0,83,0,6
10456,2,2416,2486,-70,0,125,1,6
10457,2,2328,2414,-86,0,138,0,6
10458,3,2454,2376,78,0,10,0,6
10459,2,2222,2529,-307,0,46,1,6
10460,2,2554,2648,-94,0,80,0,6
10461,2,2547,2574,-27,0,45,0,6
10462,2,2469,2461,8,0,483,1,6
10463,2,2483,2552,-69,0,313,1,6
10464,1,2436,2286,150,0,100,0,6
10465,3,2437,2421,16,0,7,0,6
10466,2,2432,2582,-150,0,267,0,6
10467,3,2441,2372,69,0,193,0,6
10468,1,2428,2215,213,0,216,0,6
10469,2,2455,2386,69,0,143,0,6
10470,1,2309,2431,-122,0,463,1,6
10471,2,2383,2465,-82,0,2,0,6
10472,1,2415,2454,-39,0,265,0,6
10473,1,2377,2413,-36,0,315,1,6
10474,1,2462,2256,206,0,43,1,6
10475,2,2327,2419,-92,0,13,0,6
10476,1,2440,2285,155,0,153,0,6
10477,1,2349,2492,-143,0,302,0,6
10478,1,2603,2413,190,0,150,0,6
10479,1,2390,2454,-64,0,2,0,6
10480,1,2520,2384,136,0,469,1,6
10481,1,2579,2542,37,0,218,1,6
10482,1,2484,2308,176,0,139,0,6
10483,2,2374,2419,-45,0,1,1,6
10484,2,2419,2512,-93,0,302,0,6
10485,1,2502,2326,176,0,344,0,6
10486,1,2283,2417,-134,0,1,0,6
10487,1,2438,2263,175,0,150,0,6
10488,1,2425,2372,53,0,133,0,6
10489,1,2369,2431,-62,0,133,0,6
10490,1,2470,2378,92,0,203,0,6
10491,1,2414,2440,-26,0,204,0,6
10492,1,2377,2423,-46,0,338,1,6
10493,2,2534,2453,81,0,250,0,6
10494,1,2438,2323,115,0,210,0,6
10495,2,2271,2440,-169,0,0,0,6
10496,2,2516,2438,78,0,110,1,6
10497,2,2306,2418,-112,0,130,0,6
10498,3,2269,2500,-231,0,304,0,6
10499,1,2652,2473,179,0,190,1,6
10500,2,2491,2411,80,0,236,0,6
10501,2,2478,2499,-21,0,40,0,6
10502,2,2316,2468,-152,0,456,0,6
10503,3,2410,2555,-145,0,130,0,6
10504,3,2622,2550,72,0,47,0,6
10506,1,2557,2360,197,0,300,0,8
10507,2,2375,2437,-62,0,16,0,6
10508,1,2586,2421,165,0,394,0,6
10509,1,2422,2441,-19,0,310,0,6
10510,2,2401,2607,-206,0,45,0,6
10511,2,2485,2357,128,0,121,0,6
10512,1,2426,2448,-22,0,117,0,6
10513,1,2532,2233,299,0,202,0,6
10514,1,2458,2506,-48,0,45,1,6
10515,2,2323,2416,-93,0,101,0,6
10516,1,2442,2332,110,0,4,1,6
10517,2,2447,2442,5,0,4,1,6
10518,1,2561,2435,126,0,45,1,6
10519,2,2374,2523,-149,0,3,1,6
10520,1,2537,2584,-47,0,45,0,6
10521,1,2424,2397,27,0,80,0,6
10522,1,2409,2369,40,0,214,0,6
10523,1,2404,2304,100,4,50,1,13
10524,2,2274,2457,-183,0,398,0,6
10525,2,2355,2465,-110,0,115,0,6
10526,3,2357,2559,-202,0,211,0,8
10527,1,2443,2377,66,0,193,0,6
10528,1,2551,2621,-70,0,335,0,6
10529,1,2460,2355,105,0,192,1,6
10530,2,2392,2430,-38,0,3,1,6
10531,1,2401,2251,150,0,45,0,6
10532,2,2417,2364,53,0,96,1,6
10533,2,2434,2266,168,0,84,0,6
10534,1,2527,2589,-62,0,0,0,6
10535,1,2472,2552,-80,0,57,0,6
10536,1,2435,2428,7,0,245,0,6
10537,1,2422,2270,152,0,302,0,6
10538,2,2356,2420,-64,0,112,0,6
10539,1,2489,2318,171,0,217,0,6
10540,2,2443,2473,-30,0,242,1,6
10541,1,2418,2415,3,0,106,1,6
10542,1,2610,2231,379,0,109,0,6
10543,2,2407,2405,2,0,27,0,6
10544,2,2442,2465,-23,0,43,1,6
10545,2,2470,2499,-29,0,101,1,6
10546,3,2403,2407,-4,0,110,0,6
10547,2,2214,2431,-217,0,302,0,6
10548,2,2258,2519,-261,0,378,0,6
10549,2,2578,2510,68,0,101,1,6
10550,1,2469,2319,150,0,48,1,6
10551,3,2413,2421,-8,0,111,0,6
10552,2,2416,2448,-32,0,223,0,6
10553,3,2450,2341,109,0,4,0,6
10554,1,2527,2371,156,0,13,1,6
10555,1,2417,2321,96,0,311,0,6
10556,2,2335,2442,-107,0,200,0,6
10557,2,2393,2544,-151,0,218,0,6
10558,2,2351,2441,-90,0,267,1,6
10559,3,2464,2400,64,0,107,0,6
10560,1,2432,2381,51,0,162,0,6
10561,1,2541,2614,-73,0,45,0,6
10562,1,2325,2422,-97,0,414,0,6
10563,3,2426,2254,172,0,90,0,6
10564,1,2435,2387,48,0,80,0,6
10565,1,2455,2315,140,0,41,0,6
10566,1,2582,2410,172,0,330,0,6
10567,2,2262,2612,-350,0,225,1,6
10568,2,2230,2526,-296,0,215,0,6
10569,1,2300,2454,-154,0,106,1,6
10570,1,2478,2534,-56,0,46,0,6
10571,2,2557,2437,120,0,80,0,6
10573,1,2426,2227,199,0,6,0,6
10574,2,2504,2424,80,0,0,0,6
10575,1,2425,2345,80,0,241,0,6
10576,2,2421,2316,105,0,45,0,6
10577,1,2413,2473,-60,0,110,0,6
10578,1,2371,2421,-50,0,1,1,6
10579,1,2407,2365,42,0,44,1,6
10580,2,2432,2304,128,0,40,0,6
10581,2,2348,2425,-77,0,1,0,6
10582,1,2371,2410,-39,0,20,0,6
10583,1,2437,2453,-16,0,406,0,6
10584,1,2469,2389,80,0,84,1,6
10585,2,2318,2493,-175,0,40,0,6
10586,1,2377,2516,-139,0,101,0,6
10587,2,2470,2571,-101,0,45,0,6
10588,2,2406,2416,-10,0,194,0,6
10589,1,2204,2528,-324,0,13,0,6
10590,2,2367,2512,-145,0,2,1,6
10591,1,2446,2332,114,0,4,0,6
10592,1,2382,2440,-58,0,277,1,6
10593,2,2438,2463,-25,0,391,0,6
10594,2,2242,2458,-216,0,5,0,6
10595,2,2445,2313,132,0,130,0,6
10596,2,2401,2376,25,0,80,0,6
10597,1,2663,2558,105,0,154,0,6
10598,1,2575,2466,109,0,101,0,6
10599,1,2423,2485,-62,0,380,0,6
10600,2,2389,2454,-65,0,211,0,5
10601,1,2527,2548,-21,0,200,0,6
10602,1,2613,2536,77,0,130,0,6
10603,1,2445,2332,113,0,121,0,6
10604,1,2402,2285,117,0,280,1,8
10605,1,2420,2549,-129,0,364,0,6
10606,3,2474,2342,132,0,314,0,6
10607,1,2518,2272,246,0,45,0,6
10608,2,2214,2420,-206,0,122,0,6
10609,1,2466,2496,-30,0,40,1,6
10610,1,2446,2319,127,0,345,0,6
10611,1,2408,2400,8,0,302,0,6
10612,1,2447,2343,104,0,110,0,6
10613,1,2466,2292,174,4,21,0,11
10614,1,2427,2383,44,0,404,1,6
10615,2,2500,2429,71,0,45,1,6
10616,2,2415,2443,-28,0,4,0,6
10617,2,2521,2315,206,0,46,0,6
10618,1,2378,2500,-122,0,1,0,6
10619,2,2469,2382,87,0,184,0,6
10620,2,2284,2433,-149,0,43,1,6
10621,2,2462,2579,-117,0,215,0,6
10622,1,2531,2360,171,0,422,0,6
10623,1,2516,2364,152,0,331,0,6
10624,2,2547,2561,-14,0,50,0,6
10625,2,2478,2430,48,0,302,0,6
10626,2,2321,2438,-117,0,345,0,6
10627,1,2450,2370,80,0,6,0,6
10628,2,2264,2412,-148,0,115,0,6
10629,3,2423,2312,111,0,241,0,6
10630,2,2241,2512,-271,0,215,0,6
10631,2,2585,2521,64,0,400,0,6
10632,2,2554,2667,-113,0,335,0,6
10633,1,2449,2389,60,0,240,0,6
10634,2,2583,2410,173,0,123,0,6
10635,1,2450,2333,117,0,40,0,6
10636,2,2428,2329,99,0,88,0,6
10637,2,2441,2332,109,0,203,1,6
10638,2,2209,2618,-409,0,45,0,6
10639,2,2507,2233,274,0,206,0,6
10640,2,2541,2451,90,0,45,0,6
10641,1,2542,2382,160,0,80,1,6
10642,2,2298,2458,-160,0,25,0,6
10643,1,2534,2226,308,0,469,0,6
10644,2,2490,2416,74,0,101,0,6
10645,2,2408,2314,94,4,306,1,13
10646,2,2474,2328,146,0,474,0,6
10647,3,2374,2414,-40,0,106,0,6
10648,1,2533,2462,71,0,0,0,6
10649,1,2402,2346,56,0,211,0,8
10650,3,2429,2350,79,0,104,0,6
10651,3,2360,2519,-159,0,3,0,6
10652,2,2448,2567,-119,0,406,0,6
10653,2,2314,2619,-305,0,46,0,6
10654,3,2462,2208,254,0,90,0,6
10655,2,2458,2385,73,0,213,0,6
10656,1,2442,2317,125,0,127,0,6
10657,2,2309,2493,-184,0,113,0,6
10658,2,2528,2579,-51,0,404,0,6
10659,2,2371,2436,-65,0,0,0,6
10660,2,2252,2421,-169,0,125,0,6
10661,2,2416,2365,51,0,49,0,6
10662,2,2504,2472,32,0,246,1,6
10663,3,2416,2420,-4,0,172,0,6
10664,2,2395,2420,-25,0,114,0,6
10665,2,2384,2542,-158,0,3,1,6
10667,1,2410,2330,80,0,106,0,6
10668,1,2413,2296,117,0,4,0,6
10669,1,2627,2516,111,0,241,1,6
10670,3,2406,2205,201,0,101,0,8
10671,2,2350,2536,-186,0,389,0,6
10672,1,2509,2380,129,0,140,0,6
10673,1,2548,2437,111,0,131,0,6
10674,1,2457,2226,231,0,372,0,6
10675,2,2341,2454,-113,0,106,0,6
10676,3,2337,2420,-83,0,34,0,6
10677,1,2441,2392,49,0,40,0,6
10678,1,2451,2575,-124,0,1,0,6
10679,1,2453,2433,20,0,142,0,6
10680,2,2424,2483,-59,0,121,0,6
10681,2,2340,2465,-125,0,226,1,6
10682,2,2444,2413,31,0,40,0,6
10683,1,2523,2538,-15,0,409,0,6
10684,2,2418,2457,-39,0,101,1,6
10685,2,2359,2437,-78,0,442,0,6
10686,2,2312,2467,-155,0,46,1,6
10687,1,2515,2348,167,0,45,0,6
10688,3,2621,2473,148,0,112,0,6
10689,1,2461,2363,98,0,331,0,6
10690,1,2571,2546,25,0,386,0,6
10691,2,2224,2496,-272,0,117,0,6
10692,2,2233,2459,-226,0,123,1,6
10693,1,2478,2359,119,0,40,0,6
10694,1,2314,2445,-131,0,300,0,6
10695,2,2372,2409,-37,0,112,0,6
10696,2,2361,2442,-81,0,190,0,6
10697,1,2539,2299,240,0,58,0,6
10698,2,2512,2584,-72,0,252,0,6
10699,2,2419,2400,19,0,302,1,6
10700,1,2488,2619,-131,0,150,1,6
10701,1,2420,2519,-99,0,206,1,6
10702,1,2567,2381,186,0,125,0,6
10703,2,2532,2529,3,0,125,0,6
10704,1,2438,2458,-20,0,40,1,6
10705,1,2475,2332,143,0,46,1,6
10706,1,2482,2545,-63,0,40,1,6
10707,1,2498,2256,242,0,45,1,6
10708,2,2427,2381,46,0,240,1,6
10709,2,2387,2419,-32,0,1,0,6
10710,2,2426,2439,-13,4,300,0,13
10711,1,2461,2222,239,0,302,0,6
10712,1,2471,2230,241,0,473,0,6
10713,1,2351,2428,-77,0,112,0,6
10714,2,2403,2291,112,0,117,1,8
10715,3,2462,2526,-64,0,102,0,6
10716,2,2338,2424,-86,0,102,0,6
10717,2,2413,2290,123,0,4,0,6
10718,1,2576,2512,64,0,0,0,6
10719,1,2461,2210,251,0,453,0,6
10720,2,2295,2413,-118,0,301,0,6
10721,2,2414,2367,47,0,372,0,6
10722,1,2420,2218,202,0,195,0,6
10723,1,2418,2348,70,0,4,0,6
10724,1,2588,2570,18,0,455,0,6
10726,1,2438,2322,116,0,127,0,6
10727,1,2541,2427,114,0,440,0,6
10728,2,2294,2404,-110,0,34,0,6
10729,1,2540,2376,164,0,45,0,6
10730,1,2298,2413,-115,0,1,0,6
10731,2,2382,2429,-47,0,105,1,6
10732,1,2385,2465,-80,0,215,1,6
10733,2,2355,2611,-256,0,190,0,6
10734,2,2373,2565,-192,0,101,0,6
10735,1,2562,2452,110,0,10,1,6
10736,2,2414,2262,152,0,43,0,6
10737,2,2335,2553,-218,0,0,0,6
10738,1,2463,2289,174,0,372,0,6
10739,1,2425,2352,73,0,202,1,6
10740,1,2427,2501,-74,0,302,0,6
10741,2,2544,2444,100,0,45,0,6
10742,2,2216,2416,-200,0,490,0,6
10743,2,2320,2478,-158,0,302,1,6
10744,2,2246,2414,-168,0,1,0,6
10745,1,2565,2581,-16,0,103,0,6
10746,1,2202,2423,-221,0,100,0,6
10747,1,2404,2242,162,0,0,0,8
10748,2,2385,2412,-27,0,245,1,6
10749,1,2387,2420,-33,0,3,0,6
10750,1,2525,2470,55,0,4,0,6
10751,3,2575,2571,4,0,45,0,6
10752,1,2538,2463,75,0,331,1,6
10753,2,2339,2423,-84,0,45,0,6
10754,1,2475,2545,-70,0,414,0,6
10755,1,2421,2358,63,0,278,0,6
10756,1,2450,2359,91,0,133,0,6
10757,2,2417,2560,-143,0,335,1,6
10758,2,2441,2425,16,0,207,0,8
10759,2,2401,2248,153,4,315,1,13
10760,3,2613,2497,116,0,13,0,6
10761,2,2249,2556,-307,0,151,0,6
10762,2,2318,2442,-124,0,300,0,6
10763,1,2408,2280,128,0,154,1,6
10764,1,2406,2283,123,0,40,0,6
10765,2,2555,2535,20,0,317,0,6
10766,1,2348,2408,-60,0,113,1,6
10767,2,2252,2406,-154,0,101,0,6
10768,3,2494,2295,199,0,45,0,6
10769,1,2452,2458,-6,0,40,1,6
10770,1,2434,2308,126,0,115,0,6
10771,2,2448,2340,108,0,52,1,6
10772,2,2530,2566,-36,0,45,0,6
10773,1,2355,2536,-181,0,3,1,6
10774,2,2248,2417,-169,0,253,1,6
10775,1,2431,2283,148,0,326,0,6
10776,3,2413,2394,19,0,86,0,6
10777,1,2408,2295,113,0,337,0,6
10778,1,2445,2314,131,0,206,1,6
10779,1,2438,2334,104,0,102,0,6
10780,2,2571,2575,-4,0,103,0,6
10781,1,2499,2376,123,0,119,0,6
10782,2,2539,2535,4,0,335,0,6
10783,1,2386,2446,-60,0,122,0,6
10784,2,2459,2428,31,0,201,0,6
10785,2,2280,2434,-154,0,43,1,6
10786,1,2410,2235,175,0,302,0,6
10787,2,2565,2549,16,0,112,0,6
10788,3,2328,2401,-73,0,120,0,6
10789,3,2384,2413,-29,0,418,0,6
10790,1,2365,2412,-47,0,45,0,6
10791,2,2275,2409,-134,0,113,0,8
10792,1,2543,2354,189,0,45,0,8
10793,2,2235,2410,-175,0,11,1,6
10794,1,2252,2405,-153,0,307,1,6
10795,3,2356,2443,-87,0,15,0,6
10796,2,2437,2458,-21,0,454,1,6
10797,1,2420,2295,125,0,45,0,6
10798,1,2487,2452,35,0,203,1,6
10799,1,2426,2306,120,0,100,0,6
10800,3,2401,2211,190,0,43,0,6
10801,1,2302,2413,-111,0,142,0,6
10802,1,2441,2393,48,0,484,0,6
10803,2,2421,2293,128,0,181,0,6
10804,1,2581,2566,15,0,45,0,6
10805,2,2273,2403,-130,0,30,1,6
10806,1,2354,2426,-72,0,112,1,6
10807,2,2448,2261,187,0,4,1,6
10808,1,2413,2394,19,0,80,1,6
10809,1,2559,2334,225,0,101,0,6
10811,1,2541,2533,8,0,31,0,6
10812,2,2453,2525,-72,0,0,0,6
10813,1,2402,2227,175,0,107,0,6
10814,1,2405,2215,190,4,262,0,13
10815,1,2430,2331,99,0,198,0,6
10816,2,2370,2413,-43,0,40,0,6
10817,1,2459,2377,82,0,1,0,6
10818,2,2405,2310,95,0,49,1,6
10819,2,2435,2546,-111,0,202,0,6
10820,1,2413,2392,21,0,381,0,6
10821,1,2560,2586,-26,0,103,0,6
10822,1,2401,2318,83,0,106,1,6
10823,1,2438,2276,162,0,40,0,6
10824,1,2541,2555,-14,0,10,1,6
10825,1,2361,2407,-46,0,70,0,6
10826,3,2418,2256,162,0,41,0,6
10827,2,2388,2418,-30,0,122,0,6
10828,2,2447,2436,11,0,41,0,6
10829,2,2468,2364,104,0,13,1,6
10830,2,2326,2432,-106,0,58,0,6
10831,1,2224,2405,-181,0,302,0,6
10832,2,2384,2434,-50,0,157,1,6
10833,2,2389,2418,-29,0,3,0,6
10834,2,2356,2562,-206,0,15,0,6
10835,1,2380,2448,-68,0,101,0,6
10836,1,2501,2530,-29,0,103,0,6
10837,2,2445,2463,-18,0,302,1,6
10838,1,2419,2412,7,0,130,0,6
10839,2,2527,2566,-39,0,469,1,6
10840,2,2309,2415,-106,0,1,0,6
10841,1,2402,2328,74,0,37,0,6
10842,2,2363,2425,-62,0,125,0,6
10843,1,2391,2400,-9,0,105,0,6
10844,1,2420,2286,134,0,302,0,6
10845,1,2549,2555,-6,0,4,0,6
10846,2,2259,2444,-185,0,300,0,6
10847,1,2425,2380,45,0,313,0,6
10848,2,2274,2408,-134,0,115,0,6
10849,1,2441,2442,-1,0,41,0,6
10850,2,2229,2408,-179,0,131,1,6
10851,1,2398,2420,-22,4,6,0,13
10852,1,2397,2423,-26,0,112,0,6
10853,3,2383,2436,-53,0,105,0,6
10854,1,2225,2410,-185,0,228,0,6
10855,1,2414,2225,189,0,122,0,6
10856,1,2564,2304,260,0,140,0,6
10857,2,2547,2671,-124,0,13,0,6
10858,1,2353,2441,-88,0,107,0,6
10859,1,2383,2439,-56,0,2,0,6
10860,3,2403,2226,177,0,117,0,6
10861,2,2447,2376,71,0,35,0,6
10862,1,2460,2371,89,0,454,0,6
10863,1,2572,2522,50,0,125,0,6
10864,1,2288,2423,-135,0,40,1,6
10865,1,2445,2267,178,0,247,1,6
10866,2,2432,2353,79,0,202,1,6
10867,1,2524,2508,16,0,9,1,6
10868,1,2469,2440,29,0,46,0,6
10869,2,2417,2403,14,0,310,1,6
10870,2,2555,2549,6,0,4,0,6
10871,1,2269,2440,-171,0,45,1,6
10872,1,2436,2447,-11,0,4,1,6
10873,3,2405,2338,67,0,408,0,6
10874,1,2434,2391,43,0,191,0,6
10875,2,2499,2543,-44,0,45,0,6
10876,1,2432,2351,81,0,101,0,6
10877,1,2415,2418,-3,4,320,0,13
10878,1,2435,2402,33,0,406,0,6
10879,1,2390,2461,-71,0,3,1,6
10880,1,2382,2440,-58,0,337,1,6
10881,1,2430,2280,150,0,241,0,6
10882,2,2372,2438,-66,0,115,0,6
10883,1,2317,2435,-118,0,25,1,6
10884,2,2507,2548,-41,0,45,1,6
10885,3,2517,2576,-59,0,470,0,6
10886,2,2415,2427,-12,0,302,0,6
10887,1,2449,2337,112,0,130,0,6
10888,2,2371,2549,-178,0,2,0,6
10889,2,2494,2529,-35,0,45,0,6
10890,2,2409,2411,-2,0,112,0,6
10891,1,2435,2298,137,0,40,0,6
10892,2,2432,2303,129,0,415,1,6
10893,2,2555,2502,53,0,0,0,6
10894,2,2441,2442,-1,0,41,0,6
10895,2,2397,2441,-44,0,43,0,6
10896,2,2346,2437,-91,0,301,0,6
10897,2,2502,2489,13,0,1,1,6
10898,1,2439,2492,-53,0,156,1,6
10899,2,2455,2568,-113,0,150,0,6
10900,2,2454,2397,57,0,85,1,6
10901,2,2380,2434,-54,0,253,0,6
10902,2,2400,2342,58,0,45,0,6
10903,1,2509,2549,-40,0,194,0,6
10904,1,2388,2489,-101,4,112,0,13
10905,1,2432,2354,78,0,133,0,6
10906,1,2410,2276,134,0,43,0,6
10907,1,2576,2518,58,0,123,1,6
10908,2,2417,2403,14,0,310,1,6
10909,1,2418,2308,110,0,202,0,6
10910,3,2438,2294,144,0,28,0,6
10911,2,2493,2427,66,0,225,0,6
10912,1,2446,2392,54,0,406,0,6
10913,1,2553,2502,51,0,113,0,6
10914,2,2404,2335,69,0,201,0,6
10915,3,2403,2266,137,0,115,0,6
10916,1,2448,2436,12,0,4,1,6
10917,1,2342,2441,-99,0,4,0,6
10918,2,2495,2489,6,0,359,0,6
10919,2,2534,2496,38,0,15,0,6
10920,2,2385,2446,-61,0,318,1,6
10921,2,2322,2453,-131,0,44,0,6
10922,2,2433,2240,193,0,5,0,6
10923,2,2258,2404,-146,0,45,0,6
10924,2,2297,2424,-127,0,132,0,6
10925,3,2387,2451,-64,0,313,0,6
10926,1,2351,2415,-64,0,414,0,6
10927,2,2573,2207,366,0,130,0,6
10928,2,2229,2421,-192,4,115,0,13
10929,1,2434,2318,116,0,125,1,6
10930,2,2435,2489,-54,0,304,0,6
10931,2,2404,2414,-10,0,2,0,6
10932,1,2514,2580,-66,0,469,0,6
10933,1,2465,2434,31,0,34,0,6
10934,2,2409,2411,-2,0,112,0,6
10935,1,2486,2368,118,0,95,0,6
10936,1,2436,2323,113,0,11,0,6
10937,1,2420,2391,29,0,302,0,6
10938,1,2448,2442,6,0,128,0,6
10939,2,2452,2523,-71,0,1,0,6
10940,1,2339,2421,-82,0,4,0,6
10941,1,2568,2491,77,0,123,0,6
10942,2,2574,2589,-15,0,49,0,6
10943,1,2440,2491,-51,0,100,0,6
10944,1,2506,2240,266,0,40,0,6
10945,1,2430,2454,-24,0,41,0,6
10946,1,2570,2403,167,0,0,1,6
10947,2,2502,2528,-26,0,1,0,6
10948,2,2365,2420,-55,0,129,1,6
10949,3,2495,2489,6,0,246,0,6
10950,1,2528,2347,181,0,134,0,6
10951,1,2448,2272,176,0,4,0,6
10952,3,2440,2345,95,2,18,0,18
10953,1,2475,2302,173,0,440,1,6
10954,2,2367,2454,-87,0,340,0,6
10955,1,2437,2310,127,0,102,0,6
10956,1,2401,2279,122,4,128,1,13
10957,2,2400,2451,-51,0,346,1,6
10958,1,2450,2388,62,0,406,1,6
10959,1,2497,2533,-36,0,409,0,6
10960,1,2408,2283,125,0,455,0,6
10961,1,2417,2404,13,0,310,0,6
10962,1,2360,2417,-57,0,263,0,6
10963,2,2268,2568,-300,0,106,1,6
10964,1,2594,2573,21,0,103,0,6
10965,2,2486,2256,230,0,40,0,6
10966,1,2528,2425,103,0,398,0,6
10967,1,2498,2412,86,0,221,0,6
10968,1,2408,2406,2,0,484,0,6
10969,1,2419,2298,121,0,48,0,6
10970,2,2433,2239,194,0,330,0,6
10971,3,2248,2444,-196,0,300,0,6
10972,1,2440,2398,42,0,10,0,6
10973,2,2249,2452,-203,0,172,0,6
10974,2,2494,2448,46,0,41,1,6
10975,1,2480,2562,-82,0,106,0,6
10976,2,2354,2436,-82,0,96,0,6
10977,1,2486,2600,-114,0,302,0,6
10978,2,2504,2520,-16,0,394,1,6
10979,1,2319,2427,-108,0,45,0,6
10980,2,2398,2423,-25,0,45,0,6
10981,1,2495,2489,6,0,249,0,6
10982,1,2421,2407,14,0,12,0,6
10983,2,2277,2574,-297,0,10,0,6
10984,2,2444,2411,33,0,408,1,6
10985,2,2458,2398,60,0,247,0,6
10986,1,2456,2364,92,0,201,1,6
10987,1,2438,2333,105,0,144,0,6
10988,2,2415,2401,14,0,196,1,6
10989,3,2238,2508,-270,0,112,0,6
10990,1,2232,2458,-226,0,268,0,6
10991,1,2386,2423,-37,0,40,1,6
10992,2,2527,2451,76,0,4,1,6
10993,1,2370,2471,-101,0,300,1,6
10994,2,2265,2570,-305,0,41,0,6
10995,2,2320,2425,-105,0,484,1,6
10996,2,2442,2229,213,0,147,0,6
10997,1,2478,2490,-12,0,466,0,6
10998,1,2454,2321,133,0,106,1,6
10999,2,2555,2568,-13,0,257,0,6
11000,2,2449,2544,-95,0,428,1,6
11001,2,2328,2494,-166,0,245,0,6
11002,1,2473,2400,73,0,206,0,6
11003,1,2414,2307,107,0,344,1,6
11004,2,2592,2384,208,0,121,0,6
11005,2,2419,2314,105,0,122,1,6
11006,3,2576,2478,98,0,0,0,6
11007,1,2441,2332,109,0,350,0,6
11008,1,2431,2291,140,0,205,0,6
11009,1,2428,2393,35,0,88,1,6
11010,1,2400,2251,149,0,3,0,6
11011,1,2484,2393,91,0,80,0,6
11012,2,2251,2550,-299,0,45,0,6
11013,2,2573,2488,85,0,154,0,6
11014,1,2533,2452,81,0,245,0,6
11015,1,2454,2487,-33,0,6,0,6
11016,1,2277,2403,-126,0,4,0,6
11017,1,2434,2348,86,0,246,0,6
11018,2,2407,2201,206,0,154,0,6
11019,1,2572,2355,217,0,341,1,6
11020,2,2364,2433,-69,0,4,0,6
11021,1,2418,2438,-20,0,106,1,6
11022,3,2449,2250,199,0,128,0,6
11023,2,2403,2387,16,0,241,1,6
11024,1,2526,2501,25,0,335,0,6
11025,1,2497,2574,-77,0,40,0,6
11026,3,2480,2325,155,0,107,0,6
11027,2,2305,2409,-104,0,45,0,6
11028,2,2447,2263,184,0,143,0,6
11029,2,2439,2537,-98,0,1,0,6
11030,1,2484,2474,10,0,337,0,6
11031,2,2396,2416,-20,0,4,0,6
11033,2,2442,2448,-6,0,142,0,6
11034,3,2552,2584,-32,0,461,0,6
11035,2,2300,2444,-144,0,404,0,6
11036,2,2338,2400,-62,0,6,0,6
11037,1,2429,2357,72,0,26,1,6
11038,2,2271,2542,-271,0,260,0,6
11039,2,2505,2406,99,0,107,0,6
11040,2,2574,2398,176,0,305,0,6
11041,2,2458,2317,141,0,4,0,6
11042,2,2458,2520,-62,0,406,0,6
11043,2,2548,2445,103,0,253,0,6
11044,2,2446,2394,52,0,120,0,6
11045,1,2500,2498,2,0,302,1,6
11046,1,2424,2422,2,4,60,0,13
11047,2,2287,2406,-119,0,253,0,8
11048,1,2413,2442,-29,0,190,1,6
11049,1,2495,2504,-9,0,100,0,6
11050,1,2477,2301,176,0,211,0,6
11051,2,2567,2566,1,0,1,0,6
11052,2,2488,2418,70,0,46,1,6
11053,2,2389,2445,-56,0,2,0,6
11054,1,2405,2434,-29,0,200,0,6
11055,2,2307,2425,-118,0,269,1,6
11056,3,2388,2433,-45,0,110,0,6
11057,1,2481,2461,20,0,241,0,6
11058,2,2340,2572,-232,0,8,0,6
11059,2,2441,2428,13,0,125,0,6
11060,1,2496,2531,-35,0,130,0,6
11061,2,2405,2334,71,0,331,0,6
11062,3,2583,2328,255,0,115,0,6
11063,1,2552,2480,72,0,125,0,6
11064,2,2407,2377,30,0,4,0,6
11065,3,2501,2566,-65,0,101,0,6
11066,1,2504,2242,262,0,112,0,6
11067,1,2417,2237,180,0,107,0,6
11068,2,2468,2477,-9,0,46,0,6
11069,3,2424,2265,159,0,4,0,6
11070,1,2425,2400,25,0,46,0,6
11071,2,2387,2502,-115,0,154,0,6
11072,1,2497,2525,-28,0,0,0,6
11073,2,2393,2452,-59,0,250,0,6
11074,2,2418,2459,-41,0,302,1,6
11075,2,2300,2580,-280,0,45,0,6
11076,2,2204,2544,-340,0,414,0,6
11077,2,2325,2490,-165,0,202,0,6
11078,1,2411,2357,54,0,219,1,6
11079,1,2574,2213,361,0,150,0,6
11080,1,2578,2694,-116,0,334,0,6
11081,1,2384,2420,-36,0,110,0,6
11082,1,2401,2562,-161,0,100,1,6
11083,1,2436,2266,170,0,1,0,6
11084,1,2621,2525,96,0,314,1,6
11085,2,2384,2453,-69,0,3,0,6
11086,2,2321,2449,-128,0,43,0,6
11087,1,2425,2481,-56,0,386,1,6
11088,1,2429,2438,-9,0,200,0,6
11089,1,2507,2436,71,0,302,1,6
11090,2,2432,2389,43,0,43,0,6
11091,1,2582,2413,169,0,115,0,6
11092,2,2390,2565,-175,0,101,0,6
11093,2,2455,2487,-32,0,8,0,6
11094,2,2357,2435,-78,0,45,1,6
11095,2,2314,2434,-120,0,129,0,6
11096,1,2494,2557,-63,0,5,0,6
11097,2,2223,2434,-211,0,300,0,6
11098,2,2483,2463,20,0,15,0,6
11099,2,2368,2410,-42,0,453,0,8
11100,2,2576,2355,221,0,262,0,6
11101,1,2425,2258,167,0,102,1,6
11102,2,2273,2428,-155,0,141,0,6
11103,2,2506,2554,-48,0,100,0,6
11104,1,2502,2519,-17,0,102,0,6
11105,1,2240,2506,-266,0,47,1,6
11106,1,2585,2409,176,0,196,0,6
11107,2,2291,2411,-120,0,253,1,6
11108,2,2315,2413,-98,0,127,0,6
11109,3,2399,2464,-65,0,7,0,6
11110,2,2359,2477,-118,0,6,0,6
11111,2,2493,2304,189,0,69,0,6
11112,1,2403,2336,67,0,40,0,6
11113,1,2390,2422,-32,0,18,0,6
11114,1,2569,2338,231,0,330,0,6
11115,1,2244,2437,-193,0,469,0,6
11116,2,2453,2318,135,0,487,0,6
11117,3,2409,2270,139,4,140,0,13
11118,1,2435,2221,214,0,123,1,6
11119,2,2421,2278,143,0,311,0,6
11120,1,2481,2571,-90,0,300,0,6
11121,2,2355,2439,-84,0,6,0,6
11122,2,2438,2429,9,0,8,0,6
11123,2,2330,2550,-220,0,4,0,6
11124,1,2406,2213,193,0,153,0,6
11125,1,2588,2501,87,0,106,0,6
11126,1,2376,2401,-25,0,308,0,6
11127,2,2414,2469,-55,0,13,0,6
11128,2,2458,2380,78,0,87,0,6
11129,2,2475,2432,43,0,46,0,6
11130,2,2502,2567,-65,0,145,0,6
11131,1,2559,2364,195,0,0,0,6
11132,1,2557,2521,36,0,39,0,6
11133,2,2333,2480,-147,0,106,0,6
11134,2,2513,2508,5,0,140,0,6
11135,1,2412,2314,98,0,133,0,6
11136,3,2395,2426,-31,0,123,0,6
11137,1,2564,2304,260,0,405,0,6
11138,2,2269,2428,-159,0,271,0,6
11139,1,2432,2396,36,0,1,0,6
11140,1,2512,2504,8,0,46,0,6
11141,2,2331,2408,-77,0,6,0,6
11142,1,2552,2463,89,0,288,0,6
11143,1,2432,2400,32,0,48,0,6
11144,1,2547,2431,116,0,330,0,6
11145,1,2415,2253,162,0,121,0,6
11146,1,2429,2438,-9,0,106,0,6
11147,2,2377,2415,-38,0,253,1,6
11148,3,2409,2592,-183,0,314,0,6
11149,2,2303,2407,-104,0,110,0,6
11150,1,2496,2416,80,0,5,0,6
11151,2,2417,2359,58,0,46,1,6
11152,1,2387,2451,-64,0,102,0,6
11153,2,2312,2421,-109,0,150,0,6
11154,1,2457,2389,68,0,50,0,6
11155,3,2517,2586,-69,0,40,0,6
11156,2,2361,2443,-82,0,151,0,6
11157,1,2562,2389,173,0,0,0,6
11158,2,2251,2432,-181,0,230,0,6
11159,2,2432,2562,-130,0,38,0,6
11160,1,2404,2340,64,0,62,1,6
11161,2,2437,2221,216,0,1,0,6
11162,2,2516,2625,-109,0,45,0,6
11163,1,2438,2468,-30,0,386,0,6
11164,2,2435,2418,17,0,210,1,6
11165,2,2430,2330,100,0,9,1,6
11166,2,2349,2497,-148,0,308,1,6
11167,2,2275,2572,-297,0,130,0,6
11168,2,2274,2450,-176,0,202,0,6
11169,3,2328,2686,-358,0,300,0,6
11170,1,2490,2566,-76,0,300,0,6
11171,2,2412,2327,85,0,331,1,6
11172,2,2474,2507,-33,0,46,0,6
11173,1,2590,2565,25,0,100,0,6
11174,2,2553,2412,141,0,102,0,6
11175,1,2411,2386,25,0,190,0,6
11176,1,2426,2396,30,0,40,0,6
11177,2,2453,2316,137,0,55,0,6
11178,2,2272,2428,-156,0,123,0,6
11179,2,2412,2446,-34,0,453,0,6
11180,1,2490,2394,96,0,4,1,6
11181,1,2498,2519,-21,0,121,0,6
11182,2,2556,2514,42,0,145,0,6
11183,2,2233,2474,-241,0,101,0,6
11184,2,2459,2444,15,0,102,0,6
11185,1,2435,2392,43,0,125,0,6
11186,2,2333,2453,-120,0,203,0,6
11187,1,2595,2339,256,0,7,0,6
11188,2,2230,2428,-198,0,236,0,6
11189,2,2240,2422,-182,0,100,0,6
11190,2,2551,2428,123,0,140,0,6
11191,2,2559,2357,202,0,49,0,6
11192,1,2448,2497,-49,0,1,0,6
11193,3,2421,2353,68,0,15,0,6
11194,2,2411,2310,101,0,15,1,6
11195,2,2421,2324,97,0,306,1,6
11196,2,2353,2497,-144,0,200,0,6
11197,2,2206,2545,-339,0,45,0,6
11198,2,2500,2420,80,0,102,0,6
11199,2,2410,2462,-52,0,48,0,6
11200,2,2441,2341,100,0,105,0,6
11201,1,2432,2337,95,0,30,1,6
11202,2,2512,2505,7,0,54,1,6
11203,3,2430,2424,6,0,337,0,6
11204,2,2228,2429,-201,0,101,0,6
11205,1,2402,2326,76,0,205,1,6
11206,2,2366,2431,-65,0,118,0,6
11207,3,2629,2648,-19,0,7,0,6
11208,1,2450,2453,-3,0,40,1,6
11209,1,2502,2574,-72,0,0,0,6
11210,2,2334,2423,-89,0,4,0,6
11211,1,2334,2445,-111,0,248,1,6
11212,2,2388,2484,-96,0,5,0,6
11213,1,2421,2286,135,0,40,0,6
11214,3,2560,2597,-37,0,1,0,6
11215,1,2512,2489,23,0,301,0,6
11216,1,2597,2493,104,0,121,1,6
11217,1,2427,2561,-134,0,4,0,6
11218,1,2421,2431,-10,0,101,0,6
11219,1,2410,2295,115,0,455,0,6
11220,2,2469,2407,62,0,343,0,6
11221,2,2441,2544,-103,0,186,0,6
11222,1,2554,2389,165,0,85,1,6
11223,1,2501,2350,151,0,15,0,6
11224,3,2324,2446,-122,0,45,0,6
11225,2,2316,2491,-175,0,307,0,6
11226,2,2454,2301,153,0,1,1,6
11227,2,2380,2511,-131,0,152,0,6
11228,1,2344,2567,-223,0,6,0,6
11229,2,2425,2547,-122,0,1,0,6
11230,2,2520,2550,-30,0,255,0,6
11231,2,2419,2405,14,0,484,1,6
11232,2,2547,2509,38,0,100,0,6
11233,1,2551,2204,347,0,49,0,6
11234,1,2457,2453,4,0,331,0,6
11235,2,2384,2425,-41,0,102,0,6
11236,2,2436,2483,-47,0,383,0,6
11237,2,2421,2430,-9,0,0,0,6
11238,2,2447,2462,-15,0,202,0,6
11239,3,2321,2406,-85,0,414,0,6
11240,2,2553,2367,186,0,0,0,6
11241,1,2518,2503,15,0,300,0,6
11242,1,2424,2260,164,0,250,1,6
11243,2,2413,2402,11,0,6,0,6
11244,1,2648,2629,19,0,45,0,6
11245,2,2413,2462,-49,0,330,0,6
11246,1,2504,2346,158,0,12,0,6
11247,2,2435,2601,-166,0,4,0,6
11248,1,2489,2330,159,0,107,0,6
11249,2,2478,2349,129,0,1,0,6
11250,2,2212,2434,-222,0,179,0,6
11251,3,2438,2437,1,0,1,0,6
11252,2,2548,2248,300,0,459,0,6
11253,1,2430,2389,41,0,243,0,6
11254,2,2324,2427,-103,0,103,0,6
11255,1,2558,2365,193,0,42,0,6
11256,1,2585,2414,171,0,15,0,6
11257,1,2462,2506,-44,0,130,0,6
11258,2,2447,2456,-9,0,102,0,6
11259,2,2377,2400,-23,0,111,1,6
11260,1,2437,2469,-32,0,405,0,6
11261,3,2419,2604,-185,0,312,0,6
11262,2,2446,2432,14,0,1,1,6
11263,1,2404,2241,163,0,6,0,6
11264,2,2515,2372,143,0,133,1,6
11265,2,2278,2429,-151,0,214,0,6
11266,3,2494,2515,-21,0,45,0,6
11267,1,2682,2355,327,0,300,0,6
11268,1,2416,2391,25,0,198,0,6
11269,1,2492,2523,-31,0,7,0,6
11270,2,2258,2416,-158,0,100,0,6
11271,1,2551,2282,269,0,11,0,6
11272,2,2386,2557,-171,0,3,0,6
11273,1,2442,2418,24,0,130,0,6
11274,3,2327,2494,-167,0,131,0,6
11275,1,2515,2282,233,0,46,1,6
11276,1,2511,2624,-113,0,247,0,6
11277,2,2409,2271,138,0,0,0,6
11278,3,2424,2436,-12,0,474,0,6
11279,2,2282,2411,-129,0,106,1,6
11280,1,2553,2493,60,0,304,1,6
11281,2,2239,2437,-198,0,153,1,6
11282,2,2354,2414,-60,0,122,1,6
11283,2,2343,2508,-165,0,215,0,6
11284,1,2488,2385,103,0,347,0,6
11285,1,2431,2431,0,0,338,0,6
11286,2,2500,2468,32,0,469,0,6
11287,1,2560,2383,177,0,85,0,6
11288,2,2224,2428,-204,0,221,0,6
11289,2,2353,2440,-87,0,310,0,6
11290,1,2438,2561,-123,0,4,0,6
11291,1,2350,2445,-95,0,290,1,6
11292,1,2566,2565,1,0,4,0,6
11293,2,2467,2408,59,0,303,0,6
11294,1,2363,2492,-129,0,134,0,6
11295,2,2538,2553,-15,0,327,0,6
11296,1,2463,2442,21,0,300,0,6
11297,1,2517,2498,19,0,228,1,6
11298,2,2217,2422,-205,0,4,0,6
11299,1,2601,2335,266,0,121,0,6
11300,2,2468,2443,25,0,421,1,6
11301,1,2448,2526,-78,0,187,1,6
11302,1,2369,2437,-68,4,221,1,13
11303,1,2471,2346,125,0,1,0,6
11304,1,2545,2356,189,0,125,0,6
11305,3,2497,2379,118,0,150,0,6
11306,1,2447,2319,128,0,140,0,6
11307,1,2421,2296,125,0,133,0,6
11308,3,2335,2510,-175,0,153,0,6
11309,2,2484,2554,-70,0,301,0,6
11310,1,2328,2507,-179,0,45,1,6
11311,2,2380,2564,-184,0,200,0,6
11312,3,2574,2606,-32,0,101,0,6
11313,3,2511,2572,-61,0,15,0,6
11314,2,2432,2290,142,0,200,0,6
11315,1,2222,2433,-211,0,221,0,6
11316,2,2475,2494,-19,0,84,1,6
11317,2,2424,2557,-133,0,101,1,6
11318,1,2488,2445,43,0,150,0,6
11319,1,2395,2437,-42,0,109,1,6
11320,1,2405,2407,-2,0,103,0,6
11321,1,2425,2415,10,0,77,0,6
11322,1,2430,2428,2,0,200,0,6
11323,1,2274,2418,-144,0,421,0,6
11324,1,2429,2349,80,0,302,0,6
11325,2,2203,2421,-218,0,310,0,6
11326,3,2447,2603,-156,0,314,0,6
11327,2,2316,2463,-147,0,302,0,6
11328,2,2437,2507,-70,0,192,0,6
11329,1,2492,2468,24,0,247,0,6
11330,1,2558,2601,-43,0,112,0,6
11331,2,2377,2449,-72,0,131,0,6
11332,2,2617,2504,113,0,9,0,6
11333,1,2412,2252,160,0,195,0,6
11334,2,2475,2493,-18,0,1,0,6
11335,2,2415,2438,-23,0,337,0,6
11336,1,2559,2239,320,0,10,1,6
11337,3,2425,2533,-108,0,123,0,6
11338,2,2221,2401,-180,0,123,0,6
11339,1,2512,2523,-11,0,46,1,6
11340,1,2433,2358,75,0,326,0,6
11341,1,2430,2460,-30,0,300,1,6
11342,2,2353,2565,-212,0,487,0,6
11343,2,2518,2548,-30,0,4,0,6
11344,2,2389,2424,-35,0,101,0,6
11345,2,2345,2520,-175,0,113,1,6
11346,1,2381,2495,-114,0,112,0,6
11347,3,2595,2553,42,0,260,0,6
11348,1,2440,2354,86,0,1,0,6
11349,2,2480,2493,-13,0,301,1,6
11350,2,2342,2462,-120,0,200,0,6
11351,1,2467,2338,129,0,113,0,6
11352,1,2567,2377,190,0,46,0,6
11353,2,2485,2360,125,0,426,0,6
11355,1,2440,2377,63,0,405,1,6
11356,1,2487,2483,4,0,106,0,6
11357,3,2406,2367,39,0,4,0,6
11358,2,2431,2435,-4,0,310,1,6
11359,1,2424,2319,105,0,130,0,6
11360,1,2486,2400,86,0,107,1,6
11361,2,2436,2425,11,0,20,0,6
11362,2,2273,2594,-321,0,135,0,6
11363,1,2429,2416,13,0,302,0,6
11364,1,2449,2519,-70,0,214,0,6
11365,2,2454,2421,33,0,153,0,6
11366,3,2567,2561,6,0,101,0,6
11367,1,2431,2361,70,0,9,0,6
11368,3,2298,2428,-130,0,125,0,6
11369,1,2499,2365,134,0,190,0,6
11370,2,2436,2560,-124,0,112,0,6
11371,1,2466,2594,-128,0,15,0,6
11372,2,2499,2469,30,0,20,0,6
11373,2,2561,2447,114,0,304,0,6
11374,2,2313,2427,-114,0,405,0,6
11375,2,2498,2470,28,0,302,1,6
11376,2,2224,2435,-211,0,221,1,6
11377,1,2567,2444,123,0,190,0,6
11378,2,2374,2570,-196,0,200,1,6
11379,3,2512,2432,80,0,318,0,6
11380,1,2444,2410,34,0,13,0,6
11381,3,2609,2455,154,0,460,0,6
11382,2,2514,2499,15,0,7,0,6
11383,2,2245,2426,-181,0,341,1,6
11384,3,2355,2531,-176,0,4,0,6
11385,2,2364,2555,-191,0,100,0,6
11386,1,2353,2438,-85,0,241,0,6
11387,3,2595,2455,140,0,265,0,6
11388,2,2222,2554,-332,0,4,0,6
11389,2,2435,2477,-42,0,487,1,6
11390,1,2528,2423,105,0,13,1,6
11391,2,2374,2593,-219,0,42,0,6
11392,2,2368,2467,-99,0,380,0,6
11393,2,2454,2523,-69,0,41,0,6
11394,1,2308,2559,-251,0,45,1,6
11395,1,2466,2398,68,0,353,0,6
11396,2,2369,2491,-122,0,104,1,6
11397,1,2518,2498,20,0,385,0,6
11398,2,2588,2407,181,0,8,0,6
11399,3,2337,2476,-139,0,131,0,6
11400,2,2254,2401,-147,0,123,1,6
11401,1,2586,2474,112,0,454,0,6
11402,1,2517,2457,60,0,46,1,6
11403,2,2253,2404,-151,0,43,0,6
11404,1,2431,2555,-124,0,325,0,6
11405,2,2277,2444,-167,0,43,0,6
11406,2,2347,2438,-91,2,147,0,18
11407,2,2398,2411,-13,0,38,0,6
11408,2,2292,2683,-391,0,416,0,6
11409,1,2429,2432,-3,0,247,1,6
11410,1,2564,2230,334,0,15,0,6
11411,3,2458,2571,-113,0,4,0,6
11412,2,2381,2476,-95,0,265,0,6
11413,2,2405,2446,-41,0,40,1,6
11414,2,2441,2379,62,0,152,0,6
11415,2,2313,2478,-165,0,106,0,6
11416,2,2476,2492,-16,0,1,0,6
11417,1,2506,2310,196,0,302,0,6
11418,2,2505,2242,263,0,101,0,6
11419,1,2508,2346,162,0,305,0,6
11420,1,2493,2470,23,0,96,1,6
11421,2,2397,2495,-98,0,102,0,6
11422,3,2433,2511,-78,0,403,0,6
11423,1,2400,2271,129,0,45,0,6
11424,3,2569,2558,11,0,260,0,6
11425,1,2430,2405,25,0,20,0,6
11426,1,2572,2371,201,0,324,0,6
11427,1,2377,2483,-106,0,131,0,6
11428,2,2425,2430,-5,0,50,0,6
11429,1,2488,2388,100,0,150,0,6
11430,2,2596,2511,85,0,100,0,6
11431,3,2342,2461,-119,0,335,0,6
11432,2,2599,2607,-8,0,245,1,6
11433,3,2558,2473,85,0,0,0,6
11434,2,2569,2495,74,0,154,0,6
11435,1,2471,2291,180,0,46,0,6
11436,1,2322,2432,-110,0,106,1,6
11437,1,2528,2450,78,0,118,0,6
11438,1,2475,2470,5,0,487,1,6
11439,2,2492,2458,34,0,485,1,6
11440,2,2513,2590,-77,0,337,0,6
11441,2,2307,2459,-152,0,1,0,6
11442,1,2432,2211,221,0,44,0,6
11443,2,2497,2470,27,0,302,0,6
11444,2,2265,2448,-183,0,48,0,6
11445,1,2419,2228,191,0,1,1,6
11446,1,2502,2247,255,0,101,0,6
11447,1,2549,2562,-13,0,46,1,6
11448,1,2509,2435,74,0,313,0,6
11449,2,2451,2464,-13,0,5,0,6
11450,1,2462,2518,-56,0,4,1,6
11451,2,2304,2589,-285,0,127,0,6
11452,2,2329,2401,-72,0,315,0,6
11453,2,2365,2509,-144,0,100,0,6
11454,2,2465,2498,-33,0,57,1,6
11455,2,2348,2556,-208,0,335,1,6
11456,2,2369,2575,-206,0,202,0,6
11457,2,2451,2391,60,0,335,0,6
11458,2,2452,2523,-71,0,301,1,6
11459,1,2267,2404,-137,0,41,0,6
11460,2,2595,2441,154,0,62,0,6
11461,1,2436,2400,36,0,15,0,6
11462,1,2377,2475,-98,0,134,0,6
11463,2,2442,2419,23,0,45,0,6
11464,1,2482,2282,200,0,1,0,6
11465,2,2269,2505,-236,0,154,1,6
11466,1,2481,2435,46,0,484,0,6
11467,3,2469,2555,-86,0,6,0,6
11468,1,2440,2201,239,0,154,0,6
11469,1,2512,2556,-44,0,46,1,6
11470,1,2417,2393,24,0,245,1,6
11471,2,2612,2831,-219,0,4,0,6
11472,1,2445,2533,-88,0,41,1,6
11473,2,2430,2514,-84,0,15,0,6
11474,1,2477,2491,-14,0,1,0,6
11475,2,2486,2464,22,0,101,0,6
11476,3,2591,2470,121,0,267,0,6
11477,2,2400,2406,-6,0,120,0,8
11478,2,2350,2441,-91,0,123,0,6
11479,2,2395,2426,-31,0,354,0,6
11480,1,2405,2478,-73,0,13,0,6
11481,1,2345,2559,-214,0,40,0,6
11482,1,2684,2579,105,0,40,1,6
11483,2,2296,2486,-190,0,131,0,6
11484,3,2384,2492,-108,0,106,0,6
11485,2,2249,2554,-305,0,40,0,6
11486,1,2571,2388,183,0,8,0,6
11487,2,2309,2442,-133,0,4,0,6
11488,1,2392,2431,-39,0,129,0,6
11489,2,2436,2340,96,0,415,0,6
11490,1,2504,2460,44,0,352,1,6
11491,1,2406,2458,-52,0,13,0,6
11492,1,2550,2589,-39,0,123,0,6
11493,2,2472,2518,-46,0,4,0,6
11494,2,2383,2444,-61,0,106,1,6
11495,2,2485,2483,2,0,4,0,6
11496,2,2449,2280,169,0,143,0,6
11497,2,2555,2587,-32,0,267,0,6
11498,1,2225,2402,-177,0,302,0,6
11499,1,2317,2418,-101,0,36,1,6
11500,3,2426,2436,-10,0,380,0,6
11501,1,2470,2484,-14,0,0,0,6
11502,2,2301,2444,-143,0,405,0,6
11503,1,2528,2489,39,0,49,1,6
11504,1,2445,2293,152,0,4,0,6
11505,2,2583,2467,116,0,221,0,6
11506,1,2556,2556,0,0,43,0,6
11507,3,2324,2551,-227,0,45,0,6
11508,1,2518,2426,92,0,302,0,6
11509,2,2523,2551,-28,0,40,0,6
11510,2,2356,2446,-90,0,153,1,6
11511,1,2462,2345,117,0,41,1,6
11512,2,2452,2480,-28,0,48,0,6
11513,2,2432,2389,43,0,13,1,6
11514,1,2451,2257,194,0,291,0,6
11515,1,2301,2476,-175,0,453,0,6
11516,1,2302,2502,-200,0,112,0,6
11517,3,2375,2478,-103,0,200,0,6
11518,3,2486,2328,158,0,1,0,6
11519,1,2515,2610,-95,0,100,0,6
11520,2,2269,2400,-131,0,315,0,6
11521,1,2489,2480,9,0,1,0,6
11522,1,2575,2508,67,0,121,0,6
11523,3,2475,2562,-87,0,6,0,6
11524,2,2464,2592,-128,0,265,0,6
11525,2,2455,2509,-54,0,57,1,6
11526,3,2557,2295,262,0,0,0,6
11527,2,2207,2518,-311,0,40,0,6
11528,2,2449,2412,37,0,310,1,6
11529,2,2289,2441,-152,0,0,0,6
11530,2,2436,2426,10,0,442,1,6
11531,2,2342,2449,-107,0,104,0,6
11532,2,2411,2286,125,0,122,0,6
11533,2,2299,2412,-113,0,147,0,6
11534,2,2297,2412,-115,0,4,0,6
11535,1,2444,2328,116,0,241,0,6
11536,2,2495,2550,-55,0,490,0,6
11537,1,2422,2523,-101,0,192,1,6
11538,1,2447,2333,114,0,41,0,6
11539,1,2689,2298,391,0,300,0,6
11540,2,2265,2422,-157,0,330,0,6
11541,1,2484,2447,37,0,53,0,6
11542,1,2605,2533,72,0,153,0,6
11543,3,2498,2548,-50,0,130,0,6
11544,2,2342,2466,-124,0,102,0,6
11545,1,2477,2385,92,0,466,0,6
11546,2,2324,2448,-124,0,151,1,6
11547,2,2655,2603,52,0,45,0,6
11548,1,2403,2396,7,0,112,0,6
11549,1,2474,2494,-20,0,4,0,6
11550,1,2529,2610,-81,0,96,1,6
11551,2,2450,2468,-18,0,463,0,6
11552,1,2513,2522,-9,0,360,0,6
11553,2,2329,2443,-114,0,40,0,6
11554,2,2486,2374,112,0,440,0,6
11555,2,2596,2460,136,0,461,0,6
11556,1,2312,2495,-183,0,104,0,6
11557,2,2265,2433,-168,0,0,0,6
11558,2,2432,2430,2,0,382,0,6
11559,1,2390,2409,-19,0,315,1,6
11560,2,2575,2416,159,0,4,1,6
11561,2,2434,2453,-19,0,102,0,6
11562,3,2403,2338,65,0,122,0,6
11563,1,2232,2420,-188,0,337,1,6
11564,2,2294,2400,-106,0,297,0,6
11565,3,2416,2489,-73,0,115,0,6
11566,2,2418,2442,-24,0,250,0,6
11567,1,2516,2429,87,0,406,0,6
11569,3,2445,2376,69,0,44,0,6
11570,1,2473,2333,140,0,17,1,6
11571,1,2609,2647,-38,0,455,0,6
11572,1,2470,2338,132,0,53,0,6
11573,1,2487,2363,124,0,140,0,6
11574,1,2555,2490,65,0,140,0,6
11575,1,2488,2480,8,0,0,1,6
11576,2,2404,2478,-74,0,142,0,6
11577,2,2425,2520,-95,0,110,1,6
11578,2,2305,2485,-180,0,100,0,6
11579,2,2588,2517,71,0,398,0,6
11580,1,2436,2257,179,0,461,0,6
11581,3,2455,2549,-94,0,190,0,6
11582,1,2426,2425,1,0,41,0,6
11583,2,2458,2367,91,0,4,1,6
11584,1,2639,2616,23,0,45,1,6
11585,2,2364,2429,-65,0,50,0,6
11586,1,2488,2382,106,0,335,0,6
11587,2,2339,2402,-63,0,113,1,6
11588,2,2295,2500,-205,0,412,0,6
11589,1,2447,2412,35,0,346,0,6
11590,2,2378,2492,-114,0,115,0,6
11591,1,2397,2444,-47,0,46,0,6
11592,1,2519,2605,-86,0,207,0,6
11593,2,2334,2439,-105,0,111,1,6
11594,1,2475,2494,-19,0,4,0,6
11595,2,2278,2400,-122,0,106,1,6
11597,1,2489,2328,161,0,1,0,6
11598,2,2581,2559,22,0,455,0,6
11599,1,2391,2432,-41,0,196,0,6
11600,2,2321,2483,-162,0,49,0,6
11601,1,2414,2352,62,0,400,0,6
11602,1,2524,2420,104,0,202,0,6
11603,1,2424,2264,160,0,6,1,6
11604,3,2407,2453,-46,0,112,0,6
11605,1,2451,2481,-30,0,8,1,6
11606,1,2491,2361,130,0,140,1,6
11607,1,2425,2398,27,0,414,1,6
11608,1,2488,2481,7,0,310,1,6
11609,1,2524,2603,-79,0,212,0,6
11610,2,2407,2334,73,0,241,1,6
11611,2,2450,2598,-148,0,45,1,6
11612,1,2416,2528,-112,0,465,0,6
11613,1,2288,2403,-115,0,133,1,6
11614,1,2437,2403,34,0,300,0,6
11615,2,2496,2374,122,0,383,0,6
11616,2,2473,2526,-53,0,404,0,6
11617,1,2305,2537,-232,0,141,0,6
11618,1,2404,2278,126,0,106,0,6
11619,1,2265,2443,-178,0,140,0,6
11620,1,2325,2458,-133,0,45,0,6
11621,1,2492,2294,198,0,1,0,6
11622,1,2452,2408,44,0,352,0,6
11623,2,2566,2531,35,0,140,0,6
11624,1,2576,2596,-20,0,101,1,6
11625,2,2475,2305,170,0,331,1,6
11626,1,2521,2424,97,0,453,0,6
11627,1,2375,2458,-83,0,140,1,6
11628,1,2475,2494,-19,0,8,1,6
11629,1,2431,2574,-143,0,484,0,6
11630,1,2341,2400,-59,0,129,0,6
11631,2,2420,2525,-105,0,12,0,6
11632,2,2407,2261,146,0,317,0,6
11633,2,2450,2266,184,0,278,0,6
11634,1,2403,2469,-66,0,103,0,6
11635,1,2601,2457,144,0,428,1,6
11636,3,2347,2419,-72,0,485,0,6
11637,1,2435,2442,-7,0,310,1,6
11638,1,2559,2488,71,0,110,0,6
11639,1,2398,2408,-10,0,332,0,6
11640,1,2537,2582,-45,0,44,0,6
11641,1,2403,2313,90,0,38,0,6
11642,2,2611,2717,-106,0,16,0,6
11643,1,2451,2353,98,0,4,0,6
11644,1,2529,2416,113,0,302,0,6
11645,3,2488,2481,7,0,6,0,6
11646,2,2417,2259,158,0,132,0,6
11647,1,2460,2321,139,0,320,0,6
11648,1,2353,2496,-143,0,48,0,6
11649,1,2267,2408,-141,0,142,0,6
11650,1,2292,2400,-108,0,150,1,6
11651,1,2484,2313,171,0,40,0,6
11652,2,2437,2439,-2,0,418,0,6
11653,2,2462,2564,-102,0,453,0,6
11654,2,2410,2416,-6,0,202,1,6
11655,1,2488,2336,152,0,102,0,6
11656,2,2605,2592,13,0,398,0,6
11657,3,2507,2246,261,2,380,0,18
11658,2,2407,2383,24,0,460,0,6
11659,2,2454,2607,-153,0,46,0,6
11660,2,2402,2404,-2,0,1,0,6
11661,1,2412,2383,29,0,118,0,6
11662,1,2481,2487,-6,0,4,0,6
11663,2,2388,2487,-99,0,115,0,6
11664,1,2404,2292,112,0,45,1,6
11665,2,2403,2338,65,0,241,0,6
11666,3,2406,2354,52,0,125,0,8
11667,2,2535,2544,-9,0,13,1,6
11668,2,2413,2432,-19,0,251,0,6
11669,1,2364,2458,-94,0,102,1,6
11670,2,2491,2502,-11,0,156,0,6
11671,2,2491,2468,23,0,485,0,6
11672,2,2445,2431,14,0,96,0,6
11673,1,2690,2299,391,0,301,0,6
11674,2,2599,2599,0,0,200,0,6
11675,3,2401,2417,-16,0,315,0,6
11676,1,2536,2446,90,0,100,1,6
11677,2,2482,2487,-5,0,1,0,6
11678,1,2418,2450,-32,0,4,1,6
11679,1,2721,2605,116,0,14,1,6
11680,2,2378,2485,-107,0,45,0,6
11681,1,2345,2415,-70,0,16,0,6
11682,1,2343,2422,-79,0,58,0,6
11683,2,2549,2566,-17,0,45,1,6
11684,2,2358,2493,-135,0,48,0,6
11685,1,2610,2404,206,0,343,0,6
11686,2,2451,2459,-8,0,46,0,6
11687,1,2401,2340,61,0,241,1,6
11688,1,2437,2371,66,0,60,0,6
11689,2,2493,2476,17,0,4,1,6
11690,1,2489,2439,50,0,426,0,6
11691,2,2408,2374,34,0,6,0,6
11692,1,2497,2324,173,0,128,0,6
11693,1,2474,2476,-2,0,207,1,6
11694,2,2470,2370,100,0,36,0,6
11695,2,2403,2373,30,0,215,1,6
11696,2,2415,2352,63,4,152,0,13
11697,1,2451,2417,34,0,13,0,6
11698,1,2237,2401,-164,0,153,1,6
11699,2,2508,2445,63,0,43,0,6
11700,3,2442,2594,-152,0,301,0,6
11701,1,2465,2422,43,0,118,0,6
11702,2,2601,2725,-124,0,302,0,6
11703,2,2407,2354,53,0,20,1,6
11704,1,2409,2359,50,0,394,0,6
11705,2,2402,2613,-211,0,143,0,6
11706,2,2486,2444,42,0,40,0,6
11707,1,2463,2540,-77,0,45,0,6
11708,2,2434,2494,-60,0,487,0,6
11709,1,2427,2402,25,0,202,0,6
11710,3,2452,2487,-35,0,310,0,6
11711,2,2576,2544,32,0,359,0,6
11712,2,2470,2482,-12,0,40,1,6
11713,3,2355,2405,-50,0,58,0,8
11714,1,2367,2404,-37,0,140,0,6
11715,2,2412,2470,-58,0,482,0,6
11716,1,2499,2429,70,0,426,0,6
11717,2,2462,2480,-18,0,113,0,6
11718,3,2327,2501,-174,0,282,0,6
11719,2,2425,2399,26,0,460,1,6
11720,2,2616,2533,83,0,4,0,6
11721,1,2299,2431,-132,0,107,1,6
11722,1,2403,2373,30,0,56,0,6
11723,2,2591,2834,-243,0,474,1,6
11724,2,2324,2480,-156,0,22,0,6
11725,2,2451,2400,51,0,43,0,6
11726,2,2550,2570,-20,0,106,0,6
11727,2,2452,2409,43,0,40,0,6
11728,2,2729,2675,54,0,110,1,6
11729,3,2487,2580,-93,0,46,0,6
11730,1,2507,2444,63,0,0,0,6
11731,1,2425,2500,-75,0,310,0,6
11732,1,2459,2449,10,0,0,0,5
11733,3,2475,2407,68,0,268,0,6
11734,2,2488,2411,77,0,1,0,6
11735,1,2409,2288,121,0,408,0,6
11736,1,2510,2609,-99,0,45,0,6
11737,2,2405,2419,-14,0,177,0,6
11738,3,2262,2400,-138,0,106,0,6
11739,2,2454,2310,144,0,57,0,6
11740,2,2589,2446,143,0,57,0,6
11741,2,2361,2407,-46,0,46,0,6
11742,2,2329,2448,-119,0,120,0,8
11743,1,2571,2444,127,0,4,0,6
11745,1,2488,2576,-88,0,4,0,6
11746,1,2516,2424,92,0,107,0,6
11747,1,2400,2432,-32,0,196,0,6
11748,3,2404,2356,48,0,125,0,8
11749,2,2545,2836,-291,0,45,0,6
11750,1,2440,2512,-72,0,40,0,6
11751,1,2408,2474,-66,0,110,1,6
11752,2,2682,2722,-40,0,404,1,6
11753,2,2384,2518,-134,0,403,0,6
11754,1,2601,2456,145,0,405,1,6
11755,2,2328,2467,-139,0,216,0,6
11756,2,2418,2481,-63,0,101,1,6
11757,1,2302,2413,-111,0,334,0,6
11758,2,2435,2392,43,0,145,0,6
11759,1,2410,2377,33,0,454,0,6
11760,2,2436,2581,-145,0,156,0,6
11761,1,2440,2454,-14,0,302,0,6
11762,2,2425,2575,-150,0,484,0,6
11763,2,2400,2370,30,0,15,0,6
11764,1,2522,2455,67,0,46,1,6
11765,2,2420,2520,-100,0,455,0,6
11766,1,2568,2543,25,0,0,0,6
11767,1,2605,2495,110,0,5,0,6
11768,2,2597,2579,18,0,413,0,6
11769,1,2445,2339,106,0,345,1,6
11770,3,2448,2324,124,0,118,0,6
11771,1,2540,2447,93,0,43,0,6
11772,1,2412,2446,-34,0,10,1,6
11773,2,2361,2415,-54,0,0,1,6
11774,1,2467,2415,52,0,268,1,6
11775,3,2505,2486,19,0,0,0,6
11776,2,2284,2453,-169,0,123,0,6
11777,1,2422,2369,53,0,310,0,6
11778,2,2315,2465,-150,0,110,0,5
11779,1,2585,2526,59,0,331,0,6
11780,2,2450,2428,22,0,15,1,6
11781,2,2491,2656,-165,0,4,0,6
11782,2,2525,2416,109,0,315,0,6
11783,1,2326,2446,-120,0,345,0,6
11784,2,2442,2609,-167,0,44,1,6
11785,2,2446,2427,19,0,338,1,6
11786,2,2585,2574,11,0,40,0,6
11787,2,2605,2544,61,0,7,0,6
11788,2,2551,2457,94,0,302,0,6
11789,3,2418,2390,28,0,10,0,6
11790,2,2410,2472,-62,0,10,0,6
11791,1,2357,2404,-47,0,58,0,8
11792,1,2677,2486,191,0,45,0,6
11793,1,2660,2630,30,0,131,0,6
11794,1,2424,2322,102,0,150,0,6
11795,2,2364,2517,-153,0,487,0,6
11796,2,2440,2522,-82,0,46,1,6
11797,2,2458,2589,-131,0,168,0,6
11798,2,2397,2420,-23,0,45,1,6
11799,2,2442,2659,-217,0,114,0,6
11800,1,2486,2488,-2,0,265,1,6
11801,2,2593,2439,154,0,57,1,6
11802,1,2454,2355,99,0,178,0,6
11803,2,2623,2612,11,0,107,0,6
11804,2,2273,2468,-195,0,4,1,5
11805,1,2439,2544,-105,0,301,0,6
11806,2,2452,2279,173,0,241,0,8
11807,2,2433,2440,-7,0,414,0,6
11808,2,2580,2579,1,0,405,0,6
11809,1,2401,2242,159,0,190,0,6
11810,1,2419,2309,110,0,10,1,6
11811,1,2477,2406,71,0,101,0,6
11812,2,2598,2680,-82,0,113,0,6
11813,1,2470,2483,-13,0,40,0,6
11814,2,2624,2665,-41,0,45,0,6
11815,1,2428,2395,33,0,150,0,6
11816,1,2351,2418,-67,0,409,0,6
11817,1,2585,2574,11,0,40,1,6
11818,2,2405,2272,133,0,106,1,6
11819,1,2369,2400,-31,0,315,1,6
11820,1,2456,2287,169,0,466,0,6
11821,1,2526,2438,88,0,300,0,6
11822,1,2662,2593,69,0,45,1,6
11823,1,2684,2436,248,0,53,0,6
11824,1,2459,2425,34,0,1,1,6
11825,1,2446,2427,19,0,338,0,6
11826,1,2476,2482,-6,0,310,0,6
11827,1,2479,2357,122,0,338,0,6
11828,2,2617,2491,126,0,118,0,6
11829,2,2315,2447,-132,0,105,0,6
11830,3,2475,2585,-110,0,405,0,6
11831,2,2364,2481,-117,0,365,0,6
11832,2,2319,2433,-114,0,171,0,6
11833,2,2838,2662,176,0,331,0,6
11834,1,2471,2271,200,0,106,0,5
11835,1,2420,2387,33,0,247,0,6
11836,2,2670,2618,52,0,131,0,6
11837,1,2300,2425,-125,0,122,0,6
11838,1,2323,2411,-88,0,101,0,6
11839,2,2447,2535,-88,0,40,0,6
11840,1,2422,2452,-30,0,414,1,6
11841,2,2434,2266,168,0,102,0,6
11842,1,2359,2425,-66,0,255,0,6
11843,3,2569,2590,-21,0,46,0,6
11844,2,2686,2530,156,0,46,1,6
11845,2,2589,2667,-78,0,112,1,6
11846,1,2433,2420,13,0,178,1,6
11847,2,2437,2388,49,0,110,0,6
11848,1,2579,2477,102,0,373,0,6
11849,2,2375,2464,-89,0,45,0,6
11850,1,2451,2311,140,0,97,0,6
11851,2,2670,2830,-160,0,190,0,6
11852,3,2433,2446,-13,0,43,0,6
11853,2,2626,2664,-38,0,1,1,6
11854,1,2583,2443,140,0,4,0,6
11855,2,2477,2499,-22,0,460,0,6
11856,1,2583,2612,-29,0,404,0,6
11857,2,2215,2407,-192,0,395,0,6
11858,1,2483,2400,83,0,247,0,6
11859,2,2485,2360,125,0,288,0,6
11860,1,2417,2308,109,0,302,0,6
11861,1,2362,2469,-107,0,409,0,6
11862,3,2426,2371,55,0,0,0,6
11863,1,2410,2315,95,0,48,0,6
11864,3,2370,2428,-58,0,18,0,6
11865,2,2284,2431,-147,0,300,0,6
11866,2,2399,2434,-35,0,338,0,6
11868,2,2410,2489,-79,0,15,0,6
11869,2,2230,2401,-171,0,122,0,6
11870,1,2669,2620,49,0,114,1,6
11871,2,2482,2439,43,0,269,1,6
11872,1,2667,2584,83,0,253,0,6
11873,1,2498,2253,245,2,400,0,18
11874,1,2308,2454,-146,0,104,0,6
11875,2,2446,2395,51,0,319,0,6
11876,1,2414,2434,-20,0,112,0,6
11877,2,2471,2610,-139,0,337,0,6
11878,2,2425,2361,64,0,0,0,6
11879,1,2672,2439,233,0,46,0,6
11880,1,2439,2394,45,0,130,0,6
11881,2,2446,2468,-22,0,43,0,6
11882,2,2404,2405,-1,0,253,1,6
11883,3,2613,2466,147,0,130,0,6
11884,1,2439,2261,178,0,302,0,6
11885,1,2356,2401,-45,0,110,0,6
11886,1,2427,2371,56,0,419,0,6
11887,1,2434,2280,154,0,140,0,6
11888,1,2420,2362,58,0,41,1,6
11889,2,2428,2580,-152,0,302,1,6
11890,1,2437,2675,-238,0,301,0,6
11891,3,2378,2420,-42,0,106,0,6
11892,2,2473,2441,32,0,45,0,6
11893,1,2418,2416,2,0,13,0,6
11894,1,2366,2432,-66,0,18,0,6
11895,3,2376,2482,-106,0,337,0,6
11897,1,2389,2442,-53,0,43,0,6
11898,1,2444,2321,123,0,102,0,6
11899,2,2601,2678,-77,0,41,1,6
11900,2,2469,2611,-142,0,400,0,6
11901,1,2411,2399,12,0,20,0,6
11902,1,2419,2291,128,0,7,0,6
11903,1,2426,2373,53,0,484,1,6
11904,1,2395,2475,-80,0,4,0,6
11905,2,2318,2448,-130,0,123,0,6
11906,1,2665,2446,219,0,45,0,6
11907,1,2593,2267,326,0,240,0,6
11908,2,2425,2363,62,0,46,1,6
11909,3,2447,2467,-20,0,43,0,6
11910,2,2493,2468,25,0,212,1,6
11911,1,2584,2538,46,0,140,0,6
11912,2,2356,2487,-131,0,15,0,6
11913,1,2401,2416,-15,0,278,0,6
11914,1,2435,2284,151,0,133,0,6
11915,1,2287,2423,-136,0,40,0,6
11916,1,2485,2436,49,0,43,0,6
11917,2,2424,2395,29,0,46,1,6
11918,1,2465,2597,-132,0,122,0,6
11919,2,2443,2668,-225,0,45,0,6
11920,2,2395,2412,-17,0,140,0,6
11921,1,2451,2314,137,0,21,0,6
11922,1,2418,2369,49,0,106,1,6
11923,1,2424,2438,-14,0,9,1,6
11924,2,2368,2431,-63,0,18,0,6
11925,1,2467,2448,19,0,108,0,6
11926,1,2411,2497,-86,0,20,1,6
11927,2,2377,2418,-41,0,106,0,6
11928,1,2683,2727,-44,0,52,0,6
11929,1,2436,2431,5,0,43,0,6
11930,1,2474,2491,-17,0,153,0,6
11931,3,2533,2572,-39,0,110,0,6
11932,1,2435,2364,71,0,333,0,6
11933,1,2404,2403,1,0,14,0,6
11934,3,2671,2441,230,0,46,0,6
11935,2,2425,2270,155,0,385,0,6
11936,1,2455,2377,78,0,150,0,6
11937,2,2423,2266,157,0,373,1,6
11938,2,2364,2423,-59,0,302,1,6
11940,2,2442,2472,-30,0,380,0,6
11941,2,2589,2418,171,0,204,0,6
11942,2,2292,2595,-303,0,107,0,6
11943,2,2461,2409,52,4,34,1,11
11944,2,2478,2440,38,0,151,0,6
11945,1,2721,2689,32,0,110,1,6
11946,1,2418,2402,16,0,20,1,6
11947,2,2485,2318,167,0,96,0,6
11948,1,2481,2358,123,0,143,0,6
11949,1,2571,2533,38,0,7,0,6
11950,2,2384,2555,-171,0,308,0,6
11951,2,2206,2413,-207,0,118,0,6
11952,1,2390,2404,-14,0,152,0,6
11953,2,2577,2390,187,0,4,0,6
11954,2,2301,2481,-180,0,216,0,6
11955,2,2417,2511,-94,0,406,0,6
11956,3,2372,2460,-88,0,414,0,6
11957,2,2444,2667,-223,0,45,1,6
11958,1,2446,2471,-25,0,380,0,6
11959,1,2398,2415,-17,0,470,0,6
11960,2,2354,2484,-130,0,30,0,6
11961,2,2427,2359,68,0,147,1,6
11962,2,2473,2558,-85,0,101,0,6
11963,3,2539,2365,174,0,300,0,6
11964,1,2380,2402,-22,0,315,0,6
11965,3,2587,2411,176,0,206,0,6
11966,2,2472,2581,-109,0,242,0,6
11967,2,2568,2427,141,0,4,0,6
11968,1,2597,2290,307,0,0,0,6
11969,2,2400,2304,96,0,5,0,6
11970,2,2390,2409,-19,0,151,0,6
11971,2,2684,2726,-42,0,51,1,6
11972,2,2326,2413,-87,0,101,0,6
11973,1,2515,2423,92,0,4,0,6
11974,2,2465,2453,12,0,112,0,6
11975,2,2415,2419,-4,0,337,0,6
11976,1,2434,2367,67,0,1,0,6
11977,2,2304,2409,-105,0,135,1,6
11978,1,2404,2358,46,0,466,1,6
11979,1,2670,2442,228,0,45,0,6
11980,2,2402,2563,-161,0,101,0,6
11981,2,2419,2426,-7,0,190,1,6
11982,1,2488,2400,88,0,147,0,6
11983,2,2432,2658,-226,0,404,0,6
11984,2,2310,2467,-157,0,302,1,6
11985,2,2560,2469,91,0,4,0,6
11986,1,2442,2379,63,0,338,0,6
11987,1,2585,2417,168,0,43,0,6
11988,2,2322,2598,-276,0,107,0,6
11989,1,2425,2435,-10,0,30,1,6
11990,2,2404,2331,73,0,278,0,6
11991,1,2566,2672,-106,0,45,0,6
11992,2,2413,2439,-26,0,302,0,6
11993,2,2301,2418,-117,0,375,1,6
11994,1,2441,2291,150,0,40,0,6
11995,2,2397,2492,-95,0,4,0,6
11996,1,2432,2520,-88,0,140,0,6
11997,2,2416,2454,-38,4,123,0,11
11998,1,2411,2372,39,0,241,0,6
11999,1,2584,2435,149,0,225,0,6
12000,3,2588,2446,142,0,305,0,6
12001,1,2414,2237,177,0,391,0,6
12002,1,2458,2459,-1,0,140,1,6
12003,2,2374,2459,-85,0,147,0,6
12005,2,2431,2369,62,0,13,0,6
12006,1,2600,2320,280,0,205,0,6
12007,2,2431,2586,-155,0,15,0,6
12008,3,2429,2391,38,0,46,0,6
12009,2,2385,2429,-44,0,250,0,6
12010,2,2448,2445,3,0,226,0,6
12011,1,2665,2476,189,0,40,1,6
12012,2,2330,2400,-70,0,121,0,6
12013,1,2573,2408,165,0,40,1,6
12014,2,2586,2444,142,0,114,0,6
12015,3,2464,2326,138,0,108,0,6
12016,2,2497,2417,80,0,242,1,6
12017,1,2417,2452,-35,0,340,0,6
12018,1,2403,2283,120,0,193,1,8
12019,2,2416,2454,-38,0,1,0,6
12020,2,2383,2425,-42,0,459,0,6
12021,2,2404,2386,18,0,320,0,6
12022,1,2427,2401,26,0,10,0,6
12023,1,2462,2428,34,0,112,0,6
12024,1,2444,2318,126,0,96,0,6
12025,2,2473,2668,-195,0,112,0,6
12026,2,2588,2660,-72,0,226,0,6
12027,1,2731,2615,116,0,267,1,6
12028,1,2450,2442,8,0,302,0,6
12029,2,2405,2464,-59,0,373,1,6
12030,1,2504,2412,92,0,0,0,8
12031,3,2351,2434,-83,0,300,0,6
12032,1,2422,2426,-4,0,5,0,6
12033,2,2320,2490,-170,0,464,0,6
12034,1,2452,2381,71,0,242,0,6
12035,2,2396,2433,-37,0,100,0,6
12036,1,2446,2347,99,0,194,0,6
12037,3,2580,2578,2,0,49,0,6
12038,2,2398,2448,-50,0,200,0,6
12039,1,2602,2286,316,0,15,0,6
12040,2,2420,2309,111,0,106,1,8
12041,1,2459,2324,135,0,41,0,6
12042,2,2410,2410,0,0,4,1,6
12043,1,2433,2367,66,0,333,1,6
12044,1,2468,2395,73,0,46,0,6
12045,2,2487,2459,28,0,195,0,6
12046,1,2377,2467,-90,0,149,0,6
12047,2,2437,2456,-19,0,226,0,6
12048,2,2408,2407,1,0,34,0,8
12049,2,2446,2605,-159,0,192,0,6
12050,2,2343,2450,-107,0,123,0,6
12051,1,2400,2580,-180,0,302,0,6
12052,1,2671,2471,200,0,40,0,6
12053,1,2578,2402,176,0,7,0,6
12054,2,2457,2419,38,0,112,1,6
12055,2,2611,2735,-124,0,130,0,6
12056,2,2351,2513,-162,0,30,1,6
12057,1,2438,2391,47,0,10,0,6
12058,1,2419,2273,146,0,102,0,6
12059,2,2428,2303,125,0,5,1,6
12060,1,2439,2263,176,0,97,1,6
12061,1,2517,2493,24,0,45,0,6
12062,1,2512,2566,-54,4,40,1,14
12063,1,2474,2318,156,0,0,0,5
12064,2,2339,2472,-133,0,101,0,6
12065,2,2527,2501,26,0,142,0,6
12066,1,2462,2431,31,0,15,0,6
12067,1,2417,2405,12,0,1,0,6
12068,1,2442,2541,-99,0,156,1,6
12069,1,2468,2674,-206,0,112,0,6
12070,2,2426,2467,-41,0,121,0,6
12071,1,2739,2607,132,0,257,0,6
12072,1,2442,2463,-21,0,141,1,6
12073,1,2604,2258,346,0,13,0,6
12074,1,2472,2421,51,0,20,0,6
12075,2,2399,2569,-170,0,9,1,6
12076,1,2386,2409,-23,0,127,0,6
12077,2,2488,2443,45,0,253,1,6
12078,2,2414,2399,15,0,202,0,6
12079,2,2342,2450,-108,0,11,0,6
12080,2,2272,2413,-141,0,242,0,8
12081,2,2420,2476,-56,0,300,1,6
12082,1,2609,2488,121,0,140,0,6
12083,2,2340,2403,-63,0,40,0,6
12084,2,2603,2743,-140,0,118,0,6
12085,2,2441,2453,-12,0,45,1,6
12086,2,2304,2402,-98,0,40,0,8
12087,1,2277,2477,-200,0,337,0,5
12088,2,2416,2477,-61,0,121,0,6
12089,2,2362,2583,-221,0,486,0,6
12090,3,2516,2521,-5,0,400,0,6
12091,1,2533,2449,84,0,244,0,6
12092,1,2590,2423,167,0,4,0,6
12093,2,2400,2388,12,0,144,0,6
12094,1,2466,2261,205,0,140,0,6
12095,2,2357,2405,-48,0,28,0,6
12096,1,2398,2483,-85,0,128,0,6
12097,1,2478,2312,166,0,263,1,6
12098,1,2665,2477,188,0,40,0,6
12099,1,2484,2448,36,0,336,0,6
12100,1,2303,2424,-121,0,6,0,6
12101,1,2461,2419,42,0,106,0,6
12102,1,2613,2593,20,0,154,0,6
12103,1,2482,2412,70,0,15,1,6
12104,2,2573,2454,119,0,319,1,6
12105,2,2449,2482,-33,0,15,0,6
12106,1,2413,2348,65,0,4,0,6
12107,3,2746,2600,146,0,247,0,6
12108,2,2416,2327,89,0,331,0,6
12109,3,2552,2415,137,0,15,0,6
12110,1,2414,2410,4,0,351,1,6
12111,2,2521,2625,-104,0,134,1,6
12112,1,2407,2366,41,0,83,0,6
12113,2,2445,2538,-93,0,233,0,6
12114,1,2534,2417,117,0,242,1,8
12115,2,2390,2516,-126,0,125,0,6
12116,1,2410,2352,58,0,405,1,6
12117,2,2459,2431,28,0,406,0,6
12118,2,2404,2392,12,0,46,1,6
12119,2,2334,2491,-157,0,300,1,6
12120,3,2306,2409,-103,0,101,0,6
12121,1,2588,2466,122,0,4,0,6
12122,2,2443,2418,25,0,100,1,6
12123,2,2487,2444,43,0,246,0,6
12124,2,2401,2351,50,0,4,0,6
12125,2,2407,2486,-79,0,121,0,6
12126,2,2520,2618,-98,0,334,0,6
12127,1,2409,2477,-68,0,190,0,6
12128,2,2298,2462,-164,0,302,0,6
12129,1,2589,2564,25,0,131,1,6
12130,3,2491,2403,88,0,27,0,6
12131,2,2604,2474,130,0,256,0,6
12132,2,2404,2420,-16,0,80,0,6
12133,2,2437,2370,67,0,300,0,6
12134,1,2516,2550,-34,0,199,0,6
12135,1,2453,2463,-10,0,61,0,6
12136,2,2591,2540,51,0,456,0,6
12137,1,2407,2257,150,0,352,1,6
12138,1,2586,2537,49,0,225,0,6
12139,2,2415,2320,95,4,143,0,13
12140,3,2494,2331,163,0,300,0,6
12141,1,2451,2481,-30,0,15,0,6
12142,1,2465,2437,28,0,225,0,6
12143,2,2413,2538,-125,0,127,0,8
12144,2,2404,2490,-86,0,102,0,6
12145,1,2557,2624,-67,0,87,0,6
12146,2,2544,2523,21,0,15,0,6
12147,1,2744,2658,86,0,110,0,6
12148,1,2465,2394,71,0,1,0,6
12149,2,2399,2430,-31,0,344,1,6
12150,2,2622,2596,26,0,244,0,6
12151,2,2413,2406,7,0,260,0,8
12152,2,2482,2585,-103,0,121,0,6
12153,2,2357,2505,-148,0,10,0,6
12154,1,2323,2419,-96,0,120,0,6
12155,1,2456,2424,32,0,131,0,6
12156,2,2409,2354,55,0,216,0,6
12157,1,2450,2355,95,0,308,0,6
12158,1,2332,2459,-127,0,125,0,6
12159,1,2457,2432,25,0,225,0,6
12160,1,2411,2470,-59,0,31,0,6
12161,2,2333,2492,-159,0,210,0,6
12162,1,2417,2477,-60,0,15,1,6
12163,1,2461,2251,210,0,107,0,6
12164,2,2402,2369,33,0,241,0,6
12165,2,2308,2460,-152,4,50,1,18
12166,3,2282,2442,-160,0,157,0,6
12167,1,2400,2402,-2,0,227,1,6
12168,1,2542,2371,171,0,241,0,6
12169,1,2475,2457,18,0,246,1,6
12170,3,2618,2566,52,0,3,0,6
12171,1,2401,2254,147,0,176,0,6
12172,2,2663,2833,-170,0,413,0,6
12173,2,2226,2556,-330,4,40,0,14
12174,1,2594,2529,65,0,140,0,6
12175,3,2507,2350,157,0,49,0,6
12176,2,2538,2589,-51,0,15,0,6
12177,1,2422,2470,-48,0,310,1,6
12178,1,2427,2462,-35,0,278,0,6
12179,2,2382,2508,-126,0,40,0,6
12180,1,2324,2418,-94,0,43,0,6
12181,2,2454,2393,61,0,345,0,6
12182,1,2495,2330,165,0,300,0,6
12183,2,2490,2464,26,0,106,0,6
12184,1,2494,2594,-100,0,48,1,6
12185,2,2470,2424,46,0,253,1,6
12186,2,2374,2533,-159,0,195,0,6
12187,2,2414,2567,-153,0,1,0,6
12188,3,2300,2404,-104,0,120,0,6
12189,2,2410,2464,-54,0,112,0,6
12190,1,2356,2456,-100,0,247,1,6
12191,2,2412,2543,-131,0,127,0,8
12192,1,2419,2462,-43,0,122,1,6
12193,3,2415,2304,111,0,106,0,6
12194,2,2470,2440,30,0,123,1,6
12195,2,2349,2462,-113,0,330,0,6
12196,2,2230,2400,-170,0,250,0,6
12197,3,2748,2836,-88,0,395,0,6
12198,2,2452,2480,-28,0,15,0,6
12199,1,2512,2410,102,0,0,0,6
12200,2,2660,2616,44,0,404,0,6
12201,2,2295,2467,-172,0,129,0,6
12202,1,2415,2553,-138,0,320,0,6
12203,2,2524,2531,-7,0,241,0,6
12204,1,2469,2266,203,0,250,1,6
12205,2,2357,2447,-90,0,409,1,6
12206,1,2468,2400,68,0,345,0,6
12207,1,2464,2340,124,0,1,0,6
12208,2,2571,2384,187,0,406,1,6
12209,3,2327,2498,-171,0,210,0,6
12210,2,2314,2408,-94,0,132,0,8
12211,2,2478,2411,67,0,40,0,6
12212,1,2316,2430,-114,0,436,0,6
12213,1,2587,2679,-92,0,4,0,6
12214,2,2342,2406,-64,0,101,1,6
12215,2,2423,2414,9,0,315,0,6
12216,3,2407,2277,130,0,130,0,6
12217,1,2545,2599,-54,0,7,1,6
12218,1,2338,2408,-70,4,326,0,13
12219,1,2536,2435,101,0,15,0,6
12220,2,2329,2605,-276,0,338,0,6
12221,2,2537,2519,18,0,45,0,6
12222,2,2835,2750,85,0,113,0,6
12223,2,2449,2475,-26,0,330,0,6
12224,2,2417,2459,-42,0,1,0,6
12225,2,2396,2424,-28,0,453,0,6
12226,1,2403,2322,81,0,210,0,6
12227,2,2672,2594,78,0,466,0,6
12228,1,2402,2401,1,0,246,0,6
12229,3,2452,2514,-62,0,331,0,6
12230,1,2623,2653,-30,0,154,1,6
12231,1,2496,2329,167,0,300,0,6
12232,1,2288,2431,-143,0,386,1,6
12233,1,2403,2258,145,0,331,1,6
12234,2,2399,2467,-68,0,150,0,6
12235,1,2420,2390,30,0,263,0,6
12236,3,2545,2561,-16,0,136,0,6
12237,2,2348,2405,-57,0,302,0,6
12238,1,2402,2353,49,0,485,0,6
12239,2,2410,2429,-19,0,109,0,6
12240,1,2362,2505,-143,0,406,0,6
12241,2,2411,2358,53,0,40,0,6
12242,2,2412,2443,-31,0,1,0,6
12243,1,2483,2615,-132,0,337,0,6
12244,1,2609,2525,84,0,5,0,6
12245,2,2477,2485,-8,0,0,0,6
12246,1,2757,2828,-71,0,332,1,6
12247,2,2426,2437,-11,0,244,0,6
12248,2,2654,2629,25,0,335,0,6
12249,2,2311,2405,-94,0,10,0,6
12250,1,2290,2407,-117,0,244,1,6
12251,1,2413,2309,104,0,250,1,8
12252,1,2430,2390,40,0,13,0,6
12253,2,2601,2665,-64,0,0,1,6
12254,1,2449,2407,42,0,106,0,6
12255,2,2312,2461,-149,0,119,1,6
12256,2,2434,2419,15,0,43,0,6
12257,2,2481,2665,-184,0,292,1,6
12258,1,2472,2453,19,0,258,0,6
12259,1,2384,2587,-203,0,107,1,6
12260,1,2407,2326,81,0,331,0,6
12261,2,2282,2473,-191,0,415,0,6
12262,1,2561,2499,62,0,327,0,6
12263,1,2577,2647,-70,0,187,0,6
12264,1,2381,2400,-19,0,310,0,6
12265,2,2425,2494,-69,0,483,0,6
12266,2,2487,2301,186,4,277,1,13
12267,2,2433,2546,-113,0,169,0,6
12268,2,2425,2491,-66,0,0,0,6
12269,2,2471,2438,33,0,45,0,6
12270,2,2520,2503,17,0,103,0,6
12271,3,2409,2257,152,0,46,0,6
12272,2,2376,2412,-36,0,133,0,6
12273,1,2635,2648,-13,0,15,0,6
12274,1,2500,2492,8,0,40,0,6
12275,1,2400,2421,-21,0,123,0,6
12276,1,2464,2308,156,0,14,0,6
12277,1,2502,2396,106,0,52,1,6
12278,2,2435,2614,-179,0,20,0,6
12279,2,2642,2641,1,0,335,0,6
12280,1,2640,2621,19,0,371,0,6
12281,2,2821,2764,57,0,112,0,6
12282,2,2385,2403,-18,0,41,0,6
12283,1,2428,2402,26,0,40,0,6
12284,1,2351,2445,-94,0,110,0,6
12285,1,2454,2387,67,0,12,0,6
12286,1,2445,2465,-20,0,267,1,6
12287,1,2596,2447,149,0,7,0,6
12288,3,2394,2407,-13,0,412,0,6
12289,3,2477,2496,-19,0,140,0,6
12290,3,2470,2337,133,0,228,0,6
12291,1,2509,2429,80,0,302,0,6
12292,2,2550,2515,35,0,141,0,6
12294,2,2405,2566,-161,0,112,0,6
12295,2,2323,2579,-256,0,335,0,6
12296,1,2443,2420,23,0,4,0,6
12297,2,2423,2390,33,0,45,1,6
12298,1,2432,2255,177,0,10,0,6
12299,1,2617,2584,33,0,4,0,6
12300,1,2647,2636,11,0,113,0,6
12301,1,2529,2494,35,0,110,1,6
12302,3,2446,2454,-8,0,190,0,6
12303,1,2481,2508,-27,0,341,1,6
12304,2,2771,2815,-44,0,56,0,6
12305,3,2486,2467,19,0,1,0,6
12306,2,2425,2415,10,0,170,1,6
12307,2,2359,2406,-47,0,123,0,6
12308,3,2592,2478,114,0,150,0,6
12309,1,2291,2438,-147,0,110,0,6
12310,2,2397,2446,-49,0,1,0,6
12311,2,2454,2370,84,0,196,1,6
12312,2,2338,2442,-104,0,302,0,6
12313,2,2495,2543,-48,0,40,1,6
12314,1,2404,2423,-19,0,44,0,6
12315,1,2409,2256,153,0,36,1,6
12316,2,2459,2380,79,0,335,0,6
12317,3,2451,2458,-7,0,426,0,6
12318,2,2305,2404,-99,0,57,0,6
12319,1,2600,2435,165,0,373,0,6
12320,1,2521,2570,-49,0,134,1,6
12321,2,2451,2392,59,0,127,1,6
12322,3,2430,2380,50,0,267,0,6
12323,1,2411,2354,57,0,240,0,6
12324,1,2354,2420,-66,0,28,0,6
12325,1,2444,2543,-99,0,345,0,6
12326,2,2408,2301,107,0,20,1,6
12327,3,2395,2623,-228,0,46,0,6
12328,2,2473,2282,191,0,131,0,6
12329,3,2468,2486,-18,0,10,0,6
12330,1,2653,2534,119,0,244,1,6
12331,1,2410,2297,113,4,403,1,13
12332,1,2489,2387,102,0,300,1,6
12333,2,2820,2766,54,0,130,0,6
12334,1,2421,2293,128,0,261,0,6
12335,1,2419,2467,-48,0,288,0,6
12336,2,2303,2430,-127,0,43,0,6
12337,1,2480,2508,-28,0,253,0,6
12338,2,2417,2400,17,0,43,1,6
12339,2,2407,2330,77,0,176,1,6
12340,1,2398,2417,-19,0,15,0,6
12341,2,2541,2590,-49,0,112,1,6
12342,3,2377,2452,-75,0,217,0,6
12343,1,2551,2491,60,0,45,0,6
12344,2,2304,2404,-100,0,113,0,6
12345,2,2458,2398,60,0,20,0,6
12346,2,2451,2464,-13,0,337,1,6
12347,1,2448,2290,158,0,46,0,6
12348,2,2445,2486,-41,0,190,0,6
12349,2,2563,2714,-151,0,49,0,6
12350,2,2460,2425,35,0,398,1,6
12351,1,2413,2361,52,0,246,0,6
12352,2,2319,2451,-132,0,40,0,6
12353,3,2397,2403,-6,0,103,0,6
12354,2,2433,2464,-31,0,192,0,6
12355,2,2399,2485,-86,0,112,0,6
12356,2,2486,2559,-73,0,302,0,6
12357,2,2527,2633,-106,0,194,0,6
12358,2,2399,2491,-92,0,1,0,6
12360,2,2379,2401,-22,4,123,0,13
12361,1,2352,2452,-100,0,46,0,6
12362,1,2356,2418,-62,0,28,0,6
12363,1,2351,2530,-179,0,241,1,6
12364,1,2383,2439,-56,0,411,1,6
12365,2,2772,2813,-41,0,459,0,6
12366,2,2414,2405,9,0,7,0,6
12367,3,2411,2357,54,0,45,0,6
12368,1,2444,2360,84,0,300,0,6
12369,2,2481,2603,-122,0,48,0,6
12370,2,2411,2402,9,0,40,0,6
12371,1,2493,2411,82,0,45,0,6
12372,1,2412,2435,-23,0,310,0,6
12373,2,2337,2400,-63,0,121,0,6
12374,2,2358,2450,-92,0,201,0,6
12375,1,2446,2263,183,0,311,0,6
12376,1,2620,2536,84,0,4,0,6
12377,1,2717,2607,110,0,122,0,6
12378,2,2559,2440,119,0,49,1,6
12379,2,2379,2477,-98,0,101,1,6
12380,1,2346,2446,-100,0,247,0,6
12381,3,2469,2449,20,0,122,0,6
12382,1,2403,2309,94,0,45,0,6
12383,1,2460,2408,52,0,245,0,6
12384,2,2470,2303,167,0,111,0,6
12385,1,2338,2428,-90,0,135,0,6
12386,1,2432,2397,35,0,15,1,6
12387,2,2495,2523,-28,0,141,1,6
12388,1,2411,2432,-21,0,386,0,6
12389,1,2479,2317,162,4,105,0,13
12390,2,2395,2459,-64,0,1,0,6
12391,2,2355,2449,-94,0,312,0,6
12392,1,2412,2363,49,0,4,0,6
12393,2,2455,2331,124,0,4,0,6
12394,1,2310,2459,-149,0,400,0,6
12395,2,2404,2375,29,0,205,0,6
12396,2,2498,2372,126,0,107,0,6
12397,1,2334,2408,-74,0,45,0,6
12398,2,2671,2637,34,0,121,0,6
12399,1,2566,2481,85,0,300,0,6
12400,1,2411,2484,-73,0,4,0,6
12401,1,2657,2469,188,0,200,0,6
12402,1,2469,2346,123,0,13,0,8
12403,2,2455,2544,-89,0,466,1,6
12404,1,2818,2767,51,0,113,0,6
12405,2,2433,2354,79,0,241,1,6
12406,1,2390,2436,-46,0,453,1,6
12407,2,2272,2440,-168,0,206,0,8
12408,1,2487,2595,-108,0,338,1,6
12409,2,2445,2390,55,0,106,0,6
12410,1,2464,2289,175,0,22,0,6
12411,1,2464,2272,192,0,0,1,6
12412,2,2603,2721,-118,0,122,1,6
12413,2,2432,2405,27,0,178,0,6
12414,1,2461,2319,142,0,107,0,6
12415,3,2478,2402,76,0,267,0,6
12416,2,2497,2363,134,0,453,0,6
12417,2,2453,2351,102,0,101,0,6
12418,2,2255,2420,-165,0,0,0,6
12419,2,2346,2482,-136,4,405,0,13
12420,1,2402,2332,70,0,4,0,6
12421,3,2371,2443,-72,0,196,0,6
12422,1,2358,2417,-59,0,27,1,6
12423,2,2350,2429,-79,0,122,0,6
12424,1,2422,2237,185,0,0,0,6
12425,2,2397,2437,-40,0,1,0,6
12426,1,2477,2437,40,0,45,0,6
12427,3,2477,2573,-96,0,303,0,6
12428,2,2532,2665,-133,0,189,0,6
12429,1,2529,2490,39,0,196,0,6
12430,2,2451,2396,55,0,44,0,6
12431,3,2481,2490,-9,0,302,0,6
12432,1,2762,2823,-61,0,56,0,6
12433,2,2452,2434,18,0,398,0,6
12434,2,2257,2408,-151,0,10,0,8
12435,1,2450,2467,-17,0,80,0,6
12436,2,2450,2392,58,0,9,0,6
12437,1,2423,2252,171,0,0,1,6
12438,2,2465,2418,47,0,100,0,6
12440,2,2404,2660,-256,0,13,0,6
12441,1,2426,2227,199,0,205,0,6
12442,3,2448,2479,-31,0,102,0,6
12443,3,2454,2450,4,0,6,0,6
12444,1,2411,2396,15,0,110,0,6
12445,2,2429,2392,37,0,106,0,6
12446,1,2571,2479,92,0,45,0,6
12447,1,2485,2534,-49,0,141,0,6
12448,1,2643,2646,-3,0,125,1,6
12449,1,2434,2345,89,0,107,1,6
12450,2,2418,2426,-8,0,15,0,6
12451,2,2406,2328,78,0,4,0,6
12452,1,2336,2482,-146,0,116,0,6
12453,2,2403,2408,-5,0,150,0,6
12454,2,2364,2432,-68,0,49,0,6
12455,1,2410,2365,45,0,140,1,6
12456,3,2542,2324,218,0,403,0,8
12457,2,2461,2456,5,0,300,1,6
12458,1,2490,2408,82,0,40,0,6
12459,1,2443,2290,153,0,9,0,6
12460,2,2398,2420,-22,0,258,0,6
12461,2,2458,2313,145,0,41,0,6
12462,2,2416,2423,-7,0,247,0,6
12463,2,2817,2769,48,0,130,1,6
12464,1,2479,2444,35,0,14,1,6
12465,1,2248,2426,-178,0,0,0,6
12466,1,2398,2429,-31,0,1,0,6
12467,2,2378,2403,-25,0,141,1,8
12468,2,2449,2450,-1,0,224,0,6
12469,2,2662,2528,134,0,130,1,6
12470,1,2576,2513,63,0,45,1,6
12471,1,2292,2440,-148,0,157,1,6
12472,2,2438,2318,120,0,400,0,6
12473,1,2495,2321,174,0,106,0,6
12474,3,2400,2450,-50,0,14,0,6
12475,2,2407,2370,37,4,201,0,13
12476,1,2429,2315,114,0,101,0,6
12477,1,2370,2410,-40,0,405,1,6
12478,1,2441,2446,-5,0,46,0,6
12479,2,2429,2474,-45,0,46,0,6
12480,2,2398,2417,-19,0,177,0,6
12481,1,2527,2492,35,0,196,0,6
12482,2,2391,2412,-21,0,311,1,6
12483,3,2311,2474,-163,0,101,0,6
12484,1,2478,2456,22,0,227,0,6
12485,2,2436,2472,-36,0,20,0,6
12486,1,2377,2498,-121,0,210,0,6
12487,3,2640,2649,-9,0,462,0,6
12488,1,2426,2252,174,0,15,0,6
12489,1,2423,2278,145,0,172,0,6
12490,2,2486,2307,179,0,4,0,6
12491,2,2312,2404,-92,0,195,1,6
12492,1,2438,2404,34,0,106,0,6
12493,1,2486,2533,-47,0,1,0,6
12494,1,2776,2810,-34,0,474,0,6
12495,1,2449,2439,10,0,212,0,6
12496,1,2483,2371,112,0,454,0,6
12497,1,2409,2431,-22,0,1,0,6
12498,1,2577,2483,94,0,40,0,6
12499,1,2429,2399,30,0,106,0,6
12500,1,2405,2539,-134,0,0,0,8
12501,3,2536,2581,-45,0,101,0,6
12502,2,2433,2422,11,0,14,0,6
12503,1,2804,2782,22,0,45,0,6
12504,1,2477,2391,86,0,469,0,6
12505,2,2431,2426,5,0,14,0,6
12506,2,2329,2486,-157,4,4,0,13
12507,2,2311,2433,-122,0,45,0,6
12508,1,2526,2493,33,0,196,0,6
12509,1,2486,2404,82,0,302,0,6
12510,3,2425,2266,159,0,245,0,6
12511,1,2471,2403,68,0,40,0,6
12512,1,2570,2402,168,0,122,0,6
12513,2,2386,2468,-82,0,40,0,6
12514,1,2479,2584,-105,0,202,0,6
12515,2,2446,2424,22,0,43,1,6
12516,2,2365,2476,-111,0,301,1,6
12517,2,2489,2350,139,0,302,0,6
12518,1,2649,2640,9,0,123,0,6
12519,2,2506,2482,24,0,20,0,6
12520,1,2490,2385,105,0,45,0,6
12521,1,2325,2447,-122,0,311,0,6
12522,2,2399,2574,-175,0,15,0,6
12523,3,2467,2494,-27,0,117,0,6
12524,1,2777,2809,-32,0,474,1,6
12525,2,2376,2430,-54,0,265,1,6
12526,1,2399,2488,-89,0,9,1,6
12527,2,2401,2432,-31,0,0,0,6
12528,2,2635,2655,-20,0,455,1,6
12529,2,2601,2654,-53,0,335,0,6
12530,1,2394,2426,-32,0,1,0,6
12531,2,2433,2306,127,0,49,1,6
12532,2,2414,2342,72,0,113,0,6
12533,1,2473,2381,92,0,130,1,6
12534,1,2425,2443,-18,0,139,1,6
12535,2,2427,2490,-63,0,35,0,6
12536,1,2580,2537,43,0,300,0,6
12537,1,2573,2418,155,0,300,0,6
12538,3,2401,2266,135,0,45,0,6
12539,1,2488,2486,2,0,356,1,6
12540,1,2476,2381,95,0,48,0,6
12541,1,2479,2319,160,0,153,0,6
12542,2,2419,2521,-102,0,265,0,6
12543,1,2401,2408,-7,0,1,0,6
12544,1,2300,2480,-180,0,200,1,6
12545,1,2328,2419,-91,0,1,0,6
12546,1,2416,2439,-23,0,1,0,6
12547,1,2494,2467,27,0,45,0,6
12548,1,2616,2481,135,0,122,0,6
12549,2,2660,2629,31,0,123,0,6
12550,1,2803,2783,20,0,45,0,6
12551,2,2348,2480,-132,0,310,1,6
12552,1,2349,2407,-58,0,122,0,6
12553,1,2495,2335,160,0,4,0,6
12554,1,2377,2477,-100,0,40,0,6
12555,2,2431,2454,-23,0,132,0,6
12556,2,2317,2499,-182,0,0,0,6
12557,2,2423,2307,116,0,107,0,6
12558,2,2406,2578,-172,0,200,1,6
12559,2,2335,2426,-91,0,400,0,6
12560,1,2402,2406,-4,0,4,0,6
12561,2,2585,2659,-74,0,45,0,6
12562,1,2508,2517,-9,0,260,0,6
12563,2,2365,2435,-70,0,253,1,6
12564,1,2362,2414,-52,0,113,0,6
12565,2,2393,2441,-48,0,198,1,6
12566,1,2481,2483,-2,0,121,0,6
12567,2,2431,2482,-51,0,101,0,6
12568,2,2433,2307,126,0,462,0,6
12569,1,2614,2417,197,0,291,0,6
12570,2,2636,2654,-18,0,402,0,6
12571,2,2438,2415,23,0,129,0,6
12572,1,2530,2619,-89,0,0,1,6
12573,3,2415,2528,-113,0,320,0,6
12574,1,2430,2424,6,0,315,0,6
12575,2,2778,2809,-31,0,31,0,6
12576,3,2470,2384,86,0,153,0,6
12577,2,2511,2514,-3,0,57,0,6
12578,1,2514,2401,113,0,4,0,6
12579,2,2663,2581,82,0,140,0,6
12580,2,2502,2314,188,0,45,0,6
12581,1,2408,2383,25,0,4,1,6
12582,1,2520,2506,14,0,260,0,6
12583,2,2273,2415,-142,0,36,0,6
12584,2,2486,2572,-86,0,202,1,6
12585,1,2582,2426,156,0,300,0,6
12586,2,2659,2630,29,0,121,0,6
12587,1,2439,2309,130,0,46,1,6
12588,2,2408,2403,5,0,15,1,6
12589,2,2315,2402,-87,0,268,1,6
12590,1,2425,2430,-5,0,5,0,6
12591,1,2588,2500,88,0,195,0,6
12592,1,2430,2346,84,0,49,0,6
12593,3,2479,2366,113,0,45,0,6
12594,2,2814,2773,41,0,331,0,6
12595,2,2386,2468,-82,0,40,1,6
12596,3,2440,2617,-177,0,211,0,6
12597,2,2487,2318,169,0,140,0,6
12598,1,2494,2612,-118,0,45,0,6
12599,2,2397,2581,-184,0,1,0,6
12600,2,2637,2653,-16,0,455,0,6
12601,2,2459,2528,-69,0,4,0,6
12602,1,2656,2587,69,0,200,0,6
12603,2,2411,2423,-12,0,335,0,6
12604,2,2577,2414,163,0,45,0,6
12605,1,2381,2532,-151,0,108,0,6
12606,3,2513,2493,20,0,302,0,6
12607,1,2621,2415,206,0,290,0,6
12608,1,2425,2385,40,0,264,0,6
12609,1,2577,2482,95,0,300,1,6
12610,1,2551,2496,55,0,15,0,6
12611,2,2424,2447,-23,0,0,0,6
12612,2,2478,2350,128,0,453,0,6
12613,1,2581,2401,180,0,45,0,6
12614,1,2355,2515,-160,0,145,0,6
12615,1,2779,2807,-28,0,474,0,6
12616,1,2409,2592,-183,0,21,1,6
12617,1,2584,2394,190,0,106,1,6
12618,2,2281,2416,-135,0,192,1,6
12619,2,2659,2631,28,0,123,0,6
12620,1,2473,2381,92,0,113,0,6
12621,1,2399,2433,-34,0,118,0,6
12622,2,2203,2406,-203,0,122,0,6
12623,1,2415,2356,59,0,122,0,6
12624,2,2605,2501,104,0,202,0,6
12625,1,2420,2310,110,0,110,0,6
12626,1,2801,2785,16,0,45,1,6
12627,2,2380,2404,-24,0,304,0,6
12628,1,2585,2569,16,0,40,0,6
12629,1,2462,2430,32,0,107,0,6
12630,1,2524,2489,35,0,121,1,6
12631,1,2389,2425,-36,0,300,1,6
12632,1,2449,2407,42,0,103,0,6
12633,1,2452,2418,34,0,55,0,6
12634,1,2315,2422,-107,0,15,1,6
12635,2,2366,2447,-81,0,40,0,6
12636,2,2478,2581,-103,0,202,1,6
12637,1,2491,2513,-22,0,80,1,6
12638,2,2316,2470,-154,0,427,1,6
12639,1,2527,2361,166,0,155,0,6
12640,1,2494,2358,136,0,302,0,6
12641,2,2351,2420,-69,0,4,1,6
12642,2,2379,2501,-122,0,41,1,6
12643,1,2431,2377,54,0,302,1,6
12644,1,2637,2653,-16,0,453,0,6
12645,1,2433,2437,-4,0,41,1,6
12646,2,2403,2391,12,0,106,0,6
12647,2,2468,2509,-41,0,20,0,6
12648,2,2440,2614,-174,0,40,0,6
12649,2,2424,2415,9,0,106,0,6
12650,1,2417,2427,-10,0,245,0,6
12651,2,2402,2367,35,0,300,0,6
12652,1,2421,2418,3,0,4,0,6
12653,1,2597,2592,5,0,202,1,6
12654,1,2413,2457,-44,0,0,0,6
12655,1,2455,2442,13,0,6,1,6
12656,2,2419,2425,-6,0,107,0,6
12657,1,2386,2419,-33,0,7,1,6
12658,1,2420,2228,192,0,335,0,6
12659,2,2400,2356,44,0,101,0,6
12660,1,2484,2323,161,0,102,0,6
12661,1,2402,2474,-72,0,112,0,6
12662,2,2507,2455,52,0,473,0,6
12663,1,2415,2428,-13,0,4,0,6
12664,2,2412,2307,105,0,116,0,8
12665,1,2497,2422,75,0,40,1,6
12666,2,2497,2500,-3,0,140,0,6
12667,2,2585,2474,111,0,335,0,6
12668,1,2487,2397,90,0,106,0,6
12669,3,2505,2388,117,0,122,0,6
12670,2,2372,2415,-43,0,41,1,6
12671,2,2328,2427,-99,0,10,0,6
12672,3,2371,2413,-42,0,25,0,6
12673,1,2430,2422,8,0,190,0,6
12674,2,2430,2421,9,0,13,1,6
12675,1,2515,2513,2,0,41,1,6
12676,3,2518,2507,11,0,53,0,6
12677,3,2506,2492,14,0,10,0,6
12678,1,2548,2428,120,0,357,0,6
12679,1,2402,2266,136,0,312,0,6
12680,1,2668,2500,168,0,86,0,6
12681,2,2313,2462,-149,0,225,0,6
12682,1,2585,2462,123,0,45,0,6
12683,3,2311,2437,-126,0,409,0,6
12684,2,2388,2404,-16,0,336,0,6
12685,1,2421,2312,109,0,115,0,6
12686,2,2328,2424,-96,0,132,0,6
12687,1,2435,2282,153,0,236,0,6
12688,1,2412,2326,86,0,131,1,6
12689,3,2393,2491,-98,0,1,0,6
12690,1,2481,2578,-97,0,202,0,6
12691,2,2384,2530,-146,0,130,0,6
12692,3,2467,2460,7,0,311,0,6
12693,1,2617,2437,180,0,15,1,6
12694,3,2417,2447,-30,0,1,0,6
12695,1,2536,2436,100,0,109,1,6
12696,2,2531,2503,28,0,107,0,6
12697,1,2434,2297,137,0,112,0,6
12698,1,2419,2590,-171,0,8,0,6
12699,1,2382,2402,-20,0,15,0,6
12701,3,2507,2517,-10,0,110,0,6
12702,1,2488,2309,179,0,241,0,6
12703,1,2465,2310,155,0,42,1,6
12704,1,2263,2439,-176,0,302,0,6
12705,1,2402,2208,194,0,40,1,6
12706,2,2279,2412,-133,0,255,0,6
12707,1,2497,2457,40,0,50,0,6
12708,1,2389,2400,-11,0,190,0,8
12709,1,2425,2427,-2,0,265,1,6
12710,3,2492,2671,-179,0,46,0,6
12711,1,2312,2409,-97,0,337,0,6
12712,2,2410,2436,-26,0,311,0,6
12713,3,2435,2431,4,0,331,0,6
12714,3,2587,2474,113,0,45,0,6
12715,1,2311,2409,-98,0,225,0,8
12716,2,2333,2417,-84,0,140,0,6
12717,1,2429,2225,204,0,178,0,6
12718,1,2347,2400,-53,0,8,0,6
12719,1,2490,2495,-5,0,125,1,6
12720,2,2235,2405,-170,0,173,0,8
12721,2,2394,2580,-186,0,1,0,6
12722,2,2412,2418,-6,0,106,0,6
12723,3,2407,2413,-6,0,242,0,6
12724,2,2446,2444,2,0,140,1,6
12725,2,2382,2521,-139,0,277,0,6
12726,2,2517,2507,10,0,224,1,6
12727,1,2480,2427,53,0,45,0,6
12728,2,2424,2279,145,0,153,0,6
12729,2,2489,2510,-21,0,122,1,6
12730,1,2480,2491,-11,0,106,0,6
12731,2,2469,2519,-50,0,203,0,6
12732,1,2429,2351,78,0,122,0,6
12733,1,2470,2386,84,4,176,0,13
12734,2,2400,2500,-100,0,245,0,6
12735,2,2404,2392,12,0,181,0,6
12736,1,2620,2669,-49,0,45,1,6
12737,2,2556,2495,61,0,15,0,6
12738,1,2402,2294,108,0,0,0,6
12739,2,2421,2319,102,0,190,0,6
12740,1,2421,2432,-11,0,108,0,6
12741,1,2436,2449,-13,0,57,0,6
12742,1,2583,2396,187,0,45,0,6
12743,1,2476,2391,85,0,106,0,6
12744,1,2501,2401,100,0,57,1,6
12745,2,2524,2427,97,0,267,0,6
12746,2,2394,2533,-139,0,130,0,6
12747,1,2524,2464,60,0,40,0,6
12748,1,2346,2406,-60,0,106,0,6
12749,2,2502,2587,-85,0,40,0,6
12750,2,2472,2393,79,0,380,1,6
12751,2,2290,2441,-151,0,42,0,6
12752,1,2489,2422,67,0,0,0,6
12753,1,2410,2295,115,0,255,0,6
12754,2,2513,2511,2,0,124,0,6
12755,1,2440,2406,34,0,153,0,6
12756,1,2515,2454,61,0,113,0,6
12757,3,2450,2347,103,0,41,0,6
12758,2,2442,2485,-43,0,405,0,6
12759,2,2398,2414,-16,0,145,1,6
12760,1,2485,2486,-1,0,110,0,6
12761,2,2387,2552,-165,0,1,0,6
12762,2,2430,2481,-51,0,242,0,6
12763,2,2517,2502,15,0,145,0,6
12764,2,2371,2424,-53,0,250,0,6
12765,1,2435,2353,82,0,338,1,6
12766,3,2627,2631,-4,0,45,0,6
12767,2,2483,2662,-179,0,253,0,6
12768,1,2435,2421,14,0,400,0,6
12769,1,2389,2507,-118,0,140,0,6
12770,1,2431,2374,57,0,111,0,6
12771,3,2472,2433,39,0,61,0,6
12772,3,2418,2494,-76,0,7,0,6
12773,1,2477,2395,82,0,130,0,6
12774,1,2401,2368,33,0,45,0,6
12775,1,2397,2449,-52,0,1,0,6
12776,2,2592,2497,95,0,45,1,6
12777,3,2450,2467,-17,0,141,0,6
12778,1,2504,2366,138,0,380,0,6
12779,1,2400,2446,-46,0,374,0,6
12780,3,2400,2380,20,0,58,0,6
12781,1,2327,2406,-79,0,41,0,6
12782,1,2415,2311,104,0,5,0,6
12783,2,2480,2491,-11,0,41,0,6
12784,1,2486,2384,102,0,106,0,6
12785,1,2507,2426,81,0,411,0,6
12786,2,2366,2401,-35,0,331,0,6
12787,2,2354,2419,-65,0,107,0,6
12788,3,2431,2437,-6,0,133,0,6
12789,1,2631,2627,4,0,331,1,6
12790,2,2376,2439,-63,0,353,0,6
12791,1,2513,2434,79,0,48,0,6
12792,2,2316,2530,-214,0,253,0,5
12793,1,2636,2215,421,0,200,0,5
12794,1,2393,2436,-43,0,207,0,6
12795,2,2372,2462,-90,0,107,0,6
12796,1,2643,2722,-79,0,405,0,6
12797,3,2397,2406,-9,0,151,0,6
12798,1,2665,2443,222,0,87,0,6
12799,1,2421,2439,-18,0,270,1,6
12800,1,2566,2512,54,0,331,0,6
12801,1,2493,2419,74,0,483,0,6
12802,2,2455,2480,-25,0,6,0,6
12803,2,2432,2419,13,0,45,0,6
12804,1,2424,2246,178,0,111,1,6
12805,2,2401,2397,4,0,115,0,6
12806,1,2505,2584,-79,0,40,1,6
12807,2,2497,2475,22,0,108,1,6
12808,2,2403,2363,40,0,1,0,6
12809,2,2380,2508,-128,0,1,0,6
12810,1,2298,2449,-151,0,120,0,6
12811,1,2391,2442,-51,0,240,1,6
12812,1,2628,2551,77,0,20,0,6
12813,1,2443,2348,95,0,302,0,6
12814,2,2426,2376,50,0,200,0,6
12815,1,2442,2407,35,0,380,0,6
12816,3,2429,2344,85,0,101,0,6
12817,1,2724,2715,9,0,404,0,6
12818,2,2402,2390,12,0,335,0,8
12819,2,2434,2362,72,0,122,0,6
12820,1,2466,2633,-167,0,106,0,6
12821,1,2398,2517,-119,0,157,0,6
12822,1,2415,2399,16,0,132,0,6
12823,2,2370,2450,-80,0,107,0,6
12824,3,2444,2270,174,4,337,0,13
12825,3,2406,2334,72,0,300,0,6
12826,2,2486,2528,-42,0,121,0,6
12827,1,2426,2518,-92,0,100,0,6
12828,1,2625,2454,171,0,207,0,6
12829,2,2547,2622,-75,0,112,0,6
12830,1,2437,2376,61,0,106,0,6
12831,1,2571,2507,64,0,160,0,6
12832,1,2668,2475,193,0,347,0,6
12833,3,2444,2420,24,0,49,0,6
12834,1,2402,2526,-124,0,40,0,6
12835,2,2709,2729,-20,0,335,0,6
12836,2,2414,2497,-83,0,8,0,6
12837,1,2669,2637,32,0,113,1,6
12838,1,2401,2226,175,0,264,0,6
12839,1,2511,2440,71,0,68,0,6
12840,2,2278,2424,-146,0,300,0,6
12841,1,2433,2427,6,0,246,1,6
12842,1,2576,2512,64,0,45,0,6
12843,1,2481,2491,-10,0,115,0,6
12844,1,2445,2397,48,0,411,0,6
12845,1,2531,2369,162,0,120,0,6
12846,2,2532,2637,-105,0,4,0,5
12847,2,2223,2404,-181,0,255,0,6
12848,1,2382,2447,-65,0,112,0,6
12849,3,2427,2318,109,0,131,0,6
12850,3,2537,2447,90,0,156,0,6
12851,1,2626,2542,84,0,300,0,6
12852,2,2380,2446,-66,4,404,0,13
12853,1,2374,2480,-106,0,267,1,6
12854,2,2402,2395,7,0,250,0,6
12855,3,2510,2533,-23,0,123,0,6
12856,1,2454,2481,-27,0,302,1,6
12857,1,2650,2628,22,0,47,0,6
12858,2,2371,2451,-80,0,1,0,6
12859,2,2372,2531,-159,0,311,0,8
12860,2,2305,2486,-181,0,118,0,6
12861,1,2502,2671,-169,0,13,1,6
12862,2,2325,2518,-193,0,131,0,6
12863,2,2341,2516,-175,0,411,0,6
12864,1,2414,2305,109,4,31,0,13
12865,1,2405,2371,34,0,300,1,6
12866,2,2735,2704,31,0,305,0,6
12867,1,2647,2635,12,0,123,0,6
12868,2,2518,2472,46,0,18,0,6
12869,1,2380,2417,-37,0,145,0,6
12870,2,2415,2335,80,0,0,0,6
12871,3,2408,2405,3,0,138,0,6
12872,1,2507,2581,-74,0,46,1,6
12873,2,2559,2507,52,0,45,0,6
12874,2,2631,2674,-43,0,0,0,6
12875,2,2425,2367,58,0,4,0,6
12876,1,2427,2410,17,0,381,0,6
12877,2,2308,2402,-94,0,100,0,6
12879,2,2534,2491,43,0,120,0,6
12880,1,2422,2459,-37,0,203,0,6
12881,1,2439,2416,23,0,150,0,6
12882,1,2510,2439,71,0,48,0,6
12883,3,2423,2508,-85,0,284,0,8
12884,1,2623,2538,85,0,245,0,6
12885,2,2374,2466,-92,0,1,1,6
12886,2,2479,2570,-91,0,207,1,6
12887,1,2652,2656,-4,0,125,0,6
12888,1,2352,2403,-51,0,0,0,6
12889,2,2710,2729,-19,0,337,0,6
12890,3,2489,2382,107,0,404,0,6
12891,2,2411,2269,142,0,485,1,6
12892,1,2533,2464,69,0,123,1,6
12893,1,2432,2510,-78,0,176,0,6
12894,1,2401,2397,4,0,115,0,6
12895,2,2511,2630,-119,0,9,0,6
12896,2,2386,2502,-116,0,105,0,6
12897,2,2380,2451,-71,4,201,0,13
12898,1,2641,2456,185,0,108,0,5
12899,2,2475,2663,-188,0,253,0,6
12900,1,2418,2356,62,0,400,1,6
12901,2,2267,2408,-141,0,40,0,6
12902,1,2431,2515,-84,0,142,0,6
12903,2,2409,2415,-6,0,10,0,6
12904,2,2514,2553,-39,0,107,0,6
12905,1,2650,2658,-8,0,61,0,6
12906,3,2406,2471,-65,0,13,0,6
12907,3,2403,2407,-4,0,4,0,6
12908,2,2442,2371,71,0,112,0,6
12909,2,2558,2509,49,0,253,0,6
12910,2,2342,2416,-74,0,331,0,6
12911,1,2574,2514,60,0,45,0,6
12912,2,2679,2528,151,0,107,0,6
12913,1,2535,2412,123,0,484,0,8
12914,2,2314,2459,-145,0,41,0,6
12915,3,2432,2459,-27,0,122,0,6
12916,2,2411,2383,28,0,5,1,6
12917,2,2465,2369,96,0,310,0,6
12918,3,2439,2433,6,0,112,0,6
12919,1,2503,2363,140,0,13,0,6
12920,1,2734,2705,29,0,404,0,6
12921,1,2666,2507,159,0,331,0,6
12922,1,2473,2324,149,0,21,0,8
12923,1,2627,2472,155,0,337,0,6
12924,1,2369,2404,-35,0,1,0,6
12925,2,2423,2444,-21,0,270,0,6
12926,1,2416,2461,-45,0,107,0,6
12927,1,2293,2406,-113,0,36,1,6
12928,1,2412,2264,148,0,0,0,6
12929,3,2283,2448,-165,0,203,0,6
12930,2,2259,2488,-229,0,414,0,6
12931,3,2391,2407,-16,0,250,0,6
12932,2,2359,2465,-106,0,131,0,6
12933,2,2403,2261,142,0,484,0,6
12934,2,2407,2406,1,0,0,1,6
12935,2,2533,2537,-4,0,415,0,6
12936,1,2515,2552,-37,0,43,1,6
12937,1,2699,2739,-40,0,337,0,6
12938,1,2451,2399,52,0,317,0,6
12939,1,2467,2381,86,0,106,0,6
12940,2,2450,2416,34,0,153,1,6
12941,2,2456,2576,-120,0,300,1,6
12942,2,2317,2429,-112,0,43,1,6
12943,1,2404,2382,22,0,49,0,6
12944,2,2277,2457,-180,0,202,0,6
12945,1,2376,2419,-43,0,193,0,6
12946,2,2556,2671,-115,0,130,0,6
12947,2,2380,2401,-21,0,40,0,6
12948,2,2463,2427,36,0,45,1,6
12949,2,2633,2656,-23,0,190,1,6
12950,2,2398,2439,-41,0,46,0,6
12951,3,2575,2474,101,0,300,0,6
12952,2,2433,2392,41,0,52,0,6
12953,1,2485,2376,109,0,106,0,6
12954,1,2519,2346,173,0,143,0,6
12955,2,2422,2367,55,0,225,1,6
12956,1,2453,2530,-77,0,301,0,5
12957,2,2360,2507,-147,0,304,1,6
12958,1,2675,2552,123,0,132,0,6
12959,1,2407,2360,47,0,112,0,6
12960,2,2319,2408,-89,0,302,0,8
12961,1,2468,2490,-22,0,200,1,6
12962,3,2498,2669,-171,0,244,0,6
12963,2,2335,2508,-173,0,41,0,6
12964,3,2400,2428,-28,0,398,0,6
12965,1,2503,2528,-25,0,9,0,6
12966,1,2435,2261,174,0,152,0,6
12967,1,2438,2392,46,0,45,0,6
12968,1,2401,2444,-43,0,421,0,6
12969,1,2543,2490,53,0,226,1,6
12970,2,2312,2454,-142,0,302,0,6
12971,2,2310,2425,-115,0,200,0,6
12972,1,2403,2410,-7,0,46,0,6
12973,1,2424,2444,-20,0,270,1,6
12974,2,2252,2405,-153,0,310,0,6
12975,1,2340,2407,-67,0,255,0,6
12976,1,2489,2377,112,0,122,0,6
12977,1,2372,2405,-33,0,1,0,6
12978,1,2545,2522,23,0,1,0,6
12979,3,2733,2706,27,0,304,0,6
12980,1,2471,2411,60,0,9,0,6
12981,3,2493,2388,105,0,112,0,6
12982,3,2412,2383,29,0,4,0,6
12983,1,2424,2304,120,0,143,0,6
12984,1,2408,2306,102,0,113,0,6
12985,1,2433,2383,50,0,335,1,6
12986,1,2456,2313,143,0,4,1,6
12987,1,2535,2531,4,0,101,0,6
12988,2,2341,2404,-63,0,17,0,6
12989,2,2353,2539,-186,0,315,0,8
12990,1,2352,2443,-91,0,426,0,6
12991,2,2440,2367,73,0,41,1,6
12992,1,2434,2428,6,0,295,0,6
12993,1,2289,2401,-112,0,7,1,6
12994,2,2679,2548,131,0,132,0,6
12995,2,2628,2646,-18,0,190,0,6
12996,2,2476,2573,-97,0,201,0,6
12997,2,2299,2438,-139,0,300,0,6
12998,1,2412,2264,148,0,406,0,8
12999,1,2438,2407,31,0,130,0,6
13000,2,2706,2733,-27,0,354,0,6
13001,1,2511,2285,226,0,162,0,6
13002,2,2427,2449,-22,0,228,0,6
13003,1,2534,2440,94,0,45,1,6
13004,1,2424,2430,-6,0,1,0,6
13005,1,2383,2412,-29,0,193,0,6
13006,1,2522,2666,-144,0,338,1,6
13007,1,2484,2337,147,0,302,0,6
13008,1,2645,2322,323,0,5,0,5
13009,2,2517,2551,-34,0,4,0,6
13010,1,2510,2603,-93,0,101,0,6
13011,1,2599,2475,124,0,246,1,6
13012,1,2409,2378,31,0,127,0,6
13013,1,2738,2701,37,0,404,0,6
13014,1,2302,2429,-127,0,268,0,6
13015,2,2439,2552,-113,0,483,0,6
13016,2,2556,2671,-115,0,130,0,6
13017,1,2407,2422,-15,0,225,0,6
13018,2,2491,2577,-86,0,202,0,6
13019,2,2389,2444,-55,0,50,0,6
13020,1,2548,2487,61,0,49,0,6
13021,2,2334,2438,-104,0,327,0,6
13022,2,2426,2298,128,0,82,0,6
13023,1,2378,2478,-100,0,360,1,6
13024,1,2408,2389,19,0,253,0,8
13025,2,2318,2459,-141,0,52,0,6
13026,1,2402,2443,-41,0,80,0,6
13027,1,2338,2434,-96,0,150,0,6
13028,1,2400,2442,-42,0,153,1,6
13029,1,2332,2493,-161,0,0,1,6
13030,2,2431,2433,-2,0,101,0,6
13031,2,2412,2401,11,4,140,1,13
13032,1,2421,2273,148,0,6,0,6
13033,2,2393,2413,-20,0,218,0,6
13034,2,2373,2414,-41,0,1,0,6
13035,1,2410,2310,100,0,5,1,6
13036,1,2406,2389,17,0,4,1,6
13037,3,2521,2623,-102,0,325,0,6
13038,1,2309,2449,-140,0,44,0,6
13039,2,2427,2268,159,0,301,1,6
13040,2,2696,2743,-47,0,255,0,6
13041,2,2587,2555,32,0,143,1,6
13042,2,2351,2411,-60,0,0,1,6
13043,1,2478,2510,-32,0,330,0,6
13044,2,2424,2368,56,0,40,0,6
13045,2,2442,2287,155,0,424,0,6
13046,1,2668,2442,226,0,190,1,6
13047,2,2439,2424,15,0,333,0,6
13048,2,2330,2538,-208,0,344,0,6
13049,1,2436,2421,15,0,119,0,6
13050,1,2441,2315,126,0,106,0,6
13051,2,2443,2317,126,0,7,1,6
13052,1,2511,2272,239,0,453,0,6
13053,1,2328,2416,-88,0,120,0,8
13054,2,2270,2425,-155,0,220,0,6
13055,2,2394,2418,-24,0,395,1,6
13056,1,2416,2405,11,0,13,1,6
13057,2,2375,2445,-70,0,1,0,6
13058,1,2530,2517,13,0,156,0,6
13059,3,2415,2483,-68,0,242,0,6
13060,1,2596,2616,-20,0,121,0,6
13061,1,2514,2459,55,0,102,0,6
13062,2,2465,2487,-22,0,269,1,6
13063,1,2363,2426,-63,0,190,0,6
13064,2,2437,2408,29,0,130,1,6
13065,2,2552,2553,-1,0,150,0,6
13066,1,2416,2419,-3,0,138,0,6
13067,1,2603,2509,94,0,122,0,6
13068,1,2510,2536,-26,0,182,1,6
13069,2,2471,2491,-20,0,121,0,6
13070,2,2744,2670,74,0,300,0,6
13071,1,2564,2675,-111,0,157,1,6
13072,1,2435,2387,48,0,131,0,6
13073,1,2748,2691,57,0,302,0,6
13074,1,2525,2381,144,0,41,0,6
13075,3,2327,2419,-92,0,45,0,6
13076,2,2301,2419,-118,0,46,0,6
13077,2,2422,2429,-7,0,106,0,6
13078,1,2306,2414,-108,0,103,0,6
13079,1,2541,2406,135,0,201,0,6
13080,2,2534,2571,-37,0,45,1,6
13081,1,2359,2415,-56,0,490,0,6
13082,2,2560,2607,-47,0,213,1,6
13083,3,2539,2505,34,0,246,0,6
13084,1,2621,2580,41,0,190,1,6
13085,1,2504,2327,177,0,403,1,6
13086,3,2355,2519,-164,0,140,0,6
13087,1,2492,2437,55,0,7,0,6
13088,1,2514,2434,80,0,302,0,6
13089,2,2336,2409,-73,0,341,0,6
13090,1,2449,2370,79,0,106,0,6
13091,1,2433,2325,108,0,456,1,6
13092,1,2413,2442,-29,0,121,0,6
13093,3,2423,2375,48,0,43,0,6
13094,1,2511,2358,153,0,15,0,6
13095,2,2610,2602,8,0,453,0,6
13096,1,2529,2403,126,0,463,0,6
13097,2,2545,2454,91,0,104,0,6
13098,1,2492,2450,42,0,11,1,6
13099,1,2409,2401,8,0,40,0,8
13100,3,2460,2545,-85,0,201,0,6
13101,2,2423,2416,7,0,302,0,6
13102,1,2451,2432,19,0,290,0,6
13103,2,2440,2671,-231,0,341,1,6
13104,2,2400,2305,95,0,339,0,6
13105,1,2686,2612,74,0,320,0,6
13106,2,2382,2440,-58,0,4,0,6
13107,1,2402,2372,30,0,45,1,6
13108,1,2400,2352,48,0,210,0,6
13109,1,2415,2430,-15,0,57,1,6
13110,3,2535,2631,-96,0,106,0,6
13111,2,2400,2396,4,0,112,0,6
13112,3,2529,2427,102,0,207,0,6
13113,2,2539,2525,14,0,170,0,6
13114,3,2508,2416,92,0,5,0,6
13115,2,2414,2367,47,0,123,0,6
13116,3,2497,2466,31,0,256,0,6
13117,1,2658,2506,152,0,442,0,6
13118,3,2463,2328,135,0,106,0,5
13119,2,2532,2404,128,0,130,0,6
13120,2,2528,2390,138,0,46,0,6
13121,1,2331,2454,-123,0,0,0,6
13122,2,2366,2516,-150,0,1,0,6
13123,2,2555,2559,-4,0,4,0,6
13124,1,2514,2334,180,0,45,1,6
13125,1,2399,2409,-10,0,464,0,6
13126,2,2407,2330,77,0,402,1,6
13127,1,2436,2419,17,0,128,0,6
13128,2,2354,2412,-58,0,130,0,6
13129,3,2608,2582,26,0,202,0,6
13130,1,2691,2629,62,0,414,0,6
13131,1,2450,2366,84,0,307,1,6
13132,2,2324,2507,-183,0,41,0,6
13133,1,2531,2537,-6,0,301,0,6
13134,1,2407,2385,22,4,130,1,13
13135,1,2608,2604,4,0,121,0,6
13136,1,2239,2414,-175,0,20,1,8
13137,1,2437,2396,41,0,106,0,6
13138,1,2492,2353,139,0,484,1,6
13139,3,2409,2298,111,0,207,0,6
13140,2,2436,2497,-61,0,106,1,6
13141,2,2373,2422,-49,0,253,0,6
13142,1,2575,2616,-41,0,330,0,6
13143,1,2417,2357,60,0,201,0,6
13144,2,2544,2461,83,0,43,0,6
13145,2,2381,2524,-143,0,132,0,6
13146,1,2520,2362,158,0,0,0,6
13147,1,2516,2358,158,0,389,0,6
13148,2,2446,2431,15,0,277,1,6
13149,1,2407,2407,0,0,123,0,6
13150,1,2427,2395,32,0,110,1,6
13151,2,2466,2518,-52,0,121,0,6
13152,2,2422,2265,157,0,40,0,6
13153,2,2564,2484,80,0,119,0,6
13154,2,2504,2507,-3,0,453,0,6
13155,2,2418,2510,-92,0,106,1,6
13156,1,2404,2417,-13,0,46,0,6
13157,1,2405,2276,129,0,216,0,6
13158,2,2502,2546,-44,0,333,0,6
13159,1,2662,2536,126,0,96,0,6
13160,2,2379,2422,-43,0,46,1,6
13161,1,2424,2347,77,0,202,0,6
13162,2,2427,2283,144,0,302,0,6
13163,1,2458,2319,139,0,400,0,6
13164,2,2377,2403,-26,0,102,0,6
13165,3,2531,2531,0,0,320,0,6
13166,1,2461,2528,-67,0,123,0,6
13167,2,2479,2550,-71,0,373,0,6
13168,2,2353,2414,-61,0,0,0,6
13169,2,2423,2368,55,0,157,1,6
13170,2,2507,2496,11,0,253,0,6
13171,2,2398,2481,-83,0,373,1,6
13172,2,2624,2696,-72,0,25,0,6
13173,2,2240,2400,-160,0,105,1,6
13174,2,2536,2495,41,0,120,1,6
13175,1,2551,2497,54,0,150,0,6
13176,1,2414,2441,-27,0,121,1,6
13177,2,2370,2407,-37,0,122,1,6
13178,2,2361,2455,-94,0,41,0,6
13179,1,2599,2614,-15,0,382,0,6
13180,1,2609,2483,126,0,133,0,6
13181,2,2275,2401,-126,0,330,1,6
13182,1,2359,2523,-164,0,1,0,6
13183,1,2442,2290,152,0,335,0,6
13184,2,2352,2480,-128,0,339,1,8
13185,2,2492,2639,-147,0,302,0,6
13186,1,2556,2532,24,0,200,0,6
13187,2,2343,2429,-86,0,113,0,6
13188,3,2345,2468,-123,0,45,0,6
13189,1,2537,2557,-20,0,45,0,6
13190,1,2648,2315,333,0,108,0,5
13191,1,2354,2519,-165,0,100,1,6
13192,2,2291,2420,-129,0,363,0,6
13193,1,2419,2251,168,0,122,0,6
13194,1,2419,2321,98,0,432,0,6
13195,2,2666,2650,16,0,464,1,6
13196,2,2554,2718,-164,0,37,0,6
13197,1,2515,2498,17,0,306,0,6
13198,2,2402,2395,7,0,100,0,8
13199,2,2512,2461,51,0,335,1,6
13200,1,2414,2523,-109,0,141,0,6
13201,1,2432,2390,42,0,110,1,6
13202,1,2485,2379,106,0,110,0,6
13203,1,2401,2237,164,0,300,0,6
13204,3,2531,2531,0,0,133,0,6
13205,1,2427,2459,-32,0,9,1,6
13206,1,2445,2501,-56,0,405,1,6
13207,3,2465,2777,-312,0,121,0,6
13208,2,2479,2613,-134,0,344,0,6
13209,2,2372,2527,-155,0,202,0,6
13210,1,2401,2390,11,0,45,0,8
13211,2,2334,2419,-85,0,106,0,6
13212,3,2643,2489,154,0,405,0,6
13213,2,2554,2475,79,0,373,1,6
13214,2,2403,2269,134,0,412,0,6
13215,3,2396,2423,-27,0,302,0,6
13216,1,2406,2294,112,0,345,0,8
13217,1,2408,2344,64,0,280,0,6
13218,2,2620,2562,58,0,305,0,6
13219,1,2414,2399,15,0,49,1,6
13220,2,2608,2605,3,0,256,1,6
13221,1,2435,2420,15,0,128,0,6
13222,2,2376,2420,-44,0,49,0,6
13223,2,2412,2341,71,0,180,1,6
13224,1,2437,2514,-77,0,479,0,6
13225,1,2522,2375,147,0,125,0,6
13226,1,2459,2307,152,0,107,0,6
13227,1,2489,2304,185,0,0,0,6
13228,2,2492,2551,-59,0,40,0,6
13229,3,2298,2445,-147,0,492,0,6
13230,3,2473,2429,44,0,395,0,6
13231,1,2405,2378,27,0,123,0,6
13232,2,2411,2347,64,0,463,0,6
13233,2,2360,2493,-133,0,133,0,6
13234,1,2423,2287,136,0,302,0,6
13235,1,2466,2347,119,0,203,0,6
13236,1,2370,2410,-40,0,224,1,6
13237,2,2539,2394,145,0,107,0,6
13238,1,2433,2339,94,0,202,0,6
13239,2,2531,2437,94,0,380,0,6
13240,1,2646,2588,58,0,484,0,6
13241,1,2317,2405,-88,0,48,0,6
13242,1,2437,2367,70,0,106,0,6
13243,2,2436,2471,-35,0,201,0,6
13244,1,2516,2493,23,0,200,0,6
13245,1,2465,2421,44,0,335,0,6
13246,2,2385,2401,-16,0,315,0,6
13247,1,2721,2668,53,0,112,0,6
13248,3,2491,2640,-149,0,414,0,6
13249,2,2486,2373,113,0,202,1,6
13250,1,2453,2434,19,0,45,1,6
13251,2,2377,2492,-115,0,112,0,6
13252,2,2649,2331,318,0,106,0,5
13253,1,2617,2660,-43,0,253,0,6
13254,2,2354,2413,-59,0,25,0,6
13255,2,2468,2506,-38,0,121,1,6
13256,2,2324,2416,-92,0,241,1,6
13257,2,2376,2518,-142,0,218,0,6
13258,1,2500,2531,-31,0,278,0,6
13259,1,2499,2482,17,0,226,0,6
13260,1,2521,2360,161,0,121,0,6
13261,1,2370,2427,-57,0,250,0,6
13262,2,2488,2634,-146,0,46,0,6
13263,1,2442,2348,94,0,200,1,6
13264,2,2296,2470,-174,4,140,0,23
13265,2,2372,2547,-175,0,112,0,6
13266,1,2418,2363,55,0,106,0,6
13267,2,2446,2314,132,0,301,0,6
13268,2,2407,2484,-77,0,300,0,8
13269,2,2338,2496,-158,0,454,0,6
13270,1,2611,2602,9,0,404,0,6
13271,3,2414,2441,-27,0,121,0,6
13272,2,2393,2443,-50,0,101,0,6
13273,2,2700,2613,87,0,106,0,6
13274,2,2348,2487,-139,0,304,0,6
13275,1,2372,2410,-38,0,145,0,6
13276,1,2556,2524,32,0,106,0,6
13277,1,2507,2444,63,0,290,1,6
13278,2,2376,2405,-29,0,43,1,6
13279,2,2406,2380,26,0,300,1,6
13280,3,2355,2470,-115,0,152,0,6
13281,2,2413,2394,19,4,201,0,13
13282,2,2476,2431,45,0,15,0,6
13283,1,2525,2505,20,0,277,1,6
13284,2,2522,2416,106,0,398,1,6
13285,1,2506,2322,184,0,20,0,6
13286,1,2438,2580,-142,0,301,0,6
13287,3,2638,2661,-23,0,372,0,6
13288,2,2494,2653,-159,0,46,0,6
13289,1,2237,2410,-173,0,335,0,8
13290,2,2412,2402,10,0,464,0,6
13291,1,2459,2477,-18,0,45,0,6
13292,1,2425,2377,48,0,109,0,6
13293,1,2420,2320,100,0,343,1,6
13294,1,2569,2623,-54,0,119,1,6
13295,2,2597,2616,-19,0,112,0,6
13296,3,2404,2487,-83,0,304,0,6
13297,1,2381,2423,-42,0,300,1,6
13298,1,2471,2290,181,0,300,0,6
13299,2,2200,2434,-234,0,101,0,6
13300,1,2358,2511,-153,0,1,1,6
13301,2,2472,2377,95,0,403,0,6
13302,3,2463,2650,-187,0,253,0,6
13303,1,2319,2486,-167,0,200,0,6
13304,1,2369,2446,-77,0,253,1,6
13305,2,2317,2453,-136,0,310,0,5
13306,1,2499,2268,231,0,150,0,6
13307,3,2657,2693,-36,0,447,0,6
13308,2,2440,2415,25,0,104,0,6
13309,2,2359,2418,-59,0,25,0,6
13310,3,2636,2490,146,0,193,0,6
13311,1,2448,2300,148,0,124,1,6
13312,1,2507,2397,110,0,374,0,8
13313,1,2410,2254,156,0,400,0,6
13314,2,2232,2400,-168,0,3,1,6
13315,1,2418,2463,-45,0,427,0,6
13316,2,2404,2379,25,0,45,0,6
13317,2,2468,2519,-51,0,128,0,6
13318,2,2470,2620,-150,0,4,1,6
13319,2,2264,2443,-179,0,257,0,6
13320,1,2622,2591,31,0,5,0,6
13321,1,2562,2474,88,0,200,0,6
13322,2,2437,2450,-13,0,156,0,6
13323,2,2367,2431,-64,0,192,1,6
13324,1,2471,2465,6,0,108,1,6
13325,1,2515,2530,-15,0,344,0,6
13326,1,2386,2425,-39,0,354,0,6
13327,1,2405,2446,-41,0,101,0,6
13328,2,2321,2400,-79,0,380,0,6
13329,3,2661,2639,22,0,404,0,6
13330,1,2402,2402,0,0,40,0,8
13331,1,2452,2402,50,0,107,0,6
13332,3,2568,2657,-89,0,255,0,6
13333,2,2617,2576,41,0,140,0,6
13334,2,2637,2592,45,0,120,0,6
13335,2,2417,2413,4,0,310,1,6
13336,2,2524,2464,60,0,200,0,6
13337,1,2355,2478,-123,0,311,1,6
13338,2,2440,2512,-72,0,479,0,6
13339,1,2410,2371,39,0,415,0,6
13340,3,2402,2355,47,0,115,0,6
13341,2,2413,2366,47,0,106,0,6
13342,2,2501,2387,114,0,200,0,6
13343,1,2391,2439,-48,0,0,0,6
13344,2,2393,2511,-118,0,302,0,8
13345,1,2640,2251,389,0,222,0,5
13346,3,2457,2313,144,0,45,0,5
13347,1,2470,2634,-164,0,120,0,6
13348,2,2382,2452,-70,0,101,0,6
13349,2,2384,2400,-16,0,151,0,6
13350,2,2327,2424,-97,0,268,0,6
13351,1,2493,2521,-28,0,46,0,6
13352,2,2397,2457,-60,0,201,0,6
13353,1,2436,2229,207,0,46,0,6
13354,2,2433,2394,39,0,194,0,6
13355,2,2397,2556,-159,0,46,0,8
13356,2,2586,2627,-41,0,106,0,6
13357,2,2409,2353,56,0,45,0,6
13358,2,2371,2408,-37,0,300,0,8
13359,1,2403,2397,6,0,4,0,6
13360,1,2624,2484,140,0,0,0,6
13361,1,2456,2314,142,0,56,0,6
13362,1,2316,2471,-155,0,40,0,6
13363,2,2405,2434,-29,0,152,0,6
13364,1,2405,2423,-18,0,305,0,6
13365,1,2566,2459,107,0,226,1,6
13366,2,2411,2376,35,0,302,1,6
13367,1,2456,2389,67,0,7,0,6
13368,3,2639,2661,-22,0,15,0,6
13369,2,2466,2420,46,0,334,0,6
13370,1,2476,2494,-18,0,389,0,6
13371,1,2418,2426,-8,0,344,0,6
13372,1,2656,2470,186,0,448,0,6
13373,1,2518,2424,94,0,107,0,6
13374,3,2392,2460,-68,0,354,0,6
13375,2,2373,2419,-46,0,1,0,6
13376,1,2405,2391,14,0,45,0,6
13377,1,2600,2631,-31,0,100,1,6
13378,1,2436,2382,54,0,165,0,6
13379,1,2626,2479,147,0,145,0,6
13380,2,2524,2506,18,0,103,0,6
13381,1,2519,2395,124,0,302,0,6
13382,2,2515,2456,59,0,303,1,6
13383,1,2517,2435,82,0,290,0,6
13384,2,2377,2441,-64,0,195,0,6
13385,1,2449,2457,-8,0,324,0,6
13386,2,2463,2405,58,0,123,1,6
13387,1,2402,2322,80,4,245,0,8
13388,1,2421,2421,0,0,270,1,6
13389,1,2377,2403,-26,0,302,0,6
13390,1,2499,2522,-23,0,327,0,6
13391,2,2482,2462,20,0,200,0,6
13392,1,2349,2430,-81,0,0,1,6
13393,1,2512,2505,7,0,40,0,6
13394,1,2415,2361,54,0,57,0,6
13395,1,2406,2317,89,0,190,0,6
13396,1,2522,2432,90,0,0,0,6
13397,2,2518,2598,-80,0,402,1,6
13398,1,2435,2498,-63,0,123,0,6
13399,2,2451,2433,18,0,301,0,6
13400,2,2467,2570,-103,0,151,0,6
13401,2,2481,2546,-65,0,302,0,6
13402,3,2515,2659,-144,0,440,0,6
13403,3,2639,2693,-54,0,487,0,6
13404,2,2544,2439,105,0,15,1,6
13405,3,2473,2581,-108,0,5,0,6
13406,2,2439,2409,30,0,102,0,6
13407,2,2501,2391,110,0,312,1,6
13408,2,2459,2393,66,0,302,0,6
13409,1,2660,2664,-4,0,398,0,6
13410,2,2559,2553,6,0,405,0,8
13411,1,2427,2324,103,0,402,1,6
13412,2,2424,2368,56,0,40,1,6
13413,1,2402,2257,145,0,45,0,6
13414,1,2408,2410,-2,0,365,1,6
13415,2,2302,2478,-176,0,130,0,6
13416,1,2413,2393,20,0,40,0,8
13417,1,2519,2505,14,0,438,0,6
13418,1,2516,2475,41,0,121,0,6
13419,3,2490,2373,117,0,90,0,6
13420,2,2267,2400,-133,0,107,0,6
13421,2,2657,2517,140,0,442,0,6
13422,1,2417,2304,113,0,136,0,6
13423,2,2625,2629,-4,0,120,0,6
13424,2,2371,2508,-137,0,53,0,6
13425,2,2439,2445,-6,0,320,0,6
13426,1,2463,2313,150,0,300,0,6
13427,2,2364,2551,-187,0,0,0,6
13428,2,2384,2411,-27,0,15,0,6
13429,2,2415,2433,-18,0,455,0,6
13430,2,2476,2426,50,0,302,1,6
13431,1,2415,2372,43,0,372,0,6
13432,2,2412,2547,-135,0,7,0,6
13433,1,2406,2305,101,0,112,0,6
13434,2,2264,2473,-209,4,45,0,23
13435,1,2447,2415,32,0,105,1,6
13436,1,2489,2554,-65,0,409,1,8
13437,2,2474,2529,-55,0,8,0,6
13438,2,2253,2438,-185,0,48,0,6
13439,3,2500,2525,-25,0,57,0,6
13440,1,2262,2400,-138,4,330,1,13
13441,2,2579,2527,52,0,202,1,6
13442,2,2470,2521,-51,0,128,0,6
13443,3,2436,2334,102,0,210,0,6
13444,2,2390,2404,-14,0,485,0,6
13445,2,2430,2456,-26,0,474,1,6
13446,3,2302,2403,-101,0,380,0,6
13447,1,2648,2514,134,0,302,0,6
13448,1,2439,2497,-58,0,151,0,6
13449,1,2356,2449,-93,0,130,0,6
13450,2,2418,2325,93,0,41,1,8
13451,1,2692,2659,33,0,414,1,6
13452,2,2455,2365,90,0,110,0,6
13453,2,2455,2640,-185,0,347,0,6
13454,1,2431,2286,145,0,15,0,6
13455,2,2604,2531,73,0,331,1,6
13456,1,2401,2320,81,0,343,1,6
13457,2,2438,2409,29,0,102,1,6
13458,2,2526,2431,95,0,249,0,6
13459,1,2466,2351,115,0,325,0,6
13460,1,2375,2418,-43,0,0,0,6
13461,3,2375,2489,-114,0,114,0,6
13462,2,2574,2603,-29,0,0,0,6
13463,1,2410,2235,175,0,190,0,6
13464,2,2512,2411,101,0,40,0,6
13465,2,2388,2430,-42,0,45,0,8
13466,1,2445,2251,194,0,40,0,5
13467,2,2405,2356,49,0,45,0,6
13468,2,2635,2619,16,0,100,0,6
13470,2,2367,2405,-38,0,258,0,6
13471,1,2286,2421,-135,0,246,0,6
13472,2,2433,2408,25,0,196,1,6
13473,1,2518,2369,149,0,378,0,6
13474,2,2295,2445,-150,0,46,1,6
13475,2,2609,2569,40,0,154,0,6
13476,3,2525,2500,25,0,434,0,6
13477,1,2420,2392,28,0,307,1,6
13478,1,2433,2539,-106,0,345,1,6
13479,2,2318,2441,-123,0,34,0,6
13480,2,2534,2573,-39,0,386,0,6
13481,2,2625,2629,-4,0,107,0,6
13482,1,2470,2526,-56,0,4,1,6
13483,1,2455,2323,132,0,45,1,6
13484,2,2466,2678,-212,0,162,0,6
13485,2,2381,2435,-54,0,0,0,6
13486,3,2410,2470,-60,0,20,0,6
13487,2,2411,2298,113,0,90,1,6
13488,1,2416,2379,37,0,305,0,6
13489,1,2500,2452,48,0,123,1,6
13490,1,2643,2510,133,0,326,0,6
13491,1,2402,2353,49,0,260,0,6
13492,1,2487,2377,110,0,84,0,6
13493,1,2316,2429,-113,0,46,0,6
13494,2,2653,2697,-44,0,414,0,6
13495,2,2441,2337,104,0,426,1,6
13496,2,2538,2598,-60,0,122,0,6
13497,2,2347,2502,-155,0,302,0,6
13498,1,2436,2547,-111,0,10,0,8
13500,1,2416,2432,-16,0,107,0,6
13501,1,2569,2651,-82,0,28,0,6
13502,1,2512,2520,-8,0,4,1,6
13503,2,2390,2555,-165,0,310,0,6
13504,2,2575,2602,-27,0,101,0,6
13505,2,2490,2372,118,0,41,0,6
13507,1,2283,2424,-141,0,220,1,6
13508,2,2259,2411,-152,0,107,1,6
13509,1,2438,2406,32,0,330,0,6
13510,2,2635,2620,15,0,100,0,6
13511,1,2501,2524,-23,0,414,1,6
13512,2,2438,2282,156,0,150,0,6
13513,1,2487,2400,87,0,335,0,6
13514,1,2439,2376,63,0,40,0,6
13515,2,2424,2281,143,0,301,0,6
13516,2,2537,2554,-17,0,107,0,6
13517,1,2680,2463,217,0,5,0,6
13518,1,2620,2468,152,0,102,0,6
13519,1,2362,2405,-43,0,195,0,6
13520,1,2445,2284,161,0,9,0,6
13521,1,2578,2528,50,0,202,1,6
13522,3,2647,2576,71,0,60,0,6
13523,1,2507,2653,-146,0,46,1,6
13524,1,2422,2344,78,0,4,0,6
13525,2,2648,2644,4,0,414,0,6
13526,1,2602,2533,69,0,311,0,6
13527,1,2614,2476,138,0,245,0,6
13528,1,2362,2519,-157,0,128,0,6
13529,2,2419,2525,-106,0,45,0,6
13531,2,2469,2411,58,0,307,0,6
13532,1,2314,2459,-145,0,1,0,6
13533,2,2373,2491,-118,0,11,1,6
13534,2,2359,2436,-77,0,163,1,6
13535,2,2306,2402,-96,0,66,0,6
13536,2,2482,2441,41,0,4,0,6
13537,2,2347,2407,-60,0,170,0,6
13538,2,2372,2502,-130,0,453,0,6
13539,2,2340,2525,-185,0,40,0,6
13540,3,2440,2447,-7,0,301,0,6
13541,1,2417,2342,75,0,102,1,6
13542,2,2683,2618,65,0,5,0,6
13543,1,2584,2460,124,0,337,0,6
13544,3,2473,2718,-245,0,4,0,6
13545,1,2404,2256,148,0,400,0,6
13546,2,2358,2434,-76,0,380,0,6
13547,1,2411,2342,69,0,0,0,6
13548,1,2607,2570,37,0,140,0,6
13549,1,2422,2357,65,0,47,0,6
13550,3,2400,2369,31,0,12,0,6
13551,1,2317,2426,-109,0,474,0,6
13552,2,2384,2629,-245,0,45,0,6
13553,1,2450,2357,93,0,6,0,6
13554,2,2415,2255,160,0,230,1,6
13555,2,2560,2425,135,0,200,0,6
13556,1,2565,2613,-48,0,13,1,6
13557,2,2643,2550,93,0,345,0,6
13558,2,2430,2282,148,0,277,0,6
13559,2,2626,2629,-3,0,107,0,6
13560,1,2416,2302,114,0,40,0,6
13561,2,2518,2507,11,0,46,0,6
13562,1,2406,2396,10,0,0,0,6
13563,1,2476,2372,104,0,4,0,6
13564,2,2407,2337,70,0,330,0,6
13565,2,2625,2676,-51,0,162,0,6
13566,1,2514,2512,2,0,302,0,6
13567,1,2416,2444,-28,0,278,0,6
13568,1,2457,2531,-74,0,107,0,6
13569,1,2524,2583,-59,0,57,0,6
13570,1,2506,2480,26,0,106,0,6
13571,1,2645,2578,67,0,4,0,6
13572,1,2294,2413,-119,0,149,0,6
13573,1,2532,2368,164,0,4,0,6
13574,1,2528,2337,191,0,200,1,6
13575,2,2505,2384,121,0,315,0,6
13576,2,2342,2451,-109,0,106,1,6
13577,1,2364,2407,-43,0,195,0,6
13578,2,2477,2422,55,0,7,0,6
13579,2,2511,2526,-15,0,101,0,6
13580,2,2370,2411,-41,0,312,0,6
13581,3,2417,2462,-45,0,13,0,6
13582,1,2414,2296,118,0,46,0,6
13584,1,2450,2288,162,0,140,0,6
13585,1,2540,2552,-12,0,4,0,6
13587,2,2576,2530,46,0,202,0,6
13588,1,2573,2515,58,0,6,0,6
13589,1,2401,2438,-37,0,1,0,6
13590,2,2260,2413,-153,0,190,1,8
13591,2,2476,2452,24,0,8,1,6
13592,2,2440,2624,-184,0,40,0,6
13593,3,2715,2681,34,0,4,0,6
13594,1,2558,2454,104,0,4,0,6
13595,1,2346,2440,-94,0,43,0,6
13596,2,2447,2437,10,0,101,0,6
13597,1,2283,2412,-129,0,40,0,6
13598,2,2448,2486,-38,0,9,0,6
13599,3,2631,2636,-5,0,302,0,6
13600,2,2381,2475,-94,0,41,0,6
13601,2,2464,2511,-47,0,202,0,6
13602,3,2372,2407,-35,0,201,0,6
13603,1,2440,2313,127,0,46,1,6
13604,1,2606,2572,34,0,154,0,6
13605,1,2402,2369,33,0,300,0,6
13606,2,2510,2588,-78,0,278,0,6
13607,1,2470,2343,127,0,4,0,6
13608,2,2402,2438,-36,0,13,0,6
13609,2,2307,2416,-109,0,199,0,6
13610,2,2428,2341,87,0,140,0,6
13611,2,2634,2620,14,0,100,0,6
13612,1,2538,2507,31,0,4,0,6
13613,1,2441,2370,71,0,16,1,6
13614,1,2364,2401,-37,0,1,0,6
13615,1,2433,2315,118,0,301,1,6
13616,2,2421,2506,-85,0,300,0,6
13617,1,2431,2407,24,0,106,0,6
13618,1,2546,2474,72,0,120,1,6
13619,2,2356,2438,-82,0,5,0,6
13620,1,2455,2415,40,0,131,1,6
13621,1,2650,2666,-16,0,380,1,6
13622,1,2400,2222,178,0,426,0,6
13623,2,2427,2331,96,0,112,0,6
13624,2,2334,2531,-197,0,485,1,6
13625,2,2462,2418,44,0,40,1,6
13626,1,2252,2400,-148,0,40,0,6
13627,1,2520,2546,-26,0,43,0,6
13628,1,2392,2413,-21,0,182,0,6
13629,1,2558,2498,60,0,131,0,6
13630,1,2537,2570,-33,0,386,1,6
13631,2,2506,2464,42,0,121,1,6
13632,2,2450,2441,9,0,4,1,6
13633,1,2419,2335,84,0,103,0,6
13634,2,2420,2421,-1,0,41,0,6
13635,2,2454,2383,71,0,145,0,6
13636,2,2512,2513,-1,0,335,0,6
13637,2,2327,2422,-95,0,303,1,6
13638,1,2566,2611,-45,0,36,0,6
13639,1,2406,2459,-53,0,211,1,6
13640,3,2332,2409,-77,0,122,0,6
13641,2,2682,2714,-32,0,13,1,6
13642,1,2578,2470,108,0,302,1,6
13643,2,2314,2437,-123,0,101,0,6
13644,1,2402,2437,-35,0,0,0,6
13645,3,2406,2288,118,0,453,0,6
13647,1,2348,2421,-73,0,10,0,6
13648,1,2569,2531,38,0,110,1,6
13649,2,2270,2404,-134,0,100,1,6
13650,1,2465,2272,193,0,106,0,6
13651,2,2592,2631,-39,0,466,0,6
13652,1,2373,2421,-48,0,121,1,6
13653,2,2489,2359,130,0,57,0,6
13654,1,2526,2635,-109,0,151,0,6
13655,2,2460,2500,-40,0,10,0,6
13656,1,2627,2437,190,0,37,1,6
13657,1,2443,2296,147,0,300,0,6
13658,2,2506,2532,-26,0,145,0,6
13659,2,2626,2629,-3,0,41,0,6
13660,1,2418,2380,38,0,305,1,6
13661,2,2366,2445,-79,0,194,0,6
13662,1,2460,2493,-33,0,330,1,6
13663,2,2359,2407,-48,0,140,1,6
13664,2,2368,2551,-183,0,315,0,6
13665,3,2282,2423,-141,0,469,0,6
13666,1,2660,2640,20,0,61,1,6
13667,2,2447,2550,-103,0,297,1,6
13668,1,2576,2582,-6,0,426,0,6
13669,2,2344,2417,-73,0,302,0,6
13670,2,2322,2476,-154,0,200,0,6
13671,1,2300,2447,-147,0,57,1,6
13672,2,2409,2331,78,0,202,0,6
13673,2,2416,2248,168,0,344,0,8
13674,1,2415,2354,61,0,202,0,6
13675,2,2564,2543,21,0,201,1,6
13676,2,2511,2499,12,0,128,1,6
13677,1,2425,2455,-30,0,13,0,6
13678,1,2556,2470,86,0,21,0,6
13679,2,2605,2573,32,0,106,1,6
13680,2,2443,2270,173,0,427,1,6
13681,2,2431,2408,23,0,130,1,6
13682,1,2266,2405,-139,0,41,0,6
13683,2,2440,2329,111,0,106,0,6
13684,1,2408,2333,75,0,200,0,6
13685,1,2518,2507,11,0,58,0,6
13686,1,2441,2310,131,0,45,0,6
13687,1,2587,2428,159,0,265,0,6
13688,1,2434,2323,111,0,301,1,6
13689,1,2365,2414,-49,0,1,1,6
13690,1,2400,2361,39,0,44,0,6
13691,1,2520,2540,-20,0,123,0,6
13692,1,2496,2522,-26,0,102,0,6
13693,1,2414,2355,59,0,140,0,6
13694,1,2412,2361,51,0,131,1,6
13695,1,2376,2403,-27,0,112,0,6
13696,1,2445,2303,142,0,4,1,6
13697,2,2466,2720,-254,0,8,0,6
13698,2,2312,2401,-89,0,124,0,6
13699,1,2548,2500,48,0,334,1,6
13700,1,2634,2620,14,0,40,0,6
13701,1,2575,2415,160,0,150,0,6
13702,2,2434,2630,-196,0,40,0,6
13703,3,2507,2526,-19,0,101,0,6
13704,1,2415,2315,100,0,122,0,6
13705,2,2328,2412,-84,0,122,0,6
13706,1,2460,2414,46,0,109,0,8
13707,1,2421,2340,81,0,40,0,6
13708,1,2431,2374,57,0,302,0,6
13709,1,2420,2361,59,0,112,0,6
13710,2,2427,2330,97,0,218,0,6
13711,1,2656,2650,6,0,46,0,6
13712,2,2405,2578,-173,0,484,0,6
13713,3,2426,2426,0,0,43,0,6
13714,1,2387,2412,-25,0,412,1,6
13715,1,2305,2445,-140,0,101,1,6
13716,2,2554,2576,-22,0,405,0,6
13717,2,2381,2406,-25,0,40,0,6
13718,1,2487,2466,21,0,344,0,6
13719,1,2581,2604,-23,0,28,0,6
13720,1,2449,2431,18,0,4,1,6
13721,1,2322,2403,-81,0,265,0,6
13723,1,2443,2554,-111,0,291,0,6
13724,1,2534,2526,8,0,131,0,6
13725,2,2466,2501,-35,0,192,0,6
13726,2,2319,2452,-133,0,200,0,6
13727,1,2375,2450,-75,0,45,0,6
13728,1,2377,2403,-26,0,112,0,6
13729,2,2549,2558,-9,0,386,0,6
13730,1,2439,2287,152,0,455,0,6
13731,2,2505,2607,-102,0,200,0,6
13732,1,2298,2481,-183,0,200,1,6
13733,2,2408,2513,-105,0,448,0,8
13734,1,2414,2424,-10,0,0,1,6
13735,1,2506,2517,-11,0,40,0,6
13736,1,2361,2419,-58,0,84,0,6
13737,2,2485,2436,49,0,315,0,6
13738,3,2319,2469,-150,0,48,0,6
13739,2,2415,2363,52,0,48,0,6
13740,1,2633,2432,201,0,13,0,6
13741,2,2413,2304,109,0,121,0,6
13742,2,2408,2372,36,0,40,0,6
13743,1,2599,2515,84,0,105,0,6
13744,1,2383,2502,-119,0,40,1,6
13745,2,2376,2406,-30,0,373,0,6
13746,1,2562,2534,28,0,142,0,6
13747,2,2581,2526,55,0,110,0,6
13748,2,2401,2306,95,0,492,0,6
13749,1,2435,2420,15,0,311,0,6
13750,2,2453,2371,82,0,127,0,6
13751,2,2424,2722,-298,0,106,0,6
13752,2,2421,2296,125,0,202,0,6
13753,1,2233,2445,-212,0,302,0,6
13754,1,2356,2413,-57,0,200,0,6
13755,1,2385,2515,-130,0,0,0,6
13756,2,2612,2579,33,0,7,0,6
13757,1,2499,2495,4,0,44,0,6
13758,1,2560,2644,-84,0,10,0,6
13759,1,2547,2507,40,0,120,0,6
13760,1,2448,2320,128,0,48,1,6
13761,2,2402,2397,5,0,38,0,6
13762,1,2506,2461,45,0,440,0,6
13763,2,2426,2372,54,0,211,0,6
13764,2,2450,2436,14,0,301,0,6
13765,2,2419,2451,-32,0,227,1,6
13766,2,2406,2309,97,0,4,1,6
13767,2,2407,2309,98,0,88,0,6
13768,1,2423,2341,82,0,106,1,6
13769,1,2549,2432,117,0,49,0,6
13770,2,2512,2512,0,0,492,1,6
13771,2,2581,2758,-177,0,58,1,6
13772,1,2417,2324,93,0,200,0,6
13773,1,2522,2520,2,0,45,0,6
13774,1,2461,2492,-31,0,300,0,6
13775,2,2454,2557,-103,0,225,0,6
13776,2,2489,2586,-97,0,36,0,6
13777,2,2468,2605,-137,0,321,0,6
13778,2,2363,2501,-138,0,128,0,6
13779,3,2665,2635,30,0,325,0,6
13780,1,2409,2367,42,0,426,0,8
13781,1,2453,2315,138,0,102,1,6
13782,2,2413,2368,45,0,112,0,6
13783,3,2377,2440,-63,0,131,0,6
13784,1,2635,2563,72,0,101,0,6
13785,1,2377,2406,-29,0,232,1,6
13786,2,2399,2442,-43,0,45,0,6
13787,1,2445,2321,124,0,190,0,6
13788,2,2628,2662,-34,0,414,0,6
13789,2,2456,2511,-55,0,136,0,6
13790,1,2724,2423,301,0,303,0,6
13791,2,2212,2479,-267,0,406,0,6
13792,1,2511,2456,55,0,302,0,6
13793,1,2419,2420,-1,0,40,0,6
13794,1,2442,2410,32,0,115,0,6
13795,3,2444,2294,150,0,267,0,6
13796,1,2378,2402,-24,0,0,1,6
13797,2,2428,2241,187,2,15,0,18
13798,1,2637,2603,34,0,6,0,6
13799,1,2412,2490,-78,0,205,0,6
13800,2,2494,2567,-73,0,288,0,6
13801,1,2529,2553,-24,0,7,0,6
13802,2,2440,2591,-151,0,158,0,6
13803,2,2421,2725,-304,0,210,0,6
13804,2,2415,2424,-9,0,269,0,6
13805,1,2417,2348,69,0,339,0,6
13806,1,2515,2386,129,0,125,0,6
13807,3,2304,2413,-109,0,260,0,6
13808,3,2477,2528,-51,0,1,0,6
13809,2,2495,2393,102,0,457,0,6
13810,2,2275,2452,-177,0,41,0,6
13811,1,2512,2426,86,0,113,0,6
13812,1,2590,2552,38,0,20,0,6
13813,2,2390,2483,-93,0,9,0,6
13814,2,2369,2419,-50,0,42,1,6
13815,2,2350,2404,-54,0,302,0,8
13816,1,2412,2323,89,0,45,0,6
13817,2,2329,2410,-81,0,120,0,6
13818,2,2406,2286,120,0,107,0,6
13819,2,2425,2399,26,0,245,0,6
13820,1,2414,2304,110,0,113,0,6
13821,1,2456,2568,-112,0,216,1,6
13822,3,2421,2300,121,0,415,0,6
13823,2,2374,2419,-45,0,40,0,6
13824,2,2401,2359,42,0,123,1,6
13825,2,2516,2451,65,0,353,0,6
13826,1,2486,2456,30,0,404,0,6
13827,1,2727,2419,308,0,28,0,6
13828,1,2631,2505,126,0,332,0,6
13829,3,2342,2442,-100,0,331,0,6
13830,1,2466,2341,125,0,132,1,6
13831,1,2392,2427,-35,0,29,0,6
13832,1,2517,2450,67,0,145,0,6
13833,2,2506,2378,128,0,387,0,6
13834,1,2443,2491,-48,0,148,0,6
13835,2,2463,2311,152,0,484,0,6
13836,2,2386,2413,-27,4,327,0,13
13837,2,2594,2578,16,0,337,0,6
13838,1,2414,2437,-23,0,8,0,6
13839,1,2547,2447,100,0,406,0,6
13840,1,2559,2640,-81,0,269,0,6
13841,1,2535,2575,-40,0,4,0,6
13842,2,2366,2526,-160,0,133,1,6
13843,1,2382,2400,-18,0,45,0,6
13844,3,2403,2397,6,0,484,0,6
13845,2,2447,2275,172,0,250,0,6
13846,1,2394,2478,-84,0,45,1,6
13847,2,2323,2449,-126,0,404,0,6
13848,2,2430,2409,21,0,40,1,6
13849,2,2527,2625,-98,0,41,0,6
13850,1,2419,2372,47,0,207,0,6
13851,2,2539,2490,49,0,140,0,6
13852,2,2598,2643,-45,0,140,1,6
13853,1,2547,2429,118,0,120,0,6
13854,1,2420,2342,78,0,300,0,6
13855,1,2501,2431,70,0,244,0,6
13856,2,2447,2313,134,0,205,1,6
13857,3,2390,2400,-10,0,90,0,6
13858,2,2417,2729,-312,0,210,1,6
13859,2,2407,2405,2,0,352,0,6
13860,1,2595,2667,-72,0,20,0,6
13861,3,2440,2344,96,0,142,0,6
13862,1,2414,2325,89,0,107,0,6
13863,3,2633,2566,67,0,176,0,6
13864,1,2587,2542,45,0,463,0,6
13865,2,2315,2517,-202,0,145,0,6
13866,2,2421,2385,36,0,100,0,6
13867,1,2529,2483,46,0,201,1,6
13868,2,2623,2611,12,0,345,0,6
13869,2,2229,2414,-185,0,41,1,8
13870,2,2427,2455,-28,0,241,0,6
13871,1,2439,2308,131,0,335,0,6
13872,2,2361,2424,-63,0,311,0,6
13873,2,2419,2320,99,0,487,0,6
13874,2,2409,2248,161,0,303,0,6
13875,2,2446,2522,-76,0,124,1,6
13876,3,2386,2416,-30,0,483,0,6
13877,2,2388,2499,-111,0,414,1,6
13878,2,2422,2569,-147,0,46,0,6
13879,1,2329,2439,-110,0,107,0,6
13880,1,2397,2418,-21,0,122,0,6
13881,1,2381,2424,-43,0,200,0,6
13882,2,2458,2551,-93,0,136,0,6
13883,1,2443,2572,-129,0,140,1,6
13884,1,2424,2271,153,0,490,0,6
13885,1,2560,2464,96,0,190,1,6
13886,2,2377,2409,-32,0,300,0,8
13887,1,2552,2491,61,0,14,0,6
13888,2,2516,2368,148,0,311,0,6
13889,2,2306,2439,-133,0,150,0,6
13890,2,2567,2632,-65,0,244,1,6
13891,1,2383,2418,-35,0,312,1,6
13892,2,2400,2397,3,0,189,0,6
13894,1,2415,2319,96,0,0,0,6
13895,2,2555,2454,101,0,337,1,6
13896,2,2515,2523,-8,0,53,0,6
13897,3,2345,2439,-94,0,289,0,6
13898,2,2327,2412,-85,0,105,1,6
13899,2,2629,2584,45,0,1,0,6
13900,1,2402,2232,170,0,142,0,6
13901,1,2484,2449,35,0,278,0,6
13902,1,2462,2351,111,0,40,1,6
13903,1,2497,2356,141,0,123,0,6
13904,1,2425,2412,13,0,56,0,6
13905,1,2291,2438,-147,0,40,0,6
13906,2,2648,2593,55,0,101,0,6
13907,2,2415,2363,52,0,122,0,6
13908,2,2426,2428,-2,0,200,0,6
13909,1,2506,2464,42,0,221,0,6
13910,1,2617,2521,96,0,58,0,6
13911,2,2391,2424,-33,0,1,0,6
13912,2,2362,2460,-98,0,241,0,6
13913,1,2443,2344,99,0,215,0,6
13914,2,2290,2406,-116,0,122,0,6
13915,2,2252,2421,-169,0,103,1,6
13916,1,2412,2342,70,0,225,0,6
13917,1,2731,2416,315,0,40,0,6
13918,1,2403,2403,0,0,122,1,6
13919,2,2557,2422,135,0,22,1,6
13920,1,2478,2487,-9,0,143,0,6
13921,2,2424,2534,-110,0,212,0,6
13922,2,2523,2533,-10,0,392,0,6
13923,1,2419,2209,210,4,247,0,13
13924,2,2429,2465,-36,0,190,0,6
13925,1,2416,2326,90,0,111,0,6
13926,1,2483,2388,95,0,241,1,6
13927,3,2437,2347,90,0,267,0,6
13928,1,2503,2430,73,0,311,1,6
13929,1,2491,2527,-36,0,366,1,6
13930,1,2538,2420,118,0,245,1,6
13931,2,2508,2459,49,0,311,0,6
13932,1,2425,2404,21,0,13,0,6
13933,2,2403,2292,111,0,107,0,6
13934,1,2484,2460,24,0,190,0,6
13935,1,2481,2469,12,0,345,0,6
13936,2,2564,2537,27,0,140,0,6
13937,1,2411,2397,14,0,278,1,6
13938,2,2569,2564,5,0,374,0,6
13939,1,2416,2378,38,0,487,0,6
13940,2,2617,2564,53,0,107,1,6
13941,2,2414,2732,-318,0,112,0,6
13942,1,2419,2548,-129,0,122,1,6
13943,1,2461,2500,-39,0,140,1,6
13944,2,2315,2420,-105,0,490,0,6
13945,1,2411,2353,58,0,113,0,6
13946,1,2501,2473,28,0,123,0,6
13947,2,2467,2568,-101,0,249,0,8
13948,1,2414,2293,121,0,337,0,8
13949,2,2478,2673,-195,0,246,0,6
13950,2,2360,2562,-202,0,3,0,6
13951,2,2318,2420,-102,0,457,0,6
13952,2,2373,2411,-38,0,107,0,6
13953,2,2517,2621,-104,0,190,0,6
13954,2,2401,2371,30,0,49,0,6
13955,2,2287,2405,-118,0,344,0,6
13956,1,2518,2637,-119,0,4,1,6
13957,2,2417,2372,45,0,100,0,8
13958,2,2390,2400,-10,0,48,0,6
13959,1,2408,2502,-94,0,103,1,6
13960,1,2410,2286,124,0,206,1,6
13961,2,2591,2622,-31,0,112,0,6
13962,1,2530,2370,160,0,8,0,8
13963,2,2600,2641,-41,0,100,0,6
13964,2,2517,2466,51,0,315,0,6
13965,2,2572,2538,34,0,205,0,6
13966,1,2489,2381,108,0,200,0,6
13967,3,2443,2401,42,0,57,0,6
13968,1,2734,2412,322,0,48,0,6
13969,1,2408,2454,-46,0,420,1,6
13970,3,2348,2436,-88,0,289,0,6
13971,2,2363,2406,-43,0,56,0,6
13972,3,2390,2636,-246,0,130,0,6
13973,2,2256,2401,-145,0,333,0,6
13974,1,2431,2419,12,0,311,0,6
13975,2,2420,2408,12,0,107,0,6
13976,1,2433,2386,47,0,40,0,6
13977,1,2368,2416,-48,0,48,1,6
13978,1,2430,2468,-38,0,121,0,6
13979,3,2550,2521,29,0,131,0,6
13980,1,2424,2311,113,0,110,0,6
13981,3,2424,2369,55,0,131,0,6
13982,3,2434,2350,84,0,149,0,6
13983,3,2507,2510,-3,0,123,0,6
13984,1,2394,2443,-49,0,200,1,6
13985,1,2414,2351,63,0,122,0,6
13986,2,2426,2414,12,0,265,0,6
13987,1,2401,2349,52,0,10,1,6
13988,2,2416,2542,-126,0,213,1,6
13989,1,2543,2558,-15,0,4,0,6
13990,1,2425,2318,107,0,126,1,6
13991,1,2565,2395,170,0,269,0,6
13992,1,2507,2510,-3,0,485,1,6
13993,1,2409,2284,125,0,262,0,6
13994,2,2633,2472,161,0,250,0,6
13995,2,2444,2490,-46,0,148,0,6
13996,1,2419,2421,-2,0,105,0,6
13997,2,2464,2486,-22,0,302,0,6
13998,2,2418,2322,96,0,312,0,8
13999,2,2311,2493,-182,0,44,0,6
14000,1,2287,2424,-137,0,16,0,6
14002,2,2392,2517,-125,0,18,0,6
14003,1,2628,2586,42,0,111,0,6
14004,1,2447,2348,99,0,100,0,6
14005,2,2347,2416,-69,0,1,1,6
14006,2,2545,2571,-26,0,152,1,6
14007,1,2540,2384,156,0,333,0,6
14008,1,2531,2368,163,0,468,0,6
14009,1,2625,2513,112,0,58,0,6
14010,1,2646,2595,51,0,0,0,6
14011,1,2494,2360,134,0,101,0,6
14012,2,2411,2736,-325,0,112,0,6
14013,2,2326,2463,-137,0,107,0,8
14014,3,2351,2433,-82,0,347,0,6
14015,2,2349,2431,-82,0,307,1,6
14016,1,2242,2410,-168,0,190,0,8
14017,2,2303,2467,-164,0,156,0,6
14018,3,2629,2526,103,0,104,0,6
14019,1,2496,2308,188,0,101,0,6
14020,2,2422,2563,-141,0,1,1,6
14021,1,2625,2467,158,0,404,0,6
14022,1,2282,2414,-132,0,112,0,6
14023,1,2494,2500,-6,0,404,0,6
14024,1,2416,2416,0,0,10,0,6
14025,2,2480,2481,-1,0,8,1,6
14026,1,2420,2317,103,0,40,1,6
14027,2,2492,2458,34,0,345,0,6
14028,1,2525,2569,-44,0,40,0,6
14029,1,2513,2254,259,0,113,0,6
14030,1,2660,2533,127,0,492,1,6
14031,2,2381,2451,-70,0,1,0,6
14032,1,2379,2415,-36,0,234,0,6
14033,2,2342,2415,-73,0,0,0,6
14034,1,2402,2366,36,0,40,0,6
14035,1,2448,2429,19,0,117,0,6
14036,2,2574,2627,-53,0,455,0,6
14037,2,2402,2419,-17,0,107,0,6
14038,2,2358,2409,-51,0,225,0,6
14039,2,2304,2428,-124,0,200,0,6
14041,1,2406,2290,116,0,206,0,6
14042,2,2475,2308,167,0,8,1,6
14043,2,2470,2420,50,0,267,1,6
14044,1,2737,2409,328,0,380,1,6
14045,2,2510,2521,-11,0,41,0,6
14046,1,2464,2628,-164,0,140,0,6
14047,2,2314,2518,-204,0,46,1,6
14048,2,2456,2484,-28,0,106,1,6
14049,2,2483,2442,41,0,122,0,6
14050,2,2417,2436,-19,0,128,0,6
14051,1,2755,2543,212,0,337,0,6
14052,2,2498,2436,62,0,123,1,6
14053,2,2376,2400,-24,0,1,0,6
14054,1,2545,2413,132,0,250,0,6
14055,2,2467,2378,89,0,100,0,8
14056,1,2429,2308,121,0,110,1,6
14057,1,2478,2500,-22,0,102,0,6
14058,2,2280,2413,-133,0,250,1,6
14059,2,2504,2507,-3,0,135,1,6
14060,1,2568,2549,19,0,121,0,6
14061,1,2374,2499,-125,0,206,1,6
14062,1,2416,2425,-9,0,484,1,6
14063,1,2495,2413,82,0,261,1,6
14064,1,2400,2461,-61,0,34,0,6
14065,2,2509,2629,-120,0,190,0,6
14066,2,2465,2486,-21,0,302,1,6
14067,2,2581,2633,-52,0,201,0,6
14068,1,2437,2391,46,0,319,0,6
14069,2,2571,2500,71,0,250,0,6
14070,3,2676,2522,154,0,470,0,6
14071,1,2420,2342,78,0,40,1,6
14072,1,2337,2421,-84,0,0,1,6
14073,2,2427,2400,27,0,200,1,6
14074,3,2437,2574,-137,0,301,0,6
14075,1,2544,2658,-114,0,5,0,6
14076,1,2488,2404,84,0,258,0,6
14077,3,2352,2432,-80,0,289,0,6
14078,2,2357,2539,-182,0,3,1,6
14079,2,2576,2509,67,0,143,1,6
14080,1,2572,2366,206,0,25,0,8
14081,1,2410,2394,16,0,136,0,6
14082,2,2421,2384,37,4,211,0,13
14083,2,2424,2365,59,0,125,1,6
14084,1,2632,2520,112,0,30,1,6
14085,2,2453,2435,18,0,105,1,6
14086,2,2409,2549,-140,0,212,0,6
14087,1,2458,2491,-33,0,6,0,6
14088,2,2567,2418,149,0,4,0,6
14089,2,2406,2409,-3,0,28,1,6
14090,2,2406,2384,22,0,107,1,6
14091,2,2432,2396,36,0,288,0,6
14092,1,2443,2494,-51,0,105,1,6
14093,1,2425,2403,22,0,113,0,6
14094,2,2444,2422,22,0,278,0,6
14095,2,2376,2422,-46,0,176,0,6
14096,1,2473,2371,102,0,106,0,6
14097,2,2460,2402,58,0,152,0,8
14098,1,2551,2550,1,0,4,0,6
14099,1,2590,2566,24,0,115,0,6
14100,1,2526,2393,133,0,49,0,6
14101,1,2311,2451,-140,0,302,0,6
14102,1,2489,2319,170,0,315,0,6
14103,2,2381,2477,-96,0,45,1,6
14104,2,2232,2410,-178,0,46,1,6
14105,2,2521,2504,17,0,123,0,6
14106,1,2421,2302,119,0,14,1,6
14107,1,2449,2399,50,0,40,0,6
14108,2,2677,2472,205,0,5,0,6
14109,2,2299,2412,-113,0,315,0,6
14110,2,2403,2426,-23,0,200,0,6
14111,2,2491,2382,109,0,211,0,6
14112,3,2638,2576,62,0,123,0,6
14113,1,2416,2564,-148,0,104,0,6
14114,2,2457,2291,166,0,414,0,6
14115,1,2492,2297,195,0,110,0,6
14116,1,2414,2345,69,0,43,0,6
14117,1,2498,2442,56,0,204,1,6
14118,1,2372,2429,-57,0,231,0,6
14119,1,2367,2435,-68,0,112,1,8
14120,1,2439,2405,34,0,45,0,6
14121,2,2562,2507,55,0,4,0,6
14122,2,2421,2424,-3,0,132,0,6
14123,2,2323,2404,-81,0,121,0,6
14124,2,2491,2545,-54,0,338,0,6
14125,2,2293,2406,-113,0,203,0,6
14126,2,2477,2474,3,0,194,1,6
14127,1,2276,2428,-152,0,48,0,6
14128,1,2500,2324,176,0,110,1,6
14129,1,2306,2477,-171,0,45,0,6
14130,3,2475,2395,80,0,130,0,6
14131,1,2492,2367,125,0,106,0,6
14132,2,2510,2515,-5,0,58,0,6
14133,1,2564,2557,7,0,57,0,6
14134,1,2572,2407,165,0,5,0,6
14135,1,2530,2451,79,0,46,0,6
14136,2,2541,2411,130,0,345,0,6
14137,1,2485,2464,21,0,315,0,6
14138,2,2417,2379,38,0,201,1,6
14139,1,2371,2427,-56,0,127,0,6
14140,2,2514,2636,-122,0,128,0,6
14141,1,2441,2320,121,0,20,0,6
14142,1,2313,2438,-125,0,1,0,6
14143,1,2572,2398,174,0,112,0,6
14144,2,2294,2430,-136,0,458,0,6
14145,1,2373,2474,-101,0,300,0,6
14146,1,2376,2416,-40,0,458,1,6
14147,1,2556,2488,68,0,80,0,6
14148,1,2430,2526,-96,0,190,1,6
14149,1,2416,2399,17,0,48,1,6
14150,2,2345,2415,-70,0,277,0,6
14151,1,2409,2246,163,0,85,1,6
14152,1,2420,2322,98,0,40,0,6
14153,2,2552,2633,-81,0,190,0,6
14154,2,2481,2668,-187,0,162,0,6
14155,2,2331,2444,-113,0,44,0,6
14156,3,2328,2453,-125,0,107,0,8
14157,1,2443,2494,-51,0,215,1,6
14158,2,2363,2401,-38,0,1,0,6
14159,1,2557,2510,47,0,41,0,6
14160,1,2431,2397,34,0,0,0,6
14161,2,2423,2348,75,0,15,1,6
14162,1,2419,2319,100,0,415,0,6
14163,1,2555,2449,106,0,4,0,6
14164,1,2514,2559,-45,0,291,0,6
14165,2,2400,2493,-93,0,300,0,6
14166,3,2340,2417,-77,0,0,0,6
14167,1,2469,2354,115,0,331,0,6
14168,3,2448,2425,23,0,45,0,6
14169,2,2459,2413,46,0,46,1,6
14170,1,2483,2313,170,0,80,0,6
14171,2,2448,2560,-112,0,301,1,6
14172,1,2389,2409,-20,0,302,1,8
14173,1,2550,2637,-87,0,337,0,6
14174,1,2342,2443,-101,0,49,0,8
14175,2,2459,2438,21,0,13,0,6
14176,1,2486,2486,0,0,80,0,6
14177,2,2447,2415,32,0,267,0,6
14178,2,2345,2469,-124,0,1,0,6
14179,3,2430,2323,107,0,469,0,6
14180,1,2481,2377,104,0,230,1,6
14181,1,2286,2423,-137,0,58,1,6
14182,2,2335,2419,-84,0,176,0,6
14183,2,2499,2445,54,0,279,0,6
14184,1,2548,2575,-27,0,101,0,6
14185,1,2445,2491,-46,0,20,0,6
14186,2,2426,2511,-85,0,300,0,6
14187,2,2552,2478,74,0,5,0,6
14188,2,2529,2521,8,0,320,0,6
14189,1,2497,2398,99,0,484,0,6
14190,1,2374,2411,-37,0,117,0,6
14191,1,2404,2575,-171,0,409,1,6
14192,3,2385,2415,-30,0,40,0,6
14193,2,2551,2620,-69,0,5,0,6
14194,2,2340,2533,-193,0,312,0,6
14195,1,2378,2431,-53,0,142,0,6
14196,2,2415,2386,29,0,198,0,6
14197,2,2437,2534,-97,0,41,0,6
14198,2,2288,2424,-136,0,459,0,6
14199,1,2392,2436,-44,0,100,0,6
14200,1,2373,2415,-42,0,107,0,6
14201,1,2411,2289,122,0,7,1,6
14202,2,2434,2374,60,0,122,0,6
14203,3,2420,2390,30,0,101,0,6
14204,1,2577,2638,-61,0,338,0,6
14205,2,2409,2449,-40,0,1,0,6
14206,1,2488,2350,138,0,200,0,6
14207,2,2467,2249,218,0,106,0,6
14208,2,2248,2423,-175,0,310,1,6
14209,1,2418,2405,13,0,40,1,6
14210,1,2420,2453,-33,0,101,0,6
14211,2,2234,2422,-188,0,140,0,6
14212,3,2402,2378,24,0,45,0,6
14213,1,2425,2358,67,0,11,1,6
14214,1,2394,2408,-14,0,218,0,6
14215,2,2492,2615,-123,0,60,0,6
14216,1,2428,2371,57,0,45,0,6
14217,3,2276,2411,-135,0,41,0,8
14218,3,2630,2557,73,0,46,0,6
14219,2,2454,2404,50,0,152,1,6
14220,3,2491,2564,-73,0,153,0,6
14221,3,2349,2415,-66,0,315,0,6
14222,2,2445,2502,-57,0,103,0,6
14223,1,2422,2428,-6,0,201,0,6
14224,1,2569,2452,117,0,102,1,6
14225,1,2400,2445,-45,0,335,0,6
14226,1,2436,2321,115,0,15,1,8
14227,1,2536,2549,-13,0,337,0,6
14228,1,2300,2451,-151,0,126,0,8
14229,1,2481,2494,-13,0,311,0,6
14230,2,2258,2401,-143,0,132,0,6
14231,2,2378,2459,-81,0,340,0,6
14232,3,2392,2451,-59,0,211,0,6
14233,1,2527,2625,-98,0,380,0,6
14234,2,2456,2497,-41,0,311,0,6
14235,2,2355,2539,-184,0,41,0,6
14236,1,2406,2392,14,0,43,0,6
14237,2,2347,2546,-199,0,3,1,6
14238,1,2475,2443,32,0,45,1,6
14239,2,2515,2433,82,0,200,0,6
14240,2,2324,2492,-168,0,200,1,6
14241,1,2542,2389,153,0,152,0,6
14242,2,2308,2421,-113,0,302,1,6
14243,2,2447,2426,21,0,302,1,6
14244,1,2484,2385,99,0,5,0,6
14245,2,2413,2451,-38,0,112,0,6
14246,1,2619,2488,131,0,120,0,6
14247,2,2418,2311,107,0,0,1,6
14248,1,2420,2332,88,0,190,0,6
14249,2,2473,2427,46,0,267,0,6
14250,2,2372,2400,-28,0,122,0,6
14251,2,2378,2482,-104,0,40,0,6
14252,1,2584,2559,25,0,326,1,6
14253,2,2403,2408,-5,0,369,0,8
14254,2,2292,2426,-134,0,312,0,6
14255,1,2451,2493,-42,0,312,0,6
14256,1,2408,2242,166,0,110,0,6
14257,1,2514,2339,175,0,141,0,6
14258,1,2567,2413,154,0,151,0,6
14259,2,2563,2547,16,0,45,0,6
14260,1,2502,2412,90,0,250,1,6
14261,1,2406,2291,115,0,106,0,6
14262,2,2424,2328,96,0,302,0,6
14263,1,2492,2624,-132,0,302,0,6
14264,1,2383,2448,-65,0,344,0,6
14265,1,2448,2348,100,0,152,0,6
14266,1,2209,2413,-204,0,118,0,6
14267,1,2433,2430,3,0,45,0,6
14268,2,2558,2629,-71,0,406,0,6
14269,1,2534,2546,-12,0,380,0,6
14270,2,2542,2487,55,0,80,0,6
14271,1,2617,2488,129,0,131,0,6
14272,1,2557,2424,133,0,300,1,6
14273,1,2405,2374,31,0,313,0,6
14274,1,2443,2395,48,0,200,0,8
14275,2,2448,2508,-60,0,13,1,6
14276,1,2493,2393,100,0,52,0,6
14277,3,2369,2531,-162,0,0,0,6
14278,2,2405,2367,38,0,113,0,6
14279,1,2440,2332,108,0,49,0,6
14280,1,2376,2405,-29,0,43,0,6
14281,1,2548,2411,137,0,7,0,6
14282,1,2495,2344,151,0,200,0,6
14283,2,2664,2485,179,0,142,0,6
14284,1,2623,2553,70,0,120,1,6
14285,1,2277,2408,-131,0,41,1,8
14286,1,2321,2466,-145,0,264,1,6
14287,2,2430,2382,48,0,492,1,6
14288,2,2432,2275,157,0,122,1,6
14289,1,2411,2381,30,0,0,0,6
14290,1,2540,2550,-10,0,152,0,6
14291,1,2543,2542,1,0,131,0,6
14292,1,2424,2452,-28,0,20,1,6
14293,1,2540,2549,-9,0,485,0,6
14294,2,2573,2518,55,0,107,0,6
14295,1,2450,2315,135,0,41,0,6
14296,1,2434,2628,-194,0,151,0,6
14297,2,2283,2422,-139,0,394,1,6
14298,2,2239,2411,-172,0,6,1,6
14299,2,2572,2641,-69,0,141,1,6
14300,3,2438,2378,60,0,7,0,6
14301,1,2414,2348,66,0,405,0,8
14302,2,2244,2417,-173,0,141,1,6
14303,1,2617,2589,28,0,45,1,6
14304,1,2633,2553,80,0,229,0,6
14305,1,2485,2621,-136,0,159,1,6
14306,1,2545,2458,87,0,56,1,6
14307,1,2546,2588,-42,0,131,0,6
14308,1,2498,2373,125,0,200,0,6
14309,2,2341,2498,-157,0,3,0,6
14310,1,2471,2393,78,0,453,0,6
14311,2,2397,2458,-61,0,140,0,6
14312,2,2214,2410,-196,0,118,0,6
14313,2,2408,2486,-78,0,148,0,6
14314,2,2336,2401,-65,0,317,1,6
14315,2,2561,2427,134,0,40,0,6
14316,3,2420,2298,122,0,213,0,6
14317,2,2507,2521,-14,0,123,0,6
14318,1,2455,2437,18,0,107,0,6
14319,3,2326,2407,-81,0,4,0,6
14320,1,2528,2389,139,0,338,0,6
14321,2,2325,2444,-119,0,404,0,6
14322,2,2339,2439,-100,0,234,0,6
14323,2,2409,2571,-162,0,409,0,6
14324,1,2513,2380,133,0,200,0,6
14325,2,2243,2420,-177,0,302,0,6
14326,3,2457,2434,23,0,101,0,6
14327,2,2548,2627,-79,0,8,0,6
14328,1,2390,2547,-157,0,313,0,8
14329,1,2311,2423,-112,0,302,0,6
14330,2,2427,2416,11,0,4,0,6
14331,2,2552,2546,6,0,374,0,6
14332,1,2448,2379,69,0,49,0,6
14333,1,2416,2329,87,0,484,0,6
14334,3,2301,2431,-130,0,484,0,6
14335,1,2549,2638,-89,0,52,0,6
14336,3,2619,2493,126,0,202,0,6
14337,2,2458,2443,15,0,105,1,6
14338,2,2319,2426,-107,0,46,1,6
14339,2,2557,2656,-99,0,226,0,6
14340,1,2414,2306,108,0,426,1,6
14341,2,2274,2448,-174,0,150,1,8
14342,1,2404,2424,-20,0,103,0,6
14343,1,2403,2295,108,0,300,1,6
14344,2,2397,2524,-127,0,107,1,6
14345,1,2337,2463,-126,0,2,0,6
14346,2,2413,2395,18,0,303,0,6
14347,2,2376,2517,-141,0,302,0,6
14348,1,2328,2414,-86,0,1,1,6
14349,1,2491,2403,88,0,292,0,6
14350,2,2584,2622,-38,0,176,0,6
14351,1,2360,2521,-161,0,17,1,6
14352,1,2441,2303,138,0,198,0,6
14353,2,2582,2436,146,0,245,0,6
14354,2,2406,2329,77,0,50,0,6
14355,2,2475,2552,-77,0,389,0,6
14356,1,2817,2613,204,0,158,0,6
14357,1,2426,2351,75,0,247,1,6
14358,2,2484,2288,196,0,4,0,6
14359,2,2420,2410,10,0,106,1,6
14360,1,2325,2410,-85,0,130,0,6
14361,1,2426,2310,116,0,4,0,6
14362,2,2421,2396,25,0,4,0,6
14363,1,2610,2422,188,0,200,0,6
14364,2,2536,2437,99,0,46,0,6
14365,1,2532,2373,159,0,340,1,6
14366,1,2361,2400,-39,0,197,0,8
14367,2,2299,2418,-119,0,302,0,6
14368,2,2389,2546,-157,0,247,0,6
14369,2,2424,2523,-99,0,203,0,6
14370,1,2560,2552,8,0,278,0,6
14371,1,2631,2556,75,0,123,0,6
14372,2,2374,2435,-61,0,45,0,6
14373,1,2345,2521,-176,0,2,1,6
14374,3,2386,2574,-188,0,31,0,6
14375,1,2444,2289,155,0,4,0,6
14376,2,2360,2561,-201,0,43,0,6
14377,1,2505,2375,130,0,469,0,6
14378,1,2393,2430,-37,0,200,0,6
14379,1,2429,2315,114,0,20,1,6
14380,2,2611,2820,-209,0,418,1,6
14381,2,2495,2613,-118,0,40,0,6
14382,1,2447,2566,-119,0,375,0,6
14383,2,2443,2373,70,0,172,1,6
14384,1,2473,2358,115,4,145,1,13
14385,1,2460,2441,19,0,128,0,6
14386,2,2660,2655,5,0,80,0,6
14387,1,2632,2552,80,0,120,0,6
14388,2,2375,2462,-87,0,45,1,6
14389,1,2399,2452,-53,0,378,0,6
14390,1,2527,2501,26,0,218,0,6
14391,1,2385,2427,-42,0,107,1,6
14392,1,2401,2237,164,0,108,0,8
14393,1,2449,2509,-60,0,13,0,6
14394,1,2407,2332,75,0,303,0,6
14395,1,2528,2420,108,0,277,0,6
14396,2,2380,2445,-65,0,245,0,6
14397,1,2579,2563,16,0,107,0,6
14398,1,2440,2386,54,0,338,0,6
14399,3,2301,2415,-114,0,127,0,6
14400,1,2418,2308,110,0,40,0,6
14401,2,2340,2403,-63,0,300,0,6
14402,1,2529,2566,-37,0,45,1,6
14403,3,2370,2414,-44,0,200,0,6
14404,3,2546,2535,11,0,190,0,6
14405,2,2428,2406,22,0,150,1,6
14406,1,2491,2475,16,0,40,0,6
14407,2,2552,2635,-83,0,398,0,6
14408,2,2544,2617,-73,0,8,0,6
14409,1,2401,2312,89,0,1,0,6
14410,2,2415,2495,-80,0,140,0,6
14411,1,2550,2456,94,0,4,0,6
14412,1,2453,2484,-31,0,337,0,6
14413,1,2512,2455,57,0,121,0,6
14414,2,2323,2422,-99,0,190,1,6
14415,2,2501,2388,113,0,107,0,6
14416,1,2406,2310,96,0,41,0,6
14417,1,2424,2328,96,0,45,0,6
14418,2,2418,2412,6,0,7,1,6
14419,2,2431,2420,11,0,123,1,6
14420,2,2823,2609,214,0,145,0,6
14421,1,2416,2433,-17,0,129,0,6
14422,1,2609,2435,174,0,15,1,6
14423,1,2311,2471,-160,0,46,0,6
14424,2,2496,2532,-36,0,123,0,6
14425,1,2428,2444,-16,0,331,0,6
14426,2,2344,2439,-95,0,49,0,6
14427,2,2349,2405,-56,0,310,1,6
14428,1,2446,2467,-21,0,296,0,6
14429,2,2413,2271,142,0,4,0,6
14430,2,2201,2402,-201,0,124,0,6
14431,3,2414,2206,208,0,302,0,6
14432,1,2305,2444,-139,0,4,0,6
14433,2,2354,2529,-175,0,2,0,6
14434,1,2425,2350,75,0,278,0,6
14435,1,2294,2450,-156,0,84,1,6
14436,2,2335,2401,-66,0,40,0,6
14437,1,2535,2497,38,0,302,1,6
14438,2,2427,2257,170,0,311,1,6
14439,2,2371,2574,-203,4,46,0,11
14440,1,2445,2290,155,0,41,1,6
14441,1,2584,2582,2,0,40,0,6
14442,1,2548,2546,2,0,228,0,6
14443,2,2470,2414,56,0,9,0,6
14444,1,2622,2458,164,0,243,1,6
14445,1,2691,2559,132,0,371,0,6
14446,2,2814,2737,77,0,302,0,6
14447,1,2560,2646,-86,0,469,0,6
14448,2,2377,2462,-85,0,201,1,6
14449,1,2375,2557,-182,0,315,0,6
14450,1,2665,2618,47,0,88,0,6
14451,2,2452,2654,-202,0,20,1,6
14452,1,2640,2547,93,0,123,0,6
14453,2,2306,2429,-123,0,255,0,6
14454,1,2459,2295,164,0,40,0,6
14455,2,2333,2517,-184,0,1,0,6
14456,1,2404,2328,76,0,112,0,6
14457,1,2493,2335,158,0,100,0,6
14458,2,2396,2484,-88,0,216,0,6
14459,2,2398,2413,-15,0,85,1,8
14460,1,2443,2369,74,0,45,0,6
14461,1,2450,2554,-104,0,337,0,6
14462,1,2409,2443,-34,0,288,1,6
14463,2,2363,2428,-65,0,200,0,6
14464,1,2436,2406,30,0,5,0,6
14465,1,2400,2395,5,0,330,1,6
14466,2,2408,2319,89,0,302,0,6
14467,2,2438,2463,-25,0,47,0,6
14468,1,2416,2352,64,0,192,1,6
14469,2,2323,2452,-129,0,264,0,6
14470,1,2461,2319,142,0,45,1,6
14471,1,2419,2254,165,0,0,0,6
14472,1,2412,2426,-14,0,4,0,6
14473,2,2553,2432,121,0,128,0,6
14474,2,2434,2532,-98,0,310,0,6
14475,1,2497,2350,147,0,200,0,6
14476,1,2410,2285,125,0,61,0,6
14477,1,2543,2644,-101,0,406,0,6
14478,3,2401,2540,-139,0,483,0,6
14479,1,2625,2492,133,0,131,0,6
14480,1,2405,2287,118,0,45,1,6
14481,1,2442,2403,39,0,36,1,6
14482,2,2358,2527,-169,0,40,0,6
14483,1,2613,2807,-194,0,40,0,6
14484,1,2576,2422,154,0,335,0,6
14485,2,2401,2433,-32,0,254,0,6
14486,2,2295,2491,-196,0,207,0,6
14487,1,2651,2510,141,0,4,1,6
14488,2,2395,2463,-68,0,104,1,6
14489,1,2421,2382,39,0,247,0,6
14490,2,2540,2626,-86,0,324,0,6
14491,2,2549,2384,165,0,201,0,6
14492,1,2455,2448,7,0,406,0,6
14493,1,2260,2427,-167,0,129,0,6
14494,1,2475,2393,82,0,58,0,8
14495,1,2456,2365,91,0,121,0,6
14496,2,2695,2554,141,0,405,0,6
14497,2,2565,2350,215,0,137,0,6
14498,1,2567,2422,145,0,13,0,6
14499,2,2520,2379,141,0,256,1,6
14500,3,2359,2466,-107,0,415,0,6
14501,1,2547,2458,89,0,4,0,6
14502,1,2631,2462,169,0,211,0,6
14503,1,2467,2447,20,0,430,1,6
14504,1,2489,2392,97,0,22,0,6
14505,2,2534,2536,-2,0,224,0,6
14506,3,2799,2621,178,0,0,0,6
14507,1,2462,2449,13,0,307,1,6
14508,1,2401,2407,-6,0,192,0,6
14509,1,2402,2327,75,0,250,0,6
14510,1,2403,2575,-172,0,234,0,8
14511,2,2555,2646,-91,0,122,0,6
14512,3,2433,2500,-67,0,45,0,6
14513,3,2494,2389,105,0,218,0,6
14514,2,2523,2657,-134,0,414,1,6
14515,2,2369,2407,-38,0,46,0,6
14516,2,2349,2414,-65,0,130,1,6
14517,1,2551,2347,204,0,330,0,6
14518,1,2468,2335,133,0,404,0,6
14519,2,2433,2465,-32,0,302,0,6
14520,2,2538,2543,-5,0,337,0,6
14521,1,2537,2570,-33,0,106,0,6
14522,2,2419,2316,103,0,0,0,6
14523,2,2333,2413,-80,0,190,0,6
14524,1,2421,2320,101,0,101,0,6
14525,1,2438,2396,42,0,145,0,6
14526,2,2398,2447,-49,0,315,1,6
14527,2,2311,2511,-200,0,7,0,6
14528,2,2337,2520,-183,4,190,0,13
14529,2,2230,2409,-179,0,57,0,6
14530,1,2420,2293,127,0,302,0,6
14531,1,2403,2418,-15,0,317,0,6
14532,1,2401,2280,121,0,300,0,6
14533,2,2488,2580,-92,0,0,1,6
14534,3,2570,2629,-59,0,110,0,6
14535,2,2418,2442,-24,0,288,0,6
14536,2,2259,2411,-152,0,200,0,6
14537,1,2553,2590,-37,0,405,0,6
14538,2,2506,2655,-149,0,335,0,6
14539,2,2417,2298,119,0,48,0,6
14540,1,2437,2323,114,0,190,1,6
14541,1,2344,2463,-119,0,2,0,6
14543,1,2361,2421,-60,0,0,0,6
14544,3,2366,2428,-62,0,301,0,6
14545,2,2388,2468,-80,0,460,0,6
14546,2,2344,2426,-82,0,45,0,6
14547,1,2605,2677,-72,0,4,0,6
14548,1,2401,2408,-7,0,318,0,6
14549,3,2453,2551,-98,0,56,0,6
14550,2,2460,2634,-174,0,324,0,6
14551,2,2391,2443,-52,0,45,0,6
14552,1,2226,2415,-189,0,45,0,6
14553,2,2366,2459,-93,0,337,0,6
14554,1,2382,2533,-151,0,1,0,6
14555,1,2550,2687,-137,0,27,0,6
14556,3,2562,2458,104,0,227,0,6
14557,2,2368,2472,-104,0,202,1,6
14558,1,2650,2551,99,0,385,0,6
14559,1,2796,2679,117,0,128,0,6
14560,1,2559,2499,60,0,455,0,6
14561,2,2442,2434,8,0,211,1,6
14562,3,2542,2512,30,0,321,0,6
14563,3,2289,2423,-134,0,40,0,6
14565,1,2401,2543,-142,0,311,1,6
14566,2,2389,2402,-13,0,302,0,8
14567,1,2564,2444,120,0,41,1,6
14568,2,2317,2467,-150,0,312,1,6
14569,1,2375,2464,-89,0,46,0,6
14570,2,2331,2515,-184,0,348,0,8
14571,2,2437,2430,7,0,56,0,6
14572,2,2361,2427,-66,0,45,0,6
14573,1,2399,2404,-5,0,100,0,6
14574,1,2470,2428,42,0,45,0,6
14575,2,2661,2472,189,0,410,0,6
14576,1,2409,2361,48,0,49,1,6
14577,3,2262,2419,-157,0,315,0,6
14578,2,2430,2419,11,0,368,0,6
14579,2,2547,2654,-107,0,122,0,6
14580,2,2367,2452,-85,0,312,0,6
14581,1,2393,2401,-8,0,380,0,6
14582,1,2385,2410,-25,0,112,0,6
14583,1,2567,2404,163,0,27,0,8
14584,1,2495,2346,149,0,255,0,6
14585,1,2584,2565,19,0,7,0,6
14586,2,2423,2475,-52,0,106,0,6
14587,1,2334,2442,-108,0,106,0,6
14588,2,2319,2448,-129,0,46,1,6
14589,2,2517,2503,14,0,302,1,6
14590,1,2414,2413,1,0,277,1,6
14591,2,2480,2637,-157,0,325,1,6
14592,1,2323,2437,-114,0,228,1,6
14593,1,2404,2330,74,0,259,0,8
14594,2,2324,2402,-78,0,110,0,6
14595,2,2628,2571,57,0,130,0,6
14596,3,2473,2370,103,0,85,0,6
14597,2,2800,2670,130,0,130,0,6
14598,2,2544,2675,-131,0,81,0,6
14599,2,2399,2463,-64,0,337,1,6
14600,2,2584,2521,63,0,58,1,6
14601,2,2304,2406,-102,0,1,0,6
14602,1,2294,2477,-183,4,244,0,13
14603,2,2354,2492,-138,0,310,0,6
14604,1,2400,2385,15,0,202,1,6
14605,1,2331,2425,-94,0,40,0,6
14606,2,2431,2304,127,0,96,0,6
14607,2,2244,2405,-161,0,150,0,6
14608,1,2549,2455,94,0,4,0,6
14609,1,2456,2484,-28,0,131,1,6
14610,3,2540,2658,-118,0,150,0,6
14611,1,2480,2418,62,0,306,0,6
14612,1,2473,2412,61,0,456,1,6
14613,1,2383,2501,-118,0,250,0,6
14614,1,2640,2391,249,0,4,0,6
14615,3,2456,2537,-81,0,187,0,6
14616,1,2417,2293,124,0,310,1,6
14617,2,2535,2436,99,0,415,1,6
14618,2,2389,2513,-124,0,321,0,6
14619,2,2389,2407,-18,0,277,0,6
14620,1,2462,2287,175,0,158,0,6
14621,1,2421,2292,129,0,114,0,6
14622,3,2454,2441,13,0,409,0,6
14624,1,2421,2371,50,0,46,0,6
14625,2,2265,2401,-136,0,318,0,6
14626,2,2413,2568,-155,0,30,0,6
14627,1,2352,2498,-146,0,2,0,6
14628,2,2409,2263,146,0,241,0,6
14629,1,2440,2471,-31,0,11,1,6
14630,2,2275,2406,-131,0,45,0,6
14631,2,2404,2377,27,0,83,0,6
14632,2,2515,2541,-26,0,123,0,6
14633,1,2457,2312,145,0,103,0,6
14634,2,2272,2407,-135,0,301,0,8
14635,1,2367,2485,-118,0,4,0,6
14636,1,2402,2406,-4,0,49,1,6
14637,1,2486,2358,128,0,131,0,6
14638,3,2658,2543,115,0,385,0,6
14639,1,2406,2319,87,0,40,1,6
14640,1,2440,2375,65,0,44,1,6
14641,2,2331,2401,-70,0,424,0,8
14642,1,2411,2360,51,0,302,1,6
14643,1,2408,2227,181,0,45,0,6
14644,1,2414,2431,-17,0,22,1,6
14645,3,2496,2350,146,0,252,0,6
14646,2,2288,2425,-137,0,330,0,6
14647,1,2607,2559,48,0,454,0,6
14648,1,2452,2430,22,0,411,0,6
14649,1,2433,2215,218,0,4,1,6
14650,1,2509,2511,-2,0,440,0,6
14651,2,2316,2441,-125,0,47,1,6
14652,3,2320,2494,-174,0,268,0,6
14653,3,2356,2540,-184,0,201,0,6
14654,2,2678,2792,-114,0,40,0,6
14655,1,2416,2207,209,0,302,0,6
14656,2,2246,2420,-174,0,335,0,6
14657,1,2571,2407,164,0,13,0,6
14658,2,2631,2528,103,0,45,0,6
14659,3,2488,2391,97,0,108,0,6
14660,2,2577,2426,151,0,469,0,6
14661,1,2517,2394,123,0,121,0,6
14662,2,2380,2406,-26,0,242,1,6
14663,1,2656,2450,206,0,4,0,6
14664,2,2451,2554,-103,0,56,0,6
14665,2,2478,2462,16,0,15,0,6
14666,2,2528,2642,-114,0,100,0,6
14667,1,2388,2528,-140,0,1,0,6
14668,2,2407,2490,-83,0,5,0,6
14669,1,2366,2409,-43,0,145,0,6
14670,1,2415,2296,119,0,133,1,6
14671,3,2541,2360,181,0,202,0,6
14672,1,2402,2330,72,0,118,0,6
14673,1,2436,2256,180,0,306,1,6
14674,1,2570,2557,13,0,390,0,6
14675,1,2401,2341,60,0,426,0,6
14676,1,2460,2457,3,0,242,1,6
14677,1,2405,2507,-102,0,100,0,6
14678,2,2410,2428,-18,0,267,1,6
14679,2,2261,2426,-165,0,0,0,6
14680,1,2420,2259,161,0,398,1,6
14681,2,2205,2547,-342,0,43,0,6
14682,1,2429,2330,99,0,113,0,6
14683,1,2547,2528,19,0,400,1,6
14684,1,2491,2345,146,0,59,0,6
14685,3,2435,2455,-20,0,113,0,6
14686,1,2424,2457,-33,0,402,1,6
14687,2,2325,2444,-119,4,106,0,13
14688,3,2366,2424,-58,0,46,0,6
14689,3,2478,2477,1,0,460,0,6
14690,1,2477,2377,100,0,80,0,6
14691,1,2468,2322,146,0,49,1,6
14692,2,2396,2454,-58,0,1,0,6
14693,2,2520,2458,62,0,45,0,6
14694,2,2419,2305,114,0,192,0,6
14695,2,2434,2471,-37,0,4,0,6
14696,2,2338,2500,-162,0,102,1,6
14697,2,2326,2402,-76,0,488,0,6
14698,1,2409,2383,26,0,205,0,8
14699,1,2368,2411,-43,0,43,0,6
14700,1,2544,2657,-113,0,122,1,6
14701,2,2505,2514,-9,0,46,1,6
14702,1,2416,2280,136,0,108,0,6
14703,3,2456,2446,10,0,105,0,6
14704,1,2536,2429,107,0,109,0,6
14705,2,2477,2375,102,0,45,0,6
14706,3,2412,2417,-5,0,107,0,6
14707,2,2536,2458,78,0,117,0,6
14708,1,2552,2623,-71,0,157,0,6
14709,2,2324,2469,-145,4,18,1,13
14710,3,2444,2296,148,0,45,0,6
14711,1,2423,2417,6,0,107,0,6
14712,2,2314,2410,-96,0,0,0,6
14713,2,2617,2569,48,0,40,0,6
14714,2,2495,2480,15,0,455,0,6
14715,1,2537,2434,103,0,491,0,6
14716,2,2402,2576,-174,0,345,0,8
14717,1,2495,2423,72,0,301,0,6
14718,2,2392,2486,-94,0,40,1,6
14719,1,2418,2373,45,0,1,0,6
14720,2,2444,2412,32,0,109,1,6
14721,2,2406,2422,-16,0,13,1,6
14722,2,2558,2447,111,0,4,0,6
14723,1,2468,2481,-13,0,141,0,6
14724,2,2549,2421,128,0,244,0,6
14725,1,2411,2267,144,0,330,1,8
14726,2,2312,2575,-263,0,107,1,6
14727,2,2646,2524,122,0,130,0,6
14728,1,2520,2376,144,0,241,0,6
14729,2,2404,2495,-91,0,205,0,6
14730,1,2411,2375,36,0,128,0,6
14731,1,2231,2458,-227,0,46,0,3
14732,2,2374,2415,-41,0,1,0,6
14733,1,2455,2435,20,0,10,0,6
14734,2,2417,2243,174,0,4,1,6
14735,2,2447,2420,27,0,4,1,6
14736,1,2390,2411,-21,0,40,0,6
14737,1,2552,2520,32,0,140,0,6
14738,1,2412,2329,83,0,218,0,6
14739,2,2681,2783,-102,0,101,0,6
14740,1,2382,2470,-88,0,491,0,6
14741,2,2326,2433,-107,0,226,0,6
14742,1,2461,2466,-5,0,433,1,6
14743,3,2429,2326,103,0,113,0,6
14744,1,2616,2559,57,0,41,0,6
14745,1,2246,2405,-159,0,124,1,6
14746,3,2312,2423,-111,0,354,0,6
14747,2,2522,2575,-53,0,87,1,6
14748,2,2446,2456,-10,0,10,1,6
14749,1,2405,2328,77,0,40,0,6
14750,3,2437,2215,222,0,8,0,6
14751,1,2556,2369,187,0,0,1,6
14752,2,2520,2425,95,0,411,0,6
14753,2,2262,2436,-174,0,455,1,6
14754,1,2455,2377,78,0,130,0,6
14755,1,2406,2248,158,0,278,0,8
14756,1,2402,2335,67,0,240,0,6
14757,1,2557,2392,165,0,211,0,6
14758,1,2402,2314,88,0,106,1,6
14759,2,2353,2493,-140,0,310,0,6
14760,2,2415,2310,105,0,101,0,6
14761,2,2649,2552,97,0,59,0,6
14762,3,2576,2611,-35,0,310,0,6
14763,2,2368,2424,-56,0,100,0,6
14764,1,2478,2366,112,0,394,0,6
14765,2,2451,2455,-4,0,121,0,6
14766,2,2477,2502,-25,0,4,0,6
14767,1,2520,2500,20,0,58,0,6
14768,1,2542,2419,123,0,487,0,6
14769,1,2533,2383,150,0,41,0,6
14770,2,2491,2388,103,0,46,0,6
14771,2,2363,2489,-126,0,2,0,6
14772,1,2270,2568,-298,0,101,0,6
14773,1,2528,2541,-13,0,210,0,6
14774,2,2458,2474,-16,0,380,0,6
14775,1,2412,2351,61,0,184,0,6
14777,3,2372,2459,-87,0,0,0,6
14778,2,2270,2405,-135,0,452,1,6
14779,1,2454,2550,-96,0,56,0,6
14781,3,2368,2524,-156,0,2,0,6
14782,2,2400,2401,-1,0,192,0,6
14783,2,2465,2529,-64,0,190,0,6
14784,2,2475,2577,-102,0,454,0,6
14785,1,2405,2373,32,0,0,0,6
14786,2,2320,2449,-129,0,234,1,6
14787,3,2369,2416,-47,0,103,0,6
14788,1,2421,2310,111,0,343,1,6
14789,1,2460,2314,146,0,154,0,6
14790,1,2639,2467,172,0,130,0,6
14791,2,2450,2560,-110,0,295,0,6
14792,1,2306,2416,-110,0,41,0,6
14793,1,2463,2389,74,0,45,0,6
14794,1,2396,2483,-87,0,43,0,6
14795,3,2371,2451,-80,0,0,0,6
14796,2,2545,2510,35,0,40,0,6
14797,2,2492,2359,133,0,40,0,6
14798,1,2461,2342,119,0,20,1,6
14799,2,2497,2349,148,0,245,0,6
14800,1,2559,2427,132,0,107,0,6
14801,2,2406,2355,51,0,242,0,6
14802,1,2462,2441,21,0,40,1,6
14803,1,2257,2469,-212,0,245,0,8
14804,2,2472,2388,84,0,4,0,6
14805,3,2236,2541,-305,0,43,0,6
14806,2,2430,2441,-11,0,122,1,6
14807,2,2420,2410,10,0,41,0,6
14808,1,2360,2537,-177,0,101,0,6
14809,2,2357,2409,-52,0,172,1,6
14810,1,2385,2468,-83,0,36,0,6
14811,1,2428,2560,-132,0,205,0,6
14812,2,2580,2535,45,0,26,0,6
14813,2,2444,2362,82,0,131,0,6
14814,1,2610,2577,33,0,40,0,6
14815,2,2461,2446,15,0,357,0,6
14816,2,2453,2417,36,0,310,1,6
14817,1,2526,2480,46,0,386,0,6
14818,1,2407,2394,13,0,13,0,6
14819,1,2453,2338,115,0,11,0,6
14820,2,2433,2402,31,0,476,0,6
14821,3,2787,2669,118,0,380,0,6
14822,1,2446,2291,155,0,101,1,6
14823,1,2499,2441,58,0,100,0,6
14824,1,2458,2374,84,0,130,0,6
14825,2,2640,2462,178,0,107,1,6
14826,1,2324,2437,-113,0,45,1,6
14827,2,2407,2281,126,0,1,0,6
14828,1,2415,2370,45,0,128,0,6
14829,1,2579,2398,181,0,344,0,8
14830,1,2619,2674,-55,0,133,0,6
14831,3,2409,2442,-33,0,4,0,6
14832,1,2620,2556,64,0,43,0,6
14833,1,2581,2522,59,0,13,0,6
14834,2,2311,2464,-153,0,406,0,6
14835,1,2545,2642,-97,0,122,1,6
14836,2,2381,2426,-45,0,46,0,6
14837,2,2532,2552,-20,0,201,0,6
14838,1,2366,2476,-110,0,288,0,6
14840,2,2376,2410,-34,0,131,1,6
14841,1,2436,2485,-49,0,1,1,6
14842,1,2537,2432,105,0,244,1,6
14843,1,2434,2333,101,0,4,0,6
14844,1,2403,2374,29,0,121,0,6
14845,2,2409,2378,31,0,211,0,8
14846,2,2367,2460,-93,0,0,1,6
14847,1,2456,2325,131,0,227,0,6
14849,2,2543,2364,179,0,8,0,6
14850,1,2404,2363,41,0,242,0,6
14851,2,2464,2642,-178,0,0,0,6
14852,2,2408,2420,-12,0,132,0,6
14853,3,2410,2539,-129,0,12,0,6
14854,1,2289,2405,-116,0,459,1,6
14855,1,2414,2407,7,0,18,0,6
14856,1,2464,2531,-67,0,102,0,6
14857,2,2423,2460,-37,0,122,0,6
14858,1,2435,2467,-32,0,20,0,6
14859,1,2524,2257,267,4,9,0,13
14860,2,2541,2574,-33,0,10,0,6
14861,2,2640,2465,175,0,15,0,6
14862,2,2520,2563,-43,0,101,0,6
14863,2,2571,2615,-44,0,426,1,6
14864,2,2307,2448,-141,0,314,0,6
14865,2,2389,2412,-23,0,190,0,6
14866,1,2436,2420,16,0,13,1,6
14867,2,2311,2407,-96,0,121,0,6
14868,3,2675,2785,-110,0,343,0,6
14869,2,2395,2535,-140,0,1,0,6
14870,2,2431,2265,166,0,334,0,6
14871,1,2411,2375,36,0,302,0,6
14872,3,2357,2489,-132,0,311,0,6
14873,2,2465,2510,-45,0,400,0,6
14874,2,2475,2627,-152,0,8,0,6
14875,2,2404,2551,-147,0,106,1,6
14876,2,2635,2625,10,0,331,0,6
14877,2,2381,2586,-205,0,107,0,6
14878,2,2667,2626,41,0,4,0,6
14879,2,2517,2632,-115,0,121,0,6
14880,1,2645,2461,184,0,405,0,6
14881,2,2257,2518,-261,0,381,0,6
14882,2,2470,2471,-1,0,415,1,6
14883,2,2558,2526,32,0,131,0,6
14884,1,2403,2400,3,0,300,0,6
14885,1,2419,2620,-201,0,48,0,6
14886,2,2538,2424,114,0,4,0,6
14887,2,2408,2426,-18,0,346,0,6
14888,1,2537,2392,145,0,83,0,6
14889,1,2635,2553,82,0,200,0,6
14890,2,2218,2541,-323,0,43,0,6
14891,1,2344,2482,-138,0,8,1,6
14892,2,2524,2427,97,0,4,1,6
14893,2,2316,2478,-162,0,398,1,6
14894,1,2443,2311,132,0,100,0,6
14895,2,2414,2410,4,0,128,0,6
14896,2,2393,2460,-67,0,487,0,6
14897,1,2536,2379,157,0,184,0,6
14898,2,2447,2464,-17,0,250,0,6
14899,1,2486,2363,123,0,40,0,6
14900,2,2415,2384,31,0,337,0,6
14901,2,2494,2418,76,0,484,0,6
14902,1,2543,2365,178,0,120,0,6
14903,2,2461,2442,19,0,105,1,6
14904,1,2474,2371,103,0,9,0,6
14905,1,2359,2406,-47,0,13,0,6
14906,2,2430,2331,99,0,101,0,6
14907,1,2473,2325,148,4,258,1,13
14908,1,2517,2648,-131,0,302,1,6
14909,2,2418,2303,115,0,113,0,6
14910,2,2296,2465,-169,0,143,0,6
14911,2,2530,2476,54,0,65,0,6
14912,1,2438,2437,1,0,4,0,6
14913,1,2487,2452,35,0,406,0,6
14914,2,2425,2349,76,0,4,1,6
14915,1,2513,2368,145,0,256,0,6
14916,2,2375,2531,-156,0,374,1,6
14917,1,2620,2567,53,0,40,0,6
14918,2,2328,2416,-88,0,1,0,6
14919,3,2323,2538,-215,0,106,0,6
14920,2,2582,2533,49,0,45,0,6
14921,1,2445,2354,91,0,250,0,6
14922,1,2519,2409,110,0,51,1,6
14923,1,2522,2359,163,0,40,1,6
14924,2,2442,2490,-48,0,4,0,6
14925,1,2434,2378,56,0,176,0,6
14926,2,2310,2422,-112,0,284,0,6
14927,1,2390,2428,-38,0,203,1,6
14928,1,2427,2568,-141,0,380,0,6
14929,1,2415,2268,147,0,247,0,6
14930,2,2448,2470,-22,0,15,1,6
14931,2,2415,2408,7,0,170,1,6
14932,1,2631,2629,2,0,40,0,6
14933,2,2383,2487,-104,0,207,0,6
14934,2,2449,2373,76,0,113,1,6
14935,1,2639,2471,168,0,247,0,6
14936,3,2395,2582,-187,0,345,0,8
14937,1,2521,2255,266,0,28,0,6
14938,2,2217,2429,-212,0,100,1,6
14939,1,2325,2403,-78,0,443,0,6
14940,2,2554,2552,2,0,16,1,6
14941,1,2307,2447,-140,0,435,1,6
14942,1,2540,2543,-3,0,211,0,6
14943,2,2477,2464,13,0,4,1,6
14944,1,2415,2350,65,0,200,0,8
14945,1,2464,2478,-14,0,485,0,6
14946,2,2470,2318,152,0,141,0,6
14947,1,2516,2358,158,0,110,0,6
14948,2,2294,2469,-175,0,142,0,6
14949,3,2602,2670,-68,0,190,0,6
14950,3,2388,2541,-153,0,1,0,6
14951,2,2376,2411,-35,0,44,0,6
14952,1,2462,2517,-55,0,103,0,6
14953,2,2326,2400,-74,0,277,0,6
14954,1,2418,2354,64,0,0,0,6
14955,2,2285,2450,-165,0,45,0,3
14956,3,2537,2661,-124,0,80,0,6
14957,1,2394,2400,-6,0,122,1,6
14958,1,2502,2545,-43,0,48,1,6
14959,2,2425,2493,-68,0,151,0,6
14960,1,2623,2637,-14,0,0,1,6
14962,2,2435,2390,45,0,114,0,6
14963,3,2784,2679,105,0,46,0,6
14965,2,2482,2523,-41,0,130,0,6
14966,1,2420,2290,130,0,200,1,6
14967,3,2472,2640,-168,0,123,0,6
14968,2,2491,2406,85,0,258,0,6
14969,3,2426,2375,51,0,107,0,6
14970,1,2418,2291,127,0,485,1,6
14971,2,2269,2403,-134,4,100,0,13
14972,1,2424,2562,-138,0,106,1,6
14973,2,2433,2534,-101,0,1,0,6
14974,1,2451,2384,67,0,200,0,8
14975,1,2517,2444,73,0,337,0,6
14976,1,2423,2367,56,0,292,1,6
14977,2,2576,2510,66,0,40,1,6
14978,2,2421,2378,43,0,40,1,6
14979,2,2261,2407,-146,0,46,0,6
14980,1,2470,2396,74,0,300,0,6
14981,2,2432,2403,29,0,479,0,6
14982,2,2373,2401,-28,0,190,0,6
14983,2,2292,2439,-147,0,170,0,6
14984,2,2366,2547,-181,0,4,0,6
14985,1,2741,2642,99,0,461,0,6
14986,2,2358,2414,-56,0,153,1,6
14987,1,2468,2518,-50,0,7,1,6
14988,2,2450,2356,94,0,40,0,6
14989,1,2260,2415,-155,0,330,0,6
14990,2,2475,2443,32,0,103,0,6
14991,2,2235,2427,-192,0,302,0,7
14992,1,2375,2472,-97,0,103,0,6
14993,1,2538,2560,-22,0,429,0,6
14994,2,2385,2520,-135,0,4,0,6
14995,2,2402,2460,-58,0,255,0,6
14996,1,2474,2391,83,0,211,0,6
14997,2,2539,2497,42,0,4,0,6
14998,2,2560,2429,131,0,106,0,6
14999,2,2404,2421,-17,0,424,1,6
15000,1,2306,2471,-165,0,46,0,6
15001,1,2470,2638,-168,0,45,1,6
15002,3,2336,2426,-90,0,236,0,6
15003,2,2659,2669,-10,0,190,0,6
15004,2,2400,2423,-23,0,122,0,6
15005,1,2428,2442,-14,0,302,0,6
15006,2,2304,2449,-145,4,106,0,13
15007,1,2469,2392,77,0,330,0,6
15008,2,2372,2523,-151,0,45,1,6
15009,1,2572,2460,112,0,403,0,6
15010,2,2631,2629,2,0,200,1,6
15011,1,2447,2479,-32,0,202,1,6
15012,1,2528,2477,51,0,463,1,6
15013,1,2383,2470,-87,0,414,0,8
15014,1,2554,2549,5,0,106,0,6
15015,1,2518,2403,115,0,0,0,8
15016,3,2437,2496,-59,0,162,0,6
15017,2,2323,2401,-78,0,41,1,6
15018,2,2638,2745,-107,0,195,0,6
15019,3,2287,2400,-113,0,4,0,6
15020,2,2456,2282,174,0,248,1,8
15021,2,2362,2415,-53,0,201,1,6
15022,1,2387,2469,-82,0,1,1,6
15023,2,2375,2432,-57,0,13,0,6
15024,2,2363,2472,-109,0,2,0,6
15025,2,2378,2495,-117,0,415,0,6
15026,3,2407,2268,139,0,37,0,6
15027,2,2323,2428,-105,0,4,0,6
15028,2,2528,2569,-41,0,43,0,6
15029,2,2449,2535,-86,0,15,1,6
15030,3,2415,2346,69,0,0,0,6
15031,1,2431,2365,66,0,222,1,6
15032,3,2341,2410,-69,0,245,0,6
15033,1,2458,2360,98,0,130,1,6
15034,1,2524,2382,142,0,121,0,6
15035,2,2408,2314,94,0,7,0,6
15036,2,2419,2353,66,0,245,0,6
15037,1,2373,2484,-111,0,207,0,6
15038,1,2432,2363,69,0,46,0,6
15039,2,2503,2525,-22,0,306,1,6
15040,2,2382,2532,-150,0,49,0,6
15041,2,2341,2511,-170,0,311,0,6
15042,2,2501,2475,26,0,4,0,6
15043,2,2539,2545,-6,0,212,0,6
15044,2,2684,2782,-98,0,487,0,6
15045,2,2412,2348,64,0,490,1,6
15046,1,2428,2394,34,0,0,1,6
15047,2,2428,2300,128,0,113,1,6
15048,3,2636,2702,-66,0,190,0,6
15049,1,2436,2539,-103,0,242,0,6
15050,2,2465,2653,-188,0,4,0,6
15051,2,2543,2426,117,0,0,0,6
15052,2,2359,2560,-201,0,2,0,6
15053,1,2420,2312,108,0,110,1,6
15054,3,2499,2347,152,0,300,0,6
15055,2,2303,2479,-176,0,325,1,6
15056,1,2409,2426,-17,0,411,0,6
15057,2,2332,2439,-107,0,227,0,6
15058,2,2554,2576,-22,0,228,0,6
15059,1,2570,2456,114,0,217,0,6
15060,2,2369,2403,-34,0,193,0,6
15061,3,2536,2533,3,0,5,0,6
15062,1,2553,2399,154,0,224,0,6
15063,2,2476,2472,4,0,302,0,6
15064,3,2530,2378,152,0,125,0,6
15065,1,2436,2434,2,0,111,1,6
15066,1,2629,2554,75,0,406,0,6
15067,1,2454,2222,232,0,123,0,3
15068,1,2268,2411,-143,4,144,1,13
15069,2,2436,2448,-12,0,1,0,6
15070,1,2429,2331,98,0,4,0,6
15071,1,2387,2442,-55,0,132,1,6
15072,1,2495,2321,174,0,190,1,6
15073,1,2514,2397,117,0,44,0,6
15074,2,2311,2424,-113,0,337,1,6
15075,2,2416,2556,-140,0,101,0,6
15076,1,2634,2635,-1,0,100,0,6
15077,1,2243,2414,-171,0,150,0,8
15078,1,2465,2574,-109,0,43,0,6
15079,1,2526,2397,129,0,110,0,6
15080,1,2425,2254,171,0,101,0,6
15081,2,2786,2673,113,0,305,0,6
15082,1,2422,2338,84,0,253,0,6
15083,1,2409,2353,56,0,150,0,6
15084,2,2342,2419,-77,0,245,0,6
15085,2,2465,2438,27,0,123,0,6
15086,1,2347,2414,-67,0,100,0,6
15087,1,2579,2398,181,0,344,0,8
15088,1,2405,2311,94,0,302,0,6
15089,2,2391,2432,-41,0,150,0,6
15090,1,2630,2640,-10,0,0,0,6
15091,1,2550,2533,17,0,487,0,6
15092,1,2481,2453,28,0,4,0,6
15093,2,2298,2476,-178,4,302,0,13
15094,2,2394,2495,-101,0,1,0,6
15095,2,2352,2487,-135,0,106,0,6
15096,1,2498,2473,25,0,106,0,6
15097,1,2549,2634,-85,0,190,0,6
15098,2,2656,2749,-93,0,267,0,6
15099,1,2405,2332,73,0,30,0,6
15100,1,2462,2494,-32,0,462,0,6
15101,3,2428,2470,-42,0,242,0,6
15102,2,2316,2433,-117,0,339,0,6
15103,3,2562,2377,185,0,335,0,6
15104,1,2405,2284,121,0,476,0,6
15105,1,2443,2436,7,0,15,1,6
15106,1,2532,2356,176,0,40,1,6
15107,2,2423,2373,50,0,153,0,6
15108,1,2381,2527,-146,0,304,0,6
15109,2,2485,2634,-149,0,175,0,6
15110,3,2477,2361,116,0,251,0,6
15111,2,2355,2443,-88,0,45,0,6
15112,2,2322,2513,-191,0,414,0,6
15113,1,2533,2452,81,0,41,0,6
15114,2,2497,2575,-78,0,123,1,6
15115,2,2399,2448,-49,0,270,0,8
15117,1,2482,2346,136,0,107,0,6
15118,2,2270,2405,-135,0,330,1,6
15119,1,2486,2582,-96,0,7,0,6
15120,2,2454,2431,23,0,106,1,6
15121,2,2428,2441,-13,0,469,0,6
15122,2,2518,2485,33,0,302,0,6
15123,2,2534,2524,10,0,115,0,6
15124,2,2308,2420,-112,0,440,0,6
15125,1,2380,2516,-136,0,202,1,6
15126,2,2328,2463,-135,0,101,0,6
15127,1,2410,2268,142,0,4,0,6
15128,1,2498,2386,112,0,107,0,6
15129,1,2407,2354,53,0,4,0,6
15130,1,2436,2318,118,0,20,1,6
15131,1,2428,2363,65,0,40,0,6
15132,1,2406,2445,-39,0,4,0,6
15133,2,2394,2406,-12,0,100,0,6
15134,2,2356,2453,-97,0,107,0,8
15135,1,2567,2494,73,0,300,1,6
15136,1,2305,2413,-108,0,45,0,6
15137,1,2627,2557,70,0,406,0,6
15138,1,2438,2404,34,0,49,1,6
15139,1,2420,2415,5,0,474,0,6
15140,1,2528,2556,-28,0,212,0,6
15141,2,2575,2444,131,0,315,0,6
15142,2,2674,2652,22,0,83,0,6
15143,1,2447,2350,97,0,172,0,6
15144,1,2499,2554,-55,0,327,0,6
15145,2,2468,2533,-65,0,130,0,6
15146,2,2467,2509,-42,0,246,0,6
15147,1,2463,2358,105,0,406,0,6
15148,2,2652,2753,-101,0,278,0,6
15149,2,2406,2396,10,0,245,0,8
15150,1,2468,2394,74,0,13,0,6
15151,2,2258,2433,-175,0,108,0,6
15152,3,2638,2470,168,0,4,0,6
15153,2,2692,2779,-87,0,101,0,6
15154,1,2467,2359,108,0,3,0,6
15155,2,2482,2560,-78,0,106,0,6
15156,3,2519,2390,129,0,4,0,6
15157,2,2437,2448,-11,0,0,0,6
15158,2,2632,2538,94,0,0,0,6
15159,1,2448,2512,-64,0,11,0,6
15160,1,2658,2491,167,0,295,0,6
15161,2,2434,2455,-21,0,4,1,6
15162,2,2382,2502,-120,0,130,0,6
15163,1,2464,2535,-71,0,242,0,6
15164,2,2353,2504,-151,0,2,0,6
15165,3,2430,2383,47,0,485,0,6
15166,1,2548,2506,42,0,4,0,6
15167,2,2360,2530,-170,0,241,1,6
15168,1,2412,2536,-124,0,10,0,6
15169,1,2413,2346,67,0,464,0,6
15170,2,2559,2532,27,0,264,1,6
15171,2,2342,2485,-143,0,106,0,6
15172,1,2581,2492,89,0,125,0,6
15173,1,2433,2293,140,0,111,0,6
15174,2,2448,2327,121,0,131,1,6
15175,1,2235,2423,-188,0,114,0,6
15176,2,2432,2570,-138,0,0,0,6
15177,2,2532,2528,4,0,453,0,6
15178,2,2349,2412,-63,0,100,0,6
15179,2,2509,2445,64,0,40,0,6
15180,2,2550,2534,16,0,426,0,6
15181,1,2466,2373,93,0,150,1,6
15182,1,2447,2429,18,0,0,0,6
15183,1,2365,2449,-84,0,46,0,6
15184,2,2206,2431,-225,0,122,0,7
15186,2,2564,2467,97,0,426,1,6
15187,2,2439,2438,1,0,14,0,6
15188,2,2552,2632,-80,0,150,0,6
15189,2,2250,2456,-206,0,120,0,3
15190,1,2507,2350,157,0,40,0,6
15191,1,2412,2384,28,0,227,1,6
15192,1,2505,2321,184,0,57,0,6
15193,2,2408,2431,-23,0,4,0,6
15194,2,2441,2383,58,0,46,0,6
15195,1,2455,2571,-116,0,13,0,6
15196,1,2453,2444,9,0,227,1,6
15197,2,2395,2583,-188,0,345,0,8
15198,1,2501,2553,-52,0,11,0,6
15199,2,2433,2389,44,0,268,0,6
15200,2,2489,2463,26,0,8,1,6
15201,1,2399,2413,-14,0,107,1,6
15202,1,2475,2298,177,0,210,1,6
15203,2,2301,2466,-165,0,46,0,6
15204,3,2478,2647,-169,0,192,0,6
15205,1,2489,2452,37,0,310,0,6
15206,1,2515,2528,-13,0,331,0,6
15207,1,2392,2517,-125,0,48,0,6
15208,3,2428,2437,-9,0,455,0,6
15209,2,2488,2758,-270,0,277,0,6
15210,2,2437,2395,42,4,261,0,13
15211,2,2472,2635,-163,0,2,0,6
15212,1,2545,2625,-80,0,40,0,6
15213,2,2457,2276,181,0,200,1,8
15214,1,2380,2421,-41,0,122,1,6
15215,1,2506,2378,128,0,107,0,6
15216,3,2645,2480,165,0,145,0,6
15217,1,2370,2409,-39,0,15,0,6
15218,2,2452,2365,87,0,101,0,6
15219,3,2586,2429,157,0,267,0,6
15220,3,2533,2393,140,0,320,0,6
15221,1,2410,2233,177,0,409,0,6
15222,1,2488,2528,-40,0,241,0,6
15223,3,2347,2502,-155,0,3,0,6
15224,3,2460,2436,24,0,352,0,6
15225,2,2392,2553,-161,0,45,1,6
15226,1,2538,2451,87,0,10,0,6
15227,1,2783,2682,101,0,485,0,6
15228,1,2452,2428,24,0,107,0,6
15229,1,2636,2548,88,0,406,0,6
15230,1,2437,2426,11,0,49,0,6
15231,2,2405,2319,86,4,222,0,13
15232,2,2486,2567,-81,0,265,0,6
15233,2,2464,2462,2,0,113,0,6
15234,1,2479,2298,181,4,204,0,13
15235,2,2618,2431,187,0,0,0,6
15236,1,2414,2490,-76,0,10,0,6
15237,1,2472,2236,236,0,141,0,8
15238,2,2331,2480,-149,0,1,0,6
15239,3,2663,2661,2,0,113,0,6
15240,1,2424,2298,126,0,243,0,6
15241,2,2358,2401,-43,0,132,1,6
15242,2,2564,2462,102,0,41,1,6
15243,2,2368,2474,-106,0,410,0,6
15244,2,2474,2472,2,0,200,1,6
15245,1,2440,2434,6,0,151,0,6
15246,1,2557,2589,-32,0,310,0,6
15247,2,2377,2508,-131,0,302,0,6
15248,1,2534,2524,10,0,265,1,6
15249,1,2386,2446,-60,0,487,0,6
15250,2,2345,2400,-55,0,4,0,8
15251,2,2478,2483,-5,0,15,0,6
15252,2,2428,2439,-11,0,0,0,6
15253,2,2432,2408,24,0,107,0,6
15254,2,2437,2470,-33,0,1,1,6
15255,2,2366,2433,-67,0,180,0,6
15256,2,2355,2405,-50,0,45,1,6
15257,1,2546,2508,38,0,459,0,6
15258,1,2295,2478,-183,0,207,0,6
15259,2,2562,2483,79,0,398,1,6
15260,2,2494,2460,34,0,310,0,6
15261,2,2522,2642,-120,0,45,0,6
15262,1,2395,2427,-32,0,203,0,6
15263,3,2336,2442,-106,0,106,0,6
15264,2,2209,2448,-239,0,1,0,8
15265,1,2522,2445,77,0,253,0,6
15266,2,2451,2427,24,0,103,0,6
15267,1,2472,2317,155,0,46,1,6
15268,1,2430,2478,-48,0,418,0,6
15269,2,2444,2468,-24,0,104,1,6
15270,1,2437,2257,180,0,300,0,6
15271,1,2499,2426,73,0,46,0,6
15272,2,2730,2638,92,0,130,0,6
15273,2,2277,2414,-137,0,107,1,6
15274,3,2429,2471,-42,0,320,0,6
15275,2,2493,2349,144,0,200,0,6
15276,2,2415,2446,-31,0,7,0,6
15277,2,2304,2425,-121,0,331,0,6
15278,2,2438,2537,-99,0,130,0,6
15279,1,2499,2518,-19,0,107,0,6
15280,1,2439,2294,145,0,8,1,6
15281,1,2403,2421,-18,0,315,0,6
15282,2,2542,2394,148,0,32,0,8
15283,1,2479,2410,69,0,265,0,6
15284,1,2556,2482,74,0,269,0,6
15285,2,2252,2402,-150,4,130,0,13
15286,1,2571,2564,7,0,395,0,6
15287,1,2459,2265,194,0,101,0,3
15288,2,2447,2609,-162,0,10,0,6
15289,1,2479,2441,38,0,302,0,6
15290,1,2472,2437,35,0,43,0,6
15291,1,2416,2342,74,0,45,0,6
15292,1,2344,2438,-94,0,180,0,6
15293,2,2395,2531,-136,0,241,0,6
15294,1,2422,2447,-25,0,211,1,6
15295,1,2333,2418,-85,0,255,0,8
15296,2,2641,2504,137,0,483,0,6
15297,1,2484,2317,167,0,110,1,6
15298,1,2458,2438,20,0,125,0,6
15299,1,2399,2459,-60,0,264,0,6
15300,1,2440,2266,174,0,211,0,6
15301,1,2556,2512,44,0,300,0,6
15302,1,2426,2373,53,0,311,0,6
15303,1,2468,2459,9,0,101,0,6
15304,2,2583,2563,20,0,4,0,6
15305,1,2503,2551,-48,0,110,0,6
15306,2,2446,2443,3,0,205,0,6
15307,3,2428,2424,4,0,14,0,6
15308,2,2444,2423,21,0,278,0,6
15309,3,2420,2439,-19,0,75,0,6
15310,2,2673,2787,-114,0,101,0,6
15311,2,2475,2489,-14,0,246,0,6
15312,1,2448,2340,108,0,113,0,8
15313,2,2405,2432,-27,0,41,0,6
15314,1,2366,2417,-51,0,2,0,6
15315,1,2662,2488,174,0,109,1,6
15316,1,2722,2561,161,0,101,0,6
15317,1,2429,2335,94,0,45,0,6
15318,2,2424,2305,119,0,4,0,6
15319,2,2417,2484,-67,0,106,0,6
15320,2,2247,2413,-166,0,251,0,6
15321,2,2390,2484,-94,0,40,1,6
15322,3,2467,2474,-7,0,6,0,6
15323,2,2238,2408,-170,0,56,0,6
15324,2,2586,2392,194,0,344,0,8
15325,1,2505,2477,28,0,250,0,6
15326,1,2415,2313,102,0,0,1,6
15327,1,2512,2439,73,0,45,1,6
15328,1,2583,2621,-38,0,0,1,6
15329,2,2421,2401,20,0,268,0,6
15330,2,2440,2386,54,0,255,0,6
15331,2,2461,2517,-56,0,7,0,6
15332,1,2431,2428,3,0,41,0,6
15333,2,2357,2476,-119,0,3,1,6
15334,2,2423,2442,-19,0,4,0,6
15335,1,2613,2432,181,0,131,0,6
15336,1,2484,2328,156,0,311,0,6
15337,1,2444,2318,126,0,15,0,6
15338,1,2465,2339,126,0,61,1,6
15339,1,2646,2558,88,0,295,0,6
15340,3,2441,2378,63,0,88,0,6
15341,2,2432,2412,20,0,106,1,6
15342,3,2403,2317,86,0,15,0,6
15343,2,2507,2577,-70,0,337,1,6
15344,2,2431,2453,-22,0,253,0,6
15345,2,2401,2577,-176,0,345,0,8
15346,2,2487,2562,-75,0,207,1,6
15347,1,2420,2400,20,0,315,0,6
15348,2,2274,2439,-165,0,71,0,6
15349,1,2424,2289,135,0,43,0,6
15350,1,2512,2428,84,0,302,1,6
15351,2,2231,2419,-188,0,112,0,6
15352,1,2364,2409,-45,0,388,0,6
15353,1,2415,2417,-2,0,20,0,6
15354,1,2569,2577,-8,0,426,0,6
15355,1,2633,2463,170,0,385,0,6
15356,2,2227,2405,-178,0,150,0,6
15357,1,2545,2509,36,0,4,0,6
15358,1,2344,2508,-164,0,101,0,6
15360,2,2390,2441,-51,0,201,0,6
15361,2,2434,2433,1,0,211,0,6
15362,1,2449,2440,9,0,440,0,6
15363,2,2402,2390,12,0,45,0,8
15364,2,2489,2431,58,0,300,1,6
15365,1,2477,2413,64,0,300,1,6
15366,1,2429,2438,-9,0,46,1,6
15367,2,2272,2430,-158,0,242,0,6
15368,1,2558,2451,107,0,112,0,6
15369,2,2338,2412,-74,0,113,0,6
15370,2,2407,2415,-8,0,203,1,6
15371,2,2378,2546,-168,0,45,0,6
15372,2,2474,2485,-11,0,2,0,6
15373,3,2365,2534,-169,0,311,0,8
15374,1,2459,2494,-35,0,122,0,6
15375,3,2451,2207,244,0,201,0,6
15376,1,2385,2511,-126,0,46,0,6
15377,2,2448,2354,94,0,7,1,6
15378,2,2393,2434,-41,0,311,1,6
15379,1,2434,2517,-83,0,241,0,6
15380,2,2437,2418,19,0,46,0,6
15381,1,2331,2406,-75,0,302,1,6
15382,1,2504,2550,-46,0,110,1,6
15383,1,2407,2222,185,4,303,0,13
15384,1,2468,2421,47,0,2,0,6
15385,2,2490,2625,-135,0,226,0,6
15386,1,2477,2350,127,0,405,0,6
15387,2,2425,2328,97,0,107,0,6
15388,1,2458,2454,4,0,114,0,6
15389,2,2578,2616,-38,0,106,1,6
15390,1,2636,2448,188,0,307,1,6
15391,1,2429,2508,-79,0,245,0,6
15392,2,2231,2462,-231,0,140,0,3
15393,2,2200,2409,-209,0,122,0,6
15394,1,2571,2575,-4,0,270,0,6
15395,2,2403,2480,-77,0,344,1,6
15396,1,2488,2353,135,0,201,0,6
15397,2,2416,2381,35,0,96,0,6
15398,1,2502,2428,74,0,337,1,6
15399,2,2446,2319,127,0,310,0,6
15400,1,2590,2582,8,0,237,0,6
15401,1,2445,2388,57,0,302,0,6
15402,2,2523,2440,83,0,4,1,6
15403,1,2516,2357,159,0,48,0,6
15404,1,2394,2426,-32,0,255,0,6
15405,1,2499,2391,108,0,338,0,6
15406,3,2566,2483,83,0,45,0,6
15407,2,2287,2483,-196,4,338,0,13
15408,2,2446,2375,71,0,389,1,6
15409,1,2615,2562,53,0,46,0,6
15410,1,2494,2472,22,0,4,0,6
15411,1,2629,2486,143,0,130,0,6
15412,1,2382,2432,-50,0,331,0,6
15413,1,2488,2465,23,0,250,0,6
15414,2,2384,2408,-24,0,50,0,6
15415,2,2336,2477,-141,0,5,0,8
15416,2,2259,2418,-159,0,140,0,6
15417,1,2402,2500,-98,0,162,0,6
15418,2,2408,2335,73,0,107,0,6
15419,1,2489,2378,111,0,190,1,6
15420,3,2417,2482,-65,0,113,0,6
15421,1,2449,2379,70,0,300,0,6
15422,3,2557,2620,-63,0,112,0,6
15423,2,2464,2439,25,0,121,0,6
15424,3,2503,2543,-40,0,250,0,6
15425,2,2424,2313,111,0,176,1,6
15426,1,2580,2398,182,0,345,0,8
15427,1,2379,2435,-56,0,414,0,6
15428,1,2443,2268,175,0,101,0,6
15429,2,2321,2410,-89,0,200,1,6
15430,2,2253,2481,-228,4,246,0,5
15431,1,2420,2402,18,0,268,0,6
15432,2,2481,2349,132,0,95,0,6
15433,1,2361,2406,-45,0,278,1,6
15434,1,2381,2550,-169,0,45,0,6
15435,1,2510,2483,27,0,45,0,6
15436,3,2632,2441,191,0,145,0,6
15437,1,2416,2405,11,0,7,0,6
15438,2,2398,2439,-41,0,310,0,6
15439,2,2239,2416,-177,0,255,0,6
15440,3,2433,2421,12,0,58,0,6
15441,2,2649,2473,176,0,331,1,6
15442,1,2403,2286,117,0,9,0,6
15443,3,2668,2493,175,0,455,0,6
15444,1,2365,2408,-43,0,107,1,6
15445,2,2445,2639,-194,0,11,0,6
15446,1,2362,2450,-88,0,125,0,6
15447,2,2621,2584,37,0,0,0,6
15448,3,2309,2416,-107,0,40,0,6
15449,2,2481,2418,63,0,112,0,6
15450,1,2576,2507,69,0,400,0,6
15451,1,2423,2381,42,0,334,0,6
15452,2,2484,2565,-81,0,207,1,6
15453,2,2310,2402,-92,0,450,0,6
15454,2,2484,2500,-16,0,302,0,6
15455,1,2409,2516,-107,0,114,0,6
15456,1,2558,2386,172,0,122,0,6
15457,2,2240,2403,-163,0,132,0,6
15458,1,2477,2515,-38,0,107,0,6
15459,2,2388,2438,-50,0,310,0,6
15460,3,2619,2595,24,0,132,0,6
15461,2,2399,2504,-105,0,140,0,6
15462,2,2280,2439,-159,0,110,1,6
15463,1,2410,2386,24,0,57,0,6
15464,2,2674,2515,159,0,113,1,6
15465,1,2397,2425,-28,0,133,1,6
15466,3,2319,2420,-101,0,127,0,6
15467,1,2297,2474,-177,0,17,0,6
15468,1,2343,2428,-85,0,226,0,6
15470,2,2498,2665,-167,0,177,0,8
15471,1,2408,2387,21,0,46,0,8
15472,1,2453,2444,9,0,300,0,6
15473,2,2425,2474,-49,0,114,0,6
15474,1,2422,2267,155,0,107,0,6
15475,2,2334,2416,-82,0,45,0,6
15476,1,2420,2401,19,0,331,0,6
15477,1,2460,2442,18,0,150,0,6
15478,1,2365,2485,-120,0,1,1,8
15479,1,2573,2630,-57,0,255,0,6
15480,2,2416,2356,60,0,5,0,6
15481,3,2414,2398,16,0,122,0,6
15482,1,2444,2424,20,0,7,1,6
15483,2,2521,2414,107,0,154,0,6
15484,1,2502,2511,-9,0,41,0,6
15485,2,2312,2401,-89,0,40,0,6
15486,1,2665,2581,84,0,265,0,6
15487,1,2374,2493,-119,0,409,1,6
15488,3,2666,2615,51,0,40,0,6
15489,2,2381,2447,-66,0,125,0,6
15490,1,2589,2591,-2,0,10,0,6
15491,2,2496,2505,-9,0,250,1,6
15492,1,2359,2426,-67,0,395,1,6
15493,1,2554,2384,170,0,4,0,6
15494,1,2421,2421,0,0,11,1,6
15495,3,2364,2435,-71,0,247,0,6
15496,3,2641,2642,-1,0,347,0,6
15497,2,2421,2372,49,0,17,0,6
15498,2,2441,2483,-42,0,104,1,6
15499,1,2623,2428,195,0,297,0,6
15500,2,2486,2369,117,0,122,0,6
15501,1,2561,2473,88,0,121,0,6
15502,1,2509,2509,0,0,41,0,6
15503,2,2569,2484,85,0,440,0,6
15504,1,2415,2214,201,0,40,1,6
15505,2,2518,2701,-183,0,1,0,6
15506,1,2406,2255,151,0,112,0,6
15508,1,2433,2251,182,0,123,0,6
15509,2,2410,2305,105,0,140,1,6
15510,2,2439,2392,47,0,115,1,6
15511,1,2508,2403,105,0,107,1,6
15512,2,2486,2276,210,4,211,0,13
15513,1,2388,2508,-120,0,122,1,6
15514,2,2409,2244,165,0,9,0,6
15515,2,2479,2420,59,0,112,0,6
15516,2,2479,2437,42,0,46,0,6
15517,1,2438,2459,-21,0,201,0,6
15518,1,2333,2413,-80,0,115,0,8
15519,1,2438,2321,117,0,487,1,6
15520,1,2505,2503,2,0,107,0,6
15521,1,2353,2424,-71,4,40,0,13
15522,2,2474,2343,131,0,207,1,6
15523,1,2437,2403,34,0,302,1,6
15524,2,2308,2415,-107,0,110,1,6
15525,1,2442,2352,90,0,220,0,6
15526,1,2301,2426,-125,0,343,0,6
15527,1,2398,2414,-16,0,203,0,6
15528,1,2449,2382,67,0,196,1,6
15529,2,2467,2594,-127,0,41,0,6
15530,2,2465,2449,16,0,49,1,6
15531,1,2419,2412,7,0,241,0,6
15532,3,2565,2641,-76,0,265,0,6
15533,1,2615,2642,-27,0,1,1,6
15534,1,2543,2380,163,0,200,0,6
15535,1,2491,2562,-71,0,201,0,6
15536,1,2433,2405,28,0,484,1,6
15537,2,2511,2607,-96,0,7,0,6
15538,2,2418,2342,76,0,463,0,6
15539,2,2316,2526,-210,0,112,1,8
15540,1,2491,2465,26,0,250,0,6
15541,1,2416,2287,129,0,228,0,6
15542,1,2334,2427,-93,0,1,0,6
15543,3,2426,2255,171,0,44,0,6
15544,1,2525,2425,100,0,406,0,6
15545,3,2395,2514,-119,0,132,0,6
15546,1,2488,2549,-61,0,2,1,6
15547,2,2299,2421,-122,0,15,0,6
15548,2,2378,2401,-23,0,125,0,6
15549,3,2446,2436,10,0,415,0,6
15550,3,2335,2415,-80,0,45,0,6
15551,1,2629,2579,50,0,120,0,6
15552,1,2419,2257,162,0,302,1,6
15553,2,2451,2292,159,0,108,0,6
15554,1,2585,2618,-33,0,0,0,6
15555,1,2704,2515,189,0,301,0,6
15556,1,2568,2626,-58,0,311,0,6
15557,2,2417,2401,16,0,120,1,6
15558,2,2373,2402,-29,0,4,1,8
15559,1,2626,2651,-25,0,461,0,6
15560,2,2337,2436,-99,0,232,1,6
15561,2,2400,2467,-67,0,4,0,6
15562,1,2497,2357,140,0,40,0,6
15563,2,2399,2512,-113,0,40,1,6
15564,1,2427,2472,-45,0,114,0,6
15565,2,2400,2453,-53,0,40,1,6
15566,1,2405,2288,117,0,483,0,6
15567,1,2313,2472,-159,0,302,0,6
15568,2,2376,2669,-293,0,1,0,8
15569,2,2501,2511,-10,0,49,0,6
15570,2,2411,2350,61,4,304,0,13
15571,2,2232,2405,-173,0,156,0,8
15572,1,2596,2444,152,0,415,0,6
15573,1,2411,2386,25,0,8,0,6
15574,1,2345,2447,-102,0,115,1,6
15575,1,2555,2498,57,0,45,0,6
15576,2,2437,2546,-109,0,311,0,6
15577,2,2418,2372,46,0,331,1,6
15578,1,2598,2417,181,0,33,0,6
15579,2,2507,2463,44,0,4,0,6
15580,2,2348,2422,-74,0,264,1,8
15581,1,2421,2530,-109,0,330,1,6
15582,2,2263,2401,-138,0,190,1,6
15583,1,2331,2442,-111,0,234,1,6
15584,2,2398,2537,-139,0,104,1,6
15585,2,2591,2639,-48,0,253,0,6
15586,2,2336,2424,-88,0,41,0,6
15587,1,2619,2575,44,0,331,0,6
15588,2,2392,2402,-10,0,315,0,6
15589,1,2492,2343,149,0,131,1,6
15590,2,2633,2622,11,0,40,0,6
15591,2,2295,2423,-128,0,236,1,6
15592,1,2612,2507,105,0,102,1,6
15593,1,2455,2365,90,0,8,0,6
15594,2,2480,2496,-16,0,147,0,6
15595,2,2495,2567,-72,0,2,0,6
15596,3,2408,2345,63,0,352,0,6
15597,2,2542,2512,30,0,140,0,6
15598,1,2542,2459,83,0,18,0,6
15599,2,2454,2248,206,0,107,0,6
15601,2,2493,2560,-67,0,101,1,6
15602,2,2403,2407,-4,0,40,0,6
15603,1,2522,2464,58,0,302,0,6
15604,1,2467,2390,77,0,56,1,6
15605,2,2618,2636,-18,0,330,0,6
15606,2,2528,2304,224,0,4,0,8
15607,2,2437,2410,27,0,263,0,6
15608,1,2429,2286,143,0,269,0,6
15609,2,2422,2430,-8,0,107,0,6
15610,2,2321,2433,-112,0,46,1,6
15611,1,2516,2395,121,0,241,0,6
15612,2,2375,2446,-71,0,13,1,6
15613,1,2550,2379,171,0,200,0,6
15614,1,2607,2574,33,0,45,0,6
15615,2,2261,2440,-179,0,152,1,6
15616,1,2463,2268,195,4,110,0,13
15617,2,2354,2495,-141,0,3,0,6
15618,2,2288,2417,-129,0,4,0,8
15619,1,2429,2267,162,0,150,1,6
15620,1,2458,2472,-14,0,15,0,6
15621,1,2516,2644,-128,0,244,1,6
15622,1,2414,2411,3,0,41,0,6
15623,1,2516,2669,-153,0,112,1,6
15624,1,2414,2406,8,0,51,0,6
15625,2,2601,2500,101,0,110,0,6
15626,2,2557,2440,117,0,4,1,6
15627,2,2217,2445,-228,0,14,0,6
15628,2,2297,2439,-142,0,317,0,6
15629,2,2309,2411,-102,0,218,0,6
15630,1,2624,2627,-3,0,110,0,6
15631,2,2405,2379,26,0,132,0,6
15632,3,2644,2490,154,0,103,0,6
15633,2,2394,2571,-177,0,101,1,6
15634,2,2459,2406,53,0,302,0,6
15635,2,2569,2612,-43,0,150,0,6
15636,3,2279,2417,-138,0,300,0,6
15637,1,2427,2436,-9,0,386,0,6
15638,1,2433,2309,124,0,241,0,6
15639,1,2518,2526,-8,0,57,0,6
15640,2,2391,2467,-76,0,95,1,6
15641,1,2616,2541,75,0,102,0,6
15642,2,2436,2403,33,0,106,0,6
15643,2,2361,2546,-185,0,135,0,6
15644,1,2435,2520,-85,0,484,0,6
15645,3,2365,2423,-58,0,302,0,6
15646,2,2499,2502,-3,0,49,1,6
15647,2,2228,2404,-176,0,107,0,6
15648,1,2381,2425,-44,0,190,1,6
15649,1,2387,2403,-16,0,303,0,6
15650,2,2350,2459,-109,0,2,1,6
15651,3,2512,2446,66,0,208,0,6
15652,2,2421,2259,162,0,0,1,8
15653,2,2549,2489,60,0,27,0,6
15654,2,2417,2339,78,0,15,0,6
15655,1,2565,2570,-5,0,45,0,6
15656,1,2362,2425,-63,0,131,0,6
15657,1,2513,2422,91,0,302,0,6
15659,2,2414,2565,-151,0,114,0,6
15660,1,2521,2402,119,0,337,1,6
15661,2,2550,2381,169,0,414,0,6
15662,2,2375,2527,-152,0,332,1,6
15663,2,2435,2376,59,0,302,1,6
15664,1,2412,2263,149,0,5,0,6
15665,1,2544,2613,-69,0,5,0,6
15666,1,2340,2408,-68,0,45,0,6
15667,1,2496,2473,23,0,45,0,6
15668,1,2317,2460,-143,0,106,0,6
15669,2,2288,2432,-144,0,115,0,6
15670,2,2307,2403,-96,0,301,1,6
15671,1,2596,2505,91,0,490,1,6
15672,1,2430,2433,-3,0,264,0,6
15673,2,2309,2477,-168,4,428,0,13
15674,2,2292,2448,-156,0,120,0,6
15675,2,2341,2581,-240,0,0,0,8
15676,1,2594,2599,-5,0,16,0,6
15677,2,2391,2408,-17,0,4,0,8
15678,2,2370,2464,-94,0,0,0,6
15679,2,2621,2630,-9,0,426,0,6
15680,2,2309,2432,-123,0,41,0,6
15681,1,2406,2421,-15,0,40,0,6
15682,1,2385,2524,-139,0,236,0,6
15684,2,2344,2466,-122,4,45,0,13
15685,1,2564,2637,-73,0,255,0,6
15686,1,2445,2387,58,0,201,0,6
15687,1,2308,2478,-170,0,477,0,8
15688,1,2508,2360,148,0,158,0,6
15689,3,2471,2386,85,0,312,0,6
15690,1,2448,2415,33,0,302,0,6
15691,2,2415,2201,214,0,479,0,6
15692,2,2493,2548,-55,0,331,1,6
15693,2,2274,2433,-159,0,436,0,6
15694,1,2437,2401,36,0,154,1,6
15695,2,2470,2400,70,0,101,0,6
15696,2,2672,2665,7,0,35,0,6
15697,1,2413,2312,101,0,466,0,6
15698,2,2305,2453,-148,0,303,0,6
15699,1,2412,2419,-7,0,145,1,6
15700,2,2620,2524,96,0,265,0,6
15701,2,2264,2671,-407,0,4,0,8
15702,2,2521,2636,-115,0,301,0,6
15703,1,2433,2440,-7,0,311,0,6
15704,1,2426,2410,16,0,170,1,6
15705,2,2410,2391,19,0,357,0,6
15706,1,2414,2325,89,0,45,1,6
15708,2,2495,2507,-12,0,140,0,6
15709,1,2406,2233,173,0,57,0,6
15710,1,2324,2501,-177,0,247,0,6
15711,1,2546,2474,72,0,491,1,6
15712,3,2452,2412,40,0,310,0,6
15713,2,2387,2574,-187,0,373,0,6
15714,2,2464,2346,118,0,4,0,6
15715,1,2630,2616,14,0,434,0,6
15716,1,2452,2327,125,0,0,0,6
15717,1,2260,2416,-156,0,40,0,6
15718,2,2542,2365,177,4,1,1,13
15719,2,2443,2401,42,0,380,1,6
15720,2,2419,2387,32,0,8,1,6
15721,2,2606,2642,-36,0,491,0,6
15722,2,2289,2400,-111,0,5,1,6
15723,2,2389,2503,-114,0,102,0,6
15724,3,2562,2571,-9,0,13,0,6
15725,2,2468,2433,35,0,6,0,6
15726,2,2427,2436,-9,0,150,0,6
15727,1,2467,2394,73,0,12,0,6
15728,1,2449,2417,32,0,243,1,6
15729,1,2570,2600,-30,0,483,1,6
15730,2,2383,2555,-172,0,45,0,6
15731,1,2369,2501,-132,0,2,0,6
15732,1,2369,2442,-73,0,311,0,6
15733,2,2507,2600,-93,0,378,0,6
15734,1,2584,2264,320,0,217,1,8
15735,1,2411,2290,121,0,202,0,6
15736,1,2377,2600,-223,0,310,1,6
15737,1,2403,2264,139,4,302,0,13
15738,2,2409,2407,2,0,190,1,6
15739,2,2456,2301,155,0,43,1,6
15740,1,2453,2516,-63,0,302,0,6
15741,1,2673,2320,353,0,411,0,8
15742,1,2436,2371,65,0,45,0,6
15743,2,2456,2318,138,0,352,0,8
15744,1,2658,2593,65,0,133,0,6
15745,3,2511,2624,-113,0,106,0,6
15746,3,2447,2392,55,0,110,0,6
15747,2,2404,2397,7,0,303,0,6
15748,1,2422,2419,3,0,41,0,6
15749,1,2413,2386,27,0,140,0,8
15750,2,2493,2333,160,0,0,0,6
15751,2,2472,2635,-163,0,265,0,6
15752,2,2316,2409,-93,0,106,0,6
15753,1,2417,2393,24,0,36,0,6
15754,2,2411,2460,-49,0,140,0,6
15755,1,2450,2377,73,0,21,0,6
15756,1,2436,2526,-90,0,115,0,6
15757,2,2321,2410,-89,0,302,1,6
15758,1,2640,2517,123,0,57,0,6
15759,3,2436,2418,18,0,106,0,6
15760,2,2503,2507,-4,0,28,0,6
15761,2,2413,2487,-74,0,46,0,6
15762,1,2495,2472,23,0,103,1,6
15763,2,2201,2412,-211,0,0,0,8
15764,2,2380,2430,-50,0,40,0,6
15765,2,2433,2389,44,0,133,0,6
15766,2,2435,2514,-79,0,70,1,6
15767,2,2610,2628,-18,0,58,0,6
15768,2,2472,2465,7,0,49,0,6
15769,1,2604,2503,101,0,81,0,6
15770,1,2314,2441,-127,0,213,0,6
15771,2,2571,2562,9,0,300,0,6
15772,1,2498,2446,52,0,458,0,6
15773,3,2480,2299,181,4,350,0,13
15774,1,2396,2446,-50,0,190,0,6
15775,3,2494,2384,110,0,30,0,6
15776,3,2394,2455,-61,0,302,0,6
15777,3,2490,2601,-111,0,148,0,6
15778,2,2513,2354,159,0,210,0,6
15779,1,2513,2439,74,0,195,0,6
15780,1,2410,2348,62,4,110,0,13
15781,2,2413,2405,8,0,138,1,6
15782,3,2536,2542,-6,0,372,0,6
15783,3,2377,2518,-141,0,487,0,6
15784,1,2403,2384,19,0,373,0,6
15785,1,2509,2357,152,0,152,0,6
15786,1,2427,2253,174,0,120,0,8
15787,2,2429,2439,-10,0,331,0,6
15788,2,2413,2442,-29,0,126,0,6
15789,1,2404,2391,13,0,268,1,6
15790,2,2451,2322,129,0,455,0,6
15791,1,2437,2364,73,0,76,0,6
15792,3,2408,2399,9,0,45,0,6
15793,2,2273,2492,-219,0,45,0,8
15794,1,2594,2386,208,0,13,0,6
15795,2,2317,2479,-162,0,246,0,6
15796,2,2448,2377,71,0,46,0,6
15797,1,2455,2436,19,0,192,0,6
15798,2,2286,2455,-169,0,1,0,6
15799,2,2413,2372,41,0,15,1,6
15800,3,2463,2395,68,0,300,0,8
15801,2,2347,2421,-74,0,40,0,6
15802,2,2437,2379,58,0,338,0,6
15803,2,2296,2409,-113,0,115,0,6
15804,2,2265,2422,-157,0,265,1,6
15805,1,2351,2407,-56,0,101,0,6
15806,1,2622,2443,179,0,170,0,6
15807,1,2517,2466,51,0,132,1,6
15808,2,2341,2484,-143,0,100,0,6
15809,2,2388,2423,-35,0,4,0,6
15810,1,2422,2363,59,0,120,0,6
15811,2,2310,2441,-131,0,302,0,6
15812,2,2309,2436,-127,0,45,0,6
15813,2,2513,2503,10,0,4,0,6
15814,1,2435,2414,21,0,352,0,6
15815,3,2639,2613,26,0,310,0,6
15816,1,2499,2316,183,0,409,1,6
15817,2,2581,2406,175,0,119,0,6
15818,2,2492,2408,84,0,40,1,6
15819,2,2303,2426,-123,0,0,1,6
15820,3,2330,2443,-113,0,9,0,6
15821,1,2568,2565,3,0,200,0,6
15822,2,2633,2428,205,0,0,0,6
15823,2,2308,2441,-133,0,335,0,8
15824,2,2558,2435,123,0,100,0,6
15825,1,2480,2317,163,0,28,0,8
15826,1,2472,2234,238,0,107,1,8
15827,3,2516,2327,189,0,12,0,8
15828,1,2471,2467,4,0,49,0,6
15829,2,2400,2306,94,0,31,0,6
15830,1,2525,2386,139,0,302,0,6
15831,1,2412,2323,89,0,4,0,6
15832,1,2361,2441,-80,0,0,0,6
15833,2,2386,2407,-21,0,325,0,6
15834,2,2362,2536,-174,0,3,0,6
15835,2,2599,2596,3,0,0,0,6
15836,2,2505,2542,-37,0,226,0,6
15837,2,2299,2433,-134,0,200,0,6
15838,1,2373,2513,-140,0,245,0,6
15839,3,2281,2450,-169,0,140,0,6
15840,2,2460,2507,-47,0,102,0,6
15841,2,2439,2396,43,0,176,0,6
15842,2,2308,2413,-105,0,41,0,6
15843,1,2425,2275,150,0,50,0,6
15844,1,2519,2517,2,0,81,0,6
15845,1,2415,2310,105,0,0,0,8
15846,2,2428,2383,45,0,27,0,6
15847,1,2357,2408,-51,4,100,1,13
15848,2,2411,2408,3,0,153,0,6
15849,1,2407,2230,177,0,41,0,6
15850,1,2644,2605,39,0,405,0,6
15851,1,2409,2447,-38,0,190,1,6
15852,2,2241,2495,-254,0,455,1,8
15853,2,2403,2364,39,0,15,0,6
15854,2,2551,2467,84,0,200,1,6
15855,1,2409,2313,96,0,43,1,6
15856,2,2428,2540,-112,0,487,0,6
15857,2,2587,2624,-37,0,102,0,6
15858,2,2286,2426,-140,0,47,0,6
15859,2,2458,2282,176,0,4,0,6
15860,2,2330,2586,-256,0,3,0,8
15861,2,2414,2580,-166,0,292,1,6
15862,1,2360,2419,-59,0,144,0,6
15863,1,2500,2477,23,0,122,0,6
15864,1,2638,2445,193,0,346,0,6
15865,1,2413,2315,98,0,150,0,6
15866,2,2354,2441,-87,0,43,1,6
15867,2,2324,2442,-118,0,300,0,6
15868,2,2402,2363,39,0,202,0,6
15870,2,2442,2418,24,0,46,0,6
15871,2,2293,2400,-107,0,4,0,8
15872,1,2440,2289,151,0,313,0,6
15873,2,2567,2492,75,0,145,0,6
15874,1,2437,2355,82,0,45,0,6
15875,1,2386,2407,-21,0,145,0,6
15876,1,2434,2368,66,0,43,0,6
15877,2,2559,2574,-15,0,300,1,6
15878,1,2490,2359,131,0,94,0,6
15879,1,2430,2244,186,0,107,1,8
15880,1,2437,2637,-200,0,190,0,6
15881,1,2396,2462,-66,0,113,1,8
15882,1,2408,2359,49,0,151,1,6
15883,1,2382,2502,-120,0,102,0,6
15884,2,2415,2433,-18,0,20,1,6
15885,2,2483,2473,10,0,463,0,6
15886,2,2649,2509,140,0,40,0,6
15887,2,2402,2393,9,0,36,0,6
15888,1,2513,2385,128,0,14,0,8
15889,1,2624,2535,89,0,41,0,6
15890,2,2389,2422,-33,0,111,0,6
15891,2,2415,2584,-169,4,268,0,13
15892,2,2451,2248,203,0,178,1,6
15893,1,2418,2313,105,0,45,1,6
15894,3,2417,2444,-27,0,411,0,6
15895,1,2411,2344,67,0,344,0,6
15896,1,2554,2506,48,0,151,0,6
15897,3,2371,2505,-134,0,250,0,6
15898,1,2471,2505,-34,0,125,0,6
15899,1,2341,2400,-59,0,37,1,6
15900,1,2438,2418,20,0,1,0,6
15901,2,2276,2419,-143,0,311,0,6
15902,1,2419,2304,115,0,110,0,8
15903,1,2424,2455,-31,0,300,0,6
15904,1,2630,2512,118,0,22,0,6
15905,1,2434,2435,-1,0,440,0,6
15906,1,2414,2451,-37,0,131,0,6
15907,2,2271,2428,-157,0,330,0,6
15908,2,2452,2461,-9,0,470,0,6
15909,2,2460,2423,37,0,255,0,6
15910,1,2359,2517,-158,0,1,1,8
15912,1,2423,2406,17,0,258,0,6
15913,2,2299,2443,-144,0,85,0,6
15914,1,2628,2383,245,0,201,1,6
15915,3,2404,2347,57,0,302,0,6
15916,1,2441,2416,25,0,145,0,6
15917,1,2300,2423,-123,0,41,0,8
15918,1,2355,2494,-139,0,2,1,6
15919,2,2401,2326,75,0,0,0,6
15920,1,2309,2442,-133,0,246,0,6
15921,1,2408,2263,145,0,111,0,6
15922,2,2446,2641,-195,0,251,0,6
15923,1,2452,2409,43,0,255,0,6
15924,1,2474,2544,-70,0,80,1,6
15925,1,2447,2290,157,0,114,0,6
15926,1,2446,2319,127,0,375,0,6
15927,2,2392,2432,-40,0,148,0,6
15928,2,2579,2554,25,0,13,0,6
15929,1,2225,2503,-278,4,115,0,13
15930,1,2399,2494,-95,0,80,0,6
15931,1,2364,2439,-75,0,40,0,6
15932,3,2566,2628,-62,0,140,0,6
15933,1,2401,2413,-12,0,4,1,6
15934,1,2441,2266,175,0,313,0,6
15935,3,2406,2389,17,0,118,0,6
15936,2,2400,2478,-78,0,140,0,6
15937,1,2304,2436,-132,0,246,1,6
15938,1,2415,2351,64,0,0,0,6
15939,3,2381,2517,-136,0,48,0,6
15940,1,2350,2412,-62,0,211,0,6
15941,1,2207,2404,-197,0,41,1,8
15942,2,2497,2675,-178,0,119,0,8
15943,3,2394,2409,-15,0,30,0,6
15944,2,2517,2544,-27,0,487,1,6
15945,2,2469,2525,-56,0,140,0,6
15946,2,2464,2390,74,0,9,0,6
15947,1,2669,2501,168,0,4,0,6
15948,2,2411,2446,-35,0,190,0,6
15949,2,2333,2423,-90,0,58,0,8
15950,1,2370,2499,-129,0,200,1,6
15951,2,2335,2430,-95,0,268,0,6
15952,2,2439,2520,-81,0,212,0,6
15953,1,2468,2295,173,0,193,0,6
15954,1,2323,2451,-128,0,104,0,6
15955,2,2434,2392,42,0,45,0,6
15956,1,2511,2525,-14,0,406,0,6
15957,3,2474,2493,-19,0,90,0,6
15958,2,2422,2384,38,0,302,0,6
15959,1,2254,2409,-155,0,254,0,6
15960,2,2411,2592,-181,0,114,0,6
15961,2,2443,2420,23,0,196,0,6
15962,1,2467,2446,21,0,9,0,6
15963,2,2503,2449,54,0,246,0,6
15964,2,2422,2439,-17,0,454,0,6
15965,3,2309,2401,-92,0,302,0,6
15966,1,2428,2291,137,0,221,0,6
15967,2,2631,2508,123,0,104,1,6
15968,3,2446,2432,14,0,332,0,6
15969,2,2341,2472,-131,0,1,0,6
15970,1,2477,2292,185,0,341,0,6
15971,2,2413,2376,37,0,310,1,6
15972,2,2374,2449,-75,0,180,0,6
15973,2,2349,2444,-95,0,46,0,6
15974,1,2633,2474,159,0,45,1,6
15975,2,2255,2428,-173,0,181,1,6
15976,1,2425,2392,33,0,77,0,6
15977,1,2487,2410,77,0,44,0,6
15978,1,2486,2363,123,0,94,0,6
15979,2,2458,2387,71,0,108,0,6
15980,1,2553,2404,149,0,245,0,6
15981,2,2287,2431,-144,0,107,1,6
15982,3,2560,2573,-13,0,300,0,6
15983,2,2397,2549,-152,0,457,0,6
15984,1,2427,2366,61,0,0,0,8
15985,2,2415,2241,174,0,53,0,8
15986,1,2448,2451,-3,0,301,0,6
15987,1,2524,2435,89,0,100,0,6
15988,1,2406,2480,-74,0,57,0,6
15989,1,2537,2443,94,0,229,0,6
15990,1,2433,2377,56,0,120,1,8
15991,1,2361,2470,-109,0,1,0,6
15992,1,2453,2530,-77,0,101,1,6
15993,2,2346,2420,-74,0,40,0,6
15994,1,2590,2368,222,0,107,0,8
15995,1,2429,2427,2,0,478,0,6
15996,3,2515,2383,132,0,305,0,6
15997,2,2384,2434,-50,0,289,0,6
15998,1,2360,2490,-130,0,3,0,6
15999,2,2559,2627,-68,0,140,0,6
16000,2,2390,2405,-15,0,290,0,6
16001,2,2401,2371,30,0,453,1,6
16002,2,2541,2641,-100,0,229,0,6
16003,2,2289,2454,-165,0,41,0,6
16004,1,2482,2396,86,0,248,1,6
16005,1,2284,2405,-121,0,315,0,6
16006,1,2429,2396,33,0,306,0,6
16007,1,2473,2413,60,0,44,0,6
16008,1,2417,2293,124,0,7,0,6
16009,1,2409,2392,17,0,40,0,6
16010,2,2499,2659,-160,0,192,0,6
16011,2,2512,2578,-66,0,6,0,6
16012,1,2587,2478,109,4,14,1,13
16013,2,2415,2332,83,0,41,1,6
16014,1,2390,2450,-60,0,125,0,6
16015,1,2416,2294,122,0,202,0,8
16016,1,2496,2353,143,0,176,1,6
16017,2,2429,2456,-27,0,190,0,6
16018,1,2456,2492,-36,0,102,1,6
16019,3,2457,2219,238,0,107,0,6
16020,2,2439,2297,142,0,40,1,6
16021,1,2445,2320,125,0,1,0,6
16022,2,2643,2550,93,0,106,0,6
16023,2,2602,2463,139,0,203,0,6
16024,1,2426,2493,-67,0,103,0,6
16025,2,2476,2672,-196,0,151,0,6
16026,1,2435,2255,180,0,106,0,6
16027,2,2435,2518,-83,0,330,0,6
16028,2,2402,2230,172,0,332,0,8
16029,1,2400,2353,47,0,57,0,6
16030,1,2519,2374,145,0,330,0,6
16031,2,2445,2416,29,0,337,0,6
16032,2,2463,2623,-160,0,196,0,6
16033,2,2612,2424,188,0,107,0,6
16034,2,2311,2434,-123,0,46,0,6
16035,2,2298,2454,-156,0,184,0,6
16036,1,2553,2391,162,0,311,0,6
16037,2,2224,2401,-177,0,260,0,6
16038,2,2298,2425,-127,0,247,0,6
16039,1,2678,2304,374,0,31,0,8
16040,1,2394,2451,-57,0,241,0,6
16041,3,2385,2431,-46,0,127,0,6
16042,1,2452,2405,47,0,105,0,6
16043,1,2439,2390,49,0,394,0,6
16044,1,2435,2327,108,0,35,0,6
16045,1,2516,2458,58,0,107,1,6
16046,2,2353,2535,-182,0,4,0,6
16047,1,2284,2462,-178,0,44,0,6
16048,1,2431,2529,-98,0,301,1,6
16049,1,2579,2602,-23,0,241,0,6
16050,3,2482,2368,114,0,210,0,6
16051,2,2271,2406,-135,0,9,0,6
16052,1,2645,2537,108,0,415,0,6
16053,2,2456,2393,63,0,8,0,6
16054,1,2632,2555,77,0,454,0,6
16055,2,2595,2430,165,0,394,1,6
16056,2,2573,2560,13,0,207,1,6
16057,1,2637,2590,47,0,0,1,6
16058,2,2418,2340,78,0,210,0,6
16059,2,2243,2592,-349,0,461,0,8
16060,1,2403,2411,-8,0,70,0,6
16061,2,2345,2403,-58,0,190,0,6
16062,2,2365,2408,-43,0,380,0,6
16063,2,2410,2421,-11,0,373,0,6
16064,1,2286,2421,-135,0,405,0,6
16065,2,2263,2424,-161,0,278,0,6
16066,1,2401,2278,123,0,0,0,6
16067,1,2288,2407,-119,0,4,1,8
16068,2,2408,2478,-70,0,454,1,6
16069,1,2419,2398,21,0,107,1,6
16070,1,2495,2507,-12,0,102,0,6
16071,2,2320,2409,-89,0,123,0,6
16072,1,2583,2408,175,0,396,0,6
16073,2,2411,2279,132,0,45,0,6
16074,1,2408,2397,11,0,133,0,6
16075,2,2433,2556,-123,0,200,0,6
16076,1,2486,2487,-1,0,3,1,6
16077,2,2391,2471,-80,0,210,0,6
16078,2,2388,2460,-72,0,41,1,6
16079,1,2627,2487,140,0,263,0,6
16080,1,2636,2517,119,0,105,1,6
16081,3,2388,2432,-44,0,45,0,8
16082,1,2557,2564,-7,0,100,0,6
16083,2,2485,2500,-15,0,331,0,6
16084,1,2405,2224,181,0,365,1,6
16085,2,2297,2408,-111,0,331,1,6
16086,1,2457,2460,-3,0,337,0,6
16087,2,2355,2431,-76,0,17,0,6
16088,2,2339,2485,-146,0,102,0,6
16089,2,2637,2601,36,0,418,0,6
16090,1,2462,2397,65,0,118,0,6
16091,2,2308,2423,-115,0,352,0,6
16092,3,2675,2473,202,0,6,0,6
16093,1,2406,2296,110,0,256,0,6
16094,1,2429,2367,62,0,240,0,6
16095,2,2538,2666,-128,0,248,0,6
16096,2,2443,2604,-161,0,300,0,6
16097,2,2438,2364,74,0,459,0,6
16098,1,2502,2431,71,0,43,0,6
16099,1,2470,2504,-34,0,4,0,6
16100,2,2317,2413,-96,0,106,1,6
16101,3,2679,2496,183,0,15,0,8
16102,1,2401,2294,107,0,122,0,6
16103,1,2586,2426,160,0,460,0,6
16104,2,2410,2533,-123,0,46,0,6
16105,3,2596,2521,75,0,10,0,6
16106,3,2307,2501,-194,0,106,0,6
16107,1,2439,2457,-18,0,436,1,6
16108,1,2400,2231,169,0,20,0,6
16109,1,2446,2313,133,0,123,0,6
16110,2,2453,2510,-57,0,80,0,6
16111,2,2385,2444,-59,0,0,0,6
16112,2,2594,2511,83,0,113,0,8
16113,1,2454,2278,176,0,207,0,6
16114,2,2521,2640,-119,0,131,1,6
16115,1,2481,2369,112,0,210,0,6
16116,2,2279,2449,-170,0,485,1,6
16117,2,2400,2530,-130,0,455,1,6
16118,2,2566,2567,-1,0,300,0,6
16119,2,2551,2567,-16,0,191,0,6
16120,2,2503,2395,108,0,131,1,6
16121,1,2441,2463,-22,0,439,1,6
16122,2,2501,2348,153,0,14,0,6
16123,2,2501,2642,-141,0,106,0,6
16124,2,2585,2571,14,0,404,0,6
16125,2,2607,2630,-23,0,80,1,6
16126,2,2274,2405,-131,0,140,0,6
16127,2,2405,2431,-26,0,297,1,6
16128,1,2465,2439,26,0,107,0,6
16129,2,2379,2444,-65,4,347,0,13
16130,2,2394,2427,-33,0,157,0,6
16131,1,2560,2541,19,0,464,1,6
16132,2,2429,2485,-56,0,106,0,6
16133,1,2396,2410,-14,0,202,0,6
16134,1,2405,2409,-4,0,211,0,6
16135,2,2490,2383,107,0,6,0,6
16136,2,2637,2498,139,0,200,1,6
16137,1,2476,2425,51,0,190,0,6
16138,2,2292,2417,-125,0,106,1,6
16139,1,2468,2209,259,0,204,0,6
16140,2,2387,2589,-202,0,153,0,6
16141,1,2392,2475,-83,0,40,0,6
16142,2,2483,2393,90,0,7,0,6
16143,3,2506,2382,124,0,0,0,6
16144,2,2409,2310,99,0,153,0,8
16145,1,2505,2480,25,0,143,0,6
16146,2,2522,2424,98,0,395,0,6
16147,1,2290,2435,-145,0,338,0,6
16148,2,2441,2435,6,0,337,0,6
16149,1,2408,2276,132,0,18,0,6
16150,2,2405,2518,-113,0,418,0,6
16151,1,2607,2585,22,0,154,1,6
16152,3,2481,2425,56,0,44,0,6
16153,1,2365,2498,-133,0,3,0,6
16154,2,2431,2263,168,0,398,1,8
16155,2,2388,2405,-17,0,6,1,6
16156,2,2537,2406,131,0,120,0,6
16157,2,2492,2490,2,0,3,0,6
16158,3,2457,2373,84,0,203,0,6
16159,3,2534,2465,69,0,49,0,6
16160,1,2412,2327,85,0,311,0,6
16161,3,2280,2440,-160,0,153,0,6
16162,2,2499,2369,130,0,107,0,8
16163,2,2237,2677,-440,0,1,0,8
16164,2,2437,2351,86,0,113,0,6
16165,2,2243,2434,-191,0,248,0,6
16166,1,2275,2413,-138,0,122,0,6
16167,2,2361,2494,-133,0,51,0,6
16168,2,2427,2386,41,0,278,0,6
16169,1,2412,2385,27,0,216,0,6
16170,1,2515,2438,77,0,100,0,6
16171,1,2401,2354,47,0,490,0,6
16172,1,2449,2380,69,0,54,0,6
16173,1,2448,2379,69,0,120,0,6
16174,2,2379,2498,-119,0,4,0,6
16175,2,2266,2433,-167,0,42,0,6
16176,1,2644,2595,49,0,107,0,6
16177,2,2429,2310,119,0,409,0,6
16178,2,2522,2467,55,0,0,0,6
16179,2,2404,2403,1,0,302,1,6
16180,1,2331,2418,-87,0,200,0,6
16181,2,2573,2561,12,0,207,0,6
16182,2,2399,2408,-9,0,123,0,6
16183,2,2468,2645,-177,0,1,0,6
16184,2,2352,2534,-182,0,241,0,6
16185,1,2451,2453,-2,0,133,0,6
16186,1,2533,2498,35,0,124,0,6
16187,2,2466,2469,-3,0,112,0,6
16188,2,2382,2449,-67,0,122,0,6
16189,1,2475,2388,87,0,4,0,6
16190,3,2636,2602,34,0,57,0,6
16191,1,2649,2579,70,0,339,0,6
16192,2,2493,2402,91,0,485,0,6
16193,2,2588,2496,92,0,218,0,6
16194,1,2453,2298,155,0,301,0,6
16195,1,2404,2402,2,0,112,0,6
16196,3,2505,2384,121,0,1,0,6
16197,2,2354,2518,-164,0,278,1,6
16198,2,2451,2342,109,0,6,0,6
16199,2,2433,2566,-133,0,300,0,6
16200,2,2318,2587,-269,0,42,0,8
16201,1,2368,2402,-34,0,130,0,8
16202,1,2518,2228,290,0,12,0,8
16203,1,2472,2594,-122,0,13,0,6
16204,2,2506,2511,-5,0,400,1,6
16205,1,2417,2318,99,0,192,0,6
16206,1,2420,2475,-55,0,269,0,6
16207,2,2326,2430,-104,0,453,0,6
16208,1,2391,2453,-62,0,300,1,6
16209,2,2455,2384,71,0,49,0,6
16210,2,2308,2453,-145,0,211,0,6
16211,2,2427,2298,129,0,152,0,6
16212,1,2401,2374,27,0,123,0,6
16213,1,2365,2529,-164,0,222,1,6
16214,2,2412,2333,79,0,20,0,6
16215,1,2477,2296,181,0,105,1,6
16216,1,2283,2491,-208,0,4,1,8
16217,1,2589,2381,208,0,125,0,8
16218,1,2590,2396,194,0,28,0,6
16219,1,2649,2502,147,0,212,0,6
16220,1,2409,2290,119,0,107,1,6
16221,2,2496,2465,31,0,383,0,6
16222,2,2298,2432,-134,0,192,1,6
16223,1,2501,2644,-143,0,46,1,6
16224,2,2270,2406,-136,0,195,0,6
16225,1,2377,2444,-67,0,241,0,6
16226,1,2567,2567,0,0,300,0,6
16227,1,2480,2497,-17,0,45,1,6
16228,1,2437,2306,131,0,122,0,6
16229,1,2443,2443,0,0,9,0,6
16230,1,2612,2427,185,0,190,0,6
16231,2,2334,2417,-83,0,110,1,6
16232,1,2460,2375,85,0,40,0,6
16233,1,2505,2456,49,0,200,0,6
16234,3,2433,2519,-86,0,80,0,6
16235,2,2414,2393,21,0,123,0,6
16236,2,2411,2338,73,0,41,1,6
16237,1,2560,2369,191,0,240,0,6
16238,1,2354,2401,-47,0,252,1,6
16239,1,2564,2480,84,0,484,0,6
16240,2,2327,2421,-94,0,45,0,6
16241,2,2447,2456,-9,0,14,0,6
16242,2,2356,2456,-100,0,205,0,6
16243,2,2410,2474,-64,0,244,0,6
16244,1,2539,2516,23,0,103,0,6
16245,2,2602,2615,-13,0,331,0,6
16246,2,2349,2406,-57,0,180,0,6
16247,2,2537,2447,90,0,123,0,6
16248,2,2420,2424,-4,0,0,0,6
16249,1,2575,2493,82,0,398,0,6
16250,1,2580,2654,-74,0,244,0,6
16251,2,2561,2572,-11,0,335,0,6
16252,1,2480,2289,191,0,311,0,6
16253,2,2307,2471,-164,0,123,0,6
16254,1,2434,2288,146,0,243,1,6
16255,2,2407,2322,85,0,242,0,6
16256,1,2540,2486,54,0,104,0,6
16257,2,2348,2436,-88,0,490,0,6
16258,1,2409,2409,0,0,176,0,6
16259,1,2662,2630,32,0,6,0,6
16260,2,2569,2458,111,0,113,0,6
16261,2,2348,2503,-155,0,140,0,6
16262,2,2406,2353,53,0,123,0,6
16263,1,2569,2430,139,0,41,0,6
16264,2,2405,2257,148,0,304,1,6
16265,1,2400,2473,-73,0,304,1,8
16266,1,2293,2520,-227,0,110,0,8
16267,2,2558,2652,-94,0,130,0,6
16268,1,2424,2390,34,0,43,0,6
16269,2,2400,2332,68,0,101,0,6
16270,1,2521,2593,-72,0,107,1,6
16271,2,2417,2439,-22,0,245,0,6
16272,3,2481,2394,87,0,107,0,6
16273,1,2314,2402,-88,0,302,0,6
16274,1,2468,2432,36,0,101,0,6
16275,2,2455,2510,-55,0,211,1,6
16276,1,2472,2339,133,4,202,0,13
16277,2,2252,2446,-194,4,145,0,13
16278,3,2447,2375,72,0,398,0,6
16279,2,2456,2398,58,0,112,0,6
16280,2,2516,2521,-5,0,256,0,6
16281,1,2578,2556,22,0,300,1,6
16282,2,2502,2326,176,0,253,1,6
16283,1,2491,2358,133,0,106,0,6
16284,1,2480,2436,44,0,255,0,6
16285,3,2441,2399,42,0,7,0,6
16286,2,2239,2402,-163,0,110,0,6
16287,1,2302,2440,-138,0,337,0,6
16288,1,2354,2448,-94,0,404,0,6
16289,1,2482,2320,162,0,112,0,8
16290,2,2461,2352,109,0,337,1,6
16291,2,2600,2608,-8,0,457,0,6
16292,2,2403,2437,-34,0,10,1,6
16293,2,2273,2413,-140,0,0,0,6
16294,1,2476,2391,85,0,270,0,6
16295,1,2370,2568,-198,0,3,0,6
16296,2,2392,2591,-199,0,0,0,8
16297,1,2465,2426,39,0,45,0,6
16298,2,2426,2366,60,0,240,0,6
16299,3,2266,2457,-191,0,41,0,6
16300,2,2340,2449,-109,0,37,1,6
16301,2,2573,2657,-84,0,400,0,6
16302,2,2372,2440,-68,0,40,0,6
16303,1,2392,2478,-86,0,11,1,6
16304,1,2518,2435,83,0,100,1,6
16305,1,2636,2554,82,0,463,0,6
16306,2,2421,2273,148,0,400,0,6
16307,1,2424,2359,65,0,22,0,6
16308,2,2233,2426,-193,0,455,0,8
16309,3,2421,2321,100,0,192,0,6
16310,1,2419,2477,-58,0,227,0,6
16311,1,2371,2407,-36,0,4,0,8
16312,1,2488,2579,-91,0,192,0,6
16313,1,2429,2501,-72,0,107,0,6
16314,2,2533,2468,65,0,49,1,6
16315,1,2405,2415,-10,0,302,0,6
16316,1,2430,2331,99,0,404,0,6
16317,2,2614,2594,20,0,405,1,6
16318,1,2625,2544,81,0,144,0,6
16319,2,2510,2457,53,0,45,1,6
16320,2,2455,2481,-26,0,400,0,6
16321,1,2515,2384,131,0,165,0,6
16322,1,2621,2550,71,0,404,0,6
16323,1,2344,2403,-59,0,218,0,6
16324,1,2506,2396,110,0,400,1,6
16325,1,2415,2254,161,0,181,0,6
16326,1,2445,2340,105,0,241,0,6
16327,1,2444,2306,138,0,131,0,6
16328,3,2577,2586,-9,0,454,0,6
16329,1,2432,2310,122,0,122,0,6
16330,2,2412,2355,57,0,106,1,6
16331,2,2495,2470,25,0,200,0,6
16332,2,2331,2467,-136,0,405,0,6
16333,1,2523,2402,121,0,81,0,6
16334,1,2416,2255,161,0,194,0,6
16335,3,2512,2678,-166,0,27,0,8
16336,3,2528,2473,55,0,463,0,6
16337,1,2336,2445,-109,0,244,0,6
16338,2,2404,2404,0,0,40,0,6
16339,3,2450,2384,66,0,43,0,6
16340,1,2354,2431,-77,0,469,1,6
16341,2,2515,2369,146,0,158,0,6
16342,2,2312,2450,-138,0,300,1,6
16343,1,2278,2434,-156,0,106,0,6
16344,1,2341,2446,-105,0,254,0,6
16345,2,2254,2409,-155,0,241,0,6
16346,1,2494,2367,127,0,45,0,6
16347,2,2461,2436,25,0,6,0,6
16348,3,2443,2421,22,0,0,0,6
16349,1,2540,2505,35,0,161,0,6
16350,1,2437,2441,-4,0,201,1,6
16351,2,2454,2359,95,0,1,0,6
16352,1,2412,2326,86,0,104,0,6
16353,1,2479,2457,22,0,154,0,6
16354,2,2346,2499,-153,0,278,0,8
16355,2,2395,2480,-85,0,453,1,6
16356,1,2415,2282,133,0,41,0,6
16357,2,2272,2413,-141,0,41,0,6
16358,3,2560,2379,181,0,40,0,6
16359,3,2641,2572,69,0,448,0,6
16360,3,2290,2411,-121,0,253,0,6
16361,2,2367,2429,-62,0,106,0,8
16362,3,2471,2399,72,0,115,0,6
16363,1,2586,2387,199,0,138,0,6
16364,3,2306,2436,-130,0,487,0,6
16365,1,2322,2426,-104,0,302,0,6
16366,1,2540,2468,72,0,409,0,6
16367,1,2380,2519,-139,0,205,1,6
16368,1,2507,2302,205,0,132,1,6
16369,1,2237,2407,-170,0,115,1,8
16370,1,2466,2385,81,0,245,0,8
16371,1,2589,2504,85,0,10,0,6
16372,2,2398,2448,-50,0,10,1,6
16373,2,2527,2550,-23,0,333,0,6
16374,1,2310,2457,-147,4,112,0,13
16375,1,2471,2474,-3,0,111,1,6
16376,1,2502,2322,180,0,4,0,8
16377,2,2384,2539,-155,0,246,0,6
16378,2,2597,2625,-28,0,331,0,6
16379,1,2418,2330,88,0,190,1,6
16380,1,2430,2420,10,0,106,0,6
16382,1,2361,2405,-44,0,1,1,6
16383,2,2399,2494,-95,0,40,0,6
16384,2,2315,2401,-86,0,460,0,8
16385,1,2438,2336,102,0,455,0,6
16386,1,2410,2293,117,0,45,0,6
16387,2,2431,2475,-44,0,330,0,6
16388,2,2406,2439,-33,0,41,0,6
16389,1,2291,2421,-130,0,278,0,6
16390,1,2500,2496,4,0,132,0,6
16391,1,2403,2334,69,0,2,0,6
16392,3,2369,2442,-73,0,241,0,6
16393,2,2371,2453,-82,0,45,1,6
16395,1,2545,2649,-104,0,102,0,6
16396,1,2442,2521,-79,0,200,1,6
16397,2,2328,2676,-348,0,190,0,8
16398,2,2227,2514,-287,0,37,0,8
16399,2,2591,2613,-22,0,81,0,6
16400,1,2513,2631,-118,0,112,1,6
16401,2,2417,2453,-36,0,312,1,6
16402,1,2416,2437,-21,0,80,1,6
16403,2,2397,2525,-128,0,202,0,6
16404,2,2400,2375,25,0,46,0,6
16405,1,2481,2405,76,0,4,0,6
16406,2,2487,2226,261,0,142,1,8
16407,2,2391,2443,-52,0,263,0,6
16408,2,2384,2435,-51,0,34,0,6
16409,1,2445,2523,-78,0,199,0,6
16410,3,2424,2297,127,0,302,0,6
16411,2,2382,2472,-90,0,3,0,6
16412,2,2466,2447,19,0,106,0,6
16413,2,2392,2595,-203,0,0,0,8
16414,2,2472,2484,-12,0,40,1,6
16415,1,2436,2449,-13,0,4,0,6
16416,1,2402,2225,177,0,241,0,6
16417,1,2434,2309,125,0,122,0,6
16418,2,2547,2573,-26,0,190,1,6
16419,2,2325,2438,-113,0,45,0,6
16420,2,2381,2509,-128,0,117,0,6
16421,1,2417,2402,15,0,201,0,6
16422,2,2344,2640,-296,0,247,0,6
16423,1,2463,2544,-81,0,394,0,6
16424,2,2576,2480,96,0,104,0,6
16425,3,2346,2401,-55,0,35,0,6
16426,2,2488,2544,-56,0,154,0,6
16427,2,2400,2470,-70,0,302,0,6
16428,2,2506,2394,112,0,111,1,6
16429,1,2490,2523,-33,0,201,0,6
16430,2,2401,2250,151,0,200,0,6
16431,2,2444,2307,137,0,210,0,6
16432,2,2209,2453,-244,0,106,0,6
16433,2,2431,2426,5,0,436,0,6
16434,1,2513,2377,136,0,259,1,6
16435,1,2283,2420,-137,0,45,0,6
16436,1,2563,2393,170,0,123,0,6
16437,2,2418,2480,-62,0,331,0,6
16438,1,2442,2345,97,0,320,1,6
16439,2,2290,2414,-124,0,201,0,6
16440,1,2431,2435,-4,0,107,0,6
16441,1,2500,2483,17,0,107,1,6
16442,2,2421,2326,95,0,436,0,6
16443,2,2434,2516,-82,0,30,0,8
16444,1,2441,2370,71,0,5,1,6
16445,1,2619,2431,188,0,121,0,6
16446,1,2395,2435,-40,0,265,1,6
16447,2,2498,2412,86,0,100,1,6
16448,2,2243,2403,-160,0,310,1,6
16449,2,2368,2466,-98,0,1,0,6
16450,1,2476,2308,168,0,101,1,6
16451,2,2404,2383,21,0,241,0,8
16452,2,2400,2566,-166,0,388,1,6
16453,1,2405,2450,-45,0,150,0,6
16454,1,2556,2552,4,0,147,1,6
16455,2,2254,2400,-146,0,302,0,6
16456,2,2641,2570,71,0,37,0,6
16457,1,2522,2393,129,0,45,0,6
16458,2,2556,2431,125,0,100,0,6
16459,1,2287,2410,-123,0,122,0,6
16460,1,2458,2381,77,0,46,0,6
16461,1,2370,2485,-115,0,302,0,6
16462,2,2400,2388,12,0,45,0,6
16463,1,2485,2375,110,0,30,0,6
16464,2,2266,2457,-191,0,106,0,6
16465,1,2478,2250,228,0,106,0,8
16466,1,2598,2236,362,0,100,0,8
16467,2,2371,2414,-43,0,432,0,6
16468,2,2453,2312,141,0,310,0,6
16469,1,2476,2568,-92,0,100,0,6
16470,1,2452,2425,27,0,375,0,6
16471,2,2607,2531,76,0,123,0,6
16472,3,2677,2389,288,0,40,0,8
16473,1,2482,2452,30,0,462,1,6
16474,2,2514,2547,-33,0,483,0,6
16475,1,2432,2440,-8,0,476,1,6
16476,1,2409,2299,110,0,332,0,6
16477,2,2516,2496,20,0,130,0,6
16478,1,2276,2420,-144,0,428,0,6
16479,2,2475,2396,79,0,117,0,6
16480,1,2537,2471,66,0,409,0,6
16481,2,2472,2535,-63,0,278,0,6
16482,2,2335,2466,-131,4,48,0,13
16483,2,2578,2437,141,0,405,1,6
16484,2,2284,2436,-152,0,211,0,6
16485,1,2333,2505,-172,0,106,0,6
16486,3,2599,2481,118,0,109,0,8
16487,1,2405,2251,154,0,343,0,8
16488,1,2414,2345,69,0,41,1,6
16489,1,2449,2337,112,0,107,0,6
16490,2,2397,2581,-184,0,9,0,6
16491,1,2469,2364,105,0,40,0,6
16492,3,2483,2498,-15,0,121,0,6
16493,2,2402,2484,-82,0,45,0,6
16494,2,2374,2517,-143,0,300,0,6
16495,1,2460,2307,153,0,13,0,8
16496,1,2470,2284,186,0,112,0,6
16497,1,2361,2412,-51,0,0,0,6
16498,1,2410,2251,159,0,101,0,6
16499,1,2238,2442,-204,0,152,0,6
16500,1,2443,2473,-30,0,141,0,6
16501,1,2443,2426,17,0,335,0,6
16502,1,2412,2261,151,0,41,0,6
16503,2,2401,2376,25,0,40,0,8
16504,3,2541,2577,-36,0,40,0,6
16505,2,2315,2409,-94,0,460,0,8
16506,2,2433,2634,-201,0,40,0,6
16507,2,2471,2545,-74,0,109,0,6
16508,2,2490,2394,96,0,150,0,6
16509,2,2354,2405,-51,0,48,1,6
16510,3,2389,2467,-78,0,491,0,6
16511,2,2305,2479,-174,0,45,1,6
16512,1,2382,2429,-47,0,108,0,8
16513,1,2520,2332,188,0,461,0,8
16514,3,2569,2659,-90,0,270,0,6
16515,2,2439,2476,-37,4,464,0,13
16516,1,2446,2265,181,0,4,0,6
16517,1,2547,2569,-22,0,195,0,6
16518,1,2641,2448,193,0,464,0,6
16519,1,2482,2231,251,0,141,0,8
16520,1,2466,2542,-76,0,394,0,6
16521,2,2438,2527,-89,0,40,0,6
16522,2,2505,2502,3,0,301,0,6
16523,2,2381,2462,-81,0,18,0,6
16524,1,2485,2428,57,0,330,1,6
16525,2,2390,2420,-30,0,337,0,6
16526,2,2308,2424,-116,0,45,1,6
16527,2,2459,2413,46,0,277,0,6
16528,1,2344,2419,-75,0,152,0,6
16529,2,2445,2345,100,0,10,0,6
16530,2,2429,2497,-68,0,278,0,6
16531,1,2523,2347,176,0,46,0,8
16532,1,2403,2468,-65,0,302,0,6
16533,2,2439,2545,-106,0,4,1,6
16534,2,2294,2478,-184,0,125,0,6
16535,2,2487,2468,19,0,49,0,6
16536,2,2413,2316,97,0,116,0,8
16537,2,2412,2398,14,0,119,0,6
16538,2,2306,2488,-182,0,112,0,6
16539,2,2440,2438,2,0,242,0,6
16540,3,2254,2405,-151,0,122,0,6
16541,1,2625,2507,118,0,130,0,6
16542,1,2637,2547,90,0,152,0,6
16543,2,2382,2449,-67,0,107,0,6
16544,1,2449,2430,19,0,151,0,6
16545,2,2622,2488,134,0,110,0,6
16546,2,2266,2485,-219,0,15,0,8
16547,1,2466,2447,19,0,123,0,6
16548,2,2511,2553,-42,0,140,0,6
16549,1,2440,2320,120,0,352,0,6
16550,1,2450,2273,177,4,331,0,13
16551,1,2533,2334,199,0,200,0,6
16552,1,2453,2471,-18,0,45,0,6
16553,1,2528,2570,-42,0,403,0,6
16554,2,2253,2417,-164,0,10,0,6
16555,1,2360,2418,-58,0,1,0,6
16556,2,2340,2498,-158,0,122,0,6
16557,1,2434,2384,50,0,253,0,6
16558,2,2404,2455,-51,0,45,0,6
16559,1,2246,2425,-179,0,413,0,6
16560,2,2205,2527,-322,0,116,0,8
16561,2,2377,2418,-41,0,335,0,6
16562,3,2408,2584,-176,0,255,0,6
16563,2,2428,2462,-34,0,190,0,6
16564,2,2381,2467,-86,0,196,0,6
16565,1,2576,2532,44,0,469,1,6
16566,3,2489,2382,107,0,10,0,6
16567,2,2445,2466,-21,0,45,1,6
16568,2,2433,2247,186,0,0,1,6
16569,1,2402,2483,-81,0,264,0,6
16570,2,2369,2401,-32,0,245,0,6
16571,1,2428,2275,153,0,49,0,6
16572,1,2421,2419,2,0,120,0,6
16573,2,2457,2449,8,0,476,0,6
16574,1,2290,2483,-193,0,40,1,6
16575,2,2505,2692,-187,0,411,0,6
16576,1,2382,2410,-28,0,484,1,6
16577,1,2330,2482,-152,0,84,0,6
16578,2,2463,2230,233,0,241,0,8
16579,1,2423,2399,24,0,4,0,8
16580,1,2528,2401,127,0,13,0,8
16581,1,2469,2401,68,0,30,0,6
16582,2,2657,2571,86,0,487,0,6
16583,2,2334,2403,-69,0,300,0,6
16584,1,2508,2499,9,0,102,0,6
16585,2,2426,2476,-50,0,265,0,6
16586,1,2542,2361,181,0,40,1,6
16587,1,2461,2410,51,0,115,1,6
16588,1,2535,2473,62,0,419,1,6
16589,1,2501,2474,27,0,244,1,6
16590,1,2471,2376,95,0,250,0,6
16591,1,2474,2338,136,0,414,0,6
16592,1,2448,2286,162,0,0,0,6
16593,1,2453,2377,76,0,186,0,6
16594,1,2487,2223,264,0,141,0,8
16595,2,2400,2455,-55,0,305,0,6
16596,2,2380,2448,-68,0,337,0,6
16597,2,2418,2261,157,0,301,1,6
16598,1,2302,2434,-132,0,45,0,6
16599,2,2474,2642,-168,0,106,1,6
16600,1,2564,2545,19,0,390,0,6
16601,1,2434,2372,62,0,251,0,6
16602,2,2481,2379,102,0,156,0,6
16603,2,2272,2418,-146,0,112,0,6
16604,2,2475,2435,40,0,100,0,6
16605,2,2485,2432,53,0,246,0,6
16606,1,2674,2215,459,0,487,0,8
16607,1,2490,2391,99,0,64,0,6
16608,1,2403,2366,37,0,106,0,6
16609,2,2467,2500,-33,0,106,1,6
16610,2,2423,2372,51,0,45,0,6
16611,1,2401,2432,-31,4,31,0,13
16612,1,2432,2332,100,0,190,0,6
16613,1,2492,2506,-14,0,307,1,6
16614,1,2408,2287,121,0,226,0,6
16615,1,2420,2422,-2,0,462,0,6
16616,1,2444,2266,178,0,40,0,6
16617,1,2416,2251,165,0,0,0,6
16618,2,2441,2644,-203,0,265,0,6
16619,1,2260,2406,-146,0,255,1,8
16620,1,2207,2547,-340,0,107,0,6
16621,2,2591,2558,33,0,487,0,6
16622,2,2335,2478,-143,0,70,0,6
16623,1,2419,2321,98,0,414,1,6
16624,3,2496,2522,-26,0,381,0,6
16625,1,2503,2434,69,0,245,1,6
16626,1,2461,2466,-5,0,330,0,6
16627,1,2400,2263,137,0,380,0,6
16628,1,2452,2394,58,0,204,0,6
16629,3,2428,2489,-61,0,0,0,8
16630,2,2650,2502,148,0,40,0,6
16631,2,2395,2451,-56,0,304,0,6
16632,2,2400,2460,-60,0,49,0,6
16633,1,2425,2399,26,0,303,0,6
16634,2,2542,2423,119,0,40,0,6
16635,2,2454,2228,226,0,141,0,8
16636,2,2458,2382,76,0,46,0,6
16637,2,2282,2443,-161,0,92,1,6
16638,2,2414,2371,43,0,242,0,6
16639,1,2476,2361,115,0,106,0,6
16640,1,2380,2408,-28,0,145,1,6
16641,1,2451,2302,149,0,56,0,6
16642,2,2501,2512,-11,0,453,1,6
16643,2,2276,2400,-124,0,102,0,6
16644,2,2420,2581,-161,0,40,1,6
16645,1,2331,2439,-108,0,200,0,6
16646,1,2459,2375,84,0,253,0,6
16647,3,2675,2532,143,0,485,0,8
16648,2,2368,2439,-71,0,264,0,6
16649,1,2387,2474,-87,0,338,0,6
16650,1,2470,2494,-24,0,43,0,6
16651,3,2405,2466,-61,0,12,0,6
16652,2,2348,2469,-121,0,190,0,6
16653,1,2468,2540,-72,0,13,1,6
16654,1,2455,2529,-74,0,84,0,6
16655,1,2514,2507,7,0,161,0,6
16656,3,2326,2534,-208,0,0,0,8
16657,2,2359,2673,-314,0,5,0,8
16658,1,2462,2459,3,0,330,0,6
16659,1,2441,2410,31,0,4,0,6
16660,2,2308,2487,-179,0,441,0,6
16661,3,2426,2261,165,0,136,0,6
16662,2,2454,2300,154,4,242,1,13
16663,1,2564,2538,26,0,196,0,6
16664,2,2394,2426,-32,0,41,0,6
16665,1,2584,2570,14,0,332,0,6
16666,1,2469,2430,39,0,10,0,6
16667,2,2412,2563,-151,0,226,0,6
16668,1,2283,2450,-167,0,460,0,6
16669,1,2416,2338,78,0,300,0,6
16670,3,2376,2424,-48,0,45,0,6
16671,3,2450,2536,-86,0,45,0,6
16672,3,2645,2510,135,0,38,0,6
16673,1,2647,2439,208,0,464,0,6
16674,1,2363,2419,-56,0,292,1,6
16675,2,2500,2471,29,0,140,1,6
16676,2,2370,2444,-74,0,22,1,6
16677,2,2481,2331,150,0,45,0,6
16678,1,2465,2462,3,0,14,1,6
16679,2,2488,2470,18,0,0,0,6
16680,1,2505,2496,9,0,112,1,6
16681,2,2564,2562,2,0,330,0,6
16682,1,2473,2344,129,0,141,1,6
16683,2,2412,2423,-11,0,41,0,6
16684,1,2466,2394,72,0,156,0,6
16685,1,2494,2457,37,0,400,0,6
16686,1,2335,2407,-72,0,277,0,6
16687,1,2689,2590,99,0,61,0,6
16688,2,2465,2388,77,0,194,0,6
16689,1,2447,2476,-29,0,138,1,6
16690,2,2429,2436,-7,0,0,0,6
16691,2,2357,2480,-123,0,1,0,6
16692,1,2496,2391,105,0,302,0,6
16693,2,2393,2408,-15,0,354,0,6
16694,1,2584,2457,127,0,310,0,6
16695,3,2402,2355,47,0,100,0,6
16696,3,2551,2582,-31,0,45,0,6
16697,2,2436,2540,-104,0,487,0,6
16698,1,2470,2397,73,4,335,0,13
16699,2,2397,2513,-116,0,9,0,6
16700,2,2371,2406,-35,0,65,1,6
16701,2,2388,2406,-18,0,300,0,6
16702,3,2650,2593,57,0,107,0,6
16703,1,2431,2329,102,0,399,0,6
16704,1,2204,2415,-211,4,153,0,13
16705,1,2416,2302,114,0,85,0,6
16706,1,2468,2460,8,0,400,1,6
16707,2,2286,2458,-172,0,4,0,6
16708,1,2445,2539,-94,0,265,0,6
16709,3,2395,2409,-14,0,45,0,8
16710,1,2302,2447,-145,0,28,1,6
16711,2,2513,2481,32,0,17,0,6
16712,1,2501,2441,60,0,133,0,6
16713,1,2425,2388,37,0,48,1,6
16714,2,2514,2499,15,0,404,0,6
16715,1,2533,2475,58,0,419,0,6
16716,2,2386,2498,-112,0,277,0,6
16717,2,2452,2429,23,0,163,0,6
16718,2,2417,2368,49,0,300,0,6
16719,1,2531,2531,0,0,42,0,6
16720,1,2273,2428,-155,0,194,0,6
16721,3,2424,2409,15,0,106,0,6
16722,3,2477,2539,-62,0,107,0,6
16723,1,2485,2482,3,0,103,0,6
16724,2,2542,2570,-28,0,69,0,6
16725,1,2512,2558,-46,0,402,0,6
16726,1,2424,2375,49,0,101,0,6
16727,1,2413,2370,43,0,43,1,6
16728,1,2476,2498,-22,0,150,0,6
16729,1,2500,2520,-20,0,46,0,6
16730,2,2429,2522,-93,0,4,0,6
16731,2,2471,2347,124,0,136,0,6
16732,1,2477,2441,36,0,302,1,6
16733,1,2461,2371,90,0,5,0,6
16734,2,2567,2583,-16,0,13,0,6
16735,1,2287,2455,-168,0,184,0,6
16736,2,2456,2470,-14,0,196,1,6
16737,1,2532,2452,80,0,405,1,6
16738,1,2574,2464,110,0,260,1,6
16739,1,2340,2477,-137,0,192,1,6
16740,2,2456,2384,72,0,190,0,6
16741,2,2288,2401,-113,0,311,0,6
16742,1,2491,2616,-125,0,345,0,6
16743,2,2453,2588,-135,0,106,0,6
16744,1,2484,2354,130,0,106,1,6
16745,1,2586,2694,-108,0,28,0,6
16746,1,2421,2399,22,0,122,0,6
16747,1,2469,2326,143,0,127,1,5
16748,3,2414,2302,112,0,15,0,6
16749,2,2387,2530,-143,0,415,1,6
16750,1,2518,2470,48,0,307,1,6
16751,1,2403,2453,-50,0,100,0,6
16752,1,2423,2284,139,4,335,0,13
16753,1,2631,2594,37,0,107,0,6
16754,1,2517,2337,180,0,311,1,6
16755,1,2506,2520,-14,0,200,1,6
16756,2,2435,2284,151,0,334,0,6
16757,2,2463,2649,-186,0,267,0,6
16758,1,2487,2507,-20,0,103,0,6
16759,3,2363,2452,-89,0,107,0,6
16760,3,2423,2360,63,0,150,0,6
16761,2,2535,2377,158,0,302,0,6
16762,1,2411,2473,-62,0,30,0,6
16763,1,2465,2454,11,0,253,0,6
16764,1,2405,2255,150,0,111,0,6
16765,2,2481,2441,40,0,46,0,6
16766,2,2577,2636,-59,0,60,0,6
16767,3,2448,2366,82,0,267,0,6
16768,1,2366,2409,-43,0,21,0,6
16769,1,2538,2478,60,0,8,1,6
16770,1,2581,2420,161,0,65,1,6
16771,1,2471,2538,-67,0,13,0,6
16772,2,2552,2561,-9,0,45,1,6
16773,2,2294,2423,-129,0,46,1,6
16774,1,2485,2482,3,0,103,0,6
16775,2,2400,2253,147,0,143,0,6
16776,1,2575,2537,38,0,140,0,6
16777,2,2514,2506,8,0,244,0,6
16778,1,2526,2519,7,0,42,1,6
16779,2,2301,2439,-138,0,200,0,6
16780,1,2502,2401,101,0,312,1,6
16781,2,2403,2337,66,0,139,0,8
16782,1,2427,2352,75,0,282,0,6
16783,2,2370,2430,-60,0,115,0,6
16784,1,2592,2449,143,0,310,1,6
16785,1,2421,2449,-28,0,245,0,6
16786,2,2365,2418,-53,0,196,0,6
16787,2,2478,2367,111,0,154,0,6
16788,1,2409,2324,85,0,300,0,8
16789,2,2530,2579,-49,0,380,0,6
16790,2,2589,2562,27,0,300,0,6
16791,2,2320,2402,-82,0,112,0,6
16792,2,2404,2475,-71,0,242,0,6
16793,1,2447,2494,-47,0,302,0,6
16794,2,2545,2593,-48,0,315,0,6
16795,1,2472,2483,-11,0,140,0,5
16796,1,2451,2404,47,0,128,0,6
16797,2,2407,2476,-69,0,485,0,6
16798,1,2469,2348,121,0,141,0,6
16799,3,2231,2428,-197,0,250,0,6
16800,1,2350,2487,-137,0,1,0,6
16801,2,2477,2497,-20,0,45,0,6
16802,2,2652,2460,192,0,463,1,6
16803,1,2412,2350,62,0,4,0,6
16804,1,2605,2448,157,0,432,0,6
16805,1,2635,2572,63,0,418,0,6
16806,1,2383,2467,-84,0,398,0,6
16807,2,2367,2447,-80,0,306,1,6
16808,1,2275,2446,-171,0,226,0,6
16809,1,2447,2296,151,0,146,0,6
16810,1,2589,2498,91,0,350,0,6
16811,2,2531,2477,54,0,419,0,6
16812,2,2449,2514,-65,0,102,0,6
16813,2,2471,2512,-41,0,133,0,6
16814,2,2349,2520,-171,0,211,0,6
16815,1,2465,2607,-142,0,407,1,6
16816,2,2418,2409,9,0,2,0,6
16817,2,2344,2473,-129,0,303,0,6
16818,2,2373,2435,-62,0,13,1,6
16819,1,2425,2465,-40,0,108,0,6
16820,1,2409,2411,-2,0,106,0,6
16821,2,2353,2460,-107,0,235,0,6
16822,1,2435,2371,64,0,4,1,6
16823,1,2354,2401,-47,0,121,0,6
16824,2,2410,2456,-46,0,400,0,6
16825,1,2443,2350,93,0,61,0,6
16826,1,2567,2580,-13,0,453,0,6
16827,2,2425,2417,8,0,483,1,6
16828,1,2405,2286,119,0,0,0,6
16829,2,2289,2403,-114,0,127,0,6
16830,2,2360,2423,-63,0,101,1,6
16831,1,2432,2370,62,0,101,0,6
16832,1,2530,2345,185,0,133,0,0
16833,1,2423,2360,63,0,0,0,6
16834,3,2461,2446,15,0,100,0,6
16835,2,2426,2350,76,0,263,0,6
16836,2,2568,2583,-15,0,335,0,6
16837,2,2532,2610,-78,0,248,1,6
16838,2,2481,2473,8,0,148,0,6
16839,1,2445,2402,43,0,112,1,6
16840,2,2508,2503,5,0,52,1,6
16841,2,2369,2427,-58,0,203,0,6
16842,1,2568,2640,-72,0,145,0,6
16843,3,2526,2543,-17,0,302,0,6
16844,1,2513,2540,-27,0,457,0,6
16845,1,2480,2486,-6,0,40,0,6
16846,3,2598,2531,67,0,20,0,6
16847,1,2397,2506,-109,0,45,0,6
16848,1,2454,2409,45,0,40,0,6
16849,1,2595,2470,125,0,426,0,6
16850,2,2337,2443,-106,0,300,0,6
16851,1,2394,2445,-51,0,40,0,6
16852,2,2407,2584,-177,0,302,0,6
16853,2,2521,2365,156,0,4,1,6
16854,1,2594,2494,100,0,13,1,6
16855,1,2508,2472,36,0,103,0,6
16856,1,2324,2416,-92,0,61,1,6
16857,2,2392,2431,-39,0,278,1,6
16858,1,2411,2396,15,0,146,0,8
16859,2,2364,2527,-163,0,301,0,6
16860,2,2450,2422,28,0,45,0,6
16861,2,2447,2446,1,0,345,1,6
16862,1,2477,2478,-1,0,128,0,5
16863,2,2475,2481,-6,4,466,0,13
16864,1,2480,2358,122,0,106,0,6
16865,1,2410,2401,9,0,200,0,6
16866,2,2519,2436,83,0,46,0,6
16867,1,2574,2444,130,0,300,0,6
16868,2,2286,2437,-151,0,49,0,6
16869,1,2484,2525,-41,0,15,1,6
16870,1,2459,2466,-7,0,302,0,6
16871,1,2567,2533,34,0,39,0,6
16872,2,2476,2341,135,0,115,0,6
16873,2,2407,2404,3,0,100,0,6
16874,2,2340,2417,-77,0,45,0,6
16875,1,2668,2519,149,0,4,0,6
16876,2,2466,2518,-52,0,0,0,6
16877,2,2264,2414,-150,0,315,0,6
16878,1,2415,2412,3,0,112,0,6
16879,2,2498,2404,94,0,214,0,6
16880,1,2415,2300,115,0,35,1,6
16881,1,2536,2522,14,0,198,1,6
16882,1,2355,2428,-73,0,210,0,6
16883,1,2356,2415,-59,0,46,0,8
16884,2,2366,2473,-107,0,307,1,6
16885,1,2390,2534,-144,0,459,0,6
16886,1,2428,2253,175,0,107,0,6
16887,1,2406,2325,81,0,315,0,6
16888,2,2292,2450,-158,0,415,1,6
16889,2,2588,2563,25,0,45,0,6
16890,3,2289,2423,-134,0,49,0,6
16891,1,2466,2511,-45,0,4,0,6
16892,1,2435,2322,113,0,40,1,6
16893,2,2447,2599,-152,0,40,0,6
16894,3,2422,2438,-16,0,249,0,6
16895,1,2432,2363,69,0,267,0,6
16896,2,2447,2475,-28,0,9,0,6
16897,2,2460,2479,-19,0,120,0,6
16898,2,2348,2469,-121,0,190,0,6
16899,2,2393,2480,-87,0,102,0,6
16900,2,2395,2481,-86,0,302,0,6
16901,2,2276,2431,-155,0,107,1,6
16902,1,2516,2528,-12,0,405,0,6
16903,1,2587,2486,101,0,249,0,6
16904,1,2532,2597,-65,0,120,1,6
16905,1,2450,2460,-10,0,285,0,6
16906,1,2528,2462,66,0,103,0,6
16907,1,2458,2465,-7,0,267,0,6
16908,1,2313,2419,-106,0,80,0,6
16909,2,2447,2336,111,0,243,0,6
16910,2,2569,2582,-13,0,338,0,6
16911,2,2374,2513,-139,0,45,0,6
16912,1,2510,2502,8,0,125,1,6
16913,1,2490,2598,-108,0,455,1,6
16914,2,2402,2354,48,0,46,0,8
16915,2,2369,2440,-71,0,111,0,6
16916,1,2489,2362,127,0,44,0,6
16917,1,2537,2452,85,0,310,0,6
16918,1,2421,2298,123,0,460,0,6
16919,1,2642,2512,130,0,483,0,6
16920,1,2401,2480,-79,0,200,0,6
16921,1,2588,2564,24,0,300,0,6
16922,2,2440,2528,-88,0,484,0,6
16923,1,2518,2520,-2,0,337,0,6
16924,2,2354,2483,-129,0,1,0,6
16925,2,2405,2392,13,0,255,0,6
16926,1,2620,2578,42,0,483,0,6
16927,2,2419,2392,27,0,81,0,6
16928,1,2440,2300,140,0,123,1,6
16929,1,2416,2354,62,0,154,0,6
16930,1,2408,2343,65,0,406,0,6
16931,1,2409,2288,121,0,409,0,6
16932,3,2425,2261,164,0,250,0,6
16933,1,2767,2625,142,0,320,0,6
16934,1,2526,2472,54,0,345,0,6
16935,1,2431,2421,10,0,122,1,6
16936,1,2389,2403,-14,0,48,0,6
16937,1,2558,2593,-35,0,344,0,6
16938,1,2310,2436,-126,0,22,0,6
16939,1,2376,2437,-61,0,211,0,6
16940,1,2427,2300,127,0,84,1,6
16941,2,2457,2536,-79,0,150,0,6
16942,1,2541,2491,50,0,434,0,6
16943,1,2483,2401,82,0,106,0,6
16944,2,2372,2471,-99,0,15,1,6
16945,3,2361,2530,-169,0,15,0,6
16946,3,2430,2339,91,0,201,0,6
16947,2,2239,2444,-205,0,107,1,6
16948,2,2412,2323,89,0,4,0,6
16949,2,2477,2444,33,0,354,1,6
16950,1,2514,2524,-10,0,140,1,6
16951,2,2352,2472,-120,0,319,1,6
16952,2,2292,2464,-172,0,302,0,6
16953,1,2485,2454,31,0,113,0,6
16954,1,2420,2363,57,0,278,1,6
16955,3,2454,2456,-2,0,253,0,6
16956,1,2480,2441,39,0,100,1,6
16957,2,2473,2345,128,0,115,0,6
16958,2,2358,2499,-141,0,380,0,6
16959,1,2444,2320,124,0,48,0,6
16960,1,2527,2522,5,0,134,0,6
16961,2,2415,2318,97,0,40,0,6
16962,3,2434,2522,-88,0,143,0,6
16963,2,2501,2399,102,0,13,0,6
16964,3,2429,2417,12,0,83,0,6
16965,1,2516,2500,16,0,453,0,6
16966,2,2460,2374,86,0,485,1,6
16967,2,2422,2323,99,0,46,0,6
16968,3,2409,2417,-8,0,90,0,8
16969,1,2527,2542,-15,0,302,1,6
16970,1,2302,2423,-121,0,123,0,6
16971,3,2482,2591,-109,0,49,0,6
16972,1,2359,2425,-66,0,196,0,6
16973,1,2545,2532,13,0,258,1,6
16974,2,2493,2390,103,0,41,0,6
16975,1,2338,2411,-73,4,245,0,13
16976,2,2517,2370,147,0,8,0,6
16977,1,2485,2669,-184,0,224,0,6
16978,1,2477,2333,144,0,4,0,6
16979,2,2467,2397,70,0,121,0,6
16980,2,2453,2289,164,0,115,0,6
16981,1,2539,2508,31,0,200,1,6
16982,2,2402,2273,129,0,15,0,8
16983,2,2622,2771,-149,0,45,0,6
16984,2,2316,2408,-92,0,40,0,6
16985,2,2573,2590,-17,0,45,1,6
16986,1,2352,2465,-113,0,196,0,6
16987,2,2486,2546,-60,0,470,0,6
16988,1,2590,2488,102,0,49,1,6
16989,3,2554,2526,28,0,58,0,6
16990,1,2401,2289,112,0,244,0,6
16991,1,2486,2487,-1,0,49,1,6
16992,2,2350,2421,-71,0,1,1,6
16993,1,2447,2490,-43,0,8,0,6
16994,1,2254,2422,-168,0,100,0,6
16995,2,2438,2335,103,0,142,0,6
16996,1,2522,2553,-31,0,386,1,6
16997,1,2494,2473,21,0,200,0,6
16998,2,2397,2469,-72,0,45,0,6
16999,1,2574,2498,76,0,110,0,6
17000,1,2587,2565,22,0,45,1,6
17001,1,2392,2488,-96,0,101,1,6
17002,1,2391,2436,-45,0,418,0,6
17003,1,2439,2228,211,4,247,0,13
17004,1,2532,2388,144,0,215,1,6
17005,2,2349,2493,-144,0,211,1,6
17006,2,2416,2401,15,0,123,0,6
17007,2,2311,2443,-132,0,263,1,6
17008,1,2412,2344,68,0,11,0,6
17009,2,2407,2493,-86,0,110,1,6
17010,2,2287,2436,-149,0,311,1,6
17011,1,2502,2355,147,0,226,0,6
17012,1,2413,2263,150,0,51,0,6
17013,1,2411,2333,78,0,13,0,6
17014,2,2554,2435,119,0,41,0,6
17015,3,2456,2454,2,0,278,0,6
17016,1,2409,2322,87,0,45,0,8
17017,1,2518,2520,-2,0,337,0,6
17018,3,2526,2618,-92,0,118,0,6
17019,1,2430,2436,-6,0,100,0,6
17020,2,2386,2448,-62,0,115,0,6
17021,2,2485,2485,0,0,102,0,6
17022,1,2243,2415,-172,0,418,0,6
17023,1,2418,2365,53,0,44,0,6
17024,2,2302,2480,-178,0,49,0,6
17025,2,2330,2450,-120,0,337,0,6
17026,1,2454,2413,41,0,211,0,6
17027,3,2481,2589,-108,0,377,0,6
17028,2,2365,2483,-118,0,246,1,6
17029,1,2417,2280,137,0,0,0,6
17030,2,2349,2415,-66,0,334,0,6
17031,1,2476,2309,167,0,123,0,6
17032,2,2382,2472,-90,0,45,0,5
17033,1,2451,2300,151,0,46,0,6
17034,2,2611,2645,-34,0,245,0,6
17035,3,2407,2400,7,0,260,0,6
17036,2,2257,2412,-155,0,300,0,6
17037,2,2503,2404,99,0,46,0,6
17038,3,2551,2482,69,0,434,0,6
17039,1,2545,2554,-9,0,4,0,6
17040,1,2457,2360,97,0,115,0,6
17041,3,2401,2347,54,4,48,0,13
17042,1,2515,2237,278,0,40,0,6
17043,2,2291,2407,-116,0,40,1,6
17044,1,2527,2568,-41,0,125,0,6
17045,1,2584,2596,-12,0,404,0,6
17046,1,2484,2455,29,0,112,0,6
17047,1,2324,2412,-88,0,201,0,6
17048,2,2411,2595,-184,0,45,0,6
17049,1,2514,2524,-10,0,140,1,6
17050,2,2412,2480,-68,0,45,0,6
17051,2,2413,2491,-78,0,45,0,6
17052,2,2228,2415,-187,0,46,1,8
17053,1,2466,2481,-15,0,244,1,6
17054,2,2414,2307,107,0,101,0,6
17055,2,2434,2402,32,0,260,0,6
17056,2,2370,2465,-95,0,241,0,6
17057,3,2436,2410,26,0,139,0,6
17058,1,2559,2592,-33,0,338,0,6
17059,2,2403,2346,57,0,10,1,6
17060,1,2663,2528,135,0,136,1,6
17061,1,2454,2316,138,0,315,1,6
17062,1,2547,2390,157,0,211,0,6
17063,3,2325,2400,-75,0,119,0,6
17064,1,2431,2492,-61,0,9,0,6
17065,2,2317,2417,-100,0,123,0,6
17066,1,2405,2368,37,0,122,0,6
17067,2,2347,2482,-135,0,153,1,6
17068,1,2453,2381,72,0,48,0,6
17069,1,2473,2334,139,0,224,0,6
17070,3,2510,2604,-94,0,107,0,6
17071,1,2598,2481,117,0,307,1,6
17072,1,2297,2445,-148,0,4,0,6
17073,2,2361,2423,-62,0,241,1,6
17074,1,2447,2419,28,0,201,0,6
17075,3,2378,2546,-168,0,45,0,6
17076,2,2443,2416,27,0,4,0,6
17077,1,2497,2399,98,0,17,0,6
17078,1,2576,2499,77,0,399,0,6
17079,1,2355,2403,-48,0,190,1,6
17080,1,2463,2284,179,0,200,0,6
17081,1,2343,2430,-87,0,255,0,6
17082,2,2351,2496,-145,0,483,0,6
17083,2,2625,2691,-66,0,435,1,6
17084,1,2441,2392,49,0,320,1,6
17085,2,2533,2455,78,0,45,1,6
17086,2,2329,2440,-111,0,101,0,6
17087,2,2617,2528,89,0,15,0,6
17088,2,2428,2487,-59,0,11,1,6
17089,1,2376,2458,-82,0,115,0,6
17090,1,2382,2407,-25,0,110,0,6
17091,2,2411,2587,-176,0,45,1,6
17092,2,2527,2573,-46,0,270,0,6
17093,1,2454,2428,26,0,261,0,6
17094,3,2590,2590,0,0,242,0,6
17095,1,2440,2391,49,0,119,0,6
17096,1,2484,2409,75,0,123,1,6
17097,1,2496,2456,40,0,405,0,6
17098,1,2306,2417,-111,0,40,0,6
17099,2,2536,2425,111,0,248,0,6
17100,1,2426,2254,172,0,130,0,6
17101,2,2297,2440,-143,0,136,0,6
17102,1,2479,2482,-3,0,124,0,6
17103,2,2449,2489,-40,0,200,0,6
17104,1,2544,2551,-7,0,131,0,6
17105,1,2483,2550,-67,0,102,1,6
17106,1,2498,2454,44,0,114,0,6
17107,2,2511,2523,-12,0,140,0,6
17108,2,2407,2369,38,0,133,0,6
17109,1,2328,2416,-88,0,414,0,6
17110,1,2457,2484,-27,0,190,0,6
17112,2,2317,2437,-120,0,107,1,6
17113,1,2561,2410,151,0,139,0,6
17114,2,2411,2436,-25,0,302,1,6
17115,1,2424,2300,124,0,335,1,6
17116,1,2373,2463,-90,0,40,0,6
17117,1,2586,2566,20,0,45,0,6
17118,2,2478,2402,76,0,200,0,6
17119,3,2469,2366,103,0,1,0,6
17120,2,2428,2298,130,0,110,0,6
17121,1,2437,2477,-40,0,4,0,6
17122,2,2543,2459,84,0,11,0,6
17123,2,2476,2472,4,0,200,1,6
17124,1,2409,2220,189,0,320,0,6
17125,2,2330,2411,-81,0,41,0,6
17126,3,2405,2259,146,0,202,0,6
17127,1,2341,2488,-147,0,394,0,6
17128,3,2524,2550,-26,0,40,0,6
17129,2,2361,2522,-161,0,278,0,8
17130,2,2328,2428,-100,0,62,0,6
17131,1,2356,2407,-51,0,142,0,6
17132,2,2477,2518,-41,0,140,1,6
17133,1,2421,2383,38,0,45,0,6
17134,2,2414,2453,-39,0,263,0,6
17135,2,2596,2609,-13,0,28,1,6
17136,2,2313,2424,-111,4,202,0,13
17137,2,2312,2421,-109,0,49,0,6
17138,1,2466,2367,99,0,106,1,6
17139,1,2494,2443,51,0,113,0,6
17140,1,2458,2471,-13,0,338,0,6
17141,1,2451,2391,60,0,48,1,6
17142,1,2591,2583,8,0,15,0,6
17143,1,2449,2467,-18,0,310,1,6
17144,1,2554,2578,-24,0,151,0,6
17145,1,2581,2450,131,0,394,1,6
17146,1,2565,2456,109,0,200,0,6
17147,2,2407,2401,6,0,100,0,6
17148,1,2386,2578,-192,0,1,0,6
17149,3,2590,2408,182,0,138,0,6
17150,2,2474,2542,-68,0,58,0,6
17151,1,2401,2371,30,0,13,0,6
17152,1,2354,2400,-46,0,47,0,6
17153,1,2471,2444,27,0,100,0,6
17154,1,2244,2400,-156,0,40,0,6
17155,1,2492,2363,129,0,43,0,6
17156,2,2486,2373,113,0,130,0,6
17157,1,2493,2529,-36,0,302,0,6
17159,2,2458,2409,49,0,201,0,6
17160,1,2432,2404,28,0,463,0,6
17161,2,2372,2441,-69,0,463,1,6
17162,2,2590,2544,46,0,485,0,6
17163,1,2490,2385,105,0,187,0,6
17164,2,2401,2400,1,0,112,0,6
17165,1,2440,2424,16,0,40,0,6
17166,1,2401,2348,53,0,10,0,6
17167,2,2378,2428,-50,0,45,0,6
17168,3,2441,2288,153,0,145,0,6
17169,3,2421,2368,53,0,225,0,6
17170,3,2423,2322,101,0,278,0,6
17171,2,2522,2574,-52,0,300,1,6
17172,1,2405,2357,48,0,302,0,6
17173,1,2329,2422,-93,0,144,0,6
17174,2,2364,2488,-124,0,107,0,6
17175,1,2441,2359,82,0,269,0,6
17176,1,2494,2501,-7,0,103,0,6
17177,2,2577,2598,-21,0,123,0,6
17178,2,2349,2505,-156,0,250,0,6
17179,1,2428,2308,120,0,106,0,6
17180,2,2550,2433,117,0,41,0,6
17181,3,2292,2403,-111,0,116,0,6
17182,2,2330,2420,-90,0,88,1,10
17183,2,2512,2525,-13,0,40,0,6
17184,2,2478,2470,8,0,244,1,6
17185,2,2353,2418,-65,0,45,0,6
17186,2,2430,2569,-139,0,140,0,6
17187,2,2452,2308,144,0,140,0,6
17188,1,2443,2454,-11,0,456,0,6
17189,1,2522,2471,51,0,311,0,6
17190,1,2615,2591,24,0,110,0,6
17191,2,2265,2417,-152,0,0,0,6
17192,2,2523,2569,-46,0,90,0,6
17193,1,2572,2564,8,0,125,0,6
17194,2,2447,2585,-138,0,152,1,6
17195,2,2465,2439,26,0,100,0,6
17196,1,2499,2476,23,0,278,0,6
17197,1,2425,2495,-70,0,10,1,6
17198,2,2500,2532,-32,0,483,1,6
17199,2,2401,2500,-99,0,190,1,6
17200,2,2343,2406,-63,0,1,0,6
17201,1,2275,2420,-145,0,106,1,6
17202,2,2407,2352,55,0,46,1,6
17203,2,2386,2402,-16,0,267,0,6
17204,1,2411,2455,-44,0,96,0,6
17205,1,2546,2469,77,0,68,0,6
17206,1,2432,2332,100,0,194,1,6
17207,1,2421,2223,198,0,43,0,8
17208,2,2550,2584,-34,0,442,0,6
17209,1,2525,2358,167,0,0,0,8
17210,2,2309,2409,-100,0,240,1,6
17211,1,2477,2354,123,0,148,0,6
17212,2,2508,2479,29,0,158,1,6
17213,2,2399,2439,-40,0,0,1,6
17214,2,2380,2513,-133,0,106,0,6
17215,1,2423,2316,107,0,20,0,6
17216,1,2430,2309,121,0,55,0,6
17217,1,2428,2293,135,0,56,0,6
17218,1,2406,2293,113,0,154,1,6
17219,2,2289,2477,-188,0,52,0,5
17220,2,2461,2423,38,0,192,0,6
17221,2,2477,2536,-59,0,41,0,6
17222,2,2515,2357,158,0,115,1,6
17223,2,2439,2368,71,0,148,0,6
17224,1,2445,2455,-10,0,114,0,6
17225,2,2354,2420,-66,0,197,1,6
17226,2,2213,2414,-201,0,147,0,6
17227,1,2467,2220,247,0,300,0,6
17228,1,2420,2413,7,0,151,1,6
17229,1,2492,2348,144,0,120,0,6
17230,1,2375,2425,-50,4,101,0,13
17231,1,2378,2475,-97,0,2,1,6
17232,2,2374,2441,-67,0,106,1,6
17233,1,2605,2570,35,0,412,0,6
17234,3,2459,2507,-48,0,131,0,6
17235,2,2445,2432,13,0,9,0,6
17236,2,2304,2426,-122,0,125,0,6
17237,1,2572,2530,42,0,136,0,6
17238,1,2470,2362,108,0,122,0,6
17239,2,2420,2368,52,0,301,0,6
17240,1,2585,2620,-35,0,28,0,6
17241,1,2392,2463,-71,0,232,1,6
17242,1,2419,2383,36,0,315,0,6
17243,1,2574,2527,47,0,321,1,6
17244,2,2522,2630,-108,0,102,1,6
17245,1,2436,2388,48,0,190,0,6
17246,2,2579,2432,147,0,268,0,6
17247,1,2528,2344,184,0,0,0,8
17248,2,2507,2519,-12,0,140,1,6
17250,1,2449,2461,-12,0,409,1,6
17251,2,2471,2418,53,0,107,1,6
17252,2,2338,2481,-143,0,1,0,6
17253,2,2465,2551,-86,0,25,1,6
17254,2,2589,2545,44,0,104,1,6
17255,3,2488,2515,-27,0,45,0,6
17256,1,2408,2303,105,0,0,0,6
17257,1,2537,2443,94,0,260,0,6
17258,2,2517,2494,23,0,341,0,6
17259,2,2243,2432,-189,0,140,0,6
17260,1,2440,2504,-64,0,15,0,6
17261,1,2435,2397,38,0,45,0,6
17262,1,2408,2320,88,0,484,0,6
17263,3,2324,2422,-98,0,337,0,6
17264,1,2472,2451,21,0,202,0,6
17265,1,2530,2502,28,0,141,0,6
17266,1,2445,2302,143,0,80,0,6
17267,2,2485,2460,25,0,150,0,6
17268,2,2431,2506,-75,0,106,0,6
17269,1,2430,2454,-24,0,3,0,6
17270,2,2541,2472,69,0,132,0,6
17271,1,2508,2410,98,0,45,0,6
17272,3,2564,2611,-47,0,125,0,6
17273,2,2221,2425,-204,0,107,1,8
17274,2,2394,2528,-134,0,121,1,6
17275,2,2364,2485,-121,0,140,0,6
17276,3,2437,2426,11,0,4,0,6
17277,1,2375,2414,-39,0,100,0,6
17278,1,2425,2278,147,0,265,0,6
17279,1,2430,2350,80,0,277,0,6
17280,2,2245,2428,-183,0,2,0,6
17281,2,2336,2496,-160,0,43,0,6
17282,1,2412,2369,43,0,241,1,6
17283,2,2422,2400,22,0,4,0,6
17284,1,2424,2354,70,0,418,0,0
17285,2,2575,2696,-121,0,409,0,6
17286,2,2271,2422,-151,0,4,0,6
17287,1,2424,2484,-60,0,151,0,6
17288,1,2468,2385,83,0,210,0,6
17289,2,2614,2592,22,0,110,0,6
17290,2,2438,2369,69,0,127,0,6
17291,2,2412,2378,34,0,0,0,6
17292,1,2525,2501,24,0,330,1,6
17293,3,2439,2445,-6,0,9,0,6
17294,1,2448,2368,80,0,40,0,6
17295,2,2471,2348,123,0,203,0,6
17296,2,2510,2426,84,0,46,1,6
17297,2,2392,2579,-187,0,245,1,6
17298,2,2418,2442,-24,0,261,1,6
17299,2,2440,2571,-131,0,414,1,6
17300,2,2417,2346,71,0,143,0,8
17301,1,2455,2522,-67,0,133,1,6
17302,1,2448,2436,12,0,184,0,6
17303,1,2524,2625,-101,0,56,0,6
17304,2,2335,2499,-164,0,1,0,6
17305,1,2381,2472,-91,0,2,0,6
17306,1,2455,2406,49,0,4,0,6
17307,1,2497,2447,50,0,187,0,6
17308,3,2439,2430,9,0,151,0,6
17309,1,2551,2583,-32,0,190,0,6
17310,2,2320,2412,-92,0,107,1,6
17311,1,2482,2477,5,0,119,0,6
17312,3,2410,2398,12,0,300,0,6
17313,2,2429,2381,48,0,469,0,6
17314,2,2446,2352,94,0,204,0,6
17315,1,2555,2461,94,0,201,0,6
17316,1,2404,2369,35,0,42,0,6
17317,1,2497,2466,31,0,190,0,6
17318,1,2441,2479,-38,0,4,0,6
17319,2,2313,2464,-151,0,200,0,6
17320,3,2502,2434,68,0,172,0,6
17321,1,2479,2391,88,0,132,0,6
17322,1,2390,2400,-10,0,205,0,8
17323,3,2450,2374,76,0,48,0,6
17324,2,2426,2467,-41,0,0,0,6
17325,1,2345,2454,-109,0,200,0,6
17326,1,2359,2406,-47,0,43,0,6
17327,2,2408,2381,27,0,246,0,6
17328,1,2343,2439,-96,0,460,0,6
17329,1,2277,2402,-125,0,45,0,6
17330,2,2419,2410,9,0,311,0,6
17331,2,2319,2470,-151,0,207,0,6
17332,2,2478,2431,47,0,241,0,6
17333,1,2489,2406,83,0,100,0,6
17334,2,2325,2462,-137,0,120,1,6
17335,2,2384,2426,-42,0,40,0,6
17336,2,2571,2557,14,0,210,0,6
17337,2,2444,2358,86,0,102,0,6
17338,3,2532,2533,-1,0,338,0,6
17339,3,2451,2294,157,0,153,0,6
17340,2,2432,2431,1,0,36,1,6
17341,2,2465,2388,77,0,210,0,6
17342,2,2363,2453,-90,0,331,0,6
17343,1,2668,2634,34,0,40,0,6
17344,2,2452,2425,27,0,242,0,10
17345,2,2448,2436,12,0,246,0,6
17346,1,2617,2495,122,0,0,0,6
17347,1,2350,2429,-79,0,61,0,0
17348,3,2388,2401,-13,0,245,0,6
17349,2,2439,2459,-20,0,9,1,6
17350,2,2389,2445,-56,0,101,1,6
17351,1,2489,2376,113,0,454,0,6
17352,1,2495,2501,-6,0,81,1,6
17353,3,2419,2371,48,0,202,0,8
17354,2,2411,2331,80,0,10,0,6
17355,2,2276,2417,-141,0,140,0,6
17356,1,2531,2535,-4,0,395,0,6
17357,2,2444,2324,120,0,101,0,6
17358,2,2576,2558,18,0,485,0,6
17359,2,2419,2388,31,4,485,0,13
17360,2,2437,2417,20,0,16,0,6
17361,2,2420,2325,95,0,106,0,6
17362,1,2467,2464,3,0,49,0,6
17363,2,2341,2477,-136,0,290,0,8
17364,3,2462,2427,35,0,436,0,6
17365,2,2345,2413,-68,0,302,0,6
17366,1,2439,2531,-92,0,151,0,6
17367,2,2438,2471,-33,0,200,0,6
17368,1,2414,2341,73,0,300,1,6
17369,1,2461,2502,-41,0,111,0,6
17370,3,2457,2359,98,0,40,0,6
17371,1,2409,2382,27,0,405,1,6
17372,2,2563,2565,-2,0,405,0,6
17373,1,2437,2444,-7,0,307,0,6
17374,2,2448,2307,141,0,303,0,6
17375,2,2399,2447,-48,0,0,1,6
17376,2,2472,2447,25,0,200,0,6
17377,3,2424,2438,-14,0,250,0,6
17378,1,2383,2411,-28,0,8,1,6
17379,3,2454,2353,101,0,277,0,6
17380,3,2308,2452,-144,0,140,0,6
17381,3,2278,2437,-159,0,128,0,6
17382,2,2733,2632,101,0,253,0,6
17383,1,2395,2458,-63,0,3,1,6
17384,1,2472,2310,162,0,134,1,6
17385,1,2509,2380,129,0,46,0,6
17386,2,2423,2431,-8,0,50,1,6
17387,2,2400,2404,-4,0,47,0,6
17388,2,2406,2289,117,0,249,1,6
17389,2,2402,2493,-91,0,300,0,6
17390,2,2629,2673,-44,0,0,0,6
17391,1,2359,2575,-216,0,414,0,6
17392,1,2431,2403,28,0,8,1,6
17393,1,2305,2403,-98,0,245,1,6
17394,2,2436,2417,19,0,45,0,6
17395,2,2661,2489,172,0,133,0,6
17396,2,2378,2449,-71,0,46,1,6
17397,1,2528,2501,27,0,45,0,6
17398,1,2386,2488,-102,0,106,0,6
17399,2,2403,2384,19,0,3,0,6
17400,1,2436,2325,111,0,339,0,6
17401,3,2368,2493,-125,0,40,0,6
17402,2,2300,2410,-110,0,51,0,6
17403,2,2437,2332,105,0,127,0,6
17404,2,2491,2621,-130,0,394,0,6
17405,1,2437,2426,11,0,130,0,6
17406,2,2484,2348,136,0,40,0,6
17407,2,2353,2527,-174,0,100,0,8
17408,1,2490,2431,59,0,40,0,6
17409,1,2520,2532,-12,0,140,1,6
17410,1,2325,2406,-81,0,246,0,6
17411,1,2557,2493,64,0,484,0,6
17412,2,2435,2379,56,0,11,0,6
17413,2,2371,2430,-59,0,198,0,6
17414,1,2482,2468,14,0,338,0,6
17415,1,2418,2286,132,0,0,0,6
17416,2,2564,2570,-6,0,190,0,6
17417,1,2496,2440,56,0,289,0,6
17418,1,2376,2402,-26,0,80,0,6
17419,3,2401,2388,13,0,6,0,6
17420,2,2418,2340,78,0,243,1,6
17421,1,2527,2348,179,0,123,0,6
17422,2,2388,2401,-13,0,100,0,6
17423,1,2533,2502,31,0,210,0,6
17424,1,2495,2464,31,0,378,0,6
17425,1,2475,2550,-75,0,45,0,6
17426,1,2426,2402,24,0,41,0,6
17427,1,2481,2434,47,0,43,0,6
17428,2,2611,2571,40,0,46,0,6
17429,2,2524,2537,-13,0,136,0,6
17430,3,2432,2473,-41,0,400,0,6
17431,1,2418,2300,118,0,414,0,6
17432,2,2394,2466,-72,0,121,0,6
17433,1,2453,2384,69,0,4,0,6
17434,2,2372,2443,-71,0,103,0,6
17435,1,2678,2624,54,0,461,0,6
17436,3,2438,2425,13,0,280,0,6
17437,2,2419,2393,26,0,172,0,6
17438,1,2355,2452,-97,0,119,0,6
17439,1,2525,2350,175,0,122,0,6
17440,2,2410,2386,24,0,335,0,6
17441,2,2442,2315,127,0,110,0,6
17442,1,2405,2339,66,0,10,0,6
17443,1,2305,2440,-135,0,110,0,6
17444,2,2388,2452,-64,0,133,0,6
17445,1,2467,2304,163,0,142,0,6
17446,1,2450,2202,248,0,110,0,6
17447,2,2455,2434,21,0,190,1,6
17448,1,2398,2402,-4,0,40,0,6
17449,2,2368,2475,-107,0,101,0,6
17450,1,2473,2331,142,0,335,0,6
17451,1,2416,2342,74,0,217,0,6
17452,1,2491,2394,97,0,11,0,6
17453,2,2368,2497,-129,0,142,1,6
17454,3,2332,2413,-81,0,292,0,6
17455,1,2555,2389,166,0,120,0,8
17456,1,2340,2430,-90,0,62,0,6
17457,1,2422,2321,101,0,56,0,6
17458,1,2429,2330,99,0,278,1,6
17459,1,2541,2539,2,0,270,0,6
17460,2,2537,2418,119,0,15,1,6
17461,3,2659,2640,19,0,288,0,6
17462,1,2348,2422,-74,0,103,0,6
17463,2,2407,2383,24,0,6,0,6
17464,2,2401,2513,-112,0,147,0,6
17465,2,2453,2386,67,0,310,1,6
17466,1,2428,2318,110,0,106,0,6
17467,2,2429,2461,-32,0,44,0,6
17468,2,2476,2471,5,0,130,1,6
17469,2,2427,2412,15,0,253,0,6
17470,2,2455,2361,94,0,60,0,6
17471,1,2526,2625,-99,0,132,0,6
17472,2,2431,2400,31,0,49,0,6
17473,1,2452,2377,75,0,114,0,6
17474,3,2576,2558,18,0,10,0,6
17475,1,2382,2435,-53,0,302,0,6
17476,1,2424,2437,-13,0,331,0,6
17477,2,2462,2562,-100,0,106,0,6
17478,1,2526,2488,38,0,483,1,6
17479,1,2403,2223,180,0,106,0,7
17480,1,2479,2364,115,0,202,1,6
17481,2,2479,2433,46,0,306,0,6
17482,3,2403,2443,-40,0,45,0,6
17483,1,2357,2404,-47,0,459,0,6
17484,2,2448,2367,81,0,454,0,6
17485,2,2396,2411,-15,0,48,0,6
17486,1,2487,2528,-41,0,429,0,6
17487,2,2458,2436,22,0,131,0,6
17488,2,2566,2656,-90,0,487,0,6
17489,1,2518,2433,85,0,4,1,6
17490,1,2404,2332,72,0,463,0,6
17491,2,2332,2480,-148,0,290,0,8
17492,2,2617,2629,-12,0,0,1,6
17493,1,2457,2389,68,0,5,0,6
17494,3,2502,2534,-32,0,13,0,6
17495,1,2577,2605,-28,0,211,0,6
17496,1,2314,2433,-119,0,302,0,6
17497,2,2389,2401,-12,0,45,0,6
17498,3,2399,2566,-167,0,434,0,6
17499,2,2442,2440,2,0,278,1,6
17500,2,2395,2411,-16,0,48,0,8
17501,1,2282,2403,-121,0,353,0,6
17502,1,2619,2683,-64,0,450,0,6
17503,1,2422,2297,125,0,41,0,6
17504,1,2445,2380,65,0,100,0,6
17505,1,2315,2446,-131,0,45,0,10
17506,1,2334,2404,-70,0,1,0,6
17507,2,2423,2348,75,0,127,1,6
17508,2,2413,2467,-54,0,128,0,6
17509,1,2371,2449,-78,0,255,0,6
17510,1,2341,2417,-76,0,468,1,6
17511,1,2531,2288,243,0,210,0,6
17512,2,2640,2659,-19,0,196,1,6
17513,1,2465,2580,-115,0,90,0,8
17514,1,2386,2451,-65,0,40,0,6
17515,1,2431,2376,55,0,144,0,6
17516,1,2501,2372,129,0,267,0,6
17517,1,2400,2263,137,4,41,0,13
17518,2,2326,2434,-108,0,190,1,6
17519,2,2403,2432,-29,0,116,0,6
17520,1,2441,2282,159,0,40,0,6
17521,2,2559,2576,-17,0,70,1,6
17522,2,2470,2531,-61,0,8,0,6
17523,1,2533,2547,-14,0,125,1,6
17525,1,2534,2349,185,0,120,0,6
17526,1,2522,2442,80,0,121,1,6
17527,2,2206,2533,-327,0,112,1,6
17528,2,2359,2544,-185,0,124,0,6
17529,2,2428,2381,47,0,302,0,6
17530,2,2436,2342,94,0,242,1,6
17531,1,2393,2461,-68,0,45,0,6
17532,1,2446,2385,61,0,45,0,6
17533,1,2661,2600,61,0,106,0,6
17534,2,2402,2208,194,0,312,1,6
17535,2,2361,2483,-122,0,101,0,6
17536,3,2421,2391,30,0,300,0,6
17537,1,2305,2477,-172,0,301,0,6
17538,2,2347,2421,-74,0,153,1,6
17539,3,2477,2660,-183,0,69,0,6
17540,3,2426,2346,80,0,300,0,6
17541,1,2374,2503,-129,0,246,0,6
17542,2,2421,2529,-108,0,150,1,6
17543,2,2368,2599,-231,0,79,0,6
17544,2,2236,2407,-171,0,4,0,6
17545,2,2300,2418,-118,0,233,0,6
17546,1,2424,2416,8,0,123,0,6
17547,2,2494,2504,-10,0,432,0,6
17548,1,2442,2496,-54,0,125,0,6
17549,1,2500,2417,83,0,31,0,6
17550,3,2635,2543,92,0,211,0,6
17551,2,2677,2626,51,0,107,0,6
17552,2,2429,2522,-93,0,459,1,6
17553,1,2370,2450,-80,0,0,0,6
17554,1,2466,2437,29,0,50,0,6
17555,2,2375,2486,-111,0,106,0,6
17556,1,2476,2398,78,0,264,0,6
17557,1,2448,2370,78,0,315,1,6
17558,2,2495,2341,154,0,10,0,6
17559,1,2416,2323,93,0,110,0,6
17560,3,2348,2412,-64,0,337,0,6
17561,1,2322,2422,-100,0,302,0,6
17562,1,2388,2437,-49,0,453,0,6
17563,1,2412,2460,-48,0,302,0,6
17564,1,2446,2437,9,0,414,0,6
17565,1,2444,2333,111,0,125,0,6
17566,1,2442,2377,65,0,43,0,6
17567,2,2383,2443,-60,0,310,0,6
17568,1,2664,2634,30,0,288,0,6
17569,1,2666,2534,132,0,337,0,6
17570,1,2397,2408,-11,0,302,0,6
17571,1,2527,2487,40,0,102,1,6
17572,1,2422,2395,27,0,190,0,6
17573,3,2349,2465,-116,0,1,0,6
17574,1,2599,2518,81,0,102,0,6
17575,1,2361,2473,-112,0,245,0,6
17576,2,2370,2451,-81,0,457,1,6
17577,1,2479,2233,246,0,40,0,6
17578,3,2410,2428,-18,0,345,0,6
17579,1,2581,2612,-31,0,35,0,6
17580,2,2657,2486,171,0,103,0,6
17581,3,2388,2449,-61,0,50,0,6
17582,2,2541,2539,2,0,245,0,6
17583,2,2487,2357,130,0,202,0,6
17584,1,2352,2415,-63,0,107,0,6
17585,1,2495,2382,113,0,17,1,6
17586,2,2495,2438,57,0,490,0,6
17587,2,2431,2394,37,0,143,0,6
17588,1,2535,2200,335,0,125,0,6
17589,2,2380,2499,-119,0,227,0,6
17590,1,2401,2472,-71,0,474,0,6
17591,1,2455,2393,62,0,40,0,6
17592,2,2329,2448,-119,0,20,0,6
17593,2,2530,2670,-140,0,154,0,6
17594,2,2307,2426,-119,0,1,0,6
17595,2,2400,2420,-20,0,45,0,6
17596,2,2632,2634,-2,0,0,0,6
17597,1,2547,2268,279,0,140,0,6
17598,1,2356,2489,-133,0,453,0,6
17599,2,2483,2449,34,0,125,1,6
17600,2,2424,2371,53,0,122,0,6
17601,2,2318,2410,-92,0,221,0,6
17602,1,2389,2472,-83,0,302,0,8
17603,1,2438,2353,85,0,255,0,6
17604,3,2349,2488,-139,0,311,0,6
17605,1,2425,2410,15,0,4,0,6
17606,3,2492,2517,-25,0,386,0,6
17607,2,2399,2452,-53,0,405,0,6
17608,2,2411,2372,39,0,120,0,6
17609,3,2523,2532,-9,0,150,0,8
17610,2,2363,2447,-84,0,5,0,6
17611,1,2629,2669,-40,0,301,0,6
17612,2,2545,2674,-129,0,100,0,6
17613,2,2366,2418,-52,0,409,1,6
17614,1,2413,2500,-87,0,102,0,6
17615,3,2471,2425,46,0,405,0,6
17616,1,2378,2415,-37,0,162,1,6
17617,2,2563,2538,25,0,152,0,6
17618,1,2602,2448,154,0,7,0,6
17619,1,2389,2481,-92,0,0,1,6
17620,2,2463,2373,90,0,107,0,6
17621,1,2430,2432,-2,0,50,0,6
17622,2,2417,2329,88,0,44,0,6
17623,2,2527,2532,-5,0,122,0,6
17624,2,2272,2537,-265,0,307,0,6
17625,1,2256,2419,-163,0,305,0,8
17626,2,2400,2315,85,0,253,0,6
17627,2,2281,2425,-144,0,0,0,6
17628,1,2348,2440,-92,0,330,0,6
17629,1,2545,2549,-4,0,211,0,6
17630,1,2610,2523,87,0,461,1,6
17631,1,2535,2427,108,0,288,0,6
17632,1,2400,2474,-74,0,320,0,6
17633,1,2436,2394,42,0,112,1,6
17634,1,2402,2314,88,0,132,0,6
17635,2,2332,2563,-231,0,345,0,6
17636,1,2436,2419,17,0,4,0,6
17637,2,2382,2412,-30,0,202,0,6
17638,2,2312,2496,-184,0,246,0,6
17639,3,2534,2243,291,0,45,0,6
17640,3,2427,2300,127,0,100,0,6
17641,2,2200,2411,-211,0,102,0,6
17642,2,2431,2452,-21,0,278,1,6
17643,2,2360,2454,-94,0,324,1,6
17644,2,2482,2333,149,0,37,0,6
17645,3,2207,2539,-332,0,112,0,6
17646,1,2549,2310,239,0,253,0,6
17647,1,2606,2588,18,0,0,0,6
17648,1,2402,2410,-8,0,5,0,6
17649,1,2469,2338,131,0,58,0,6
17650,1,2425,2332,93,0,218,0,6
17651,1,2459,2349,110,0,4,0,6
17652,1,2424,2348,76,0,11,0,6
17653,1,2378,2499,-121,0,106,0,6
17654,1,2310,2408,-98,0,300,0,6
17655,2,2328,2417,-89,0,45,1,6
17656,2,2463,2351,112,0,106,1,6
17657,2,2510,2685,-175,0,242,1,6
17658,1,2425,2335,90,0,43,0,6
17659,1,2494,2497,-3,0,3,0,6
17660,3,2649,2376,273,0,101,0,6
17661,1,2455,2253,202,0,245,0,6
17662,2,2401,2378,23,0,15,0,6
17663,2,2493,2452,41,0,302,1,6
17664,1,2427,2270,157,0,190,0,6
17665,1,2434,2455,-21,0,140,0,6
17666,3,2444,2367,77,0,43,0,6
17667,2,2373,2403,-30,0,302,0,8
17668,1,2426,2473,-47,0,13,1,6
17669,1,2402,2297,105,0,172,1,6
17670,2,2417,2326,91,0,6,0,6
17671,1,2639,2666,-27,0,267,0,6
17672,3,2663,2627,36,0,106,0,6
17673,2,2211,2413,-202,0,102,0,6
17674,2,2344,2429,-85,0,67,0,6
17675,1,2455,2404,51,0,125,0,6
17676,2,2359,2408,-49,0,89,0,6
17677,1,2636,2674,-38,0,101,0,6
17678,2,2364,2458,-94,0,445,0,6
17679,3,2532,2523,9,0,194,0,8
17680,2,2482,2227,255,0,40,1,6
17681,2,2406,2232,174,0,4,0,6
17682,1,2345,2489,-144,0,4,1,6
17683,1,2486,2464,22,0,123,0,6
17684,1,2486,2351,135,0,429,1,6
17685,2,2430,2268,162,0,43,1,6
17686,1,2490,2470,20,0,408,0,6
17687,1,2477,2425,52,0,241,0,6
17688,1,2605,2551,54,0,7,1,6
17689,2,2294,2410,-116,0,0,0,6
17690,2,2421,2394,27,0,427,1,6
17691,1,2677,2541,136,0,62,0,6
17692,2,2444,2368,76,0,102,0,6
17693,1,2521,2505,16,0,102,0,6
17694,3,2429,2384,45,0,36,0,6
17695,2,2491,2386,105,0,483,0,6
17696,1,2474,2345,129,0,190,1,6
17697,3,2407,2333,74,0,12,0,6
17698,1,2534,2396,138,0,112,0,6
17699,1,2533,2397,136,0,453,0,6
17700,1,2285,2441,-156,0,43,0,6
17701,1,2518,2460,58,0,131,1,6
17702,2,2582,2611,-29,0,21,0,6
17703,1,2440,2430,10,0,150,0,6
17704,2,2463,2389,74,0,302,0,6
17705,2,2316,2401,-85,0,253,0,6
17706,1,2357,2402,-45,0,180,0,6
17707,2,2482,2500,-18,0,102,1,6
17708,1,2491,2361,130,0,14,1,6
17709,1,2595,2646,-51,0,320,1,6
17710,2,2337,2491,-154,0,40,0,6
17711,2,2408,2465,-57,0,244,0,8
17712,2,2420,2527,-107,0,110,1,6
17713,1,2401,2258,143,0,41,1,6
17714,1,2419,2259,160,0,253,0,8
17715,2,2358,2456,-98,0,1,0,6
17716,1,2499,2381,118,0,405,0,6
17717,1,2431,2270,161,0,84,0,6
17718,2,2539,2578,-39,0,216,0,6
17719,2,2407,2507,-100,0,15,0,6
17720,1,2288,2446,-158,0,464,0,6
17721,3,2557,2423,134,0,14,0,6
17722,1,2457,2426,31,0,414,0,6
17723,1,2406,2354,52,0,120,0,6
17724,2,2520,2523,-3,0,80,0,8
17725,2,2503,2475,28,0,466,0,8
17726,1,2403,2413,-10,0,338,0,8
17727,3,2273,2414,-141,0,302,0,6
17728,2,2356,2476,-120,0,1,1,6
17729,2,2616,2577,39,0,152,0,6
17730,3,2375,2437,-62,0,310,0,6
17731,2,2627,2662,-35,0,347,0,6
17732,2,2465,2645,-180,0,487,0,6
17733,2,2352,2430,-78,0,13,0,6
17734,2,2459,2300,159,0,331,0,6
17735,1,2405,2312,93,0,135,0,6
17736,2,2442,2387,55,0,11,0,6
17737,1,2468,2486,-18,0,222,0,6
17738,1,2452,2400,52,0,485,0,6
17739,1,2458,2386,72,0,211,0,6
17740,1,2499,2427,72,0,40,1,6
17741,2,2407,2410,-3,0,107,0,6
17742,2,2408,2401,7,0,330,0,6
17743,1,2433,2430,3,0,57,0,6
17744,1,2243,2424,-181,0,6,0,6
17745,2,2391,2479,-88,0,101,0,6
17746,1,2466,2390,76,0,104,0,6
17747,1,2553,2365,188,0,107,0,6
17748,1,2402,2383,19,0,48,1,6
17749,2,2394,2484,-90,0,133,1,6
17750,1,2404,2303,101,0,150,0,6
17751,1,2458,2346,112,0,4,0,6
17752,2,2290,2427,-137,0,302,1,6
17753,2,2402,2494,-92,0,106,0,6
17754,2,2538,2681,-143,0,100,1,6
17755,1,2523,2532,-9,0,184,0,8
17756,2,2348,2490,-142,0,311,0,6
17757,2,2358,2418,-60,0,31,0,6
17758,1,2385,2428,-43,0,102,0,6
17759,2,2480,2492,-12,0,45,0,6
17760,1,2413,2224,189,0,336,0,6
17761,1,2418,2288,130,0,131,0,6
17762,3,2499,2530,-31,0,381,0,6
17763,2,2393,2415,-22,0,16,1,6
17764,2,2350,2441,-91,0,373,0,6
17765,1,2565,2226,339,0,310,0,6
17766,1,2363,2405,-42,0,240,0,6
17767,2,2328,2462,-134,0,125,0,6
17768,1,2474,2443,31,0,222,0,6
17769,1,2331,2408,-77,0,103,0,6
17770,2,2472,2429,43,0,300,0,6
17771,2,2395,2448,-53,0,37,1,6
17772,1,2391,2424,-33,0,0,0,6
17773,2,2610,2668,-58,0,8,1,6
17774,1,2426,2372,54,0,102,0,6
17775,1,2583,2462,121,0,46,0,6
17776,2,2460,2354,106,0,106,0,6
17777,2,2330,2429,-99,0,49,0,6
17778,3,2412,2401,11,0,415,0,6
17779,2,2622,2633,-11,0,80,0,6
17780,2,2352,2421,-69,0,113,0,6
17781,1,2539,2279,260,0,101,0,6
17782,1,2474,2324,150,0,300,0,6
17783,2,2432,2345,87,0,49,0,6
17784,1,2357,2439,-82,0,75,0,6
17785,1,2639,2663,-24,0,115,0,6
17786,2,2308,2409,-101,0,253,0,6
17787,2,2503,2451,52,0,40,1,6
17788,1,2377,2472,-95,0,43,0,6
17789,1,2435,2392,43,0,338,1,6
17790,2,2396,2451,-55,0,300,0,6
17791,2,2301,2407,-106,0,265,0,6
17792,2,2378,2556,-178,0,255,0,6
17793,2,2505,2668,-163,0,3,1,6
17794,1,2484,2476,8,0,130,1,6
17795,2,2470,2403,67,0,330,1,8
17796,1,2388,2413,-25,0,4,0,6
17797,1,2385,2501,-116,0,140,0,6
17798,1,2436,2462,-26,0,241,0,6
17799,2,2402,2389,13,0,46,0,8
17800,2,2435,2296,139,0,178,0,6
17801,1,2429,2308,121,0,190,0,6
17802,3,2416,2455,-39,0,236,0,6
17803,2,2529,2399,130,0,307,0,8
17804,1,2499,2396,103,0,130,1,6
17805,2,2421,2401,20,0,225,0,6
17806,2,2484,2471,13,0,234,0,6
17807,2,2546,2509,37,0,211,0,6
17808,3,2421,2462,-41,0,288,0,6
17809,3,2322,2435,-113,0,381,0,6
17811,2,2362,2453,-91,0,1,1,6
17812,1,2494,2523,-29,0,461,0,6
17813,2,2504,2386,118,0,315,0,6
17814,1,2480,2340,140,0,437,1,6
17815,1,2497,2315,182,0,338,0,6
17816,1,2422,2391,31,0,124,1,6
17817,1,2416,2365,51,0,246,1,6
17818,1,2488,2389,99,0,483,0,6
17819,1,2484,2474,10,0,15,0,6
17820,1,2421,2370,51,0,45,1,6
17821,1,2556,2497,59,0,387,1,6
17822,2,2374,2534,-160,0,4,0,6
17823,3,2331,2440,-109,0,302,0,10
17824,2,2433,2587,-154,0,300,0,6
17825,1,2423,2273,150,0,453,1,6
17826,2,2418,2458,-40,0,33,0,6
17827,2,2386,2541,-155,0,115,0,6
17828,2,2374,2426,-52,0,241,0,6
17829,3,2465,2416,49,0,46,0,6
17830,2,2298,2409,-111,0,205,0,6
17831,1,2493,2333,160,0,121,0,6
17832,2,2294,2423,-129,0,57,0,8
17833,1,2685,2534,151,0,301,1,6
17834,2,2440,2489,-49,0,101,0,6
17835,2,2305,2402,-97,0,380,0,6
17836,1,2407,2394,13,0,43,1,6
17837,1,2403,2328,75,0,202,0,6
17838,1,2562,2412,150,0,344,0,6
17839,1,2394,2477,-83,0,300,0,6
17840,2,2374,2407,-33,0,45,0,8
17841,1,2497,2211,286,0,434,0,8
17842,2,2639,2617,22,0,41,0,6
17843,3,2672,2605,67,0,173,0,6
17844,1,2443,2480,-37,0,184,0,6
17845,3,2414,2304,110,0,158,0,6
17846,2,2364,2432,-68,0,229,0,6
17847,1,2406,2376,30,0,45,1,6
17848,3,2349,2425,-76,0,17,0,6
17849,2,2456,2456,0,0,199,1,6
17850,2,2392,2645,-253,0,300,0,6
17851,2,2457,2300,157,0,125,0,6
17852,2,2440,2497,-57,0,20,0,6
17853,2,2516,2529,-13,0,249,0,8
17854,3,2559,2291,268,0,210,0,6
17855,2,2469,2502,-33,0,13,0,6
17856,1,2671,2571,100,0,132,0,6
17857,1,2431,2467,-36,0,190,0,6
17858,1,2531,2497,34,0,34,1,6
17859,2,2458,2310,148,0,327,0,6
17860,2,2251,2401,-150,4,255,0,13
17861,1,2433,2326,107,0,404,0,6
17862,1,2494,2524,-30,0,324,1,6
17863,1,2415,2251,164,0,123,0,6
17864,2,2396,2436,-40,0,150,0,6
17865,3,2534,2503,31,0,13,0,8
17866,2,2479,2429,50,0,404,1,6
17867,2,2437,2247,190,0,54,0,6
17868,1,2623,2633,-10,0,4,0,6
17869,2,2397,2517,-120,0,111,0,6
17870,3,2384,2403,-19,0,152,0,6
17871,1,2463,2403,60,0,58,1,6
17872,2,2415,2351,64,0,153,1,6
17873,2,2330,2503,-173,0,40,0,6
17874,1,2401,2341,60,0,7,0,6
17875,2,2436,2341,95,0,131,0,6
17876,1,2407,2496,-89,0,46,1,6
17877,1,2385,2493,-108,0,133,0,6
17878,1,2627,2629,-2,0,50,0,6
17879,1,2386,2427,-41,0,102,1,6
17880,2,2331,2422,-91,4,133,0,13
17881,1,2457,2358,99,0,40,0,6
17882,2,2464,2417,47,0,302,0,6
17883,1,2407,2339,68,0,336,0,6
17884,3,2433,2324,109,0,357,0,6
17885,2,2417,2449,-32,0,40,1,6
17886,1,2393,2425,-32,0,315,0,6
17887,2,2493,2436,57,0,125,0,6
17888,3,2477,2365,112,0,141,0,6
17889,1,2529,2540,-11,0,7,0,6
17890,2,2305,2412,-107,0,255,0,6
17891,1,2566,2430,136,0,56,0,6
17892,1,2408,2360,48,0,415,0,6
17893,1,2494,2358,136,0,106,0,6
17894,1,2507,2647,-140,0,3,0,6
17895,3,2389,2449,-60,0,300,0,6
17896,1,2502,2463,39,0,255,0,6
17897,3,2421,2567,-146,0,131,0,6
17898,2,2331,2500,-169,0,336,0,6
17899,3,2445,2422,23,0,200,0,6
17900,1,2499,2263,236,4,4,0,13
17901,2,2484,2305,179,0,57,1,6
17902,1,2418,2309,109,0,123,0,6
17903,2,2416,2301,115,0,132,0,6
17904,1,2432,2416,16,4,106,0,13
17905,1,2391,2400,-9,4,398,0,13
17906,1,2531,2688,-157,0,100,0,6
17907,3,2449,2389,60,0,154,0,6
17908,1,2473,2441,32,0,47,0,6
17909,2,2395,2463,-68,0,14,0,8
17910,1,2435,2405,30,0,484,1,6
17911,2,2368,2402,-34,0,45,1,6
17912,3,2285,2420,-135,0,200,0,6
17913,2,2395,2470,-75,0,380,0,6
17914,2,2606,2671,-65,0,265,0,6
17915,3,2428,2274,154,0,453,0,6
17916,1,2675,2492,183,0,132,0,6
17917,2,2395,2413,-18,0,11,0,6
17918,1,2430,2331,99,0,260,0,6
17919,2,2238,2412,-174,0,20,0,8
17920,2,2421,2463,-42,0,338,0,6
17921,3,2567,2241,326,0,40,0,8
17922,1,2506,2327,179,0,140,0,6
17923,3,2273,2453,-180,0,122,0,6
17924,1,2355,2498,-143,0,46,0,6
17925,2,2248,2443,-195,4,45,0,13
17926,2,2251,2431,-180,0,320,0,6
17927,1,2485,2393,92,0,125,1,6
17928,2,2450,2571,-121,0,167,1,6
17929,1,2462,2324,138,0,177,0,6
17930,3,2304,2427,-123,0,245,0,6
17931,2,2353,2461,-108,0,1,0,6
17932,2,2234,2555,-321,0,4,0,6
17933,2,2472,2471,1,0,90,0,6
17934,2,2860,2642,218,0,247,0,6
17935,1,2498,2341,157,0,202,0,6
17936,1,2361,2422,-61,0,16,0,6
17937,1,2490,2363,127,0,45,0,6
17938,1,2516,2457,59,0,300,1,6
17939,2,2427,2403,24,0,80,0,6
17940,1,2438,2414,24,0,140,0,10
17941,3,2468,2643,-175,0,428,0,6
17942,3,2327,2434,-107,0,0,0,6
17943,2,2324,2412,-88,0,48,0,6
17944,1,2545,2202,343,0,130,0,6
17945,2,2468,2511,-43,0,405,0,6
17946,2,2489,2448,41,0,315,1,6
17947,1,2474,2390,84,0,150,1,6
17948,3,2437,2334,103,0,405,0,6
17949,1,2567,2600,-33,0,110,0,6
17950,1,2537,2435,102,0,10,0,6
17951,1,2415,2390,25,0,7,0,6
17952,2,2458,2502,-44,0,80,1,6
17953,2,2632,2623,9,0,60,0,6
17954,3,2504,2534,-30,0,142,0,8
17955,2,2418,2413,5,0,131,0,6
17956,2,2421,2393,28,0,200,0,6
17957,2,2335,2419,-84,0,200,0,6
17958,2,2424,2569,-145,0,102,0,6
17959,2,2418,2472,-54,0,302,0,6
17960,2,2309,2409,-100,0,100,1,6
17961,3,2434,2348,86,0,404,0,6
17962,1,2479,2475,4,0,246,1,6
17963,2,2316,2557,-241,0,269,0,6
17964,2,2233,2471,-238,0,6,0,6
17965,1,2436,2455,-19,0,13,0,6
17966,2,2287,2403,-116,0,245,1,6
17967,2,2442,2479,-37,0,45,0,6
17968,1,2359,2494,-135,0,41,0,6
17969,1,2524,2354,170,0,101,0,6
17970,1,2640,2535,105,0,173,0,6
17971,1,2479,2367,112,0,130,0,0
17972,1,2401,2268,133,0,107,0,6
17973,1,2418,2384,34,0,0,0,6
17974,2,2678,2539,139,0,211,0,6
17975,1,2534,2506,28,0,125,0,6
17976,2,2471,2369,102,0,404,0,6
17977,1,2448,2338,110,0,100,1,6
17978,1,2408,2245,163,4,143,0,13
17979,2,2419,2284,135,0,492,0,6
17980,3,2350,2428,-78,0,250,0,6
17981,2,2320,2466,-146,0,4,0,6
17982,1,2402,2390,12,0,365,0,6
17984,3,2505,2426,79,0,5,0,6
17985,2,2325,2431,-106,0,381,0,6
17986,1,2651,2839,-188,0,146,0,6
17987,1,2469,2483,-14,0,141,0,6
17988,2,2399,2415,-16,0,103,1,6
17989,2,2549,2526,23,0,140,0,6
17990,2,2423,2330,93,0,96,0,6
17991,1,2409,2230,179,0,40,0,6
17992,2,2349,2432,-83,0,466,0,6
17993,1,2486,2442,44,0,300,1,6
17994,1,2403,2238,165,0,256,0,6
17995,3,2451,2318,133,0,43,0,6
17996,1,2411,2337,74,0,118,0,6
17997,1,2482,2486,-4,0,140,1,6
17998,2,2405,2323,82,0,4,0,6
17999,1,2216,2429,-213,0,311,0,6
18000,1,2473,2264,209,0,45,0,6
18001,1,2455,2594,-139,0,101,0,6
18002,1,2389,2489,-100,0,190,0,6
18003,1,2477,2477,0,0,300,0,6
18004,2,2390,2466,-76,0,211,0,6
18005,3,2575,2447,128,0,126,0,6
18006,1,2465,2350,115,0,106,0,6
18007,1,2415,2350,65,0,140,0,8
18008,2,2411,2265,146,0,57,0,6
18009,2,2478,2562,-84,0,101,1,8
18010,1,2402,2222,180,0,5,0,8
18012,2,2335,2409,-74,0,455,0,6
18013,1,2519,2522,-3,0,10,0,6
18014,1,2419,2386,33,0,103,0,6
18015,1,2383,2471,-88,0,211,0,6
18016,1,2367,2407,-40,0,128,1,6
18017,1,2378,2463,-85,0,122,0,6
18018,2,2232,2408,-176,0,40,0,6
18019,1,2641,2511,130,0,45,0,6
18020,2,2402,2413,-11,0,113,0,6
18021,1,2358,2432,-74,0,201,0,6
18022,2,2436,2644,-208,0,302,0,6
18023,1,2456,2501,-45,0,125,1,6
18024,1,2516,2463,53,0,405,1,6
18025,2,2425,2306,119,0,177,0,6
18026,2,2573,2539,34,0,338,0,6
18027,1,2504,2280,224,0,345,0,6
18028,1,2334,2412,-78,0,446,1,6
18029,1,2385,2412,-27,0,300,1,6
18030,2,2400,2399,1,0,170,0,6
18031,1,2395,2453,-58,0,43,0,6
18033,1,2486,2484,2,0,81,0,6
18034,1,2424,2214,210,0,226,0,6
18035,2,2407,2338,69,0,125,0,6
18036,1,2416,2522,-106,0,210,0,6
18037,2,2420,2364,56,0,4,1,6
18038,1,2382,2407,-25,4,45,0,13
18039,2,2451,2423,28,0,200,0,6
18040,2,2531,2626,-95,0,20,1,6
18041,2,2413,2305,108,0,0,0,6
18042,2,2493,2343,150,0,43,0,8
18043,1,2464,2459,5,0,406,0,6
18044,2,2469,2484,-15,0,110,0,6
18045,3,2577,2589,-12,0,156,0,6
18046,2,2462,2304,158,0,320,0,6
18047,2,2443,2393,50,0,15,0,6
18048,3,2428,2412,16,0,41,0,6
18049,1,2422,2393,29,0,253,0,6
18050,1,2617,2670,-53,0,3,1,6
18051,2,2364,2431,-67,0,269,1,6
18052,2,2331,2405,-74,0,338,1,6
18053,3,2644,2547,97,0,464,0,6
18054,1,2507,2449,58,0,260,0,6
18055,3,2559,2476,83,0,110,0,6
18056,1,2482,2396,86,0,123,1,6
18057,2,2427,2296,131,0,15,0,6
18058,1,2431,2325,106,4,140,0,13
18059,2,2422,2269,153,0,49,0,6
18060,1,2319,2524,-205,0,122,0,6
18061,1,2565,2400,165,0,9,0,6
18062,2,2423,2423,0,0,373,0,6
18063,1,2503,2445,58,0,383,0,6
18064,2,2336,2436,-100,0,301,1,6
18065,2,2444,2324,120,0,332,0,6
18066,1,2819,2660,159,0,40,1,6
18067,2,2320,2452,-132,0,46,1,6
18068,2,2417,2362,55,0,7,0,6
18069,2,2512,2469,43,0,25,1,6
18070,2,2435,2321,114,0,358,0,6
18071,3,2411,2288,123,0,8,0,6
18072,1,2586,2437,149,0,48,0,6
18073,1,2437,2491,-54,0,107,0,6
18074,1,2501,2439,62,0,195,0,6
18075,3,2433,2515,-82,0,302,0,6
18076,2,2420,2393,27,0,200,1,6
18077,2,2346,2469,-123,0,1,0,6
18078,2,2416,2413,3,0,373,0,6
18079,2,2646,2567,79,0,118,1,6
18080,1,2403,2281,122,0,380,0,6
18081,1,2386,2430,-44,0,62,0,6
18082,2,2577,2546,31,0,21,0,6
18083,1,2441,2426,15,0,373,1,8
18084,2,2381,2402,-21,0,131,0,6
18085,2,2516,2424,92,0,344,0,6
18086,3,2312,2405,-93,0,101,0,6
18087,2,2480,2446,34,0,4,0,6
18088,2,2337,2402,-65,0,124,0,6
18089,2,2527,2438,89,0,426,0,6
18090,2,2232,2427,-195,0,102,0,6
18091,2,2212,2412,-200,0,107,0,6
18092,1,2449,2573,-124,0,160,0,6
18093,3,2513,2423,90,0,300,0,6
18094,2,2483,2420,63,0,46,0,6
18095,1,2409,2234,175,0,107,0,10
18096,2,2434,2506,-72,0,101,0,6
18097,2,2472,2445,27,0,46,0,6
18098,1,2401,2373,28,0,474,0,6
18099,1,2456,2385,71,0,46,0,6
18100,1,2405,2451,-46,0,123,0,6
18101,2,2481,2418,63,0,216,0,6
18102,1,2452,2318,134,0,101,1,6
18103,2,2314,2418,-104,0,245,0,6
18104,3,2415,2368,47,0,15,0,6
18105,1,2282,2405,-123,0,132,0,8
18106,3,2490,2464,26,0,302,0,6
18107,1,2505,2494,11,0,377,0,6
18108,1,2533,2505,28,0,187,0,8
18109,3,2415,2293,122,0,300,0,6
18110,1,2427,2421,6,0,355,1,6
18111,1,2492,2311,181,0,200,1,6
18112,1,2478,2470,8,0,211,0,6
18113,1,2371,2406,-35,0,140,0,6
18114,1,2400,2391,9,0,0,0,6
18115,1,2462,2534,-72,0,125,0,6
18116,3,2477,2354,123,0,45,0,6
18117,2,2414,2316,98,0,46,1,6
18118,2,2279,2507,-228,0,46,0,6
18119,1,2473,2342,131,0,40,0,6
18120,1,2631,2661,-30,0,65,0,6
18121,1,2298,2413,-115,0,263,0,8
18122,1,2451,2321,130,0,45,1,6
18123,2,2401,2483,-82,0,215,0,6
18124,2,2367,2436,-69,0,485,0,6
18125,2,2440,2394,46,0,45,0,6
18126,2,2290,2426,-136,0,255,0,6
18127,2,2381,2461,-80,0,229,0,6
18128,2,2392,2487,-95,0,246,1,6
18129,2,2538,2643,-105,0,339,1,6
18130,3,2422,2477,-55,0,122,0,6
18131,1,2447,2454,-7,0,45,0,6
18132,2,2401,2512,-111,0,48,0,8
18133,2,2338,2436,-98,0,45,0,6
18134,3,2445,2411,34,0,250,0,6
18135,2,2656,2826,-170,0,301,0,6
18136,2,2297,2407,-110,0,0,0,6
18137,1,2401,2289,112,4,424,0,13
18138,1,2345,2456,-111,0,335,0,6
18139,1,2368,2406,-38,0,128,1,6
18140,1,2419,2330,89,0,229,0,6
18141,3,2404,2281,123,0,375,0,6
18142,2,2216,2476,-260,0,113,0,6
18143,1,2510,2323,187,0,304,0,6
18144,1,2429,2484,-55,0,107,0,6
18145,1,2420,2383,37,0,110,0,6
18146,2,2488,2427,61,0,132,0,6
18147,2,2443,2386,57,0,112,1,6
18148,2,2549,2589,-40,0,20,1,6
18149,2,2223,2405,-182,0,300,0,6
18150,2,2269,2431,-162,0,83,0,6
18151,1,2288,2404,-116,0,200,0,8
18152,2,2292,2548,-256,0,470,0,6
18153,2,2543,2537,6,0,4,0,6
18154,1,2400,2414,-14,0,102,0,6
18155,1,2432,2509,-77,0,106,0,6
18156,2,2453,2365,88,0,49,0,6
18157,1,2466,2376,90,0,263,0,6
18158,2,2425,2482,-57,0,276,1,6
18159,2,2476,2474,2,0,140,0,6
18160,1,2776,2573,203,0,130,0,6
18161,1,2514,2637,-123,0,267,0,6
18162,2,2640,2655,-15,0,190,0,6
18163,2,2392,2574,-182,0,0,0,6
18164,2,2410,2345,65,0,291,0,6
18165,1,2433,2283,150,0,135,0,6
18166,1,2420,2311,109,0,106,0,8
18167,2,2274,2420,-146,0,405,0,6
18168,1,2423,2265,158,0,200,0,6
18169,2,2405,2346,59,0,334,1,6
18170,1,2427,2434,-7,0,107,0,10
18171,2,2305,2408,-103,0,70,0,6
18172,2,2571,2779,-208,0,200,0,6
18173,2,2565,2456,109,0,125,0,6
18174,2,2303,2420,-117,0,432,0,6
18175,3,2425,2331,94,0,150,0,6
18176,1,2552,2511,41,0,210,0,6
18177,2,2430,2559,-129,0,4,0,6
18178,1,2464,2489,-25,0,129,0,6
18179,2,2502,2439,63,0,415,0,6
18180,2,2369,2422,-53,0,228,0,6
18181,3,2224,2411,-187,0,107,0,6
18182,3,2424,2452,-28,0,107,0,8
18183,3,2489,2417,72,0,101,0,6
18184,2,2384,2437,-53,0,206,1,6
18185,1,2588,2578,10,0,309,1,6
18186,2,2400,2434,-34,0,101,1,6
18187,1,2487,2351,136,0,303,0,6
18188,2,2411,2409,2,0,45,0,8
18189,1,2413,2407,6,0,211,0,6
18190,1,2455,2316,139,0,114,0,6
18191,2,2331,2428,-97,0,386,1,6
18192,1,2468,2326,142,0,108,1,6
18193,1,2396,2490,-94,0,102,0,6
18194,2,2208,2442,-234,0,120,1,6
18195,2,2302,2411,-109,0,202,0,6
18196,2,2511,2602,-91,0,176,1,6
18197,3,2378,2421,-43,0,10,0,6
18198,1,2338,2477,-139,0,1,1,6
18199,1,2415,2226,189,0,211,1,6
18200,2,2481,2469,12,0,136,0,6
18201,1,2434,2466,-32,0,125,0,6
18202,1,2480,2484,-4,0,245,0,6
18203,1,2470,2527,-57,0,157,0,6
18204,2,2438,2501,-63,0,410,1,6
18205,2,2371,2470,-99,0,113,0,6
18206,2,2408,2327,81,0,44,0,6
18207,2,2464,2312,152,0,49,0,6
18208,2,2476,2463,13,0,113,0,6
18209,1,2416,2433,-17,0,278,0,6
18210,2,2354,2402,-48,0,324,0,6
18211,2,2451,2494,-43,0,45,1,6
18212,2,2448,2377,71,0,111,0,6
18213,1,2440,2328,112,0,0,0,6
18214,1,2397,2417,-20,0,426,0,6
18215,2,2420,2568,-148,0,11,0,6
18216,3,2429,2508,-79,0,267,0,6
18217,2,2412,2301,111,0,337,0,6
18218,1,2834,2653,181,0,40,0,6
18219,1,2440,2326,114,0,332,1,6
18220,2,2594,2543,51,0,43,0,6
18221,2,2353,2474,-121,0,101,0,8
18222,2,2491,2387,104,0,483,0,6
18223,2,2423,2437,-14,0,107,0,6
18224,2,2393,2446,-53,0,43,0,6
18225,2,2363,2459,-96,0,338,0,6
18226,1,2441,2312,129,0,43,0,6
18227,1,2448,2480,-32,0,41,0,6
18228,1,2400,2374,26,0,474,0,6
18229,3,2534,2392,142,0,333,0,6
18230,1,2427,2387,40,0,123,0,6
18231,2,2478,2647,-169,0,45,0,6
18232,1,2421,2312,109,0,320,1,8
18233,1,2436,2368,68,0,194,0,6
18234,1,2568,2634,-66,0,150,0,6
18235,2,2345,2412,-67,0,106,0,6
18236,1,2310,2471,-161,0,40,0,6
18237,2,2270,2425,-155,0,405,1,6
18238,1,2539,2494,45,0,357,0,7
18239,3,2423,2440,-17,0,15,0,6
18240,2,2370,2537,-167,0,101,0,6
18241,1,2435,2373,62,0,201,0,6
18242,2,2408,2406,2,0,200,0,6
18243,2,2433,2629,-196,0,492,1,6
18244,2,2401,2217,184,0,5,0,6
18245,2,2450,2353,97,0,126,0,6
18246,1,2411,2533,-122,0,45,0,6
18247,2,2587,2521,66,0,130,0,6
18248,2,2339,2491,-152,0,483,1,6
18249,3,2623,2629,-6,0,3,0,6
18250,2,2488,2475,13,0,211,0,6
18251,1,2558,2388,170,0,106,0,6
18252,2,2265,2432,-167,0,41,1,6
18253,1,2660,2440,220,0,107,1,6
18254,2,2331,2415,-84,0,218,0,6
18255,2,2304,2440,-136,0,45,1,6
18256,2,2418,2495,-77,0,43,0,6
18257,1,2442,2464,-22,0,196,1,6
18258,1,2474,2486,-12,0,3,0,6
18259,1,2417,2469,-52,0,13,0,6
18260,2,2369,2405,-36,0,128,0,6
18261,2,2456,2463,-7,0,46,1,6
18262,1,2439,2395,44,0,302,1,6
18263,1,2398,2483,-85,0,180,0,6
18264,2,2249,2550,-301,0,454,0,6
18265,1,2557,2521,36,0,228,0,6
18266,2,2442,2441,1,0,196,0,6
18267,1,2505,2370,135,0,107,0,6
18268,3,2549,2588,-39,0,101,0,6
18269,2,2404,2469,-65,0,318,0,6
18270,2,2343,2418,-75,0,301,0,6
18271,2,2650,2840,-190,0,115,0,6
18272,2,2471,2506,-35,0,101,0,6
18273,1,2260,2427,-167,0,0,0,6
18274,1,2469,2346,123,0,127,0,6
18275,1,2507,2606,-99,0,121,1,6
18276,1,2416,2341,75,0,128,0,6
18277,1,2333,2424,-91,0,301,0,6
18278,1,2477,2475,2,0,135,0,6
18279,1,2380,2403,-23,0,338,0,6
18280,2,2437,2499,-62,0,125,0,6
18281,3,2532,2484,48,0,225,0,6
18282,2,2476,2442,34,0,6,0,6
18283,1,2558,2296,262,0,375,1,8
18284,1,2454,2298,156,0,22,1,8
18285,1,2475,2389,86,0,106,0,6
18286,1,2650,2520,130,0,377,0,6
18287,3,2444,2349,95,0,310,0,6
18288,1,2523,2391,132,0,58,0,8
18289,2,2290,2420,-130,0,453,0,6
18290,1,2402,2231,171,0,7,0,8
18291,1,2360,2438,-78,0,320,1,6
18292,2,2418,2404,14,0,200,0,6
18293,2,2487,2341,146,0,12,0,6
18294,1,2443,2391,52,0,106,1,6
18295,3,2415,2386,29,0,43,0,8
18296,1,2387,2432,-45,0,1,0,6
18297,3,2423,2465,-42,0,120,0,6
18298,2,2650,2624,26,0,200,1,6
18299,2,2359,2425,-66,0,170,0,8
18300,1,2452,2286,166,0,105,0,8
18301,2,2234,2417,-183,4,0,0,13
18302,3,2610,2533,77,0,0,0,6
18303,2,2449,2344,105,0,127,1,6
18304,1,2309,2470,-161,0,306,0,6
18305,1,2427,2364,63,0,292,0,6
18306,2,2422,2352,70,0,4,0,6
18307,1,2448,2454,-6,0,246,0,6
18308,1,2399,2425,-26,0,7,0,6
18309,2,2577,2479,98,0,46,0,6
18310,1,2432,2422,10,0,310,0,6
18311,2,2411,2402,9,0,103,1,6
18312,2,2273,2421,-148,0,41,1,6
18313,1,2627,2562,65,0,270,0,6
18314,1,2485,2206,279,0,10,0,8
18315,2,2493,2366,127,0,110,0,6
18316,1,2321,2412,-91,0,470,1,6
18317,2,2361,2451,-90,0,12,0,6
18318,1,2441,2444,-3,0,432,1,6
18319,3,2419,2482,-63,0,380,0,6
18320,3,2435,2336,99,0,154,0,6
18321,2,2342,2473,-131,0,1,1,6
18322,1,2494,2580,-86,0,398,0,6
18323,1,2458,2448,10,0,115,0,6
18324,2,2427,2412,15,0,200,0,6
18325,2,2405,2358,47,0,303,0,6
18326,1,2462,2429,33,0,200,0,6
18327,3,2438,2663,-225,0,301,0,6
18328,1,2480,2414,66,0,101,0,6
18329,2,2516,2527,-11,0,38,1,6
18330,2,2443,2293,150,0,201,0,6
18331,1,2400,2351,49,0,319,0,6
18332,1,2453,2577,-124,0,6,1,6
18333,3,2629,2509,120,0,327,0,6
18334,2,2310,2424,-114,0,30,1,6
18335,3,2520,2550,-30,0,40,0,8
18336,2,2504,2458,46,0,426,0,6
18337,2,2384,2409,-25,0,10,0,6
18338,2,2345,2451,-106,0,45,1,6
18339,1,2385,2436,-51,0,200,1,6
18340,2,2484,2531,-47,0,21,0,6
18341,2,2587,2550,37,0,45,0,6
18342,2,2471,2420,51,0,57,0,6
18343,2,2297,2425,-128,0,4,0,8
18344,1,2534,2599,-65,0,122,0,6
18345,1,2410,2363,47,0,335,1,6
18346,1,2554,2502,52,0,190,0,6
18347,1,2469,2569,-100,0,245,0,6
18348,1,2487,2482,5,0,300,1,6
18349,3,2418,2380,38,0,81,0,6
18350,3,2572,2507,65,0,50,0,6
18351,3,2402,2444,-42,0,383,0,6
18352,3,2355,2430,-75,0,374,0,6
18353,3,2220,2403,-183,0,419,0,6
18354,1,2333,2417,-84,0,419,0,6
18355,1,2285,2421,-136,0,7,0,8
18356,1,2469,2418,51,0,101,0,6
18357,2,2400,2291,109,0,255,0,6
18358,1,2607,2238,369,0,184,1,6
18359,1,2660,2441,219,0,107,0,6
18360,1,2397,2529,-132,0,48,1,8
18361,1,2517,2516,1,0,262,0,6
18362,2,2281,2413,-132,0,130,0,6
18363,2,2519,2487,32,0,48,0,8
18364,1,2442,2357,85,0,486,1,6
18365,1,2760,2632,128,0,20,0,6
18366,1,2420,2299,121,0,122,0,6
18367,1,2263,2459,-196,0,110,0,6
18368,1,2461,2456,5,0,4,0,6
18369,2,2296,2455,-159,0,0,0,8
18370,1,2609,2557,52,0,0,0,6
18371,3,2431,2465,-34,0,130,0,6
18372,1,2499,2367,132,0,43,1,6
18373,2,2435,2448,-13,0,242,0,6
18374,1,2654,2565,89,0,308,1,6
18375,1,2421,2365,56,0,248,1,6
18376,1,2358,2425,-67,0,16,0,6
18377,2,2485,2402,83,0,200,0,6
18378,1,2279,2420,-141,0,344,0,6
18379,1,2481,2409,72,0,101,0,6
18380,1,2473,2408,65,0,102,1,6
18381,1,2359,2416,-57,0,133,0,6
18382,1,2424,2296,128,0,0,0,6
18383,1,2478,2468,10,0,222,1,6
18384,2,2447,2420,27,0,40,0,6
18385,1,2438,2662,-224,0,211,0,6
18386,1,2397,2418,-21,0,106,0,6
18387,1,2409,2478,-69,0,2,0,6
18388,1,2479,2354,125,0,101,0,8
18389,2,2423,2537,-114,0,267,0,6
18390,2,2346,2414,-68,0,40,0,6
18391,1,2581,2627,-46,0,300,0,6
18392,1,2523,2475,48,0,150,0,6
18393,1,2442,2463,-21,0,196,1,6
18394,2,2477,2339,138,0,40,0,6
18395,2,2301,2435,-134,0,485,0,6
18396,2,2511,2341,170,0,300,0,6
18397,1,2434,2339,95,0,1,1,6
18398,1,2413,2429,-16,0,36,0,6
18399,1,2405,2302,103,0,232,0,6
18400,2,2419,2427,-8,0,8,0,6
18401,2,2358,2424,-66,0,7,1,6
18402,2,2441,2474,-33,0,151,0,6
18403,1,2445,2479,-34,0,100,0,6
18404,1,2251,2411,-160,0,131,0,6
18405,2,2401,2324,77,0,101,0,6
18406,1,2415,2330,85,0,228,0,6
18407,3,2569,2513,56,0,341,0,6
18408,2,2228,2450,-222,0,117,0,6
18409,3,2416,2405,11,0,388,0,6
18410,2,2449,2476,-27,0,320,0,6
18411,1,2465,2497,-32,0,411,0,6
18412,2,2352,2471,-119,0,300,0,6
18413,1,2628,2442,186,0,291,1,6
18414,2,2553,2541,12,0,145,0,6
18415,3,2536,2479,57,0,225,0,6
18416,1,2441,2373,68,0,310,0,6
18417,2,2426,2464,-38,0,207,0,6
18418,1,2521,2406,115,0,444,0,8
18419,2,2455,2391,64,0,40,0,6
18420,1,2464,2311,153,4,29,1,13
18421,1,2271,2446,-175,0,394,0,6
18422,1,2450,2477,-27,0,138,0,6
18423,3,2480,2535,-55,0,244,0,6
18424,2,2485,2413,72,0,101,0,6
18425,1,2549,2429,120,0,45,1,8
18426,1,2375,2423,-48,0,199,0,6
18427,2,2508,2476,32,0,8,0,6
18428,1,2748,2360,388,0,40,0,6
18429,1,2405,2287,118,0,338,0,6
18430,2,2203,2400,-197,0,311,0,6
18431,2,2318,2477,-159,0,151,0,6
18432,2,2564,2653,-89,0,190,0,6
18433,3,2408,2369,39,0,45,0,8
18434,2,2268,2412,-144,0,6,0,6
18435,1,2414,2298,116,0,112,1,6
18436,2,2380,2428,-48,0,103,0,6
18437,1,2431,2378,53,0,202,0,6
18438,1,2621,2587,34,0,306,0,6
18439,3,2441,2464,-23,0,124,0,6
18440,1,2479,2436,43,0,107,0,6
18441,1,2453,2249,204,0,485,1,6
18442,1,2428,2364,64,0,40,1,6
18443,1,2478,2409,69,0,172,0,6
18444,1,2422,2310,112,0,100,0,6
18445,3,2404,2411,-7,0,120,0,6
18446,1,2332,2420,-88,0,443,0,6
18447,2,2401,2299,102,0,31,0,6
18448,2,2209,2553,-344,0,111,0,6
18449,1,2471,2416,55,0,4,0,6
18450,1,2555,2568,-13,0,112,0,6
18451,1,2439,2228,211,0,11,0,8
18452,2,2502,2464,38,0,300,0,6
18453,2,2404,2439,-35,0,45,1,6
18454,2,2462,2447,15,0,107,0,6
18455,2,2409,2366,43,0,4,0,6
18456,1,2484,2426,58,0,222,0,6
18457,1,2426,2368,58,0,110,1,6
18458,1,2469,2421,48,0,57,0,6
18459,2,2419,2360,59,0,45,0,6
18460,1,2408,2339,69,0,150,0,6
18461,2,2461,2625,-164,0,4,1,6
18462,1,2298,2405,-107,4,1,0,13
18463,2,2347,2469,-122,0,1,0,6
18464,1,2514,2528,-14,0,314,0,6
18465,3,2463,2335,128,4,394,0,13
18466,2,2433,2334,99,0,10,0,6
18467,2,2445,2384,61,0,302,0,6
18468,1,2562,2448,114,0,403,0,6
18469,1,2410,2470,-60,0,196,0,6
18470,2,2347,2419,-72,0,0,1,6
18471,2,2405,2490,-85,0,250,0,6
18472,1,2405,2205,200,0,80,1,8
18473,2,2350,2468,-118,0,405,1,6
18474,3,2342,2417,-75,0,45,0,6
18475,2,2440,2263,177,0,1,0,6
18476,2,2431,2283,148,0,250,1,6
18477,2,2283,2414,-131,0,150,0,6
18478,1,2459,2402,57,0,131,0,8
18479,1,2457,2440,17,0,199,0,6
18480,2,2238,2401,-163,0,122,0,6
18481,2,2495,2384,111,0,57,0,8
18482,1,2491,2471,20,0,447,1,6
18483,3,2534,2481,53,0,120,0,6
18484,2,2435,2631,-196,0,9,0,6
18485,2,2302,2448,-146,0,212,1,6
18486,1,2434,2597,-163,0,45,0,6
18487,2,2471,2456,15,0,6,0,6
18488,2,2547,2556,-9,0,228,0,6
18489,1,2381,2439,-58,0,4,0,6
18490,2,2297,2528,-231,0,115,0,8
18491,2,2473,2451,22,0,4,0,6
18492,1,2763,2658,105,0,18,0,6
18493,1,2398,2431,-33,0,226,0,6
18494,1,2349,2428,-79,0,200,0,6
18495,3,2481,2411,70,0,13,0,6
18496,1,2433,2270,163,0,113,0,6
18497,2,2502,2476,26,0,200,1,6
18498,1,2421,2503,-82,0,106,0,6
18499,1,2290,2418,-128,0,123,0,6
18500,1,2262,2416,-154,0,302,1,6
18501,2,2547,2551,-4,0,215,0,6
18502,2,2238,2502,-264,0,121,0,8
18503,1,2472,2334,138,0,398,0,8
18504,2,2358,2404,-46,0,211,0,8
18505,2,2359,2749,-390,0,4,0,6
18506,2,2412,2395,17,0,45,0,6
18507,1,2470,2494,-24,0,202,1,6
18508,1,2464,2480,-16,0,150,0,6
18509,2,2517,2412,105,0,4,0,6
18510,2,2403,2570,-167,0,312,0,6
18511,3,2508,2357,151,0,374,0,6
18512,1,2429,2400,29,0,110,0,6
18513,1,2444,2340,104,0,380,0,6
18514,1,2402,2412,-10,0,106,0,6
18515,2,2582,2626,-44,0,45,0,6
18516,2,2422,2350,72,0,350,0,0
18517,2,2342,2405,-63,0,1,0,6
18518,3,2499,2444,55,0,45,0,6
18519,2,2433,2456,-23,0,330,0,6
18520,1,2425,2404,21,0,106,0,6
18521,2,2473,2343,130,0,106,1,6
18522,1,2411,2404,7,0,45,0,6
18523,2,2359,2439,-80,0,57,1,6
18524,1,2429,2370,59,0,1,0,8
18525,2,2211,2405,-194,0,49,0,8
18526,2,2438,2353,85,0,253,0,6
18527,3,2521,2494,27,0,254,0,8
18528,1,2444,2399,45,0,100,0,6
18529,1,2458,2467,-9,0,40,0,6
18530,1,2392,2551,-159,0,311,0,8
18531,1,2486,2407,79,0,338,0,8
18532,1,2562,2453,109,0,107,0,6
18533,2,2421,2489,-68,0,0,0,6
18534,2,2631,2577,54,0,302,0,6
18535,1,2654,2634,20,0,154,0,6
18536,1,2750,2358,392,0,40,0,6
18537,2,2372,2403,-31,0,404,0,6
18538,1,2438,2313,125,0,113,0,6
18539,1,2482,2534,-52,0,244,1,6
18540,2,2520,2416,104,0,59,0,6
18541,2,2462,2465,-3,0,30,1,6
18542,1,2628,2436,192,0,58,0,6
18544,2,2435,2522,-87,0,123,0,6
18545,2,2463,2400,63,0,154,0,6
18546,2,2421,2386,35,0,0,1,6
18547,1,2432,2529,-97,0,1,0,6
18548,1,2333,2417,-84,4,46,1,13
18549,1,2342,2480,-138,0,0,0,6
18550,2,2343,2495,-152,0,45,0,8
18551,2,2291,2423,-132,0,320,0,6
18552,2,2426,2521,-95,0,224,0,8
18553,1,2274,2424,-150,0,45,0,6
18554,1,2401,2406,-5,0,132,0,6
18555,2,2466,2497,-31,0,392,0,6
18556,1,2425,2344,81,0,343,0,6
18557,1,2232,2475,-243,0,101,0,8
18558,2,2433,2536,-103,0,4,1,6
18559,2,2474,2412,62,0,210,0,6
18560,2,2567,2767,-200,0,190,0,6
18561,1,2415,2473,-58,0,428,0,6
18562,1,2258,2400,-142,0,110,0,8
18563,3,2335,2415,-80,0,80,0,6
18564,1,2271,2432,-161,0,100,0,6
18565,2,2452,2403,49,0,344,1,6
18566,2,2357,2751,-394,0,10,0,6
18567,1,2543,2285,258,0,45,1,8
18568,1,2406,2259,147,0,352,0,8
18569,2,2497,2428,69,0,7,0,6
18570,2,2217,2607,-390,0,200,0,8
18571,2,2295,2415,-120,0,7,0,8
18572,2,2462,2431,31,0,134,0,6
18573,2,2541,2517,24,0,122,1,6
18574,1,2528,2590,-62,0,101,0,6
18575,2,2495,2526,-31,0,36,0,6
18576,2,2244,2410,-166,0,459,0,6
18577,1,2433,2399,34,0,106,0,6
18578,1,2468,2631,-163,0,110,1,6
18579,2,2394,2415,-21,0,43,0,6
18580,1,2511,2394,117,0,120,0,6
18581,1,2393,2553,-160,0,7,1,8
18582,2,2309,2429,-120,0,101,0,6
18583,1,2487,2496,-9,0,300,0,6
18584,2,2408,2366,42,0,50,0,6
18585,2,2541,2556,-15,0,123,0,6
18586,3,2400,2407,-7,0,45,0,6
18587,2,2464,2394,70,0,4,0,6
18588,2,2584,2625,-41,0,45,0,6
18589,1,2410,2235,175,0,20,0,6
18590,2,2310,2429,-119,0,84,0,6
18591,2,2398,2417,-19,0,36,0,6
18592,1,2443,2483,-40,0,317,1,6
18593,2,2463,2456,7,0,180,0,6
18594,2,2493,2416,77,0,222,1,6
18595,1,2530,2566,-36,0,110,0,6
18596,2,2482,2513,-31,0,302,0,6
18597,1,2346,2475,-129,0,40,0,6
18598,1,2401,2246,155,0,134,1,6
18599,2,2351,2465,-114,0,1,0,6
18600,1,2483,2408,75,0,120,0,8
18601,1,2629,2477,152,0,291,0,6
18602,1,2427,2287,140,0,4,0,6
18603,2,2449,2457,-8,0,200,0,6
18604,2,2527,2489,38,0,225,1,6
18605,1,2414,2335,79,0,278,0,6
18606,1,2471,2562,-91,0,234,0,6
18607,1,2408,2367,41,0,4,0,6
18608,2,2424,2659,-235,0,123,0,6
18609,1,2515,2421,94,0,120,0,6
18610,2,2402,2442,-40,0,107,0,6
18611,1,2521,2357,164,0,146,0,0
18612,2,2476,2593,-117,0,46,0,6
18613,2,2472,2588,-116,0,140,1,6
18614,1,2414,2391,23,0,0,0,6
18615,1,2502,2461,41,0,426,1,6
18616,2,2444,2405,39,0,300,1,6
18617,2,2441,2564,-123,0,245,0,6
18618,2,2456,2462,-6,0,190,0,6
18619,1,2371,2446,-75,0,107,0,6
18620,2,2437,2458,-21,0,251,1,6
18621,1,2408,2545,-137,0,302,0,8
18622,2,2408,2383,25,0,122,1,6
18623,1,2416,2282,134,0,111,0,6
18624,1,2630,2579,51,0,7,0,6
18625,1,2445,2350,95,0,49,0,6
18626,1,2468,2419,49,0,201,0,6
18627,2,2291,2443,-152,0,4,0,6
18628,2,2374,2430,-56,0,55,0,6
18629,1,2560,2536,24,0,107,1,6
18630,2,2456,2433,23,0,81,0,6
18631,1,2424,2390,34,0,1,0,6
18632,2,2583,2544,39,0,45,0,6
18633,2,2540,2450,90,0,302,0,6
18634,2,2468,2439,29,0,105,0,6
18635,3,2531,2415,116,0,211,0,6
18636,3,2519,2339,180,0,247,0,6
18637,1,2283,2431,-148,0,56,0,6
18638,1,2334,2435,-101,0,300,1,6
18639,1,2483,2491,-8,0,49,0,6
18640,2,2461,2463,-2,0,4,0,6
18641,1,2662,2422,240,0,15,0,6
18642,1,2446,2350,96,0,404,0,6
18643,1,2462,2444,18,0,107,0,6
18644,2,2299,2403,-104,0,106,1,6
18645,1,2469,2347,122,0,106,0,6
18646,2,2623,2476,147,0,41,0,6
18647,1,2548,2407,141,0,127,0,6
18648,2,2490,2478,12,0,4,0,6
18649,1,2556,2400,156,0,131,1,6
18650,1,2664,2384,280,0,144,0,6
18651,2,2306,2404,-98,0,213,0,6
18652,2,2444,2496,-52,0,41,1,6
18653,2,2402,2521,-119,0,487,1,6
18654,1,2550,2477,73,0,374,0,6
18655,2,2466,2320,146,0,335,1,6
18656,1,2413,2495,-82,4,226,0,11
18657,1,2463,2332,131,0,44,0,6
18658,1,2409,2421,-12,0,414,1,8
18659,2,2446,2375,71,0,352,0,6
18660,2,2306,2457,-151,0,40,0,6
18661,2,2463,2235,228,0,118,0,6
18662,1,2370,2497,-127,0,395,0,6
18663,2,2279,2420,-141,0,45,1,6
18664,2,2445,2400,45,0,245,0,6
18665,1,2462,2465,-3,0,196,1,6
18666,2,2476,2450,26,0,102,1,6
18667,2,2473,2494,-21,0,113,1,6
18668,1,2435,2266,169,0,150,0,6
18669,1,2432,2433,-1,0,260,0,6
18670,1,2498,2331,167,0,41,0,8
18671,2,2335,2477,-142,0,16,0,6
18672,2,2657,2770,-113,0,190,0,6
18673,1,2247,2418,-171,0,15,0,6
18674,2,2420,2470,-50,0,122,0,6
18675,2,2230,2400,-170,0,335,0,6
18676,2,2505,2384,121,0,426,0,6
18677,1,2359,2419,-60,0,190,0,6
18678,1,2574,2448,126,0,35,0,6
18679,1,2495,2521,-26,0,4,1,6
18680,1,2423,2358,65,0,125,0,6
18681,2,2479,2504,-25,0,40,0,8
18682,2,2356,2439,-83,0,38,0,6
18683,1,2362,2413,-51,0,4,0,6
18684,2,2351,2489,-138,0,15,1,6
18685,2,2510,2597,-87,0,107,1,6
18686,2,2472,2437,35,0,303,0,6
18687,2,2454,2370,84,0,110,0,6
18688,1,2353,2401,-48,0,300,0,6
18689,1,2437,2362,75,4,310,0,13
18691,2,2420,2303,117,0,0,1,6
18692,1,2460,2449,11,0,45,1,6
18693,2,2436,2369,67,0,110,1,6
18694,2,2278,2402,-124,0,110,0,8
18695,1,2456,2507,-51,0,490,0,6
18696,2,2360,2468,-108,0,219,0,6
18697,2,2457,2568,-111,0,247,0,6
18698,1,2412,2288,124,0,6,1,6
18699,1,2368,2416,-48,0,48,1,8
18700,1,2401,2413,-12,0,385,0,6
18701,1,2439,2441,-2,0,483,0,6
18702,3,2592,2468,124,0,18,0,6
18703,1,2739,2562,177,0,211,0,6
18704,3,2414,2533,-119,0,2,0,6
18705,2,2355,2413,-58,0,50,1,6
18706,1,2439,2468,-29,0,216,0,6
18707,1,2419,2664,-245,0,205,0,6
18708,1,2566,2574,-8,0,306,0,6
18709,2,2358,2409,-51,0,46,0,8
18710,2,2343,2473,-130,0,1,0,6
18711,1,2403,2516,-113,0,106,0,6
18712,1,2410,2439,-29,0,211,0,6
18713,2,2306,2486,-180,0,13,1,6
18714,1,2520,2215,305,0,106,1,8
18715,2,2559,2742,-183,0,201,0,6
18716,2,2300,2418,-118,4,1,0,13
18717,1,2342,2481,-139,0,112,0,6
18718,1,2635,2531,104,0,41,0,6
18719,1,2423,2292,131,0,1,0,6
18720,2,2521,2529,-8,0,33,0,6
18721,1,2427,2406,21,0,409,0,6
18722,1,2442,2282,160,0,200,0,6
18723,1,2434,2298,136,0,42,0,8
18724,1,2438,2541,-103,0,245,0,6
18725,2,2401,2273,128,0,115,0,6
18726,1,2407,2423,-16,0,398,0,6
18727,1,2304,2405,-101,0,35,0,6
18728,1,2285,2611,-326,0,338,0,8
18729,1,2607,2484,123,0,246,1,6
18730,2,2204,2406,-202,0,311,0,6
18731,1,2484,2458,26,0,200,1,6
18732,2,2402,2448,-46,0,107,0,6
18733,2,2390,2440,-50,0,123,0,6
18734,2,2423,2275,148,0,300,0,6
18735,1,2469,2455,14,0,40,0,6
18736,1,2422,2436,-14,0,110,0,6
18737,1,2615,2555,60,0,406,0,6
18738,1,2745,2556,189,0,43,0,6
18739,2,2397,2560,-163,0,40,0,6
18740,3,2444,2466,-22,0,474,0,6
18741,1,2364,2416,-52,0,45,0,6
18742,1,2433,2254,179,0,315,1,6
18743,1,2487,2474,13,0,120,0,8
18744,3,2259,2478,-219,0,485,0,8
18745,2,2454,2468,-14,0,46,1,6
18746,2,2291,2444,-153,0,113,0,6
18747,2,2515,2484,31,0,41,1,6
18748,2,2280,2440,-160,0,115,0,6
18749,1,2450,2397,53,0,4,1,6
18750,1,2479,2453,26,0,250,1,6
18751,1,2477,2339,138,0,40,0,6
18752,2,2438,2352,86,0,200,0,6
18753,2,2344,2409,-65,0,1,1,6
18754,2,2455,2248,207,0,101,0,6
18755,1,2572,2468,104,0,403,0,6
18756,2,2401,2486,-85,0,141,0,6
18757,1,2407,2369,38,0,1,0,6
18758,2,2456,2470,-14,0,310,0,6
18759,2,2377,2545,-168,0,207,0,8
18760,1,2525,2354,171,0,146,0,0
18761,2,2437,2338,99,0,354,0,6
18762,1,2568,2571,-3,0,45,1,6
18763,2,2417,2428,-11,0,260,0,6
18764,2,2313,2520,-207,0,311,0,6
18765,1,2500,2462,38,0,156,1,6
18766,1,2377,2489,-112,0,388,0,6
18767,1,2602,2592,10,0,469,0,6
18768,2,2527,2639,-112,0,120,0,6
18769,1,2527,2506,21,0,105,0,6
18770,1,2518,2502,16,0,53,1,6
18771,1,2493,2407,86,0,302,0,6
18772,2,2510,2300,210,0,48,0,8
18773,1,2428,2445,-17,0,491,0,6
18774,3,2411,2412,-1,0,200,0,6
18775,1,2426,2310,116,0,49,0,6
18776,1,2309,2444,-135,0,301,0,6
18777,1,2317,2466,-149,0,40,0,6
18778,2,2459,2417,42,0,45,0,6
18779,2,2285,2416,-131,0,20,1,6
18780,2,2288,2440,-152,0,332,0,6
18781,1,2655,2774,-119,0,192,0,6
18782,1,2464,2383,81,0,300,0,6
18783,1,2462,2429,33,0,45,0,6
18784,2,2436,2266,170,0,40,0,6
18785,3,2415,2340,75,0,101,0,8
18786,2,2445,2550,-105,0,226,1,6
18787,1,2465,2444,21,0,247,1,6
18788,1,2579,2473,106,0,300,0,6
18789,1,2293,2433,-140,0,300,0,6
18790,2,2336,2480,-144,0,1,0,6
18791,3,2421,2259,162,0,10,0,6
18792,1,2470,2416,54,0,200,1,6
18793,2,2417,2413,4,0,20,1,6
18794,1,2535,2400,135,0,131,0,6
18795,1,2343,2409,-66,4,344,1,13
18796,2,2264,2426,-162,0,107,0,6
18797,1,2480,2488,-8,0,7,0,6
18798,2,2531,2611,-80,0,326,0,6
18799,2,2515,2431,84,0,107,1,6
18800,3,2430,2255,175,0,49,0,6
18801,2,2363,2412,-49,0,19,0,6
18802,2,2481,2453,28,0,241,0,6
18803,1,2447,2494,-47,0,205,0,6
18804,1,2543,2372,171,0,250,0,6
18805,1,2452,2274,178,0,278,1,6
18806,2,2450,2475,-25,0,4,0,6
18807,1,2390,2433,-43,0,241,0,6
18808,2,2406,2275,131,0,20,0,8
18809,1,2643,2523,120,0,41,0,6
18810,1,2392,2410,-18,0,172,0,8
18812,3,2423,2467,-44,0,123,0,6
18813,2,2473,2489,-16,0,100,1,6
18814,2,2472,2333,139,0,380,0,6
18815,2,2509,2491,18,0,140,0,6
18816,2,2587,2607,-20,0,37,0,6
18817,1,2328,2485,-157,0,365,0,6
18818,1,2396,2448,-52,0,242,0,6
18819,1,2553,2748,-195,0,201,0,6
18820,2,2550,2620,-70,0,411,0,6
18821,1,2590,2595,-5,0,133,1,6
18822,2,2284,2430,-146,0,7,1,6
18823,2,2351,2528,-177,0,484,1,0
18824,2,2356,2416,-60,0,216,1,6
18825,3,2446,2282,164,0,127,0,6
18826,2,2530,2536,-6,0,115,0,8
18827,1,2556,2209,347,0,130,0,8
18828,1,2287,2428,-141,0,11,0,6
18829,3,2416,2338,78,0,80,0,6
18830,1,2426,2402,24,0,226,0,6
18831,2,2403,2498,-95,0,88,0,6
18832,1,2444,2231,213,0,302,0,6
18833,1,2434,2392,42,0,151,0,6
18834,1,2366,2578,-212,0,111,0,6
18835,1,2412,2227,185,0,131,0,6
18836,1,2406,2344,62,0,190,0,6
18837,2,2501,2532,-31,0,410,0,6
18838,1,2490,2583,-93,0,200,1,6
18839,2,2448,2576,-128,0,247,1,6
18840,1,2327,2422,-95,0,2,0,6
18841,2,2326,2430,-104,0,10,0,6
18842,1,2432,2312,120,0,190,0,6
18843,2,2566,2574,-8,0,57,0,6
18844,2,2484,2332,152,0,40,0,6
18845,1,2446,2318,128,0,473,0,6
18846,1,2239,2412,-173,0,200,0,6
18847,1,2464,2476,-12,0,113,0,6
18848,3,2539,2456,83,0,43,0,8
18849,2,2403,2497,-94,0,40,0,6
18850,2,2523,2310,213,0,251,1,6
18851,2,2469,2616,-147,0,302,0,6
18852,1,2498,2411,87,0,127,1,6
18853,2,2341,2414,-73,0,227,0,8
18854,1,2429,2431,-2,0,1,1,6
18855,1,2663,2673,-10,0,140,0,6
18856,1,2632,2527,105,0,118,0,6
18857,3,2447,2294,153,0,333,0,6
18858,1,2457,2506,-49,0,52,0,6
18859,2,2224,2403,-179,0,130,0,8
18860,1,2352,2426,-74,0,210,0,8
18861,2,2767,2619,148,0,326,1,6
18862,1,2497,2374,123,0,188,0,6
18863,1,2424,2277,147,0,265,0,6
18864,2,2295,2406,-111,4,253,0,13
18865,1,2436,2348,88,0,41,0,6
18866,2,2458,2419,39,0,1,0,6
18867,1,2411,2316,95,0,107,0,6
18868,2,2463,2492,-29,0,241,0,6
18869,1,2417,2359,58,0,200,0,6
18870,2,2465,2563,-98,0,455,0,6
18872,2,2442,2403,39,0,302,0,6
18873,1,2383,2414,-31,0,265,0,6
18874,1,2412,2432,-20,0,11,0,6
18875,1,2419,2281,138,0,101,0,6
18876,2,2275,2548,-273,0,202,1,8
18877,1,2419,2427,-8,0,460,0,6
18878,1,2299,2403,-104,4,457,0,13
18879,1,2352,2437,-85,0,46,1,6
18880,1,2468,2313,155,0,307,0,8
18881,1,2555,2441,114,0,107,0,6
18882,2,2427,2254,173,0,110,1,6
18883,1,2371,2428,-57,0,58,0,6
18884,2,2739,2562,177,0,301,0,6
18885,2,2397,2498,-101,0,107,0,6
18886,2,2539,2532,7,0,131,0,6
18887,1,2439,2271,168,0,335,1,6
18888,1,2443,2277,166,0,263,0,6
18889,2,2473,2471,2,0,140,1,6
18890,1,2503,2355,148,0,106,0,6
18891,1,2482,2452,30,0,100,1,6
18892,2,2271,2455,-184,0,4,1,6
18893,2,2411,2475,-64,0,3,1,6
18894,1,2647,2535,112,0,310,0,6
18895,2,2345,2453,-108,0,62,0,6
18896,1,2437,2278,159,0,474,0,6
18897,2,2402,2393,9,0,302,0,6
18898,1,2446,2415,31,0,190,0,6
18899,1,2531,2348,183,0,146,0,0
18900,1,2497,2613,-116,0,107,0,6
18901,2,2470,2470,0,0,277,0,6
18902,1,2438,2436,2,0,150,0,6
18903,2,2309,2454,-145,0,404,0,6
18904,2,2508,2468,40,0,120,0,6
18905,2,2495,2560,-65,0,110,0,6
18906,2,2312,2450,-138,0,301,0,6
18907,1,2545,2395,150,0,80,0,6
18908,1,2335,2440,-105,0,304,0,6
18909,1,2427,2335,92,0,120,0,6
18910,2,2424,2580,-156,0,101,0,6
18911,2,2415,2370,45,0,306,0,6
18912,1,2404,2324,80,0,0,1,6
18913,3,2415,2285,130,0,45,0,6
18914,2,2424,2500,-76,0,332,0,6
18915,2,2545,2536,9,0,302,0,6
18916,2,2669,2698,-29,0,113,1,6
18917,2,2236,2437,-201,0,150,0,8
18918,1,2274,2424,-150,0,0,0,6
18919,2,2433,2496,-63,0,105,1,6
18920,2,2667,2651,16,0,267,0,6
18921,2,2415,2364,51,0,36,0,6
18922,2,2382,2458,-76,0,106,0,6
18923,1,2445,2321,124,0,1,0,6
18924,1,2523,2334,189,0,331,0,6
18925,2,2410,2265,145,0,177,0,6
18926,3,2327,2451,-124,0,102,0,6
18927,1,2408,2312,96,0,110,0,8
18928,1,2434,2322,112,0,200,0,6
18929,1,2596,2531,65,0,141,1,6
18930,1,2523,2537,-14,0,315,0,6
18931,1,2627,2576,51,0,111,0,6
18932,2,2486,2502,-16,0,7,0,6
18933,1,2407,2444,-37,0,247,1,6
18934,1,2570,2731,-161,0,112,0,6
18935,2,2476,2549,-73,0,426,1,6
18936,2,2254,2441,-187,0,101,1,6
18937,1,2499,2464,35,0,188,1,6
18938,3,2451,2443,8,0,120,0,6
18939,1,2354,2422,-68,0,46,0,6
18940,1,2565,2490,75,0,40,0,6
18941,3,2590,2498,92,0,41,0,6
18942,3,2405,2343,62,0,312,0,8
18943,2,2319,2514,-195,0,311,0,6
18944,1,2444,2355,89,0,247,0,6
18945,2,2437,2559,-122,0,455,0,6
18946,2,2341,2407,-66,0,1,1,6
18947,2,2401,2356,45,0,106,0,6
18949,2,2475,2451,24,0,10,0,6
18950,2,2458,2426,32,0,4,0,6
18951,2,2488,2383,105,0,310,1,6
18952,1,2430,2444,-14,0,311,0,6
18953,2,2414,2385,29,0,40,0,8
18954,3,2392,2526,-134,0,1,0,6
18955,2,2252,2415,-163,0,375,0,6
18956,1,2435,2426,9,0,301,0,6
18957,1,2418,2379,39,0,10,0,6
18958,3,2426,2390,36,0,206,0,6
18959,3,2425,2432,-7,0,398,0,6
18960,2,2421,2273,148,0,255,0,6
18961,1,2406,2345,61,0,405,1,6
18962,1,2458,2268,190,0,269,0,6
18963,1,2464,2505,-41,0,318,1,6
18964,1,2502,2409,93,0,300,0,6
18965,1,2538,2546,-8,0,4,0,6
18966,2,2457,2420,37,0,203,0,6
18967,1,2390,2531,-141,0,4,0,6
18968,2,2259,2446,-187,0,326,0,8
18969,2,2399,2402,-3,0,324,0,6
18970,3,2274,2446,-172,0,112,0,6
18971,1,2486,2569,-83,0,110,0,6
18972,1,2372,2419,-47,0,80,0,6
18973,1,2464,2441,23,0,242,0,6
18974,2,2393,2488,-95,0,125,0,6
18975,2,2438,2436,2,0,150,0,6
18976,1,2475,2428,47,0,142,0,6
18977,1,2400,2244,156,0,80,0,6
18978,1,2605,2467,138,0,13,1,6
18979,1,2446,2366,80,0,0,1,6
18980,2,2407,2539,-132,0,2,0,6
18981,1,2524,2394,130,0,96,0,6
18982,1,2406,2229,177,0,112,0,6
18983,1,2292,2423,-131,0,150,0,6
18984,1,2375,2442,-67,0,245,0,6
18985,1,2571,2542,29,0,300,0,6
18986,2,2533,2671,-138,0,150,0,6
18987,1,2283,2433,-150,0,29,1,6
18988,2,2312,2419,-107,0,302,0,8
18989,2,2632,2501,131,0,415,0,6
18990,2,2583,2474,109,0,45,0,6
18991,1,2451,2434,17,0,61,0,6
18992,2,2459,2571,-112,0,300,0,6
18993,2,2413,2529,-116,0,45,0,6
18994,2,2202,2442,-240,4,140,0,13
18995,2,2451,2370,81,0,107,0,6
18996,1,2657,2660,-3,0,445,0,6
18997,1,2675,2454,221,0,15,0,6
18998,2,2580,2421,159,0,58,0,6
18999,1,2451,2484,-33,0,128,0,6
19001,1,2352,2462,-110,0,455,0,6
19002,2,2307,2448,-141,0,115,1,6
19003,1,2450,2377,73,0,302,0,6
19004,2,2703,2663,40,0,334,0,6
19005,2,2388,2531,-143,0,54,0,6
19006,2,2301,2405,-104,0,466,1,8
19007,2,2285,2453,-168,0,335,0,6
19008,1,2435,2382,53,0,0,1,6
19010,1,2508,2449,59,0,103,0,6
19011,2,2579,2526,53,0,140,0,6
19012,1,2505,2481,24,0,222,1,6
19014,1,2501,2400,101,0,40,1,8
19015,2,2427,2438,-11,0,226,0,6
19016,1,2554,2471,83,0,40,0,6
19017,1,2413,2413,0,0,5,1,6
19018,1,2459,2504,-45,0,490,1,6
19019,1,2407,2314,93,0,112,0,6
19020,1,2517,2316,201,0,251,0,6
19021,1,2470,2528,-58,0,277,0,6
19022,2,2295,2538,-243,0,7,0,8
19023,1,2524,2308,216,0,369,0,8
19024,3,2388,2457,-69,0,107,0,6
19025,1,2492,2433,59,0,241,0,6
19026,1,2402,2247,155,0,13,0,6
19027,2,2523,2601,-78,0,101,0,6
19028,1,2430,2350,80,0,207,1,6
19029,2,2449,2438,11,0,45,0,6
19030,2,2368,2400,-32,0,0,0,6
19031,2,2499,2543,-44,0,123,0,6
19033,2,2431,2343,88,0,250,0,6
19034,1,2425,2336,89,0,398,0,6
19035,1,2403,2480,-77,0,2,0,6
19036,1,2413,2359,54,0,107,1,6
19037,2,2345,2534,-189,0,484,0,0
19038,2,2444,2539,-95,0,46,0,6
19039,1,2471,2576,-105,0,101,0,6
19040,1,2403,2285,118,0,300,0,6
19041,1,2423,2421,2,0,5,0,6
19042,1,2390,2529,-139,0,1,0,6
19043,1,2289,2409,-120,0,102,0,6
19044,1,2472,2476,-4,0,107,0,6
19045,3,2401,2409,-8,0,311,0,6
19046,1,2535,2562,-27,0,269,0,6
19047,2,2423,2412,11,0,4,0,6
19048,1,2482,2493,-11,0,106,0,6
19049,1,2550,2234,316,0,331,1,8
19050,1,2575,2455,120,0,337,1,6
19051,3,2405,2499,-94,0,133,0,6
19052,3,2609,2677,-68,0,37,0,6
19053,1,2452,2464,-12,0,332,1,6
19054,1,2455,2533,-78,0,130,0,6
19055,1,2568,2479,89,0,45,0,6
19056,2,2303,2443,-140,0,100,0,6
19057,3,2537,2625,-88,0,211,0,6
19058,2,2301,2419,-118,0,5,1,6
19059,2,2551,2572,-21,0,7,0,6
19060,2,2398,2451,-53,0,4,0,6
19061,2,2293,2444,-151,0,4,1,6
19062,1,2518,2337,181,0,102,0,6
19063,1,2401,2420,-19,0,427,0,8
19064,2,2425,2407,18,0,324,1,6
19065,3,2568,2544,24,0,0,0,6
19066,2,2395,2429,-34,0,122,1,6
19067,2,2501,2398,103,0,123,0,6
19068,3,2403,2407,-4,4,326,0,13
19069,2,2654,2663,-9,0,3,0,6
19070,2,2332,2417,-85,0,1,0,6
19071,2,2432,2467,-35,0,264,0,6
19072,1,2474,2573,-99,0,101,0,6
19073,1,2456,2477,-21,0,474,1,6
19074,2,2327,2418,-91,0,260,0,6
19075,1,2421,2430,-9,0,122,0,6
19076,2,2427,2282,145,0,243,1,6
19077,1,2400,2412,-12,0,101,0,6
19078,3,2429,2453,-24,0,256,0,6
19079,2,2270,2457,-187,0,5,1,6
19080,2,2455,2411,44,0,6,0,6
19081,2,2494,2548,-54,0,15,1,6
19082,1,2428,2399,29,0,131,0,6
19083,1,2411,2459,-48,0,123,1,6
19084,2,2423,2384,39,0,245,0,6
19085,2,2377,2440,-63,0,245,1,6
19086,2,2409,2374,35,0,80,0,6
19087,2,2290,2444,-154,0,352,1,6
19088,1,2423,2308,115,0,103,0,8
19089,1,2433,2442,-9,0,115,1,6
19090,1,2348,2413,-65,0,221,1,6
19091,1,2498,2465,33,0,253,0,6
19092,2,2428,2497,-69,0,151,0,6
19094,1,2505,2605,-100,0,101,1,6
19095,2,2511,2636,-125,0,151,0,6
19096,2,2425,2362,63,0,162,0,6
19097,3,2244,2406,-162,0,2,0,6
19098,1,2362,2415,-53,0,464,1,6
19099,1,2552,2521,31,0,284,1,6
19100,1,2438,2419,19,0,106,0,6
19101,2,2476,2407,69,0,127,0,6
19102,1,2668,2647,21,0,382,0,6
19103,1,2456,2390,66,0,4,0,6
19104,2,2487,2488,-1,0,120,0,6
19105,2,2406,2362,44,0,380,0,6
19106,2,2459,2512,-53,0,110,1,6
19107,3,2540,2505,35,0,40,0,8
19108,1,2489,2286,203,0,380,0,6
19109,3,2516,2572,-56,0,43,0,6
19110,1,2545,2410,135,0,4,0,6
19111,2,2446,2526,-80,0,30,0,8
19112,3,2533,2577,-44,0,267,0,6
19113,2,2473,2401,72,0,107,0,6
19114,3,2410,2446,-36,0,100,0,6
19115,1,2444,2276,168,0,43,0,6
19116,1,2676,2610,66,0,46,0,6
19117,2,2556,2494,62,0,25,0,6
19118,2,2409,2460,-51,0,43,0,8
19119,2,2493,2417,76,0,120,0,8
19120,2,2253,2425,-172,0,112,0,6
19121,1,2521,2361,160,0,4,0,6
19122,1,2428,2348,80,0,88,0,6
19123,2,2462,2385,77,0,130,0,6
19124,1,2642,2674,-32,0,0,0,6
19125,2,2344,2430,-86,0,8,0,6
19126,1,2301,2415,-114,0,113,0,6
19127,1,2453,2430,23,0,203,1,6
19128,1,2526,2507,19,0,284,0,6
19129,1,2640,2670,-30,0,192,0,6
19130,1,2427,2273,154,0,112,0,6
19131,1,2456,2407,49,0,0,0,6
19132,1,2458,2384,74,0,122,0,6
19133,1,2405,2393,12,0,122,0,6
19134,3,2418,2355,63,0,46,0,6
19135,2,2304,2427,-123,0,302,0,8
19136,1,2297,2434,-137,0,7,0,6
19137,1,2422,2317,105,0,4,0,6
19138,1,2493,2481,12,0,135,0,6
19139,1,2565,2482,83,0,45,0,6
19140,1,2422,2393,29,0,113,1,6
19141,2,2501,2424,77,0,52,0,6
19142,2,2451,2418,33,0,45,0,6
19143,2,2419,2427,-8,0,316,1,6
19144,1,2419,2333,86,0,125,0,6
19145,1,2422,2327,95,0,4,0,6
19146,2,2231,2439,-208,0,47,0,6
19147,1,2408,2391,17,0,40,0,8
19148,2,2409,2373,36,0,71,0,6
19149,2,2579,2499,80,0,16,0,6
19150,2,2447,2429,18,0,120,0,6
19151,2,2446,2471,-25,0,140,1,6
19152,2,2366,2415,-49,0,120,0,6
19153,1,2440,2276,164,0,46,0,6
19154,1,2472,2392,80,0,334,0,6
19155,2,2545,2538,7,0,20,0,6
19156,1,2424,2424,0,0,192,0,6
19157,2,2553,2541,12,0,43,0,6
19158,3,2461,2465,-4,0,123,0,6
19159,2,2460,2503,-43,0,310,0,6
19160,1,2489,2578,-89,0,123,0,6
19161,1,2667,2466,201,0,215,0,6
19162,1,2410,2404,6,4,424,0,13
19163,2,2309,2445,-136,0,485,0,6
19164,1,2424,2458,-34,0,56,0,6
19165,2,2398,2549,-151,0,1,1,6
19166,2,2403,2371,32,0,40,0,6
19167,1,2436,2439,-3,0,16,0,6
19168,2,2333,2441,-108,0,3,1,6
19169,1,2408,2372,36,0,300,0,6
19170,1,2516,2406,110,0,331,1,6
19171,2,2428,2403,25,0,202,0,6
19172,1,2424,2506,-82,0,241,0,6
19173,1,2448,2396,52,0,106,0,6
19174,1,2521,2331,190,0,101,0,6
19175,2,2305,2458,-153,0,100,0,6
19176,2,2470,2284,186,0,6,0,6
19177,2,2361,2478,-117,0,40,0,6
19178,1,2414,2470,-56,0,107,0,6
19179,3,2400,2540,-140,0,101,0,8
19180,2,2516,2476,40,0,83,0,6
19181,2,2409,2369,40,0,25,1,6
19182,1,2598,2605,-7,0,141,0,6
19183,2,2435,2499,-64,0,123,0,6
19184,1,2531,2403,128,0,57,0,6
19185,3,2531,2353,178,0,405,0,8
19186,2,2392,2523,-131,0,123,0,6
19187,1,2396,2528,-132,0,404,0,6
19188,2,2550,2404,146,0,44,0,6
19189,2,2477,2570,-93,0,261,0,6
19190,1,2501,2417,84,0,202,0,6
19191,2,2328,2461,-133,0,100,1,6
19192,2,2298,2430,-132,0,133,0,6
19193,1,2651,2544,107,0,331,1,6
19194,1,2267,2406,-139,0,320,0,6
19195,1,2506,2490,16,0,394,0,6
19196,1,2321,2502,-181,0,331,0,6
19197,1,2451,2402,49,0,453,0,6
19198,2,2215,2432,-217,0,4,0,6
19199,1,2407,2309,98,0,300,0,6
19200,3,2574,2534,40,0,123,0,6
19201,1,2370,2424,-54,0,409,1,6
19202,2,2431,2473,-42,0,453,0,6
19203,1,2329,2411,-82,0,133,0,6
19204,2,2323,2426,-103,0,1,0,6
19205,2,2232,2552,-320,0,202,0,8
19206,2,2422,2261,161,0,302,0,6
19207,1,2326,2444,-118,0,154,0,6
19208,1,2411,2389,22,0,256,0,6
19209,1,2572,2417,155,0,156,0,6
19210,2,2265,2427,-162,0,312,0,6
19211,1,2407,2387,20,0,48,0,6
19212,2,2413,2505,-92,0,255,0,6
19213,2,2435,2350,85,0,130,1,6
19214,1,2409,2412,-3,0,426,0,6
19215,1,2462,2431,31,0,129,0,6
19216,1,2465,2205,260,0,1,0,8
19217,2,2205,2450,-245,0,200,0,8
19218,1,2462,2293,169,0,123,0,6
19219,1,2405,2364,41,0,102,0,6
19220,2,2567,2388,179,0,130,0,6
19221,1,2527,2350,177,0,256,1,6
19222,1,2433,2418,15,0,331,1,6
19223,2,2435,2282,153,0,46,1,6
19224,2,2427,2600,-173,0,30,1,6
19225,1,2547,2647,-100,0,154,1,6
19226,2,2313,2413,-100,0,269,0,6
19227,2,2404,2507,-103,0,469,1,8
19228,1,2388,2443,-55,0,411,1,6
19229,2,2402,2440,-38,0,4,0,8
19230,2,2412,2542,-130,0,415,1,6
19231,1,2482,2681,-199,0,123,0,6
19232,2,2465,2461,4,0,52,0,6
19233,3,2401,2407,-6,0,133,0,8
19234,2,2419,2463,-44,0,200,0,6
19235,1,2476,2440,36,0,249,0,6
19236,1,2446,2425,21,0,6,0,6
19238,1,2414,2383,31,0,40,1,6
19239,1,2509,2372,137,0,260,0,6
19240,1,2391,2432,-41,0,455,0,8
19241,1,2538,2309,229,0,45,0,8
19242,2,2442,2368,74,0,289,0,3
19243,2,2392,2512,-120,0,43,0,6
19244,3,2420,2319,101,0,106,0,6
19245,2,2329,2524,-195,4,202,1,13
19246,1,2604,2552,52,0,112,0,6
19247,1,2367,2400,-33,0,42,0,6
19248,3,2499,2434,65,0,45,0,6
19249,2,2359,2410,-51,0,0,0,6
19250,2,2317,2486,-169,0,7,0,8
19251,2,2309,2433,-124,0,302,1,6
19252,2,2430,2268,162,0,484,0,6
19253,2,2433,2442,-9,0,6,0,6
19254,1,2449,2305,144,0,245,0,6
19255,1,2463,2421,42,0,127,0,6
19256,2,2375,2456,-81,0,4,0,6
19257,1,2520,2595,-75,0,335,1,6
19258,2,2428,2379,49,0,107,0,6
19259,3,2212,2403,-191,0,4,0,6
19260,2,2445,2418,27,0,45,0,6
19261,3,2425,2276,149,0,335,0,6
19262,1,2431,2263,168,0,112,1,6
19263,1,2441,2390,51,0,200,0,6
19264,1,2419,2307,112,0,44,0,6
19265,1,2664,2465,199,0,312,0,6
19267,2,2397,2430,-33,0,151,0,6
19268,1,2388,2468,-80,0,301,0,8
19269,3,2444,2302,142,0,40,0,6
19270,2,2334,2510,-176,0,123,1,8
19271,1,2436,2334,102,0,101,0,6
19272,1,2402,2455,-53,0,3,1,6
19273,1,2378,2493,-115,0,277,0,6
19274,1,2477,2384,93,0,335,0,6
19275,2,2411,2397,14,0,211,0,6
19276,1,2476,2258,218,0,205,0,6
19277,1,2403,2384,19,0,150,0,8
19278,3,2272,2466,-194,0,8,0,6
19279,1,2404,2362,42,0,46,0,6
19280,1,2415,2354,61,0,376,0,6
19281,3,2548,2395,153,0,8,0,6
19282,1,2403,2311,92,0,15,0,6
19283,1,2534,2574,-40,0,261,0,6
19284,1,2408,2355,53,0,395,0,6
19285,1,2417,2377,40,0,267,0,6
19286,2,2516,2359,157,0,190,1,6
19287,1,2349,2430,-81,0,45,0,6
19288,2,2381,2438,-57,0,242,0,6
19289,1,2461,2458,3,0,302,0,6
19290,2,2540,2543,-3,0,211,1,6
19291,2,2405,2413,-8,0,113,1,6
19292,2,2357,2575,-218,0,490,0,6
19293,2,2559,2547,12,0,226,0,6
19294,1,2397,2428,-31,0,242,1,6
19295,2,2512,2341,171,0,207,0,6
19296,1,2422,2369,53,0,245,0,6
19297,2,2423,2530,-107,0,13,0,6
19298,1,2672,2491,181,0,0,0,6
19299,1,2301,2418,-117,0,0,1,6
19300,2,2242,2410,-168,0,459,1,8
19301,2,2603,2639,-36,0,28,0,6
19302,1,2545,2432,113,0,380,0,6
19303,2,2485,2576,-91,0,369,1,6
19304,2,2452,2408,44,0,44,0,6
19305,1,2389,2528,-139,0,105,0,6
19306,1,2290,2414,-124,0,305,0,6
19307,2,2321,2419,-98,0,1,0,6
19308,3,2435,2481,-46,0,140,0,6
19309,3,2349,2419,-70,0,200,0,6
19310,1,2512,2323,189,0,400,0,6
19311,2,2385,2490,-105,0,101,0,8
19312,2,2297,2561,-264,0,123,0,8
19313,1,2423,2356,67,0,4,0,6
19314,2,2203,2435,-232,0,454,0,6
19315,1,2387,2431,-44,4,112,0,13
19316,1,2498,2378,120,0,100,0,6
19317,1,2416,2468,-52,0,246,0,6
19318,2,2404,2422,-18,0,133,1,6
19319,2,2666,2570,96,0,106,0,6
19320,2,2330,2440,-110,0,157,0,6
19321,2,2448,2427,21,0,380,1,6
19322,2,2421,2331,90,0,133,0,6
19323,2,2304,2403,-99,4,201,1,13
19324,2,2462,2527,-65,0,1,0,6
19325,2,2313,2419,-106,0,301,1,6
19326,2,2387,2436,-49,0,106,0,6
19327,1,2511,2206,305,0,48,0,8
19328,2,2334,2416,-82,0,85,1,6
19329,1,2435,2422,13,0,242,0,6
19330,2,2463,2279,184,0,122,1,6
19331,2,2320,2438,-118,0,300,1,8
19332,3,2541,2589,-48,0,101,0,6
19333,2,2392,2516,-124,0,211,0,6
19334,1,2335,2502,-167,0,123,0,6
19335,2,2427,2477,-50,0,123,0,6
19336,1,2451,2467,-16,0,31,0,6
19337,1,2449,2409,40,0,203,0,6
19338,1,2408,2376,32,0,110,1,6
19339,2,2413,2385,28,0,484,0,6
19340,1,2553,2598,-45,0,107,0,6
19341,1,2408,2323,85,0,247,0,8
19342,2,2279,2564,-285,0,440,0,8
19343,1,2644,2501,143,0,101,0,6
19344,2,2423,2317,106,0,106,0,6
19345,2,2404,2303,101,0,123,0,8
19346,2,2379,2513,-134,0,343,0,8
19347,1,2413,2438,-25,0,190,0,6
19348,2,2578,2434,144,0,58,0,6
19349,1,2410,2406,4,0,46,0,6
19350,1,2453,2545,-92,0,113,0,6
19351,1,2350,2443,-93,0,458,1,6
19352,2,2439,2515,-76,0,45,1,6
19353,1,2304,2409,-105,0,125,0,6
19354,3,2376,2432,-56,0,28,0,3
19355,1,2418,2400,18,0,48,0,6
19356,3,2269,2409,-140,4,300,0,13
19357,2,2481,2446,35,0,45,0,6
19358,2,2659,2508,151,0,200,0,6
19359,1,2351,2428,-77,0,43,0,6
19360,1,2400,2298,102,0,311,0,6
19361,2,2307,2434,-127,0,46,1,6
19362,2,2549,2534,15,0,255,0,6
19363,1,2441,2382,59,0,124,0,6
19364,1,2421,2403,18,0,130,0,6
19365,1,2488,2675,-187,0,100,0,6
19366,1,2577,2397,180,0,202,0,6
19367,1,2555,2442,113,0,140,0,6
19368,2,2478,2376,102,0,138,0,6
19369,2,2415,2446,-31,0,331,1,6
19370,2,2272,2408,-136,0,83,0,6
19371,1,2465,2532,-67,0,14,0,6
19372,1,2495,2413,82,0,200,0,8
19373,2,2381,2400,-19,0,37,0,8
19374,3,2457,2468,-11,0,0,0,6
19375,2,2513,2414,99,0,45,0,8
19376,2,2549,2520,29,0,427,0,6
19377,1,2354,2427,-73,0,110,0,6
19378,2,2317,2438,-121,0,485,0,6
19379,1,2418,2419,-1,0,49,0,6
19380,1,2266,2404,-138,0,256,0,6
19381,2,2482,2422,60,0,101,0,6
19382,1,2374,2534,-160,0,300,1,6
19383,2,2480,2436,44,0,300,0,6
19384,3,2462,2423,39,0,127,0,6
19385,2,2400,2406,-6,0,112,0,6
19386,3,2428,2327,101,0,53,0,6
19387,1,2600,2210,390,0,315,0,6
19388,2,2380,2467,-87,0,104,1,6
19389,1,2447,2268,179,0,302,0,6
19390,2,2438,2230,208,0,4,0,6
19391,2,2273,2421,-148,0,302,0,6
19392,3,2494,2343,151,0,110,0,6
19393,1,2298,2460,-162,0,302,0,6
19395,1,2434,2442,-8,0,411,1,6
19396,3,2427,2345,82,0,400,0,6
19397,2,2356,2441,-85,0,441,1,6
19398,2,2324,2416,-92,0,0,0,6
19399,2,2411,2393,18,0,332,1,6
19400,2,2257,2414,-157,0,240,0,6
19401,3,2591,2394,197,0,10,0,6
19402,1,2540,2271,269,0,45,0,8
19403,1,2486,2377,109,0,249,1,6
19404,1,2559,2555,4,0,140,0,6
19405,3,2653,2580,73,0,381,0,6
19406,2,2420,2320,100,0,40,1,6
19407,2,2461,2458,3,0,337,0,6
19408,2,2381,2480,-99,0,317,0,6
19409,2,2588,2648,-60,0,154,1,6
19410,1,2498,2454,44,0,374,1,6
19411,2,2306,2408,-102,0,200,1,8
19412,2,2529,2499,30,0,308,1,8
19413,1,2421,2308,113,0,4,0,6
19414,1,2449,2454,-5,0,300,1,6
19415,2,2426,2458,-32,0,484,1,6
19416,2,2309,2414,-105,0,45,0,6
19417,2,2394,2424,-30,0,455,1,6
19418,1,2478,2404,74,0,40,1,6
19419,1,2462,2213,249,0,1,0,8
19420,1,2647,2655,-8,0,246,0,6
19421,3,2436,2358,78,0,110,0,6
19422,2,2377,2446,-69,0,10,0,6
19423,1,2526,2543,-17,0,15,1,6
19424,3,2442,2420,22,0,35,0,6
19425,2,2354,2470,-116,0,419,0,6
19426,1,2384,2500,-116,0,142,0,6
19427,1,2322,2444,-122,0,301,0,6
19428,2,2485,2464,21,0,125,0,8
19429,1,2667,2497,170,0,0,0,6
19430,1,2438,2559,-121,0,5,0,6
19431,2,2385,2407,-22,4,140,0,13
19432,1,2480,2361,119,0,107,1,6
19433,2,2377,2438,-61,0,199,0,6
19434,3,2610,2525,85,0,335,0,6
19435,1,2318,2472,-154,0,41,1,6
19436,2,2412,2288,124,0,406,0,6
19437,1,2441,2335,106,0,41,0,6
19438,2,2476,2416,60,0,106,1,6
19439,1,2410,2428,-18,0,214,0,8
19440,1,2432,2419,13,0,292,0,6
19441,3,2435,2340,95,0,373,0,6
19442,1,2462,2449,13,0,40,0,6
19443,1,2526,2540,-14,0,256,1,6
19444,2,2438,2519,-81,0,330,1,6
19445,3,2273,2442,-169,0,300,0,8
19446,2,2423,2461,-38,0,110,1,6
19447,1,2443,2474,-31,0,140,1,6
19448,2,2423,2435,-12,0,107,0,6
19449,3,2494,2670,-176,0,100,0,6
19450,1,2407,2331,76,0,315,0,8
19451,2,2468,2296,172,0,106,0,6
19452,1,2439,2282,157,0,242,0,6
19453,1,2417,2279,138,0,303,0,6
19454,1,2371,2410,-39,0,125,0,6
19455,1,2472,2506,-34,0,4,0,6
19456,1,2425,2352,73,0,4,0,6
19457,1,2445,2443,2,0,203,0,6
19458,1,2477,2659,-182,0,153,1,6
19459,1,2379,2427,-48,0,40,0,6
19460,2,2340,2602,-262,0,125,1,6
19461,1,2304,2429,-125,0,108,0,6
19462,3,2425,2326,99,0,150,0,6
19463,2,2583,2536,47,0,115,0,6
19464,1,2423,2390,33,0,335,0,6
19465,1,2362,2506,-144,0,108,0,8
19466,1,2484,2361,123,0,45,0,6
19467,1,2327,2413,-86,0,1,0,6
19468,3,2397,2580,-183,0,1,0,6
19469,1,2223,2527,-304,4,302,0,13
19470,1,2373,2490,-117,0,337,1,6
19471,1,2412,2542,-130,0,101,0,8
19472,1,2474,2351,123,0,133,1,6
19473,3,2431,2377,54,0,289,0,3
19474,1,2346,2491,-145,0,123,1,6
19475,2,2449,2453,-4,0,347,0,6
19476,2,2305,2429,-124,0,302,0,8
19477,1,2390,2420,-30,0,180,1,6
19478,1,2440,2405,35,0,45,1,6
19479,1,2279,2508,-229,0,122,0,6
19480,3,2550,2539,11,0,0,0,6
19481,2,2421,2306,115,0,310,1,6
19482,1,2424,2276,148,0,45,0,6
19483,1,2414,2438,-24,0,204,0,6
19484,2,2492,2359,133,0,338,1,6
19485,1,2435,2392,43,0,122,0,6
19486,1,2248,2418,-170,0,45,0,6
19487,3,2215,2493,-278,0,200,0,6
19488,2,2429,2322,107,0,315,0,6
19489,1,2434,2289,145,0,8,0,6
19490,1,2649,2565,84,0,414,1,6
19491,1,2399,2536,-137,0,3,1,6
19492,2,2416,2450,-34,0,242,1,6
19494,2,2324,2516,-192,0,107,0,6
19495,2,2527,2581,-54,0,485,0,6
19496,1,2428,2330,98,0,41,0,6
19497,3,2278,2414,-136,0,330,0,6
19498,1,2485,2318,167,0,101,1,6
19499,2,2542,2577,-35,0,7,0,6
19500,1,2463,2388,75,0,100,0,6
19501,2,2385,2527,-142,0,245,0,6
19502,1,2668,2496,172,0,0,0,6
19503,2,2404,2358,46,0,33,0,6
19504,1,2538,2533,5,0,101,0,6
19505,2,2443,2484,-41,0,484,0,6
19506,1,2451,2328,123,0,107,0,6
19507,2,2295,2500,-205,4,141,0,13
19508,1,2379,2525,-146,0,14,0,8
19509,3,2430,2444,-14,0,145,0,6
19510,3,2223,2517,-294,0,133,0,8
19511,2,2338,2523,-185,0,302,0,8
19513,1,2240,2401,-161,0,140,0,6
19514,2,2418,2443,-25,0,301,0,6
19515,1,2402,2342,60,0,46,1,6
19516,3,2238,2411,-173,0,1,0,6
19517,1,2422,2275,147,0,100,0,8
19518,1,2446,2222,224,0,11,1,6
19519,1,2466,2418,48,0,127,1,6
19520,1,2317,2428,-111,0,45,1,6
19521,1,2406,2300,106,0,301,1,6
19522,1,2406,2334,72,0,40,0,6
19523,1,2534,2559,-25,0,125,0,6
19524,2,2468,2449,19,0,225,0,6
19525,1,2532,2427,105,0,200,0,6
19526,1,2296,2409,-113,0,13,1,6
19527,1,2440,2291,149,0,200,0,6
19528,1,2387,2422,-35,0,205,1,6
19529,2,2586,2588,-2,0,462,1,6
19530,1,2535,2268,267,0,40,0,8
19531,2,2420,2471,-51,0,147,0,8
19532,1,2444,2347,97,0,43,1,6
19533,3,2319,2478,-159,0,45,0,6
19534,3,2504,2520,-16,0,203,0,6
19535,1,2366,2445,-79,0,45,0,6
19536,2,2303,2416,-113,4,15,0,13
19537,1,2486,2342,144,0,432,0,6
19538,3,2442,2432,10,0,145,0,6
19539,1,2482,2423,59,0,205,0,6
19540,1,2433,2322,111,0,103,0,8
19541,2,2517,2275,242,0,301,1,8
19542,2,2276,2442,-166,0,13,0,6
19543,1,2498,2370,128,0,250,0,8
19544,2,2515,2609,-94,0,405,0,6
19545,1,2421,2445,-24,0,21,0,6
19546,1,2494,2223,271,0,202,1,6
19547,2,2277,2437,-160,0,51,0,6
19548,1,2554,2439,115,0,306,0,8
19549,2,2530,2432,98,0,40,0,6
19550,2,2467,2320,147,4,50,0,13
19551,2,2354,2526,-172,0,3,0,8
19552,2,2468,2430,38,0,244,0,6
19553,1,2443,2489,-46,0,343,0,6
19554,2,2330,2410,-80,0,1,0,6
19555,1,2410,2409,1,0,30,1,6
19556,2,2384,2413,-29,0,300,0,6
19557,2,2426,2306,120,0,331,0,6
19558,1,2531,2382,149,0,401,0,6
19559,1,2519,2359,160,0,8,0,6
19560,1,2414,2347,67,0,1,0,6
19561,3,2305,2468,-163,0,122,0,6
19562,1,2303,2485,-182,0,1,0,6
19563,2,2528,2407,121,0,210,1,6
19564,2,2493,2671,-178,0,123,1,6
19565,1,2412,2280,132,0,110,0,6
19566,1,2456,2367,89,0,46,0,6
19567,1,2533,2537,-4,0,4,0,6
19568,1,2483,2354,129,0,110,1,6
19569,2,2304,2409,-105,0,30,1,6
19570,1,2282,2443,-161,0,2,1,6
19571,1,2455,2462,-7,0,200,0,6
19572,1,2529,2318,211,0,89,0,8
19573,3,2347,2488,-141,0,46,0,6
19574,1,2429,2280,149,0,101,0,6
19575,1,2341,2420,-79,0,57,0,6
19576,3,2378,2430,-52,0,180,0,3
19577,1,2476,2425,51,0,339,0,8
19578,1,2424,2415,9,0,211,0,8
19579,2,2353,2455,-102,0,378,0,6
19580,1,2655,2450,205,0,46,0,6
19581,1,2483,2206,277,0,310,0,6
19582,3,2466,2308,158,0,210,0,6
19583,2,2487,2484,3,0,249,1,6
19584,3,2340,2428,-88,0,45,0,6
19585,3,2613,2582,31,0,335,0,6
19587,2,2320,2412,-92,0,2,0,6
19588,1,2284,2448,-164,0,0,0,6
19589,2,2379,2482,-103,0,244,0,6
19590,1,2522,2590,-68,0,37,0,6
19591,2,2442,2361,81,0,106,0,6
19592,2,2302,2501,-199,0,398,0,8
19593,1,2513,2296,217,0,48,0,8
19594,2,2651,2653,-2,0,130,0,6
19595,2,2415,2326,89,0,40,1,6
19596,2,2240,2400,-160,0,80,0,6
19597,1,2561,2588,-27,0,49,0,6
19598,1,2401,2324,77,0,0,1,6
19599,2,2336,2421,-85,0,109,0,6
19600,2,2404,2355,49,0,202,1,6
19601,1,2516,2401,115,0,46,0,6
19602,1,2432,2420,12,0,331,0,6
19603,2,2413,2471,-58,0,246,0,6
19604,1,2409,2262,147,0,45,1,6
19605,2,2296,2410,-114,0,4,0,6
19606,2,2403,2468,-65,0,311,0,6
19607,1,2433,2440,-7,0,228,0,6
19608,2,2438,2373,65,0,84,0,6
19609,2,2357,2415,-58,0,336,1,6
19610,1,2400,2393,7,0,15,0,6
19611,1,2512,2341,171,0,157,1,6
19612,2,2547,2541,6,0,302,0,6
19613,2,2385,2440,-55,0,138,1,6
19614,2,2515,2367,148,0,302,0,8
19615,1,2419,2272,147,0,240,0,6
19616,2,2308,2445,-137,0,474,0,6
19617,1,2419,2231,188,0,200,0,6
19618,2,2409,2383,26,0,147,0,6
19619,2,2342,2410,-68,0,200,0,8
19620,1,2433,2531,-98,0,218,0,8
19621,2,2478,2378,100,0,108,0,6
19622,2,2441,2445,-4,0,8,0,6
19623,1,2575,2615,-40,0,255,0,6
19624,2,2482,2296,186,4,103,0,13
19625,3,2543,2462,81,0,218,0,6
19627,2,2404,2523,-119,0,53,0,6
19628,3,2415,2271,144,0,454,0,6
19629,2,2345,2433,-88,0,121,0,6
19630,2,2435,2303,132,0,200,1,6
19631,1,2520,2219,301,0,45,0,6
19632,2,2456,2524,-68,0,459,0,6
19633,1,2356,2415,-59,0,458,0,6
19634,3,2310,2463,-153,0,122,0,6
19635,1,2446,2484,-38,0,40,1,6
19636,1,2445,2321,124,0,411,0,6
19637,2,2415,2590,-175,0,2,0,6
19638,1,2435,2332,103,0,311,1,6
19639,2,2460,2350,110,0,40,0,6
19640,1,2490,2481,9,0,247,0,6
19641,1,2362,2459,-97,0,463,1,6
19642,3,2519,2519,0,0,4,0,6
19643,2,2319,2438,-119,0,301,1,8
19644,1,2577,2538,39,0,102,0,6
19645,2,2350,2487,-137,0,107,0,6
19646,1,2582,2555,27,0,101,0,6
19647,2,2486,2532,-46,0,45,0,6
19648,2,2584,2529,55,0,265,0,6
19649,2,2659,2669,-10,0,113,1,6
19650,2,2490,2658,-168,0,269,0,6
19651,2,2425,2322,103,0,210,1,6
19652,1,2320,2418,-98,0,110,1,6
19653,1,2320,2437,-117,0,190,0,6
19654,1,2415,2343,72,0,110,0,8
19655,1,2254,2413,-159,0,53,0,6
19656,2,2399,2503,-104,0,107,0,6
19657,2,2390,2471,-81,0,132,0,6
19658,1,2307,2402,-95,0,8,0,6
19659,2,2536,2612,-76,0,200,0,6
19660,1,2461,2313,148,0,332,0,6
19661,2,2331,2503,-172,0,343,1,6
19662,1,2505,2558,-53,0,206,1,6
19663,2,2449,2414,35,0,20,1,6
19664,1,2476,2409,67,0,127,1,6
19665,1,2406,2382,24,0,0,1,6
19666,2,2477,2486,-9,0,405,0,6
19667,1,2413,2349,64,0,432,0,6
19668,2,2333,2408,-75,0,0,0,6
19669,2,2326,2473,-147,0,103,1,6
19670,2,2582,2567,15,0,456,0,6
19671,1,2413,2299,114,0,45,0,6
19672,2,2414,2437,-23,0,190,0,6
19673,3,2508,2527,-19,0,312,0,6
19674,2,2395,2406,-11,0,113,0,6
19675,1,2440,2452,-12,0,103,0,6
19676,1,2443,2382,61,0,4,0,6
19677,2,2226,2485,-259,0,7,1,6
19678,2,2292,2437,-145,0,311,0,6
19679,2,2538,2294,244,0,380,0,8
19680,2,2546,2542,4,0,200,0,6
19681,2,2266,2401,-135,0,241,0,8
19682,1,2445,2393,52,0,375,0,6
19683,2,2376,2422,-46,0,40,0,6
19684,2,2476,2412,64,0,203,0,6
19685,2,2357,2420,-63,0,200,0,6
19686,1,2496,2515,-19,0,101,0,6
19687,2,2524,2515,9,0,40,0,8
19688,3,2445,2291,154,0,301,0,8
19689,1,2593,2407,186,0,52,0,6
19691,2,2338,2517,-179,0,46,0,6
19692,1,2471,2378,93,0,6,1,6
19693,1,2448,2606,-158,0,302,0,6
19694,2,2310,2423,-113,0,268,1,6
19695,2,2533,2576,-43,0,172,0,6
19696,2,2400,2469,-69,0,331,1,6
19697,1,2519,2419,100,0,4,0,6
19698,3,2636,2573,63,0,301,0,6
19699,2,2441,2428,13,0,242,1,6
19700,3,2274,2413,-139,0,200,0,6
19701,1,2472,2532,-60,0,332,1,6
19702,2,2368,2662,-294,0,46,0,6
19703,2,2293,2429,-136,0,123,0,6
19704,2,2272,2474,-202,4,40,0,13
19705,1,2492,2233,259,0,106,0,8
19706,2,2617,2451,166,0,392,0,6
19707,3,2449,2327,122,0,13,0,6
19708,1,2426,2410,16,0,210,0,6
19709,1,2491,2382,109,0,45,0,6
19710,1,2519,2510,9,0,483,0,6
19711,1,2366,2490,-124,0,150,0,6
19712,2,2417,2215,202,0,45,0,6
19713,1,2423,2319,104,2,133,0,28
19714,1,2337,2509,-172,0,20,0,8
19715,1,2328,2439,-111,0,45,0,6
19716,2,2404,2396,8,0,13,1,6
19717,1,2536,2577,-41,0,15,0,6
19718,1,2452,2529,-77,0,122,0,6
19719,2,2371,2552,-181,0,103,0,6
19720,2,2489,2533,-44,0,45,1,6
19721,2,2380,2432,-52,0,45,1,6
19722,1,2662,2511,151,0,310,1,6
19723,2,2272,2482,-210,0,120,0,8
19724,1,2279,2400,-121,0,130,0,6
19725,2,2343,2417,-74,0,55,1,6
19726,1,2412,2328,84,0,0,0,6
19727,1,2523,2348,175,0,45,1,6
19728,1,2411,2380,31,0,87,0,6
19729,1,2355,2423,-68,0,2,0,8
19730,3,2368,2500,-132,0,13,0,6
19731,2,2362,2439,-77,0,30,0,6
19732,1,2350,2425,-75,0,110,0,6
19733,1,2305,2435,-130,0,17,1,6
19734,2,2275,2410,-135,0,314,0,6
19735,1,2436,2418,18,0,4,0,6
19736,1,2507,2328,179,0,135,0,6
19737,3,2527,2588,-61,0,101,0,6
19739,1,2547,2541,6,0,13,0,6
19740,2,2324,2417,-93,0,1,0,6
19741,1,2443,2409,34,0,292,0,6
19742,1,2558,2337,221,0,45,0,0
19743,1,2330,2461,-131,0,301,1,6
19744,1,2549,2571,-22,0,130,0,6
19745,1,2420,2411,9,0,40,0,6
19746,1,2330,2433,-103,0,0,0,6
19747,1,2464,2287,177,0,241,0,6
19748,2,2411,2481,-70,0,318,0,6
19749,3,2398,2459,-61,0,300,0,6
19750,1,2487,2209,278,0,455,0,6
19751,1,2401,2260,141,0,374,0,6
19752,3,2523,2358,165,0,52,0,6
19753,1,2551,2609,-58,0,335,0,6
19754,1,2200,2412,-212,0,100,1,8
19755,1,2428,2371,57,0,100,0,6
19756,1,2491,2309,182,0,203,0,6
19757,1,2511,2391,120,0,144,1,6
19758,2,2522,2450,72,0,138,1,6
19759,2,2324,2518,-194,0,84,0,8
19760,1,2521,2505,16,0,302,0,8
19761,2,2609,2645,-36,0,335,0,6
19762,1,2405,2263,142,0,1,0,6
19763,1,2460,2446,14,0,128,0,6
19764,2,2370,2468,-98,0,466,0,6
19765,1,2420,2293,127,0,110,0,8
19766,2,2321,2474,-153,0,300,1,6
19767,2,2535,2553,-18,0,300,0,6
19768,1,2442,2315,127,0,25,1,8
19770,2,2341,2441,-100,0,46,0,8
19771,2,2335,2482,-147,0,4,0,6
19772,2,2520,2475,45,0,40,0,6
19773,2,2491,2451,40,0,18,0,6
19774,1,2581,2528,53,0,398,1,6
19775,1,2405,2235,170,0,0,1,6
19776,1,2543,2596,-53,0,394,0,6
19777,1,2426,2438,-12,0,40,1,6
19778,1,2580,2480,100,0,229,0,6
19779,2,2415,2523,-108,0,2,0,6
19780,2,2306,2494,-188,0,122,0,6
19781,1,2496,2496,0,0,113,0,6
19782,1,2525,2479,46,0,463,0,6
19783,1,2374,2446,-72,0,255,0,6
19784,1,2411,2276,135,0,305,0,6
19785,1,2422,2368,54,0,404,0,6
19786,2,2325,2510,-185,0,124,0,6
19787,2,2428,2426,2,0,109,0,6
19788,1,2435,2257,178,0,280,1,6
19789,2,2434,2278,156,0,205,0,6
19790,2,2433,2332,101,0,190,0,6
19791,1,2383,2525,-142,0,128,0,6
19792,2,2440,2295,145,0,453,1,6
19793,1,2560,2338,222,0,43,1,6
19794,2,2416,2229,187,0,110,0,8
19795,1,2565,2556,9,0,101,0,6
19796,2,2602,2558,44,0,301,0,6
19797,1,2538,2400,138,0,0,1,6
19798,1,2358,2426,-68,0,13,1,6
19799,1,2507,2444,63,0,45,0,6
19800,2,2404,2448,-44,0,190,1,6
19801,1,2436,2375,61,0,84,1,6
19802,1,2665,2575,90,0,335,0,6
19803,3,2485,2362,123,0,1,0,8
19804,1,2359,2460,-101,0,225,0,6
19805,1,2414,2272,142,0,202,1,6
19806,2,2598,2451,147,0,31,0,6
19807,2,2207,2491,-284,0,117,1,6
19808,2,2261,2432,-171,0,122,0,6
19809,1,2445,2390,55,0,103,0,8
19810,2,2418,2494,-76,0,271,0,6
19811,1,2528,2604,-76,0,206,0,6
19812,2,2363,2426,-63,0,104,0,6
19813,2,2223,2489,-266,0,331,0,6
19814,3,2427,2393,34,0,59,0,6
19815,2,2353,2473,-120,0,45,0,6
19816,2,2362,2447,-85,0,105,0,6
19817,1,2528,2366,162,0,110,0,6
19818,2,2464,2472,-8,0,150,0,6
19819,1,2587,2513,74,0,132,0,6
19820,1,2485,2382,103,0,112,1,6
19821,2,2484,2573,-89,0,352,0,6
19822,1,2485,2405,80,0,58,0,6
19823,1,2352,2439,-87,0,211,0,6
19824,2,2272,2415,-143,0,17,0,6
19825,1,2338,2400,-62,0,13,1,6
19826,3,2312,2471,-159,0,1,0,6
19827,2,2457,2415,42,0,45,1,6
19828,2,2458,2316,142,0,122,0,6
19829,1,2390,2424,-34,0,211,0,6
19830,1,2456,2387,69,0,456,1,6
19831,1,2520,2505,15,0,48,0,6
19832,1,2679,2530,149,0,270,1,6
19833,2,2597,2535,62,0,433,1,6
19834,1,2476,2329,147,0,441,0,6
19835,2,2515,2358,157,0,154,0,6
19836,1,2465,2409,56,0,107,0,6
19837,2,2323,2475,-152,4,129,0,13
19838,1,2410,2425,-15,0,46,0,6
19839,2,2404,2584,-180,0,133,0,6
19840,2,2477,2371,106,0,132,0,6
19841,1,2440,2589,-149,0,121,1,6
19842,1,2453,2338,115,0,100,0,6
19843,3,2495,2393,102,0,303,0,6
19844,1,2521,2208,313,0,453,0,8
19845,1,2513,2322,191,0,8,0,6
19846,1,2409,2267,142,0,0,1,6
19847,2,2236,2527,-291,0,264,0,6
19848,1,2535,2467,68,0,331,0,6
19849,1,2515,2407,108,0,345,1,6
19850,1,2362,2531,-169,0,53,1,6
19851,2,2432,2514,-82,0,301,1,6
19852,2,2411,2527,-116,0,2,0,6
19853,3,2508,2351,157,0,426,0,6
19854,2,2499,2440,59,0,300,0,6
19855,1,2418,2269,149,0,115,0,6
19856,1,2495,2423,72,0,234,0,6
19857,2,2381,2403,-22,0,130,0,6
19858,1,2491,2506,-15,0,337,0,6
19859,2,2238,2527,-289,0,122,1,8
19860,1,2500,2408,92,0,230,1,8
19861,1,2418,2357,61,0,205,0,6
19862,2,2302,2442,-140,4,310,0,13
19863,1,2438,2318,120,0,156,0,6
19864,1,2477,2204,273,0,302,0,6
19865,1,2586,2461,125,0,106,0,6
19866,2,2306,2456,-150,0,211,0,6
19867,1,2477,2416,61,0,110,0,6
19868,2,2431,2330,101,0,8,0,6
19869,1,2542,2523,19,0,13,0,6
19870,1,2427,2381,46,0,4,0,6
19871,2,2563,2439,124,0,40,0,8
19872,2,2517,2490,27,0,200,0,6
19873,2,2432,2401,31,0,203,0,6
19874,1,2303,2445,-142,0,41,0,6
19875,2,2324,2414,-90,0,123,0,8
19876,1,2590,2230,360,0,331,1,6
19877,2,2418,2442,-24,0,344,0,6
19878,1,2480,2506,-26,4,101,0,13
19879,1,2336,2409,-73,0,129,0,6
19880,1,2419,2365,54,0,50,0,6
19881,3,2425,2560,-135,0,250,0,6
19882,2,2436,2334,102,0,143,0,6
19883,1,2470,2396,74,0,263,0,6
19884,1,2344,2451,-107,0,255,1,6
19885,1,2405,2252,153,0,101,0,8
19886,3,2262,2426,-164,0,121,0,6
19887,2,2301,2483,-182,0,146,0,8
19888,2,2422,2401,21,0,210,0,6
19889,3,2443,2380,63,0,110,0,6
19890,1,2446,2470,-24,0,140,1,6
19891,1,2669,2391,278,0,61,1,6
19892,1,2526,2378,148,0,48,0,6
19893,2,2571,2588,-17,0,120,0,6
19894,1,2480,2358,122,0,128,0,6
19895,2,2539,2490,49,0,315,0,6
19896,1,2461,2494,-33,0,46,0,6
19897,2,2371,2441,-70,0,45,1,6
19898,1,2259,2407,-148,0,324,0,6
19899,2,2311,2446,-135,0,40,1,8
19900,1,2432,2404,28,0,487,0,6
19901,1,2458,2463,-5,0,331,0,6
19902,1,2415,2364,51,0,150,0,8
19903,1,2467,2451,16,0,107,1,6
19904,1,2453,2399,54,0,292,0,6
19905,2,2319,2516,-197,0,343,1,6
19906,1,2531,2507,24,0,5,0,6
19907,2,2432,2412,20,0,13,1,6
19908,2,2303,2401,-98,0,122,0,6
19909,3,2324,2450,-126,0,210,0,8
19910,1,2367,2422,-55,0,218,0,6
19911,1,2647,2407,240,0,40,0,6
19912,1,2401,2233,168,0,245,1,6
19913,1,2650,2653,-3,0,244,0,6
19914,1,2619,2447,172,0,300,1,6
19915,2,2439,2408,31,0,388,0,6
19916,1,2581,2526,55,0,331,0,6
19917,2,2370,2431,-61,0,22,0,8
19918,2,2412,2511,-99,0,455,0,6
19919,2,2375,2403,-28,0,345,1,6
19920,1,2518,2590,-72,0,201,1,6
19921,3,2365,2489,-124,0,49,0,6
19922,2,2398,2523,-125,0,200,0,6
19923,1,2446,2492,-46,0,394,0,6
19924,3,2419,2548,-129,0,46,0,6
19925,2,2529,2481,48,0,45,1,6
19926,1,2523,2299,224,0,409,0,8
19927,1,2404,2374,30,0,4,0,6
19928,2,2360,2424,-64,0,13,0,6
19929,2,2342,2428,-86,0,320,0,6
19930,2,2518,2519,-1,0,45,0,6
19931,2,2574,2583,-9,0,10,1,6
19932,2,2240,2416,-176,0,246,0,6
19933,1,2375,2529,-154,0,15,0,6
19934,2,2497,2511,-14,0,332,1,6
19935,2,2296,2424,-128,0,130,1,6
19936,1,2467,2586,-119,0,45,1,6
19937,3,2486,2504,-18,0,308,0,8
19938,3,2404,2496,-92,0,103,0,8
19939,1,2200,2424,-224,0,107,0,6
19940,2,2371,2442,-71,0,466,0,6
19941,2,2289,2444,-155,0,142,0,6
19942,1,2522,2683,-161,0,227,0,6
19943,1,2382,2533,-151,0,112,0,6
19944,1,2482,2496,-14,0,311,0,6
19945,2,2405,2651,-246,0,3,0,6
19946,1,2406,2299,107,0,13,0,6
19947,2,2344,2418,-74,0,40,1,6
19948,1,2481,2392,89,0,250,1,6
19949,1,2570,2475,95,0,330,0,6
19950,1,2317,2477,-160,4,130,0,13
19951,1,2515,2399,116,0,295,0,6
19952,2,2446,2366,80,0,200,0,6
19953,2,2394,2458,-64,0,140,0,6
19954,1,2334,2423,-89,0,313,1,6
19955,1,2392,2416,-24,0,456,0,6
19956,1,2352,2423,-71,0,110,0,6
19957,1,2541,2392,149,0,46,1,6
19958,2,2429,2355,74,0,40,0,6
19959,3,2502,2537,-35,0,241,0,6
19960,2,2393,2415,-22,0,200,0,6
19961,1,2452,2464,-12,0,374,0,6
19962,2,2447,2257,190,0,301,0,8
19963,1,2577,2524,53,0,41,1,6
19964,1,2655,2402,253,0,331,0,6
19965,1,2518,2316,202,0,373,0,6
19966,1,2419,2264,155,0,406,1,8
19967,1,2459,2315,144,0,106,0,6
19968,2,2432,2329,103,0,211,0,6
19969,1,2431,2267,164,0,0,0,6
19970,2,2530,2622,-92,0,414,0,6
19971,1,2470,2366,104,0,255,0,6
19972,1,2444,2521,-77,0,190,0,6
19973,1,2335,2444,-109,0,53,0,6
19974,1,2354,2404,-50,0,150,1,6
19975,2,2464,2656,-192,0,190,0,6
19976,2,2389,2575,-186,0,213,0,6
19977,2,2260,2405,-145,0,200,1,6
19978,2,2588,2525,63,0,27,0,6
19979,2,2426,2450,-24,0,4,0,6
19980,2,2380,2555,-175,0,202,0,8
19981,2,2299,2504,-205,0,0,0,8
19982,2,2486,2453,33,0,300,0,6
19983,2,2427,2373,54,0,485,1,6
19984,1,2414,2247,167,0,45,1,6
19985,2,2379,2513,-134,0,123,0,6
19986,1,2390,2447,-57,0,206,1,6
19987,2,2327,2400,-73,0,106,1,6
19988,3,2421,2261,160,0,100,0,8
19989,2,2519,2525,-6,0,190,0,6
19990,1,2395,2438,-43,0,50,1,6
19991,2,2490,2659,-169,0,115,0,6
19992,2,2421,2421,0,0,138,0,6
19993,2,2446,2484,-38,0,300,1,6
19994,3,2400,2455,-55,0,2,0,6
19995,2,2492,2525,-33,0,440,0,6
19996,1,2450,2408,42,0,21,0,8
19997,2,2517,2397,120,0,121,1,6
19998,3,2354,2473,-119,0,405,0,6
19999,1,2549,2579,-30,0,151,0,6
20001,1,2408,2224,184,0,241,0,8
20002,1,2487,2303,184,0,34,0,6
20003,2,2423,2475,-52,0,0,1,6
20004,2,2353,2404,-51,0,46,0,6
20005,3,2536,2433,103,0,0,0,6
20006,1,2410,2264,146,0,13,0,6
20007,2,2433,2282,151,0,343,0,6
20008,1,2495,2310,185,0,243,0,6
20009,2,2626,2485,141,0,300,0,6
20010,1,2362,2422,-60,0,331,1,6
20011,1,2418,2329,89,0,300,0,6
20012,1,2438,2290,148,0,46,0,6
20013,1,2411,2388,23,0,263,0,6
20014,2,2502,2526,-24,0,203,0,6
20015,1,2410,2463,-53,0,150,0,6
20016,1,2340,2475,-135,0,304,0,6
20017,1,2414,2379,35,0,46,0,6
20018,1,2431,2200,231,0,123,0,8
20019,2,2455,2487,-32,0,245,1,6
20020,2,2519,2582,-63,0,245,1,6
20021,2,2313,2521,-208,0,310,1,6
20022,2,2458,2461,-3,0,253,0,6
20023,3,2362,2490,-128,0,310,0,6
20024,1,2506,2436,70,0,301,0,8
20025,2,2401,2458,-57,0,3,0,6
20026,1,2469,2488,-19,4,129,1,13
20027,2,2451,2374,77,0,278,1,6
20028,3,2414,2336,78,0,40,0,6
20029,2,2388,2514,-126,0,280,0,6
20030,2,2425,2250,175,0,300,0,6
20031,3,2665,2582,83,0,21,0,6
20032,3,2401,2278,123,0,337,0,6
20033,1,2523,2488,35,0,45,1,6
20034,1,2373,2439,-66,0,45,0,6
20035,1,2467,2387,80,0,248,1,6
20036,1,2531,2497,34,0,382,0,6
20037,2,2401,2373,28,0,11,1,6
20038,2,2532,2530,2,0,112,0,6
20039,1,2400,2230,170,0,404,0,8
20040,1,2459,2480,-21,0,40,0,6
20041,3,2414,2487,-73,0,202,0,6
20042,2,2427,2478,-51,0,4,0,6
20043,1,2287,2421,-134,0,145,0,6
20044,2,2516,2376,140,0,40,1,6
20045,1,2525,2480,45,0,249,0,6
20046,2,2517,2659,-142,0,190,0,6
20047,1,2572,2383,189,0,394,1,6
20048,1,2349,2416,-67,0,58,0,6
20049,1,2653,2509,144,0,101,0,6
20050,2,2405,2272,133,0,135,1,6
20051,2,2378,2530,-152,0,132,0,8
20052,2,2359,2413,-54,0,131,1,6
20053,2,2509,2551,-42,0,122,1,6
20054,1,2235,2420,-185,0,46,1,6
20055,1,2408,2588,-180,0,4,1,6
20056,1,2583,2441,142,0,28,0,6
20057,1,2450,2296,154,4,48,1,13
20058,1,2418,2324,94,0,0,1,6
20059,1,2382,2422,-40,0,138,0,6
20060,1,2436,2303,133,0,37,0,6
20061,2,2526,2419,107,0,337,0,8
20062,1,2485,2480,5,0,6,1,6
20063,3,2302,2456,-154,0,122,0,6
20064,2,2401,2354,47,0,310,1,6
20065,2,2495,2487,8,0,144,1,8
20066,2,2422,2558,-136,0,40,0,8
20067,2,2663,2542,121,0,42,1,6
20068,2,2536,2413,123,0,310,0,6
20069,1,2380,2433,-53,0,187,1,6
20070,3,2262,2447,-185,0,337,0,8
20071,2,2463,2396,67,0,95,0,6
20072,2,2409,2395,14,0,43,0,6
20073,1,2441,2272,169,0,176,0,6
20074,2,2415,2369,46,0,50,0,6
20075,2,2400,2530,-130,0,0,1,6
20076,2,2215,2505,-290,0,101,0,8
20077,2,2493,2618,-125,0,200,1,6
20078,1,2471,2356,115,0,332,0,6
20079,1,2492,2364,128,0,271,0,6
20080,1,2483,2479,4,0,40,0,6
20081,3,2453,2534,-81,0,201,0,6
20082,2,2402,2444,-42,0,131,0,8
20083,3,2370,2402,-32,0,110,0,6
20084,1,2474,2465,9,0,302,0,6
20085,1,2536,2449,87,0,55,0,6
20086,2,2422,2444,-22,0,9,0,6
20087,2,2274,2417,-143,0,35,0,6
20088,1,2327,2471,-144,0,288,1,6
20089,2,2475,2537,-62,0,120,0,6
20090,2,2459,2492,-33,0,387,0,6
20091,3,2470,2382,88,0,250,0,6
20092,1,2533,2288,245,0,40,0,8
20093,2,2384,2508,-124,0,123,0,6
20094,3,2458,2367,91,0,0,0,6
20095,1,2573,2415,158,0,15,0,6
20096,1,2441,2413,28,0,45,0,6
20098,2,2376,2444,-68,0,139,0,6
20099,2,2255,2419,-164,0,197,0,8
20100,2,2303,2403,-100,0,490,1,8
20101,2,2540,2379,161,0,7,0,6
20102,2,2338,2513,-175,0,320,0,6
20103,2,2361,2496,-135,0,302,0,6
20104,2,2418,2340,78,0,224,0,6
20105,1,2474,2491,-17,0,100,0,6
20106,2,2580,2528,52,0,40,0,6
20107,2,2457,2407,50,0,300,0,6
20108,1,2287,2511,-224,0,200,0,8
20109,1,2401,2403,-2,0,320,0,6
20110,1,2409,2356,53,0,207,0,6
20111,2,2236,2485,-249,0,56,1,6
20112,2,2418,2489,-71,0,303,0,6
20113,3,2426,2315,111,0,133,0,8
20114,3,2507,2519,-12,0,200,0,8
20115,1,2533,2408,125,0,311,0,6
20116,1,2438,2346,92,0,337,1,6
20117,1,2403,2454,-51,0,3,1,6
20118,1,2459,2459,0,0,300,0,6
20119,1,2402,2371,31,0,100,0,6
20120,1,2360,2420,-60,0,322,0,6
20121,1,2593,2550,43,0,42,0,6
20122,1,2444,2450,-6,0,121,0,6
20123,2,2411,2248,163,0,200,0,8
20124,2,2305,2536,-231,0,130,0,8
20125,1,2409,2334,75,0,466,0,6
20126,1,2416,2355,61,0,211,1,6
20128,1,2575,2417,158,0,406,0,6
20129,2,2473,2488,-15,0,40,1,6
20130,2,2512,2380,132,0,300,0,6
20131,2,2479,2655,-176,0,40,1,6
20132,1,2516,2454,62,0,155,0,6
20133,3,2427,2480,-53,0,145,0,6
20134,1,2656,2526,130,0,145,0,6
20135,2,2576,2470,106,0,15,0,6
20136,1,2449,2276,173,0,100,1,8
20137,1,2492,2446,46,0,107,1,6
20138,1,2400,2357,43,0,46,0,6
20139,2,2347,2523,-176,0,35,0,6
20140,1,2453,2463,-10,0,337,1,6
20141,1,2503,2497,6,0,128,0,6
20143,2,2260,2489,-229,0,103,0,8
20144,3,2384,2469,-85,0,246,0,6
20145,1,2444,2265,179,0,40,1,8
20146,1,2479,2428,51,0,45,0,6
20147,2,2387,2417,-30,0,113,1,6
20148,1,2509,2471,38,0,213,0,6
20149,2,2318,2403,-85,0,300,0,6
20150,3,2422,2243,179,0,455,0,8
20151,2,2535,2532,3,0,335,0,6
20152,3,2368,2457,-89,0,81,0,6
20153,2,2403,2398,5,0,14,0,6
20154,1,2504,2388,116,0,121,0,6
20155,2,2562,2334,228,0,45,0,0
20156,2,2329,2413,-84,0,337,1,6
20157,3,2343,2432,-89,0,454,0,6
20158,2,2413,2407,6,0,4,0,6
20159,1,2541,2507,34,0,483,1,6
20160,1,2414,2384,30,0,458,1,6
20161,2,2396,2487,-91,0,35,0,6
20162,2,2410,2407,3,0,44,0,6
20163,1,2550,2569,-19,0,132,0,6
20164,2,2442,2272,170,0,337,1,6
20165,1,2578,2537,41,0,409,0,6
20166,1,2411,2218,193,0,112,0,8
20167,2,2444,2505,-61,0,101,1,6
20168,1,2418,2318,100,0,311,0,6
20169,1,2415,2379,36,0,258,1,6
20170,1,2545,2522,23,0,398,0,6
20171,2,2466,2598,-132,0,380,0,6
20172,2,2527,2353,174,0,107,0,6
20173,1,2448,2410,38,0,210,1,6
20174,2,2388,2504,-116,0,1,0,6
20175,1,2449,2304,145,0,474,0,6
20176,2,2352,2475,-123,0,122,0,6
20177,1,2292,2425,-133,0,0,0,8
20178,1,2383,2414,-31,0,37,0,6
20179,2,2494,2468,26,0,483,0,6
20180,1,2559,2477,82,0,15,0,6
20181,2,2291,2458,-167,4,106,0,13
20182,1,2492,2509,-17,0,154,1,6
20183,3,2492,2502,-10,0,207,0,8
20184,2,2531,2476,55,0,15,0,6
20185,1,2333,2407,-74,0,45,1,6
20186,2,2620,2556,64,0,47,0,6
20187,1,2314,2534,-220,0,41,0,6
20188,1,2337,2419,-82,0,190,0,8
20189,1,2432,2490,-58,0,107,0,8
20190,1,2492,2380,112,0,191,1,6
20191,1,2468,2385,83,0,250,0,6
20192,1,2458,2346,112,0,192,0,6
20193,2,2423,2484,-61,0,305,0,6
20194,2,2355,2508,-153,0,302,0,6
20195,1,2302,2407,-105,0,455,0,8
20196,2,2538,2529,9,0,8,1,6
20197,1,2403,2363,40,0,240,0,8
20198,2,2553,2459,94,0,331,0,6
20199,2,2345,2414,-69,0,45,0,6
20200,2,2563,2565,-2,0,140,1,6
20201,2,2351,2414,-63,0,1,0,6
20202,1,2413,2480,-67,0,415,0,6
20203,1,2236,2530,-294,0,224,0,6
20204,1,2404,2261,143,0,45,0,6
20205,1,2479,2348,131,0,263,0,6
20206,1,2320,2460,-140,0,255,0,6
20207,1,2455,2370,85,0,250,0,6
20208,1,2413,2408,5,0,42,0,6
20209,1,2403,2382,21,0,466,0,6
20210,2,2263,2434,-171,0,415,0,6
20212,1,2507,2300,207,0,110,1,8
20213,1,2400,2418,-18,0,337,0,6
20214,1,2407,2442,-35,0,190,0,6
20215,2,2489,2546,-57,0,45,0,6
20216,1,2368,2521,-153,0,320,0,6
20217,1,2532,2439,93,0,113,0,6
20218,2,2491,2346,145,0,302,1,6
20219,3,2424,2322,102,0,110,0,8
20220,2,2462,2325,137,0,152,0,6
20221,2,2317,2407,-90,0,122,1,6
20222,1,2550,2510,40,0,307,0,6
20223,1,2429,2280,149,0,15,0,6
20224,1,2374,2450,-76,0,335,0,6
20225,1,2524,2441,83,0,107,1,6
20226,1,2539,2315,224,0,48,0,8
20227,2,2459,2414,45,0,241,0,6
20228,1,2462,2462,0,0,485,0,6
20229,2,2345,2483,-138,0,15,0,6
20230,2,2242,2412,-170,0,13,0,8
20231,1,2517,2563,-46,0,201,0,6
20232,3,2467,2405,62,0,40,0,6
20233,2,2518,2546,-28,0,7,0,6
20234,2,2420,2453,-33,0,140,0,6
20235,1,2485,2371,114,0,4,1,6
20236,2,2457,2326,131,0,437,0,6
20237,1,2512,2551,-39,0,200,0,6
20238,2,2422,2483,-61,0,15,1,6
20239,2,2408,2488,-80,0,106,1,6
20240,2,2452,2455,-3,0,153,0,8
20241,1,2408,2524,-116,0,45,0,6
20242,1,2475,2295,180,0,106,1,6
20243,2,2286,2468,-182,0,301,0,6
20244,2,2483,2261,222,0,40,0,8
20245,2,2371,2441,-70,0,46,0,8
20246,2,2420,2513,-93,0,335,0,6
20247,2,2498,2428,70,0,150,1,6
20248,1,2400,2279,121,0,109,0,6
20249,1,2340,2419,-79,0,45,0,6
20250,1,2474,2386,88,0,150,1,6
20251,2,2381,2472,-91,0,246,1,6
20252,1,2453,2383,70,0,394,0,6
20253,2,2333,2437,-104,0,13,0,6
20254,2,2454,2419,35,0,112,0,6
20255,2,2294,2541,-247,0,110,0,8
20256,3,2365,2460,-95,0,404,0,6
20257,1,2392,2449,-57,0,200,1,6
20258,1,2535,2532,3,0,301,0,6
20259,1,2496,2404,92,0,191,0,6
20260,2,2257,2435,-178,0,310,0,6
20261,2,2392,2536,-144,0,203,1,6
20262,2,2374,2409,-35,0,302,0,6
20263,2,2374,2421,-47,0,144,0,6
20264,1,2503,2423,80,0,210,0,8
20265,2,2443,2518,-75,0,332,1,6
20266,2,2415,2409,6,0,0,0,6
20267,1,2572,2557,15,0,100,0,6
20268,2,2556,2514,42,0,56,0,6
20269,1,2319,2424,-105,0,15,1,6
20270,1,2335,2404,-69,0,106,0,6
20271,2,2457,2419,38,0,202,0,6
20272,1,2521,2244,277,0,300,0,6
20273,1,2553,2379,174,0,45,1,8
20274,1,2366,2433,-67,0,176,0,6
20275,2,2366,2482,-116,0,128,0,8
20276,1,2406,2466,-60,0,3,1,6
20277,3,2458,2415,43,0,200,0,6
20278,1,2412,2406,6,0,351,0,6
20279,1,2224,2404,-180,0,121,0,6
20280,2,2400,2309,91,0,41,0,8
20281,1,2484,2453,31,0,455,1,6
20282,2,2425,2375,50,0,268,1,6
20283,2,2203,2408,-205,0,211,0,8
20284,2,2311,2447,-136,0,284,1,6
20285,1,2438,2278,160,0,176,0,6
20286,2,2524,2662,-138,0,245,0,6
20287,1,2418,2471,-53,0,250,0,6
20288,2,2419,2382,37,0,204,0,6
20289,3,2486,2341,145,0,293,0,6
20290,2,2473,2514,-41,0,255,0,6
20292,2,2450,2347,103,0,310,1,6
20293,1,2415,2410,5,0,102,0,6
20294,2,2296,2404,-108,0,40,0,6
20295,1,2412,2238,174,0,13,1,6
20296,1,2505,2517,-12,0,190,0,6
20297,1,2218,2416,-198,0,45,0,8
20298,1,2434,2329,105,0,463,0,6
20299,2,2337,2455,-118,0,379,0,6
20300,1,2476,2376,100,0,106,1,6
20301,2,2401,2390,11,0,107,1,6
20302,1,2488,2425,63,0,300,0,6
20303,2,2415,2368,47,0,6,0,6
20304,1,2511,2365,146,0,120,0,8
20305,3,2513,2528,-15,0,255,0,6
20306,1,2526,2541,-15,0,374,0,6
20307,2,2491,2417,74,0,115,0,6
20308,2,2552,2578,-26,0,0,0,6
20309,1,2382,2478,-96,0,264,0,6
20310,2,2468,2383,85,0,41,1,8
20311,2,2269,2415,-146,0,302,0,6
20312,2,2333,2499,-166,0,40,1,6
20313,1,2458,2367,91,0,14,1,6
20314,1,2660,2557,103,0,341,1,6
20315,2,2254,2442,-188,0,21,0,6
20316,1,2400,2500,-100,0,8,0,6
20317,2,2416,2425,-9,0,335,0,6
20318,1,2519,2489,30,0,242,1,6
20319,1,2468,2539,-71,0,219,0,6
20320,2,2328,2523,-195,0,257,0,6
20322,1,2401,2417,-16,0,337,0,6
20323,1,2415,2329,86,0,46,0,8
20324,1,2388,2441,-53,0,224,0,6
20325,1,2416,2457,-41,0,100,1,6
20326,1,2571,2549,22,0,112,0,6
20327,1,2357,2441,-84,0,343,0,6
20328,2,2486,2267,219,0,130,0,8
20329,3,2476,2322,154,0,338,0,8
20330,1,2674,2459,215,0,4,0,6
20331,1,2342,2440,-98,0,11,0,8
20332,2,2442,2373,69,0,70,0,6
20333,2,2451,2413,38,0,210,0,6
20334,1,2418,2241,177,0,110,0,8
20335,2,2447,2489,-42,0,145,0,6
20336,1,2668,2520,148,0,130,0,6
20337,2,2437,2457,-20,0,45,1,6
20338,2,2407,2508,-101,0,211,0,8
20339,2,2277,2408,-131,0,96,0,6
20340,1,2530,2445,85,0,335,0,6
20341,1,2416,2307,109,0,107,1,6
20342,2,2337,2419,-82,0,21,1,6
20343,2,2387,2418,-31,0,118,0,6
20344,1,2410,2237,173,0,242,0,6
20345,2,2319,2514,-195,0,308,0,8
20346,1,2439,2541,-102,0,224,1,6
20347,1,2511,2419,92,0,200,0,6
20348,1,2354,2442,-88,0,40,1,6
20349,1,2430,2460,-30,0,226,1,6
20350,2,2461,2511,-50,0,302,1,6
20351,1,2375,2408,-33,0,4,0,6
20352,1,2493,2502,-9,0,106,0,6
20353,1,2521,2544,-23,0,40,0,6
20354,2,2337,2419,-82,0,225,0,6
20355,2,2235,2415,-180,0,33,1,6
20356,2,2434,2441,-7,0,278,1,6
20358,1,2451,2412,39,0,45,0,6
20359,2,2431,2484,-53,0,128,1,6
20360,2,2484,2464,20,0,106,0,6
20362,1,2471,2389,82,0,130,0,6
20363,1,2430,2434,-4,0,241,0,6
20364,1,2321,2460,-139,0,145,0,6
20365,2,2552,2664,-112,0,267,1,6
20366,1,2400,2342,58,0,250,0,6
20367,1,2533,2445,88,0,41,1,6
20368,1,2584,2546,38,0,100,1,6
20369,2,2363,2463,-100,0,404,0,6
20370,1,2502,2339,163,0,348,0,6
20371,2,2477,2474,3,0,144,0,8
20372,3,2341,2403,-62,0,332,0,6
20373,1,2412,2326,86,0,309,0,6
20374,3,2451,2422,29,0,200,0,6
20375,2,2412,2407,5,0,0,1,6
20376,1,2556,2344,212,0,45,0,0
20377,1,2495,2442,53,0,45,1,6
20378,2,2312,2495,-183,0,128,1,6
20379,3,2299,2413,-114,0,15,0,8
20380,1,2512,2275,237,0,40,1,8
20381,3,2343,2484,-141,0,426,0,6
20382,2,2379,2429,-50,0,278,0,6
20383,2,2363,2490,-127,0,4,0,6
20384,1,2421,2255,166,0,43,0,6
20385,1,2423,2339,84,0,45,0,6
20386,2,2424,2382,42,0,250,0,6
20387,2,2268,2517,-249,0,101,1,8
20388,3,2462,2513,-51,0,302,0,6
20389,2,2309,2420,-111,0,304,0,8
20390,1,2434,2515,-81,0,45,0,6
20391,2,2309,2421,-112,0,353,0,8
20392,1,2490,2333,157,0,107,0,6
20393,1,2424,2331,93,0,36,1,6
20394,1,2538,2535,3,0,40,0,6
20395,2,2404,2457,-53,0,300,0,6
20396,2,2437,2343,94,0,125,1,6
20397,1,2482,2324,158,4,106,0,13
20398,2,2534,2415,119,0,210,0,6
20399,2,2272,2435,-163,0,52,1,6
20400,2,2496,2499,-3,0,244,0,6
20401,2,2470,2361,109,0,200,1,6
20402,2,2337,2405,-68,0,395,0,6
20403,3,2306,2432,-126,0,130,0,6
20404,2,2385,2476,-91,0,246,1,6
20405,2,2311,2463,-152,0,1,0,6
20407,1,2329,2493,-164,0,106,0,6
20408,2,2523,2526,-3,0,256,1,6
20409,2,2341,2469,-128,0,375,0,6
20410,1,2516,2456,60,0,200,0,6
20411,1,2402,2381,21,0,6,0,6
20412,1,2431,2454,-23,0,30,1,6
20413,2,2450,2509,-59,0,106,0,8
20414,1,2429,2334,95,0,483,0,6
20415,1,2422,2578,-156,0,3,0,6
20416,3,2460,2342,118,0,332,0,8
20417,1,2446,2426,20,0,152,1,6
20418,1,2506,2326,180,0,45,0,6
20419,1,2428,2437,-9,0,45,1,6
20420,1,2336,2416,-80,0,110,1,6
20421,1,2479,2403,76,0,485,0,8
20422,2,2259,2471,-212,0,57,0,8
20423,3,2535,2517,18,0,124,0,6
20424,1,2668,2548,120,0,30,1,6
20425,2,2467,2359,108,0,255,0,6
20426,1,2489,2439,50,0,269,1,6
20427,2,2428,2435,-7,0,36,1,6
20428,1,2426,2416,10,0,230,0,6
20429,2,2433,2350,83,0,140,0,8
20430,2,2375,2402,-27,0,334,0,6
20431,3,2423,2450,-27,0,140,0,6
20432,1,2537,2386,151,0,453,0,6
20433,1,2441,2280,161,0,102,0,6
20434,3,2408,2491,-83,0,7,0,6
20435,3,2520,2370,150,0,236,0,8
20436,1,2410,2333,77,0,250,0,6
20437,2,2438,2500,-62,0,122,1,6
20438,1,2446,2263,183,0,330,0,6
20439,1,2466,2451,15,0,338,0,6
20440,1,2540,2227,313,4,301,0,13
20441,1,2388,2417,-29,0,118,1,6
20442,2,2407,2337,70,0,101,0,6
20443,1,2424,2206,218,0,44,1,8
20444,2,2260,2406,-146,0,250,1,6
20445,2,2287,2402,-115,0,242,0,6
20446,2,2449,2589,-140,0,50,1,6
20447,2,2461,2559,-98,0,200,1,8
20448,1,2318,2401,-83,0,337,0,6
20449,2,2365,2514,-149,0,80,0,8
20450,1,2425,2337,88,0,110,0,8
20451,1,2508,2527,-19,0,4,0,6
20452,2,2358,2509,-151,0,40,0,6
20453,2,2581,2635,-54,0,150,0,6
20454,1,2529,2388,141,0,469,0,6
20455,1,2480,2381,99,0,130,1,6
20456,2,2461,2399,62,0,315,0,6
20457,1,2411,2431,-20,0,46,0,6
20458,1,2451,2396,55,0,45,0,6
20459,3,2484,2444,40,0,484,0,8
20460,3,2331,2463,-132,0,15,0,6
20461,2,2254,2521,-267,0,43,0,6
20462,1,2463,2302,161,0,221,0,6
20463,2,2512,2354,158,0,144,1,6
20464,1,2521,2431,90,0,200,0,6
20465,1,2569,2544,25,0,40,1,6
20466,2,2510,2451,59,0,202,0,6
20467,1,2401,2250,151,0,131,1,6
20468,1,2369,2485,-116,0,40,0,6
20469,3,2482,2346,136,0,1,0,6
20470,1,2399,2535,-136,0,118,0,6
20471,2,2341,2438,-97,0,200,0,6
20472,2,2338,2433,-95,0,145,0,6
20473,1,2376,2452,-76,0,337,1,6
20474,2,2413,2408,5,0,330,1,6
20475,1,2474,2313,161,0,42,0,6
20476,1,2494,2517,-23,0,120,0,6
20477,1,2444,2335,109,0,45,1,6
20478,2,2448,2342,106,0,200,0,6
20479,2,2438,2426,12,0,30,0,6
20480,2,2299,2431,-132,0,210,0,6
20481,2,2517,2541,-24,0,201,0,6
20482,2,2414,2335,79,0,100,0,6
20483,1,2297,2411,-114,0,200,1,6
20484,2,2424,2430,-6,0,4,0,6
20485,1,2545,2672,-127,0,267,0,6
20486,1,2370,2432,-62,0,88,0,6
20487,3,2366,2460,-94,0,409,0,6
20488,3,2431,2421,10,0,268,0,6
20489,2,2426,2517,-91,0,2,0,6
20490,1,2450,2423,27,0,4,0,6
20491,2,2407,2446,-39,0,277,0,6
20492,2,2441,2423,18,0,241,0,6
20493,2,2445,2406,39,0,242,0,6
20494,1,2593,2494,99,0,125,0,6
20495,2,2490,2410,80,0,42,1,6
20496,1,2409,2243,166,0,420,1,6
20497,3,2324,2437,-113,0,125,0,6
20498,1,2472,2405,67,0,414,0,6
20499,2,2477,2504,-27,0,300,0,6
20500,2,2434,2334,100,0,337,0,6
20501,2,2377,2434,-57,0,107,0,6
20502,1,2465,2512,-47,0,453,0,6
20503,1,2414,2305,109,0,110,0,6
20504,2,2476,2383,93,0,46,0,6
20505,1,2411,2395,16,0,265,0,6
20506,2,2304,2403,-99,0,16,0,6
20507,2,2458,2533,-75,0,40,1,6
20508,3,2455,2423,32,0,49,0,6
20509,3,2512,2311,201,0,152,0,6
20510,3,2314,2513,-199,0,190,0,6
20511,3,2377,2484,-107,0,264,0,6
20512,1,2514,2504,10,0,345,0,6
20513,1,2451,2385,66,0,395,0,6
20514,1,2429,2435,-6,0,36,1,6
20515,1,2316,2556,-240,0,305,0,6
20516,1,2402,2320,82,0,110,0,6
20517,1,2410,2368,42,0,8,0,6
20518,2,2418,2455,-37,0,380,0,6
20519,2,2538,2563,-25,0,405,0,6
20520,3,2521,2579,-58,0,301,0,6
20521,1,2525,2527,-2,0,171,0,6
20522,2,2407,2478,-71,0,189,0,6
20523,3,2342,2407,-65,0,0,0,6
20524,1,2522,2422,100,0,40,1,6
20525,2,2401,2345,56,0,111,0,6
20526,1,2413,2407,6,0,352,0,6
20527,2,2345,2504,-159,0,320,0,6
20528,1,2350,2511,-161,0,332,1,6
20529,1,2568,2505,63,0,7,0,6
20530,2,2332,2421,-89,0,5,0,6
20531,3,2509,2325,184,0,128,0,6
20532,2,2506,2432,74,0,190,0,6
20533,2,2445,2432,13,0,143,0,6
20534,2,2287,2448,-161,0,203,0,6
20535,1,2440,2425,15,0,45,0,6
20536,1,2459,2352,107,0,4,0,8
20537,1,2458,2368,90,0,245,1,6
20538,2,2350,2511,-161,0,375,0,6
20539,2,2512,2514,-2,0,201,0,6
20540,1,2425,2417,8,0,45,0,6
20541,1,2455,2401,54,0,300,0,6
20542,2,2255,2426,-171,0,152,1,8
20543,1,2577,2469,108,0,102,0,6
20544,3,2403,2546,-143,0,202,0,6
20545,1,2425,2496,-71,0,178,0,6
20546,1,2439,2431,8,0,40,0,6
20547,2,2461,2280,181,0,302,0,6
20548,1,2461,2454,7,0,125,0,6
20549,2,2389,2417,-28,0,315,0,6
20550,1,2490,2424,66,0,154,0,6
20551,2,2598,2446,152,0,261,0,6
20552,2,2301,2418,-117,0,106,0,6
20553,1,2404,2316,88,0,130,1,6
20554,1,2563,2457,106,0,45,1,8
20555,1,2435,2428,7,0,264,0,6
20556,1,2465,2379,86,0,267,0,6
20557,2,2357,2426,-69,0,23,0,6
20558,1,2421,2345,76,0,335,0,6
20559,2,2453,2588,-135,0,203,1,6
20560,1,2472,2339,133,0,43,0,6
20561,1,2407,2300,107,0,135,1,6
20562,3,2413,2413,0,0,8,0,6
20563,2,2254,2511,-257,4,260,0,13
20564,1,2510,2483,27,0,300,1,6
20565,1,2409,2397,12,4,332,1,13
20566,1,2577,2568,9,0,111,0,6
20567,1,2438,2381,57,0,345,0,6
20568,1,2500,2316,184,0,252,0,6
20569,2,2268,2547,-279,0,22,0,6
20570,1,2441,2253,188,0,108,0,6
20571,3,2514,2363,151,0,53,0,6
20572,1,2521,2454,67,0,300,0,6
20573,2,2451,2537,-86,0,106,1,6
20574,3,2435,2363,72,0,140,0,6
20575,2,2531,2371,160,0,253,0,6
20576,1,2532,2261,271,0,245,0,6
20577,3,2400,2299,101,0,302,0,6
20578,2,2524,2475,49,4,404,0,13
20579,1,2483,2378,105,0,310,0,6
20580,1,2563,2552,11,0,227,0,6
20581,2,2418,2573,-155,0,2,0,6
20583,2,2396,2460,-64,0,460,1,6
20584,3,2473,2377,96,0,427,0,6
20585,1,2400,2247,153,0,101,0,6
20586,2,2419,2449,-30,0,20,0,6
20587,2,2402,2482,-80,0,0,0,6
20588,1,2319,2406,-87,0,4,0,6
20589,1,2503,2454,49,0,244,0,6
20590,2,2350,2468,-118,0,106,0,6
20591,1,2441,2522,-81,0,131,1,6
20592,1,2408,2247,161,0,45,0,6
20593,1,2526,2346,180,0,45,0,6
20594,1,2495,2401,94,0,115,0,6
20595,2,2363,2462,-99,0,409,0,6
20596,2,2449,2514,-65,0,49,0,6
20597,1,2578,2605,-27,0,474,0,6
20598,1,2406,2432,-26,0,135,0,6
20599,1,2520,2506,14,0,301,1,6
20600,1,2449,2466,-17,0,6,1,6
20601,1,2424,2301,123,0,245,0,6
20602,2,2348,2463,-115,0,107,1,8
20603,3,2246,2460,-214,4,46,0,13
20604,1,2549,2364,185,0,225,0,6
20605,1,2422,2297,125,0,45,0,6
20606,1,2343,2426,-83,0,331,0,6
20607,1,2529,2398,131,0,45,0,6
20608,2,2422,2384,38,0,268,1,6
20609,1,2507,2582,-75,0,190,0,6
20610,1,2534,2435,99,0,245,0,6
20611,1,2547,2569,-22,0,122,0,6
20612,1,2420,2337,83,0,102,0,6
20613,2,2503,2443,60,0,251,1,6
20614,1,2340,2443,-103,0,6,1,6
20615,2,2386,2508,-122,0,332,0,6
20617,2,2425,2272,153,0,46,1,6
20618,2,2478,2515,-37,0,1,0,6
20619,2,2403,2245,158,0,10,0,6
20620,2,2452,2478,-26,0,302,0,6
20622,2,2430,2352,78,0,144,0,6
20623,1,2285,2405,-120,0,241,0,8
20624,2,2276,2447,-171,0,202,1,6
20625,1,2327,2424,-97,0,302,1,6
20626,1,2467,2359,108,0,1,0,6
20627,2,2270,2427,-157,0,101,0,6
20628,2,2244,2412,-168,0,302,0,6
20629,2,2245,2408,-163,0,484,1,6
20630,2,2392,2426,-34,0,136,1,6
20631,1,2458,2414,44,0,45,1,6
20632,1,2430,2323,107,0,46,0,8
20633,1,2404,2304,100,0,255,1,6
20634,2,2500,2444,56,0,210,0,6
20635,2,2475,2440,35,0,16,0,6
20636,3,2512,2417,95,0,256,0,6
20637,1,2413,2262,151,0,45,1,6
20638,2,2461,2367,94,0,101,0,6
20639,1,2403,2376,27,0,0,0,6
20640,2,2425,2439,-14,0,242,0,6
20641,1,2413,2499,-86,0,7,0,6
20642,2,2450,2346,104,0,44,1,6
20643,1,2520,2473,47,0,300,0,6
20644,2,2550,2646,-96,0,486,0,6
20645,1,2448,2277,171,0,140,0,6
20646,2,2475,2420,55,0,101,0,6
20647,2,2428,2307,121,0,112,0,6
20648,1,2455,2460,-5,0,321,0,6
20649,2,2415,2261,154,0,190,1,6
20650,2,2415,2533,-118,0,3,1,6
20651,1,2318,2411,-93,0,101,0,6
20652,1,2293,2426,-133,0,117,1,6
20653,2,2430,2466,-36,0,246,1,6
20654,2,2355,2471,-116,0,404,0,6
20655,3,2511,2322,189,0,43,0,6
20656,1,2590,2501,89,0,398,0,6
20657,2,2357,2419,-62,0,6,0,6
20658,2,2274,2433,-159,0,32,0,6
20659,1,2415,2567,-152,0,7,0,6
20660,1,2408,2529,-121,0,320,0,6
20661,2,2496,2594,-98,0,123,0,6
20662,1,2453,2392,61,0,110,0,8
20663,1,2497,2313,184,0,42,0,6
20664,3,2392,2521,-129,0,308,0,6
20665,2,2519,2510,9,0,332,0,6
20666,1,2310,2448,-138,0,127,0,6
20667,1,2419,2296,123,0,463,0,6
20668,1,2436,2348,88,0,102,0,6
20669,2,2399,2485,-86,0,0,0,6
20670,1,2552,2266,286,0,101,0,6
20671,1,2375,2497,-122,0,187,0,6
20672,1,2450,2399,51,0,110,1,6
20673,2,2343,2484,-141,0,320,0,6
20674,2,2296,2417,-121,0,300,0,6
20675,1,2370,2538,-168,0,28,0,6
20676,1,2334,2432,-98,4,1,0,13
20677,2,2316,2575,-259,0,130,0,6
20678,1,2514,2366,148,0,246,0,6
20679,1,2650,2431,219,0,130,0,6
20680,1,2451,2494,-43,0,40,1,6
20681,3,2487,2428,59,0,344,0,6
20682,1,2412,2406,6,0,265,0,6
20683,2,2482,2516,-34,4,130,0,13
20684,2,2311,2468,-157,0,278,0,6
20685,3,2446,2408,38,0,22,0,6
20686,1,2577,2577,0,0,4,0,6
20687,1,2426,2449,-23,0,256,0,6
20688,2,2468,2525,-57,0,145,1,6
20689,2,2423,2353,70,0,335,0,6
20690,1,2353,2442,-89,0,101,0,6
20691,1,2423,2461,-38,0,345,0,6
20692,2,2443,2454,-11,0,122,0,6
20693,2,2261,2433,-172,0,59,1,6
20694,2,2437,2270,167,0,110,0,6
20695,2,2419,2451,-32,0,145,0,6
20696,2,2359,2423,-64,0,11,0,5
20697,2,2271,2447,-176,0,487,0,6
20698,1,2504,2537,-33,0,441,0,6
20699,1,2490,2395,95,0,127,1,6
20700,2,2513,2411,102,0,331,0,6
20701,2,2300,2405,-105,0,244,1,6
20702,1,2458,2565,-107,0,46,0,6
20703,1,2474,2425,49,0,45,0,6
20704,3,2519,2353,166,0,45,0,6
20705,1,2416,2358,58,0,115,1,6
20706,1,2491,2404,87,0,300,0,6
20707,2,2440,2416,24,0,150,0,6
20708,1,2417,2310,107,0,46,0,6
20709,1,2475,2351,124,0,256,1,6
20710,2,2599,2492,107,0,398,0,6
20711,2,2303,2453,-150,0,110,0,6
20712,2,2356,2421,-65,0,307,0,6
20713,2,2442,2438,4,0,331,1,6
20714,1,2516,2500,16,0,101,1,6
20715,2,2460,2472,-12,0,113,1,6
20716,1,2440,2465,-25,0,15,0,6
20717,1,2425,2271,154,4,40,0,13
20718,1,2349,2440,-91,0,49,1,6
20719,2,2578,2569,9,0,107,0,6
20720,2,2544,2398,146,0,46,0,6
20721,1,2517,2490,27,0,45,0,6
20722,2,2523,2357,166,0,44,0,6
20723,1,2652,2455,197,0,213,0,6
20724,1,2428,2394,34,0,112,1,6
20725,2,2435,2361,74,0,44,1,6
20726,2,2300,2487,-187,0,101,0,6
20727,2,2293,2450,-157,0,129,1,6
20728,2,2434,2296,138,0,111,0,6
20729,1,2489,2335,154,0,317,0,6
20730,2,2302,2458,-156,0,199,0,8
20731,1,2530,2510,20,0,45,0,6
20732,1,2454,2430,24,0,302,0,6
20733,2,2245,2404,-159,0,1,1,6
20734,3,2557,2465,92,0,343,0,6
20735,2,2409,2445,-36,0,110,0,6
20736,3,2399,2429,-30,0,302,0,6
20737,1,2367,2408,-41,0,218,0,6
20738,1,2457,2300,157,0,180,0,6
20739,1,2338,2457,-119,0,344,0,6
20740,1,2555,2331,224,0,128,0,6
20741,1,2406,2379,27,0,205,1,6
20742,1,2488,2413,75,0,442,0,6
20743,1,2703,2591,112,0,172,0,6
20744,2,2357,2421,-64,0,40,0,6
20745,1,2530,2463,67,0,300,1,6
20746,2,2289,2434,-145,0,107,0,6
20747,1,2444,2398,46,0,249,1,6
20748,2,2300,2430,-130,0,418,0,6
20749,1,2400,2486,-86,0,140,1,6
20750,3,2508,2518,-10,0,40,0,6
20751,1,2500,2651,-151,0,101,0,6
20753,2,2354,2559,-205,0,207,0,8
20754,1,2557,2453,104,0,265,0,6
20755,2,2391,2494,-103,0,189,0,6
20756,1,2428,2449,-21,0,100,0,6
20757,1,2401,2428,-27,0,207,0,6
20758,2,2422,2375,47,0,67,0,6
20759,1,2425,2246,179,0,236,1,6
20760,1,2428,2355,73,0,108,0,5
20761,2,2500,2515,-15,0,101,0,6
20762,1,2536,2522,14,0,311,0,6
20763,1,2348,2478,-130,0,81,1,6
20764,3,2444,2406,38,0,122,0,6
20765,1,2484,2460,24,0,132,1,6
20766,1,2587,2418,169,0,330,0,6
20767,2,2390,2425,-35,0,6,0,6
20768,1,2494,2400,94,0,40,1,6
20769,1,2452,2366,86,0,40,1,6
20770,2,2297,2460,-163,0,313,1,6
20771,2,2394,2438,-44,0,315,1,6
20772,2,2402,2522,-120,0,4,0,6
20773,2,2477,2655,-178,0,54,0,6
20774,2,2455,2446,9,0,123,0,6
20775,2,2408,2493,-85,0,192,1,6
20777,2,2389,2434,-45,0,80,0,6
20778,1,2402,2387,15,0,45,0,6
20779,2,2451,2499,-48,0,16,1,6
20780,2,2467,2556,-89,0,46,0,6
20781,2,2315,2403,-88,0,4,1,6
20782,1,2518,2561,-43,0,190,0,6
20783,1,2536,2490,46,0,380,0,6
20784,1,2426,2395,31,0,411,0,6
20785,1,2443,2352,91,0,17,0,6
20786,1,2505,2609,-104,0,96,0,6
20787,2,2415,2296,119,0,52,1,6
20788,1,2430,2421,9,0,409,0,6
20789,2,2324,2400,-76,0,120,0,8
20790,1,2520,2494,26,0,0,0,6
20791,1,2582,2415,167,0,8,1,6
20792,2,2390,2449,-59,0,41,1,6
20793,2,2386,2509,-123,0,448,0,6
20795,2,2374,2411,-37,0,10,0,6
20796,1,2439,2393,46,0,256,1,6
20797,1,2517,2336,181,0,310,0,6
20798,1,2506,2541,-35,0,426,0,6
20799,2,2458,2535,-77,0,141,1,6
20800,2,2452,2474,-22,0,415,0,6
20801,2,2658,2643,15,0,101,1,6
20802,2,2324,2450,-126,0,16,1,6
20803,2,2490,2375,115,0,150,0,6
20804,2,2386,2431,-45,0,200,0,6
20805,1,2408,2350,58,0,104,0,6
20806,3,2443,2384,59,0,200,0,6
20807,1,2430,2342,88,0,316,0,6
20808,2,2454,2378,76,0,46,0,6
20809,2,2490,2590,-100,0,154,0,6
20810,1,2513,2572,-59,0,464,0,6
20811,1,2422,2459,-37,0,200,0,6
20812,1,2526,2371,155,0,121,1,6
20813,1,2454,2443,11,0,49,0,6
20814,1,2479,2407,72,0,324,0,6
20815,2,2381,2407,-26,0,200,0,6
20816,1,2413,2457,-44,0,205,0,6
20817,1,2400,2407,-7,0,234,0,6
20818,2,2428,2526,-98,0,101,1,6
20819,1,2407,2317,90,0,100,0,6
20820,1,2376,2402,-26,0,211,0,6
20821,2,2420,2428,-8,4,345,0,13
20822,1,2477,2514,-37,4,250,0,13
20823,2,2356,2404,-48,0,409,0,6
20824,1,2542,2462,80,0,16,0,6
20825,1,2447,2314,133,0,156,0,6
20826,1,2560,2449,111,0,335,0,6
20827,1,2553,2415,138,0,331,0,6
20828,3,2427,2446,-19,0,45,0,6
20829,1,2520,2512,8,0,45,0,6
20830,2,2399,2426,-27,0,48,0,6
20831,1,2541,2369,172,0,40,0,6
20832,1,2423,2358,65,0,223,0,6
20833,2,2421,2444,-23,0,13,1,6
20834,1,2436,2310,126,0,101,1,6
20835,3,2562,2343,219,0,211,0,8
20836,2,2279,2414,-135,4,48,0,13
20837,1,2382,2454,-72,0,134,0,6
20838,2,2312,2576,-264,0,375,0,6
20839,2,2429,2302,127,0,150,0,6
20840,2,2345,2463,-118,0,241,0,8
20841,2,2453,2414,39,0,331,0,6
20842,1,2601,2508,93,0,145,0,6
20843,1,2595,2407,188,0,371,0,6
20844,1,2544,2472,72,0,157,0,6
20845,1,2486,2526,-40,0,101,0,6
20846,1,2652,2520,132,0,110,0,6
20847,2,2351,2504,-153,0,79,0,6
20848,1,2436,2378,58,0,302,0,6
20849,1,2415,2318,97,0,432,1,6
20850,3,2404,2461,-57,0,153,0,8
20851,2,2427,2460,-33,0,306,0,6
20852,3,2539,2454,85,0,300,0,6
20853,3,2413,2376,37,0,45,0,6
20854,1,2437,2460,-23,0,302,1,6
20855,2,2423,2419,4,0,415,0,6
20856,1,2458,2530,-72,0,302,0,6
20857,1,2402,2343,59,4,50,0,13
20858,3,2288,2442,-154,0,0,0,6
20859,2,2333,2408,-75,0,347,1,6
20860,2,2302,2404,-102,0,113,0,6
20861,2,2368,2529,-161,0,128,1,6
20862,1,2556,2451,105,0,11,1,6
20863,1,2454,2320,134,0,130,0,6
20864,2,2445,2564,-119,0,200,1,6
20865,1,2370,2433,-63,0,107,0,6
20866,1,2304,2441,-137,0,310,0,6
20867,2,2569,2577,-8,0,110,1,6
20868,2,2445,2445,0,0,22,0,6
20869,1,2220,2428,-208,0,101,0,6
20870,1,2565,2257,308,0,110,0,6
20871,1,2386,2447,-61,0,151,0,6
20872,2,2412,2544,-132,0,3,0,6
20873,2,2427,2519,-92,0,101,0,6
20874,2,2342,2412,-70,0,0,0,6
20875,1,2350,2492,-142,0,1,0,6
20876,1,2401,2350,51,0,143,0,6
20877,2,2432,2530,-98,0,150,0,6
20878,2,2356,2512,-156,0,133,1,6
20879,1,2436,2424,12,0,302,0,6
20880,2,2425,2478,-53,0,130,1,6
20881,1,2277,2418,-141,0,426,0,6
20882,2,2402,2484,-82,0,242,0,6
20883,1,2520,2310,210,0,300,0,6
20884,2,2446,2598,-152,0,386,0,6
20885,1,2449,2416,33,0,254,0,6
20886,1,2451,2381,70,0,152,1,6
20887,2,2513,2555,-42,0,140,0,6
20888,2,2447,2321,126,0,153,0,6
20889,2,2467,2389,78,0,152,1,6
20891,2,2306,2459,-153,0,300,0,6
20892,2,2409,2308,101,0,255,1,6
20893,1,2419,2229,190,0,45,1,6
20894,3,2468,2548,-80,0,409,0,6
20895,2,2507,2449,58,0,244,1,6
20896,2,2249,2428,-179,0,255,1,6
20897,2,2504,2516,-12,0,199,0,6
20898,3,2656,2664,-8,0,110,0,6
20899,1,2411,2338,73,0,453,0,6
20900,1,2420,2347,73,0,400,1,6
20901,2,2510,2459,51,0,300,0,6
20902,2,2421,2438,-17,0,150,0,6
20903,1,2427,2381,46,0,250,0,6
20904,1,2548,2408,140,0,13,0,6
20905,1,2417,2376,41,0,120,0,6
20906,2,2455,2538,-83,0,141,1,6
20907,1,2561,2582,-21,0,113,0,6
20908,2,2523,2205,318,0,211,1,6
20909,3,2454,2407,47,0,40,0,6
20910,1,2471,2319,152,0,310,0,6
20911,1,2322,2447,-125,0,311,0,6
20912,2,2448,2349,99,0,143,0,6
20913,1,2373,2484,-111,0,387,0,6
20914,3,2532,2465,67,0,200,0,6
20915,2,2308,2447,-139,0,212,0,6
20916,1,2524,2346,178,0,330,0,6
20917,1,2601,2443,158,0,50,0,6
20918,1,2492,2389,103,0,201,0,6
20919,1,2393,2405,-12,0,0,0,6
20920,1,2345,2406,-61,0,251,0,6
20921,1,2412,2436,-24,0,4,0,6
20922,1,2567,2560,7,0,100,0,6
20923,1,2492,2440,52,0,4,0,6
20924,2,2420,2416,4,0,84,0,6
20925,1,2411,2455,-44,0,248,0,6
20926,1,2444,2329,115,0,210,0,6
20927,2,2483,2420,63,0,413,1,6
20928,1,2431,2467,-36,0,241,1,8
20929,2,2412,2333,79,0,2,1,6
20930,2,2354,2446,-92,0,2,0,6
20931,2,2369,2579,-210,0,48,0,6
20932,2,2422,2363,59,0,112,0,6
20933,1,2664,2656,8,0,460,1,6
20934,2,2316,2457,-141,0,16,1,6
20935,1,2315,2401,-86,0,27,0,6
20936,3,2604,2505,99,0,145,0,6
20937,1,2371,2432,-61,0,241,0,6
20938,2,2440,2303,137,0,101,1,6
20939,1,2440,2352,88,0,205,1,6
20940,1,2357,2467,-110,0,260,0,8
20941,1,2404,2551,-147,0,3,1,6
20942,1,2360,2428,-68,0,476,1,6
20943,2,2340,2403,-63,0,335,0,6
20944,1,2431,2246,185,0,4,0,6
20945,1,2740,2509,231,0,297,0,6
20946,1,2426,2344,82,0,107,1,6
20947,1,2497,2465,32,0,9,0,6
20948,1,2534,2456,78,0,0,0,6
20949,3,2326,2440,-114,0,277,0,6
20950,2,2316,2475,-159,0,300,0,6
20951,2,2308,2509,-201,0,210,0,6
20952,2,2337,2477,-140,0,0,0,6
20953,2,2416,2380,36,0,352,1,6
20954,2,2418,2238,180,4,394,0,13
20955,3,2522,2527,-5,0,311,0,6
20956,2,2488,2398,90,0,325,1,6
20958,2,2340,2441,-101,0,127,1,6
20959,2,2252,2407,-155,4,123,0,13
20960,2,2401,2489,-88,0,101,0,6
20961,2,2448,2500,-52,0,101,0,6
20962,1,2280,2429,-149,0,0,0,6
20963,1,2462,2424,38,0,46,0,6
20964,2,2456,2531,-75,0,128,0,6
20965,2,2398,2402,-4,0,190,0,6
20966,2,2466,2569,-103,0,40,1,6
20967,1,2512,2366,146,0,6,0,6
20968,3,2582,2555,27,0,334,0,6
20969,2,2584,2427,157,0,406,0,6
20970,1,2407,2258,149,0,461,0,6
20971,1,2420,2288,132,0,4,0,6
20972,3,2420,2505,-85,0,133,0,6
20973,1,2353,2403,-50,0,344,1,6
20974,2,2526,2495,31,0,201,0,6
20975,2,2468,2469,-1,0,301,0,6
20976,1,2402,2408,-6,0,4,0,6
20977,1,2451,2452,-1,0,343,0,6
20978,1,2510,2530,-20,0,200,0,6
20979,1,2614,2560,54,0,9,0,6
20980,3,2440,2419,21,0,351,0,6
20981,2,2478,2476,2,0,225,0,6
20982,2,2492,2487,5,0,464,0,6
20983,3,2536,2552,-16,0,130,0,6
20984,2,2339,2535,-196,0,300,0,6
20985,2,2299,2434,-135,4,112,0,13
20986,1,2268,2573,-305,0,106,1,6
20987,1,2496,2421,75,0,8,0,6
20988,1,2524,2501,23,0,112,0,6
20989,3,2409,2411,-2,0,269,0,6
20990,1,2407,2404,3,0,3,0,6
20991,2,2542,2529,13,0,46,0,6
20992,1,2698,2609,89,0,101,0,6
20993,2,2575,2595,-20,0,123,0,6
20994,1,2522,2332,190,0,310,1,6
20995,2,2269,2406,-137,0,151,0,6
20996,2,2425,2378,47,0,127,0,6
20997,1,2400,2457,-57,0,46,0,6
20998,1,2507,2743,-236,0,120,1,6
20999,1,2546,2507,39,0,27,0,6
21000,2,2493,2397,96,0,120,1,6
21002,1,2413,2417,-4,0,48,0,6
21004,3,2435,2425,10,0,131,0,6
21005,3,2457,2443,14,0,145,0,6
21006,1,2722,2500,222,0,122,0,6
21007,1,2517,2585,-68,0,241,0,6
21008,1,2504,2450,54,0,135,0,6
21009,2,2402,2397,5,0,133,0,6
21010,2,2385,2419,-34,0,0,0,6
21011,2,2432,2418,14,0,254,0,6
21012,1,2505,2334,171,0,100,0,6
21013,2,2280,2414,-134,0,46,0,6
21014,2,2274,2422,-148,0,203,0,6
21015,1,2203,2453,-250,0,168,0,6
21016,1,2517,2203,314,0,306,0,6
21017,2,2385,2407,-22,0,107,1,6
21018,1,2460,2382,78,0,190,0,8
21019,1,2452,2378,74,0,107,0,6
21020,2,2356,2407,-51,0,262,0,6
21021,1,2559,2321,238,0,100,1,6
21022,2,2431,2336,95,0,202,0,6
21023,1,2543,2515,28,0,45,1,6
21024,3,2455,2323,132,0,45,0,6
21025,2,2243,2434,-191,0,107,0,6
21026,2,2330,2527,-197,0,101,0,6
21027,2,2410,2390,20,0,181,0,6
21028,3,2438,2338,100,0,357,0,6
21029,1,2443,2497,-54,0,128,0,6
21030,1,2325,2448,-123,0,150,1,6
21031,3,2443,2324,119,0,89,0,6
21032,1,2320,2447,-127,0,162,0,6
21033,2,2378,2413,-35,0,218,0,6
21034,3,2452,2441,11,0,101,0,6
21035,2,2387,2426,-39,0,311,1,6
21036,1,2461,2307,154,0,249,1,8
21037,1,2424,2576,-152,0,125,0,6
21038,2,2452,2541,-89,0,191,0,6
21039,1,2460,2435,25,0,211,0,6
21040,1,2348,2536,-188,0,123,1,6
21041,1,2529,2502,27,0,80,0,6
21042,1,2557,2413,144,0,0,0,6
21043,3,2434,2555,-121,0,103,0,6
21044,3,2426,2620,-194,0,344,0,6
21045,3,2555,2472,83,0,337,0,6
21046,3,2424,2588,-164,0,101,0,6
21047,1,2523,2311,212,0,9,0,6
21048,2,2462,2314,148,0,301,0,6
21049,1,2475,2351,124,0,310,0,6
21050,1,2430,2465,-35,0,101,0,6
21051,1,2437,2240,197,0,405,1,6
21052,1,2380,2438,-58,0,211,0,6
21053,3,2438,2320,118,4,476,0,13
21054,1,2535,2424,111,0,130,0,6
21055,2,2254,2554,-300,0,461,0,6
21056,1,2474,2387,87,0,120,0,6
21057,2,2331,2509,-178,0,300,0,6
21058,2,2339,2459,-120,0,335,0,8
21059,3,2405,2481,-76,0,242,0,6
21060,1,2555,2563,-8,0,112,0,6
21061,2,2480,2203,277,0,39,0,6
21062,2,2409,2560,-151,0,2,0,6
21063,2,2305,2703,-398,0,416,0,6
21064,2,2404,2486,-82,0,101,0,6
21065,2,2348,2423,-75,0,113,0,6
21066,2,2734,2516,218,0,258,0,6
21067,1,2496,2472,24,0,123,0,6
21068,1,2535,2423,112,0,40,0,6
21069,2,2502,2513,-11,0,245,0,6
21070,1,2461,2286,175,0,115,0,6
21071,2,2504,2429,75,0,117,0,6
21072,2,2310,2436,-126,0,45,0,6
21073,1,2459,2436,23,0,200,0,6
21074,2,2413,2339,74,0,265,0,6
21075,2,2332,2726,-394,0,101,0,6
21076,2,2440,2380,60,0,211,0,6
21077,2,2319,2476,-157,0,464,0,6
21078,3,2360,2442,-82,0,140,0,6
21079,2,2296,2425,-129,0,40,0,6
21080,2,2411,2549,-138,0,40,1,6
21081,2,2356,2450,-94,0,288,1,6
21082,2,2404,2411,-7,0,302,0,6
21083,2,2419,2408,11,0,40,0,6
21084,1,2446,2569,-123,0,20,0,6
21085,2,2261,2561,-300,0,46,0,6
21086,1,2564,2406,158,0,210,0,6
21087,1,2568,2386,182,0,406,0,6
21088,2,2525,2725,-200,0,130,1,6
21089,1,2419,2355,64,0,123,0,6
21090,1,2552,2270,282,0,335,0,6
21091,1,2486,2454,32,0,307,0,6
21092,1,2420,2255,165,0,48,0,6
21093,2,2432,2574,-142,0,106,0,6
21094,2,2418,2383,35,0,330,0,6
21095,3,2403,2212,191,0,140,0,6
21096,1,2519,2334,185,0,120,0,6
21097,1,2539,2386,153,0,122,0,6
21098,1,2535,2270,265,0,153,0,6
21099,2,2306,2536,-230,0,300,0,6
21100,1,2228,2516,-288,0,143,0,6
21101,1,2617,2485,132,0,15,0,6
21102,1,2315,2449,-134,0,302,0,6
21103,2,2288,2536,-248,0,301,0,6
21104,1,2457,2329,128,0,337,0,6
21105,2,2324,2465,-141,0,104,1,8
21106,2,2586,2431,155,0,122,0,6
21107,2,2519,2496,23,0,122,0,6
21108,2,2413,2381,32,0,351,0,6
21109,1,2545,2448,97,0,150,0,6
21110,2,2294,2426,-132,0,300,1,6
21111,2,2377,2561,-184,0,40,0,8
21112,2,2340,2527,-187,0,13,0,6
21113,1,2531,2224,307,0,143,1,6
21114,1,2468,2265,203,4,49,0,0
21115,1,2620,2522,98,0,125,0,6
21116,2,2237,2440,-203,0,245,0,6
21117,1,2399,2418,-19,0,200,0,6
21118,1,2447,2201,246,0,302,0,6
21119,2,2457,2494,-37,0,249,0,6
21120,2,2320,2430,-110,0,406,0,6
21121,3,2499,2445,54,0,115,0,6
21122,1,2512,2670,-158,0,202,0,6
21123,2,2421,2440,-19,0,190,0,6
21124,1,2466,2454,12,0,404,0,6
21125,1,2556,2223,333,0,405,0,6
21126,2,2400,2383,17,0,4,1,6
21127,1,2346,2406,-60,0,302,1,6
21128,1,2539,2542,-3,0,418,0,6
21129,3,2465,2351,114,0,140,0,8
21130,2,2420,2383,37,0,127,0,6
21131,1,2402,2567,-165,0,3,0,6
21132,2,2431,2465,-34,0,130,1,6
21133,2,2428,2366,62,0,122,1,6
21134,1,2216,2406,-190,0,302,0,6
21135,2,2450,2443,7,0,278,1,6
21137,2,2500,2236,264,0,40,0,6
21138,1,2436,2479,-43,0,8,0,6
21139,2,2563,2516,47,0,210,0,6
21140,3,2440,2629,-189,0,357,0,6
21141,1,2422,2307,115,0,13,0,6
21142,1,2429,2452,-23,0,110,0,6
21143,1,2422,2221,201,0,134,1,6
21144,1,2287,2526,-239,0,120,1,6
21145,2,2552,2454,98,0,300,0,6
21146,2,2412,2405,7,0,454,0,6
21147,2,2444,2550,-106,0,112,0,6
21148,2,2577,2428,149,0,338,1,6
21149,3,2518,2586,-68,0,4,0,6
21150,2,2338,2673,-335,0,106,0,6
21151,1,2728,2522,206,0,297,0,6
21152,3,2426,2275,151,0,4,0,6
21153,2,2503,2513,-10,0,245,0,6
21154,2,2237,2520,-283,0,300,0,6
21155,1,2419,2286,133,0,211,0,6
21156,2,2523,2334,189,0,61,0,6
21157,1,2602,2372,230,0,455,0,6
21158,1,2704,2225,479,0,41,0,6
21159,1,2457,2405,52,0,386,1,6
21160,1,2530,2439,91,0,122,0,6
21161,2,2248,2411,-163,0,232,1,6
21162,1,2365,2526,-161,0,123,0,6
21163,2,2507,2323,184,0,200,1,6
21164,2,2430,2291,139,0,205,1,6
21165,1,2443,2234,209,0,404,1,6
21166,2,2411,2520,-109,0,2,0,6
21167,1,2406,2238,168,0,101,0,6
21168,2,2247,2411,-164,0,4,0,6
21169,2,2414,2247,167,0,121,0,6
21170,3,2401,2660,-259,0,12,0,6
21171,1,2558,2526,32,0,115,1,6
21172,2,2417,2413,4,0,241,0,6
21173,3,2414,2301,113,0,5,0,6
21174,1,2454,2323,131,0,36,0,6
21175,2,2384,2406,-22,0,302,1,6
21176,2,2537,2352,185,0,0,0,6
21177,1,2351,2424,-73,0,263,0,6
21178,1,2501,2228,273,0,133,0,6
21179,1,2561,2443,118,0,241,0,6
21180,1,2409,2551,-142,0,138,0,6
21181,1,2498,2474,24,0,245,0,6
21182,2,2388,2408,-20,0,110,0,6
21183,2,2296,2412,-116,0,200,0,6
21184,1,2249,2413,-164,0,106,0,6
21185,2,2582,2557,25,0,8,0,6
21186,3,2446,2228,218,0,9,0,6
21187,1,2350,2409,-59,0,45,0,6
21188,3,2413,2441,-28,0,12,0,6
21189,2,2273,2403,-130,0,22,1,6
21190,3,2355,2554,-199,0,135,0,6
21191,2,2448,2389,59,0,466,1,6
21192,1,2510,2426,84,0,56,0,6
21193,3,2585,2497,88,0,27,0,6
21194,1,2470,2426,44,0,46,1,6
21195,3,2482,2728,-246,0,101,0,6
21196,1,2705,2532,173,0,153,0,6
21197,2,2280,2518,-238,0,3,0,6
21198,2,2480,2407,73,0,58,0,6
21199,3,2520,2730,-210,0,228,0,6
21200,1,2314,2407,-93,0,4,0,6
21201,2,2317,2412,-95,0,4,0,6
21202,2,2303,2430,-127,0,206,0,6
21203,1,2623,2443,180,0,246,1,6
21204,1,2462,2545,-83,0,112,0,6
21205,2,2222,2537,-315,0,45,1,6
21206,2,2527,2348,179,0,414,1,6
21207,1,2522,2281,241,0,45,0,6
21208,2,2435,2292,143,0,143,0,6
21209,2,2535,2519,16,0,122,1,6
21210,1,2524,2407,117,0,202,0,6
21211,2,2443,2621,-178,0,4,0,6
21212,3,2472,2658,-186,0,330,0,6
21213,2,2303,2444,-141,0,45,0,6
21214,1,2525,2240,285,0,20,0,6
21215,2,2445,2514,-69,0,190,0,6
21216,1,2468,2463,5,0,221,0,8
21217,1,2449,2302,147,0,149,0,6
21218,3,2379,2442,-63,0,134,0,6
21219,1,2418,2287,131,0,136,0,6
21220,2,2554,2440,114,0,304,1,6
21221,2,2416,2293,123,0,301,0,6
21222,1,2283,2524,-241,0,200,0,6
21223,2,2414,2444,-30,0,45,0,6
21224,2,2383,2446,-63,0,4,0,6
21225,2,2487,2518,-31,0,331,0,6
21226,3,2656,2462,194,0,156,0,6
21227,1,2521,2275,246,0,101,0,6
21228,1,2446,2324,122,0,245,0,6
21229,2,2507,2260,247,4,110,0,13
21230,1,2332,2433,-101,0,373,0,6
21231,1,2499,2355,144,0,415,0,6
21232,2,2427,2383,44,0,0,0,6
21233,1,2280,2491,-211,0,10,1,6
21234,2,2232,2446,-214,0,107,0,6
21235,2,2300,2422,-122,0,301,0,6
21236,1,2563,2515,48,0,40,0,6
21237,1,2530,2564,-34,0,215,0,6
21238,1,2297,2583,-286,0,275,0,6
21239,1,2361,2415,-54,0,45,1,6
21240,2,2272,2523,-251,0,3,0,6
21241,1,2433,2412,21,0,250,1,6
21242,1,2360,2528,-168,0,110,1,6
21243,2,2539,2463,76,0,131,1,6
21244,1,2435,2372,63,0,150,0,6
21245,2,2269,2546,-277,0,300,0,6
21246,1,2231,2405,-174,0,40,0,6
21247,2,2338,2475,-137,0,130,0,6
21248,2,2656,2228,428,0,345,0,6
21249,1,2215,2481,-266,0,0,0,6
21250,1,2499,2538,-39,0,46,1,6
21251,2,2421,2475,-54,0,223,1,6
21252,2,2293,2407,-114,0,115,0,6
21253,2,2469,2543,-74,0,138,0,6
21254,1,2568,2292,276,0,101,0,6
21255,1,2503,2524,-21,0,101,0,6
21256,2,2396,2421,-25,0,100,0,6
21257,2,2398,2584,-186,0,4,1,6
21258,1,2415,2226,189,0,302,0,6
21259,1,2525,2268,257,0,101,0,6
21260,1,2457,2341,116,0,152,0,8
21261,1,2529,2239,290,0,245,0,6
21262,1,2604,2708,-104,0,414,0,6
21263,1,2402,2369,33,0,317,0,6
21264,3,2325,2443,-118,0,4,0,6
21265,2,2400,2300,100,0,338,0,6
21266,1,2403,2528,-125,0,2,1,6
21267,2,2224,2441,-217,0,212,0,6
21268,3,2419,2372,47,0,334,0,6
21269,3,2341,2411,-70,0,186,0,6
21270,3,2298,2482,-184,0,278,0,6
21271,1,2433,2337,96,0,405,0,6
21272,3,2440,2388,52,0,314,0,6
21273,2,2498,2629,-131,0,245,1,6
21274,2,2255,2431,-176,0,333,0,6
21275,1,2426,2388,38,0,112,1,6
21276,1,2448,2411,37,0,121,0,6
21277,2,2422,2529,-107,0,301,0,6
21278,1,2578,2404,174,0,121,0,6
21279,1,2446,2422,24,0,0,0,6
21280,1,2540,2357,183,0,327,0,6
21281,1,2414,2473,-59,0,242,1,6
21282,1,2374,2417,-43,0,217,0,6
21283,1,2462,2223,239,0,380,0,6
21284,1,2624,2358,266,0,485,1,6
21285,1,2515,2206,309,0,108,0,6
21286,2,2411,2453,-42,0,303,0,6
21287,1,2264,2528,-264,0,3,1,6
21288,1,2451,2378,73,0,100,1,6
21289,2,2412,2277,135,0,211,1,6
21290,2,2525,2651,-126,0,461,0,6
21291,1,2482,2380,102,0,43,0,6
21292,1,2523,2440,83,0,100,0,6
21293,2,2448,2229,219,0,4,1,6
21294,2,2448,2546,-98,0,200,1,6
21295,3,2559,2503,56,0,49,0,6
21296,1,2294,2565,-271,0,21,0,6
21297,1,2563,2511,52,0,210,0,6
21298,1,2464,2453,11,0,143,0,6
21299,3,2426,2257,169,0,5,0,6
21300,1,2408,2246,162,0,46,0,6
21301,1,2576,2653,-77,0,40,0,6
21302,2,2239,2558,-319,0,106,0,6
21303,3,2504,2451,53,0,310,0,6
21304,2,2289,2517,-228,0,306,1,6
21305,3,2607,2242,365,0,140,0,6
21306,1,2548,2558,-10,0,28,0,6
21307,2,2314,2416,-102,0,0,0,6
21308,1,2231,2723,-492,0,300,0,6
21309,3,2507,2485,22,0,132,0,6
21310,2,2518,2413,105,0,40,0,6
21311,2,2551,2243,308,0,331,0,6
21312,2,2320,2509,-189,0,40,0,6
21313,2,2408,2450,-42,0,151,0,6
21314,1,2426,2532,-106,0,105,0,6
21315,2,2411,2391,20,0,120,0,6
21316,1,2533,2418,115,0,100,0,6
21317,2,2442,2221,221,0,303,0,6
21318,3,2568,2349,219,0,143,0,6
21319,1,2418,2403,15,0,152,0,6
21320,2,2410,2337,73,0,125,0,8
21321,1,2409,2368,41,0,45,1,6
21322,2,2425,2453,-28,0,45,0,6
21323,2,2505,2587,-82,0,41,0,6
21324,1,2395,2439,-44,0,14,0,6
21325,2,2480,2581,-101,0,80,1,6
21326,1,2519,2370,149,0,344,0,6
21327,2,2275,2539,-264,0,61,0,6
21328,2,2503,2675,-172,0,414,0,6
21329,2,2340,2438,-98,0,200,0,6
21330,3,2360,2518,-158,0,206,0,6
21331,1,2636,2495,141,0,125,0,6
21332,1,2413,2425,-12,0,132,0,6
21333,1,2420,2310,110,0,200,0,6
21334,1,2215,2470,-255,0,0,0,6
21335,1,2353,2482,-129,0,125,0,6
21336,2,2325,2406,-81,0,6,1,6
21337,2,2243,2403,-160,0,15,0,6
21338,2,2383,2431,-48,0,324,0,6
21339,1,2209,2443,-234,0,428,0,6
21340,3,2645,2583,62,0,413,0,6
21341,3,2211,2412,-201,0,255,0,6
21342,1,2539,2464,75,0,110,0,6
21343,1,2411,2381,30,0,156,1,6
21344,1,2481,2220,261,0,101,0,6
21345,1,2448,2470,-22,0,301,0,6
21346,2,2331,2403,-72,0,100,0,6
21347,1,2518,2411,107,0,210,0,6
21348,2,2302,2412,-110,0,109,0,6
21349,2,2401,2655,-254,0,15,0,6
21350,2,2201,2452,-251,0,382,0,6
21351,2,2267,2486,-219,0,277,0,6
21352,2,2376,2418,-42,0,241,0,6
21353,1,2397,2401,-4,0,145,1,6
21354,2,2521,2422,99,0,315,1,6
21355,2,2211,2438,-227,0,300,1,6
21356,2,2324,2433,-109,0,152,0,6
21357,1,2424,2423,1,0,207,0,6
21358,2,2434,2449,-15,0,101,1,6
21359,3,2454,2559,-105,0,101,0,6
21360,2,2238,2439,-201,0,126,1,6
21361,1,2550,2443,107,0,150,1,6
21362,3,2524,2433,91,0,45,0,6
21363,1,2543,2612,-69,0,46,0,6
21364,2,2354,2700,-346,0,106,0,6
21365,1,2470,2224,246,0,10,0,6
21366,2,2511,2256,255,0,56,1,6
21367,2,2500,2270,230,0,140,0,6
21368,1,2467,2354,113,0,46,0,6
21369,1,2416,2298,118,0,146,1,6
21370,1,2537,2521,16,0,244,0,6
21371,2,2283,2450,-167,0,405,0,6
21372,3,2573,2420,153,0,46,0,6
21373,2,2220,2480,-260,0,46,0,6
21374,1,2558,2465,93,0,405,0,6
21375,2,2455,2626,-171,0,140,0,6
21376,1,2367,2419,-52,0,112,0,6
21377,2,2459,2387,72,0,110,0,6
21378,2,2591,2501,90,0,10,0,6
21379,1,2408,2326,82,0,153,0,6
21380,1,2404,2253,151,0,302,1,6
21381,1,2408,2357,51,0,3,1,6
21382,2,2373,2413,-40,0,255,0,6
21383,2,2380,2474,-94,0,124,0,6
21384,1,2348,2419,-71,0,245,0,6
21385,2,2261,2482,-221,0,41,0,6
21386,2,2406,2375,31,0,300,0,6
21387,2,2491,2643,-152,0,245,1,6
21388,1,2420,2470,-50,0,4,0,6
21389,2,2536,2585,-49,0,80,0,6
21390,3,2363,2516,-153,0,206,0,6
21391,1,2532,2269,263,0,151,0,6
21392,1,2479,2317,162,0,226,0,6
21393,2,2512,2376,136,0,115,0,6
21394,1,2411,2321,90,0,331,0,6
21395,2,2541,2534,7,0,311,0,6
21396,3,2477,2371,106,0,253,0,6
21397,3,2562,2500,62,0,49,0,6
21398,1,2480,2461,19,0,250,0,6
21399,1,2322,2412,-90,0,306,0,6
21400,1,2464,2454,10,0,143,0,6
21401,1,2522,2414,108,0,100,1,6
21402,1,2378,2417,-39,0,40,0,6
21403,1,2481,2353,128,0,142,0,6
21404,1,2565,2225,340,0,143,0,6
21405,2,2584,2643,-59,0,45,1,6
21406,1,2241,2423,-182,0,45,0,6
21407,3,2420,2363,57,0,45,0,6
21408,3,2444,2222,222,0,123,0,6
21409,2,2455,2403,52,0,242,0,6
21410,2,2412,2440,-28,0,0,0,6
21411,2,2528,2427,101,0,100,1,6
21412,1,2464,2471,-7,0,46,0,6
21413,3,2435,2350,85,0,4,0,6
21414,2,2376,2416,-40,0,217,0,6
21415,2,2407,2523,-116,0,3,0,6
21416,3,2352,2602,-250,0,45,0,6
21417,1,2520,2219,301,0,109,0,6
21418,1,2265,2434,-169,0,45,0,6
21419,1,2428,2374,54,0,176,0,6
21420,2,2432,2501,-69,0,301,0,6
21421,2,2368,2430,-62,0,411,0,6
21422,2,2421,2290,131,0,1,0,6
21423,1,2460,2543,-83,0,302,0,6
21424,2,2404,2402,2,0,302,0,6
21425,2,2351,2442,-91,0,205,0,6
21426,2,2515,2657,-142,0,487,0,6
21427,2,2276,2429,-153,0,115,0,6
21428,1,2418,2323,95,0,9,0,6
21429,2,2465,2514,-49,0,10,0,6
21430,1,2342,2702,-360,0,344,1,6
21431,1,2442,2235,207,0,242,1,6
21432,3,2265,2489,-224,0,301,0,6
21433,2,2434,2502,-68,0,8,0,6
21434,2,2522,2566,-44,0,107,0,6
21435,2,2429,2707,-278,0,300,1,6
21436,1,2439,2554,-115,0,200,0,6
21437,2,2244,2423,-179,0,107,0,6
21438,1,2411,2212,199,0,133,0,6
21439,3,2482,2629,-147,0,62,0,6
21440,1,2527,2403,124,0,13,0,6
21441,2,2584,2400,184,0,16,0,6
21442,1,2501,2409,92,0,155,0,6
21443,2,2269,2428,-159,0,131,1,6
21444,1,2506,2287,219,0,335,0,6
21445,1,2317,2415,-98,0,6,0,6
21446,2,2448,2470,-22,0,301,0,6
21447,1,2508,2585,-77,0,46,0,6
21448,1,2435,2363,72,0,100,0,6
21449,1,2419,2374,45,0,201,0,6
21450,1,2441,2484,-43,0,260,0,6
21451,1,2417,2258,159,0,40,0,6
21452,1,2362,2418,-56,0,301,1,6
21453,1,2273,2420,-147,0,250,0,6
21454,2,2335,2514,-179,0,133,1,6
21455,1,2650,2488,162,0,46,1,6
21456,2,2379,2473,-94,0,414,1,6
21457,1,2434,2312,122,0,380,0,6
21458,2,2400,2445,-45,0,247,0,6
21459,1,2436,2365,71,0,103,0,6
21460,1,2475,2443,32,0,140,1,6
21461,1,2466,2354,112,0,46,1,6
21462,2,2470,2355,115,0,45,1,6
21463,1,2413,2376,37,0,125,0,6
21464,2,2214,2415,-201,0,200,0,6
21465,2,2405,2329,76,0,153,0,6
21466,1,2531,2360,171,0,51,0,6
21467,2,2410,2526,-116,0,301,0,6
21468,2,2434,2231,203,0,46,0,6
21469,1,2419,2220,199,0,108,0,6
21470,2,2373,2476,-103,0,470,0,6
21471,2,2303,2413,-110,0,2,1,6
21472,1,2445,2407,38,0,11,0,6
21473,2,2364,2410,-46,0,46,1,6
21474,1,2524,2327,197,0,43,0,6
21475,1,2649,2580,69,0,413,0,6
21476,1,2433,2272,161,0,308,0,6
21477,3,2562,2482,80,0,337,0,6
21478,1,2479,2453,26,0,110,0,6
21479,3,2461,2350,111,0,343,0,6
21480,1,2456,2323,133,0,80,0,6
21481,2,2410,2229,181,0,302,0,6
21482,1,2486,2437,49,0,100,0,6
21483,1,2552,2606,-54,0,34,0,6
21484,2,2308,2486,-178,4,22,0,13
21485,1,2304,2496,-192,0,141,1,6
21486,2,2384,2423,-39,0,46,0,6
21487,1,2483,2414,69,0,140,0,6
21488,1,2446,2561,-115,0,319,0,6
21489,1,2512,2459,53,0,330,1,6
21490,1,2539,2298,241,0,106,0,6
21491,2,2334,2433,-99,0,143,1,6
21492,2,2421,2371,50,0,156,0,6
21493,2,2423,2571,-148,0,242,0,6
21494,1,2426,2299,127,0,404,1,6
21495,2,2290,2485,-195,0,41,0,6
21496,3,2660,2531,129,0,245,0,6
21497,2,2399,2576,-177,0,2,0,6
21498,2,2336,2541,-205,0,300,0,6
21499,2,2506,2370,136,0,45,1,6
21500,1,2431,2521,-90,0,217,0,6
21501,1,2590,2428,162,0,264,1,6
21502,1,2409,2578,-169,0,100,0,6
21503,1,2411,2252,159,0,107,0,6
21504,1,2534,2305,229,0,131,0,6
21505,2,2441,2270,171,0,34,0,6
21506,2,2414,2535,-121,0,46,0,6
21507,2,2450,2460,-10,0,41,1,6
21508,1,2428,2249,179,0,40,0,6
21509,1,2710,2448,262,0,122,0,6
21510,1,2346,2402,-56,0,7,0,6
21511,2,2233,2445,-212,0,115,1,6
21512,1,2480,2368,112,0,21,0,6
21513,3,2227,2429,-202,0,40,0,6
21514,2,2415,2599,-184,0,101,0,6
21515,2,2359,2439,-80,0,411,1,6
21516,3,2513,2366,147,0,414,0,6
21517,2,2210,2517,-307,0,177,1,6
21518,2,2369,2479,-110,0,0,0,6
21519,1,2547,2447,100,0,120,0,6
21520,3,2692,2259,433,0,57,0,6
21521,1,2579,2515,64,0,54,1,6
21522,2,2552,2534,18,0,40,0,6
21523,2,2433,2386,47,0,462,0,6
21524,1,2352,2491,-139,0,46,0,6
21525,2,2338,2408,-70,0,13,0,6
21526,2,2296,2513,-217,0,201,0,6
21527,3,2679,2425,254,0,4,0,6
21528,2,2485,2656,-171,0,148,0,6
21529,1,2439,2259,180,0,303,0,6
21530,3,2575,2654,-79,0,440,0,6
21531,1,2450,2219,231,0,469,0,6
21532,1,2553,2488,65,0,337,0,6
21533,2,2530,2406,124,0,100,0,6
21534,2,2402,2292,110,0,302,1,6
21535,2,2345,2557,-212,0,146,0,6
21536,2,2438,2480,-42,0,4,1,6
21537,3,2536,2373,163,0,345,0,6
21538,3,2377,2481,-104,0,284,0,6
21539,2,2528,2396,132,0,210,0,6
21540,1,2308,2485,-177,0,140,0,6
21541,3,2454,2470,-16,0,58,0,6
21542,1,2426,2272,154,0,8,0,6
21543,2,2208,2418,-210,0,107,0,6
21544,2,2384,2420,-36,0,101,1,6
21545,2,2394,2412,-18,0,330,0,6
21546,1,2417,2297,120,0,1,0,6
21547,3,2215,2459,-244,0,302,0,6
21548,1,2465,2414,51,0,234,0,6
21549,1,2377,2415,-38,0,216,0,6
21550,1,2489,2527,-38,0,211,1,6
21551,2,2311,2424,-113,0,6,1,6
21552,2,2357,2416,-59,0,45,0,6
21553,2,2428,2379,49,0,15,1,6
21554,2,2318,2784,-466,4,45,0,8
21555,3,2455,2386,69,0,122,0,6
21556,1,2426,2202,224,0,311,0,6
21557,1,2486,2453,33,0,309,0,6
21558,1,2596,2389,207,0,412,0,6
21559,1,2658,2602,56,0,194,0,6
21560,1,2294,2437,-143,0,301,0,6
21561,1,2586,2533,53,0,398,1,6
21562,1,2627,2378,249,0,14,0,6
21563,2,2484,2227,257,0,43,0,6
21564,1,2238,2409,-171,0,248,1,6
21565,1,2327,2445,-118,0,300,0,6
21566,3,2511,2417,94,0,46,0,6
21567,2,2291,2421,-130,0,2,0,6
21568,2,2287,2412,-125,0,1,0,6
21569,1,2425,2269,156,0,101,0,6
21570,2,2234,2713,-479,0,101,0,6
21571,1,2446,2296,150,0,170,0,6
21572,2,2403,2331,72,0,386,0,6
21573,1,2436,2339,97,0,10,0,6
21574,1,2414,2523,-109,0,301,0,6
21575,2,2593,2488,105,0,121,0,6
21576,1,2438,2329,109,0,338,0,6
21577,1,2280,2436,-156,0,46,0,6
21578,1,2362,2508,-146,0,245,0,6
21579,1,2488,2261,227,0,335,0,6
21580,1,2530,2336,194,0,334,0,6
21581,3,2599,2412,187,0,327,0,6
21582,1,2687,2559,128,0,141,0,6
21583,1,2365,2484,-119,0,43,0,6
21584,2,2304,2415,-111,0,242,0,6
21585,2,2293,2552,-259,0,306,0,6
21586,1,2444,2354,90,0,148,0,6
21587,1,2519,2309,210,0,131,0,6
21588,3,2574,2419,155,0,325,0,6
21589,1,2598,2466,132,0,457,0,6
21590,1,2483,2445,38,0,103,0,6
21591,1,2448,2230,218,0,225,0,6
21592,3,2558,2462,96,0,49,0,6
21593,3,2439,2483,-44,0,301,0,6
21594,3,2498,2386,112,4,110,0,13
21595,1,2597,2404,193,0,40,0,6
21596,2,2443,2551,-108,0,132,0,6
21597,1,2546,2386,160,0,45,0,6
21598,2,2510,2526,-16,0,45,0,6
21599,2,2464,2385,79,0,7,0,6
21600,2,2661,2482,179,0,4,1,6
21601,1,2540,2395,145,0,102,0,6
21602,2,2412,2409,3,0,43,1,6
21603,2,2310,2413,-103,0,247,0,6
21604,1,2429,2384,45,0,156,1,6
21605,2,2393,2520,-127,0,101,0,6
21606,2,2500,2459,41,0,429,1,6
21607,1,2675,2629,46,0,4,0,6
21608,1,2485,2433,52,0,1,0,6
21609,2,2253,2453,-200,0,300,0,6
21610,2,2539,2418,121,0,90,0,6
21611,3,2240,2410,-170,0,53,0,6
21612,2,2426,2479,-53,0,406,0,6
21613,1,2482,2445,37,0,120,0,6
21614,1,2409,2206,203,0,135,0,6
21615,3,2427,2327,100,0,46,0,6
21616,3,2297,2429,-132,0,121,0,6
21617,2,2400,2294,106,0,45,0,6
21618,1,2524,2367,157,0,242,0,6
21619,1,2424,2285,139,0,102,1,6
21620,1,2423,2285,138,0,101,0,6
21621,2,2462,2535,-73,0,337,0,6
21622,1,2326,2467,-141,0,331,0,6
21623,2,2306,2500,-194,0,15,0,6
21624,2,2276,2479,-203,0,230,0,6
21625,2,2242,2495,-253,0,1,0,6
21626,1,2506,2355,151,0,4,0,6
21627,2,2369,2549,-180,0,9,1,6
21628,2,2369,2511,-142,0,206,0,6
21629,2,2376,2534,-158,0,302,0,6
21630,1,2786,2317,469,4,100,0,8
21631,1,2309,2428,-119,0,123,0,6
21632,2,2433,2606,-173,0,90,0,6
21633,2,2419,2386,33,0,115,1,6
21634,1,2434,2324,110,0,49,0,6
21635,3,2319,2443,-124,0,177,0,6
21636,2,2603,2440,163,0,253,0,6
21637,1,2399,2543,-144,0,152,0,6
21638,1,2516,2491,25,0,278,0,6
21639,2,2465,2476,-11,0,4,1,6
21640,2,2515,2421,94,0,100,0,6
21642,2,2258,2428,-170,0,122,1,6
21643,3,2350,2448,-98,0,411,0,6
21645,2,2362,2407,-45,0,45,0,6
21646,1,2714,2370,344,0,122,0,6
21647,2,2295,2433,-138,0,13,0,6
21648,1,2401,2288,113,0,21,0,6
21650,1,2488,2207,281,0,200,1,6
21651,2,2400,2259,141,0,205,0,6
21652,1,2417,2306,111,0,40,0,6
21653,2,2228,2450,-222,0,126,1,6
21654,1,2458,2280,178,0,200,0,6
21655,2,2415,2556,-141,0,211,0,6
21656,2,2244,2596,-352,0,123,0,6
21657,3,2418,2415,3,0,302,0,6
21658,1,2434,2449,-15,0,45,0,6
21659,3,2460,2293,167,0,4,0,6
21660,1,2299,2489,-190,0,343,0,6
21661,1,2544,2527,17,0,15,1,6
21662,2,2318,2445,-127,0,460,0,6
21663,1,2419,2392,27,0,45,0,6
21664,1,2560,2302,258,0,106,0,6
21665,2,2546,2454,92,0,49,0,6
21666,2,2246,2429,-183,0,107,0,6
21667,1,2375,2418,-43,0,300,1,6
21668,1,2295,2522,-227,0,210,1,6
21669,2,2452,2534,-82,0,110,0,6
21670,2,2295,2442,-147,0,203,0,6
21671,1,2497,2316,181,0,192,0,6
21672,1,2419,2402,17,0,285,0,6
21673,1,2392,2431,-39,0,100,0,6
21674,3,2430,2457,-27,0,5,0,6
21675,1,2469,2537,-68,0,46,1,6
21676,2,2314,2434,-120,0,343,0,6
21677,3,2379,2415,-36,0,172,0,6
21678,1,2554,2479,75,0,245,0,6
21679,3,2482,2440,42,0,106,0,6
21680,1,2425,2315,110,0,40,1,6
21681,1,2440,2343,97,0,412,0,6
21682,3,2346,2475,-129,0,125,0,6
21683,2,2302,2484,-182,0,250,0,6
21684,1,2456,2532,-76,0,62,1,6
21685,1,2508,2490,18,0,122,0,6
21686,1,2443,2282,161,0,101,0,6
21687,1,2466,2456,10,0,463,0,6
21688,1,2412,2494,-82,0,101,0,6
21689,2,2247,2430,-183,0,40,0,6
21690,2,2461,2540,-79,0,0,1,6
21691,3,2335,2573,-238,0,41,0,6
21692,2,2352,2402,-50,0,45,0,6
21693,2,2515,2365,150,0,414,0,6
21694,3,2503,2506,-3,0,394,0,6
21695,1,2242,2420,-178,0,6,0,6
21696,1,2421,2429,-8,0,400,0,6
21697,3,2529,2538,-9,0,111,0,6
21698,2,2350,2421,-71,0,13,0,6
21699,2,2233,2450,-217,0,36,0,6
21700,1,2281,2483,-202,0,301,1,6
21701,2,2552,2602,-50,0,45,0,6
21702,1,2441,2261,180,0,45,0,6
21703,2,2427,2398,29,0,462,0,6
21704,3,2490,2240,250,0,107,0,6
21705,1,2430,2451,-21,0,337,0,6
21706,2,2302,2421,-119,0,246,0,6
21707,2,2373,2680,-307,0,106,0,6
21708,3,2624,2449,175,0,485,0,6
21709,2,2487,2544,-57,0,201,0,6
21710,2,2315,2419,-104,0,373,0,6
21711,2,2533,2213,320,0,10,0,6
21712,1,2560,2598,-38,0,405,0,6
21713,2,2285,2411,-126,0,56,0,6
21714,1,2432,2392,40,0,107,1,6
21715,2,2401,2673,-272,0,2,0,6
21716,1,2447,2489,-42,0,250,0,6
21717,2,2269,2415,-146,0,126,0,6
21718,3,2424,2538,-114,0,7,0,6
21719,3,2373,2419,-46,0,201,0,6
21720,1,2492,2297,195,0,381,1,6
21721,2,2405,2427,-22,0,463,0,6
21722,2,2441,2553,-112,0,106,1,6
21723,2,2421,2332,89,0,101,0,6
21724,2,2229,2523,-294,0,211,0,6
21725,3,2236,2461,-225,0,1,0,6
21726,2,2415,2583,-168,0,87,0,6
21727,1,2318,2509,-191,0,123,0,6
21728,2,2486,2376,110,0,464,0,6
21729,1,2461,2432,29,0,307,0,6
21730,3,2425,2298,127,0,40,0,6
21731,1,2453,2225,228,0,1,0,6
21732,2,2209,2424,-215,0,315,1,6
21733,2,2520,2549,-29,0,112,0,6
21734,2,2438,2334,104,0,190,0,6
21735,3,2513,2363,150,0,140,0,6
21736,2,2323,2545,-222,0,145,0,6
21737,1,2563,2366,197,0,260,0,6
21738,1,2487,2447,40,0,308,1,6
21739,2,2318,2482,-164,0,41,0,6
21740,3,2549,2356,193,0,400,0,6
21741,1,2402,2232,170,0,311,0,6
21742,1,2483,2453,30,0,205,0,6
21743,2,2448,2284,164,0,13,0,6
21744,3,2407,2595,-188,0,101,0,6
21745,2,2395,2584,-189,0,241,0,6
21746,3,2433,2359,74,0,8,0,6
21747,1,2425,2537,-112,0,151,0,6
21748,3,2289,2420,-131,0,43,0,6
21749,2,2299,2514,-215,0,255,0,6
21750,2,2506,2426,80,0,100,0,6
21751,2,2537,2503,34,0,49,0,6
21752,2,2267,2474,-207,0,2,0,6
21753,2,2675,2399,276,0,95,0,6
21754,1,2607,2548,59,0,7,0,6
21755,3,2436,2440,-4,0,115,0,6
21756,2,2240,2407,-167,0,58,1,6
21757,1,2535,2243,292,0,133,0,6
21758,3,2339,2407,-68,0,101,0,6
21759,3,2411,2257,154,0,354,0,6
21760,1,2554,2515,39,0,300,0,6
21761,3,2302,2441,-139,0,107,0,6
21762,1,2425,2436,-11,0,301,1,6
21763,1,2402,2236,166,0,490,0,6
21764,3,2281,2473,-192,0,43,0,6
21765,2,2423,2427,-4,0,135,1,6
21766,1,2457,2309,148,0,0,1,6
21767,2,2360,2432,-72,0,43,1,6
21768,3,2467,2432,35,0,337,0,6
21769,1,2476,2251,225,0,49,0,6
21770,3,2446,2500,-54,0,132,0,6
21771,2,2485,2538,-53,0,112,0,6
21772,2,2448,2488,-40,0,255,1,6
21773,2,2395,2474,-79,0,278,0,6
21774,2,2358,2436,-78,0,96,0,6
21775,1,2295,2441,-146,0,106,0,6
21776,2,2214,2482,-268,0,227,0,6
21777,1,2537,2433,104,0,177,0,6
21778,2,2316,2446,-130,0,0,1,6
21779,2,2339,2432,-93,0,200,0,6
21780,1,2452,2472,-20,0,194,0,6
21781,1,2453,2369,84,0,107,0,6
21782,1,2622,2324,298,0,35,0,6
21783,2,2457,2334,123,0,205,0,6
21784,1,2437,2431,6,0,125,0,6
21785,1,2427,2256,171,0,2,0,6
21786,2,2223,2455,-232,0,126,1,6
21787,2,2423,2388,35,0,107,0,6
21788,2,2428,2387,41,0,345,1,6
21789,1,2544,2529,15,0,398,1,6
21790,1,2300,2408,-108,0,200,0,6
21791,1,2409,2665,-256,0,2,0,6
21792,3,2375,2507,-132,0,206,0,6
21793,2,2444,2244,200,0,40,0,6
21794,1,2717,2355,362,0,246,0,6
21795,1,2477,2271,206,0,8,0,6
21796,1,2693,2463,230,0,272,0,6
21797,3,2525,2284,241,0,106,0,6
21798,1,2557,2437,120,0,300,0,6
21799,1,2470,2458,12,0,45,0,6
21800,2,2485,2445,40,0,310,0,6
21801,1,2315,2523,-208,0,395,1,6
21802,3,2525,2280,245,0,311,0,6
21803,2,2591,2365,226,0,455,0,6
21804,3,2406,2222,184,0,9,0,6
21805,3,2436,2392,44,0,207,0,6
21807,2,2387,2418,-31,0,380,1,6
21808,2,2442,2365,77,0,202,0,6
21809,2,2335,2516,-181,0,245,0,6
21810,2,2280,2495,-215,0,34,0,6
21811,1,2543,2373,170,0,40,0,6
21812,1,2440,2437,3,0,18,0,6
21813,2,2306,2405,-99,0,150,0,6
21814,2,2390,2568,-178,0,46,0,6
21815,1,2548,2300,248,0,45,0,6
21816,1,2510,2374,136,0,43,0,6
21817,2,2530,2499,31,0,40,0,6
21818,2,2308,2442,-134,0,125,0,6
21819,2,2510,2560,-50,0,118,0,6
21820,1,2418,2523,-105,0,202,0,6
21821,2,2408,2462,-54,0,112,0,6
21822,1,2374,2452,-78,0,106,1,6
21823,1,2305,2419,-114,0,145,1,6
21824,1,2405,2296,109,0,485,0,6
21825,1,2449,2396,53,0,220,1,8
21826,3,2433,2506,-73,0,5,0,6
21827,2,2383,2543,-160,0,302,0,6
21828,2,2335,2486,-151,0,265,0,6
21829,2,2257,2440,-183,0,1,0,6
21830,2,2501,2430,71,0,101,0,6
21831,1,2401,2347,54,0,301,0,6
21832,1,2433,2484,-51,0,80,0,6
21833,1,2543,2441,102,0,200,0,6
21834,1,2656,2418,238,0,210,0,6
21835,2,2542,2480,62,0,110,0,6
21836,1,2354,2430,-76,0,461,0,6
21837,1,2234,2485,-251,0,225,0,6
21838,2,2277,2479,-202,0,122,0,6
21839,1,2560,2291,269,0,133,0,6
21840,1,2364,2521,-157,0,154,0,6
21841,2,2288,2566,-278,0,2,0,6
21842,1,2426,2492,-66,0,288,0,6
21843,1,2357,2402,-45,0,335,0,6
21844,1,2291,2432,-141,0,45,0,6
21845,1,2546,2623,-77,0,43,0,6
21846,1,2470,2241,229,0,330,0,6
21847,1,2493,2443,50,0,211,0,6
21848,2,2417,2375,42,0,347,0,6
21849,2,2424,2275,149,0,101,0,6
21850,1,2460,2445,15,0,4,0,6
21851,2,2473,2271,202,0,101,1,6
21852,2,2343,2449,-106,0,4,0,6
21853,1,2302,2435,-133,0,22,1,6
21854,1,2531,2371,160,0,131,0,6
21855,1,2452,2573,-121,0,9,1,6
21856,1,2505,2377,128,0,414,0,6
21857,1,2342,2409,-67,0,254,0,6
21858,3,2541,2410,131,0,196,0,6
21859,1,2406,2530,-124,0,45,0,6
21860,2,2313,2429,-116,0,51,0,6
21861,2,2367,2476,-109,0,324,0,6
21862,3,2506,2481,25,0,245,0,6
21863,1,2457,2524,-67,0,106,0,6
21864,2,2658,2612,46,0,100,0,6
21865,2,2208,2460,-252,0,483,0,6
21866,1,2305,2457,-152,0,185,0,6
21867,1,2458,2220,238,0,0,1,6
21868,2,2393,2422,-29,0,409,0,6
21869,2,2364,2419,-55,0,320,0,6
21870,3,2316,2521,-205,0,211,0,6
21871,2,2571,2675,-104,0,4,0,6
21872,2,2436,2369,67,0,40,0,6
21873,3,2486,2546,-60,0,40,0,6
21874,2,2452,2229,223,0,302,0,6
21875,1,2294,2513,-219,0,109,0,6
21876,2,2300,2450,-150,0,200,0,6
21877,1,2332,2504,-172,0,100,0,6
21878,2,2519,2384,135,0,122,0,6
21879,1,2328,2447,-119,0,113,0,6
21880,2,2499,2219,280,0,102,0,6
21881,3,2439,2313,126,0,140,0,6
21882,2,2259,2567,-308,0,1,0,6
21883,2,2522,2550,-28,0,202,1,6
21884,1,2479,2433,46,0,100,0,6
21885,3,2274,2466,-192,0,216,0,6
21886,2,2327,2436,-109,0,320,1,6
21887,1,2425,2297,128,0,101,0,6
21888,1,2446,2304,142,0,100,0,6
21889,1,2568,2248,320,0,143,1,6
21890,2,2616,2434,182,0,9,0,6
21891,2,2392,2553,-161,0,123,0,6
21892,1,2438,2498,-60,0,146,0,6
21893,3,2313,2402,-89,0,411,0,6
21894,1,2719,2257,462,0,200,0,6
21895,1,2565,2505,60,0,308,0,6
21896,2,2412,2291,121,4,4,1,13
21897,3,2466,2472,-6,0,360,0,6
21898,2,2505,2458,47,0,245,0,6
21899,1,2481,2357,124,0,67,1,6
21900,3,2374,2460,-86,0,271,0,6
21901,3,2286,2695,-409,0,3,0,6
21902,3,2222,2419,-197,0,150,0,6
21903,1,2366,2562,-196,0,241,0,6
21904,1,2437,2380,57,0,466,1,6
21905,3,2440,2376,64,0,31,0,6
21906,1,2547,2393,154,0,101,1,6
21907,2,2358,2456,-98,0,304,0,6
21908,2,2445,2535,-90,0,485,0,6
21909,2,2487,2548,-61,0,140,0,6
21910,2,2379,2466,-87,0,41,0,6
21911,2,2477,2266,211,0,225,0,6
21912,1,2518,2440,78,0,40,0,6
21913,1,2518,2505,13,0,43,0,6
21914,2,2363,2464,-101,0,132,0,6
21915,1,2314,2406,-92,0,4,0,6
21916,2,2423,2370,53,0,464,0,6
21917,2,2208,2420,-212,0,134,0,6
21918,2,2462,2560,-98,0,4,0,6
21919,3,2240,2410,-170,0,268,0,6
21920,2,2248,2490,-242,0,1,0,6
21921,2,2618,2652,-34,0,4,0,6
21922,1,2504,2514,-10,0,359,0,6
21923,3,2435,2303,132,0,4,0,6
21924,1,2513,2410,103,0,62,0,6
21925,1,2569,2372,197,0,336,1,6
21926,2,2392,2407,-15,0,337,0,6
21927,1,2503,2230,273,0,247,0,6
21928,1,2342,2430,-88,0,16,0,6
21929,2,2402,2359,43,0,192,0,6
21930,1,2492,2438,54,0,177,1,6
21931,3,2436,2442,-6,0,302,0,6
21932,2,2289,2429,-140,0,145,0,6
21933,1,2566,2409,157,0,101,0,6
21934,1,2566,2460,106,0,10,0,6
21935,2,2445,2539,-94,0,20,0,6
21936,1,2556,2316,240,0,469,0,6
21937,1,2535,2389,146,0,112,0,6
21938,1,2567,2482,85,0,428,0,6
21939,2,2218,2460,-242,0,101,0,6
21940,3,2451,2395,56,0,122,0,6
21941,2,2388,2424,-36,0,340,0,6
21942,2,2359,2487,-128,0,398,0,6
21943,3,2423,2510,-87,0,291,0,6
21944,1,2545,2429,116,0,45,1,6
21945,1,2690,2352,338,0,10,0,6
21946,1,2512,2209,303,0,245,0,6
21947,2,2496,2450,46,0,230,0,6
21948,2,2373,2508,-135,0,466,0,6
21949,1,2492,2445,47,0,205,1,6
21950,1,2469,2359,110,0,302,0,6
21951,1,2468,2385,83,0,112,0,6
21952,3,2380,2539,-159,0,145,0,6
21953,2,2582,2247,335,0,108,0,6
21954,3,2259,2407,-148,0,1,0,6
21955,1,2440,2301,139,0,100,0,6
21956,1,2517,2568,-51,0,220,0,6
21957,2,2315,2417,-102,0,487,0,6
21958,3,2290,2720,-430,0,101,0,6
21959,2,2490,2418,72,0,402,1,6
21960,3,2437,2692,-255,0,3,0,6
21961,1,2477,2266,211,0,45,0,6
21962,1,2470,2375,95,0,9,0,6
21963,2,2500,2569,-69,0,110,1,6
21964,2,2207,2468,-261,0,45,0,6
21965,2,2406,2572,-166,0,338,0,6
21966,3,2465,2473,-8,0,133,0,6
21967,3,2289,2499,-210,0,43,0,6
21968,2,2383,2555,-172,0,49,0,6
21969,3,2468,2309,159,0,123,0,6
21970,1,2238,2403,-165,0,7,0,6
21971,1,2657,2551,106,0,41,0,6
21972,2,2442,2441,1,0,40,1,6
21973,1,2371,2474,-103,0,0,0,6
21974,1,2408,2242,166,0,481,0,6
21975,1,2439,2497,-58,0,49,0,6
21976,3,2377,2506,-129,0,434,0,6
21977,2,2433,2249,184,0,41,0,6
21978,3,2310,2480,-170,0,324,0,6
21979,2,2539,2349,190,0,190,0,6
21980,1,2513,2312,201,0,107,1,6
21982,3,2433,2569,-136,0,112,0,6
21983,1,2348,2424,-76,0,242,0,6
21984,2,2297,2443,-146,0,107,0,6
21985,1,2353,2406,-53,0,17,0,6
21986,2,2294,2429,-135,0,101,0,6
21987,1,2430,2276,154,0,300,0,6
21988,2,2325,2401,-76,0,102,0,6
21989,2,2523,2561,-38,0,225,1,6
21990,1,2482,2217,265,0,302,0,6
21991,1,2478,2572,-94,0,201,0,6
21992,2,2239,2411,-172,0,268,1,6
21993,2,2462,2216,246,0,4,0,6
21994,1,2429,2383,46,0,1,0,6
21995,1,2503,2441,62,0,25,0,6
21996,1,2454,2438,16,0,267,1,6
21997,2,2404,2434,-30,0,46,0,6
21998,2,2520,2511,9,0,149,0,6
21999,1,2547,2531,16,0,107,0,6
22000,2,2456,2400,56,0,114,1,6
22001,3,2682,2468,214,0,14,0,6
22002,2,2358,2523,-165,0,11,0,6
22003,3,2679,2489,190,0,240,0,6
22004,1,2440,2497,-57,0,250,0,6
22005,1,2259,2435,-176,0,145,1,6
22006,1,2252,2421,-169,0,487,0,6
22007,1,2423,2549,-126,0,9,1,6
22008,2,2288,2403,-115,0,50,0,6
22009,3,2432,2484,-52,0,250,0,6
22010,1,2405,2363,42,0,123,0,6
22011,1,2574,2496,78,0,302,0,6
22012,1,2329,2423,-94,0,0,0,6
22013,2,2427,2279,148,0,101,0,6
22014,2,2558,2380,178,0,404,0,6
22015,2,2615,2575,40,0,113,0,6
22016,2,2436,2473,-37,0,418,1,6
22017,1,2512,2369,143,0,414,0,6
22018,1,2272,2434,-162,0,177,1,6
22019,2,2564,2485,79,0,335,0,6
22020,3,2400,2360,40,0,46,0,6
22021,1,2392,2406,-14,0,102,0,6
22022,1,2447,2294,153,0,40,0,6
22023,1,2321,2516,-195,0,226,0,6
22024,1,2581,2566,15,0,306,1,6
22025,1,2517,2262,255,0,58,0,6
22026,1,2414,2236,178,0,482,0,6
22027,1,2430,2443,-13,0,123,0,6
22028,2,2311,2485,-174,0,112,1,6
22029,1,2483,2373,110,0,200,1,6
22030,1,2445,2286,159,0,352,0,6
22031,1,2419,2432,-13,0,470,0,6
22032,2,2363,2446,-83,0,330,0,6
22033,3,2303,2508,-205,0,46,0,6
22034,1,2518,2676,-158,0,111,0,6
22035,1,2447,2552,-105,0,112,0,6
22036,1,2525,2440,85,0,103,0,6
22037,2,2225,2453,-228,0,106,0,6
22038,1,2419,2257,162,0,133,0,6
22039,1,2406,2355,51,0,480,0,6
22040,1,2378,2527,-149,0,332,1,6
22041,2,2492,2557,-65,0,202,0,6
22042,2,2417,2401,16,0,267,0,6
22043,2,2292,2434,-142,0,1,0,6
22044,2,2483,2492,-9,0,52,0,6
22045,1,2412,2450,-38,0,21,1,6
22046,2,2550,2530,20,0,456,0,6
22047,1,2427,2290,137,0,100,0,6
22048,1,2436,2508,-72,0,20,1,6
22049,2,2407,2541,-134,0,40,0,6
22050,1,2491,2579,-88,0,112,1,6
22051,2,2256,2431,-175,0,40,0,6
22052,1,2404,2479,-75,0,194,0,6
22053,1,2233,2417,-184,0,268,1,6
22054,1,2369,2497,-128,0,353,0,6
22055,1,2400,2398,2,0,100,0,6
22056,1,2439,2460,-21,0,112,0,6
22057,1,2425,2281,144,0,130,0,6
22058,3,2378,2487,-109,0,300,0,6
22059,1,2545,2475,70,0,123,0,6
22060,1,2455,2554,-99,0,190,0,6
22061,2,2438,2457,-19,0,373,0,6
22062,1,2379,2470,-91,0,46,0,6
22063,1,2562,2421,141,0,45,1,6
22064,2,2477,2434,43,0,40,0,6
22065,1,2487,2591,-104,0,254,0,6
22066,1,2441,2358,83,0,120,0,6
22067,1,2456,2223,233,0,25,1,6
22068,2,2561,2416,145,0,0,0,6
22069,1,2587,2430,157,0,312,1,6
22070,1,2511,2305,206,0,246,0,6
22071,2,2287,2423,-136,0,101,0,6
22072,1,2369,2471,-102,0,404,0,6
22073,1,2587,2406,181,0,202,0,6
22074,2,2490,2353,137,0,101,0,6
22075,1,2498,2668,-170,0,115,0,6
22076,2,2353,2550,-197,0,112,0,6
22077,3,2390,2482,-92,0,103,0,6
22078,1,2486,2376,110,0,130,0,6
22079,1,2411,2350,61,0,154,1,6
22080,2,2350,2536,-186,0,4,0,6
22081,2,2544,2464,80,0,13,0,6
22082,2,2388,2519,-131,0,302,0,6
22083,2,2553,2495,58,0,124,1,6
22085,1,2553,2584,-31,0,0,0,6
22086,2,2386,2498,-112,0,314,1,6
22087,3,2425,2480,-55,0,45,0,6
22088,1,2472,2449,23,0,335,1,6
22089,1,2432,2443,-11,0,88,1,6
22090,1,2393,2406,-13,0,102,0,6
22091,2,2424,2545,-121,0,2,0,6
22092,1,2404,2411,-7,0,58,0,6
22093,1,2426,2430,-4,0,145,0,6
22094,2,2257,2415,-158,0,41,0,6
22095,3,2409,2336,73,0,107,0,6
22096,1,2404,2356,48,0,40,1,6
22097,1,2498,2269,229,4,151,0,13
22098,1,2482,2403,79,0,210,0,6
22099,3,2590,2566,24,0,200,0,6
22100,2,2463,2389,74,0,101,1,6
22101,2,2263,2426,-163,0,101,0,6
22102,1,2220,2458,-238,0,210,1,6
22103,2,2302,2520,-218,0,101,0,6
22104,1,2427,2283,144,0,100,0,6
22105,3,2494,2202,292,0,302,0,6
22106,3,2520,2210,310,0,45,0,6
22107,2,2480,2590,-110,0,400,0,6
22108,1,2522,2402,120,0,195,1,6
22109,1,2414,2423,-9,0,130,0,6
22110,2,2372,2492,-120,0,353,0,6
22111,2,2399,2487,-88,0,278,1,6
22112,1,2407,2239,168,0,210,0,6
22113,2,2440,2430,10,0,110,0,6
22114,1,2660,2476,184,0,103,0,6
22115,2,2427,2305,122,0,98,1,6
22116,2,2237,2404,-167,0,302,1,6
22117,1,2594,2462,132,0,461,0,6
22118,3,2678,2472,206,0,152,0,6
22119,2,2485,2366,119,0,130,1,6
22120,1,2538,2473,65,0,130,1,8
22121,1,2549,2477,72,0,45,0,6
22122,1,2310,2426,-116,0,311,0,6
22123,3,2337,2408,-71,0,246,0,6
22124,2,2400,2399,1,0,100,1,6
22125,1,2444,2347,97,0,151,0,6
22126,2,2405,2409,-4,0,113,0,6
22127,2,2546,2562,-16,0,112,0,6
22128,1,2416,2254,162,0,1,1,6
22129,2,2420,2537,-117,0,3,0,6
22130,2,2419,2382,37,0,345,0,6
22131,2,2351,2409,-58,0,343,0,6
22132,1,2502,2334,168,0,200,0,6
22133,2,2420,2432,-12,0,190,1,6
22134,2,2393,2438,-45,0,0,1,6
22135,1,2428,2326,102,0,118,0,6
22136,3,2448,2278,170,0,176,0,6
22137,2,2311,2434,-123,0,136,1,6
22138,2,2559,2464,95,0,0,0,6
22139,2,2203,2481,-278,0,18,0,6
22140,2,2280,2430,-150,0,100,0,6
22141,1,2566,2589,-23,0,386,1,6
22142,2,2413,2339,74,0,28,0,6
22143,1,2399,2456,-57,0,46,0,6
22144,2,2389,2418,-29,0,315,0,6
22145,2,2511,2451,60,0,330,1,6
22146,1,2567,2416,151,0,4,0,6
22147,1,2435,2541,-106,0,207,0,6
22148,1,2497,2369,128,0,152,0,6
22149,1,2491,2395,96,0,192,0,6
22150,2,2299,2435,-136,0,267,0,6
22151,2,2415,2399,16,0,58,0,6
22152,1,2473,2338,135,0,4,0,6
22153,3,2475,2303,172,0,302,0,6
22154,2,2526,2374,152,0,110,1,6
22155,2,2331,2506,-175,0,6,0,6
22156,2,2419,2503,-84,0,46,0,6
22157,1,2299,2470,-171,0,218,0,6
22158,2,2423,2373,50,0,311,0,6
22159,2,2365,2502,-137,0,245,0,6
22160,1,2404,2394,10,0,66,0,6
22161,3,2354,2460,-106,0,324,0,6
22162,1,2313,2448,-135,0,123,0,6
22163,1,2414,2346,68,0,112,1,6
22164,1,2553,2589,-36,0,45,0,6
22165,2,2411,2350,61,0,291,1,6
22166,3,2434,2276,158,0,100,0,6
22167,1,2332,2465,-133,0,463,0,6
22168,1,2447,2598,-151,0,449,0,6
22169,3,2342,2516,-174,0,302,0,6
22170,2,2401,2314,87,0,412,0,6
22171,2,2443,2351,92,0,46,0,6
22172,2,2350,2495,-145,0,245,0,6
22173,2,2347,2543,-196,0,190,1,6
22174,2,2390,2535,-145,0,122,0,6
22175,1,2506,2445,61,0,107,0,6
22176,2,2583,2572,11,0,202,0,6
22177,1,2452,2310,142,0,335,0,6
22178,2,2413,2552,-139,0,2,0,6
22179,1,2472,2571,-99,0,112,0,6
22180,1,2450,2406,44,0,167,0,6
22181,1,2545,2334,211,0,4,0,6
22182,1,2423,2384,39,0,300,1,6
22183,2,2346,2438,-92,0,300,0,6
22184,3,2670,2351,319,0,138,0,6
22185,2,2225,2419,-194,0,332,0,6
22186,1,2289,2420,-131,0,49,0,6
22187,1,2276,2444,-168,0,40,1,6
22188,1,2457,2302,155,0,43,0,6
22189,2,2508,2504,4,0,13,1,6
22190,1,2507,2361,146,0,152,0,6
22191,1,2439,2242,197,0,141,0,6
22192,2,2309,2468,-159,0,302,0,8
22193,2,2389,2410,-21,0,100,1,6
22194,3,2534,2347,187,0,304,0,6
22195,2,2272,2457,-185,0,301,0,6
22196,2,2499,2509,-10,0,107,0,6
22197,1,2556,2409,147,0,200,0,6
22198,1,2483,2213,270,0,45,0,6
22199,2,2405,2409,-4,0,113,0,6
22200,3,2440,2321,119,0,105,0,6
22201,1,2341,2419,-78,0,315,0,6
22202,1,2402,2408,-6,0,258,0,6
22203,1,2590,2583,7,0,414,1,6
22204,1,2417,2560,-143,0,40,1,6
22205,2,2578,2577,1,0,80,0,6
22206,1,2367,2467,-100,0,353,0,6
22207,1,2379,2436,-57,0,300,0,6
22208,1,2454,2363,91,0,110,0,6
22209,1,2279,2432,-153,0,100,1,6
22210,2,2369,2456,-87,0,0,1,6
22211,2,2361,2460,-99,0,210,0,6
22212,2,2406,2559,-153,0,2,0,6
22213,3,2299,2461,-162,0,302,0,6
22214,1,2564,2458,106,0,4,0,6
22215,2,2267,2501,-234,4,48,0,13
22216,1,2546,2344,202,0,14,1,6
22217,2,2442,2455,-13,0,153,0,6
22218,1,2485,2249,236,0,48,1,6
22219,1,2548,2231,317,0,5,1,6
22220,1,2412,2348,64,0,113,0,6
22221,1,2531,2502,29,0,321,0,6
22222,1,2436,2379,57,0,110,0,6
22223,2,2485,2510,-25,0,316,0,6
22224,1,2479,2647,-168,0,292,1,6
22225,3,2536,2350,186,0,300,0,6
22226,1,2441,2412,29,0,418,0,6
22227,1,2430,2383,47,0,45,0,6
22228,3,2415,2386,29,0,315,0,6
22229,2,2415,2400,15,0,122,1,6
22230,2,2386,2404,-18,0,302,0,6
22231,1,2323,2438,-115,0,107,0,6
22232,2,2578,2468,110,0,56,1,6
22233,1,2514,2493,21,0,245,0,6
22234,1,2358,2460,-102,0,112,0,6
22235,2,2371,2510,-139,0,200,0,6
22236,1,2406,2425,-19,0,320,0,6
22237,2,2583,2573,10,0,200,1,6
22238,2,2294,2408,-114,0,301,0,6
22239,1,2379,2423,-44,0,36,1,6
22240,1,2552,2435,117,0,310,0,6
22241,2,2577,2403,174,0,40,0,6
22242,2,2516,2563,-47,0,306,1,6
22243,1,2457,2455,2,0,458,0,6
22244,2,2471,2296,175,0,241,0,8
22245,3,2442,2485,-43,0,110,0,6
22246,2,2505,2536,-31,0,10,0,6
22247,1,2460,2374,86,0,46,0,6
22248,2,2297,2675,-378,0,106,1,6
22249,1,2488,2520,-32,0,466,0,6
22250,1,2431,2331,100,0,205,0,6
22251,2,2284,2446,-162,0,200,1,6
22252,1,2441,2330,111,0,200,0,6
22253,1,2407,2377,30,0,101,0,6
22254,2,2332,2497,-165,0,58,0,6
22255,2,2235,2442,-207,0,135,0,6
22256,1,2460,2460,0,0,211,0,6
22257,1,2672,2365,307,0,461,0,6
22258,2,2344,2441,-97,0,487,0,6
22259,2,2282,2445,-163,0,112,1,6
22260,1,2415,2290,125,0,65,0,6
22261,1,2501,2533,-32,0,400,0,6
22262,2,2342,2549,-207,0,311,1,6
22263,2,2406,2409,-3,0,131,0,6
22264,1,2341,2412,-71,0,456,0,6
22265,1,2639,2568,71,0,142,1,6
22266,2,2347,2430,-83,0,150,0,6
22267,1,2392,2419,-27,0,300,0,6
22268,2,2372,2412,-40,0,112,1,6
22270,1,2452,2462,-10,0,301,0,6
22271,2,2449,2413,36,0,447,0,6
22272,2,2412,2362,50,0,302,1,6
22273,1,2579,2577,2,0,58,0,6
22274,2,2500,2411,89,0,95,0,6
22275,2,2459,2302,157,0,214,0,6
22276,2,2317,2431,-114,0,101,0,6
22277,1,2417,2302,115,0,218,0,6
22278,3,2244,2415,-171,0,415,0,6
22279,1,2476,2443,33,0,302,0,6
22280,2,2492,2630,-138,0,201,0,6
22281,3,2395,2536,-141,0,409,0,6
22282,1,2286,2419,-133,0,301,0,6
22283,2,2262,2551,-289,0,122,0,6
22284,1,2556,2422,134,0,335,1,6
22285,1,2514,2494,20,0,259,0,6
22286,1,2455,2374,81,0,400,0,6
22287,2,2456,2508,-52,0,335,0,6
22288,2,2311,2423,-112,0,123,0,6
22289,1,2326,2435,-109,0,323,1,6
22290,2,2500,2568,-68,0,20,0,6
22291,1,2492,2322,170,0,52,0,6
22292,1,2458,2242,216,2,110,0,18
22293,1,2350,2466,-116,0,415,1,6
22294,1,2514,2425,89,0,112,0,6
22295,1,2541,2366,175,0,0,1,6
22296,1,2421,2405,16,0,190,1,6
22297,1,2667,2210,457,0,190,0,6
22298,1,2415,2400,15,0,58,0,6
22299,1,2454,2389,65,0,103,0,6
22300,2,2445,2340,105,0,100,1,6
22301,1,2634,2482,152,0,247,0,6
22302,2,2476,2443,33,0,40,0,6
22303,3,2643,2458,185,0,111,0,6
22304,1,2572,2584,-12,0,202,0,6
22305,1,2434,2343,91,0,101,0,6
22306,1,2573,2507,66,0,11,1,6
22307,1,2490,2495,-5,0,31,0,6
22308,1,2677,2303,374,0,7,0,6
22309,3,2435,2417,18,0,46,0,6
22310,2,2437,2403,34,0,110,0,6
22311,2,2434,2269,165,0,107,0,6
22312,1,2406,2394,12,0,41,1,6
22313,2,2418,2501,-83,0,3,1,6
22314,1,2534,2496,38,0,405,0,6
22315,2,2413,2285,128,0,46,0,6
22316,1,2674,2362,312,0,256,0,6
22317,2,2257,2503,-246,4,277,0,13
22318,1,2455,2449,6,0,106,0,6
22319,3,2427,2560,-133,0,302,0,6
22320,2,2463,2331,132,0,248,0,6
22321,1,2472,2245,227,0,138,0,6
22322,1,2445,2367,78,0,133,0,6
22323,1,2513,2209,304,0,316,0,6
22324,1,2489,2334,155,0,96,0,6
22325,2,2384,2459,-75,0,200,0,6
22326,2,2458,2544,-86,0,109,1,6
22327,1,2395,2420,-25,0,113,0,6
22328,1,2433,2409,24,0,255,1,6
22329,3,2516,2518,-2,0,5,0,6
22330,1,2427,2424,3,0,190,0,6
22331,2,2347,2438,-91,0,4,0,6
22332,3,2456,2469,-13,0,7,0,6
22333,3,2427,2289,138,0,157,0,8
22334,1,2579,2578,1,0,45,1,6
22335,3,2256,2528,-272,0,101,0,8
22336,1,2438,2472,-34,0,255,0,6
22337,2,2409,2369,40,0,300,0,6
22338,1,2666,2641,25,0,302,1,6
22339,3,2442,2343,99,0,100,0,6
22340,3,2461,2578,-117,0,485,0,6
22341,1,2476,2239,237,0,302,0,6
22342,2,2389,2412,-23,0,46,0,6
22343,1,2362,2434,-72,0,101,0,6
22344,2,2308,2436,-128,0,46,0,6
22345,1,2453,2264,189,0,214,0,6
22346,2,2465,2678,-213,0,101,0,6
22347,1,2506,2414,92,0,95,0,6
22348,2,2553,2474,79,0,5,1,6
22349,2,2417,2461,-44,0,101,0,6
22350,2,2444,2406,38,0,450,1,6
22351,2,2445,2539,-94,0,202,1,6
22352,1,2418,2277,141,0,152,0,6
22353,3,2314,2486,-172,0,245,0,6
22354,1,2429,2432,-3,0,311,1,6
22355,2,2207,2478,-271,0,18,0,6
22356,1,2558,2493,65,0,45,0,6
22357,1,2380,2457,-77,0,120,0,6
22358,2,2464,2469,-5,0,246,0,6
22359,2,2376,2403,-27,0,315,1,6
22360,2,2260,2439,-179,0,101,1,6
22361,1,2462,2432,30,0,4,0,6
22362,1,2428,2400,28,0,127,1,6
22363,1,2414,2401,13,0,61,1,6
22364,3,2439,2486,-47,0,110,0,6
22365,1,2572,2584,-12,0,201,0,6
22366,1,2549,2410,139,0,0,0,6
22367,2,2312,2440,-128,0,267,0,6
22368,2,2485,2450,35,0,45,0,6
22369,1,2344,2440,-96,0,4,0,6
22370,2,2428,2454,-26,0,45,0,6
22371,2,2245,2422,-177,0,150,0,6
22372,1,2668,2312,356,0,190,0,6
22373,1,2466,2417,49,0,250,0,6
22374,3,2427,2352,75,0,130,0,6
22375,2,2229,2422,-193,0,107,0,6
22376,2,2510,2576,-66,0,464,0,6
22377,2,2459,2213,246,0,111,0,6
22378,1,2488,2455,33,0,15,0,6
22379,2,2412,2562,-150,0,218,0,6
22380,2,2396,2427,-31,0,343,0,6
22381,2,2328,2518,-190,0,45,0,6
22382,1,2552,2458,94,0,0,0,6
22383,3,2207,2546,-339,0,107,0,6
22384,2,2475,2437,38,0,106,1,6
22385,1,2568,2406,162,0,200,0,6
22386,1,2422,2277,145,0,40,1,6
22387,1,2412,2242,170,0,46,0,6
22388,1,2450,2387,63,0,4,0,6
22389,2,2442,2440,2,0,121,0,6
22390,2,2570,2543,27,0,200,0,6
22391,1,2447,2304,143,0,13,1,6
22392,3,2268,2425,-157,0,150,0,6
22393,2,2557,2578,-21,0,0,0,6
22394,1,2292,2454,-162,0,211,0,6
22395,3,2402,2294,108,0,140,0,6
22396,2,2418,2441,-23,0,331,0,6
22397,2,2324,2471,-147,0,59,1,6
22398,1,2394,2412,-18,0,4,1,6
22399,1,2284,2478,-194,0,123,0,6
22400,2,2396,2420,-24,0,131,0,6
22401,2,2408,2371,37,0,300,0,6
22402,1,2440,2317,123,0,40,0,6
22403,1,2307,2444,-137,0,6,0,6
22404,2,2433,2352,81,0,110,0,6
22405,2,2363,2430,-67,0,134,0,6
22406,1,2676,2428,248,0,4,0,6
22407,1,2682,2205,477,0,4,0,6
22408,1,2480,2463,17,0,302,0,6
22409,1,2517,2288,229,0,101,1,6
22410,2,2432,2391,41,0,176,1,6
22411,1,2382,2455,-73,0,19,1,6
22412,1,2505,2349,156,0,85,0,6
22413,2,2446,2372,74,0,148,1,6
22414,3,2425,2353,72,0,365,0,6
22415,2,2293,2678,-385,0,40,0,6
22416,1,2580,2571,9,0,241,0,6
22418,2,2327,2424,-97,0,6,0,6
22419,2,2337,2409,-72,0,302,1,6
22420,2,2377,2402,-25,0,315,1,6
22421,1,2448,2271,177,0,134,1,6
22422,2,2403,2566,-163,0,2,0,6
22423,1,2422,2307,115,0,110,0,6
22424,2,2444,2426,18,0,310,0,6
22425,2,2536,2567,-31,0,200,0,6
22426,1,2469,2437,32,0,45,0,6
22427,2,2271,2517,-246,0,449,0,6
22428,1,2428,2202,226,0,40,0,6
22429,2,2257,2435,-178,0,320,0,6
22430,1,2405,2223,182,0,310,0,8
22431,2,2239,2401,-162,2,331,0,18
22432,2,2515,2453,62,0,25,1,6
22433,1,2550,2564,-14,0,46,0,6
22434,1,2428,2358,70,0,45,0,6
22435,1,2353,2402,-49,0,10,0,6
22436,2,2425,2390,35,0,67,0,6
22437,1,2379,2412,-33,0,84,0,6
22438,1,2406,2551,-145,0,40,0,6
22439,1,2329,2438,-109,0,4,0,6
22440,2,2426,2426,0,0,194,0,6
22441,1,2346,2509,-163,0,3,0,6
22442,1,2457,2401,56,0,10,1,6
22443,1,2558,2556,2,0,1,1,6
22444,2,2566,2663,-97,0,0,0,6
22445,1,2542,2484,58,0,5,0,6
22446,3,2304,2426,-122,0,100,0,6
22447,1,2469,2307,162,0,4,0,6
22448,1,2425,2335,90,0,242,1,6
22449,1,2448,2389,59,0,8,0,6
22450,1,2450,2439,11,0,308,0,6
22451,1,2516,2474,42,0,307,0,6
22452,1,2458,2521,-63,0,201,0,6
22453,2,2414,2432,-18,0,405,0,6
22454,1,2451,2465,-14,0,269,0,6
22455,3,2424,2680,-256,0,210,0,6
22456,2,2409,2353,56,0,156,0,6
22457,1,2432,2267,165,0,46,0,6
22458,1,2438,2437,1,0,106,0,6
22459,2,2432,2493,-61,0,45,0,6
22460,2,2236,2408,-172,0,101,0,8
22461,1,2457,2223,234,0,218,0,6
22462,1,2500,2354,146,0,85,1,6
22463,1,2400,2590,-190,0,3,0,6
22464,2,2265,2410,-145,0,248,0,6
22465,1,2407,2246,161,0,300,0,6
22466,3,2426,2367,59,0,28,0,6
22467,3,2369,2569,-200,0,40,0,6
22468,1,2284,2411,-127,0,4,0,6
22469,1,2432,2421,11,0,151,0,6
22470,1,2561,2583,-22,0,300,1,6
22471,1,2474,2520,-46,0,106,0,6
22472,1,2401,2249,152,0,140,0,6
22473,1,2684,2268,416,0,462,0,6
22474,3,2543,2484,59,0,0,0,6
22475,2,2259,2570,-311,0,123,0,8
22476,2,2497,2522,-25,0,14,0,6
22477,2,2668,2645,23,0,45,0,6
22478,1,2294,2428,-134,0,317,0,6
22479,2,2406,2386,20,0,414,1,6
22480,2,2376,2461,-85,0,268,0,6
22481,1,2275,2424,-149,0,140,0,6
22482,1,2550,2586,-36,0,305,0,6
22483,2,2384,2453,-69,0,227,0,6
22484,1,2438,2438,0,0,151,0,6
22485,3,2566,2463,103,0,320,0,6
22486,2,2313,2408,-95,0,115,0,6
22487,2,2441,2300,141,0,118,0,6
22488,1,2487,2347,140,0,302,0,6
22489,2,2218,2400,-182,0,11,1,6
22490,2,2581,2431,150,0,8,0,6
22491,2,2385,2444,-59,0,106,0,6
22492,2,2254,2430,-176,0,135,0,6
22493,2,2331,2415,-84,0,400,1,6
22494,1,2670,2222,448,0,190,1,6
22495,1,2435,2457,-22,0,49,0,6
22496,2,2416,2504,-88,0,153,1,6
22497,1,2441,2250,191,0,192,1,6
22498,2,2412,2309,103,0,145,0,6
22499,2,2277,2415,-138,0,190,0,6
22500,2,2466,2372,94,0,10,1,6
22501,2,2432,2351,81,0,240,0,6
22502,2,2443,2448,-5,0,106,0,6
22503,2,2314,2435,-121,0,4,0,6
22504,1,2515,2246,269,0,100,0,6
22505,3,2405,2233,172,0,277,0,6
22506,2,2254,2430,-176,0,354,1,6
22507,1,2412,2242,170,0,245,1,6
22508,1,2391,2411,-20,0,101,0,8
22509,2,2471,2492,-21,0,58,0,6
22510,2,2372,2425,-53,0,302,0,6
22511,2,2200,2432,-232,0,3,0,6
22512,3,2638,2577,61,0,48,0,6
22513,2,2429,2676,-247,0,43,0,6
22514,1,2556,2408,148,0,40,1,6
22515,3,2580,2651,-71,0,211,0,6
22516,3,2304,2480,-176,0,305,0,6
22517,2,2244,2405,-161,0,251,1,8
22518,2,2270,2409,-139,0,344,0,6
22519,2,2662,2542,120,0,40,0,6
22520,1,2414,2384,30,0,123,0,6
22521,1,2403,2315,88,0,1,1,6
22522,2,2457,2380,77,0,61,0,6
22524,1,2416,2252,164,0,297,0,6
22525,1,2465,2497,-32,0,58,0,6
22526,1,2564,2439,125,0,310,0,6
22527,2,2419,2465,-46,0,200,0,6
22528,2,2381,2428,-47,0,414,0,6
22529,2,2214,2509,-295,0,410,1,6
22530,1,2439,2545,-106,0,250,1,6
22531,1,2379,2459,-80,0,268,1,6
22532,2,2428,2360,68,0,133,0,6
22533,1,2400,2300,100,0,404,0,6
22534,1,2444,2326,118,0,156,0,6
22535,1,2508,2343,165,0,84,0,6
22536,2,2233,2416,-183,0,0,0,6
22537,1,2435,2441,-6,0,311,0,6
22538,2,2351,2562,-211,0,52,1,6
22539,1,2421,2568,-147,0,201,0,6
22540,2,2313,2416,-103,0,268,1,6
22541,3,2410,2331,79,0,10,0,6
22542,1,2405,2245,160,0,58,0,8
22543,2,2358,2411,-53,0,2,0,6
22544,2,2239,2415,-176,0,245,0,6
22545,2,2420,2281,139,0,45,0,6
22546,2,2453,2456,-3,0,484,0,6
22547,2,2361,2425,-64,0,170,0,6
22548,1,2573,2392,181,0,7,0,6
22549,2,2578,2569,9,0,265,0,6
22550,3,2491,2472,19,0,13,0,6
22551,2,2405,2508,-103,0,3,0,6
22552,2,2432,2550,-118,0,106,0,6
22553,2,2650,2654,-4,0,154,0,6
22554,1,2434,2200,234,0,48,1,6
22555,1,2420,2419,1,0,123,1,6
22556,1,2470,2412,58,0,300,1,6
22557,2,2268,2414,-146,0,36,0,6
22558,3,2560,2418,142,0,45,0,6
22559,1,2451,2452,-1,0,268,0,6
22560,2,2264,2436,-172,0,101,0,6
22561,3,2538,2496,42,0,203,0,6
22562,1,2417,2263,154,0,199,0,6
22563,1,2339,2455,-116,0,102,0,6
22564,2,2417,2356,61,0,150,0,8
22565,1,2462,2670,-208,0,344,0,6
22566,2,2408,2315,93,0,244,0,8
22567,2,2401,2512,-111,0,3,1,6
22568,2,2420,2317,103,0,40,0,6
22569,1,2590,2661,-71,0,246,0,6
22570,1,2293,2408,-115,0,16,1,8
22571,1,2404,2377,27,0,148,0,6
22572,1,2573,2471,102,0,121,0,6
22573,1,2575,2489,86,0,455,0,6
22574,1,2412,2389,23,0,9,0,6
22575,1,2523,2367,156,0,132,0,6
22576,1,2427,2356,71,0,101,0,6
22577,2,2554,2491,63,0,0,1,6
22578,2,2259,2421,-162,0,36,0,6
22579,2,2413,2425,-12,0,0,1,6
22580,2,2312,2439,-127,0,0,1,6
22581,1,2446,2474,-28,0,483,1,6
22582,3,2496,2558,-62,0,40,0,6
22583,2,2576,2520,56,0,7,0,6
22584,1,2364,2526,-162,0,307,0,6
22585,2,2384,2457,-73,0,36,1,6
22586,1,2654,2576,78,0,113,0,6
22587,1,2419,2442,-23,4,45,0,11
22588,2,2537,2577,-40,0,101,1,6
22589,2,2389,2412,-23,0,245,0,6
22590,2,2485,2433,52,0,251,1,6
22591,2,2474,2382,92,0,259,1,6
22593,2,2406,2269,137,0,246,0,6
22594,1,2406,2292,114,0,0,1,6
22595,1,2463,2352,111,0,46,0,8
22596,1,2446,2328,118,0,206,0,6
22597,3,2498,2378,120,0,10,0,6
22598,2,2461,2379,82,0,102,0,6
22599,2,2397,2547,-150,0,2,1,6
22600,1,2431,2434,-3,0,123,0,6
22601,1,2497,2659,-162,0,46,0,6
22602,2,2572,2557,15,0,0,0,6
22603,1,2442,2324,118,0,40,0,6
22604,3,2409,2418,-9,0,190,0,6
22605,2,2514,2462,52,0,2,0,6
22606,1,2539,2569,-30,0,200,1,6
22607,2,2582,2372,210,0,115,1,6
22608,2,2472,2532,-60,0,371,0,6
22609,2,2485,2651,-166,0,133,1,6
22610,1,2410,2324,86,0,108,0,8
22611,1,2428,2277,151,0,253,0,6
22612,2,2377,2437,-60,0,352,0,6
22613,2,2401,2382,19,0,44,0,8
22614,2,2309,2450,-141,0,3,1,6
22615,2,2293,2455,-162,0,132,0,6
22616,2,2284,2686,-402,0,212,0,6
22617,3,2578,2563,15,0,40,0,6
22618,2,2386,2454,-68,0,226,0,6
22619,2,2446,2336,110,0,45,0,6
22620,1,2319,2415,-96,0,46,0,8
22621,2,2496,2410,86,0,10,0,6
22622,2,2294,2687,-393,0,212,1,6
22623,1,2551,2449,102,0,0,0,6
22624,1,2566,2222,344,0,110,0,6
22625,1,2561,2483,78,0,49,0,6
22626,2,2468,2471,-3,0,255,1,6
22627,2,2373,2568,-195,0,52,0,6
22628,2,2221,2415,-194,0,456,0,6
22629,2,2468,2508,-40,0,300,0,6
22630,2,2537,2441,96,0,42,0,6
22631,1,2339,2467,-128,0,20,1,8
22632,1,2442,2411,31,0,110,1,6
22633,3,2323,2423,-100,0,112,0,8
22634,1,2563,2654,-91,0,45,1,6
22635,2,2381,2448,-67,0,354,0,6
22636,1,2417,2409,8,0,332,0,6
22638,1,2688,2204,484,0,41,0,6
22639,2,2223,2417,-194,0,0,0,6
22640,1,2432,2295,137,0,194,0,6
22641,2,2573,2459,114,0,202,0,6
22642,2,2280,2480,-200,0,52,0,5
22643,2,2439,2296,143,0,46,0,6
22644,3,2284,2571,-287,0,143,0,6
22645,1,2432,2312,120,0,211,0,6
22646,1,2218,2566,-348,0,202,1,6
22647,2,2445,2530,-85,0,250,0,6
22648,3,2484,2577,-93,0,211,0,6
22649,1,2315,2489,-174,0,58,0,6
22650,1,2404,2395,9,0,487,0,8
22651,2,2445,2403,42,4,202,0,13
22652,2,2476,2636,-160,0,88,0,6
22653,1,2459,2258,201,0,211,0,6
22654,1,2534,2555,-21,0,108,0,6
22655,2,2453,2376,77,0,352,0,6
22656,2,2291,2435,-144,0,22,1,6
22657,1,2433,2254,179,0,4,0,6
22658,2,2283,2463,-180,0,110,0,6
22659,1,2355,2447,-92,0,211,0,6
22660,2,2647,2644,3,0,345,0,6
22661,1,2467,2431,36,0,101,0,6
22662,1,2393,2400,-7,0,200,1,6
22663,1,2393,2566,-173,0,0,1,6
22664,2,2576,2571,5,0,40,0,6
22665,1,2481,2556,-75,0,218,0,6
22666,2,2420,2479,-59,0,245,0,6
22667,2,2298,2481,-183,0,45,1,6
22668,2,2567,2689,-122,0,202,0,6
22669,2,2460,2351,109,0,337,0,8
22670,2,2380,2417,-37,0,16,0,6
22671,1,2250,2436,-186,0,18,1,6
22672,1,2403,2234,169,0,36,0,6
22673,2,2390,2423,-33,0,120,0,8
22674,2,2466,2440,26,0,331,0,6
22675,2,2326,2404,-78,0,0,0,6
22676,1,2465,2473,-8,0,245,0,6
22677,2,2549,2639,-90,0,0,0,6
22678,2,2433,2540,-107,0,260,0,6
22679,1,2404,2423,-19,0,190,0,6
22680,1,2359,2452,-93,0,107,0,8
22681,2,2520,2383,137,0,6,0,6
22682,1,2485,2459,26,0,45,1,6
22683,2,2650,2780,-130,0,113,0,6
22684,2,2641,2557,84,0,101,0,6
22685,3,2229,2426,-197,0,6,0,6
22686,2,2306,2461,-155,0,309,0,6
22687,2,2327,2472,-145,0,391,1,6
22688,2,2549,2211,338,0,49,0,6
22689,1,2421,2401,20,0,241,0,6
22690,2,2446,2484,-38,0,202,0,6
22691,1,2425,2549,-124,0,301,0,6
22692,1,2417,2410,7,0,411,0,6
22693,2,2644,2544,100,0,233,0,6
22694,2,2415,2693,-278,0,100,1,6
22695,2,2366,2445,-79,0,140,0,8
22696,1,2634,2394,240,0,210,0,6
22697,2,2298,2477,-179,0,100,0,6
22698,3,2446,2423,23,0,310,0,6
22699,1,2440,2385,55,0,350,0,8
22700,2,2552,2637,-85,0,138,0,6
22701,1,2391,2454,-63,0,46,0,6
22702,2,2784,2647,137,0,352,0,6
22703,1,2475,2476,-1,0,200,0,6
22704,2,2280,2402,-122,0,15,1,6
22705,2,2397,2406,-9,0,228,0,8
22706,1,2410,2375,35,0,15,0,6
22707,1,2423,2426,-3,0,302,0,6
22708,2,2553,2262,291,0,220,0,6
22709,2,2480,2636,-156,0,200,0,6
22710,2,2279,2406,-127,0,315,1,6
22711,2,2640,2518,122,0,455,0,6
22712,2,2441,2481,-40,0,46,0,6
22713,2,2490,2430,60,0,114,0,6
22714,2,2427,2300,127,0,147,0,6
22715,2,2470,2445,25,0,103,0,6
22717,1,2465,2304,161,0,153,0,6
22718,1,2605,2491,114,0,311,1,6
22719,1,2641,2547,94,0,233,0,6
22720,1,2530,2257,273,0,205,1,6
22721,3,2400,2469,-69,0,40,0,6
22722,2,2493,2404,89,0,49,1,6
22723,1,2429,2322,107,0,49,0,6
22724,2,2404,2423,-19,0,190,0,6
22725,3,2447,2398,49,0,112,0,6
22726,2,2449,2421,28,0,311,1,6
22727,3,2226,2415,-189,0,101,0,6
22728,2,2331,2400,-69,0,241,0,6
22729,2,2428,2427,1,4,300,0,13
22730,2,2206,2699,-493,0,10,0,6
22731,2,2464,2390,74,0,129,0,6
22732,1,2526,2391,135,0,202,0,6
22733,3,2645,2632,13,0,45,0,6
22734,1,2303,2448,-145,0,103,0,6
22735,1,2406,2286,120,0,374,0,6
22736,1,2433,2294,139,0,411,1,6
22737,2,2423,2275,148,0,129,0,6
22738,1,2428,2399,29,0,411,0,6
22739,2,2483,2436,47,0,118,0,6
22740,2,2486,2390,96,0,110,0,6
22741,2,2441,2421,20,4,112,0,13
22742,1,2609,2433,176,0,56,1,6
22743,1,2398,2446,-48,0,315,1,6
22744,1,2429,2416,13,0,45,0,6
22745,3,2457,2427,30,0,11,0,6
22746,2,2318,2457,-139,0,455,0,6
22747,2,2410,2337,73,0,404,1,6
22748,2,2468,2450,18,0,42,0,6
22749,2,2388,2570,-182,0,2,0,6
22750,1,2440,2331,109,0,21,1,6
22751,3,2398,2479,-81,0,43,0,6
22752,2,2285,2460,-175,0,200,1,6
22753,1,2426,2400,26,0,130,0,6
22754,2,2470,2488,-18,0,46,0,6
22755,2,2456,2455,1,0,43,0,6
22756,2,2537,2508,29,0,242,0,6
22757,2,2442,2438,4,0,107,0,6
22758,1,2569,2523,46,0,453,0,6
22759,1,2429,2434,-5,0,106,1,6
22760,1,2468,2460,8,0,3,0,6
22762,1,2655,2612,43,0,184,0,6
22763,3,2488,2492,-4,0,0,0,6
22764,1,2283,2415,-132,0,10,0,6
22765,2,2404,2414,-10,0,127,0,6
22766,1,2700,2530,170,0,152,0,6
22767,1,2434,2376,58,0,46,1,6
22768,2,2282,2437,-155,0,6,1,6
22769,3,2293,2400,-107,4,487,0,13
22770,2,2491,2447,44,0,107,0,6
22771,1,2419,2298,121,4,248,0,13
22772,3,2351,2467,-116,0,40,0,6
22773,2,2332,2492,-160,0,40,1,6
22774,2,2258,2410,-152,0,129,1,6
22775,2,2370,2477,-107,0,151,0,6
22776,2,2452,2543,-91,0,351,0,6
22777,1,2442,2461,-19,0,46,1,6
22778,2,2434,2314,120,0,45,1,6
22779,2,2354,2462,-108,0,45,0,6
22780,1,2464,2297,167,0,110,0,6
22781,3,2447,2426,21,0,62,0,6
22782,2,2487,2509,-22,0,192,0,6
22783,1,2423,2395,28,0,133,1,6
22784,2,2395,2518,-123,0,101,0,6
22785,3,2435,2574,-139,0,106,0,6
22786,1,2428,2381,47,0,4,0,6
22787,2,2226,2474,-248,0,81,0,6
22788,3,2427,2401,26,0,159,0,6
22789,1,2573,2436,137,0,34,1,6
22790,1,2270,2413,-143,0,341,0,6
22791,1,2291,2407,-116,0,40,0,6
22792,1,2373,2446,-73,0,127,0,6
22793,2,2516,2299,217,0,131,0,6
22794,2,2587,2597,-10,0,135,0,6
22795,1,2298,2481,-183,0,259,1,6
22797,1,2344,2403,-59,0,312,0,6
22798,1,2547,2436,111,0,151,0,6
22799,1,2429,2428,1,4,120,0,13
22800,2,2485,2214,271,0,125,0,7
22801,1,2463,2320,143,0,1,1,6
22802,1,2207,2437,-230,0,134,0,6
22803,2,2493,2202,291,0,122,1,6
22804,1,2704,2273,431,0,244,0,6
22805,2,2480,2516,-36,0,45,0,6
22806,2,2476,2572,-96,0,2,0,6
22807,3,2339,2439,-100,0,3,0,6
22808,1,2433,2228,205,0,5,0,6
22809,2,2320,2435,-115,0,130,0,6
22810,2,2405,2522,-117,0,101,0,6
22811,2,2396,2603,-207,0,135,0,6
22813,3,2496,2315,181,0,41,0,6
22814,2,2432,2421,11,0,138,0,6
22815,1,2455,2467,-12,0,132,1,6
22816,2,2308,2472,-164,0,4,0,6
22817,2,2332,2444,-112,0,15,1,6
22818,1,2448,2472,-24,0,202,0,6
22819,1,2576,2457,119,0,43,0,6
22820,2,2421,2333,88,0,100,0,6
22821,2,2413,2401,12,0,13,0,6
22822,2,2427,2401,26,0,152,0,6
22823,2,2361,2436,-75,0,100,1,6
22824,2,2366,2607,-241,0,401,0,6
22825,2,2284,2463,-179,0,301,0,6
22826,3,2467,2257,210,0,414,0,6
22827,2,2441,2439,2,0,27,0,6
22828,2,2293,2427,-134,0,107,0,6
22829,1,2220,2475,-255,0,1,0,6
22830,2,2481,2467,14,0,210,1,6
22831,2,2209,2705,-496,0,20,0,6
22832,2,2278,2661,-383,0,331,0,6
22833,2,2306,2526,-220,0,7,1,6
22834,2,2236,2481,-245,0,121,1,6
22835,3,2425,2272,153,0,486,0,6
22836,1,2426,2348,78,0,1,0,6
22837,1,2467,2389,78,0,140,0,6
22838,1,2426,2415,11,0,101,0,6
22839,1,2390,2446,-56,0,0,0,6
22840,3,2427,2309,118,0,5,0,6
22841,1,2300,2530,-230,0,106,1,6
22843,2,2517,2278,239,0,127,0,6
22844,3,2274,2402,-128,0,187,0,6
22845,2,2430,2607,-177,0,135,0,6
22846,1,2662,2328,334,0,13,0,6
22847,1,2291,2430,-139,0,8,1,6
22848,2,2320,2438,-118,0,177,0,6
22849,2,2394,2563,-169,0,205,0,6
22850,2,2388,2461,-73,0,127,0,6
22851,2,2206,2409,-203,0,45,1,6
22852,2,2211,2453,-242,0,0,0,6
22853,1,2580,2484,96,0,4,0,6
22854,1,2479,2385,94,0,145,1,6
22855,2,2431,2550,-119,0,248,0,6
22856,2,2610,2431,179,0,106,1,6
22857,2,2392,2427,-35,0,25,0,6
22858,1,2508,2326,182,0,105,1,6
22859,1,2408,2455,-47,0,113,1,6
22860,2,2295,2404,-109,0,0,1,6
22861,2,2276,2454,-178,0,405,0,6
22862,1,2705,2283,422,0,244,0,6
22863,1,2483,2445,38,0,190,0,6
22864,1,2610,2428,182,0,131,1,6
22865,2,2214,2435,-221,0,127,0,6
22866,1,2364,2444,-80,0,0,0,6
22867,3,2312,2440,-128,0,40,0,6
22868,1,2425,2421,4,0,15,0,6
22869,1,2529,2338,191,0,49,0,6
22870,1,2401,2360,41,0,45,1,6
22871,2,2467,2461,6,0,130,0,6
22872,2,2218,2483,-265,0,484,0,6
22873,1,2584,2524,60,0,406,0,6
22874,1,2430,2374,56,0,1,1,6
22875,2,2286,2480,-194,0,123,0,6
22876,3,2403,2277,126,0,106,0,6
22877,1,2429,2222,207,0,335,0,6
22878,1,2384,2583,-199,0,45,0,6
22879,1,2472,2308,164,0,455,0,6
22880,2,2476,2476,0,0,90,0,6
22881,3,2335,2491,-156,0,288,0,6
22882,3,2439,2204,235,0,200,0,6
22883,1,2491,2663,-172,0,40,0,6
22884,2,2395,2432,-37,0,151,0,6
22885,1,2466,2234,232,0,41,1,6
22886,2,2485,2387,98,0,365,0,6
22887,1,2400,2276,124,0,7,0,6
22888,1,2544,2409,135,0,4,0,6
22889,1,2393,2475,-82,0,57,0,6
22890,1,2438,2338,100,0,338,0,6
22891,2,2483,2589,-106,0,106,0,6
22892,2,2519,2344,175,0,228,0,6
22893,1,2554,2462,92,0,210,0,6
22894,1,2465,2287,178,0,176,0,6
22895,1,2412,2464,-52,4,144,1,13
22896,3,2455,2466,-11,0,301,0,6
22897,2,2440,2284,156,0,50,0,6
22898,2,2440,2311,129,0,130,1,6
22899,2,2435,2266,169,0,135,0,6
22900,3,2655,2601,54,0,312,0,6
22901,2,2486,2415,71,0,318,0,6
22902,1,2447,2388,59,0,0,1,6
22903,2,2279,2471,-192,0,46,0,6
22904,1,2482,2346,136,0,2,0,6
22905,2,2288,2411,-123,0,466,0,6
22906,1,2443,2341,102,0,130,0,6
22907,1,2422,2483,-61,0,45,0,6
22908,1,2532,2300,232,0,43,0,6
22909,3,2306,2415,-109,0,13,0,6
22910,2,2384,2479,-95,0,30,0,6
22911,2,2602,2395,207,0,117,0,6
22912,3,2593,2654,-61,0,40,0,6
22913,1,2427,2312,115,0,101,0,6
22914,3,2412,2407,5,0,8,0,6
22915,1,2355,2448,-93,0,320,0,6
22916,1,2455,2218,237,0,301,1,6
22917,2,2210,2435,-225,0,200,0,6
22918,1,2466,2367,99,0,300,1,6
22919,1,2461,2455,6,0,200,0,6
22920,3,2706,2333,373,0,326,0,6
22921,2,2468,2278,190,0,301,0,6
22922,2,2489,2511,-22,0,242,0,6
22923,1,2401,2321,80,0,141,0,6
22924,1,2334,2489,-155,0,250,0,6
22925,2,2273,2404,-131,0,211,1,6
22926,1,2450,2467,-17,0,194,0,6
22927,1,2406,2407,-1,0,113,1,6
22928,2,2278,2613,-335,0,305,0,6
22929,1,2422,2468,-46,0,174,1,6
22930,1,2298,2486,-188,0,4,1,6
22931,2,2209,2501,-292,0,0,0,6
22932,2,2432,2534,-102,0,310,1,6
22933,2,2438,2320,118,0,1,0,6
22934,1,2436,2373,63,0,15,0,6
22935,3,2506,2420,86,0,150,0,6
22937,2,2324,2468,-144,0,45,1,6
22938,1,2458,2558,-100,0,302,1,6
22939,3,2594,2432,162,0,453,0,6
22940,1,2461,2456,5,0,152,1,6
22941,2,2653,2470,183,0,411,0,6
22942,3,2427,2443,-16,0,106,0,6
22943,1,2473,2452,21,0,107,0,6
22944,2,2426,2484,-58,0,45,0,6
22945,2,2548,2493,55,0,202,0,6
22946,2,2285,2401,-116,0,436,0,6
22947,1,2483,2575,-92,0,122,0,6
22948,3,2413,2408,5,0,100,0,6
22949,2,2376,2431,-55,0,131,0,6
22950,1,2593,2352,241,0,121,0,6
22951,1,2477,2421,56,0,153,0,6
22952,2,2330,2405,-75,0,107,0,6
22953,2,2401,2427,-26,0,127,1,6
22954,2,2240,2458,-218,0,114,1,6
22955,1,2538,2320,218,0,409,0,6
22956,2,2473,2443,30,0,1,1,6
22957,1,2614,2333,281,0,112,0,6
22958,1,2477,2399,78,0,3,0,6
22959,1,2441,2429,12,0,302,0,6
22960,3,2448,2361,87,0,345,0,6
22961,1,2462,2311,151,0,466,1,6
22962,1,2418,2378,40,0,353,0,6
22963,1,2400,2272,128,0,245,1,6
22964,1,2333,2421,-88,0,3,0,6
22965,2,2327,2490,-163,0,45,0,6
22966,1,2489,2430,59,0,142,0,6
22967,2,2327,2403,-76,0,133,1,6
22968,1,2448,2207,241,0,40,0,6
22969,1,2503,2480,23,0,16,0,6
22970,2,2481,2479,2,0,0,0,6
22971,1,2645,2281,364,0,15,0,6
22972,3,2518,2405,113,0,0,0,6
22973,3,2408,2248,160,0,8,0,6
22974,2,2265,2412,-147,0,45,1,6
22975,2,2269,2405,-136,0,136,0,6
22976,1,2430,2229,201,0,5,0,6
22977,1,2350,2427,-77,0,30,0,6
22978,2,2436,2414,22,0,131,0,6
22980,2,2443,2482,-39,0,88,0,6
22981,1,2462,2369,93,0,209,0,6
22982,1,2499,2429,70,0,11,0,6
22983,2,2433,2541,-108,0,101,1,6
22984,2,2410,2245,165,0,101,0,6
22985,1,2474,2362,112,0,255,0,8
22986,1,2407,2395,12,0,41,0,6
22987,1,2516,2592,-76,0,106,0,6
22988,2,2344,2447,-103,0,107,0,6
22989,2,2399,2425,-26,0,141,1,6
22990,1,2280,2494,-214,0,474,0,6
22991,1,2479,2433,46,0,140,0,6
22992,1,2467,2450,17,0,110,1,6
22993,2,2424,2334,90,0,45,0,6
22994,1,2313,2646,-333,0,4,0,6
22995,2,2245,2401,-156,0,11,0,6
22996,1,2408,2265,143,0,130,0,6
22997,2,2486,2447,39,0,216,0,6
22998,2,2487,2616,-129,0,3,0,6
22999,2,2484,2438,46,0,10,0,6
23000,1,2475,2373,102,0,37,0,6
23001,1,2413,2307,106,0,130,0,6
23002,1,2408,2230,178,0,0,0,6
23003,1,2494,2312,182,0,122,0,6
23004,2,2371,2482,-111,0,241,0,6
23006,1,2326,2423,-97,0,40,1,6
23007,2,2282,2557,-275,0,123,0,6
23008,1,2436,2313,123,0,205,0,6
23009,1,2545,2394,151,0,49,0,6
23010,1,2472,2429,43,0,106,0,6
23011,1,2428,2274,154,4,143,1,13
23012,2,2307,2420,-113,0,123,1,6
23013,1,2357,2508,-151,0,1,0,6
23014,1,2475,2269,206,0,380,0,6
23015,1,2433,2301,132,0,62,0,6
23016,2,2220,2450,-230,0,15,0,6
23017,2,2267,2412,-145,0,0,0,6
23018,2,2417,2465,-48,0,45,0,6
23019,2,2305,2404,-99,0,111,0,6
23020,1,2592,2423,169,0,122,0,6
23021,2,2416,2466,-50,0,42,0,6
23022,3,2201,2433,-232,0,40,0,6
23023,1,2504,2365,139,0,13,0,6
23024,2,2415,2483,-68,0,90,0,6
23025,1,2424,2430,-6,0,151,0,6
23026,2,2485,2523,-38,0,243,0,6
23027,1,2620,2394,226,0,219,0,6
23028,1,2585,2289,296,0,46,0,6
23029,1,2416,2230,186,0,332,0,6
23030,2,2559,2549,10,0,101,0,6
23031,1,2431,2402,29,0,1,0,6
23032,1,2439,2391,48,0,110,0,6
23033,2,2309,2440,-131,0,10,0,6
23034,1,2602,2294,308,0,192,0,6
23035,1,2500,2204,296,0,41,0,6
23036,1,2404,2214,190,0,0,0,6
23037,1,2416,2323,93,0,41,0,6
23038,2,2636,2478,158,0,15,0,6
23039,1,2444,2497,-53,0,13,0,6
23040,1,2392,2623,-231,0,190,1,6
23041,2,2457,2325,132,0,85,1,6
23042,1,2370,2484,-114,0,70,1,6
23043,1,2471,2571,-100,0,167,1,6
23044,2,2227,2411,-184,0,247,0,6
23045,1,2486,2367,119,0,153,0,6
23046,1,2500,2480,20,0,48,0,6
23047,2,2222,2478,-256,0,200,0,6
23048,1,2528,2365,163,0,102,0,6
23049,2,2297,2436,-139,0,57,1,6
23050,2,2347,2595,-248,0,2,0,6
23051,1,2488,2587,-99,0,2,0,6
23052,1,2452,2296,156,0,45,0,6
23053,3,2418,2511,-93,0,1,0,6
23054,1,2448,2419,29,0,311,0,6
23055,1,2555,2451,104,0,40,0,6
23056,1,2341,2431,-90,0,40,0,6
23057,2,2490,2408,82,0,110,0,6
23058,1,2554,2477,77,0,112,0,6
23059,1,2424,2444,-20,0,177,0,6
23060,3,2349,2508,-159,0,315,0,6
23061,1,2424,2388,36,0,125,1,6
23062,1,2388,2411,-23,0,9,0,6
23063,1,2414,2224,190,0,200,0,6
23064,1,2430,2234,196,0,4,0,6
23065,2,2313,2412,-99,0,463,0,6
23066,2,2384,2453,-69,0,119,0,6
23067,1,2481,2436,45,0,0,0,6
23068,2,2486,2474,12,0,456,1,6
23069,3,2506,2628,-122,0,17,0,6
23070,3,2304,2426,-122,0,200,0,6
23071,1,2418,2336,82,0,337,0,6
23072,3,2456,2327,129,0,440,0,6
23073,2,2776,2654,122,0,474,0,6
23074,2,2438,2385,53,0,205,0,6
23075,2,2478,2395,83,0,4,1,6
23076,1,2422,2201,221,0,140,0,6
23077,1,2483,2301,182,0,110,0,6
23078,1,2425,2262,163,0,43,1,6
23079,2,2289,2580,-291,0,40,0,6
23080,1,2358,2453,-95,0,107,0,6
23081,2,2365,2443,-78,0,307,0,6
23082,2,2319,2447,-128,0,4,0,6
23083,3,2559,2420,139,0,410,0,6
23084,1,2221,2417,-196,0,247,0,6
23085,2,2509,2405,104,0,135,0,6
23086,2,2598,2420,178,0,122,1,6
23087,2,2402,2371,31,0,50,0,6
23088,2,2402,2209,193,0,487,1,6
23089,2,2432,2402,30,0,414,1,6
23090,2,2455,2558,-103,0,107,0,6
23091,1,2413,2362,51,0,211,0,6
23092,1,2349,2420,-71,0,40,0,6
23093,1,2614,2531,83,0,242,0,6
23094,1,2410,2248,162,0,112,1,6
23095,2,2386,2422,-36,0,40,0,6
23096,1,2364,2490,-126,0,142,1,6
23097,1,2604,2305,299,0,45,1,6
23098,3,2439,2362,77,0,398,0,6
23099,1,2425,2220,205,0,130,0,6
23100,1,2480,2330,150,0,84,0,6
23101,1,2225,2431,-206,0,0,0,6
23102,2,2364,2502,-138,0,8,0,6
23103,1,2626,2287,339,0,448,1,6
23104,2,2581,2508,73,0,4,0,6
23105,3,2476,2480,-4,0,115,0,6
23106,2,2480,2377,103,0,172,0,6
23107,2,2440,2479,-39,0,406,0,6
23108,2,2486,2486,0,0,0,1,6
23109,1,2431,2298,133,0,1,0,6
23110,2,2253,2496,-243,0,10,1,6
23111,2,2259,2419,-160,0,130,0,6
23112,3,2458,2564,-106,0,123,0,6
23113,1,2289,2417,-128,0,84,0,6
23114,1,2527,2394,133,0,190,1,6
23115,1,2618,2401,217,0,278,0,6
23116,2,2445,2411,34,0,45,1,6
23117,1,2662,2768,-106,0,395,0,6
23118,1,2403,2309,94,0,255,0,6
23119,1,2474,2451,23,0,106,0,6
23120,1,2417,2483,-66,0,216,0,6
23121,3,2562,2430,132,0,135,0,6
23122,2,2450,2241,209,0,50,0,6
23123,2,2422,2575,-153,0,41,0,6
23124,1,2317,2506,-189,0,121,0,6
23125,2,2429,2515,-86,0,100,0,6
23126,1,2448,2361,87,0,205,0,6
23127,1,2449,2484,-35,0,46,0,8
23128,2,2454,2315,139,0,43,1,6
23129,2,2321,2418,-97,0,300,0,6
23130,1,2451,2589,-138,0,4,0,6
23131,1,2428,2342,86,0,56,0,6
23132,2,2408,2234,174,0,107,1,6
23133,3,2435,2426,9,0,1,0,6
23134,2,2294,2422,-128,0,157,0,6
23135,2,2452,2631,-179,0,10,0,6
23136,2,2329,2428,-99,0,41,0,6
23137,1,2492,2473,19,0,122,0,6
23138,2,2322,2477,-155,0,256,0,6
23139,1,2480,2480,0,0,1,0,6
23141,3,2354,2439,-85,0,172,0,6
23142,2,2356,2452,-96,0,307,1,6
23143,1,2497,2628,-131,0,201,0,6
23144,2,2414,2425,-11,0,4,0,6
23145,1,2484,2376,108,0,135,0,6
23146,2,2301,2446,-145,0,4,0,6
23147,1,2426,2389,37,0,112,1,6
23148,1,2498,2480,18,0,2,0,6
23149,2,2350,2493,-143,0,107,0,6
23150,1,2432,2256,176,0,40,0,6
23151,2,2311,2407,-96,0,230,0,6
23152,2,2246,2466,-220,0,300,1,8
23153,2,2201,2413,-212,0,22,1,6
23154,1,2519,2578,-59,0,5,1,6
23155,1,2497,2234,263,0,205,1,6
23156,2,2226,2432,-206,0,484,0,6
23157,1,2291,2419,-128,0,436,0,6
23158,2,2410,2560,-150,0,0,0,6
23159,2,2478,2323,155,0,4,1,8
23160,1,2319,2428,-109,0,107,0,6
23161,2,2531,2459,72,0,106,0,6
23162,2,2474,2435,39,0,0,0,6
23163,1,2422,2477,-55,0,107,0,6
23164,2,2486,2424,62,0,30,0,6
23165,2,2426,2385,41,0,385,0,6
23166,1,2761,2670,91,0,100,0,6
23167,2,2296,2646,-350,0,414,0,8
23168,1,2410,2472,-62,0,190,0,6
23169,1,2367,2439,-72,0,107,0,6
23170,2,2419,2620,-201,0,13,0,6
23171,1,2529,2465,64,0,345,0,6
23172,2,2411,2504,-93,0,80,0,6
23173,2,2400,2232,168,0,258,1,6
23174,2,2242,2557,-315,0,0,0,6
23175,2,2364,2474,-110,0,113,0,6
23176,2,2562,2387,175,0,406,0,6
23177,1,2583,2381,202,0,219,0,6
23178,2,2252,2431,-179,0,13,0,6
23179,2,2449,2374,75,0,138,1,6
23180,2,2435,2470,-35,0,216,0,6
23181,1,2429,2224,205,0,107,0,6
23182,1,2351,2459,-108,0,0,0,6
23183,1,2488,2435,53,0,101,0,6
23184,2,2450,2221,229,0,301,0,6
23185,1,2431,2446,-15,0,45,0,6
23186,2,2468,2431,37,0,0,0,6
23187,1,2434,2323,111,0,45,0,6
23188,1,2441,2270,171,0,1,0,6
23189,2,2561,2634,-73,0,150,0,6
23190,1,2606,2438,168,0,38,1,6
23191,3,2391,2420,-29,0,38,0,6
23192,1,2434,2342,92,0,41,0,6
23193,3,2571,2524,47,0,4,0,6
23194,2,2366,2407,-41,0,117,1,6
23195,1,2431,2526,-95,0,100,0,6
23196,3,2558,2466,92,0,40,0,6
23197,3,2564,2479,85,0,144,0,6
23198,2,2455,2456,-1,0,350,1,8
23199,3,2438,2407,31,0,211,0,6
23200,1,2508,2462,46,0,3,0,6
23201,1,2581,2466,115,0,120,0,6
23202,2,2340,2425,-85,0,200,1,6
23203,1,2432,2236,196,0,45,0,6
23204,2,2422,2242,180,0,5,0,6
23205,2,2623,2507,116,0,305,0,6
23206,3,2478,2283,195,0,45,0,6
23207,1,2411,2441,-30,0,4,0,6
23208,2,2457,2437,20,0,153,0,6
23209,1,2411,2417,-6,0,409,0,6
23210,1,2666,2765,-99,0,123,0,6
23211,2,2461,2527,-66,0,302,1,6
23212,2,2452,2430,22,0,388,1,6
23213,1,2499,2493,6,0,42,0,6
23214,2,2283,2478,-195,0,200,0,6
23215,1,2554,2442,112,0,331,1,6
23216,2,2417,2381,36,0,127,0,6
23217,2,2311,2489,-178,0,305,0,6
23218,1,2506,2359,147,0,121,1,6
23219,3,2294,2435,-141,0,46,0,6
23220,2,2429,2436,-7,0,125,0,6
23221,2,2259,2414,-155,0,123,0,6
23222,2,2417,2395,22,0,46,1,6
23223,1,2487,2502,-15,0,241,0,6
23224,1,2371,2505,-134,0,176,0,6
23225,2,2462,2470,-8,0,106,0,6
23226,1,2430,2318,112,0,337,0,6
23227,2,2594,2675,-81,0,404,0,8
23228,1,2647,2226,421,0,45,0,8
23229,2,2242,2572,-330,0,114,0,8
23230,2,2411,2443,-32,0,120,0,6
23231,2,2758,2673,85,0,474,1,6
23232,1,2402,2412,-10,0,114,1,6
23233,2,2468,2244,224,0,301,0,8
23234,2,2448,2414,34,0,45,0,6
23235,1,2497,2417,80,0,190,0,6
23236,2,2555,2456,99,0,200,1,6
23237,1,2442,2424,18,0,0,0,6
23238,2,2446,2438,8,0,337,0,6
23239,1,2437,2388,49,0,106,1,6
23240,2,2411,2558,-147,0,169,0,6
23241,1,2256,2411,-155,0,147,0,6
23242,1,2585,2459,126,0,120,0,6
23243,1,2331,2433,-102,0,45,1,6
23244,1,2496,2493,3,0,45,0,6
23245,1,2577,2454,123,0,140,1,6
23246,2,2497,2510,-13,0,242,0,6
23247,2,2482,2342,140,0,106,0,6
23248,1,2350,2408,-58,0,110,1,6
23249,2,2477,2397,80,0,440,0,6
23250,2,2353,2406,-53,0,1,0,6
23251,1,2561,2403,158,0,335,0,6
23252,2,2680,2751,-71,0,301,1,6
23253,2,2440,2407,33,0,40,0,6
23254,2,2429,2399,30,4,212,0,13
23255,2,2397,2444,-47,0,253,1,6
23256,1,2442,2403,39,0,40,1,6
23257,2,2463,2542,-79,0,46,1,6
23258,1,2418,2248,170,0,140,1,6
23259,2,2474,2492,-18,0,153,1,6
23260,3,2502,2580,-78,0,45,0,6
23261,2,2400,2411,-11,0,265,0,6
23262,2,2299,2413,-114,0,199,0,6
23263,1,2323,2412,-89,0,2,0,6
23264,1,2386,2589,-203,0,111,0,8
23265,1,2574,2277,297,0,318,0,8
23266,1,2648,2313,335,0,14,0,8
23267,2,2415,2437,-22,4,112,0,13
23268,2,2565,2456,109,0,57,0,6
23269,1,2401,2434,-33,0,12,1,6
23270,1,2438,2368,70,0,409,0,8
23271,2,2364,2414,-50,0,4,1,6
23272,1,2341,2469,-128,0,411,0,6
23273,1,2453,2485,-32,0,311,1,6
23274,1,2290,2537,-247,0,4,0,6
23275,2,2309,2449,-140,0,288,1,6
23276,2,2253,2459,-206,0,44,0,8
23277,1,2404,2270,134,0,48,0,6
23278,2,2387,2571,-184,0,302,0,6
23279,2,2398,2447,-49,0,41,0,6
23280,3,2284,2421,-137,0,57,0,6
23281,1,2443,2203,240,0,211,0,6
23282,2,2313,2428,-115,0,193,0,6
23283,2,2610,2676,-66,0,101,0,6
23284,1,2464,2311,153,0,110,1,6
23285,1,2532,2557,-25,0,405,0,6
23286,2,2416,2497,-81,0,121,0,6
23287,2,2394,2469,-75,0,205,1,6
23288,2,2417,2287,130,0,41,0,6
23289,1,2500,2412,88,0,40,0,6
23290,3,2460,2389,71,0,335,0,6
23291,2,2681,2605,76,0,106,0,6
23292,2,2384,2433,-49,0,46,1,6
23293,1,2574,2428,146,0,53,0,6
23294,1,2407,2284,123,0,10,0,6
23295,2,2404,2479,-75,0,312,0,6
23296,1,2452,2393,59,0,58,1,6
23298,1,2450,2309,141,0,28,0,6
23299,1,2453,2306,147,0,28,0,6
23300,2,2405,2422,-17,4,143,0,13
23301,1,2426,2379,47,0,311,1,6
23302,2,2505,2382,123,0,377,1,6
23303,2,2401,2345,56,0,115,0,6
23304,1,2412,2551,-139,0,157,1,6
23305,1,2502,2337,165,0,130,1,6
23306,2,2389,2473,-84,0,211,0,6
23307,1,2282,2446,-164,0,108,0,6
23308,2,2312,2576,-264,0,119,0,8
23309,2,2327,2683,-356,0,46,1,8
23310,1,2307,2467,-160,0,67,0,6
23311,2,2577,2665,-88,0,46,1,6
23312,1,2407,2424,-17,0,265,0,6
23313,1,2546,2390,156,0,15,0,6
23314,1,2612,2674,-62,0,13,0,6
23315,2,2366,2411,-45,0,114,0,6
23316,1,2438,2459,-21,0,187,0,6
23317,2,2437,2302,135,0,123,0,6
23318,2,2302,2484,-182,0,134,1,6
23319,2,2457,2399,58,0,17,1,6
23320,1,2400,2360,40,0,123,0,6
23321,2,2514,2448,66,0,246,0,6
23322,1,2455,2317,138,0,117,0,6
23323,1,2462,2250,212,0,302,0,8
23324,1,2388,2457,-69,0,386,0,6
23325,2,2414,2459,-45,0,9,0,6
23326,1,2449,2281,168,0,133,0,6
23327,1,2374,2431,-57,0,107,0,6
23328,2,2478,2497,-19,0,102,0,6
23329,2,2334,2505,-171,0,45,0,6
23330,1,2543,2386,157,0,335,1,6
23331,1,2406,2269,137,0,303,1,6
23332,1,2420,2470,-50,0,145,0,6
23333,2,2355,2405,-50,0,163,0,6
23334,1,2450,2395,55,0,40,1,6
23335,2,2421,2389,32,0,455,0,6
23336,3,2400,2311,89,0,103,0,6
23337,2,2550,2475,75,0,15,0,6
23338,1,2365,2424,-59,0,210,0,6
23339,1,2430,2361,69,0,112,0,6
23340,1,2438,2215,223,0,51,0,6
23341,1,2619,2573,46,0,20,0,6
23342,2,2416,2297,119,0,320,1,6
23343,2,2339,2450,-111,0,337,0,6
23344,2,2611,2586,25,0,107,1,6
23345,2,2271,2413,-142,0,211,0,6
23346,3,2418,2444,-26,0,46,0,6
23347,2,2452,2409,43,0,300,0,6
23348,3,2487,2413,74,0,40,0,6
23349,2,2406,2508,-102,0,49,1,6
23350,2,2331,2434,-103,0,45,0,6
23351,1,2477,2454,23,0,227,1,6
23352,1,2578,2650,-72,0,23,1,8
23353,2,2304,2472,-168,0,44,0,6
23354,2,2435,2389,46,0,246,0,6
23355,2,2547,2452,95,0,386,0,6
23356,1,2416,2252,164,0,40,0,6
23357,2,2265,2410,-145,0,6,1,6
23358,2,2383,2426,-43,0,265,1,6
23359,1,2390,2455,-65,0,386,0,6
23360,2,2568,2532,36,0,405,1,6
23361,2,2379,2445,-66,0,106,0,6
23362,1,2369,2498,-129,0,442,0,6
23363,1,2426,2409,17,0,110,1,6
23364,2,2367,2426,-59,0,106,0,6
23365,2,2419,2538,-119,0,340,0,6
23366,1,2592,2476,116,0,10,0,6
23367,1,2416,2224,192,0,25,0,6
23368,2,2410,2350,60,0,125,0,6
23369,2,2444,2428,16,0,147,0,6
23370,1,2440,2253,187,0,107,0,6
23371,1,2370,2405,-35,0,15,0,6
23372,2,2486,2396,90,0,345,1,6
23373,1,2643,2539,104,0,4,0,6
23374,2,2421,2459,-38,0,103,1,6
23375,1,2624,2464,160,0,12,0,6
23376,2,2247,2465,-218,0,40,0,8
23377,2,2401,2543,-142,0,405,0,6
23378,1,2449,2512,-63,0,15,0,6
23379,2,2418,2451,-33,4,310,0,13
23380,2,2395,2415,-20,0,115,0,6
23381,1,2362,2480,-118,0,101,0,6
23382,2,2475,2450,25,0,101,0,6
23383,1,2414,2262,152,0,303,0,6
23384,1,2422,2378,44,0,330,0,6
23385,2,2447,2289,158,0,435,0,6
23386,1,2397,2461,-64,0,344,0,6
23387,1,2420,2371,49,0,46,0,6
23388,1,2434,2438,-4,0,102,1,6
23389,2,2302,2470,-168,0,120,0,8
23390,2,2487,2419,68,0,0,0,6
23391,2,2341,2535,-194,0,405,1,6
23392,1,2400,2280,120,4,112,0,13
23393,2,2596,2647,-51,0,370,0,6
23394,1,2483,2363,120,0,245,0,5
23395,2,2562,2627,-65,0,4,0,6
23396,3,2402,2403,-1,0,333,0,6
23397,2,2324,2404,-80,0,100,0,6
23398,2,2403,2377,26,0,113,0,6
23399,2,2458,2478,-20,0,136,0,6
23400,1,2431,2472,-41,0,88,0,6
23401,1,2293,2428,-135,0,123,0,6
23402,1,2505,2518,-13,0,210,1,6
23403,1,2650,2400,250,0,140,0,8
23404,2,2373,2585,-212,0,112,0,8
23405,2,2259,2443,-184,0,43,0,6
23406,2,2373,2464,-91,0,264,0,6
23407,1,2454,2317,137,0,308,1,6
23408,1,2456,2432,24,0,97,0,6
23409,2,2258,2418,-160,0,6,1,6
23410,1,2438,2357,81,0,49,0,6
23411,1,2464,2289,175,0,121,1,6
23412,1,2331,2440,-109,0,43,0,6
23413,1,2403,2224,179,0,45,0,6
23414,1,2426,2230,196,0,25,0,6
23415,2,2409,2524,-115,0,466,0,6
23416,1,2503,2340,163,0,40,0,6
23417,2,2403,2369,34,0,337,0,6
23418,3,2469,2591,-122,0,108,0,6
23419,1,2418,2369,49,0,200,0,6
23420,2,2538,2557,-19,0,40,1,6
23421,2,2433,2397,36,0,300,0,6
23422,2,2349,2452,-103,0,292,1,6
23423,2,2484,2652,-168,0,49,1,6
23424,2,2338,2453,-115,0,337,0,6
23425,1,2465,2420,45,0,190,0,6
23426,2,2359,2486,-127,0,52,0,5
23427,2,2513,2511,2,0,153,1,6
23428,1,2378,2546,-168,0,106,0,6
23429,2,2528,2462,66,0,101,0,6
23430,1,2352,2427,-75,0,90,0,6
23431,2,2307,2405,-98,0,144,0,6
23432,1,2484,2393,91,0,253,0,6
23433,1,2442,2373,69,0,317,1,6
23434,1,2458,2450,8,0,53,0,6
23435,1,2422,2255,167,0,48,0,6
23436,1,2506,2335,171,0,405,0,6
23437,2,2488,2381,107,0,133,0,6
23438,2,2415,2470,-55,0,310,1,6
23439,2,2403,2442,-39,0,312,0,6
23440,1,2375,2458,-83,0,205,0,6
23441,2,2442,2283,159,0,211,0,6
23442,1,2409,2300,109,0,107,0,6
23443,1,2562,2655,-93,0,40,0,6
23444,1,2646,2331,315,0,152,1,8
23445,2,2368,2588,-220,0,113,0,8
23446,1,2489,2348,141,4,101,0,13
23447,2,2302,2481,-179,0,2,0,6
23448,2,2432,2386,46,0,202,1,6
23449,1,2408,2315,93,0,0,1,6
23450,1,2240,2403,-163,0,453,1,6
23451,2,2289,2462,-173,0,308,0,8
23452,2,2403,2589,-186,0,108,0,6
23453,2,2231,2404,-173,4,434,0,13
23454,3,2382,2522,-140,0,45,0,6
23455,2,2354,2434,-80,0,45,1,6
23456,1,2517,2507,10,0,288,0,6
23457,1,2386,2484,-98,0,135,1,6
23458,1,2451,2382,69,0,247,1,6
23459,1,2308,2464,-156,0,40,1,6
23460,1,2420,2371,49,0,106,1,6
23461,2,2445,2572,-127,0,110,0,6
23462,1,2454,2317,137,0,22,1,6
23463,2,2252,2425,-173,0,312,0,6
23464,2,2369,2509,-140,0,102,0,6
23465,1,2542,2459,83,0,314,0,6
23466,1,2471,2331,140,0,243,0,6
23467,2,2392,2406,-14,0,101,1,6
23468,1,2475,2533,-58,0,45,1,6
23469,1,2410,2276,134,0,77,0,6
23470,3,2472,2225,247,0,121,0,7
23471,1,2429,2400,29,0,1,0,6
23472,1,2411,2570,-159,0,106,0,6
23473,1,2413,2353,60,0,81,0,6
23474,1,2515,2226,289,0,13,1,6
23475,1,2519,2400,119,0,263,0,6
23476,2,2415,2601,-186,0,107,0,6
23477,2,2350,2503,-153,0,107,1,6
23478,1,2393,2438,-45,0,152,0,6
23479,1,2426,2447,-21,0,202,0,6
23480,2,2428,2480,-52,0,4,0,6
23481,2,2343,2425,-82,0,4,0,6
23482,1,2501,2523,-22,0,43,1,6
23483,2,2477,2414,63,0,46,1,6
23484,1,2385,2456,-71,0,91,1,6
23485,2,2313,2457,-144,0,128,1,6
23486,2,2366,2455,-89,0,302,0,6
23487,1,2378,2438,-60,0,113,1,6
23488,2,2244,2403,-159,0,5,0,6
23489,2,2592,2441,151,0,15,0,6
23490,2,2485,2424,61,0,2,0,6
23491,1,2429,2249,180,0,303,1,6
23492,2,2388,2435,-47,0,106,1,6
23493,2,2411,2327,84,0,307,0,6
23494,2,2386,2474,-88,0,264,0,6
23495,2,2441,2432,9,0,410,0,6
23496,1,2517,2220,297,0,122,0,6
23498,3,2526,2482,44,0,327,0,6
23499,2,2397,2519,-122,0,120,0,6
23500,2,2523,2399,124,0,208,1,6
23501,1,2432,2273,159,0,210,0,6
23502,2,2327,2504,-177,0,37,1,6
23503,3,2412,2406,6,0,121,0,6
23504,1,2567,2478,89,0,4,0,6
23505,1,2382,2497,-115,0,150,1,6
23506,3,2648,2576,72,0,242,0,6
23507,2,2386,2429,-43,0,43,1,6
23508,3,2368,2438,-70,0,410,0,6
23509,3,2507,2546,-39,0,277,0,6
23510,2,2432,2407,25,0,48,0,6
23511,1,2460,2362,98,0,202,1,6
23512,2,2343,2449,-106,0,96,0,6
23513,2,2404,2392,12,0,96,0,6
23514,2,2481,2476,5,0,15,0,6
23515,1,2523,2493,30,4,46,0,13
23516,1,2432,2395,37,0,27,0,6
23517,2,2246,2432,-186,0,8,0,6
23519,1,2335,2439,-104,0,121,1,6
23520,1,2420,2382,38,0,484,0,6
23521,1,2440,2376,64,0,0,0,6
23522,1,2419,2259,160,0,211,0,6
23523,1,2214,2519,-305,0,315,0,6
23524,1,2307,2407,-100,0,110,0,6
23525,1,2435,2417,18,0,144,1,6
23526,1,2449,2508,-59,0,202,1,6
23527,2,2604,2420,184,0,344,0,6
23528,3,2412,2516,-104,0,269,0,6
23529,1,2489,2526,-37,0,15,0,6
23530,2,2407,2444,-37,0,141,1,6
23531,2,2474,2572,-98,0,3,0,6
23532,3,2523,2483,40,0,327,0,6
23533,2,2465,2315,150,0,102,0,6
23534,2,2509,2245,264,0,4,0,6
23535,2,2434,2304,130,0,125,0,6
23536,2,2413,2244,169,0,57,0,6
23537,2,2437,2381,56,0,241,0,6
23538,1,2357,2464,-107,0,302,0,6
23539,2,2256,2422,-166,0,106,1,6
23540,1,2466,2273,193,0,48,1,8
23541,1,2275,2432,-157,0,4,1,6
23542,2,2426,2349,77,0,41,1,6
23543,2,2318,2437,-119,0,313,0,6
23544,2,2482,2514,-32,0,4,0,6
23545,1,2425,2364,61,0,200,1,6
23546,1,2435,2243,192,0,48,0,6
23547,1,2366,2444,-78,0,106,1,6
23548,2,2456,2365,91,0,202,1,6
23549,1,2386,2431,-45,0,184,0,6
23550,2,2274,2500,-226,0,0,1,6
23551,1,2501,2399,102,0,263,1,6
23552,1,2596,2470,126,0,123,0,6
23553,1,2519,2428,91,0,70,0,6
23554,1,2411,2413,-2,0,4,0,6
23555,1,2489,2441,48,0,153,1,6
23556,1,2483,2382,101,0,300,0,6
23557,1,2378,2449,-71,0,32,0,6
23558,1,2577,2430,147,0,10,0,6
23559,2,2314,2418,-104,0,37,1,6
23560,1,2316,2435,-119,0,200,0,6
23561,3,2522,2393,129,0,337,0,6
23562,2,2425,2524,-99,0,157,0,6
23563,1,2427,2374,53,0,106,1,6
23564,2,2519,2656,-137,0,152,0,6
23565,2,2477,2508,-31,0,8,0,6
23566,1,2240,2438,-198,0,8,1,6
23567,2,2312,2441,-129,0,112,0,6
23568,2,2376,2526,-150,0,13,0,6
23569,2,2404,2430,-26,0,104,0,6
23570,1,2443,2487,-44,0,310,0,6
23571,1,2402,2241,161,0,15,0,6
23572,2,2338,2437,-99,0,106,0,6
23574,2,2488,2249,239,4,101,0,13
23575,2,2421,2600,-179,0,143,0,6
23576,2,2466,2506,-40,0,3,0,6
23577,1,2528,2395,133,0,345,0,6
23578,2,2336,2488,-152,0,327,0,6
23579,1,2271,2436,-165,4,127,0,13
23580,2,2445,2427,18,0,4,1,6
23581,1,2647,2516,131,0,245,0,6
23582,2,2529,2494,35,0,45,0,6
23583,1,2436,2417,19,0,218,1,6
23584,1,2659,2479,180,0,50,0,6
23585,1,2443,2385,58,0,1,0,6
23586,1,2395,2537,-142,0,105,0,6
23587,1,2503,2267,236,0,0,0,6
23588,1,2332,2432,-100,0,0,0,6
23589,2,2456,2603,-147,0,241,1,6
23590,1,2387,2435,-48,0,102,0,6
23591,2,2425,2277,148,0,46,0,6
23592,1,2429,2249,180,0,303,1,6
23593,2,2591,2651,-60,0,226,0,6
23595,1,2447,2500,-53,0,190,0,6
23596,1,2424,2450,-26,0,230,1,6
23597,1,2447,2442,5,0,1,1,6
23598,1,2511,2461,50,0,127,0,6
23599,2,2448,2373,75,0,216,0,6
23600,1,2512,2408,104,0,190,0,6
23601,3,2465,2318,147,4,440,0,13
23602,1,2403,2364,39,0,490,1,6
23603,1,2650,2532,118,0,13,0,6
23604,1,2428,2416,12,0,453,0,6
23605,2,2289,2418,-129,0,308,1,6
23606,2,2663,2528,135,0,45,0,6
23607,1,2439,2377,62,0,483,0,6
23608,1,2429,2441,-12,0,195,0,6
23609,1,2505,2260,245,0,233,0,6
23610,1,2247,2412,-165,0,100,0,6
23611,1,2424,2348,76,0,242,1,6
23612,1,2529,2654,-125,0,7,0,6
23613,2,2238,2417,-179,0,0,0,6
23614,2,2360,2435,-75,0,471,0,6
23615,2,2536,2655,-119,0,406,0,6
23616,1,2390,2516,-126,0,201,0,6
23617,2,2246,2432,-186,0,8,0,6
23618,2,2421,2285,136,0,190,0,6
23619,1,2380,2441,-61,0,404,0,6
23620,2,2453,2374,79,0,176,0,6
23621,2,2433,2418,15,0,9,1,6
23622,1,2430,2523,-93,0,134,0,6
23623,1,2436,2392,44,0,0,0,6
23624,2,2444,2443,1,0,310,0,6
23625,2,2298,2410,-112,0,304,0,6
23626,2,2254,2508,-254,0,52,1,6
23627,1,2456,2516,-60,0,2,0,6
23628,1,2440,2398,42,0,241,0,6
23629,2,2379,2413,-34,0,130,0,6
23630,1,2606,2532,74,0,13,1,6
23631,1,2256,2498,-242,0,11,1,8
23632,1,2435,2243,192,0,303,0,6
23633,2,2404,2247,157,0,132,1,6
23634,1,2422,2285,137,0,189,0,6
23635,1,2422,2377,45,0,101,0,6
23636,2,2457,2647,-190,0,4,0,6
23637,2,2391,2537,-146,0,386,0,6
23638,1,2414,2404,10,0,40,0,6
23639,1,2435,2387,48,0,202,1,6
23640,1,2419,2374,45,0,37,0,6
23641,1,2510,2248,262,0,200,0,6
23642,1,2449,2393,56,0,483,0,6
23643,2,2446,2381,65,0,176,0,6
23644,2,2243,2512,-269,0,0,0,6
23645,2,2509,2463,46,0,458,0,6
23646,3,2427,2438,-11,0,4,0,6
23647,1,2387,2441,-54,0,40,1,6
23648,2,2438,2445,-7,0,490,0,6
23649,1,2420,2427,-7,0,40,0,6
23650,1,2545,2438,107,0,0,0,6
23651,2,2448,2420,28,0,210,0,6
23652,1,2240,2438,-198,0,312,0,6
23653,3,2650,2611,39,0,15,0,6
23654,1,2527,2364,163,0,81,1,6
23655,2,2516,2586,-70,0,486,0,6
23656,1,2382,2440,-58,0,373,0,6
23657,1,2509,2333,176,0,101,0,6
23658,1,2412,2426,-14,0,463,0,6
23659,2,2469,2503,-34,0,2,0,6
23660,2,2591,2659,-68,0,203,1,6
23661,1,2320,2431,-111,0,1,0,6
23662,2,2403,2549,-146,0,42,0,6
23663,1,2429,2249,180,0,303,0,6
23664,2,2402,2388,14,0,0,0,6
23665,2,2425,2439,-14,0,198,1,6
23666,2,2451,2333,118,0,102,0,6
23667,3,2432,2612,-180,0,346,0,6
23668,1,2283,2400,-117,0,454,0,6
23669,2,2330,2512,-182,0,256,0,6
23670,1,2612,2437,175,0,43,1,6
23671,2,2441,2405,36,0,60,0,6
23672,3,2424,2349,75,0,22,0,6
23673,2,2435,2409,26,0,107,0,6
23675,2,2318,2420,-102,0,53,1,6
23676,1,2508,2464,44,0,135,0,6
23678,1,2423,2418,5,0,118,1,6
23679,1,2313,2453,-140,0,311,0,6
23680,2,2552,2586,-34,0,7,0,6
23681,2,2246,2433,-187,0,8,0,6
23682,1,2342,2496,-154,0,100,0,6
23683,3,2223,2522,-299,0,215,0,6
23684,1,2380,2511,-131,0,345,0,6
23685,1,2609,2399,210,0,335,1,6
23686,1,2403,2408,-5,0,300,0,6
23687,2,2443,2435,8,0,167,1,6
23688,2,2515,2429,86,0,104,0,6
23689,2,2459,2513,-54,0,2,1,6
23690,2,2390,2520,-130,0,474,0,6
23691,1,2380,2403,-23,0,119,0,6
23692,3,2282,2435,-153,0,311,0,6
23693,3,2411,2590,-179,0,490,0,6
23694,2,2663,2646,17,0,41,0,6
23695,1,2516,2474,42,0,311,0,6
23696,1,2424,2414,10,0,45,0,6
23697,1,2390,2432,-42,0,84,0,6
23698,1,2436,2243,193,0,48,0,6
23699,1,2436,2456,-20,0,205,1,6
23700,2,2630,2551,79,0,2,1,6
23701,1,2412,2508,-96,0,485,0,6
23702,1,2380,2463,-83,0,201,0,6
23703,2,2400,2436,-36,0,103,0,6
23704,2,2350,2521,-171,0,45,0,6
23705,2,2469,2547,-78,0,4,1,6
23706,1,2492,2309,183,0,385,0,6
23707,2,2288,2438,-150,0,300,0,6
23708,1,2426,2386,40,0,241,0,6
23709,1,2399,2437,-38,0,150,1,6
23710,2,2441,2612,-171,0,394,1,6
23711,2,2240,2438,-198,0,312,0,6
23712,2,2456,2397,59,0,330,1,6
23713,2,2518,2454,64,0,10,0,6
23714,1,2477,2350,127,4,332,0,8
23715,1,2524,2420,104,0,311,0,6
23716,2,2705,2756,-51,0,398,0,6
23717,1,2364,2433,-69,0,201,0,6
23718,2,2430,2272,158,0,300,0,6
23719,2,2409,2430,-21,0,454,0,6
23720,2,2441,2395,46,0,202,0,6
23721,1,2493,2552,-59,0,466,1,6
23722,1,2524,2465,59,0,315,0,6
23723,2,2343,2481,-138,4,101,0,8
23724,3,2441,2237,204,0,303,0,6
23725,1,2520,2279,241,0,311,0,6
23726,2,2433,2377,56,0,404,1,6
23727,2,2401,2435,-34,0,102,0,6
23728,1,2461,2281,180,0,248,0,6
23729,1,2510,2576,-66,0,13,0,6
23730,1,2360,2406,-46,0,107,0,6
23731,1,2461,2511,-50,0,2,0,6
23732,2,2444,2438,6,0,188,1,6
23733,2,2449,2383,66,0,107,0,6
23734,3,2435,2464,-29,0,247,0,6
23735,2,2403,2422,-19,0,45,1,6
23736,1,2414,2344,70,0,15,0,6
23737,1,2403,2285,118,0,80,0,6
23738,2,2761,2699,62,0,20,0,6
23739,1,2398,2402,-4,0,200,0,6
23740,2,2240,2438,-198,0,312,0,6
23741,2,2354,2522,-168,0,1,0,6
23742,2,2440,2396,44,0,160,1,6
23743,2,2461,2374,87,0,457,0,8
23744,1,2545,2460,85,0,0,0,6
23745,1,2442,2379,63,0,414,0,6
23746,1,2569,2517,52,0,292,0,6
23747,1,2463,2286,177,0,145,1,6
23748,2,2505,2468,37,0,85,0,6
23749,1,2552,2376,176,0,483,0,6
23750,1,2360,2438,-78,0,130,1,6
23751,1,2249,2409,-160,0,302,1,6
23752,2,2383,2419,-36,0,278,0,6
23753,2,2362,2423,-61,0,269,1,6
23754,1,2444,2420,24,0,360,0,6
23755,3,2376,2426,-50,0,265,0,6
23756,2,2373,2559,-186,0,409,0,6
23757,2,2588,2429,159,0,226,0,6
23758,2,2264,2436,-172,0,16,0,6
23759,2,2416,2398,18,0,45,0,6
23760,1,2396,2447,-51,0,200,0,6
23761,2,2441,2238,203,0,303,1,6
23762,2,2512,2574,-62,0,143,1,6
23763,2,2474,2498,-24,0,295,0,6
23764,2,2403,2434,-31,0,102,0,6
23765,3,2456,2466,-10,0,4,0,6
23766,2,2415,2416,-1,0,400,0,6
23767,2,2525,2292,233,0,311,1,6
23768,1,2449,2549,-100,0,40,0,6
23769,1,2421,2368,53,0,120,1,6
23770,2,2424,2404,20,0,48,0,6
23771,2,2335,2432,-97,0,454,0,6
23772,2,2708,2754,-46,0,111,0,6
23773,1,2401,2403,-2,0,203,0,6
23774,2,2335,2440,-105,0,304,0,6
23776,2,2240,2457,-217,0,51,0,8
23777,1,2428,2357,71,0,400,1,6
23778,2,2422,2309,113,0,40,0,6
23779,1,2579,2507,72,0,292,1,6
23780,1,2410,2387,23,0,463,1,6
23781,2,2436,2320,116,0,315,1,6
23782,2,2439,2436,3,0,107,0,6
23783,1,2461,2312,149,4,306,0,13
23784,1,2542,2504,38,0,0,0,6
23785,2,2456,2456,0,0,373,0,6
23786,1,2246,2432,-186,0,312,0,6
23787,1,2416,2304,112,0,247,1,6
23788,1,2415,2295,120,0,22,0,6
23789,1,2759,2702,57,0,106,0,6
23790,2,2490,2456,34,0,200,0,6
23791,2,2437,2580,-143,0,478,0,6
23792,3,2552,2495,57,0,4,0,6
23793,2,2462,2407,55,0,40,1,6
23794,2,2441,2433,8,0,102,0,6
23795,2,2296,2425,-129,0,265,0,6
23796,2,2434,2583,-149,0,154,0,6
23797,1,2381,2415,-34,0,301,1,6
23798,2,2372,2428,-56,0,0,0,6
23799,2,2382,2547,-165,0,106,0,6
23800,1,2499,2456,43,0,300,0,6
23801,3,2351,2416,-65,0,113,0,6
23802,2,2403,2419,-16,0,241,0,6
23803,3,2403,2410,-7,0,302,0,6
23804,1,2445,2279,166,0,414,0,6
23805,2,2439,2484,-45,0,289,0,6
23806,2,2463,2452,11,0,6,1,6
23807,2,2550,2456,94,0,1,0,6
23808,1,2413,2277,136,0,301,1,6
23809,1,2408,2367,41,0,49,0,6
23810,3,2550,2420,130,0,8,0,6
23811,2,2451,2456,-5,0,7,1,6
23812,2,2408,2300,108,0,405,1,6
23813,2,2358,2448,-90,0,210,0,6
23814,2,2430,2406,24,0,106,1,6
23815,1,2365,2433,-68,0,61,1,6
23816,2,2489,2434,55,0,102,0,6
23817,2,2583,2656,-73,0,226,0,6
23818,1,2454,2504,-50,0,46,1,6
23819,3,2615,2496,119,0,100,0,6
23820,2,2412,2379,33,0,132,1,6
23821,1,2415,2352,63,0,81,0,6
23822,2,2353,2521,-168,0,345,1,6
23823,2,2408,2326,82,0,122,0,6
23824,1,2441,2482,-41,0,245,1,6
23825,1,2423,2383,40,0,244,0,6
23826,2,2696,2764,-68,0,131,0,6
23827,2,2372,2587,-215,0,143,1,6
23828,2,2358,2407,-49,0,0,0,6
23829,2,2463,2457,6,0,106,1,6
23830,1,2428,2202,226,0,107,0,5
23831,3,2477,2308,169,0,34,0,6
23832,2,2428,2397,31,0,122,0,6
23833,2,2304,2417,-113,0,40,0,6
23834,2,2585,2311,274,0,106,0,6
23835,2,2422,2548,-126,0,115,1,6
23836,1,2272,2444,-172,0,1,0,6
23837,1,2410,2298,112,0,153,1,6
23838,1,2613,2462,151,0,15,1,6
23839,2,2385,2424,-39,0,107,1,6
23840,2,2407,2371,36,0,20,0,6
23841,1,2498,2461,37,0,300,0,6
23842,1,2524,2350,174,0,253,0,6
23843,1,2307,2405,-98,0,52,0,6
23844,1,2512,2445,67,0,315,0,6
23845,1,2419,2356,63,0,332,0,6
23846,1,2413,2244,169,0,49,0,6
23847,1,2449,2332,117,0,15,0,6
23848,1,2353,2410,-57,0,0,1,6
23849,1,2543,2376,167,0,253,1,8
23850,1,2426,2333,93,0,316,1,6
23851,1,2498,2564,-66,0,1,1,6
23852,1,2463,2457,6,0,4,1,6
23853,3,2343,2474,-131,0,45,0,6
23854,1,2403,2422,-19,0,142,0,6
23855,2,2411,2476,-65,0,386,0,6
23856,2,2380,2406,-26,0,122,0,6
23857,1,2335,2421,-86,0,123,1,6
23858,1,2503,2456,47,0,300,1,6
23859,1,2451,2208,243,0,40,1,6
23860,2,2329,2506,-177,0,107,1,6
23861,2,2553,2418,135,0,4,0,6
23862,1,2351,2516,-165,0,40,1,6
23863,1,2769,2691,78,0,404,0,6
23864,2,2441,2745,-304,0,5,0,6
23865,2,2429,2447,-18,0,405,1,6
23866,1,2308,2414,-106,0,335,0,6
23867,2,2436,2470,-34,0,190,0,6
23868,2,2431,2309,122,0,4,0,6
23869,1,2347,2527,-180,0,345,0,6
23870,1,2360,2453,-93,0,303,0,6
23871,1,2378,2401,-23,0,463,0,6
23872,2,2310,2475,-165,0,45,0,6
23873,1,2453,2242,211,0,300,0,6
23874,1,2395,2416,-21,0,250,0,6
23875,3,2559,2502,57,0,380,0,6
23876,2,2468,2458,10,0,4,0,6
23877,1,2403,2431,-28,0,107,1,6
23878,1,2481,2367,114,0,127,0,6
23879,2,2356,2445,-89,0,315,0,6
23880,1,2259,2407,-148,0,45,1,6
23881,2,2557,2505,52,0,1,0,6
23882,1,2451,2617,-166,0,46,0,6
23883,2,2685,2773,-88,0,21,0,6
23884,1,2407,2316,91,0,0,1,6
23885,2,2478,2403,75,0,206,0,6
23886,1,2414,2380,34,0,45,0,6
23887,1,2390,2435,-45,0,202,0,6
23888,2,2416,2410,6,0,122,0,6
23889,2,2402,2421,-19,0,57,0,8
23890,2,2431,2354,77,0,42,0,6
23891,3,2336,2456,-120,0,122,0,6
23892,2,2439,2452,-13,0,5,0,6
23893,2,2338,2424,-86,0,301,0,6
23894,1,2576,2430,146,0,45,0,6
23895,1,2450,2515,-65,0,31,0,6
23896,2,2302,2479,-177,0,41,0,8
23897,2,2464,2463,1,0,4,0,6
23898,1,2425,2326,99,0,4,0,6
23899,2,2503,2410,93,0,244,0,6
23900,1,2428,2329,99,0,0,1,6
23901,1,2471,2579,-108,0,15,1,6
23902,1,2410,2401,9,0,49,1,6
23903,1,2315,2419,-104,0,9,0,6
23904,1,2508,2375,133,0,301,0,6
23905,3,2512,2615,-103,0,1,0,6
23906,2,2404,2576,-172,0,9,0,6
23907,1,2252,2426,-174,0,46,0,6
23908,1,2429,2331,98,0,181,0,6
23909,2,2429,2434,-5,0,5,1,6
23910,1,2457,2423,34,0,438,0,6
23911,3,2298,2465,-167,4,122,0,13
23912,2,2371,2552,-181,0,200,0,6
23913,1,2418,2286,132,0,15,0,6
23914,1,2512,2427,85,0,211,0,6
23915,1,2389,2410,-21,0,40,1,6
23916,1,2457,2379,78,0,374,1,6
23917,1,2401,2247,154,4,101,1,13
23918,2,2420,2477,-57,0,123,1,6
23919,2,2388,2454,-66,0,125,0,6
23920,2,2368,2433,-65,0,121,0,6
23921,1,2432,2398,34,0,201,0,6
23922,1,2450,2380,70,0,61,0,6
23923,2,2267,2405,-138,0,47,0,6
23924,2,2355,2496,-141,0,380,1,6
23925,1,2282,2421,-139,0,157,0,6
23926,1,2322,2402,-80,0,15,0,6
23927,1,2613,2579,34,0,40,0,6
23928,1,2480,2311,169,0,377,0,6
23929,1,2411,2416,-5,0,107,0,6
23930,1,2403,2329,74,0,250,0,6
23931,2,2396,2416,-20,0,250,0,6
23932,1,2415,2462,-47,0,188,0,6
23933,1,2401,2540,-139,0,8,0,6
23934,2,2513,2605,-92,0,1,1,6
23935,1,2439,2418,21,0,4,0,6
23936,2,2329,2534,-205,0,108,0,6
23937,1,2437,2438,-1,0,22,0,6
23938,1,2531,2547,-16,0,4,1,8
23939,2,2349,2479,-130,0,0,0,6
23940,1,2432,2363,69,0,132,1,6
23941,2,2393,2401,-8,0,11,1,6
23942,1,2414,2438,-24,0,4,1,6
23943,1,2477,2374,103,0,308,0,6
23944,1,2308,2444,-136,0,43,1,6
23945,3,2339,2485,-146,0,16,0,6
23946,1,2334,2579,-245,0,107,0,6
23947,1,2414,2290,124,0,485,0,6
23948,1,2500,2352,148,0,244,1,6
23949,1,2456,2422,34,0,58,0,6
23950,2,2432,2345,87,0,132,0,6
23951,3,2574,2623,-49,0,80,0,6
23952,2,2443,2445,-2,0,11,1,6
23953,2,2393,2476,-83,0,152,0,6
23954,1,2497,2532,-35,0,380,1,6
23955,1,2315,2455,-140,0,203,0,6
23956,1,2413,2366,47,0,101,1,6
23957,2,2406,2329,77,0,46,1,6
23958,2,2431,2531,-100,0,2,1,6
23959,2,2222,2448,-226,0,5,0,6
23960,2,2321,2437,-116,0,112,0,6
23961,2,2459,2523,-64,0,302,1,6
23962,1,2421,2359,62,0,378,0,6
23963,1,2482,2345,137,0,20,0,6
23964,2,2449,2336,113,0,278,0,6
23965,1,2591,2509,82,0,100,0,6
23967,2,2286,2417,-131,0,177,0,6
23968,2,2432,2420,12,0,0,1,6
23969,2,2388,2481,-93,0,306,1,6
23970,3,2622,2575,47,0,3,0,6
23971,2,2263,2400,-137,4,101,1,13
23972,1,2292,2401,-109,0,190,0,6
23973,2,2435,2379,56,0,101,0,8
23974,2,2436,2357,79,0,211,1,6
23975,2,2481,2410,71,0,331,0,6
23976,3,2451,2262,189,0,107,0,6
23977,2,2417,2450,-33,0,265,0,6
23978,1,2426,2369,57,0,404,0,6
23979,3,2493,2418,75,0,288,0,6
23980,1,2426,2437,-11,0,2,1,6
23981,1,2404,2353,51,0,130,1,6
23982,1,2535,2458,77,0,302,0,6
23983,2,2576,2621,-45,0,101,0,6
23984,1,2807,2553,254,0,243,1,6
23985,1,2425,2338,87,0,100,0,6
23986,2,2447,2298,149,0,485,0,6
23987,1,2461,2426,35,0,58,1,6
23988,2,2426,2382,44,0,202,1,5
23989,1,2462,2273,189,4,330,1,13
23990,1,2482,2316,166,0,267,1,6
23991,1,2482,2395,87,0,110,0,6
23992,2,2347,2408,-61,0,46,0,6
23993,1,2364,2456,-92,0,244,0,6
23994,1,2321,2430,-109,0,310,0,6
23995,1,2456,2412,44,0,5,0,6
23996,2,2254,2421,-167,0,261,0,6
23997,2,2491,2419,72,0,203,0,6
23998,2,2505,2618,-113,0,1,0,6
23999,2,2421,2343,78,0,373,1,6
24000,2,2280,2430,-150,0,418,1,6
24001,2,2571,2568,3,0,300,0,6
24002,1,2486,2442,44,0,485,0,6
24003,1,2287,2439,-152,0,15,0,6
24004,1,2402,2335,67,0,106,0,6
24005,2,2626,2671,-45,0,5,0,6
24006,1,2458,2540,-82,0,101,0,6
24007,2,2344,2421,-77,0,58,0,6
24008,3,2426,2485,-59,0,311,0,6
24009,1,2401,2466,-65,0,405,0,6
24010,2,2407,2461,-54,0,106,0,6
24011,1,2423,2295,128,0,40,1,6
24012,2,2409,2809,-400,0,0,0,6
24013,2,2371,2421,-50,0,170,0,6
24014,1,2418,2565,-147,0,40,0,6
24015,2,2421,2517,-96,0,490,0,6
24016,1,2425,2297,128,0,305,0,6
24017,2,2459,2416,43,0,44,0,6
24018,3,2676,2621,55,0,40,0,6
24019,2,2304,2408,-104,0,8,1,6
24020,3,2466,2402,64,0,5,0,6
24021,1,2622,2533,89,0,10,0,6
24022,1,2412,2330,82,0,106,0,6
24023,2,2465,2490,-25,0,107,1,6
24024,3,2550,2501,49,0,100,0,6
24025,1,2439,2289,150,0,4,0,6
24026,2,2484,2427,57,0,133,1,6
24027,2,2425,2339,86,0,46,1,6
24028,2,2409,2390,19,0,183,1,6
24029,1,2416,2417,-1,0,55,0,6
24030,2,2430,2422,8,0,133,1,6
24031,3,2428,2571,-143,0,49,0,6
24032,1,2495,2491,4,0,150,0,6
24033,1,2405,2266,139,4,221,0,13
24034,1,2412,2433,-21,0,256,1,6
24035,2,2460,2596,-136,0,225,0,6
24036,2,2403,2465,-62,0,265,0,6
24037,1,2421,2328,93,0,103,0,6
24038,1,2459,2262,197,0,490,1,6
24039,1,2412,2349,63,0,344,0,6
24040,1,2529,2589,-60,0,398,0,6
24041,1,2413,2326,87,0,106,0,6
24042,1,2415,2366,49,0,45,0,6
24043,2,2502,2550,-48,0,1,0,6
24044,1,2426,2394,32,0,13,1,6
24045,2,2418,2346,72,0,0,1,6
24046,1,2296,2454,-158,0,190,0,6
24047,1,2434,2399,35,0,345,0,6
24048,1,2410,2396,14,0,46,1,6
24049,2,2411,2422,-11,0,300,0,6
24050,1,2408,2292,116,0,405,0,6
24051,1,2439,2485,-46,0,1,0,6
24052,2,2627,2707,-80,0,332,1,6
24053,1,2555,2456,99,0,128,0,6
24054,1,2410,2404,6,4,120,0,13
24055,2,2398,2417,-19,0,204,1,6
24056,2,2583,2497,86,0,100,0,6
24057,2,2403,2344,59,0,358,0,6
24058,1,2627,2536,91,0,37,0,6
24059,2,2428,2422,6,0,414,1,6
24060,1,2469,2419,50,0,5,1,6
24061,2,2321,2424,-103,0,1,0,6
24062,1,2427,2406,21,0,107,0,6
24063,3,2502,2378,124,0,207,0,6
24064,1,2516,2354,162,0,201,1,6
24065,1,2411,2513,-102,0,80,0,6
24066,2,2559,2408,151,0,127,0,6
24067,2,2330,2412,-82,0,201,0,6
24068,1,2414,2301,113,0,46,0,6
24069,2,2411,2365,46,0,98,0,6
24070,2,2479,2394,85,0,485,0,6
24071,2,2480,2636,-156,0,211,0,6
24072,1,2439,2317,122,0,106,0,6
24073,1,2317,2422,-105,0,268,0,6
24074,2,2290,2417,-127,0,146,0,6
24075,1,2444,2381,63,0,292,0,6
24076,2,2238,2403,-165,0,332,0,6
24077,1,2484,2452,32,0,321,0,6
24078,2,2569,2431,138,0,226,0,6
24079,1,2712,2622,90,0,45,1,6
24080,1,2414,2259,155,0,0,0,8
24081,1,2522,2476,46,0,216,0,6
24082,1,2401,2422,-21,0,45,1,6
24083,1,2474,2505,-31,0,4,1,6
24084,1,2393,2419,-26,0,163,1,6
24085,1,2404,2330,74,0,45,1,6
24086,1,2433,2457,-24,0,331,0,6
24087,1,2353,2500,-147,0,453,1,6
24088,1,2429,2519,-90,0,45,0,6
24089,1,2533,2395,138,0,303,0,6
24090,2,2675,2602,73,0,405,0,6
24091,2,2408,2397,11,0,43,0,6
24092,1,2350,2403,-53,0,483,0,6
24093,1,2301,2443,-142,0,133,0,6
24094,2,2354,2421,-67,0,123,0,6
24095,2,2531,2642,-111,0,466,0,6
24096,2,2401,2314,87,0,40,0,6
24097,1,2523,2310,213,0,46,0,6
24098,2,2342,2416,-74,0,0,1,6
24099,1,2404,2432,-28,0,112,0,6
24101,1,2438,2409,29,0,40,0,6
24102,2,2447,2483,-36,0,202,0,6
24103,2,2286,2450,-164,0,153,0,6
24104,2,2368,2436,-68,0,133,1,6
24105,1,2416,2323,93,0,49,1,6
24106,1,2499,2377,122,0,474,0,6
24107,2,2407,2481,-74,0,300,0,6
24109,3,2362,2536,-174,0,107,0,6
24110,2,2338,2451,-113,0,181,0,6
24111,2,2413,2399,14,0,0,1,6
24112,2,2618,2716,-98,0,7,1,6
24113,2,2403,2439,-36,0,113,0,6
24114,2,2246,2409,-163,0,113,0,6
24115,2,2321,2450,-129,0,1,1,6
24116,1,2646,2668,-22,0,123,0,6
24117,1,2403,2283,120,0,302,0,6
24118,2,2395,2445,-50,0,148,0,6
24119,1,2425,2404,21,0,202,0,6
24120,1,2279,2410,-131,0,268,0,6
24121,2,2292,2639,-347,0,206,1,6
24122,1,2551,2442,109,0,7,1,6
24123,1,2346,2511,-165,0,141,0,6
24124,1,2647,2581,66,0,270,1,6
24125,2,2388,2493,-105,0,151,0,6
24126,1,2440,2338,102,0,52,0,6
24127,1,2417,2351,66,0,102,0,6
24128,1,2303,2439,-136,0,11,1,6
24129,2,2472,2485,-13,0,0,1,6
24130,1,2416,2402,14,0,55,0,6
24131,1,2358,2407,-49,0,0,1,6
24132,1,2455,2405,50,0,284,0,6
24133,1,2364,2407,-43,0,43,1,6
24134,2,2662,2652,10,0,455,1,6
24135,1,2504,2591,-87,0,1,0,6
24136,2,2720,2614,106,0,300,1,6
24137,2,2239,2413,-174,0,310,1,6
24138,1,2247,2402,-155,0,337,0,6
24139,2,2317,2451,-134,0,1,0,6
24140,2,2405,2487,-82,0,320,0,6
24141,1,2527,2208,319,0,8,0,6
24142,1,2402,2316,86,0,40,0,6
24143,2,2432,2398,34,0,204,0,6
24144,1,2453,2503,-50,0,85,0,6
24145,3,2379,2404,-25,0,7,0,6
24146,2,2335,2451,-116,0,0,1,6
24147,1,2412,2406,6,0,112,1,6
24148,1,2351,2528,-177,0,225,0,6
24149,1,2549,2492,57,0,130,0,6
24150,1,2497,2391,106,0,4,0,6
24151,1,2386,2430,-44,0,8,0,6
24152,2,2304,2407,-103,0,469,0,6
24153,2,2438,2652,-214,0,121,0,6
24154,3,2584,2511,73,0,100,0,6
24155,1,2453,2555,-102,0,106,0,6
24156,2,2496,2400,96,0,302,0,6
24157,1,2312,2407,-95,0,41,1,6
24158,1,2460,2459,1,0,153,0,6
24159,2,2491,2466,25,0,4,0,6
24160,1,2418,2242,176,4,245,0,13
24161,1,2443,2290,153,0,157,0,6
24162,2,2405,2439,-34,0,337,0,6
24163,1,2455,2431,24,0,45,0,6
24164,1,2487,2399,88,0,9,0,6
24165,1,2404,2486,-82,0,381,0,6
24166,3,2406,2302,104,0,236,0,6
24167,2,2313,2401,-88,0,1,0,6
24168,2,2256,2439,-183,0,211,1,6
24169,1,2431,2311,120,0,305,1,6
24170,1,2520,2242,278,0,453,1,6
24171,2,2334,2422,-88,0,0,0,6
24172,1,2621,2713,-92,0,302,1,6
24173,1,2550,2543,7,0,130,0,6
24174,2,2472,2363,109,0,133,0,6
24175,1,2424,2372,52,0,45,0,6
24176,2,2358,2431,-73,0,40,0,6
24177,1,2404,2371,33,0,17,1,6
24178,2,2461,2302,159,0,310,0,6
24179,2,2435,2454,-19,0,121,0,6
24180,1,2640,2486,154,0,151,1,6
24181,1,2547,2487,60,0,0,0,6
24182,1,2274,2422,-148,0,405,0,6
24183,2,2375,2489,-114,0,105,0,6
24184,1,2476,2408,68,0,337,0,6
24185,1,2424,2506,-82,0,40,1,6
24186,2,2401,2280,121,0,12,1,6
24187,2,2459,2411,48,0,487,1,6
24188,1,2435,2386,49,0,31,0,8
24189,1,2423,2259,164,0,101,0,6
24190,1,2492,2393,99,0,18,0,6
24191,1,2430,2543,-113,0,202,1,6
24192,2,2583,2554,29,0,140,0,6
24193,2,2405,2399,6,0,4,0,6
24194,2,2455,2485,-30,0,302,0,6
24195,3,2405,2400,5,0,41,0,6
24196,1,2445,2319,126,0,44,0,6
24197,1,2479,2391,88,0,140,0,6
24198,2,2421,2355,66,0,352,0,6
24199,2,2426,2499,-73,0,112,0,6
24200,3,2284,2659,-375,0,125,0,6
24201,2,2656,2660,-4,0,320,0,6
24202,2,2368,2429,-61,0,311,0,6
24203,2,2436,2487,-51,0,112,0,6
24204,1,2461,2309,152,0,106,0,6
24205,3,2450,2371,79,0,84,0,6
24206,2,2493,2556,-63,0,43,1,6
24207,2,2404,2523,-119,0,432,0,6
24208,1,2396,2476,-80,0,410,0,6
24209,1,2436,2353,83,0,114,0,6
24210,1,2442,2330,112,0,5,0,6
24211,2,2428,2412,16,0,140,0,6
24212,2,2552,2577,-25,0,0,0,6
24213,2,2307,2435,-128,0,11,0,6
24214,1,2706,2629,77,0,300,0,6
24215,2,2293,2468,-175,4,106,0,13
24216,1,2534,2400,134,0,321,0,6
24217,2,2310,2410,-100,0,106,0,6
24218,1,2403,2473,-70,0,204,1,6
24220,2,2405,2551,-146,0,40,1,6
24221,2,2426,2358,68,0,106,0,6
24222,2,2317,2497,-180,0,123,0,6
24224,2,2306,2499,-193,0,0,1,6
24225,1,2481,2452,29,0,335,1,6
24227,2,2417,2438,-21,0,324,0,6
24228,3,2277,2434,-157,0,1,0,6
24229,2,2418,2339,79,0,202,0,6
24230,2,2315,2431,-116,0,46,0,6
24231,1,2400,2305,95,0,40,1,6
24232,1,2504,2622,-118,0,80,0,6
24233,1,2329,2408,-79,0,10,0,6
24234,1,2521,2414,107,0,40,0,6
24235,2,2329,2489,-160,0,40,1,6
24236,1,2316,2414,-98,0,204,0,6
24237,1,2421,2293,128,0,119,0,6
24238,1,2386,2465,-79,0,36,0,6
24239,2,2539,2417,122,0,152,0,6
24240,2,2500,2405,95,0,101,1,6
24241,3,2244,2479,-235,0,40,0,8
24242,2,2293,2449,-156,0,220,0,6
24243,1,2343,2483,-140,0,380,0,6
24244,1,2252,2409,-157,4,121,0,13
24245,2,2624,2710,-86,0,28,0,6
24246,2,2435,2421,14,0,112,1,6
24247,1,2400,2291,109,0,487,0,6
24248,2,2311,2570,-259,0,374,0,6
24249,2,2358,2489,-131,0,81,0,6
24250,3,2582,2547,35,0,109,0,6
24251,1,2615,2511,104,0,4,0,6
24252,1,2414,2384,30,0,110,0,6
24253,2,2268,2406,-138,4,45,0,13
24254,3,2410,2426,-16,0,106,0,6
24255,2,2283,2418,-135,0,144,0,6
24256,2,2466,2422,44,0,120,1,6
24257,3,2481,2383,98,0,135,0,6
24258,1,2367,2472,-105,0,45,0,6
24259,2,2432,2402,30,0,201,0,6
24260,2,2420,2401,19,0,100,1,6
24261,3,2359,2447,-88,0,0,0,6
24262,1,2502,2304,198,0,102,1,6
24263,2,2410,2393,17,0,89,1,6
24264,2,2432,2489,-57,0,251,0,6
24265,1,2644,2452,192,0,100,0,6
24266,2,2453,2466,-13,0,405,0,6
24267,2,2292,2430,-138,0,310,0,8
24268,1,2373,2486,-113,0,354,0,6
24269,2,2388,2446,-58,0,380,0,6
24270,2,2452,2326,126,0,43,1,6
24271,2,2407,2306,101,0,40,1,6
24272,2,2425,2432,-7,0,4,0,6
24273,1,2572,2309,263,0,300,0,6
24274,2,2263,2654,-391,0,49,0,6
24275,2,2395,2507,-112,0,141,0,6
24276,1,2438,2304,134,0,305,1,6
24277,1,2516,2493,23,0,107,0,6
24278,2,2619,2651,-32,0,4,0,6
24279,2,2380,2404,-24,0,1,0,6
24280,2,2351,2548,-197,0,469,1,6
24281,1,2715,2620,95,0,300,0,6
24282,2,2365,2480,-115,0,0,0,6
24283,2,2510,2582,-72,0,300,0,6
24284,2,2609,2791,-182,0,306,0,6
24285,2,2356,2488,-132,0,140,0,6
24286,1,2655,2424,231,0,133,0,6
24287,2,2429,2329,100,0,111,1,6
24288,2,2449,2647,-198,0,112,0,6
24289,2,2426,2410,16,0,5,1,6
24290,2,2464,2428,36,0,107,0,6
24291,1,2401,2502,-101,0,310,0,6
24292,1,2438,2419,19,0,3,0,6
24293,2,2366,2409,-43,0,107,0,6
24294,1,2408,2425,-17,0,315,0,6
24295,3,2401,2347,54,4,8,0,13
24296,1,2471,2448,23,0,20,0,6
24298,2,2441,2445,-4,0,80,0,6
24299,1,2492,2333,159,0,123,0,6
24300,1,2255,2414,-159,0,463,1,6
24301,2,2399,2404,-5,0,100,0,6
24302,1,2422,2541,-119,0,474,0,6
24303,2,2656,2614,42,0,404,0,6
24304,1,2436,2375,61,0,18,0,6
24305,1,2434,2494,-60,0,373,1,6
24306,1,2451,2383,68,0,5,1,6
24307,2,2414,2443,-29,0,4,0,6
24308,1,2494,2243,251,0,135,0,6
24309,1,2495,2339,156,0,124,1,6
24310,2,2330,2404,-74,0,305,0,6
24311,2,2295,2408,-113,0,31,0,6
24312,2,2586,2548,38,0,201,1,6
24313,1,2658,2210,448,0,106,0,6
24314,1,2620,2650,-30,0,0,1,6
24315,2,2536,2392,144,0,107,0,6
24316,1,2411,2289,122,0,102,1,6
24317,1,2374,2550,-176,0,4,0,6
24318,1,2414,2361,53,0,35,0,6
24319,2,2362,2435,-73,0,145,0,6
24320,1,2530,2298,232,0,48,0,6
24321,2,2313,2421,-108,0,1,0,6
24322,1,2416,2522,-106,0,132,1,6
24323,1,2511,2516,-5,0,483,1,6
24324,2,2370,2441,-71,0,45,0,6
24325,3,2402,2505,-103,0,107,0,6
24326,2,2479,2448,31,0,200,0,6
24327,1,2410,2307,103,0,106,0,6
24328,2,2233,2497,-264,0,45,1,6
24329,2,2477,2382,95,0,175,1,6
24330,3,2294,2406,-112,0,38,0,6
24331,1,2434,2375,59,0,256,0,8
24332,3,2534,2467,67,0,28,0,6
24333,2,2394,2405,-11,0,211,1,6
24334,2,2267,2659,-392,0,455,0,6
24335,2,2425,2309,116,0,106,1,6
24336,2,2488,2419,69,0,373,1,6
24337,1,2650,2447,203,0,0,0,6
24338,1,2356,2419,-63,0,241,0,6
24339,1,2454,2445,9,0,110,0,6
24340,2,2400,2474,-74,4,106,0,13
24341,2,2542,2449,93,0,0,0,6
24342,2,2412,2265,147,0,343,0,6
24343,1,2574,2308,266,0,300,0,6
24344,1,2326,2473,-147,0,102,0,6
24345,2,2555,2580,-25,0,36,0,6
24346,1,2408,2317,91,0,7,0,6
24347,1,2408,2317,91,0,340,0,6
24348,2,2306,2576,-270,0,50,0,6
24349,1,2375,2425,-50,0,211,0,6
24350,1,2660,2533,127,0,255,0,6
24351,1,2423,2260,163,0,112,0,6
24352,2,2424,2348,76,0,231,0,8
24353,1,2358,2528,-170,0,48,0,6
24354,1,2332,2426,-94,4,9,0,13
24355,2,2349,2503,-154,0,107,0,6
24356,1,2414,2404,10,0,0,0,6
24357,2,2533,2429,104,0,124,0,6
24358,3,2436,2293,143,0,53,0,6
24359,1,2440,2424,16,0,335,0,6
24360,1,2509,2533,-24,0,41,0,6
24361,1,2455,2474,-19,0,310,0,6
24362,1,2499,2327,172,0,101,1,6
24363,1,2337,2531,-194,0,10,0,8
24364,3,2468,2488,-20,0,152,0,6
24365,1,2369,2514,-145,0,132,0,6
24366,2,2304,2505,-201,0,40,0,6
24367,3,2442,2379,63,0,49,0,6
24368,2,2258,2413,-155,0,45,0,6
24369,3,2585,2549,36,0,118,0,6
24370,1,2317,2418,-101,0,1,0,6
24371,1,2365,2440,-75,0,487,0,6
24372,2,2504,2524,-20,0,36,0,6
24373,2,2481,2535,-54,0,4,0,6
24374,1,2537,2389,148,0,46,1,6
24375,1,2533,2334,199,0,120,0,6
24376,1,2426,2270,156,0,123,0,6
24377,1,2405,2314,91,0,244,0,6
24378,2,2520,2366,154,0,135,1,6
24379,1,2419,2282,137,0,369,0,6
24380,1,2434,2389,45,0,50,0,6
24381,1,2412,2301,111,0,360,0,6
24382,1,2664,2426,238,0,133,0,6
24383,2,2358,2423,-65,0,0,0,6
24384,1,2411,2324,87,0,135,0,6
24385,2,2527,2515,12,0,107,0,6
24386,2,2606,2643,-37,0,366,0,6
24387,3,2282,2447,-165,0,132,0,6
24388,1,2498,2498,0,0,16,0,6
24390,1,2487,2431,56,0,122,0,6
24391,2,2561,2530,31,0,180,0,6
24393,1,2446,2423,23,0,40,0,6
24394,1,2416,2270,146,0,383,0,6
24395,2,2477,2307,170,0,35,0,6
24396,1,2513,2439,74,0,263,0,6
24397,3,2294,2400,-106,0,103,0,6
24398,2,2506,2468,38,0,300,0,6
24399,1,2422,2536,-114,0,172,0,6
24400,1,2433,2331,102,0,123,0,6
24401,2,2470,2541,-71,0,304,0,6
24402,2,2476,2466,10,0,7,0,6
24403,1,2540,2504,36,0,0,0,6
24404,1,2530,2325,205,0,7,0,6
24405,2,2401,2451,-50,0,152,0,8
24406,1,2493,2537,-44,0,123,0,6
24407,1,2492,2357,135,0,404,0,6
24408,1,2429,2334,95,0,205,0,6
24409,1,2521,2521,0,0,302,1,6
24410,2,2475,2545,-70,0,112,0,6
24411,2,2359,2667,-308,0,0,0,6
24412,1,2500,2404,96,0,40,1,6
24413,1,2315,2418,-103,0,303,0,6
24414,1,2416,2320,96,0,106,0,6
24415,1,2446,2296,150,0,84,0,6
24416,2,2265,2503,-238,0,410,1,6
24417,1,2532,2417,115,0,102,0,6
24418,1,2352,2441,-89,0,300,0,6
24419,2,2418,2451,-33,0,370,1,6
24420,1,2435,2554,-119,0,123,0,6
24421,3,2297,2492,-195,0,385,0,6
24422,3,2649,2601,48,0,405,0,6
24423,1,2434,2415,19,0,241,0,6
24424,2,2322,2428,-106,0,330,0,6
24425,1,2430,2515,-85,0,133,0,6
24426,1,2584,2550,34,0,129,0,6
24427,2,2413,2418,-5,0,5,0,6
24428,1,2527,2341,186,4,13,1,13
24429,1,2316,2411,-95,0,255,0,6
24430,2,2378,2413,-35,0,428,0,6
24431,1,2437,2303,134,0,25,0,6
24432,2,2428,2499,-71,0,33,0,6
24433,2,2533,2420,113,0,5,0,6
24434,2,2424,2223,201,0,106,0,6
24435,2,2449,2545,-96,0,474,1,6
24436,2,2396,2668,-272,0,460,0,6
24437,1,2330,2472,-142,0,302,0,6
24438,2,2308,2433,-125,0,131,0,6
24439,1,2470,2412,58,0,5,0,6
24440,2,2554,2569,-15,0,45,0,6
24441,2,2444,2443,1,0,58,0,6
24442,1,2369,2536,-167,0,277,0,6
24443,3,2530,2499,31,0,143,0,6
24444,3,2400,2303,97,0,41,0,6
24445,2,2424,2475,-51,0,300,0,6
24446,2,2515,2527,-12,0,241,0,6
24447,2,2262,2410,-148,4,453,0,13
24448,1,2317,2465,-148,0,15,0,6
24449,1,2432,2349,83,0,41,0,6
24450,2,2380,2433,-53,0,453,1,6
24451,1,2372,2456,-84,0,45,0,6
24453,2,2353,2446,-93,0,210,0,6
24454,1,2358,2441,-83,0,113,0,6
24455,2,2508,2300,208,0,331,0,6
24456,1,2410,2316,94,0,106,1,6
24457,1,2545,2589,-44,0,13,1,6
24458,1,2404,2313,91,0,469,0,6
24459,2,2602,2648,-46,0,380,0,6
24460,2,2504,2470,34,0,20,0,6
24461,1,2423,2424,-1,0,337,0,6
24462,3,2404,2299,105,0,302,0,6
24463,3,2439,2391,48,0,81,0,6
24464,1,2430,2309,121,0,386,1,6
24465,1,2404,2229,175,0,0,0,6
24466,2,2441,2313,128,0,101,1,6
24467,1,2418,2373,45,0,4,0,6
24468,1,2483,2400,83,4,337,1,13
24469,1,2411,2304,107,0,324,0,6
24470,2,2277,2437,-160,0,392,1,6
24471,2,2427,2316,111,0,320,0,6
24472,2,2274,2525,-251,0,41,0,6
24473,1,2464,2310,154,0,133,0,6
24474,1,2652,2465,187,0,111,0,6
24475,1,2434,2359,75,0,305,1,6
24476,2,2439,2423,16,0,117,0,6
24477,2,2310,2431,-121,0,176,0,6
24478,2,2670,2507,163,0,147,1,6
24479,1,2440,2445,-5,0,210,0,6
24480,2,2549,2575,-26,0,0,0,6
24481,1,2530,2480,50,0,267,1,6
24482,1,2450,2349,101,0,45,0,6
24483,3,2426,2567,-141,0,110,0,6
24484,2,2415,2394,21,0,253,0,6
24485,2,2436,2407,29,0,123,0,6
24486,1,2378,2449,-71,0,140,1,6
24487,2,2434,2499,-65,0,380,1,6
24488,1,2457,2358,99,0,345,0,6
24489,1,2506,2337,169,0,110,1,6
24490,1,2454,2435,19,0,46,1,6
24491,1,2493,2325,168,0,330,0,6
24492,1,2528,2324,204,0,8,1,6
24493,2,2583,2552,31,0,129,0,6
24494,2,2312,2414,-102,0,1,0,6
24495,2,2418,2438,-20,0,133,0,6
24496,2,2465,2426,39,0,58,1,8
24497,1,2476,2524,-48,0,107,0,6
24498,2,2429,2434,-5,0,337,1,6
24499,1,2379,2454,-75,0,45,0,6
24500,1,2408,2282,126,0,411,1,6
24501,1,2434,2416,18,0,343,1,6
24502,1,2544,2655,-111,0,0,0,6
24503,2,2368,2467,-99,0,331,1,6
24504,1,2446,2229,217,0,40,0,6
24505,2,2415,2399,16,0,49,1,6
24506,1,2425,2440,-15,0,133,0,6
24507,2,2428,2333,95,0,230,0,6
24508,2,2526,2429,97,0,5,0,6
24509,2,2409,2286,123,0,414,0,6
24510,1,2321,2433,-112,0,302,0,6
24511,1,2439,2375,64,0,414,1,6
24512,3,2461,2565,-104,0,346,0,6
24513,1,2413,2338,75,0,0,0,6
24514,2,2300,2429,-129,0,103,0,6
24515,1,2475,2430,45,0,7,0,6
24516,1,2580,2614,-34,0,454,0,6
24517,1,2418,2308,110,0,40,0,6
24518,2,2341,2421,-80,0,247,0,6
24519,2,2355,2662,-307,0,122,0,6
24520,2,2443,2444,-1,0,490,0,6
24521,2,2407,2413,-6,0,284,0,6
24522,1,2440,2546,-106,0,61,0,6
24523,2,2432,2350,82,0,43,0,6
24524,3,2430,2459,-29,0,315,0,6
24525,2,2437,2439,-2,0,436,0,6
24526,1,2434,2335,99,0,205,0,6
24527,1,2427,2263,164,0,6,0,6
24528,1,2558,2577,-19,0,36,0,6
24529,1,2565,2463,102,0,110,0,6
24530,1,2528,2455,73,0,300,1,6
24531,2,2487,2354,133,0,150,0,6
24532,2,2479,2336,143,0,258,1,6
24533,2,2283,2425,-142,0,317,1,6
24534,1,2423,2418,5,0,405,0,6
24535,2,2304,2422,-118,0,1,0,6
24536,1,2433,2357,76,0,337,0,6
24537,1,2363,2530,-167,0,226,0,6
24538,1,2419,2241,178,0,45,1,6
24539,2,2329,2439,-110,0,0,0,6
24540,2,2518,2648,-130,0,40,0,6
24541,1,2474,2395,79,0,42,0,6
24542,2,2323,2444,-121,0,40,0,6
24543,1,2439,2419,20,0,46,1,6
24544,3,2286,2443,-157,0,373,0,6
24545,1,2318,2438,-120,0,130,0,6
24546,2,2425,2345,80,0,335,0,6
24547,2,2390,2578,-188,0,10,0,6
24548,1,2404,2364,40,0,345,1,6
24549,3,2256,2517,-261,0,45,0,6
24550,2,2519,2515,4,0,4,1,6
24551,2,2437,2480,-43,0,315,1,6
24552,2,2321,2420,-99,0,267,1,6
24553,2,2260,2431,-171,0,415,0,6
24554,2,2374,2401,-27,0,122,0,6
24555,2,2425,2447,-22,0,242,0,6
24556,1,2458,2450,8,0,304,1,6
24557,2,2519,2587,-68,0,4,0,6
24558,1,2448,2419,29,0,330,0,6
24559,2,2449,2386,63,0,202,1,6
24560,1,2403,2314,89,0,45,0,6
24561,1,2664,2313,351,0,101,0,6
24562,1,2505,2483,22,0,132,0,6
24563,3,2431,2319,112,0,345,0,6
24564,1,2538,2423,115,0,267,0,6
24565,2,2412,2500,-88,0,315,1,6
24566,1,2390,2438,-48,0,102,1,6
24567,2,2400,2409,-9,0,205,0,6
24568,1,2273,2413,-140,0,110,0,6
24569,2,2407,2561,-154,0,486,0,6
24570,2,2571,2509,62,0,112,0,6
24571,2,2294,2426,-132,0,203,0,6
24572,3,2450,2533,-83,0,455,0,6
24573,1,2297,2430,-133,0,130,0,6
24574,1,2419,2299,120,0,138,0,6
24575,1,2426,2300,126,0,127,0,6
24576,1,2449,2429,20,0,242,1,6
24577,2,2309,2424,-115,0,7,1,6
24578,1,2652,2653,-1,0,0,1,6
24579,2,2456,2553,-97,0,3,0,6
24580,2,2522,2423,99,0,303,0,6
24581,1,2371,2469,-98,0,7,0,6
24582,1,2426,2446,-20,0,302,0,6
24584,1,2289,2432,-143,0,389,1,6
24585,1,2296,2430,-134,0,1,1,6
24586,1,2413,2485,-72,0,265,1,6
24587,2,2395,2492,-97,4,106,1,13
24588,2,2288,2419,-131,0,13,1,6
24589,2,2401,2450,-49,0,45,0,6
24590,2,2431,2254,177,4,288,1,8
24591,3,2453,2509,-56,0,375,0,6
24592,2,2448,2269,179,0,140,1,6
24593,1,2413,2320,93,4,145,0,13
24594,1,2409,2380,29,0,214,0,6
24595,1,2403,2372,31,0,200,1,6
24596,2,2513,2665,-152,0,196,0,6
24597,1,2430,2439,-9,0,13,1,6
24598,2,2352,2418,-66,0,112,0,6
24599,1,2430,2383,47,0,469,0,6
24600,1,2234,2515,-281,0,264,0,6
24601,1,2469,2359,110,0,7,0,6
24602,2,2535,2591,-56,0,133,0,6
24603,1,2581,2397,184,0,330,0,6
24604,2,2550,2535,15,0,4,0,6
24605,1,2378,2552,-174,0,0,0,6
24606,2,2245,2433,-188,4,6,0,11
24608,2,2266,2506,-240,0,253,0,6
24609,1,2337,2402,-65,0,330,0,6
24610,1,2431,2397,34,0,344,0,6
24611,1,2516,2564,-48,0,213,0,6
24612,2,2553,2726,-173,0,150,0,6
24613,1,2414,2429,-15,0,49,0,6
24614,2,2423,2455,-32,0,204,0,6
24615,3,2444,2429,15,0,304,0,6
24616,2,2608,2452,156,0,154,0,6
24617,3,2407,2247,160,0,45,0,6
24618,1,2531,2451,80,0,344,0,6
24619,2,2440,2432,8,0,121,0,6
24620,2,2414,2770,-356,0,150,0,6
24621,1,2478,2478,0,0,156,0,6
24622,1,2422,2230,192,4,330,0,13
24623,2,2424,2393,31,0,7,1,6
24624,3,2444,2333,111,0,28,0,6
24625,2,2335,2457,-122,0,176,0,6
24626,3,2260,2402,-142,0,13,0,6
24627,1,2438,2345,93,0,107,1,6
24628,1,2658,2647,11,0,36,0,6
24629,2,2508,2650,-142,0,7,1,6
24630,1,2422,2304,118,0,0,0,6
24631,2,2379,2408,-29,0,205,0,6
24632,2,2478,2420,58,0,5,1,6
24633,3,2263,2510,-247,0,45,0,6
24634,1,2508,2268,240,0,15,0,6
24635,2,2300,2426,-126,0,1,0,6
24636,2,2389,2409,-20,0,41,1,6
24637,1,2596,2558,38,0,335,0,6
24638,1,2565,2389,176,0,203,0,6
24639,1,2423,2396,27,0,335,0,6
24640,1,2476,2512,-36,0,241,1,6
24641,3,2460,2418,42,0,246,0,6
24642,2,2226,2435,-209,0,123,0,6
24643,3,2431,2409,22,0,338,0,6
24644,2,2363,2423,-60,0,317,0,6
24645,2,2392,2436,-44,0,153,1,6
24646,1,2730,2550,180,0,101,0,6
24647,3,2393,2536,-143,0,120,0,6
24648,1,2404,2297,107,0,45,0,6
24649,2,2460,2600,-140,0,3,0,6
24650,2,2225,2460,-235,0,153,0,6
24651,1,2245,2403,-158,0,269,1,6
24652,2,2219,2441,-222,0,100,0,6
24653,2,2476,2420,56,0,335,0,6
24654,1,2400,2330,70,0,4,0,6
24655,2,2367,2669,-302,0,123,0,6
24656,2,2434,2436,-2,0,76,0,6
24657,2,2392,2543,-151,0,469,1,6
24658,2,2606,2582,24,0,130,0,6
24659,3,2777,2412,365,0,405,0,6
24660,1,2451,2484,-33,0,4,1,6
24661,3,2413,2331,82,0,405,0,6
24662,2,2438,2434,4,0,345,1,6
24663,2,2419,2321,98,0,0,0,6
24664,2,2448,2415,33,0,308,1,8
24665,1,2357,2418,-61,0,102,1,6
24666,2,2430,2296,134,0,106,0,6
24667,3,2443,2354,89,0,341,0,6
24668,1,2400,2289,111,0,46,0,6
24669,1,2239,2409,-170,4,0,0,13
24670,2,2523,2447,76,0,202,1,6
24671,1,2375,2433,-58,0,207,0,8
24672,1,2604,2457,147,0,107,1,6
24673,3,2289,2442,-153,0,131,0,6
24674,1,2671,2310,361,0,101,0,6
24675,2,2328,2412,-84,0,40,0,6
24676,2,2471,2464,7,0,117,0,6
24677,3,2536,2472,64,0,5,0,6
24678,1,2553,2601,-48,0,133,0,6
24679,3,2390,2544,-154,0,110,0,6
24680,2,2589,2454,135,0,45,0,6
24681,2,2399,2428,-29,0,300,0,6
24682,2,2506,2372,134,0,211,0,6
24683,2,2409,2341,68,0,198,0,6
24684,1,2663,2482,181,0,13,0,6
24685,1,2428,2414,14,0,41,0,6
24686,2,2542,2416,126,0,4,0,6
24687,1,2386,2431,-45,0,15,1,6
24688,2,2441,2393,48,0,41,0,6
24689,1,2555,2599,-44,0,392,0,6
24690,2,2424,2431,-7,0,50,0,6
24691,2,2507,2672,-165,0,487,0,6
24692,3,2510,2534,-24,0,4,0,6
24693,1,2547,2395,152,0,0,0,6
24694,1,2568,2417,151,0,106,0,6
24695,1,2511,2438,73,0,455,0,6
24696,2,2356,2470,-114,0,319,1,6
24697,1,2310,2401,-91,0,115,1,6
24698,1,2411,2389,22,0,13,0,6
24699,2,2304,2422,-118,0,1,0,6
24700,2,2453,2533,-80,0,4,0,6
24701,1,2440,2432,8,0,121,0,6
24702,1,2462,2457,5,0,43,0,6
24703,2,2440,2400,40,0,310,0,8
24704,1,2343,2424,-81,0,40,0,6
24705,3,2424,2553,-129,0,409,0,6
24706,1,2440,2365,75,0,106,0,6
24707,1,2408,2363,45,0,45,0,6
24708,2,2394,2534,-140,0,300,0,6
24709,2,2453,2607,-154,0,211,1,6
24710,2,2595,2559,36,0,300,0,6
24711,2,2270,2444,-174,0,261,0,6
24712,3,2473,2466,7,0,7,0,6
24713,2,2308,2435,-127,0,474,0,6
24714,1,2372,2498,-126,0,101,0,6
24715,2,2354,2418,-64,0,485,0,6
24716,1,2441,2412,29,0,31,1,6
24717,1,2538,2454,84,0,200,0,6
24718,2,2640,2638,2,0,106,0,6
24719,2,2386,2434,-48,0,310,0,6
24720,1,2470,2533,-63,0,46,1,6
24721,2,2666,2649,17,0,245,0,6
24722,3,2421,2380,41,0,207,0,6
24723,2,2479,2593,-114,0,150,0,6
24724,1,2338,2516,-178,0,122,0,6
24725,3,2443,2380,63,0,244,0,6
24726,3,2447,2267,180,0,46,0,6
24727,1,2404,2369,35,0,38,0,6
24728,2,2538,2489,49,0,4,0,6
24729,1,2407,2390,17,0,202,0,6
24730,1,2269,2676,-407,0,45,0,6
24731,1,2251,2465,-214,0,485,1,6
24732,2,2427,2445,-18,0,315,0,6
24733,3,2427,2439,-12,0,209,0,6
24734,2,2550,2389,161,0,0,1,6
24736,2,2392,2416,-24,0,120,0,6
24737,1,2516,2258,258,0,4,1,6
24738,1,2499,2366,133,4,440,0,13
24739,1,2366,2474,-108,0,215,0,6
24740,1,2300,2420,-120,0,1,0,6
24741,3,2491,2380,111,0,453,0,6
24742,1,2412,2352,60,0,222,0,6
24743,1,2426,2385,41,0,8,0,6
24744,1,2447,2433,14,0,44,1,8
24745,2,2232,2418,-186,4,173,0,13
24746,3,2424,2632,-208,0,373,0,6
24747,1,2439,2310,129,0,59,0,6
24748,1,2566,2589,-23,0,101,0,6
24749,2,2466,2473,-7,0,267,1,6
24750,1,2611,2450,161,0,81,1,6
24751,2,2466,2359,107,0,426,0,6
24752,1,2642,2634,8,0,302,0,6
24753,1,2461,2365,96,0,110,0,6
24754,1,2439,2387,52,0,34,1,6
24755,1,2251,2413,-162,0,101,0,6
24756,1,2422,2304,118,0,7,0,6
24757,1,2656,2660,-4,0,106,0,6
24758,2,2450,2542,-92,0,40,1,6
24759,2,2414,2344,70,0,180,1,6
24760,2,2597,2655,-58,0,106,0,6
24761,2,2475,2663,-188,0,277,0,6
24762,2,2445,2421,24,0,300,1,6
24763,2,2525,2531,-6,0,320,0,6
24764,1,2388,2496,-108,0,228,0,6
24765,1,2369,2417,-48,0,244,0,6
24767,2,2456,2285,171,0,1,1,6
24768,2,2384,2447,-63,0,288,0,6
24769,1,2439,2338,101,0,41,0,6
24770,1,2289,2423,-134,0,454,1,6
24771,2,2459,2542,-83,0,466,0,6
24772,2,2420,2400,20,0,202,0,6
24773,1,2426,2571,-145,0,466,0,6
24774,1,2639,2511,128,0,46,0,6
24775,2,2436,2413,23,0,10,0,6
24776,2,2308,2452,-144,0,1,1,6
24777,1,2508,2306,202,0,201,0,6
24778,1,2473,2472,1,0,46,0,6
24779,2,2361,2426,-65,0,5,1,6
24780,1,2358,2431,-73,0,49,0,6
24781,2,2303,2511,-208,0,106,0,6
24782,1,2538,2614,-76,0,338,0,6
24783,2,2647,2659,-12,0,40,0,6
24784,1,2415,2520,-105,0,112,0,6
24785,2,2426,2523,-97,0,85,0,8
24786,1,2583,2572,11,0,300,1,6
24787,1,2809,2794,15,0,101,0,6
24788,1,2500,2477,23,0,4,0,6
24789,2,2382,2460,-78,0,140,0,6
24790,1,2551,2363,188,0,7,0,6
24791,1,2400,2375,25,0,104,0,6
24792,2,2325,2442,-117,0,100,0,6
24793,2,2478,2455,23,0,8,0,6
24794,1,2320,2423,-103,0,415,1,6
24795,2,2488,2362,126,0,247,0,6
24796,1,2497,2506,-9,0,22,0,6
24797,2,2329,2402,-73,0,241,0,8
24798,1,2444,2429,15,0,57,0,6
24799,1,2399,2546,-147,0,106,1,6
24800,1,2382,2420,-38,0,211,0,6
24801,3,2666,2629,37,0,277,0,6
24802,1,2339,2444,-105,0,7,0,6
24803,2,2357,2465,-108,0,30,1,6
24804,1,2405,2442,-37,0,311,1,6
24805,2,2478,2429,49,0,241,0,6
24806,1,2488,2443,45,0,101,0,6
24807,1,2334,2465,-131,0,242,1,6
24808,2,2446,2518,-72,0,46,1,6
24809,1,2459,2409,50,0,120,0,6
24810,1,2360,2554,-194,0,105,0,6
24811,1,2411,2371,40,0,211,0,6
24812,2,2424,2365,59,0,225,0,6
24813,2,2353,2537,-184,0,113,0,6
24814,1,2407,2369,38,0,277,0,6
24815,1,2307,2405,-98,0,354,1,6
24816,1,2444,2339,105,0,106,0,6
24817,1,2301,2456,-155,0,115,0,6
24818,2,2379,2428,-49,0,106,0,6
24819,1,2261,2404,-143,0,334,0,6
24820,1,2430,2563,-133,0,331,1,6
24821,2,2464,2629,-165,0,49,0,6
24822,1,2430,2479,-49,0,337,0,6
24823,2,2305,2414,-109,0,1,0,6
24824,2,2455,2466,-11,0,457,0,6
24825,1,2421,2407,14,0,201,1,6
24826,2,2430,2545,-115,0,345,1,6
24827,1,2504,2408,96,0,391,0,6
24828,3,2461,2377,84,0,65,0,6
24829,1,2513,2301,212,0,201,1,6
24830,2,2472,2458,14,0,4,0,6
24831,1,2355,2416,-61,0,40,1,6
24832,1,2566,2588,-22,0,101,0,6
24833,1,2417,2359,58,0,122,1,6
24834,1,2438,2493,-55,0,400,0,6
24835,1,2414,2278,136,0,113,1,6
24836,2,2473,2506,-33,0,331,0,6
24837,2,2404,2428,-24,0,300,0,6
24838,2,2441,2449,-8,0,130,1,6
24839,1,2448,2357,91,0,400,0,6
24840,2,2422,2332,90,0,480,0,6
24841,1,2416,2249,167,0,145,0,6
24842,1,2418,2301,117,0,106,0,6
24843,1,2527,2268,259,0,200,0,8
24844,2,2371,2418,-47,0,80,0,6
24845,2,2401,2453,-52,0,201,0,6
24846,2,2389,2500,-111,0,162,1,6
24847,1,2400,2283,117,0,7,0,6
24848,2,2629,2665,-36,0,282,0,6
24849,1,2665,2642,23,0,39,0,6
24850,2,2436,2397,39,0,378,1,6
24851,1,2310,2411,-101,0,123,0,6
24852,2,2470,2353,117,0,201,0,6
24853,1,2563,2754,-191,0,125,0,6
24854,1,2680,2597,83,0,394,0,6
24855,1,2536,2503,33,0,202,0,6
24856,2,2371,2472,-101,0,140,0,6
24857,1,2435,2483,-48,0,131,1,6
24858,1,2284,2457,-173,0,242,0,6
24859,2,2297,2422,-125,0,1,0,6
24860,1,2671,2624,47,0,331,0,6
24861,1,2403,2407,-4,0,150,1,6
24862,1,2593,2685,-92,0,433,0,6
24863,2,2317,2498,-181,0,142,0,6
24864,1,2410,2437,-27,0,250,0,6
24865,1,2471,2450,21,0,34,1,6
24866,2,2378,2451,-73,0,45,0,6
24867,1,2540,2370,170,0,337,0,8
24868,3,2427,2459,-32,0,319,0,6
24869,2,2379,2495,-116,0,215,0,6
24870,3,2405,2378,27,0,309,0,6
24871,2,2403,2256,147,0,380,0,6
24872,2,2283,2464,-181,0,46,0,6
24873,1,2501,2466,35,0,246,1,6
24874,1,2545,2369,176,0,260,0,6
24875,2,2324,2458,-134,0,40,0,6
24876,1,2426,2397,29,0,256,0,6
24877,2,2549,2733,-184,0,151,0,6
24878,1,2409,2309,100,0,338,0,6
24879,1,2430,2360,70,0,315,1,6
24880,2,2582,2573,9,0,300,0,6
24881,1,2545,2524,21,0,47,0,6
24882,1,2401,2487,-86,0,277,1,6
24883,2,2377,2412,-35,0,106,1,6
24884,1,2423,2366,57,0,225,0,6
24885,1,2445,2438,7,0,57,0,6
24886,2,2268,2404,-136,0,310,1,6
24887,1,2398,2461,-63,0,300,1,6
24888,2,2455,2389,66,0,315,1,6
24889,2,2476,2391,85,0,260,0,6
24890,2,2446,2339,107,0,130,0,6
24891,2,2461,2276,185,0,228,1,6
24892,2,2637,2666,-29,0,311,1,6
24893,1,2404,2374,30,0,483,0,6
24894,1,2467,2432,35,0,110,0,6
24895,1,2426,2293,133,0,106,0,6
24896,2,2451,2322,129,0,112,1,6
24897,1,2364,2448,-84,0,44,0,6
24898,2,2426,2433,-7,0,15,1,6
24899,2,2450,2480,-30,0,389,0,6
24900,1,2501,2439,62,0,22,0,6
24901,1,2298,2430,-132,0,120,1,6
24902,3,2619,2676,-57,0,453,0,6
24903,2,2366,2548,-182,0,105,0,6
24904,2,2529,2526,3,0,107,0,6
24905,2,2370,2420,-50,0,106,0,6
24906,1,2448,2293,155,0,140,0,6
24907,1,2499,2477,22,0,466,1,6
24908,1,2354,2421,-67,0,394,1,6
24909,2,2789,2815,-26,0,312,1,6
24910,2,2455,2386,69,0,411,0,6
24911,2,2396,2435,-39,0,50,1,6
24912,1,2419,2247,172,0,101,0,6
24913,1,2409,2452,-43,0,414,0,6
24914,2,2375,2670,-295,0,102,0,6
24915,1,2402,2301,101,0,5,0,6
24916,2,2293,2404,-111,0,454,1,6
24917,2,2362,2427,-65,0,46,0,6
24918,1,2533,2442,91,0,389,0,6
24919,1,2516,2572,-56,0,485,0,6
24920,1,2492,2506,-14,0,4,0,6
24921,2,2403,2333,70,0,57,0,6
24922,2,2435,2435,0,0,344,0,6
24923,2,2506,2533,-27,0,107,0,6
24924,2,2578,2576,2,0,101,1,6
24925,3,2459,2428,31,0,310,0,6
24926,3,2417,2512,-95,0,148,0,6
24927,2,2418,2375,43,0,263,0,6
24928,1,2675,2620,55,0,123,0,6
24929,1,2517,2356,161,0,375,0,6
24930,1,2399,2454,-55,0,200,0,6
24931,1,2480,2408,72,0,152,1,6
24932,1,2531,2523,8,0,244,1,6
24933,1,2289,2429,-140,0,1,1,6
24934,2,2290,2452,-162,0,260,0,6
24935,2,2398,2469,-71,0,123,1,6
24936,1,2316,2446,-130,0,253,0,6
24937,1,2454,2365,89,0,150,0,6
24938,2,2396,2448,-52,0,303,0,6
24939,1,2440,2429,11,0,52,1,6
24940,2,2421,2344,77,0,8,1,6
24941,1,2471,2409,62,0,436,0,6
24942,1,2438,2417,21,0,16,0,6
24943,2,2538,2500,38,0,40,0,6
24944,1,2506,2422,84,0,16,0,6
24945,1,2425,2365,60,0,4,0,6
24946,1,2672,2564,108,0,142,0,6
24947,1,2472,2467,5,0,246,1,6
24948,2,2433,2342,91,0,218,1,6
24949,1,2516,2541,-25,0,153,0,6
24950,1,2422,2427,-5,0,483,0,6
24951,1,2422,2316,106,0,40,0,6
24952,1,2464,2298,166,0,483,0,6
24953,1,2369,2418,-49,0,106,0,6
24954,2,2508,2447,61,0,212,0,6
24955,3,2506,2406,100,0,190,0,6
24956,1,2504,2555,-51,0,331,0,6
24957,2,2472,2477,-5,0,40,0,6
24958,2,2631,2681,-50,0,459,1,6
24959,2,2391,2498,-107,4,112,0,13
24960,1,2431,2315,116,0,41,0,6
24961,1,2822,2784,38,0,101,0,6
24962,1,2578,2391,187,0,488,0,6
24963,2,2538,2373,165,0,0,1,6
24964,1,2432,2357,75,0,245,0,6
24965,3,2438,2433,5,0,330,0,6
24966,1,2433,2335,98,0,5,1,6
24967,2,2353,2437,-84,0,49,0,6
24968,2,2352,2428,-76,0,253,1,6
24969,2,2582,2573,9,0,335,0,6
24970,2,2321,2421,-100,0,45,1,6
24971,1,2467,2323,144,0,302,0,6
24972,2,2422,2297,125,0,127,1,6
24973,2,2314,2415,-101,0,56,0,6
24974,1,2507,2532,-25,0,241,0,6
24975,1,2418,2239,179,0,172,0,6
24976,1,2455,2286,169,0,140,0,6
24977,1,2419,2372,47,0,112,0,6
24978,2,2458,2426,32,0,130,1,6
24979,2,2360,2429,-69,0,106,1,6
24980,2,2403,2484,-81,0,400,0,6
24981,2,2417,2288,129,0,114,0,6
24982,3,2326,2446,-120,0,40,0,6
24983,2,2454,2471,-17,0,121,0,6
24984,1,2438,2453,-15,0,459,0,6
24985,2,2473,2411,62,0,125,0,6
24986,2,2535,2511,24,0,140,0,6
24987,2,2230,2414,-184,0,103,0,6
24988,1,2380,2445,-65,0,300,0,6
24989,1,2417,2283,134,0,112,0,6
24990,1,2504,2443,61,0,128,1,6
24991,1,2441,2348,93,0,0,0,6
24992,3,2412,2407,5,0,123,0,6
24993,3,2445,2367,78,0,269,0,6
24994,2,2419,2523,-104,0,190,0,6
24995,1,2376,2423,-47,0,100,0,6
24996,1,2298,2404,-106,0,200,1,6
24997,2,2686,2626,60,0,120,0,6
24998,1,2405,2293,112,0,302,1,6
24999,1,2438,2297,141,0,330,0,6
25000,1,2581,2526,55,0,331,0,6
25001,1,2446,2497,-51,0,80,0,6
25002,2,2385,2550,-165,0,148,0,6
25003,1,2565,2363,202,0,225,1,6
25004,1,2517,2395,122,0,36,1,6
25005,3,2381,2479,-98,0,242,0,6
25006,2,2459,2476,-17,0,127,0,6
25007,1,2489,2399,90,0,192,0,6
25008,1,2423,2422,1,0,0,0,8
25009,2,2529,2501,28,0,56,0,6
25010,1,2411,2291,120,0,156,0,6
25011,1,2601,2425,176,0,302,1,6
25012,1,2348,2417,-69,0,240,0,6
25013,1,2422,2474,-52,0,40,0,6
25014,1,2633,2679,-46,0,40,0,6
25015,1,2419,2310,109,0,122,0,6
25016,3,2424,2383,41,0,105,0,6
25017,2,2490,2352,138,0,477,0,6
25018,3,2564,2576,-12,0,131,0,6
25019,2,2779,2828,-49,0,192,1,6
25020,1,2460,2417,43,0,265,1,6
25021,2,2283,2458,-175,0,260,1,6
25022,2,2452,2357,95,0,40,0,6
25023,3,2330,2432,-102,0,7,0,6
25024,1,2576,2564,12,0,300,0,6
25025,1,2434,2305,129,0,4,0,6
25026,2,2344,2446,-102,0,49,1,6
25027,1,2461,2467,-6,0,40,0,6
25028,2,2558,2582,-24,0,131,0,6
25029,2,2438,2509,-71,0,111,0,6
25030,2,2425,2418,7,0,103,0,6
25031,2,2356,2417,-61,0,107,1,6
25032,2,2579,2510,69,0,245,0,6
25034,1,2521,2586,-65,0,46,0,6
25035,1,2412,2467,-55,0,102,0,6
25036,3,2611,2640,-29,0,39,0,6
25037,2,2265,2536,-271,0,176,1,6
25038,1,2411,2429,-18,0,133,0,6
25039,2,2394,2493,-99,0,44,0,6
25040,3,2364,2445,-81,0,400,0,6
25041,2,2451,2408,43,0,107,0,6
25042,2,2407,2370,37,0,30,0,6
25043,1,2507,2523,-16,0,253,0,6
25044,1,2401,2350,51,0,240,0,6
25045,2,2267,2409,-142,0,156,0,6
25046,2,2615,2466,149,0,112,1,6
25047,2,2424,2419,5,0,242,0,6
25048,2,2360,2402,-42,0,133,1,6
25049,1,2410,2414,-4,0,4,0,6
25050,1,2302,2438,-136,0,1,0,6
25051,1,2526,2412,114,0,246,0,6
25052,1,2246,2419,-173,0,11,0,6
25053,1,2587,2553,34,0,300,0,6
25054,2,2500,2605,-105,0,228,1,6
25055,2,2471,2341,130,0,339,0,6
25056,1,2514,2434,80,0,128,0,6
25057,1,2355,2423,-68,0,146,0,6
25058,1,2465,2383,82,0,127,1,6
25059,1,2415,2405,10,0,113,0,6
25060,1,2437,2207,230,0,140,0,6
25061,1,2295,2416,-121,0,4,0,6
25062,1,2408,2241,167,0,202,0,6
25063,2,2461,2355,106,0,250,0,6
25064,1,2450,2340,110,0,101,0,6
25065,1,2527,2497,30,0,405,0,6
25066,1,2386,2424,-38,0,300,0,6
25067,2,2467,2355,112,0,310,0,6
25068,3,2404,2360,44,0,311,0,6
25069,1,2497,2390,107,0,153,0,6
25070,1,2433,2411,22,0,46,1,6
25071,3,2833,2774,59,0,487,0,6
25072,2,2408,2419,-11,0,4,0,6
25073,1,2532,2572,-40,0,131,0,6
25074,2,2461,2433,28,0,28,0,6
25075,1,2391,2404,-13,0,210,0,6
25076,2,2423,2459,-36,0,331,0,6
25077,2,2447,2286,161,0,101,0,6
25078,2,2456,2305,151,4,101,0,7
25079,1,2434,2335,99,0,267,0,6
25080,3,2399,2420,-21,0,300,0,6
25081,1,2417,2351,66,0,189,0,6
25082,2,2430,2418,12,0,5,0,6
25083,2,2407,2310,97,0,4,1,6
25084,2,2401,2375,26,0,374,0,6
25085,1,2415,2482,-67,0,104,0,6
25086,3,2548,2592,-44,0,45,0,6
25087,1,2408,2445,-37,0,8,0,6
25088,2,2425,2363,62,0,40,0,6
25089,2,2639,2607,32,0,330,0,6
25090,1,2326,2530,-204,0,13,0,6
25091,1,2287,2412,-125,0,167,1,6
25092,2,2429,2518,-89,0,111,0,6
25093,2,2427,2474,-47,0,336,0,6
25094,1,2550,2517,33,0,15,0,6
25095,1,2592,2549,43,0,43,0,6
25096,2,2408,2566,-158,0,45,1,6
25097,1,2472,2611,-139,0,141,0,6
25098,1,2417,2372,45,0,41,0,6
25099,1,2393,2469,-76,0,300,0,6
25100,1,2379,2537,-158,0,107,0,6
25101,1,2343,2428,-85,0,200,0,6
25102,1,2421,2337,84,0,112,0,6
25103,2,2257,2406,-149,2,107,0,18
25104,2,2454,2362,92,0,207,1,6
25105,1,2403,2223,180,0,43,0,6
25106,2,2336,2454,-118,0,49,1,6
25107,2,2425,2427,-2,0,234,0,6
25108,1,2327,2438,-111,0,300,0,6
25109,1,2390,2486,-96,0,101,1,6
25110,1,2438,2338,100,0,102,1,6
25111,1,2415,2308,107,0,8,1,6
25112,2,2425,2521,-96,0,121,0,6
25113,1,2566,2538,28,0,157,1,6
25114,2,2302,2441,-139,0,45,0,6
25115,2,2517,2418,99,0,133,0,6
25116,2,2406,2325,81,0,107,1,6
25117,1,2570,2597,-27,0,45,0,6
25118,2,2481,2299,182,0,250,0,6
25119,1,2479,2421,58,0,205,0,6
25120,2,2439,2464,-25,0,337,0,6
25121,1,2446,2306,140,0,206,0,6
25122,1,2382,2448,-66,0,250,0,6
25123,1,2401,2369,32,0,28,0,6
25124,1,2370,2442,-72,0,190,0,6
25125,1,2512,2580,-68,0,212,0,6
25126,2,2775,2832,-57,0,315,0,6
25127,1,2423,2387,36,0,48,0,6
25128,1,2614,2633,-19,0,278,0,6
25129,1,2437,2313,124,0,302,0,6
25130,1,2521,2582,-61,0,247,0,6
25131,1,2407,2395,12,0,332,0,6
25132,1,2317,2584,-267,0,1,0,6
25133,2,2308,2406,-98,0,6,0,6
25134,3,2416,2544,-128,0,46,0,8
25135,2,2279,2419,-140,0,453,0,6
25136,1,2591,2577,14,0,45,0,6
25137,2,2600,2480,120,0,1,0,6
25138,3,2483,2435,48,0,261,0,6
25139,3,2419,2425,-6,0,133,0,6
25140,2,2387,2462,-75,0,331,0,6
25141,1,2227,2542,-315,0,45,0,6
25142,1,2431,2334,97,0,195,0,6
25143,2,2322,2435,-113,0,180,0,6
25144,1,2363,2424,-61,0,415,1,6
25145,1,2513,2349,164,0,104,0,6
25146,2,2303,2449,-146,0,269,0,6
25147,2,2316,2447,-131,0,320,0,6
25148,1,2697,2433,264,0,120,0,6
25149,2,2405,2441,-36,0,17,0,6
25150,1,2433,2484,-51,0,113,1,6
25151,1,2539,2383,156,0,270,0,6
25152,1,2627,2620,7,0,455,0,6
25153,2,2403,2392,11,0,123,0,6
25154,1,2476,2346,130,0,50,0,6
25155,2,2421,2525,-104,0,405,0,6
25156,1,2573,2519,54,0,56,0,6
25157,1,2421,2410,11,0,226,0,6
25158,2,2478,2533,-55,0,132,1,6
25159,1,2571,2596,-25,0,101,1,6
25160,2,2326,2426,-100,0,1,0,6
25161,1,2500,2451,49,0,242,0,6
25162,1,2422,2381,41,0,315,0,6
25163,2,2388,2421,-33,0,123,1,6
25164,2,2343,2443,-100,0,263,0,6
25165,1,2453,2299,154,0,206,0,6
25166,2,2429,2445,-16,0,424,0,6
25167,1,2467,2382,85,0,207,1,6
25168,2,2553,2571,-18,0,344,0,6
25169,1,2416,2397,19,0,125,0,6
25170,1,2511,2361,150,0,436,0,6
25171,1,2430,2322,108,0,106,1,6
25172,2,2425,2590,-165,0,40,0,6
25173,1,2477,2348,129,0,14,0,6
25174,2,2279,2446,-167,0,463,0,6
25175,2,2419,2333,86,0,255,0,6
25176,2,2673,2699,-26,0,228,0,6
25177,2,2304,2528,-224,0,0,0,6
25178,1,2542,2386,156,0,317,0,8
25179,2,2400,2427,-27,0,128,1,6
25180,3,2400,2420,-20,0,300,0,6
25181,1,2568,2580,-12,0,123,0,6
25182,1,2447,2356,91,0,109,0,6
25183,2,2614,2633,-19,0,385,0,6
25184,2,2312,2439,-127,0,46,0,6
25186,1,2542,2431,111,0,132,1,6
25187,1,2529,2396,133,0,200,0,6
25188,1,2420,2480,-60,0,112,0,6
25189,2,2266,2427,-161,0,120,0,6
25190,2,2575,2340,235,0,1,0,6
25191,2,2538,2510,28,0,140,0,6
25193,1,2482,2302,180,0,20,0,6
25194,1,2440,2346,94,0,107,0,6
25195,1,2405,2459,-54,0,45,1,6
25196,2,2446,2505,-59,0,255,1,6
25197,1,2704,2667,37,0,106,0,6
25198,2,2417,2293,124,4,337,0,13
25199,2,2435,2345,90,0,110,1,6
25200,1,2578,2440,138,0,302,0,6
25201,2,2337,2400,-63,0,113,0,6
25202,1,2590,2532,58,0,300,0,6
25203,1,2576,2516,60,0,140,1,6
25204,3,2449,2295,154,0,4,0,6
25205,1,2451,2406,45,0,41,0,6
25206,3,2200,2400,-200,4,43,0,13
25207,1,2425,2413,12,0,295,0,6
25208,2,2426,2431,-5,0,130,0,6
25209,2,2359,2407,-48,4,211,0,13
25210,1,2438,2345,93,0,46,1,6
25211,2,2296,2456,-160,0,269,0,6
25212,1,2594,2444,150,0,15,0,6
25213,1,2451,2422,29,0,121,0,6
25214,2,2403,2393,10,0,130,0,6
25215,2,2318,2434,-116,0,1,0,6
25216,1,2638,2609,29,0,455,0,6
25217,1,2216,2438,-222,0,212,0,6
25218,1,2344,2424,-80,0,152,1,6
25219,1,2584,2498,86,0,7,0,6
25220,1,2442,2417,25,0,45,1,6
25221,1,2449,2508,-59,0,121,0,6
25222,2,2474,2323,151,0,14,0,6
25223,2,2531,2371,160,0,248,0,6
25224,1,2436,2279,157,0,323,0,6
25225,2,2380,2546,-166,0,107,1,6
25226,3,2514,2522,-8,0,106,0,6
25227,1,2427,2510,-83,0,48,0,6
25228,1,2569,2442,127,0,230,0,6
25229,2,2533,2599,-66,0,34,1,6
25230,2,2575,2443,132,0,345,0,6
25231,1,2436,2267,169,0,304,0,6
25232,1,2540,2440,100,0,7,0,6
25233,2,2595,2709,-114,0,80,1,6
25234,1,2400,2400,0,0,300,0,6
25235,1,2453,2314,139,0,106,0,6
25236,2,2417,2456,-39,0,344,1,6
25237,1,2453,2455,-2,0,45,0,6
25238,2,2525,2358,167,0,107,1,6
25239,1,2436,2456,-20,0,210,0,6
25240,1,2581,2604,-23,0,154,0,6
25241,2,2421,2260,161,0,49,0,6
25242,2,2459,2292,167,0,206,0,6
25243,1,2447,2299,148,0,460,1,6
25244,1,2311,2443,-132,0,1,0,6
25245,1,2394,2402,-8,0,416,0,6
25246,1,2407,2430,-23,0,436,0,6
25247,1,2400,2426,-26,0,302,0,6
25248,2,2417,2372,45,0,7,0,6
25249,1,2414,2441,-27,0,122,0,6
25250,2,2493,2582,-89,0,5,1,6
25251,1,2591,2458,133,0,49,0,6
25252,3,2381,2491,-110,0,405,0,6
25253,1,2407,2240,167,0,138,0,6
25254,2,2412,2449,-37,0,343,0,6
25255,2,2372,2479,-107,0,20,0,6
25256,2,2503,2366,137,0,204,0,6
25257,1,2522,2514,8,0,140,0,6
25258,2,2440,2434,6,0,4,1,6
25259,2,2300,2404,-104,0,30,0,6
25260,1,2544,2459,85,0,4,0,6
25261,2,2587,2561,26,0,188,0,6
25262,2,2605,2644,-39,0,33,0,6
25263,2,2450,2501,-51,0,121,1,6
25264,1,2713,2591,122,0,45,1,6
25265,2,2436,2483,-47,0,102,1,6
25266,1,2368,2495,-127,0,460,0,6
25267,2,2435,2420,15,0,123,0,6
25268,2,2442,2596,-154,0,288,0,6
25269,2,2410,2380,30,4,11,0,13
25270,3,2439,2372,67,0,46,0,6
25271,1,2396,2400,-4,0,242,0,6
25272,1,2437,2384,53,0,100,1,6
25273,2,2403,2393,10,0,210,0,6
25274,2,2435,2319,116,0,40,0,6
25275,1,2458,2370,88,0,250,0,6
25276,2,2501,2455,46,0,244,0,6
25277,3,2450,2374,76,0,3,0,6
25278,2,2319,2407,-88,0,101,0,6
25279,2,2587,2527,60,0,463,0,6
25280,3,2450,2327,123,4,101,0,7
25281,3,2451,2389,62,0,112,0,6
25282,1,2382,2458,-76,0,218,0,6
25283,1,2599,2489,110,0,25,0,6
25284,1,2416,2346,70,0,41,0,6
25285,1,2470,2305,165,0,485,0,6
25286,1,2592,2509,83,0,45,0,6
25287,3,2567,2581,-14,0,101,0,6
25288,2,2303,2528,-225,0,40,0,6
25289,2,2267,2411,-144,0,156,0,6
25290,2,2315,2401,-86,0,122,0,6
25291,1,2367,2517,-150,0,0,0,6
25292,1,2649,2549,100,0,327,0,6
25293,1,2413,2413,0,0,305,0,6
25294,2,2506,2445,61,0,200,0,6
25295,1,2326,2427,-101,0,1,0,6
25296,1,2435,2295,140,0,145,1,6
25297,2,2426,2429,-3,0,244,0,6
25298,1,2405,2292,113,0,112,0,6
25299,2,2333,2433,-100,0,426,0,6
25300,2,2587,2603,-16,0,300,0,6
25301,1,2431,2462,-31,0,302,1,6
25302,2,2342,2434,-92,0,40,0,6
25303,1,2607,2677,-70,0,405,0,6
25304,1,2587,2485,102,0,400,0,6
25305,1,2402,2481,-79,0,308,1,6
25306,1,2277,2406,-129,0,48,0,6
25307,2,2374,2495,-121,0,0,0,6
25308,1,2492,2311,181,0,474,0,6
25309,2,2292,2441,-149,0,122,0,6
25310,1,2488,2443,45,0,378,0,6
25311,2,2441,2439,2,0,253,1,6
25312,2,2532,2490,42,0,315,1,6
25313,2,2440,2449,-9,0,353,0,6
25314,2,2296,2438,-142,0,15,0,6
25315,1,2315,2473,-158,0,0,0,6
25316,2,2400,2414,-14,0,260,0,6
25317,1,2544,2382,162,0,5,0,6
25318,2,2420,2580,-160,0,46,0,6
25319,2,2250,2406,-156,0,115,0,6
25320,1,2390,2420,-30,0,310,1,6
25321,2,2461,2548,-87,0,112,0,6
25322,1,2451,2375,76,0,110,0,6
25323,2,2504,2596,-92,0,216,0,6
25324,2,2341,2409,-68,0,46,1,6
25325,1,2677,2334,343,0,10,0,6
25326,2,2311,2421,-110,0,122,0,6
25327,1,2499,2366,133,0,100,1,6
25328,2,2307,2495,-188,0,196,0,6
25329,1,2438,2378,60,0,459,1,6
25330,2,2534,2581,-47,0,400,1,6
25331,1,2583,2441,142,0,345,1,6
25332,2,2507,2347,160,0,40,0,6
25333,1,2552,2371,181,0,228,0,6
25334,3,2393,2514,-121,0,207,0,6
25335,2,2435,2498,-63,0,150,1,6
25336,2,2455,2341,114,0,414,0,6
25337,2,2438,2499,-61,0,311,1,6
25338,2,2398,2440,-42,0,181,0,6
25339,2,2346,2420,-74,0,389,0,6
25340,1,2466,2351,115,0,10,0,6
25341,2,2493,2610,-117,0,474,0,6
25342,2,2332,2679,-347,0,1,0,6
25343,2,2343,2409,-66,0,330,0,6
25344,1,2285,2407,-122,0,302,1,6
25345,2,2481,2567,-86,0,30,0,6
25346,1,2438,2260,178,0,20,1,6
25347,2,2530,2635,-105,0,153,1,6
25348,2,2390,2408,-18,0,250,0,6
25349,2,2316,2422,-106,0,335,0,6
25350,1,2386,2404,-18,4,462,0,13
25351,2,2355,2412,-57,0,122,0,6
25352,1,2421,2256,165,0,0,0,6
25353,2,2445,2435,10,0,260,0,6
25354,1,2296,2439,-143,0,190,0,6
25356,1,2203,2458,-255,0,140,0,6
25357,1,2600,2500,100,0,45,0,6
25358,1,2470,2435,35,0,14,0,6
25359,1,2503,2457,46,0,477,1,6
25360,1,2566,2356,210,0,300,1,8
25361,2,2420,2417,3,0,103,0,6
25362,1,2415,2380,35,0,211,0,6
25363,1,2571,2477,94,0,41,0,6
25364,2,2469,2489,-20,0,48,1,6
25365,1,2455,2307,148,0,487,1,6
25366,2,2502,2499,3,0,242,0,6
25367,1,2355,2418,-63,0,460,0,6
25368,1,2414,2351,63,0,400,0,6
25369,2,2402,2218,184,0,22,0,6
25370,1,2425,2448,-23,0,200,1,6
25371,1,2441,2439,2,0,253,0,6
25372,1,2586,2587,-1,0,107,0,6
25373,2,2402,2470,-68,0,118,0,6
25374,1,2423,2339,84,0,14,0,6
25375,1,2490,2433,57,0,107,0,6
25376,1,2473,2504,-31,0,8,1,6
25377,2,2511,2615,-104,0,484,1,6
25378,2,2576,2555,21,0,398,0,6
25379,1,2334,2428,-94,0,247,0,6
25380,2,2496,2605,-109,0,207,0,6
25381,2,2258,2421,-163,4,34,1,13
25382,2,2347,2400,-53,0,36,0,6
25383,2,2517,2640,-123,0,302,0,6
25384,1,2529,2592,-63,0,0,0,6
25385,1,2445,2337,108,0,101,0,6
25386,1,2346,2431,-85,0,101,0,6
25387,1,2331,2474,-143,0,1,1,6
25388,2,2411,2293,118,0,122,0,6
25389,1,2490,2336,154,0,474,0,6
25390,1,2430,2476,-46,0,315,0,6
25391,1,2497,2458,39,0,344,0,6
25392,1,2337,2424,-87,0,300,0,6
25393,1,2430,2447,-17,0,200,1,6
25394,1,2414,2398,16,0,270,0,6
25395,1,2414,2338,76,0,300,0,6
25396,1,2476,2581,-105,0,41,0,6
25397,2,2508,2497,11,0,311,0,6
25398,2,2609,2492,117,0,300,0,6
25399,1,2424,2384,40,0,326,0,6
25400,2,2312,2413,-101,0,254,1,6
25402,1,2417,2463,-46,0,252,0,6
25403,2,2450,2258,192,0,0,0,6
25404,3,2490,2382,108,0,107,0,6
25405,1,2513,2592,-79,0,300,0,6
25406,2,2389,2400,-11,0,229,0,6
25407,1,2447,2392,55,0,253,0,6
25408,2,2562,2569,-7,0,224,0,6
25409,1,2433,2431,2,0,107,0,6
25410,2,2488,2452,36,0,200,0,6
25411,1,2442,2360,82,0,414,0,6
25412,2,2444,2394,50,0,110,0,6
25413,2,2428,2607,-179,0,268,0,6
25414,1,2498,2479,19,0,107,0,6
25415,1,2405,2354,51,0,130,0,6
25416,1,2584,2536,48,0,253,0,6
25417,1,2460,2419,41,0,135,0,6
25418,2,2430,2574,-144,0,180,0,6
25419,2,2438,2267,171,0,45,0,8
25420,1,2619,2483,136,0,30,0,6
25421,2,2507,2578,-71,0,30,0,6
25422,2,2300,2420,-120,0,302,0,6
25423,1,2356,2468,-112,0,106,1,6
25424,2,2403,2342,61,0,20,0,6
25425,3,2643,2753,-110,0,354,0,6
25426,1,2381,2518,-137,0,130,0,6
25427,1,2623,2469,154,0,111,0,6
25428,2,2412,2436,-24,0,36,0,6
25429,1,2339,2418,-79,0,300,1,6
25430,1,2446,2342,104,0,474,0,6
25431,2,2528,2420,108,0,398,0,6
25432,2,2624,2509,115,0,38,0,6
25433,3,2480,2502,-22,0,400,0,6
25434,1,2361,2419,-58,0,269,0,6
25435,3,2575,2502,73,0,341,0,6
25436,2,2402,2384,18,0,151,1,6
25437,2,2467,2339,128,0,10,0,6
25438,2,2291,2461,-170,0,241,0,8
25439,1,2500,2601,-101,0,13,0,6
25440,2,2457,2423,34,0,308,0,6
25441,2,2424,2354,70,0,27,1,6
25442,2,2422,2297,125,0,44,0,6
25443,1,2623,2436,187,0,140,1,6
25444,1,2491,2425,66,0,106,1,6
25445,2,2423,2592,-169,0,48,0,6
25446,1,2371,2456,-85,0,46,1,6
25447,1,2401,2437,-36,0,343,0,6
25448,2,2360,2452,-92,0,242,1,6
25449,1,2394,2410,-16,0,106,1,6
25450,1,2455,2465,-10,0,424,0,6
25451,2,2349,2465,-116,0,112,1,6
25452,1,2585,2613,-28,0,140,0,6
25453,1,2445,2627,-182,0,203,0,6
25454,2,2487,2439,48,0,269,0,6
25455,2,2468,2458,10,0,487,0,6
25456,1,2503,2474,29,0,4,1,6
25457,1,2341,2501,-160,0,218,0,6
25458,1,2403,2340,63,0,264,0,6
25459,1,2615,2480,135,0,4,0,6
25460,2,2531,2590,-59,0,253,0,6
25461,2,2238,2417,-179,0,107,0,6
25462,1,2289,2441,-152,0,49,1,6
25463,2,2375,2418,-43,0,57,0,8
25464,2,2507,2532,-25,0,104,0,6
25465,2,2751,2645,106,0,312,1,6
25466,1,2574,2386,188,0,13,1,6
25467,2,2391,2494,-103,0,88,1,6
25468,1,2442,2413,29,0,337,0,6
25469,1,2594,2507,87,0,45,0,6
25470,2,2503,2591,-88,0,101,0,6
25471,2,2417,2376,41,0,320,1,6
25472,3,2430,2367,63,0,45,0,8
25473,1,2516,2441,75,0,131,0,6
25474,2,2304,2517,-213,0,40,0,6
25475,2,2503,2574,-71,0,476,0,6
25476,2,2501,2454,47,0,331,0,6
25477,1,2347,2482,-135,0,1,0,6
25478,2,2464,2465,-1,0,202,0,6
25479,1,2423,2269,154,0,130,0,6
25480,3,2334,2403,-69,0,81,0,6
25481,2,2433,2626,-193,0,110,0,6
25482,1,2538,2318,220,0,371,0,6
25483,1,2420,2461,-41,0,225,0,6
25484,2,2579,2595,-16,0,10,0,6
25485,1,2404,2309,95,0,225,0,6
25486,1,2459,2418,41,0,267,0,6
25487,1,2262,2408,-146,0,337,0,6
25488,1,2770,2641,129,0,305,0,6
25489,1,2446,2447,-1,0,132,0,6
25490,1,2449,2317,132,0,455,0,6
25491,3,2493,2514,-21,0,257,0,6
25492,2,2387,2417,-30,0,140,0,6
25493,1,2407,2349,58,0,41,1,6
25494,1,2420,2293,127,0,177,0,6
25495,1,2469,2378,91,0,13,0,6
25496,2,2618,2619,-1,0,106,0,6
25497,1,2456,2401,55,0,205,0,6
25498,2,2464,2336,128,0,151,0,8
25499,2,2341,2468,-127,0,139,0,6
25500,1,2449,2302,147,0,100,0,6
25501,2,2330,2400,-70,0,300,1,6
25502,1,2365,2476,-111,0,4,1,6
25503,1,2577,2389,188,0,118,0,6
25504,1,2503,2577,-74,0,140,0,6
25505,1,2595,2527,68,0,228,0,6
25506,1,2433,2336,97,0,200,0,6
25507,2,2207,2426,-219,0,190,0,6
25508,2,2404,2355,49,0,106,0,6
25509,3,2653,2744,-91,0,354,0,6
25510,2,2468,2520,-52,0,200,0,6
25511,2,2370,2499,-129,0,1,0,6
25512,1,2579,2499,80,0,344,0,6
25513,3,2508,2402,106,0,50,0,6
25514,2,2310,2441,-131,0,292,0,6
25515,2,2310,2409,-99,0,40,0,6
25516,3,2419,2451,-32,0,40,0,6
25517,1,2596,2499,97,0,106,0,6
25518,1,2522,2600,-78,0,320,0,6
25519,3,2441,2451,-10,0,337,0,6
25521,1,2629,2427,202,0,131,1,6
25522,3,2601,2614,-13,0,200,0,6
25523,1,2429,2282,147,0,45,0,8
25524,1,2393,2574,-181,0,40,0,6
25525,2,2374,2461,-87,0,243,1,6
25526,2,2411,2476,-65,0,44,0,6
25527,2,2326,2448,-122,0,41,0,6
25528,1,2608,2625,-17,0,106,0,6
25529,2,2423,2548,-125,0,46,0,8
25530,2,2430,2613,-183,0,200,1,6
25531,3,2445,2345,100,0,130,0,6
25532,2,2346,2426,-80,0,409,0,6
25533,1,2510,2537,-27,0,242,0,6
25534,1,2429,2303,126,0,210,0,6
25535,2,2742,2654,88,0,312,0,6
25536,2,2464,2422,42,0,218,1,6
25537,1,2361,2461,-100,0,1,0,6
25538,2,2495,2600,-105,0,130,0,6
25539,3,2637,2774,-137,0,93,0,6
25540,1,2377,2445,-68,0,135,0,6
25541,1,2429,2270,159,0,130,0,6
25542,1,2437,2412,25,0,424,0,6
25543,1,2401,2298,103,4,49,0,13
25544,2,2401,2339,62,0,178,0,6
25545,2,2232,2400,-168,4,106,0,13
25546,3,2494,2583,-89,0,354,0,6
25547,1,2404,2297,107,0,115,0,6
25548,1,2244,2401,-157,4,30,0,13
25549,1,2468,2338,130,0,300,0,6
25550,1,2593,2529,64,0,207,0,6
25551,1,2413,2257,156,0,152,1,6
25552,2,2338,2400,-62,0,4,0,6
25553,1,2489,2314,175,0,6,0,6
25554,1,2457,2433,24,0,241,0,8
25555,1,2601,2600,1,0,110,0,6
25556,3,2397,2402,-5,0,107,0,6
25557,1,2525,2450,75,0,200,0,6
25558,1,2530,2516,14,0,428,0,6
25559,3,2424,2632,-208,0,302,0,6
25560,1,2538,2451,87,0,5,0,6
25561,1,2293,2476,-183,0,4,0,6
25562,3,2408,2441,-33,0,122,0,6
25563,1,2549,2477,72,0,270,0,6
25564,2,2292,2465,-173,0,302,0,6
25565,2,2571,2565,6,0,106,0,6
25566,1,2379,2507,-128,0,45,1,6
25567,2,2666,2588,78,0,133,1,6
25568,1,2619,2626,-7,0,0,0,6
25569,1,2350,2409,-59,0,200,0,6
25570,1,2582,2427,155,0,484,0,6
25571,2,2470,2324,146,0,6,1,6
25572,2,2407,2322,85,0,208,0,6
25573,2,2334,2472,-138,0,10,0,6
25574,3,2443,2366,77,0,242,0,6
25575,1,2425,2374,51,0,380,0,6
25576,1,2335,2454,-119,0,316,0,6
25577,2,2381,2542,-161,0,224,1,6
25578,2,2353,2429,-76,0,200,0,6
25579,2,2374,2420,-46,0,202,0,8
25580,2,2454,2311,143,0,122,1,6
25581,1,2404,2458,-54,0,4,1,6
25582,1,2604,2491,113,0,106,0,6
25583,2,2440,2258,182,0,300,1,6
25584,2,2240,2580,-340,0,140,0,6
25585,2,2404,2369,35,0,106,0,6
25586,2,2406,2305,101,0,487,0,6
25587,1,2464,2565,-101,0,5,1,6
25588,1,2524,2598,-74,0,45,0,6
25590,1,2571,2565,6,0,1,0,6
25591,1,2424,2390,34,0,398,0,6
25592,2,2431,2299,132,0,58,0,6
25593,2,2416,2369,47,0,111,0,6
25594,2,2469,2446,23,0,210,1,6
25595,2,2427,2461,-34,0,303,0,6
25596,1,2511,2536,-25,0,242,0,6
25597,3,2629,2567,62,0,312,0,6
25598,2,2594,2625,-31,0,426,0,6
25599,1,2441,2428,13,0,315,0,6
25600,1,2472,2424,48,0,403,0,6
25601,2,2447,2543,-96,0,104,0,6
25602,1,2324,2403,-79,0,263,0,8
25603,2,2409,2420,-11,0,105,0,6
25604,3,2385,2419,-34,0,113,0,6
25605,1,2772,2640,132,0,343,0,6
25606,1,2621,2548,73,0,3,1,6
25607,2,2401,2401,0,0,41,0,6
25608,1,2429,2397,32,0,48,1,6
25609,1,2375,2403,-28,0,1,0,6
25610,2,2436,2523,-87,0,113,0,6
25611,2,2316,2442,-126,0,1,0,6
25612,1,2446,2462,-16,0,113,1,6
25613,3,2659,2387,272,0,241,0,6
25614,1,2332,2496,-164,0,305,0,6
25615,2,2327,2488,-161,0,0,0,6
25616,1,2431,2396,35,0,207,0,6
25617,3,2530,2517,13,0,151,0,6
25618,2,2446,2443,3,0,337,0,6
25619,1,2262,2427,-165,0,107,0,8
25620,1,2547,2399,148,0,7,1,6
25621,2,2400,2204,196,0,264,0,6
25622,2,2364,2405,-41,0,45,0,6
25623,2,2400,2342,58,0,178,1,6
25624,1,2591,2531,60,0,466,0,6
25625,1,2365,2446,-81,0,263,0,6
25626,1,2422,2337,85,0,48,1,6
25627,1,2451,2411,40,0,196,0,6
25628,2,2330,2487,-157,0,41,0,6
25629,1,2577,2471,106,0,25,0,6
25630,1,2419,2270,149,0,45,0,8
25631,1,2521,2422,99,0,107,0,6
25632,1,2586,2655,-69,0,325,1,6
25633,2,2462,2527,-65,0,8,0,6
25634,2,2359,2463,-104,0,9,0,6
25635,1,2494,2348,146,0,194,0,6
25636,1,2386,2491,-105,0,5,0,6
25637,3,2631,2598,33,0,13,0,6
25638,3,2636,2775,-139,0,487,0,6
25639,1,2245,2403,-158,0,303,0,6
25640,1,2488,2418,70,0,107,1,6
25641,1,2400,2381,19,0,10,0,6
25642,2,2427,2551,-124,0,102,0,6
25643,2,2419,2439,-20,0,245,0,6
25644,3,2376,2445,-69,0,303,0,6
25645,1,2409,2238,171,4,250,0,13
25646,1,2435,2368,67,0,487,0,6
25647,2,2449,2441,8,0,132,0,6
25648,3,2423,2416,7,0,485,0,6
25649,1,2546,2625,-79,0,201,0,6
25650,1,2581,2467,114,0,107,0,6
25651,1,2589,2628,-39,0,40,0,6
25652,1,2456,2391,65,0,15,0,6
25653,2,2466,2391,75,0,400,0,6
25654,1,2517,2530,-13,0,195,0,6
25655,1,2525,2452,73,0,215,1,6
25656,2,2410,2403,7,0,306,0,6
25657,1,2444,2435,9,0,30,0,6
25658,2,2403,2330,73,0,101,0,6
25659,2,2473,2437,36,0,0,0,6
25660,1,2420,2375,45,0,49,0,6
25661,1,2527,2596,-69,0,227,1,6
25662,2,2446,2568,-122,0,203,0,6
25663,1,2406,2456,-50,0,415,0,6
25664,1,2555,2424,131,0,107,0,6
25665,1,2490,2530,-40,0,15,0,6
25666,1,2418,2449,-31,0,50,1,6
25667,2,2554,2391,163,0,241,1,6
25668,1,2423,2396,27,0,80,0,8
25669,3,2457,2427,30,0,7,0,6
25670,2,2452,2467,-15,0,345,1,6
25671,1,2618,2532,86,0,3,1,6
25672,3,2560,2557,3,0,201,0,6
25673,3,2386,2477,-91,0,253,0,6
25674,1,2420,2216,204,0,264,0,6
25675,1,2622,2595,27,0,112,0,6
25676,1,2400,2327,73,0,215,0,6
25677,1,2484,2354,130,0,40,0,6
25678,2,2341,2460,-119,0,122,0,6
25679,2,2444,2593,-149,0,202,0,6
25680,2,2569,2648,-79,0,120,0,6
25681,1,2520,2420,100,0,337,1,6
25682,3,2596,2440,156,0,386,0,6
25683,2,2344,2553,-209,0,315,0,6
25684,1,2413,2492,-79,0,123,0,6
25685,3,2444,2377,67,0,112,0,6
25686,1,2599,2468,131,0,83,0,6
25687,1,2432,2214,218,0,114,0,6
25688,1,2773,2638,135,0,140,0,6
25689,1,2409,2351,58,0,253,0,6
25690,2,2386,2461,-75,0,310,0,6
25691,2,2414,2459,-45,0,127,0,6
25692,2,2360,2424,-64,0,60,0,6
25693,1,2591,2274,317,4,7,1,8
25694,1,2630,2443,187,0,13,0,6
25695,2,2448,2447,1,0,0,1,6
25696,1,2464,2296,168,0,300,0,6
25697,3,2590,2627,-37,0,40,0,6
25698,1,2603,2523,80,0,45,0,6
25699,1,2380,2405,-25,0,48,1,6
25700,1,2430,2442,-12,0,315,0,6
25701,2,2296,2400,-104,0,244,0,6
25702,2,2450,2412,38,0,142,1,6
25703,2,2560,2530,30,0,131,0,6
25704,1,2427,2267,160,0,313,0,6
25705,2,2299,2582,-283,0,140,0,6
25706,2,2424,2367,57,0,101,1,6
25707,1,2438,2455,-17,0,374,0,6
25708,2,2443,2594,-151,0,202,0,6
25709,3,2386,2408,-22,0,5,0,6
25710,1,2523,2497,26,0,107,0,6
25711,3,2378,2443,-65,0,40,0,6
25712,1,2358,2425,-67,0,45,1,6
25713,1,2476,2304,172,0,405,0,6
25714,2,2446,2387,59,0,414,1,6
25715,1,2410,2287,123,4,424,0,13
25716,1,2409,2423,-14,0,212,0,6
25717,1,2430,2332,98,0,217,0,6
25718,2,2481,2474,7,0,336,0,6
25719,1,2416,2442,-26,0,436,1,6
25720,2,2297,2415,-118,4,80,0,13
25721,1,2653,2467,186,0,242,1,6
25722,1,2513,2399,114,0,241,0,6
25723,2,2485,2420,65,0,433,0,6
25724,1,2610,2531,79,0,45,1,6
25725,1,2491,2529,-38,0,40,0,6
25727,1,2428,2304,124,0,45,0,8
25728,1,2424,2387,37,4,277,1,13
25729,1,2626,2591,35,0,113,0,6
25730,2,2395,2517,-122,0,40,0,6
25731,1,2467,2342,125,0,151,0,6
25732,2,2434,2324,110,0,251,0,6
25733,1,2382,2402,-20,0,404,1,6
25734,3,2334,2435,-101,0,1,0,6
25735,1,2437,2320,117,0,100,0,6
25736,1,2442,2379,63,0,18,0,6
25737,2,2480,2472,8,0,278,0,6
25738,1,2519,2607,-88,0,207,1,6
25739,2,2623,2633,-10,0,3,0,6
25740,2,2445,2440,5,0,300,0,6
25741,1,2427,2479,-52,0,123,0,6
25742,3,2635,2777,-142,0,29,0,6
25743,1,2424,2425,-1,0,301,1,6
25744,1,2597,2440,157,0,487,0,6
25745,2,2547,2553,-6,0,143,0,6
25746,1,2407,2391,16,0,45,0,6
25747,1,2401,2442,-41,0,14,0,6
25748,1,2404,2387,17,0,136,0,6
25749,2,2328,2465,-137,0,136,0,6
25750,2,2419,2443,-24,0,4,0,6
25751,1,2584,2297,287,0,124,0,6
25752,2,2424,2402,22,0,470,0,6
25753,1,2292,2417,-125,0,151,1,6
25754,2,2250,2410,-160,0,332,0,6
25755,2,2521,2663,-142,0,80,0,6
25756,2,2338,2471,-133,0,85,0,6
25757,1,2523,2498,25,0,106,0,6
25758,2,2417,2444,-27,0,50,0,6
25759,3,2394,2453,-59,0,0,0,6
25760,1,2448,2415,33,0,267,0,6
25761,2,2229,2414,-185,4,48,0,13
25762,3,2425,2432,-7,0,46,0,8
25763,3,2589,2656,-67,0,325,0,6
25764,2,2526,2356,170,0,406,0,6
25765,2,2316,2431,-115,0,6,0,6
25766,1,2472,2434,38,0,414,1,6
25767,3,2492,2528,-36,0,200,0,6
25768,1,2464,2422,42,0,470,0,6
25769,2,2614,2521,93,0,40,1,6
25770,1,2449,2413,36,0,196,0,6
25771,2,2400,2409,-9,0,373,0,6
25772,1,2445,2413,32,0,386,0,6
25773,1,2586,2632,-46,0,40,0,6
25774,1,2375,2447,-72,0,302,1,6
25775,1,2324,2400,-76,0,414,0,6
25776,2,2529,2617,-88,0,4,0,6
25777,2,2517,2639,-122,0,106,0,6
25778,3,2441,2354,87,0,85,0,6
25779,2,2334,2404,-70,0,70,0,6
25780,2,2388,2440,-52,0,335,0,6
25781,2,2436,2408,28,0,150,1,6
25782,2,2331,2401,-70,0,48,1,6
25783,2,2541,2559,-18,0,143,0,6
25784,2,2345,2429,-84,0,100,1,6
25785,2,2446,2454,-8,0,184,0,6
25786,2,2468,2440,28,0,31,0,6
25787,1,2464,2302,162,0,123,0,6
25788,2,2361,2430,-69,0,110,0,6
25789,2,2435,2572,-137,0,1,0,6
25790,2,2450,2405,45,0,354,0,6
25791,2,2518,2517,1,0,406,0,6
25792,1,2412,2526,-114,0,15,0,6
25793,2,2341,2435,-94,0,46,1,6
25794,2,2376,2425,-49,0,16,0,8
25795,3,2622,2525,97,0,0,0,6
25796,1,2449,2401,48,0,102,0,6
25797,2,2231,2593,-362,4,300,0,11
25798,2,2407,2452,-45,0,100,0,6
25799,1,2395,2444,-49,0,296,0,6
25800,1,2412,2489,-77,0,190,0,6
25801,1,2527,2493,34,0,11,0,6
25802,1,2401,2356,45,0,302,0,6
25803,1,2346,2476,-130,0,106,0,6
25804,1,2643,2700,-57,0,13,0,6
25805,3,2413,2280,133,0,133,0,6
25806,1,2429,2477,-48,0,404,0,6
25807,1,2409,2415,-6,0,102,1,6
25808,3,2775,2637,138,0,345,0,6
25809,2,2528,2607,-79,0,112,0,6
25810,1,2655,2634,21,0,240,0,6
25811,1,2419,2302,117,0,122,0,6
25812,1,2513,2334,179,0,216,0,6
25813,1,2525,2295,230,0,404,0,6
25814,2,2440,2590,-150,0,320,0,6
25815,2,2358,2406,-48,0,1,0,6
25816,1,2440,2382,58,0,38,0,6
25817,2,2410,2303,107,0,154,0,6
25818,1,2458,2443,15,0,50,1,6
25819,1,2406,2420,-14,0,302,0,6
25820,1,2397,2402,-5,0,277,0,6
25821,1,2427,2279,148,0,130,1,6
25822,1,2461,2383,78,0,300,1,6
25823,2,2417,2469,-52,0,335,1,6
25824,1,2348,2462,-114,0,135,0,6
25825,3,2440,2524,-84,0,160,0,6
25826,1,2565,2533,32,0,201,1,6
25827,2,2444,2460,-16,0,123,0,6
25828,2,2491,2419,72,0,310,0,6
25829,2,2546,2499,47,0,118,1,6
25830,1,2411,2406,5,0,335,0,6
25831,1,2445,2337,108,0,41,1,6
25832,2,2481,2512,-31,0,420,0,6
25833,1,2576,2423,153,0,140,0,6
25834,2,2369,2431,-62,0,100,0,6
25835,1,2483,2443,40,0,440,1,6
25836,2,2434,2295,139,0,46,0,6
25837,2,2313,2417,-104,0,2,0,6
25838,2,2276,2437,-161,0,224,0,6
25839,2,2377,2445,-68,0,40,0,6
25840,1,2433,2346,87,0,484,1,6
25841,1,2573,2516,57,0,177,1,6
25842,1,2402,2419,-17,0,14,0,6
25843,2,2629,2609,20,0,48,0,6
25844,1,2468,2530,-62,0,301,1,6
25845,2,2389,2453,-64,0,180,0,6
25846,2,2353,2526,-173,0,1,0,6
25847,2,2439,2429,10,0,123,0,6
25848,2,2465,2409,56,0,200,1,6
25849,2,2443,2333,110,0,131,0,6
25850,1,2452,2325,127,0,300,1,6
25851,1,2471,2435,36,0,432,1,6
25852,2,2354,2411,-57,0,245,0,6
25853,1,2311,2400,-89,0,301,0,6
25854,1,2464,2369,95,0,200,0,6
25855,1,2415,2529,-114,0,106,0,6
25856,1,2612,2513,99,0,45,0,6
25857,2,2271,2410,-139,0,4,1,6
25858,1,2403,2266,137,0,135,1,6
25859,2,2274,2469,-195,0,45,0,6
25860,2,2354,2527,-173,0,331,0,6
25861,2,2437,2350,87,0,100,0,6
25862,1,2558,2643,-85,0,115,0,6
25863,3,2639,2773,-134,0,11,0,6
25864,1,2464,2378,86,0,466,0,6
25865,1,2438,2403,35,0,18,0,6
25866,1,2429,2404,25,0,50,1,6
25867,2,2455,2607,-152,0,4,0,6
25868,2,2326,2455,-129,0,107,1,6
25869,1,2519,2663,-144,0,40,0,6
25870,1,2450,2372,78,0,380,0,6
25871,1,2522,2442,80,0,353,0,6
25872,1,2537,2536,1,0,34,0,6
25873,3,2333,2449,-116,0,210,0,6
25874,2,2333,2441,-108,0,46,0,6
25875,1,2427,2443,-16,0,47,1,6
25876,2,2379,2452,-73,0,46,0,6
25877,1,2522,2438,84,0,153,0,6
25878,2,2436,2293,143,4,306,1,13
25879,1,2349,2422,-73,0,152,0,6
25880,2,2368,2454,-86,0,153,0,6
25881,1,2409,2398,11,0,62,0,6
25882,1,2276,2440,-164,0,318,0,6
25883,2,2430,2408,22,0,115,0,6
25884,1,2530,2357,173,0,40,0,6
25885,1,2543,2473,70,0,30,0,6
25886,2,2518,2616,-98,0,331,0,6
25887,1,2440,2328,112,0,200,0,6
25888,1,2424,2392,32,0,100,0,6
25889,2,2425,2479,-54,0,150,0,6
25890,1,2454,2484,-30,0,46,0,6
25891,1,2416,2459,-43,0,152,0,6
25892,2,2414,2526,-112,0,106,0,6
25893,2,2433,2523,-90,0,101,0,6
25894,2,2467,2547,-80,0,331,1,6
25895,2,2655,2490,165,0,195,0,6
25896,1,2364,2472,-108,0,228,0,6
25897,2,2430,2386,44,0,48,0,8
25898,1,2458,2325,133,0,16,0,6
25899,2,2437,2506,-69,0,113,0,6
25900,2,2430,2527,-97,0,47,0,6
25901,1,2363,2448,-85,0,80,1,6
25902,1,2641,2488,153,0,107,0,6
25903,3,2447,2468,-21,0,310,0,6
25904,1,2413,2321,92,0,111,0,6
25905,1,2432,2387,45,0,140,1,6
25906,2,2444,2438,6,0,277,0,6
25907,2,2294,2470,-176,0,303,0,6
25908,2,2452,2422,30,0,140,1,6
25909,3,2652,2631,21,0,241,0,6
25910,1,2593,2477,116,0,398,0,6
25911,1,2679,2620,59,0,330,0,6
25912,1,2321,2451,-130,0,136,0,6
25913,1,2610,2513,97,0,151,1,6
25914,1,2459,2544,-85,0,297,0,6
25915,1,2445,2337,108,0,313,1,6
25916,1,2357,2401,-44,0,237,0,6
25917,1,2329,2433,-104,0,302,0,6
25918,1,2432,2382,50,0,112,0,6
25919,2,2467,2376,91,0,67,0,6
25920,1,2444,2288,156,0,118,0,6
25921,2,2425,2414,11,0,401,1,6
25922,1,2615,2684,-69,0,45,1,6
25924,1,2411,2398,13,0,47,0,6
25925,1,2322,2436,-114,0,100,0,6
25926,1,2386,2416,-30,0,120,0,6
25927,2,2354,2407,-53,0,1,0,6
25928,1,2462,2355,107,0,216,1,6
25929,2,2421,2461,-40,0,127,0,6
25930,2,2293,2425,-132,0,315,0,6
25931,1,2443,2374,69,0,311,0,6
25932,2,2473,2647,-174,0,46,0,6
25933,1,2527,2397,130,0,100,0,6
25934,1,2496,2337,159,0,192,1,6
25935,1,2420,2429,-9,0,150,1,6
25936,1,2552,2461,91,0,34,0,6
25937,2,2485,2645,-160,0,100,0,6
25938,2,2439,2597,-158,0,365,0,6
25939,1,2532,2426,106,0,6,0,6
25940,2,2419,2631,-212,0,241,0,6
25941,2,2454,2504,-50,0,6,0,6
25942,1,2771,2641,130,0,150,1,6
25943,2,2465,2527,-62,0,152,0,6
25944,1,2609,2665,-56,0,103,0,6
25945,1,2406,2394,12,0,1,0,6
25946,2,2425,2418,7,0,106,0,6
25947,2,2393,2531,-138,0,0,0,6
25948,3,2429,2433,-4,0,302,0,6
25949,2,2435,2371,64,0,0,1,6
25950,3,2443,2320,123,0,4,0,6
25951,2,2438,2448,-10,0,112,0,6
25952,1,2468,2389,79,0,40,1,6
25953,1,2448,2372,76,0,373,0,6
25954,1,2392,2411,-19,0,120,0,6
25955,3,2285,2440,-155,0,4,0,6
25956,2,2369,2460,-91,0,331,0,6
25957,2,2432,2285,147,0,46,0,6
25958,3,2466,2533,-67,0,133,0,6
25959,1,2510,2634,-124,0,41,0,6
25960,1,2416,2495,-79,0,122,1,6
25961,2,2228,2473,-245,0,45,0,6
25962,1,2428,2446,-18,0,123,1,6
25963,2,2416,2416,0,0,255,0,6
25964,2,2509,2424,85,0,404,1,6
25965,1,2531,2379,152,0,245,1,6
25966,1,2366,2434,-68,0,43,0,6
25967,1,2425,2308,117,0,120,1,6
25968,1,2422,2536,-114,0,50,0,6
25969,2,2447,2273,174,0,404,1,6
25970,1,2420,2460,-40,0,13,0,6
25971,1,2449,2466,-17,0,487,0,6
25972,2,2677,2622,55,0,330,0,6
25973,3,2405,2333,72,0,5,0,6
25974,1,2577,2650,-73,0,132,0,6
25975,2,2470,2498,-28,0,49,0,6
25976,2,2481,2648,-167,0,100,0,6
25977,2,2456,2426,30,0,45,1,6
25978,1,2469,2496,-27,0,3,0,6
25979,1,2412,2425,-13,0,114,0,6
25980,1,2532,2398,134,0,474,0,6
25981,1,2423,2380,43,0,46,0,8
25982,2,2524,2428,96,0,110,0,6
25983,2,2349,2429,-80,0,1,0,6
25984,1,2433,2439,-6,0,132,1,6
25985,2,2422,2228,194,0,241,1,6
25986,2,2615,2653,-38,0,184,1,6
25987,3,2567,2488,79,0,300,0,6
25988,1,2423,2389,34,0,106,0,6
25989,1,2419,2342,77,0,170,0,6
25990,2,2455,2419,36,0,462,0,6
25991,2,2391,2505,-114,0,133,1,6
25992,1,2412,2313,99,0,30,0,6
25993,1,2409,2535,-126,0,101,1,6
25994,1,2424,2365,59,0,207,0,6
25995,1,2615,2473,142,0,200,0,6
25996,1,2626,2464,162,0,331,0,6
25997,3,2600,2534,66,0,125,0,6
25998,1,2352,2429,-77,0,80,0,6
25999,2,2436,2517,-81,0,40,0,6
26000,2,2528,2659,-131,0,325,0,6
26001,2,2423,2467,-44,0,490,0,6
26002,2,2297,2410,-113,0,302,0,6
26003,1,2455,2282,173,0,107,0,6
26004,2,2384,2460,-76,0,1,0,6
26005,1,2376,2439,-63,0,210,1,6
26006,2,2389,2582,-193,0,438,0,6
26007,1,2612,2652,-40,0,46,0,6
26008,2,2629,2670,-41,0,45,0,6
26009,2,2433,2553,-120,0,0,0,6
26010,2,2320,2421,-101,0,8,0,6
26011,1,2488,2453,35,0,5,1,6
26012,2,2402,2389,13,0,200,0,6
26013,1,2446,2448,-2,0,45,0,6
26014,1,2507,2508,-1,0,36,0,6
26015,1,2440,2434,6,0,140,1,6
26016,2,2406,2552,-146,0,143,0,8
26017,1,2502,2426,76,0,330,0,6
26018,1,2431,2363,68,0,382,0,6
26019,3,2637,2774,-137,0,385,0,6
26020,2,2404,2266,138,0,4,0,6
26021,1,2424,2405,19,0,304,0,6
26022,2,2275,2438,-163,0,51,0,6
26023,1,2475,2253,222,0,123,1,6
26024,3,2430,2589,-159,0,412,0,6
26025,2,2335,2465,-130,0,303,1,6
26026,3,2453,2315,138,0,268,0,6
26027,1,2455,2465,-10,0,15,0,6
26028,2,2373,2419,-46,0,215,0,6
26029,1,2415,2287,128,0,288,1,6
26030,2,2442,2345,97,0,455,0,6
26031,2,2461,2424,37,0,107,0,6
26032,1,2643,2544,99,0,278,0,6
26033,1,2429,2433,-4,0,122,0,6
26034,2,2489,2566,-77,0,101,0,6
26035,1,2336,2503,-167,0,1,0,6
26036,3,2518,2383,135,0,455,0,6
26037,2,2521,2431,90,0,343,0,6
26038,1,2467,2478,-11,0,153,0,6
26039,1,2430,2327,103,0,246,0,6
26040,2,2469,2490,-21,0,310,0,6
26041,1,2532,2618,-86,0,153,0,6
26042,2,2452,2453,-1,0,315,0,6
26043,1,2571,2485,86,0,40,0,6
26044,1,2535,2377,158,0,476,0,6
26045,3,2676,2624,52,0,6,0,6
26046,1,2630,2508,122,0,40,1,6
26047,2,2474,2345,129,0,315,0,6
26048,2,2426,2406,20,0,260,0,6
26049,1,2434,2430,4,0,302,0,6
26050,1,2461,2329,132,0,437,1,6
26051,1,2417,2430,-13,0,200,0,6
26052,3,2502,2438,64,0,302,0,6
26053,1,2557,2610,-53,0,17,0,6
26055,2,2524,2536,-12,0,375,1,6
26056,2,2353,2452,-99,0,124,0,6
26057,1,2451,2404,47,0,152,0,6
26058,1,2424,2298,126,0,0,0,6
26059,1,2519,2287,232,0,4,0,6
26060,3,2422,2423,-1,0,190,0,6
26061,2,2463,2516,-53,0,8,0,6
26062,2,2295,2434,-139,0,8,1,6
26063,3,2463,2507,-44,0,405,0,6
26064,2,2530,2436,94,0,153,0,6
26065,2,2540,2648,-108,0,46,0,6
26066,2,2243,2410,-167,0,20,0,8
26067,2,2473,2420,53,0,253,1,6
26068,1,2360,2412,-52,0,308,0,6
26069,2,2527,2572,-45,0,202,1,6
26070,1,2429,2446,-17,0,153,1,6
26071,1,2575,2464,111,0,300,0,6
26072,2,2469,2495,-26,0,315,1,6
26073,1,2480,2587,-107,0,141,0,6
26074,2,2439,2514,-75,0,41,0,6
26075,1,2321,2449,-128,4,415,0,13
26076,2,2658,2625,33,0,405,1,6
26077,2,2455,2432,23,0,101,0,6
26078,2,2424,2430,-6,0,241,1,6
26079,1,2426,2365,61,0,46,0,6
26080,2,2599,2527,72,0,286,1,6
26081,2,2344,2435,-91,0,40,1,6
26082,2,2427,2423,4,0,115,0,6
26083,1,2431,2313,118,0,41,1,6
26084,1,2430,2308,122,0,302,0,6
26085,2,2437,2521,-84,0,460,0,6
26086,2,2317,2402,-85,0,469,1,8
26087,2,2440,2447,-7,0,132,0,6
26088,1,2539,2458,81,0,202,0,6
26089,2,2331,2501,-170,0,81,0,6
26090,1,2504,2439,65,0,10,0,6
26091,1,2652,2634,18,0,107,0,6
26092,1,2423,2333,90,0,320,0,6
26093,2,2362,2556,-194,0,357,0,8
26094,2,2495,2474,21,0,45,1,6
26096,1,2511,2332,179,0,478,1,6
26097,1,2351,2441,-90,0,51,0,6
26099,2,2429,2319,110,0,46,0,6
26100,2,2393,2430,-37,0,311,1,6
26101,2,2270,2421,-151,0,120,0,6
26102,3,2423,2323,100,0,122,0,6
26103,2,2385,2462,-77,0,41,0,8
26104,2,2465,2506,-41,0,436,0,6
26105,1,2526,2516,10,0,8,0,6
26106,1,2290,2433,-143,0,49,0,6
26107,1,2454,2519,-65,0,4,1,6
26108,1,2452,2428,24,0,216,0,6
26109,1,2436,2472,-36,0,241,0,6
26110,1,2419,2519,-100,0,106,0,6
26111,1,2544,2625,-81,0,330,0,6
26112,3,2625,2539,86,0,300,0,6
26113,2,2332,2466,-134,0,61,0,6
26114,1,2460,2443,17,0,426,0,6
26115,2,2405,2579,-174,0,302,0,6
26116,1,2450,2266,184,0,106,0,6
26118,2,2472,2509,-37,0,106,0,6
26119,1,2434,2301,133,0,49,0,6
26120,2,2438,2449,-11,0,40,0,6
26121,1,2458,2488,-30,0,107,0,6
26122,2,2367,2466,-99,0,326,0,6
26123,2,2435,2440,-5,0,150,0,6
26124,1,2500,2535,-35,0,225,0,6
26125,1,2435,2328,107,0,409,1,6
26126,1,2652,2670,-18,0,404,0,6
26127,2,2498,2387,111,0,374,0,6
26128,1,2251,2401,-150,0,253,1,6
26129,2,2488,2523,-35,0,106,0,6
26130,1,2437,2348,89,0,4,1,6
26131,1,2435,2432,3,0,302,1,6
26132,1,2439,2427,12,0,122,1,6
26133,1,2509,2449,60,0,28,0,6
26134,2,2408,2426,-18,0,0,1,6
26135,1,2428,2411,17,0,115,0,6
26136,1,2496,2312,184,0,41,0,6
26137,1,2628,2582,46,0,7,1,6
26138,2,2648,2657,-9,0,157,1,6
26139,2,2467,2380,87,0,123,0,6
26140,1,2322,2456,-134,0,0,0,6
26141,2,2438,2465,-27,0,310,1,6
26142,1,2450,2424,26,0,45,0,6
26143,2,2297,2465,-168,0,40,0,6
26145,3,2555,2582,-27,0,306,0,6
26146,2,2400,2402,-2,0,245,0,6
26147,1,2346,2445,-99,0,1,0,6
26148,2,2429,2514,-85,0,106,0,6
26149,2,2412,2489,-77,0,40,0,6
26150,1,2268,2419,-151,0,0,0,6
26151,2,2432,2435,-3,0,310,1,6
26152,2,2304,2438,-134,0,200,1,6
26153,2,2217,2532,-315,0,252,0,6
26154,1,2528,2507,21,0,141,0,6
26155,1,2511,2445,66,0,106,1,6
26156,3,2336,2470,-134,0,4,0,6
26157,2,2454,2433,21,0,241,0,6
26158,2,2362,2456,-94,0,41,1,6
26159,1,2460,2364,96,0,60,0,6
26160,3,2512,2461,51,0,201,0,6
26161,3,2465,2369,96,0,2,0,6
26162,2,2325,2422,-97,0,456,0,6
26163,1,2278,2444,-166,0,110,1,6
26164,2,2394,2511,-117,0,4,1,6
26165,1,2387,2453,-66,0,102,1,6
26166,3,2470,2540,-70,0,153,0,6
26167,1,2442,2464,-22,0,6,0,6
26168,2,2315,2400,-85,0,52,0,8
26169,1,2384,2490,-106,0,123,0,6
26170,3,2664,2658,6,0,366,0,6
26171,2,2256,2400,-144,4,296,0,13
26172,2,2221,2407,-186,0,456,0,8
26173,3,2345,2434,-89,0,1,0,6
26174,2,2425,2363,62,0,207,0,6
26175,3,2434,2439,-5,0,133,0,6
26176,1,2518,2424,94,0,455,1,6
26177,1,2534,2305,229,0,4,0,6
26178,1,2383,2414,-31,0,1,0,6
26179,1,2558,2272,286,0,338,0,8
26180,2,2510,2584,-74,0,190,0,6
26181,1,2344,2458,-114,0,45,0,6
26182,1,2446,2429,17,0,140,0,6
26183,2,2312,2442,-130,0,184,0,6
26184,2,2287,2440,-153,0,41,1,6
26185,2,2663,2642,21,0,247,1,6
26186,1,2499,2406,93,0,45,1,6
26187,1,2501,2534,-33,0,439,0,6
26188,2,2472,2503,-31,4,113,1,13
26189,2,2403,2407,-4,0,0,0,6
26190,3,2420,2432,-12,0,190,0,6
26191,1,2435,2633,-198,0,4,0,6
26192,3,2408,2343,65,0,15,0,6
26193,2,2263,2442,-179,0,315,1,6
26194,2,2302,2408,-106,0,101,0,6
26195,1,2395,2448,-53,0,122,0,6
26196,1,2324,2422,-98,0,316,0,6
26197,1,2386,2471,-85,0,218,0,6
26198,1,2582,2399,183,0,45,0,6
26199,1,2434,2321,113,0,300,1,8
26200,1,2410,2260,150,0,195,0,6
26201,2,2503,2555,-52,0,15,1,6
26202,2,2516,2483,33,0,36,0,6
26203,2,2426,2413,13,0,192,1,6
26204,2,2461,2511,-50,0,10,0,6
26205,2,2440,2325,115,0,111,1,6
26206,1,2432,2516,-84,0,129,1,6
26207,3,2442,2372,70,0,190,0,6
26208,2,2239,2536,-297,0,380,0,6
26209,2,2493,2439,54,0,45,0,6
26210,1,2528,2508,20,0,261,0,6
26211,2,2264,2420,-156,0,211,1,6
26212,2,2391,2405,-14,0,125,0,8
26213,1,2360,2416,-56,0,429,0,6
26214,1,2464,2518,-54,0,247,1,6
26215,1,2380,2448,-68,0,57,0,6
26216,1,2293,2471,-178,0,242,0,6
26217,2,2625,2658,-33,0,5,0,6
26218,1,2456,2426,30,0,45,0,6
26219,3,2431,2445,-14,0,241,0,6
26220,2,2446,2385,61,0,167,0,6
26221,1,2419,2370,49,0,211,0,6
26222,1,2274,2430,-156,0,465,0,6
26223,1,2538,2508,30,0,370,0,6
26224,2,2412,2479,-67,0,46,1,6
26225,2,2449,2434,15,0,4,1,6
26226,1,2439,2325,114,0,484,0,6
26227,1,2501,2211,290,0,15,1,6
26228,2,2232,2543,-311,0,252,0,6
26229,1,2523,2334,189,0,23,0,6
26230,1,2445,2311,134,0,15,0,6
26231,1,2539,2565,-26,0,352,0,6
26233,1,2444,2509,-65,0,311,1,6
26234,2,2648,2657,-9,0,175,1,6
26235,2,2436,2286,150,0,268,0,6
26236,3,2429,2273,156,0,113,0,8
26237,1,2559,2380,179,0,8,0,6
26238,1,2420,2352,68,0,122,1,6
26239,1,2433,2382,51,0,40,0,6
26240,1,2450,2521,-71,0,113,0,6
26241,3,2239,2417,-178,0,200,0,8
26242,1,2464,2373,91,0,385,0,6
26243,2,2527,2562,-35,0,380,0,6
26244,2,2468,2458,10,0,0,0,6
26245,2,2363,2432,-69,0,211,0,6
26246,1,2440,2544,-104,0,122,0,6
26247,2,2522,2585,-63,0,101,1,6
26248,1,2533,2389,144,0,134,0,6
26249,3,2345,2400,-55,0,14,0,6
26250,2,2252,2440,-188,0,45,0,6
26251,2,2463,2301,162,0,253,1,6
26252,1,2321,2498,-177,0,380,1,6
26253,1,2234,2401,-167,0,42,0,6
26254,1,2337,2402,-65,0,45,0,6
26255,1,2412,2620,-208,0,415,0,6
26256,2,2421,2354,67,0,110,0,6
26257,3,2421,2377,44,0,101,0,6
26258,2,2455,2386,69,0,45,0,8
26259,1,2516,2505,11,0,463,0,6
26260,1,2474,2454,20,0,108,0,6
26261,1,2409,2367,42,0,122,0,6
26262,2,2511,2470,41,0,120,0,6
26263,2,2445,2344,101,0,200,0,6
26264,1,2445,2432,13,0,4,0,6
26265,1,2570,2446,124,0,18,0,6
26266,1,2531,2329,202,0,4,0,6
26267,1,2459,2249,210,0,301,0,6
26268,1,2501,2443,58,0,315,1,6
26269,3,2528,2461,67,0,201,0,6
26270,2,2417,2545,-128,0,172,0,6
26271,3,2401,2365,36,0,211,0,6
26272,2,2695,2708,-13,0,13,0,6
26273,3,2417,2390,27,4,310,0,13
26274,2,2442,2562,-120,0,456,0,6
26275,2,2383,2462,-79,0,4,0,6
26276,2,2448,2365,83,0,242,0,6
26277,1,2484,2408,76,0,6,0,6
26278,1,2537,2487,50,0,210,0,6
26279,1,2386,2422,-36,0,176,1,6
26280,1,2503,2300,203,0,13,0,6
26281,1,2427,2280,147,0,60,0,6
26282,1,2514,2331,183,0,130,1,6
26283,2,2525,2457,68,0,207,0,6
26284,2,2515,2449,66,0,45,0,6
26285,2,2422,2251,171,0,1,1,6
26286,2,2339,2463,-124,0,487,0,6
26287,1,2546,2214,332,0,14,0,6
26288,2,2662,2643,19,0,247,0,6
26289,2,2259,2410,-151,0,122,0,8
26290,1,2477,2505,-28,0,269,1,6
26291,1,2509,2378,131,0,122,0,6
26292,1,2468,2420,48,0,65,0,6
26293,1,2552,2503,49,0,4,0,6
26294,1,2611,2663,-52,0,386,1,6
26295,2,2464,2462,2,0,314,0,6
26296,1,2285,2438,-153,0,107,0,8
26297,1,2437,2421,16,0,133,1,6
26298,1,2589,2440,149,0,300,0,6
26299,1,2315,2451,-136,0,113,1,6
26300,1,2366,2400,-34,0,83,0,6
26301,1,2454,2329,125,0,177,0,6
26302,1,2464,2466,-2,0,107,1,6
26303,2,2314,2518,-204,0,454,0,8
26304,2,2423,2293,130,0,405,0,6
26305,1,2423,2329,94,0,107,1,6
26306,1,2467,2308,159,0,53,0,6
26307,1,2582,2443,139,0,109,0,6
26308,2,2499,2451,48,0,55,0,6
26309,2,2310,2455,-145,0,242,0,6
26310,2,2377,2562,-185,0,102,0,6
26311,1,2503,2505,-2,0,81,1,6
26312,1,2522,2362,160,0,405,0,6
26313,2,2401,2488,-87,0,386,0,6
26314,2,2364,2468,-104,0,5,0,6
26315,1,2351,2438,-87,0,320,0,6
26316,3,2559,2517,42,0,15,0,6
26317,2,2384,2430,-46,0,6,0,6
26318,3,2403,2492,-89,0,101,0,6
26319,1,2412,2279,133,0,1,0,6
26320,1,2566,2438,128,0,109,0,6
26321,2,2490,2564,-74,0,4,1,6
26322,2,2646,2604,42,0,184,0,6
26323,3,2649,2656,-7,0,175,0,6
26324,1,2350,2458,-108,0,460,0,6
26325,2,2468,2458,10,0,46,0,6
26326,1,2547,2506,41,0,45,1,6
26327,2,2247,2438,-191,0,302,0,6
26328,1,2246,2507,-261,0,80,0,6
26329,2,2372,2403,-31,0,308,0,6
26330,2,2212,2495,-283,0,106,1,6
26331,1,2489,2441,48,0,0,1,6
26332,1,2413,2401,12,0,101,0,6
26333,2,2445,2366,79,0,49,0,6
26334,1,2288,2465,-177,0,400,1,6
26335,2,2721,2689,32,0,6,0,6
26336,2,2243,2400,-157,0,140,0,6
26337,2,2438,2542,-104,0,46,0,6
26338,1,2478,2428,50,0,411,0,6
26339,2,2415,2473,-58,0,200,0,6
26340,2,2345,2527,-182,0,10,0,6
26341,2,2369,2467,-98,0,107,1,6
26342,1,2442,2450,-8,0,119,0,6
26343,1,2521,2305,216,0,106,0,8
26344,1,2452,2437,15,0,0,0,6
26345,2,2456,2490,-34,0,41,0,6
26346,1,2441,2315,126,0,3,0,6
26347,2,2442,2277,165,4,207,0,13
26348,1,2593,2600,-7,0,43,0,6
26349,1,2537,2355,182,0,100,0,6
26350,1,2482,2340,142,0,45,1,6
26351,2,2400,2496,-96,0,263,0,6
26352,1,2347,2400,-53,0,210,0,6
26353,3,2498,2557,-59,0,300,0,6
26354,3,2549,2483,66,0,474,0,6
26355,2,2392,2513,-121,0,129,0,6
26356,1,2415,2443,-28,0,335,0,6
26357,1,2479,2306,173,0,190,0,6
26358,2,2610,2639,-29,0,192,0,6
26359,2,2481,2458,23,0,320,0,6
26360,1,2657,2617,40,0,455,0,6
26361,1,2414,2499,-85,0,256,0,8
26362,1,2518,2360,158,0,241,0,6
26363,2,2462,2443,19,0,115,1,6
26364,2,2254,2404,-150,0,490,0,6
26365,2,2491,2202,289,0,100,0,6
26366,1,2419,2459,-40,0,107,1,6
26367,1,2434,2570,-136,0,226,0,6
26368,1,2403,2272,131,0,354,0,6
26369,2,2461,2431,30,0,300,0,6
26370,1,2441,2396,45,0,398,1,6
26371,1,2586,2525,61,0,315,1,6
26372,1,2408,2367,41,0,16,0,6
26373,1,2431,2358,73,0,200,0,6
26374,2,2311,2410,-99,0,145,0,6
26375,2,2450,2329,121,0,218,0,6
26376,2,2470,2439,31,0,123,1,6
26377,1,2409,2458,-49,0,0,1,6
26378,1,2444,2357,87,0,45,0,6
26379,1,2413,2415,-2,0,1,0,6
26380,1,2427,2448,-21,0,145,0,6
26381,1,2549,2235,314,0,8,0,6
26382,1,2469,2379,90,0,147,0,6
26383,2,2309,2569,-260,0,50,0,8
26384,2,2260,2435,-175,0,201,0,6
26385,2,2516,2570,-54,0,415,0,6
26386,1,2387,2478,-91,0,1,0,6
26387,1,2392,2402,-10,0,200,1,6
26388,2,2696,2707,-11,0,13,1,6
26389,2,2310,2410,-100,0,474,0,6
26390,1,2517,2430,87,0,201,0,6
26391,2,2396,2462,-66,0,122,0,6
26392,3,2562,2442,120,0,130,0,6
26393,3,2552,2501,51,0,45,0,6
26394,1,2350,2459,-109,0,194,0,6
26395,2,2430,2316,114,0,300,1,8
26396,1,2408,2211,197,0,260,0,6
26397,1,2481,2472,9,0,135,0,6
26398,1,2404,2294,110,0,337,0,6
26399,1,2428,2375,53,0,132,0,6
26400,3,2239,2425,-186,0,46,0,6
26401,3,2305,2431,-126,0,202,0,6
26402,1,2612,2594,18,0,43,0,6
26403,1,2437,2436,1,0,112,0,6
26404,1,2429,2422,7,0,133,0,6
26405,1,2656,2494,162,0,150,0,6
26406,2,2378,2565,-187,0,46,0,6
26407,1,2295,2406,-111,0,130,1,6
26408,1,2471,2306,165,0,10,0,6
26409,2,2467,2391,76,0,6,0,6
26410,2,2465,2422,43,0,253,0,6
26411,1,2521,2356,165,0,241,0,6
26412,2,2391,2556,-165,0,320,0,6
26413,2,2337,2443,-106,0,28,1,6
26414,1,2474,2540,-66,0,56,0,6
26415,2,2521,2599,-78,0,101,0,6
26416,1,2575,2508,67,0,244,0,6
26417,1,2484,2362,122,0,211,0,6
26418,1,2423,2432,-9,0,40,0,6
26419,1,2471,2474,-3,0,466,0,6
26420,1,2421,2485,-64,0,140,0,6
26421,2,2273,2405,-132,0,115,0,6
26422,1,2560,2305,255,0,337,0,8
26423,1,2230,2411,-181,0,252,0,6
26424,1,2502,2464,38,0,324,0,6
26425,2,2449,2446,3,0,374,1,6
26426,2,2452,2494,-42,0,303,1,6
26427,2,2373,2442,-69,0,145,1,6
26428,2,2328,2426,-98,0,147,0,6
26429,2,2511,2448,63,0,40,0,6
26430,3,2451,2408,43,0,6,0,6
26431,2,2645,2667,-22,0,113,0,6
26432,1,2351,2416,-65,0,300,0,6
26433,1,2326,2433,-107,0,207,0,6
26435,1,2437,2455,-18,0,133,1,6
26436,1,2362,2433,-71,0,130,0,6
26437,1,2402,2210,192,0,260,0,6
26438,2,2444,2568,-124,0,31,0,6
26439,2,2414,2513,-99,0,102,0,6
26440,1,2428,2307,121,0,133,1,6
26441,3,2457,2367,90,0,306,0,6
26442,1,2500,2398,102,0,1,0,6
26443,1,2362,2421,-59,0,47,0,6
26444,2,2416,2409,7,0,320,0,6
26445,2,2435,2451,-16,0,190,0,6
26446,1,2719,2690,29,0,6,1,6
26447,1,2398,2460,-62,0,106,0,6
26448,1,2440,2499,-59,0,120,0,6
26449,1,2380,2430,-50,0,0,0,6
26450,1,2423,2291,132,0,1,0,6
26451,1,2483,2361,122,0,380,0,6
26452,1,2357,2517,-160,0,115,0,6
26453,1,2456,2362,94,0,140,0,6
26454,1,2492,2475,17,0,120,0,6
26455,2,2358,2488,-130,0,483,0,6
26456,1,2357,2471,-114,0,46,0,6
26457,1,2345,2525,-180,0,317,0,6
26458,1,2479,2219,260,0,123,0,6
26459,1,2282,2412,-130,0,332,0,6
26460,2,2435,2295,140,0,110,0,6
26461,1,2490,2331,159,0,259,0,6
26462,1,2660,2476,184,0,215,0,6
26463,2,2437,2468,-31,0,408,0,6
26464,2,2375,2458,-83,0,243,0,6
26465,2,2589,2675,-86,0,45,0,6
26466,1,2572,2441,131,0,25,0,6
26467,2,2551,2232,319,0,458,1,6
26468,2,2426,2428,-2,0,260,1,6
26469,1,2447,2333,114,0,218,0,6
26470,1,2487,2467,20,0,135,0,6
26471,1,2509,2391,118,0,110,0,8
26472,2,2339,2431,-92,0,250,0,6
26473,2,2579,2508,71,0,129,0,6
26474,1,2388,2410,-22,0,470,0,6
26475,3,2415,2409,6,0,106,0,6
26476,1,2421,2268,153,0,140,0,8
26477,2,2390,2419,-29,0,4,0,6
26478,2,2447,2459,-12,0,326,0,6
26479,1,2438,2375,63,0,332,0,6
26480,1,2249,2428,-179,0,122,0,6
26481,1,2568,2360,208,0,334,1,6
26482,2,2411,2356,55,0,20,0,6
26483,1,2400,2329,71,0,1,0,6
26484,2,2443,2446,-3,0,145,0,6
26485,1,2455,2504,-49,0,330,1,6
26486,2,2444,2419,25,0,100,1,6
26487,3,2404,2434,-30,0,40,0,6
26488,2,2499,2663,-164,0,54,0,6
26489,1,2410,2269,141,0,326,0,6
26490,1,2425,2347,78,0,150,0,6
26491,1,2363,2402,-39,0,212,0,6
26492,1,2329,2451,-122,0,483,0,6
26493,2,2292,2457,-165,0,151,0,6
26494,1,2402,2251,151,0,359,1,6
26495,1,2443,2394,49,0,462,0,6
26496,1,2386,2408,-22,0,145,1,6
26497,1,2457,2556,-99,0,310,0,6
26498,1,2492,2433,59,0,140,0,6
26499,2,2298,2425,-127,0,200,0,6
26501,1,2400,2432,-32,0,7,0,6
26502,1,2453,2405,48,0,40,0,6
26503,3,2355,2415,-60,0,325,0,6
26504,2,2469,2519,-50,0,61,0,6
26505,2,2305,2414,-109,0,16,0,6
26506,1,2533,2497,36,0,255,1,6
26507,1,2652,2649,3,0,307,0,6
26508,2,2473,2339,134,0,109,1,6
26509,3,2315,2461,-146,0,344,0,6
26510,2,2435,2427,8,0,106,0,6
26511,1,2679,2584,95,0,207,1,6
26512,1,2429,2397,32,0,41,0,6
26513,3,2408,2201,207,0,152,0,6
26514,1,2494,2390,104,0,15,0,6
26515,2,2427,2497,-70,0,474,0,6
26516,1,2448,2498,-50,0,311,0,6
26517,1,2515,2389,126,0,49,0,6
26518,2,2201,2563,-362,0,438,0,8
26519,1,2537,2242,295,0,374,0,6
26520,2,2400,2458,-58,0,106,0,6
26521,2,2492,2501,-9,0,344,0,6
26522,3,2402,2212,190,0,338,0,3
26523,2,2298,2430,-132,0,107,0,6
26524,2,2452,2438,14,0,288,0,6
26525,1,2404,2281,123,0,4,1,6
26526,1,2426,2463,-37,0,242,0,6
26527,1,2429,2450,-21,0,380,1,6
26528,1,2429,2441,-12,0,109,1,6
26529,1,2507,2257,250,0,1,0,6
26530,2,2433,2486,-53,0,225,1,6
26531,2,2434,2429,5,0,11,0,6
26532,3,2425,2385,40,0,1,0,6
26533,2,2615,2445,170,0,5,1,6
26534,1,2404,2362,42,0,106,0,6
26535,1,2493,2539,-46,0,34,0,6
26536,1,2519,2419,100,0,415,0,6
26537,2,2594,2674,-80,0,112,1,6
26538,1,2438,2327,111,0,478,0,6
26539,2,2318,2421,-103,0,408,0,6
26540,2,2394,2405,-11,0,40,1,6
26541,2,2311,2449,-138,0,132,0,6
26542,1,2464,2283,181,0,22,0,6
26543,2,2368,2432,-64,0,5,0,6
26544,1,2409,2305,104,0,145,0,6
26545,1,2435,2438,-3,0,487,0,6
26546,2,2530,2301,229,0,140,1,6
26547,1,2456,2420,36,0,131,0,6
26548,1,2420,2581,-161,0,112,1,6
26549,3,2276,2434,-158,0,112,0,6
26550,2,2517,2514,3,0,246,0,6
26551,1,2501,2421,80,0,100,0,6
26552,3,2587,2525,62,0,409,0,6
26554,1,2516,2374,142,0,110,0,6
26555,1,2418,2330,88,0,100,0,6
26556,1,2446,2312,134,0,106,1,6
26557,2,2336,2492,-156,0,21,1,6
26558,2,2463,2395,68,0,0,0,6
26559,1,2526,2342,184,0,4,0,6
26560,2,2444,2497,-53,0,205,0,6
26561,1,2435,2349,86,0,36,0,6
26562,1,2539,2662,-123,0,5,0,6
26563,1,2326,2413,-87,0,15,0,6
26564,2,2393,2466,-73,0,44,1,6
26565,2,2400,2524,-124,0,304,0,6
26566,2,2508,2366,142,0,45,0,6
26567,1,2462,2398,64,0,131,0,6
26568,1,2580,2683,-103,0,45,0,6
26569,2,2441,2519,-78,0,129,1,6
26570,1,2564,2513,51,0,51,0,8
26571,2,2459,2443,16,0,4,0,6
26572,2,2294,2586,-292,0,122,1,6
26573,2,2357,2499,-142,0,102,0,6
26574,1,2409,2415,-6,0,122,0,6
26575,2,2321,2455,-134,0,4,0,6
26576,2,2392,2591,-199,0,3,0,6
26577,2,2302,2433,-131,0,345,0,6
26578,1,2469,2247,222,0,106,1,8
26579,3,2558,2451,107,0,302,0,6
26580,1,2424,2303,121,0,110,0,6
26581,3,2442,2392,50,0,136,0,6
26582,1,2458,2330,128,0,139,0,6
26583,3,2479,2341,138,4,301,0,13
26584,3,2316,2403,-87,0,108,0,6
26585,1,2511,2506,5,0,200,0,6
26586,2,2406,2443,-37,0,386,0,6
26587,2,2435,2428,7,0,230,0,6
26588,2,2339,2491,-152,0,122,0,6
26589,1,2446,2277,169,0,90,1,6
26590,1,2454,2607,-153,0,383,0,6
26591,2,2332,2491,-159,0,45,0,6
26592,1,2467,2408,59,0,112,0,6
26593,2,2455,2487,-32,0,245,0,6
26594,1,2315,2453,-138,0,239,0,6
26595,2,2432,2459,-27,0,81,0,6
26596,2,2364,2405,-41,0,245,0,6
26597,2,2432,2520,-88,0,101,0,6
26598,1,2654,2547,107,0,31,0,6
26599,1,2402,2362,40,0,21,0,6
26600,1,2510,2507,3,0,46,1,6
26601,1,2460,2322,138,0,394,0,6
26602,1,2404,2245,159,0,41,0,6
26603,2,2410,2342,68,0,1,0,6
26604,3,2399,2404,-5,0,386,0,3
26605,1,2653,2554,99,0,241,0,6
26606,1,2459,2307,152,0,22,0,6
26607,1,2428,2388,40,0,0,1,6
26608,2,2374,2409,-35,0,485,0,6
26609,2,2415,2429,-14,0,107,0,6
26611,2,2285,2456,-171,0,335,0,6
26612,1,2516,2466,50,0,14,0,6
26613,2,2402,2456,-54,0,106,0,6
26614,2,2496,2333,163,0,200,0,6
26615,2,2435,2459,-24,0,109,1,6
26616,1,2437,2330,107,0,190,0,6
26617,1,2449,2450,-1,0,9,0,6
26618,2,2435,2593,-158,0,83,1,6
26619,1,2452,2459,-7,0,7,0,6
26620,2,2495,2335,160,0,80,0,6
26621,1,2500,2517,-17,0,212,0,6
26622,2,2543,2658,-115,0,5,0,6
26623,3,2676,2588,88,0,123,0,6
26624,1,2461,2397,64,0,101,0,6
26625,3,2439,2470,-31,0,141,0,6
26626,2,2254,2434,-180,4,140,0,13
26627,1,2352,2439,-87,0,0,1,6
26628,1,2445,2312,133,0,335,0,6
26629,1,2434,2487,-53,0,120,0,6
26630,1,2433,2548,-115,0,302,0,6
26631,2,2426,2524,-98,0,300,0,6
26632,2,2281,2407,-126,0,8,1,6
26633,3,2366,2529,-163,0,116,0,6
26634,1,2382,2478,-96,0,302,0,6
26635,2,2508,2329,179,0,121,0,8
26636,1,2357,2407,-50,0,300,1,6
26637,1,2502,2389,113,0,210,0,6
26638,1,2323,2410,-87,0,196,0,6
26639,2,2413,2428,-15,0,4,0,6
26640,2,2462,2434,28,0,455,1,6
26641,2,2351,2520,-169,0,310,0,6
26642,2,2362,2441,-79,0,351,1,6
26643,2,2494,2462,32,0,106,1,6
26644,1,2448,2435,13,0,411,0,6
26645,2,2403,2340,63,0,150,0,6
26646,1,2550,2479,71,0,245,1,6
26647,2,2318,2463,-145,0,310,1,6
26648,2,2426,2574,-148,0,241,0,6
26649,2,2402,2323,79,0,302,0,6
26650,2,2284,2528,-244,0,291,1,6
26651,1,2591,2245,346,0,103,0,6
26652,1,2478,2449,29,0,130,0,6
26653,1,2391,2403,-12,0,106,1,6
26655,2,2465,2414,51,0,154,1,6
26656,2,2420,2363,57,0,107,0,6
26657,2,2360,2511,-151,0,244,0,6
26658,3,2407,2399,8,0,112,0,3
26659,2,2341,2496,-155,0,483,0,6
26660,3,2502,2559,-57,0,399,0,6
26661,1,2389,2471,-82,0,0,0,6
26662,2,2662,2539,123,0,453,0,6
26663,2,2413,2461,-48,0,242,0,6
26664,3,2523,2383,140,0,1,0,6
26665,3,2486,2483,3,0,426,0,6
26666,1,2348,2444,-96,0,310,0,6
26667,1,2437,2428,9,0,315,0,6
26668,1,2455,2294,161,0,347,0,6
26669,2,2441,2459,-18,0,241,0,6
26670,1,2510,2541,-31,0,43,0,6
26671,1,2421,2403,18,0,484,1,6
26672,2,2249,2448,-199,0,102,0,6
26673,2,2589,2675,-86,0,45,1,6
26674,1,2422,2529,-107,0,101,1,6
26675,1,2467,2302,165,0,49,0,6
26677,1,2403,2278,125,0,10,1,6
26678,1,2588,2336,252,0,102,0,6
26679,1,2680,2230,450,0,311,0,6
26680,3,2369,2419,-50,0,453,0,6
26681,1,2480,2343,137,0,80,0,6
26682,1,2393,2466,-73,0,106,0,6
26683,2,2389,2434,-45,0,143,0,6
26684,2,2577,2441,136,0,10,0,6
26685,2,2592,2291,301,0,112,1,6
26686,1,2434,2440,-6,0,335,0,6
26687,2,2477,2423,54,0,194,0,6
26688,2,2440,2432,8,0,242,0,6
26689,1,2437,2358,79,0,485,0,6
26690,2,2499,2338,161,0,6,1,6
26691,2,2426,2298,128,0,386,0,6
26692,3,2430,2262,168,0,140,0,6
26693,1,2341,2414,-73,0,107,0,6
26694,2,2259,2477,-218,4,1,0,13
26695,1,2468,2474,-6,0,436,1,6
26696,1,2555,2519,36,0,245,0,6
26697,1,2473,2422,51,0,335,0,6
26698,1,2472,2434,38,0,36,0,6
26699,2,2396,2429,-33,0,201,0,8
26700,2,2547,2655,-108,0,300,0,6
26701,1,2521,2385,136,0,200,0,6
26702,2,2403,2398,5,0,4,0,6
26703,3,2337,2400,-63,0,464,0,6
26704,1,2408,2551,-143,0,200,0,6
26705,1,2386,2436,-50,0,345,0,6
26706,2,2418,2314,104,0,108,0,6
26707,2,2467,2503,-36,0,207,0,6
26708,1,2530,2330,200,0,43,0,6
26709,2,2400,2349,51,0,151,0,6
26710,1,2364,2441,-77,0,319,0,6
26711,1,2558,2384,174,0,7,0,6
26712,1,2378,2422,-44,4,141,0,13
26713,2,2430,2492,-62,0,405,0,6
26714,1,2502,2429,73,0,107,1,6
26715,1,2527,2224,303,0,8,0,6
26716,1,2464,2599,-135,0,4,0,6
26717,1,2483,2357,126,0,242,1,6
26718,1,2659,2543,116,0,43,0,6
26719,3,2310,2486,-176,0,152,0,6
26720,2,2535,2582,-47,0,133,0,6
26721,1,2451,2369,82,0,373,0,6
26722,1,2403,2459,-56,0,0,0,6
26723,3,2340,2456,-116,0,110,0,6
26724,1,2376,2470,-94,0,11,0,6
26725,2,2428,2400,28,0,245,0,6
26726,2,2403,2397,6,0,1,0,6
26727,1,2422,2237,185,0,16,0,6
26728,2,2318,2499,-181,0,51,0,8
26729,2,2679,2585,94,0,122,1,6
26730,1,2438,2439,-1,0,382,0,6
26731,1,2681,2204,477,0,300,0,6
26732,2,2524,2437,87,0,15,1,6
26733,2,2434,2401,33,0,208,0,6
26734,2,2459,2344,115,0,13,0,6
26735,1,2407,2316,91,0,113,1,6
26736,1,2310,2421,-111,0,190,0,6
26737,2,2298,2419,-121,0,300,1,6
26738,3,2417,2478,-61,0,110,0,6
26739,1,2587,2530,57,0,300,0,6
26740,2,2511,2515,-4,0,65,0,6
26741,2,2570,2606,-36,0,469,0,6
26742,3,2451,2205,246,0,1,0,6
26743,3,2714,2559,155,0,466,0,6
26744,2,2543,2381,162,0,40,0,6
26745,3,2235,2400,-165,0,113,0,6
26747,2,2384,2562,-178,0,112,0,6
26748,2,2449,2508,-59,0,455,0,6
26749,1,2453,2282,171,0,336,1,6
26750,1,2461,2315,146,0,206,0,6
26751,2,2340,2496,-156,0,131,1,6
26752,2,2537,2410,127,0,406,0,6
26753,2,2391,2401,-10,0,106,0,6
26754,2,2434,2429,5,0,405,0,6
26755,2,2429,2360,69,0,133,1,6
26756,2,2477,2317,160,0,454,0,6
26757,2,2370,2429,-59,0,151,1,6
26758,1,2469,2346,123,0,400,1,6
26759,3,2474,2506,-32,0,440,0,6
26760,2,2266,2418,-152,0,107,0,6
26761,1,2392,2417,-25,0,339,1,6
26762,3,2474,2453,21,0,110,0,6
26763,2,2376,2472,-96,0,106,0,6
26764,2,2301,2529,-228,0,415,0,6
26765,2,2425,2530,-105,0,73,0,6
26766,1,2226,2590,-364,0,3,1,6
26767,1,2434,2462,-28,0,331,0,6
26768,2,2404,2240,164,0,331,0,3
26769,2,2250,2424,-174,0,123,0,8
26770,1,2406,2484,-78,0,311,0,6
26771,1,2321,2442,-121,0,110,1,6
26772,1,2480,2571,-91,0,105,0,6
26773,1,2463,2329,134,0,320,0,6
26774,2,2286,2429,-143,0,310,0,6
26775,1,2435,2343,92,0,150,0,6
26776,2,2334,2682,-348,0,106,0,6
26777,1,2310,2469,-159,0,48,0,6
26778,1,2386,2487,-101,0,190,0,6
26779,2,2525,2592,-67,0,133,0,6
26780,1,2390,2507,-117,0,3,0,6
26781,2,2317,2457,-140,0,40,0,6
26782,2,2411,2405,6,0,255,0,6
26783,1,2564,2539,25,0,463,0,6
26784,1,2471,2506,-35,0,167,1,6
26785,1,2434,2353,81,0,46,1,8
26786,1,2425,2289,136,0,142,0,6
26787,2,2393,2475,-82,0,80,0,6
26788,1,2408,2428,-20,0,337,1,6
26789,1,2427,2254,173,0,140,0,6
26790,1,2565,2607,-42,0,4,0,6
26791,2,2418,2465,-47,0,247,0,6
26793,1,2513,2444,69,0,46,0,6
26794,1,2453,2474,-21,0,0,0,6
26795,2,2414,2353,61,0,241,0,6
26796,1,2413,2374,39,0,311,0,6
26797,1,2520,2523,-3,0,124,1,6
26798,1,2499,2477,22,0,311,0,6
26799,1,2683,2530,153,0,300,0,6
26800,1,2418,2332,86,0,469,1,6
26801,1,2367,2424,-57,0,316,0,6
26802,1,2432,2376,56,0,485,0,6
26803,1,2279,2409,-130,0,123,1,6
26804,1,2461,2380,81,0,300,0,6
26805,2,2343,2472,-129,0,13,0,6
26806,2,2506,2592,-86,0,216,0,6
26807,3,2456,2440,16,0,45,0,6
26808,1,2410,2361,49,0,107,0,6
26809,2,2475,2570,-95,0,41,0,6
26810,2,2598,2706,-108,0,45,0,6
26811,2,2556,2524,32,0,305,0,6
26812,1,2437,2398,39,0,398,1,6
26813,2,2293,2417,-124,0,121,0,6
26814,3,2479,2355,124,0,300,0,6
26815,3,2411,2319,92,4,353,0,13
26816,2,2343,2441,-98,0,1,1,6
26817,2,2370,2467,-97,0,111,0,6
26818,2,2326,2461,-135,0,65,0,6
26819,1,2596,2520,76,0,300,1,6
26820,1,2402,2370,32,0,250,1,6
26821,1,2424,2501,-77,0,200,0,6
26822,3,2200,2580,-380,0,49,0,6
26823,2,2597,2612,-15,0,45,0,6
26824,2,2326,2454,-128,0,34,1,6
26825,1,2534,2570,-36,0,7,0,6
26826,2,2312,2406,-94,0,107,0,6
26827,1,2427,2288,139,0,130,0,8
26828,2,2262,2480,-218,4,106,0,13
26829,2,2246,2504,-258,4,310,0,11
26830,2,2403,2385,18,0,1,1,6
26831,2,2556,2418,138,0,7,0,6
26832,1,2414,2351,63,0,211,0,6
26833,3,2422,2477,-55,0,113,0,6
26834,2,2415,2499,-84,0,45,0,6
26835,3,2397,2528,-131,0,2,0,6
26836,1,2472,2470,2,0,485,0,6
26837,3,2476,2339,137,0,400,0,6
26838,1,2571,2375,196,0,455,0,6
26839,1,2449,2421,28,0,46,0,6
26840,3,2434,2400,34,0,101,0,6
26841,1,2534,2457,77,0,371,0,6
26842,1,2564,2540,24,0,58,0,6
26843,2,2371,2413,-42,0,315,0,6
26844,1,2418,2353,65,0,107,0,6
26845,2,2464,2471,-7,0,193,0,6
26846,1,2443,2394,49,0,8,0,6
26847,2,2563,2487,76,0,217,0,6
26848,2,2422,2419,3,0,341,0,6
26849,2,2459,2279,180,0,14,0,6
26850,1,2401,2515,-114,0,101,0,6
26851,1,2425,2394,31,0,485,0,6
26852,2,2301,2424,-123,0,4,1,6
26853,2,2285,2434,-149,0,113,0,6
26854,2,2452,2440,12,0,10,0,6
26855,1,2417,2237,180,0,7,1,6
26856,1,2532,2396,136,0,373,0,6
26857,2,2447,2550,-103,0,3,0,6
26858,2,2308,2471,-163,0,268,0,6
26859,1,2373,2436,-63,0,429,0,6
26860,1,2526,2399,127,0,343,1,6
26861,2,2442,2478,-36,0,90,0,6
26862,2,2291,2473,-182,0,123,0,8
26863,2,2269,2464,-195,0,120,0,6
26864,2,2494,2339,155,0,213,0,6
26865,1,2431,2418,13,0,41,0,6
26866,2,2516,2601,-85,0,40,0,6
26867,1,2482,2345,137,0,38,0,6
26868,1,2617,2591,26,0,43,0,6
26869,1,2476,2299,177,0,0,0,6
26870,3,2469,2497,-28,0,405,0,6
26871,2,2535,2569,-34,0,8,0,6
26872,2,2349,2454,-105,0,110,0,6
26873,1,2275,2426,-151,0,61,0,6
26874,2,2331,2440,-109,0,107,0,6
26875,1,2431,2438,-7,0,200,0,8
26876,1,2445,2437,8,0,313,1,6
26877,3,2307,2410,-103,0,21,0,6
26878,2,2476,2486,-10,0,205,0,6
26879,2,2422,2401,21,0,275,1,6
26880,1,2391,2462,-71,0,0,0,6
26881,1,2308,2422,-114,0,30,0,6
26882,1,2605,2512,93,0,43,0,6
26883,2,2584,2562,22,0,184,0,6
26884,1,2483,2350,133,4,102,1,13
26885,2,2451,2574,-123,0,115,0,6
26886,1,2507,2610,-103,0,133,0,6
26887,2,2488,2393,95,0,17,1,6
26888,1,2409,2300,109,0,41,0,6
26889,2,2445,2339,106,0,192,0,6
26890,1,2465,2276,189,0,211,0,6
26891,2,2399,2508,-109,0,3,0,6
26892,1,2407,2276,131,0,4,0,6
26893,1,2413,2244,169,0,474,0,6
26894,1,2548,2379,169,0,0,1,6
26895,2,2425,2280,145,0,345,1,6
26896,2,2400,2290,110,0,246,0,6
26897,1,2487,2433,54,0,120,0,6
26898,2,2274,2417,-143,0,430,0,6
26899,1,2541,2436,105,0,343,0,6
26900,2,2477,2459,18,0,485,0,6
26901,1,2429,2252,177,0,200,0,6
26902,2,2458,2357,101,0,4,1,6
26903,2,2446,2447,-1,0,345,0,6
26904,1,2464,2379,85,0,46,0,6
26905,1,2416,2345,71,0,135,0,6
26906,2,2507,2526,-19,0,60,0,6
26907,1,2781,2560,221,0,0,0,6
26908,3,2384,2528,-144,0,424,0,6
26909,1,2513,2533,-20,0,40,0,6
26910,1,2452,2303,149,0,49,0,6
26911,2,2574,2474,100,0,395,0,6
26912,2,2288,2451,-163,0,106,1,6
26913,1,2586,2623,-37,0,218,0,6
26914,1,2512,2395,117,0,202,0,6
26915,1,2602,2515,87,0,43,0,6
26916,2,2416,2448,-32,0,58,0,6
26917,1,2420,2536,-116,0,4,0,6
26918,2,2346,2423,-77,0,382,0,6
26919,1,2423,2443,-20,0,48,0,6
26920,3,2418,2304,114,0,40,0,6
26921,2,2351,2539,-188,0,300,0,6
26922,2,2345,2479,-134,0,106,0,6
26923,1,2296,2408,-112,0,107,0,6
26924,2,2429,2254,175,0,211,0,6
26925,2,2321,2492,-171,0,255,0,6
26926,1,2459,2424,35,0,143,1,6
26927,2,2396,2437,-41,0,4,0,6
26928,2,2347,2526,-179,0,104,0,6
26929,1,2426,2366,60,0,128,0,6
26930,2,2459,2465,-6,0,10,1,6
26931,2,2312,2687,-375,0,110,0,6
26932,1,2486,2341,145,0,0,1,6
26933,2,2353,2412,-59,0,105,0,6
26934,1,2406,2305,101,0,100,1,6
26935,1,2569,2577,-8,0,190,0,6
26936,2,2262,2450,-188,0,123,0,6
26937,2,2492,2455,37,0,196,0,6
26939,2,2407,2200,207,0,112,0,6
26940,2,2416,2463,-47,0,113,1,6
26941,2,2495,2557,-62,0,405,1,6
26942,2,2298,2411,-113,4,150,0,18
26943,2,2347,2403,-56,0,203,0,6
26944,2,2271,2432,-161,0,310,0,6
26945,1,2521,2457,64,0,242,0,6
26946,1,2600,2516,84,0,33,0,6
26947,1,2465,2484,-19,0,315,0,6
26948,1,2616,2592,24,0,216,0,6
26949,1,2414,2316,98,0,260,0,6
26950,2,2416,2455,-39,0,315,0,6
26951,2,2413,2376,37,0,46,0,6
26952,1,2578,2447,131,0,4,1,6
26953,1,2222,2406,-184,0,115,1,6
26954,2,2249,2420,-171,0,31,0,6
26955,2,2410,2432,-22,0,206,0,8
26956,1,2360,2471,-111,0,1,0,6
26957,3,2319,2444,-125,0,41,0,6
26958,2,2441,2468,-27,0,487,0,6
26959,2,2467,2400,67,0,10,1,6
26960,1,2569,2521,48,0,40,0,6
26961,2,2557,2784,-227,0,151,0,6
26962,2,2368,2411,-43,0,45,0,6
26963,1,2511,2607,-96,0,133,0,6
26964,2,2345,2451,-106,0,107,0,6
26965,1,2400,2303,97,0,300,0,6
26966,1,2470,2502,-32,0,110,0,6
26967,1,2526,2432,94,0,46,1,6
26968,1,2587,2622,-35,0,46,0,6
26969,3,2530,2411,119,0,415,0,6
26970,2,2532,2486,46,0,201,0,6
26971,1,2401,2259,142,0,201,0,6
26972,1,2496,2449,47,0,120,1,6
26973,3,2362,2431,-69,0,30,0,6
26974,2,2263,2420,-157,0,8,1,6
26975,2,2374,2472,-98,0,4,0,8
26976,1,2567,2429,138,0,394,0,6
26977,2,2417,2306,111,0,0,0,6
26978,1,2416,2482,-66,0,344,1,6
26979,1,2409,2245,164,4,133,0,13
26980,2,2364,2437,-73,0,305,0,6
26981,3,2322,2437,-115,0,52,0,8
26982,1,2427,2258,169,0,14,0,6
26983,2,2303,2439,-136,0,405,0,6
26984,1,2473,2427,46,0,211,1,6
26985,1,2572,2657,-85,0,345,0,6
26986,1,2424,2311,113,0,107,0,6
26987,1,2464,2370,94,0,484,0,6
26988,1,2400,2383,17,0,80,0,6
26989,1,2787,2555,232,0,108,0,6
26990,2,2332,2435,-103,0,1,1,6
26991,1,2573,2544,29,0,115,0,6
26992,1,2252,2487,-235,4,1,0,13
26993,1,2432,2322,110,0,332,0,6
26994,1,2429,2370,59,0,40,1,6
26995,1,2448,2300,148,0,339,1,6
26996,1,2407,2504,-97,0,302,1,6
26997,3,2392,2517,-125,0,2,0,6
26998,3,2571,2551,20,0,463,0,6
26999,3,2316,2453,-137,0,13,0,6
27000,2,2238,2453,-215,0,15,1,6
27001,3,2476,2306,170,0,206,0,6
27002,2,2381,2554,-173,0,88,0,6
27003,3,2489,2412,77,0,0,0,6
27004,1,2478,2312,166,0,313,0,6
27005,2,2338,2471,-133,0,483,1,6
27006,1,2454,2360,94,0,373,0,6
27007,1,2421,2291,130,0,454,0,6
27008,1,2661,2519,142,0,302,0,6
27009,1,2649,2579,70,0,398,0,6
27010,2,2512,2551,-39,0,123,0,6
27011,1,2582,2480,102,0,4,0,6
27012,2,2444,2431,13,0,265,1,6
27013,1,2496,2411,85,0,106,0,6
27014,1,2615,2593,22,0,1,0,6
27015,2,2281,2436,-155,0,107,1,6
27016,2,2404,2312,92,0,201,0,6
27017,2,2476,2550,-74,0,268,0,6
27018,1,2474,2346,128,0,455,1,6
27019,3,2315,2413,-98,0,190,0,6
27020,2,2342,2528,-186,0,255,0,6
27021,2,2435,2613,-178,0,333,0,6
27022,3,2516,2363,153,0,201,0,6
27023,1,2722,2627,95,0,409,0,6
27024,1,2552,2789,-237,0,245,0,6
27025,1,2526,2455,71,0,176,1,6
27026,2,2237,2439,-202,0,300,0,6
27027,2,2530,2551,-21,0,31,0,6
27028,1,2581,2576,5,0,130,0,6
27029,1,2492,2371,121,0,143,0,6
27030,2,2574,2654,-80,0,344,0,6
27031,1,2500,2428,72,0,375,0,6
27032,1,2406,2324,82,0,301,1,6
27033,2,2373,2406,-33,0,38,0,6
27034,2,2442,2411,31,0,411,0,6
27036,1,2557,2378,179,0,203,1,6
27037,1,2382,2428,-46,0,106,0,6
27038,3,2423,2390,33,0,122,0,6
27039,3,2411,2423,-12,0,46,0,6
27040,3,2296,2430,-134,0,102,0,6
27041,2,2444,2501,-57,0,45,1,6
27042,3,2323,2410,-87,0,245,0,6
27043,1,2475,2586,-111,0,327,0,6
27044,2,2277,2454,-177,0,125,1,6
27045,2,2571,2525,46,0,60,0,6
27046,1,2372,2430,-58,0,45,0,6
27047,2,2453,2516,-63,0,308,1,6
27048,2,2397,2478,-81,0,4,0,6
27049,2,2350,2430,-80,0,195,0,6
27050,1,2435,2362,73,0,250,1,8
27051,1,2324,2468,-144,0,211,0,6
27052,1,2531,2422,109,0,406,0,6
27053,3,2390,2443,-53,0,347,0,6
27054,1,2428,2326,102,0,111,1,6
27055,2,2208,2424,-216,0,152,0,6
27056,1,2336,2474,-138,0,463,0,6
27057,2,2485,2578,-93,0,331,0,6
27058,2,2411,2688,-277,0,52,0,6
27060,2,2280,2411,-131,0,102,0,6
27061,2,2439,2432,7,0,464,0,6
27062,1,2399,2525,-126,0,43,0,6
27063,2,2515,2394,121,0,330,0,6
27064,1,2442,2357,85,0,406,0,6
27065,2,2355,2529,-174,0,115,0,6
27066,1,2458,2317,141,0,4,0,6
27067,3,2555,2589,-34,0,4,0,6
27068,1,2475,2309,166,0,217,1,6
27069,3,2588,2621,-33,0,300,0,6
27070,2,2400,2392,8,0,40,0,6
27071,1,2552,2408,144,0,484,1,6
27072,2,2289,2426,-137,0,107,1,6
27073,2,2413,2475,-62,0,136,1,6
27074,2,2439,2488,-49,0,61,0,6
27075,2,2676,2587,89,0,4,0,6
27076,1,2557,2506,51,0,303,0,6
27077,1,2442,2308,134,0,150,1,6
27078,3,2437,2483,-46,0,4,0,6
27079,3,2380,2414,-34,4,43,0,13
27080,2,2365,2411,-46,0,106,0,6
27081,2,2331,2451,-120,0,48,0,6
27082,1,2404,2408,-4,0,212,0,6
27083,1,2415,2402,13,0,300,0,6
27084,1,2278,2402,-124,0,4,0,6
27085,2,2569,2505,64,0,50,1,6
27086,2,2659,2570,89,0,9,0,6
27088,2,2426,2438,-12,0,241,1,6
27089,1,2449,2562,-113,0,107,0,6
27090,2,2423,2336,87,0,43,0,6
27091,1,2690,2313,377,0,45,0,6
27092,1,2409,2382,27,0,426,0,6
27093,2,2465,2514,-49,0,40,1,6
27094,2,2438,2532,-94,0,60,1,6
27095,1,2460,2334,126,0,357,1,6
27096,1,2457,2313,144,0,25,0,6
27097,1,2381,2496,-115,0,218,0,6
27098,1,2582,2444,138,0,115,0,6
27099,2,2261,2461,-200,0,102,0,6
27100,1,2507,2333,174,0,45,0,6
27101,1,2353,2463,-110,0,46,0,6
27102,1,2408,2259,149,0,1,0,6
27103,2,2310,2414,-104,0,15,0,6
27104,2,2454,2462,-8,0,13,1,6
27105,2,2588,2517,71,0,128,0,6
27106,1,2454,2404,50,0,115,0,6
27107,1,2478,2385,93,0,105,0,6
27108,2,2420,2398,22,0,40,0,6
27109,1,2300,2414,-114,0,46,1,6
27110,2,2491,2570,-79,0,461,0,6
27111,2,2306,2432,-126,0,206,0,6
27112,2,2544,2568,-24,0,106,0,6
27113,2,2428,2360,68,0,365,0,6
27114,2,2416,2452,-36,0,418,0,6
27115,1,2528,2420,108,0,128,0,6
27116,1,2497,2417,80,0,411,0,6
27117,2,2434,2402,32,0,404,0,6
27118,1,2597,2493,104,0,404,0,6
27119,1,2620,2589,31,0,43,0,6
27120,2,2489,2438,51,0,258,0,6
27121,2,2501,2563,-62,0,200,0,6
27122,3,2529,2574,-45,0,107,0,6
27123,2,2430,2393,37,0,106,1,6
27124,1,2424,2564,-140,0,267,1,6
27125,1,2556,2375,181,0,331,0,6
27126,2,2376,2416,-40,0,65,0,6
27127,1,2456,2343,113,0,1,1,6
27128,2,2406,2482,-76,0,49,0,6
27129,1,2595,2554,41,0,241,0,6
27130,2,2381,2442,-61,0,225,0,6
27131,1,2390,2422,-32,0,255,0,6
27132,2,2414,2585,-171,0,353,0,6
27133,2,2330,2447,-117,0,4,0,6
27134,1,2428,2407,21,0,41,0,6
27135,1,2408,2381,27,0,142,0,6
27136,1,2395,2409,-14,0,122,0,6
27137,1,2563,2408,155,0,398,1,6
27138,2,2363,2440,-77,0,120,0,8
27139,1,2416,2384,32,0,45,1,6
27140,2,2446,2292,154,0,330,0,6
27141,1,2323,2535,-212,0,292,0,6
27142,2,2401,2536,-135,0,2,0,6
27143,2,2402,2438,-36,0,131,0,6
27144,3,2577,2652,-75,0,278,0,6
27145,1,2482,2480,2,0,136,0,6
27146,1,2415,2287,128,4,491,0,13
27147,2,2255,2482,-227,0,45,0,6
27148,1,2482,2514,-32,0,394,0,6
27149,1,2411,2244,167,0,302,0,6
27150,1,2383,2438,-55,0,9,1,8
27151,1,2464,2399,65,0,61,1,6
27152,1,2519,2460,59,0,106,0,6
27153,1,2454,2434,20,0,246,0,6
27154,2,2443,2337,106,0,258,0,6
27155,1,2286,2446,-160,0,84,0,6
27156,1,2443,2407,36,0,196,0,6
27157,1,2532,2381,151,0,9,0,6
27158,2,2437,2420,17,0,22,0,6
27159,2,2574,2539,35,0,0,0,6
27160,1,2467,2461,6,0,107,0,6
27161,1,2322,2413,-91,0,144,0,6
27162,1,2568,2497,71,0,45,1,6
27163,1,2435,2471,-36,0,338,0,6
27164,2,2524,2582,-58,0,434,0,6
27165,1,2449,2341,108,0,13,0,6
27166,1,2672,2560,112,0,133,1,6
27167,3,2341,2489,-148,0,392,0,6
27168,3,2445,2366,79,0,55,0,6
27169,1,2467,2282,185,0,205,0,6
27170,1,2368,2401,-33,0,312,0,6
27171,2,2439,2379,60,0,395,0,6
27172,2,2414,2560,-146,0,46,0,6
27173,2,2353,2433,-80,0,122,0,6
27174,2,2302,2414,-112,0,122,0,6
27175,2,2583,2626,-43,0,46,0,6
27176,1,2464,2407,57,0,8,0,6
27177,1,2432,2371,61,0,136,0,6
27178,2,2474,2488,-14,0,3,0,6
27179,1,2487,2573,-86,0,41,0,6
27180,2,2488,2402,86,0,300,1,6
27181,3,2438,2267,171,0,414,0,6
27182,2,2509,2444,65,0,15,0,8
27183,2,2448,2383,65,0,107,0,6
27184,2,2321,2404,-83,0,170,0,6
27185,1,2399,2421,-22,0,245,0,6
27186,1,2455,2524,-69,0,40,1,6
27187,1,2443,2397,46,0,203,0,6
27188,1,2458,2424,34,0,46,0,6
27189,2,2401,2424,-23,0,320,1,6
27190,2,2540,2530,10,0,302,0,6
27191,1,2435,2355,80,0,205,0,6
27192,2,2549,2418,131,0,207,0,6
27193,2,2398,2559,-161,0,2,0,6
27194,3,2449,2364,85,0,4,0,6
27195,1,2542,2490,52,0,207,0,6
27196,1,2588,2390,198,0,152,0,6
27197,2,2438,2319,119,0,310,1,6
27198,1,2560,2557,3,0,250,0,6
27199,1,2533,2249,284,0,135,0,6
27200,1,2379,2545,-166,0,229,0,6
27201,1,2346,2478,-132,0,106,0,6
27202,2,2262,2422,-160,0,7,0,6
27203,2,2651,2578,73,0,398,0,6
27204,1,2402,2405,-3,0,302,0,6
27205,1,2449,2440,9,0,196,0,6
27206,1,2536,2360,176,0,10,0,6
27207,1,2457,2429,28,0,366,0,6
27208,2,2505,2561,-56,0,45,0,6
27209,2,2416,2397,19,0,122,0,6
27210,2,2339,2453,-114,0,71,1,6
27211,2,2208,2469,-261,0,5,1,6
27212,1,2500,2450,50,0,241,0,6
27213,2,2539,2436,103,0,16,0,6
27214,1,2426,2441,-15,0,302,0,6
27215,2,2321,2469,-148,0,46,0,6
27216,2,2555,2592,-37,0,427,0,6
27217,1,2443,2492,-49,0,131,0,6
27218,2,2364,2442,-78,0,45,0,6
27220,1,2448,2437,11,0,190,0,6
27221,1,2526,2252,274,0,55,0,6
27222,1,2485,2332,153,0,354,0,6
27223,1,2571,2419,152,0,45,1,6
27224,2,2439,2566,-127,0,4,0,6
27225,1,2406,2494,-88,0,112,0,6
27226,1,2439,2473,-34,0,140,0,6
27227,1,2332,2467,-135,0,323,0,6
27228,1,2692,2394,298,0,108,0,6
27229,1,2414,2283,131,4,178,0,13
27230,2,2418,2298,120,0,40,0,6
27231,3,2365,2432,-67,0,490,0,6
27232,2,2493,2469,24,0,125,0,6
27233,1,2562,2394,168,0,331,0,6
27234,2,2282,2410,-128,0,50,0,6
27235,1,2409,2475,-66,0,48,0,6
27236,1,2390,2413,-23,0,343,1,6
27237,1,2330,2463,-133,0,403,0,6
27238,1,2451,2502,-51,0,109,0,8
27239,1,2549,2534,15,0,43,0,6
27240,2,2298,2536,-238,0,0,0,6
27241,2,2371,2591,-220,0,255,0,6
27242,1,2456,2270,186,0,302,0,6
27244,1,2429,2395,34,0,107,1,6
27245,1,2459,2444,15,0,247,0,6
27246,2,2470,2439,31,0,141,1,6
27247,2,2434,2454,-20,0,190,0,6
27248,2,2294,2547,-253,0,292,1,6
27249,1,2590,2489,101,0,404,1,6
27250,1,2424,2446,-22,0,216,0,6
27251,1,2230,2405,-175,0,8,0,6
27252,2,2268,2570,-302,0,135,0,6
27253,1,2363,2430,-67,0,315,0,6
27254,1,2469,2456,13,0,202,0,6
27255,1,2470,2399,71,0,250,0,6
27256,1,2401,2262,139,0,0,0,6
27257,1,2537,2536,1,0,206,0,6
27258,2,2457,2387,70,0,4,1,6
27259,1,2310,2461,-151,0,315,0,6
27260,2,2414,2373,41,0,46,0,6
27261,2,2438,2413,25,0,258,0,6
27262,1,2431,2366,65,0,302,0,8
27263,1,2471,2488,-17,0,4,0,6
27264,2,2422,2313,109,0,113,1,6
27265,2,2597,2556,41,0,380,0,6
27266,1,2565,2391,174,0,331,0,6
27267,1,2495,2361,134,0,227,1,6
27268,1,2365,2435,-70,0,101,1,6
27269,2,2487,2601,-114,0,406,1,6
27270,1,2389,2413,-24,0,424,0,6
27271,1,2472,2486,-14,0,380,0,6
27272,1,2694,2338,356,0,404,0,6
27273,1,2408,2409,-1,0,302,0,6
27274,3,2475,2432,43,0,2,0,6
27275,1,2342,2454,-112,0,122,1,6
27276,2,2232,2410,-178,0,16,0,6
27277,1,2439,2360,79,0,106,0,6
27278,1,2446,2447,-1,0,300,0,6
27279,1,2385,2487,-102,0,205,0,6
27280,2,2392,2574,-182,0,106,0,6
27281,1,2538,2528,10,0,14,0,6
27282,1,2459,2306,153,0,302,0,6
27283,2,2408,2412,-4,0,302,0,6
27284,3,2438,2454,-16,0,140,0,6
27285,1,2579,2630,-51,0,46,0,6
27286,1,2481,2415,66,0,46,1,6
27287,1,2460,2463,-3,0,119,0,6
27288,1,2421,2292,129,0,210,0,6
27289,2,2431,2322,109,0,90,0,6
27290,1,2676,2437,239,0,107,0,6
27291,3,2462,2405,57,0,40,0,6
27292,3,2467,2388,79,0,197,0,6
27293,1,2566,2375,191,0,4,1,6
27294,2,2416,2480,-64,0,304,0,6
27295,1,2311,2468,-157,0,10,1,6
27296,2,2467,2458,9,0,200,0,6
27297,1,2459,2369,90,0,41,0,6
27298,2,2329,2402,-73,0,302,0,6
27299,1,2406,2359,47,0,110,0,6
27300,1,2498,2425,73,0,104,0,6
27301,1,2577,2591,-14,0,28,0,6
27302,1,2563,2551,12,0,335,0,6
27303,2,2453,2319,134,0,242,0,6
27304,2,2338,2543,-205,0,11,0,6
27305,1,2428,2469,-41,4,50,0,13
27306,2,2422,2405,17,0,300,0,8
27307,1,2342,2424,-82,0,315,0,6
27308,1,2572,2396,176,0,121,0,6
27309,1,2463,2516,-53,0,40,0,6
27310,1,2298,2427,-129,0,247,1,6
27311,2,2271,2537,-266,0,229,0,6
27312,3,2434,2370,64,0,105,0,6
27313,2,2395,2464,-69,0,113,0,6
27314,1,2475,2666,-191,0,130,0,6
27315,1,2316,2429,-113,0,202,0,6
27316,1,2474,2355,119,0,410,1,6
27317,2,2388,2569,-181,0,2,0,6
27318,2,2403,2410,-7,0,255,0,6
27319,1,2480,2430,50,0,221,0,6
27320,1,2400,2407,-7,0,304,0,6
27321,1,2577,2343,234,0,113,1,6
27322,2,2484,2594,-110,0,110,0,6
27323,2,2372,2695,-323,0,52,0,6
27324,1,2499,2353,146,0,122,0,6
27325,1,2451,2407,44,0,45,0,6
27326,2,2237,2420,-183,4,247,0,13
27327,2,2441,2308,133,0,11,0,6
27328,2,2403,2483,-80,0,394,0,6
27329,2,2330,2444,-114,0,395,1,6
27330,2,2460,2414,46,0,106,1,6
27331,2,2440,2283,157,0,353,0,6
27332,1,2482,2312,170,0,52,0,6
27333,2,2440,2390,50,0,107,0,6
27334,1,2478,2452,26,0,311,0,6
27336,1,2605,2483,122,0,487,0,6
27337,1,2362,2419,-57,0,122,0,6
27338,1,2585,2583,2,0,335,1,6
27339,2,2328,2425,-97,0,40,0,6
27340,1,2435,2462,-27,0,41,0,6
27341,2,2375,2477,-102,0,102,0,6
27342,1,2623,2586,37,0,43,1,6
27343,2,2367,2549,-182,0,246,0,6
27344,2,2424,2372,52,0,45,0,6
27345,2,2575,2403,172,0,116,0,6
27346,3,2390,2466,-76,0,101,0,6
27347,3,2474,2402,72,0,3,0,6
27348,2,2530,2566,-36,0,203,0,6
27349,2,2598,2480,118,0,301,0,6
27350,2,2273,2454,-181,0,4,0,6
27351,2,2327,2445,-118,0,106,1,6
27352,1,2302,2400,-98,0,269,1,6
27353,1,2287,2417,-130,4,288,0,13
27354,1,2419,2438,-19,0,380,0,6
27356,1,2417,2407,10,0,310,0,6
27357,1,2411,2486,-75,0,101,0,6
27358,1,2494,2678,-184,0,111,1,6
27359,1,2545,2335,210,0,207,1,6
27360,1,2307,2462,-155,4,123,0,13
27361,2,2504,2464,40,0,463,1,6
27362,3,2414,2399,15,0,251,0,6
27363,2,2238,2415,-177,0,46,0,6
27364,2,2485,2468,17,0,129,0,6
27365,2,2390,2421,-31,0,184,1,6
27366,1,2482,2544,-62,0,4,0,6
27367,1,2523,2486,37,0,315,0,6
27368,2,2202,2406,-204,0,302,0,6
27369,2,2371,2433,-62,0,325,0,6
27370,1,2657,2661,-4,0,106,0,6
27371,1,2479,2444,35,0,315,1,6
27372,1,2572,2385,187,0,330,0,6
27373,1,2364,2432,-68,0,101,0,6
27374,2,2351,2478,-127,0,318,1,6
27375,1,2444,2349,95,0,8,0,6
27376,1,2569,2397,172,0,7,0,6
27377,2,2397,2402,-5,0,404,0,6
27378,3,2433,2484,-51,0,302,0,6
27379,2,2328,2447,-119,0,200,1,6
27380,1,2390,2435,-45,4,301,0,13
27381,2,2463,2294,169,0,485,1,6
27382,2,2388,2404,-16,0,46,0,6
27383,2,2425,2469,-44,0,484,0,6
27384,3,2437,2259,178,0,211,0,6
27385,1,2423,2398,25,0,4,0,6
27386,1,2436,2411,25,0,302,0,8
27387,1,2468,2350,118,0,177,0,6
27388,2,2456,2441,15,0,35,0,6
27389,2,2488,2525,-37,0,151,1,6
27390,2,2299,2412,-113,0,305,0,6
27391,1,2449,2323,126,0,242,0,6
27392,1,2484,2309,175,0,125,0,6
27393,1,2413,2453,-40,0,46,1,6
27394,1,2475,2301,174,0,226,1,6
27395,1,2578,2591,-13,0,335,0,6
27396,1,2655,2663,-8,0,173,0,6
27397,2,2335,2567,-232,0,123,0,6
27398,2,2581,2628,-47,0,46,0,6
27399,1,2339,2480,-141,0,40,0,6
27400,2,2594,2620,-26,0,118,0,6
27401,1,2344,2448,-104,0,373,1,6
27402,1,2462,2472,-10,0,130,0,6
27403,3,2361,2537,-176,0,1,0,6
27404,3,2697,2488,209,0,405,0,6
27405,1,2379,2417,-38,0,133,1,6
27406,2,2473,2418,55,0,3,0,6
27407,2,2354,2507,-153,0,106,0,6
27408,1,2458,2368,90,0,251,0,8
27409,1,2416,2397,19,0,122,0,6
27410,1,2401,2234,167,0,84,0,6
27411,1,2412,2210,202,0,4,0,6
27412,1,2448,2326,122,0,41,1,6
27413,2,2457,2234,223,0,0,0,6
27414,2,2479,2326,153,0,302,0,6
27415,2,2415,2418,-3,0,46,0,6
27416,1,2302,2422,-120,0,1,1,6
27417,1,2435,2310,125,0,4,1,6
27418,1,2420,2262,158,0,365,0,6
27419,2,2333,2548,-215,0,11,1,6
27420,1,2670,2546,124,0,103,0,6
27421,2,2318,2401,-83,0,302,1,6
27422,1,2515,2484,31,0,0,0,6
27423,2,2418,2287,131,0,42,0,6
27424,3,2481,2322,159,0,315,0,6
27425,2,2258,2528,-270,0,291,0,6
27426,1,2463,2344,119,0,395,0,6
27427,1,2585,2584,1,0,455,0,6
27428,1,2441,2367,74,0,48,0,8
27429,2,2321,2425,-104,0,132,1,6
27430,2,2409,2334,75,0,50,0,6
27431,1,2420,2385,35,0,253,0,6
27432,2,2253,2468,-215,0,110,0,6
27433,2,2424,2505,-81,0,1,0,6
27434,1,2497,2457,40,0,406,0,6
27435,1,2300,2409,-109,0,302,0,6
27436,1,2418,2301,117,0,0,0,6
27437,2,2341,2478,-137,0,119,0,6
27438,2,2354,2411,-57,0,106,0,6
27439,3,2657,2661,-4,0,106,0,6
27440,1,2510,2589,-79,0,18,0,6
27441,1,2438,2575,-137,0,242,0,6
27442,2,2465,2366,99,0,102,0,6
27443,1,2321,2464,-143,0,245,0,6
27444,1,2447,2450,-3,0,41,1,6
27445,2,2413,2356,57,0,132,1,6
27446,2,2226,2580,-354,0,232,0,6
27447,1,2367,2409,-42,0,268,0,6
27448,1,2391,2401,-10,0,345,0,6
27449,1,2482,2353,129,0,365,0,6
27450,1,2425,2424,1,0,56,1,6
27451,1,2419,2330,89,0,125,0,6
27452,1,2274,2434,-160,0,34,0,6
27453,2,2430,2364,66,0,106,1,6
27454,3,2565,2528,37,0,241,0,6
27455,1,2491,2420,71,0,108,0,6
27456,2,2319,2453,-134,0,106,1,6
27457,1,2262,2429,-167,0,4,0,6
27458,2,2569,2404,165,0,121,0,6
27459,3,2483,2547,-64,0,106,0,9
27460,1,2431,2447,-16,0,426,0,6
27461,2,2347,2434,-87,0,338,0,6
27462,2,2438,2434,4,0,406,0,6
27463,2,2408,2344,64,0,101,1,6
27464,1,2418,2383,35,0,454,0,6
27465,2,2487,2419,68,0,125,0,6
27466,1,2551,2479,72,0,201,0,6
27467,1,2415,2373,42,0,304,0,6
27468,1,2474,2309,165,0,184,0,6
27469,2,2474,2394,80,0,150,0,6
27470,3,2295,2410,-115,0,123,0,6
27471,1,2435,2343,92,0,112,0,6
27472,2,2324,2409,-85,0,100,1,6
27473,1,2491,2250,241,0,4,0,6
27474,2,2530,2694,-164,0,315,0,6
27475,3,2431,2360,71,0,127,0,6
27476,2,2576,2542,34,0,15,0,6
27477,3,2545,2467,78,0,80,0,6
27478,2,2551,2330,221,0,207,0,6
27479,1,2380,2486,-106,0,288,0,6
27480,1,2269,2421,-152,0,268,0,6
27481,2,2483,2517,-34,0,106,0,6
27482,1,2661,2657,4,0,143,0,6
27483,1,2397,2496,-99,0,13,1,6
27484,1,2467,2241,226,0,106,0,6
27485,2,2411,2385,26,0,45,1,6
27486,1,2347,2449,-102,0,35,0,6
27487,1,2281,2471,-190,4,40,0,0
27488,2,2314,2471,-157,0,302,0,6
27489,1,2405,2410,-5,0,122,0,8
27490,2,2409,2578,-169,0,106,1,6
27491,2,2280,2455,-175,0,300,1,6
27492,1,2634,2591,43,0,434,0,6
27493,2,2406,2410,-4,0,46,0,6
27494,2,2401,2290,111,0,45,1,6
27495,2,2509,2527,-18,0,245,0,6
27496,1,2472,2390,82,0,156,0,6
27497,1,2424,2450,-26,0,106,1,6
27498,2,2380,2462,-82,0,133,0,8
27499,2,2503,2382,121,0,330,0,6
27500,2,2441,2482,-41,0,460,1,6
27501,2,2374,2413,-39,0,1,0,6
27502,2,2439,2538,-99,0,130,0,6
27503,2,2429,2452,-23,0,331,0,6
27504,1,2378,2423,-45,0,180,0,6
27505,2,2225,2543,-318,0,236,1,6
27506,1,2426,2419,7,0,100,0,6
27507,2,2485,2546,-61,0,119,0,9
27508,1,2415,2446,-31,0,426,0,6
27509,2,2446,2448,-2,0,46,0,8
27510,1,2509,2399,110,0,247,0,6
27511,3,2536,2561,-25,0,373,0,6
27512,2,2652,2667,-15,0,103,0,6
27513,1,2456,2441,15,0,45,1,6
27514,1,2618,2628,-10,0,448,0,6
27515,1,2412,2325,87,0,336,0,6
27516,2,2478,2494,-16,0,58,0,6
27517,3,2336,2432,-96,0,111,0,6
27518,1,2403,2291,112,0,307,0,6
27519,2,2316,2492,-176,0,101,0,6
27520,1,2530,2426,104,0,132,0,6
27521,1,2424,2480,-56,0,350,1,6
27522,2,2458,2444,14,0,46,1,6
27523,1,2511,2497,14,0,300,0,6
27524,2,2337,2536,-199,0,110,0,6
27525,2,2528,2503,25,0,46,0,6
27526,2,2270,2409,-139,0,400,0,6
27528,2,2270,2470,-200,0,454,0,6
27529,2,2451,2397,54,0,4,0,6
27530,2,2474,2449,25,0,302,1,6
27531,1,2409,2343,66,0,115,0,6
27532,2,2446,2395,51,0,245,0,6
27533,2,2544,2477,67,0,400,0,6
27534,1,2513,2390,123,0,200,0,6
27535,1,2415,2540,-125,0,245,1,6
27536,2,2371,2552,-181,0,277,0,6
27537,3,2206,2476,-270,0,50,0,6
27538,1,2442,2354,88,0,241,0,6
27539,2,2300,2400,-100,0,141,0,6
27540,2,2385,2535,-150,0,107,0,6
27541,1,2392,2401,-9,0,305,0,6
27542,1,2586,2639,-53,0,454,0,6
27543,1,2339,2542,-203,0,11,0,6
27544,3,2489,2326,163,0,217,0,6
27545,1,2621,2624,-3,0,426,0,6
27546,1,2632,2475,157,0,219,0,6
27547,1,2432,2478,-46,0,9,1,6
27548,2,2477,2346,131,0,211,0,6
27549,2,2409,2320,89,4,485,0,13
27550,2,2418,2375,43,0,52,0,6
27552,1,2351,2485,-134,0,125,0,6
27553,2,2249,2419,-170,0,201,0,6
27554,1,2509,2522,-13,0,107,0,6
27555,2,2391,2405,-14,0,133,1,6
27556,2,2452,2564,-112,0,101,0,6
27557,3,2518,2431,87,0,45,0,6
27559,1,2243,2420,-177,0,116,1,6
27560,1,2454,2270,184,4,120,0,13
27561,2,2414,2435,-21,0,1,0,6
27562,1,2422,2542,-120,0,55,0,6
27563,3,2672,2646,26,0,141,0,6
27564,1,2533,2348,185,0,207,0,6
27565,2,2473,2479,-6,0,130,1,6
27566,3,2564,2697,-133,0,118,0,6
27567,2,2623,2444,179,0,302,0,6
27568,1,2440,2435,5,0,250,1,6
27569,2,2544,2255,289,0,135,1,6
27570,2,2287,2444,-157,0,108,1,6
27571,2,2404,2220,184,0,130,0,8
27572,1,2368,2421,-53,0,106,0,6
27573,2,2417,2473,-56,0,469,0,6
27574,1,2484,2517,-33,0,106,0,6
27575,1,2446,2430,16,0,206,0,6
27576,2,2291,2428,-137,0,1,0,6
27577,1,2408,2346,62,0,45,0,6
27578,3,2499,2238,261,0,4,0,6
27579,2,2422,2535,-113,0,304,0,6
27580,1,2487,2436,51,0,154,0,6
27581,2,2472,2262,210,0,130,0,6
27582,1,2567,2452,115,0,9,0,6
27583,2,2275,2444,-169,0,100,1,6
27584,1,2538,2386,152,0,40,1,6
27585,2,2440,2470,-30,0,448,0,6
27586,1,2566,2370,196,0,100,0,6
27587,1,2695,2327,368,0,311,1,6
27588,1,2458,2486,-28,0,409,0,6
27589,1,2317,2485,-168,0,0,1,6
27590,1,2299,2465,-166,0,46,0,6
27591,2,2436,2493,-57,0,265,1,6
27592,2,2349,2501,-152,0,245,0,6
27593,1,2415,2257,158,0,314,1,6
27594,2,2345,2467,-122,0,301,1,6
27595,2,2365,2413,-48,0,46,1,6
27596,1,2414,2350,64,0,107,1,6
27597,2,2361,2558,-197,0,6,0,6
27598,1,2411,2440,-29,0,207,0,8
27599,1,2413,2313,100,0,201,0,6
27600,2,2592,2618,-26,0,427,0,6
27601,2,2296,2468,-172,0,101,0,6
27602,2,2404,2370,34,0,40,1,6
27603,1,2523,2480,43,0,246,0,6
27604,2,2345,2536,-191,0,11,0,6
27605,1,2467,2495,-28,0,394,0,6
27606,1,2404,2429,-25,0,69,0,6
27607,3,2296,2539,-243,0,112,0,6
27608,1,2539,2418,121,0,121,0,6
27609,1,2352,2469,-117,0,100,0,6
27610,1,2395,2471,-76,0,0,0,6
27611,2,2414,2542,-128,0,304,0,6
27612,2,2628,2672,-44,0,483,0,6
27613,1,2444,2469,-25,0,248,0,6
27614,2,2473,2230,243,0,118,0,6
27615,2,2232,2577,-345,0,240,0,6
27616,1,2409,2347,62,0,1,0,6
27617,2,2404,2341,63,0,48,0,6
27618,2,2647,2672,-25,0,247,0,6
27619,1,2436,2237,199,0,106,0,6
27620,1,2423,2434,-11,0,102,0,6
27621,2,2464,2418,46,0,100,0,6
27622,3,2516,2510,6,0,40,0,6
27623,2,2442,2267,175,0,46,1,6
27624,3,2448,2446,2,0,325,0,6
27625,3,2252,2407,-155,0,200,0,6
27626,2,2472,2453,19,0,54,0,6
27627,1,2368,2413,-45,0,152,0,6
27628,2,2504,2491,13,0,130,1,6
27629,2,2624,2587,37,0,405,1,6
27630,2,2568,2448,120,0,261,1,6
27631,2,2475,2415,60,0,220,0,6
27632,1,2405,2462,-57,0,100,0,6
27633,3,2245,2496,-251,0,267,0,6
27634,3,2466,2284,182,0,337,0,6
27635,1,2505,2315,190,0,0,0,6
27636,3,2456,2424,32,0,4,0,6
27637,1,2429,2352,77,0,6,0,6
27638,3,2579,2535,44,0,256,0,6
27639,1,2521,2366,155,0,245,1,6
27640,2,2430,2551,-121,0,7,0,6
27641,1,2752,2250,502,0,15,0,6
27642,1,2489,2445,44,0,321,0,6
27643,1,2342,2412,-70,0,196,0,6
27644,3,2478,2411,67,0,345,0,6
27645,2,2269,2431,-162,0,181,0,6
27646,2,2677,2622,55,0,130,0,6
27647,2,2458,2477,-19,0,448,1,6
27648,1,2383,2542,-159,0,2,0,6
27649,3,2475,2293,182,0,22,0,6
27650,1,2462,2447,15,0,15,0,6
27651,2,2253,2412,-159,0,102,0,6
27652,3,2696,2315,381,0,354,0,6
27653,2,2338,2438,-100,0,107,0,6
27654,1,2439,2339,100,0,121,1,6
27655,1,2498,2365,133,0,445,0,6
27656,1,2620,2571,49,0,2,0,6
27657,2,2431,2434,-3,0,106,0,6
27658,1,2432,2413,19,0,83,1,6
27659,3,2255,2570,-315,0,152,0,6
27660,2,2239,2457,-218,0,455,0,6
27661,1,2424,2464,-40,0,0,0,6
27662,2,2539,2342,197,0,202,0,6
27663,2,2345,2419,-74,0,112,1,6
27664,2,2475,2534,-59,0,335,1,6
27665,2,2306,2446,-140,0,107,1,6
27666,3,2523,2516,7,0,341,0,6
27667,1,2376,2400,-24,0,112,0,6
27668,1,2402,2452,-50,0,302,0,6
27669,1,2471,2309,162,0,46,1,6
27670,1,2266,2402,-136,0,4,0,6
27671,1,2566,2369,197,0,107,0,6
27672,1,2546,2411,135,0,132,0,6
27673,1,2523,2259,264,0,354,0,6
27674,2,2677,2642,35,0,123,0,6
27675,1,2426,2423,3,0,373,1,6
27676,1,2407,2359,48,0,101,0,6
27677,1,2442,2339,103,0,45,0,6
27678,3,2466,2453,13,0,338,0,6
27679,1,2442,2334,108,0,410,1,6
27680,2,2536,2692,-156,0,14,0,6
27681,3,2467,2434,33,0,4,0,6
27682,2,2425,2423,2,0,200,0,6
27683,3,2560,2594,-34,0,112,0,6
27684,1,2464,2466,-2,0,268,0,6
27685,2,2502,2502,0,0,123,0,6
27686,2,2257,2434,-177,0,57,0,6
27687,2,2452,2516,-64,0,415,0,6
27688,1,2566,2625,-59,0,101,1,6
27689,2,2511,2555,-44,0,200,0,6
27690,1,2407,2550,-143,0,304,1,6
27691,1,2508,2516,-8,0,241,0,6
27692,2,2471,2481,-10,0,128,0,6
27693,1,2459,2429,30,0,106,0,6
27694,2,2428,2522,-94,0,245,1,6
27695,1,2440,2425,15,0,4,0,6
27696,2,2376,2434,-58,0,315,0,6
27697,1,2328,2465,-137,0,101,0,6
27698,2,2408,2414,-6,0,453,0,6
27699,2,2535,2391,144,0,202,1,6
27700,2,2422,2383,39,0,140,1,6
27701,2,2629,2670,-41,0,469,0,6
27702,2,2455,2275,180,0,0,0,6
27703,2,2456,2547,-91,0,110,0,6
27704,2,2351,2530,-179,0,28,0,6
27705,1,2463,2365,98,0,242,0,6
27706,3,2510,2514,-4,0,4,0,6
27707,2,2440,2483,-43,0,301,0,6
27708,1,2460,2224,236,0,115,0,6
27709,2,2362,2471,-109,0,398,0,6
27710,1,2439,2308,131,0,100,1,6
27711,1,2457,2496,-39,0,339,1,6
27712,2,2336,2457,-121,4,42,1,13
27713,2,2496,2506,-10,0,106,0,6
27714,2,2648,2671,-23,0,253,0,6
27715,1,2446,2341,105,0,300,1,6
27716,2,2220,2443,-223,0,135,0,6
27717,1,2501,2466,35,0,42,0,6
27718,2,2375,2403,-28,0,277,0,6
27719,2,2368,2408,-40,0,394,0,6
27720,2,2449,2368,81,0,101,1,6
27721,1,2438,2495,-57,0,148,0,6
27722,2,2618,2573,45,0,335,1,6
27723,1,2458,2260,198,0,115,0,6
27724,1,2389,2431,-42,0,100,0,6
27725,2,2476,2358,118,0,17,0,6
27726,2,2582,2497,85,0,140,0,6
27727,2,2408,2438,-30,0,1,0,6
27728,1,2457,2475,-18,0,300,0,6
27729,2,2470,2577,-107,0,414,0,6
27730,2,2505,2418,87,0,476,0,6
27731,1,2412,2352,60,0,106,0,6
27732,2,2306,2467,-161,0,120,0,6
27733,2,2435,2402,33,0,315,1,6
27734,2,2460,2320,140,0,312,0,6
27735,1,2446,2205,241,0,118,0,6
27736,1,2593,2561,32,0,456,0,6
27737,2,2407,2431,-24,0,109,0,6
27738,2,2302,2439,-137,0,113,1,6
27739,2,2419,2403,16,0,174,0,6
27740,3,2560,2368,192,0,11,0,6
27741,1,2415,2514,-99,0,304,0,6
27742,1,2407,2293,114,0,380,0,8
27743,1,2533,2348,185,0,200,0,6
27744,1,2675,2624,51,0,130,1,6
27745,2,2461,2420,41,0,196,0,6
27746,1,2429,2429,0,0,335,1,6
27747,2,2287,2462,-175,0,5,0,6
27748,2,2510,2718,-208,0,49,0,6
27749,2,2415,2555,-140,0,302,0,6
27750,2,2459,2511,-52,0,106,1,6
27751,1,2420,2416,4,0,292,1,6
27752,2,2437,2403,34,0,221,0,6
27753,1,2437,2460,-23,0,109,0,6
27754,2,2284,2446,-162,0,4,0,6
27755,2,2491,2536,-45,0,244,0,6
27756,1,2527,2404,123,0,67,1,6
27757,1,2676,2643,33,0,46,1,6
27758,2,2415,2435,-20,0,321,0,6
27759,2,2511,2502,9,0,331,1,6
27760,3,2476,2305,171,0,151,0,6
27761,2,2488,2469,19,0,312,0,6
27762,1,2504,2525,-21,0,124,0,6
27763,1,2399,2579,-180,0,253,1,6
27764,1,2490,2464,26,0,15,0,6
27765,2,2446,2527,-81,0,110,1,6
27766,2,2522,2517,5,0,41,1,6
27767,3,2335,2465,-130,0,4,0,6
27768,1,2425,2517,-92,0,190,0,6
27769,2,2450,2429,21,0,301,0,6
27770,2,2423,2292,131,0,245,0,6
27771,2,2453,2571,-118,0,132,0,6
27772,1,2455,2444,11,0,151,0,6
27773,2,2544,2466,78,0,246,0,6
27774,1,2348,2417,-69,0,8,0,6
27775,1,2425,2227,198,0,0,0,6
27776,1,2453,2366,87,0,1,0,6
27777,2,2407,2386,21,0,301,0,6
27778,2,2442,2451,-9,0,140,1,6
27779,1,2409,2428,-19,0,40,0,6
27780,1,2449,2437,12,0,0,1,6
27781,2,2506,2422,84,0,145,0,6
27782,2,2536,2426,110,0,190,0,6
27783,3,2581,2413,168,0,58,0,6
27784,2,2442,2389,53,0,46,0,6
27785,2,2367,2498,-131,0,102,0,6
27786,2,2358,2450,-92,0,130,0,6
27787,1,2702,2351,351,0,113,0,6
27788,1,2516,2337,179,0,120,1,6
27789,1,2721,2508,213,0,6,1,6
27790,1,2619,2680,-61,0,255,0,6
27791,2,2410,2355,55,0,190,0,6
27792,2,2454,2461,-7,0,0,1,6
27793,1,2503,2345,158,0,302,0,6
27794,1,2447,2409,38,0,6,0,6
27795,2,2391,2434,-43,0,211,0,8
27796,1,2463,2218,245,0,131,0,6
27797,1,2486,2452,34,0,4,0,6
27798,2,2412,2279,133,0,57,0,6
27799,1,2559,2402,157,0,400,0,6
27800,3,2542,2486,56,0,20,0,6
27801,1,2571,2408,163,0,201,0,6
27802,2,2502,2400,102,0,80,0,6
27803,2,2303,2471,-168,0,182,0,6
27804,3,2459,2435,24,0,200,0,6
27805,2,2254,2406,-152,0,240,0,8
27806,1,2491,2405,86,0,4,0,6
27807,2,2464,2427,37,0,302,0,6
27808,1,2495,2356,139,0,455,0,6
27809,1,2483,2482,1,0,45,0,6
27810,1,2475,2364,111,0,302,0,6
27811,1,2400,2280,120,0,104,0,6
27812,1,2674,2626,48,0,130,0,6
27813,1,2508,2510,-2,0,140,0,6
27814,1,2358,2425,-67,0,380,1,6
27815,2,2443,2531,-88,0,83,0,6
27816,2,2682,2499,183,0,246,0,6
27817,1,2415,2362,53,0,46,0,6
27818,2,2452,2356,96,0,400,1,6
27819,1,2401,2270,131,0,405,1,6
27820,2,2357,2447,-90,0,45,0,6
27821,2,2404,2432,-28,0,365,0,6
27822,1,2369,2446,-77,0,46,0,6
27823,2,2531,2422,109,0,40,0,6
27824,1,2468,2361,107,0,211,0,6
27825,3,2579,2618,-39,0,80,0,6
27826,2,2404,2574,-170,0,3,0,6
27827,2,2404,2466,-62,0,130,0,6
27828,2,2431,2455,-24,0,138,1,6
27829,3,2615,2479,136,0,120,0,6
27830,2,2318,2454,-136,0,226,0,6
27831,1,2435,2376,59,0,112,0,6
27832,2,2436,2557,-121,0,46,0,6
27833,1,2519,2396,123,0,120,0,6
27834,2,2423,2437,-14,0,320,1,6
27835,3,2487,2541,-54,0,130,0,6
27836,1,2439,2496,-57,0,112,1,6
27837,2,2494,2439,55,0,302,1,6
27838,1,2355,2419,-64,0,250,0,6
27839,1,2472,2342,130,0,331,1,6
27840,2,2435,2377,58,0,89,0,6
27841,2,2704,2341,363,0,311,0,8
27842,2,2407,2529,-122,0,234,0,6
27843,2,2336,2436,-100,0,43,0,6
27844,2,2505,2724,-219,0,40,0,6
27845,2,2479,2393,86,0,46,0,6
27846,1,2385,2458,-73,0,245,0,6
27847,2,2362,2404,-42,0,7,0,6
27848,2,2436,2402,34,0,40,1,6
27849,1,2523,2439,84,0,249,0,6
27850,2,2486,2448,38,0,107,0,6
27851,1,2437,2418,19,0,302,0,6
27852,2,2414,2360,54,0,107,0,6
27853,1,2577,2640,-63,0,14,0,6
27854,1,2287,2440,-153,0,45,0,6
27855,2,2493,2560,-67,0,9,0,6
27856,2,2364,2400,-36,0,121,1,6
27857,2,2262,2470,-208,0,453,0,6
27858,2,2508,2673,-165,0,245,0,6
27859,2,2399,2458,-59,0,311,0,6
27860,2,2621,2679,-58,0,466,0,6
27861,3,2424,2424,0,0,324,0,6
27862,2,2631,2504,127,0,317,1,6
27863,2,2401,2523,-122,0,3,0,6
27864,2,2423,2536,-113,0,4,1,6
27865,2,2375,2473,-98,0,200,0,6
27866,1,2420,2392,28,0,133,0,6
27867,2,2516,2514,2,0,30,0,6
27868,1,2271,2420,-149,0,128,0,6
27869,1,2517,2568,-51,0,122,0,8
27870,1,2401,2398,3,0,0,0,6
27871,1,2434,2202,232,0,313,0,6
27872,1,2515,2507,8,0,300,0,6
27873,2,2430,2533,-103,0,343,1,6
27874,2,2238,2458,-220,0,455,0,6
27875,1,2357,2474,-117,0,15,0,6
27876,1,2409,2357,52,0,190,0,6
27877,1,2477,2328,149,0,121,0,6
27878,2,2527,2537,-10,0,302,0,6
27879,1,2428,2579,-151,0,129,0,6
27880,2,2353,2457,-104,0,134,0,6
27881,2,2402,2416,-14,0,176,1,6
27882,2,2418,2314,104,0,41,0,6
27883,2,2369,2459,-90,0,335,0,6
27884,1,2540,2367,173,0,483,0,6
27885,1,2314,2433,-119,0,200,0,6
27886,1,2331,2416,-85,0,25,1,6
27887,1,2473,2336,137,0,240,0,6
27888,2,2481,2613,-132,0,10,0,6
27889,2,2434,2527,-93,0,478,0,6
27890,1,2599,2488,111,0,404,0,6
27891,3,2359,2432,-73,0,315,0,6
27893,2,2677,2505,172,0,337,0,6
27894,1,2508,2515,-7,0,46,1,6
27895,3,2284,2460,-176,0,40,0,6
27896,2,2442,2375,67,0,151,0,6
27897,1,2443,2428,15,0,380,0,6
27898,2,2374,2410,-36,0,100,1,6
27899,2,2618,2503,115,0,3,0,6
27900,1,2356,2404,-48,0,106,0,6
27901,1,2527,2473,54,0,247,0,6
27902,1,2413,2352,61,0,6,1,6
27903,2,2360,2489,-129,0,151,0,6
27904,1,2524,2398,126,0,202,0,6
27905,2,2488,2476,12,0,409,0,6
27906,2,2338,2472,-134,0,11,0,6
27907,2,2306,2407,-101,0,45,1,6
27908,3,2536,2454,82,0,148,0,6
27909,2,2280,2431,-151,0,1,0,6
27910,2,2409,2346,63,0,267,0,6
27911,1,2424,2360,64,0,466,0,6
27912,2,2461,2313,148,4,120,1,13
27913,2,2455,2496,-41,0,32,1,6
27914,1,2424,2425,-1,0,40,0,6
27915,1,2404,2290,114,0,57,0,6
27917,2,2463,2445,18,0,190,0,6
27918,2,2436,2349,87,0,0,0,6
27919,2,2234,2400,-166,0,255,0,6
27920,1,2411,2222,189,0,365,0,8
27921,2,2513,2668,-155,0,106,0,6
27922,3,2572,2463,109,0,59,0,6
27923,2,2394,2488,-94,0,62,0,6
27924,1,2532,2429,103,0,200,1,6
27925,2,2371,2439,-68,0,46,0,8
27926,1,2410,2332,78,0,115,0,6
27927,1,2543,2522,21,0,88,0,6
27928,1,2446,2305,141,0,264,0,6
27929,2,2301,2435,-134,0,302,1,6
27930,2,2362,2426,-64,0,108,0,6
27931,2,2461,2477,-16,0,100,0,6
27932,2,2438,2382,56,0,170,0,6
27933,1,2323,2452,-129,0,308,0,6
27934,2,2392,2465,-73,0,227,0,6
27935,2,2405,2275,130,0,121,0,6
27936,1,2477,2434,43,0,103,0,6
27938,2,2434,2253,181,0,122,0,6
27939,3,2472,2491,-19,4,110,0,11
27940,3,2467,2440,27,0,196,0,6
27941,1,2448,2478,-30,0,65,0,6
27942,1,2469,2537,-68,0,310,1,6
27943,2,2306,2405,-99,0,312,0,6
27944,1,2393,2431,-38,0,302,0,6
27945,1,2531,2430,101,0,228,0,6
27946,3,2419,2265,154,0,0,0,6
27947,2,2333,2429,-96,0,114,1,6
27948,3,2423,2428,-5,0,327,0,6
27949,2,2543,2455,88,0,463,0,6
27950,2,2467,2432,35,0,45,0,6
27951,1,2446,2439,7,0,45,1,6
27952,2,2493,2364,129,0,411,1,6
27953,3,2502,2540,-38,0,115,0,6
27954,3,2463,2429,34,0,115,0,6
27955,2,2484,2502,-18,0,151,0,6
27956,2,2247,2401,-154,0,304,1,6
27957,2,2389,2482,-93,0,105,0,6
27958,1,2482,2351,131,0,218,1,6
27959,2,2421,2397,24,0,176,0,6
27960,1,2364,2404,-40,0,405,1,6
27961,1,2480,2410,70,0,121,0,6
27962,1,2510,2510,0,0,107,0,6
27963,1,2514,2474,40,0,48,1,6
27964,1,2465,2522,-57,0,143,0,6
27965,1,2672,2510,162,0,43,0,6
27966,2,2512,2610,-98,0,241,1,6
27967,2,2269,2414,-145,0,191,1,8
27968,2,2317,2415,-98,0,45,0,6
27970,1,2411,2364,47,0,8,0,6
27971,2,2425,2475,-50,0,302,1,6
27972,1,2464,2548,-84,0,300,0,6
27974,1,2394,2536,-142,0,3,0,6
27975,2,2575,2536,39,0,106,0,6
27976,2,2335,2434,-99,0,57,0,6
27977,2,2561,2414,147,0,40,0,6
27978,2,2336,2417,-81,0,40,0,6
27979,1,2472,2290,182,0,130,1,6
27980,2,2451,2457,-6,0,210,0,6
27981,1,2321,2497,-176,0,40,1,8
27982,2,2515,2444,71,0,103,0,6
27983,1,2482,2331,151,0,142,0,6
27984,1,2417,2263,154,0,45,1,6
27985,1,2431,2357,74,0,380,1,6
27986,1,2501,2461,40,0,208,0,6
27987,3,2466,2460,6,0,278,0,6
27988,1,2522,2528,-6,0,38,0,6
27989,1,2492,2322,170,0,112,1,6
27990,3,2603,2611,-8,0,409,0,6
27991,2,2257,2415,-158,0,151,1,6
27992,1,2419,2326,93,0,8,0,6
27993,1,2453,2450,3,0,107,0,6
27994,3,2351,2429,-78,0,104,0,6
27995,1,2537,2201,336,0,4,0,6
27996,1,2419,2387,32,0,107,0,6
27997,3,2413,2485,-72,0,380,0,6
27998,2,2406,2439,-33,0,320,0,6
27999,1,2569,2632,-63,0,405,0,6
28000,1,2514,2434,80,0,107,0,6
28001,1,2542,2521,21,0,120,0,6
28002,1,2475,2303,172,0,4,0,6
28003,2,2401,2390,11,0,102,0,6
28004,1,2425,2440,-15,0,335,0,6
28005,1,2466,2335,131,0,202,0,6
28006,1,2271,2418,-147,0,45,0,6
28007,1,2328,2470,-142,0,224,1,6
28008,2,2507,2675,-168,0,221,0,6
28009,1,2505,2515,-10,0,46,1,6
28010,3,2403,2364,39,0,41,0,6
28011,2,2532,2581,-49,0,6,0,8
28012,1,2434,2295,139,0,115,0,6
28013,3,2530,2476,54,0,265,0,6
28014,1,2486,2431,55,0,411,0,6
28016,2,2258,2431,-173,0,242,0,6
28017,3,2403,2415,-12,0,200,0,6
28018,2,2309,2456,-147,0,5,1,6
28019,1,2372,2485,-113,0,15,0,6
28020,2,2355,2444,-89,0,16,0,8
28021,2,2286,2408,-122,0,205,0,6
28022,2,2423,2485,-62,0,0,0,6
28023,1,2421,2232,189,0,101,0,6
28024,3,2430,2282,148,0,80,0,6
28025,1,2294,2428,-134,0,57,1,6
28026,1,2663,2478,185,0,133,0,6
28027,1,2605,2600,5,0,196,1,6
28028,2,2458,2570,-112,0,12,0,6
28029,2,2270,2438,-168,0,117,0,6
28030,2,2444,2519,-75,0,461,0,6
28031,1,2562,2536,26,0,462,0,6
28032,1,2307,2408,-101,0,153,0,6
28033,1,2524,2562,-38,0,122,0,6
28034,2,2386,2449,-63,0,128,1,6
28035,1,2422,2331,91,0,0,0,6
28036,3,2457,2618,-161,0,0,0,6
28037,3,2451,2354,97,0,202,0,6
28038,2,2452,2528,-76,0,132,0,6
28039,1,2586,2396,190,0,15,0,8
28040,1,2426,2409,17,0,332,0,6
28041,1,2508,2402,106,0,210,0,6
28042,1,2434,2438,-4,0,48,0,6
28043,1,2478,2548,-70,0,106,0,6
28044,1,2364,2486,-122,0,125,0,6
28045,1,2328,2463,-135,0,141,0,6
28046,2,2422,2386,36,0,455,0,6
28047,1,2435,2475,-40,0,267,0,6
28048,1,2420,2293,127,0,46,1,6
28049,1,2312,2420,-108,0,125,0,6
28050,1,2432,2368,64,0,6,0,6
28051,2,2465,2286,179,0,121,1,6
28052,2,2426,2350,76,0,0,0,6
28053,1,2342,2418,-76,0,34,0,6
28054,1,2427,2444,-17,0,107,0,6
28055,1,2535,2517,18,0,211,0,6
28056,2,2352,2436,-84,0,195,0,6
28057,2,2401,2495,-94,0,415,1,6
28058,2,2344,2424,-80,0,1,1,6
28059,1,2506,2417,89,0,1,1,6
28060,2,2468,2441,27,0,242,0,6
28061,1,2441,2542,-101,0,307,1,6
28062,2,2488,2414,74,0,414,0,6
28063,2,2483,2331,152,0,200,1,6
28064,1,2678,2504,174,0,277,0,6
28065,2,2239,2569,-330,0,411,1,8
28066,1,2401,2432,-31,0,36,1,6
28067,3,2584,2576,8,0,15,0,6
28068,1,2396,2490,-94,0,395,0,6
28069,2,2471,2418,53,0,4,1,6
28070,1,2510,2511,-1,0,140,0,6
28071,1,2474,2403,71,0,253,1,6
28072,1,2336,2491,-155,0,102,0,6
28073,2,2462,2322,140,0,4,0,6
28074,3,2616,2460,156,0,138,0,6
28076,2,2611,2575,36,0,355,0,6
28077,2,2326,2540,-214,0,4,0,6
28078,2,2365,2402,-37,0,200,0,6
28079,1,2502,2389,113,0,105,0,6
28080,1,2365,2438,-73,0,315,0,6
28081,1,2529,2462,67,0,142,1,6
28082,1,2514,2674,-160,0,80,1,6
28083,2,2415,2403,12,0,178,0,6
28084,3,2523,2439,84,0,15,0,6
28085,3,2415,2363,52,0,373,0,6
28086,1,2522,2475,47,0,130,0,6
28087,1,2371,2427,-56,0,110,0,6
28088,2,2478,2460,18,0,115,1,6
28089,2,2515,2602,-87,0,4,0,6
28090,2,2427,2427,0,0,203,0,6
28091,1,2458,2454,4,0,288,0,6
28092,1,2483,2309,174,0,404,0,6
28093,2,2530,2357,173,0,122,0,6
28094,2,2483,2344,139,0,40,0,6
28095,2,2254,2431,-177,0,43,0,6
28096,2,2594,2610,-16,0,194,0,6
28097,2,2354,2423,-69,0,112,1,6
28098,1,2398,2512,-114,0,2,0,6
28099,2,2589,2530,59,0,15,0,8
28100,1,2567,2390,177,0,40,0,6
28101,1,2432,2403,29,0,302,0,6
28102,2,2430,2283,147,0,61,1,6
28103,2,2408,2318,90,0,300,0,6
28104,2,2410,2419,-9,0,40,1,6
28105,1,2454,2357,97,0,40,0,6
28106,2,2200,2423,-223,0,311,0,6
28107,3,2315,2437,-122,0,4,0,6
28108,2,2361,2485,-124,0,112,0,6
28109,2,2503,2614,-111,0,330,1,6
28110,1,2453,2289,164,4,112,0,13
28111,1,2441,2348,93,0,1,0,6
28112,1,2534,2481,53,0,16,0,6
28113,1,2386,2421,-35,0,140,0,6
28114,2,2432,2448,-16,0,375,1,6
28115,2,2462,2416,46,0,33,0,6
28116,1,2404,2253,151,0,330,0,6
28117,2,2543,2456,87,0,220,0,6
28118,1,2431,2247,184,0,176,0,6
28119,2,2539,2542,-3,0,80,1,6
28120,1,2433,2365,68,0,107,0,6
28121,1,2438,2345,93,0,250,0,6
28122,2,2500,2681,-181,0,107,0,6
28123,1,2535,2584,-49,0,107,1,6
28124,2,2475,2486,-11,0,80,0,6
28125,1,2412,2283,129,0,57,1,6
28126,1,2499,2393,106,0,101,0,6
28127,2,2576,2535,41,0,307,0,6
28128,1,2434,2325,109,0,320,0,6
28129,3,2448,2460,-12,0,40,0,6
28130,2,2505,2515,-10,0,302,1,6
28131,2,2463,2421,42,0,115,0,6
28132,2,2535,2378,157,0,8,1,6
28133,2,2425,2555,-130,0,107,0,6
28134,1,2454,2465,-11,0,4,0,6
28135,1,2584,2605,-21,0,56,0,6
28136,2,2416,2396,20,0,44,1,6
28137,1,2441,2522,-81,0,123,0,6
28138,1,2511,2460,51,0,470,1,6
28139,1,2413,2299,114,0,414,0,6
28140,1,2534,2448,86,0,101,0,6
28141,2,2472,2392,80,0,241,0,6
28142,2,2466,2303,163,0,4,0,6
28143,1,2426,2288,138,0,408,0,6
28144,3,2487,2473,14,4,373,0,11
28145,1,2438,2364,74,0,44,0,6
28146,1,2470,2541,-71,0,101,1,6
28147,1,2497,2437,60,0,103,0,6
28148,1,2401,2308,93,0,40,0,6
28149,1,2411,2349,62,0,131,0,6
28150,1,2426,2208,218,0,302,1,6
28151,2,2339,2850,-511,0,33,0,6
28152,3,2240,2423,-183,4,373,0,13
28153,1,2464,2312,152,0,192,0,6
28154,2,2448,2361,87,0,46,0,8
28155,1,2522,2570,-48,0,375,0,6
28156,1,2365,2405,-40,0,106,0,6
28157,2,2405,2666,-261,0,3,0,6
28158,1,2353,2414,-61,0,46,0,6
28159,1,2449,2443,6,0,337,0,6
28160,2,2431,2571,-140,0,331,0,6
28161,2,2344,2445,-101,0,112,0,6
28162,2,2387,2479,-92,0,4,0,6
28163,1,2524,2476,48,0,246,0,6
28164,1,2431,2421,10,0,16,0,6
28165,2,2361,2425,-64,0,0,0,6
28166,2,2671,2504,167,0,62,0,6
28167,2,2458,2436,22,0,40,0,6
28168,1,2408,2618,-210,0,40,0,6
28169,3,2385,2401,-16,0,61,0,6
28170,2,2415,2404,11,0,107,1,6
28171,2,2476,2539,-63,0,107,0,6
28172,2,2616,2589,27,0,196,0,6
28173,1,2427,2453,-26,0,487,1,6
28174,1,2398,2409,-11,0,395,0,6
28175,1,2427,2280,147,0,0,0,6
28176,1,2457,2323,134,0,210,0,6
28177,1,2424,2322,102,0,8,0,6
28178,2,2389,2429,-40,0,135,0,6
28179,1,2455,2422,33,0,250,0,6
28180,1,2578,2499,79,0,372,1,6
28181,2,2443,2470,-27,0,250,0,6
28182,2,2360,2450,-90,0,122,0,6
28183,1,2459,2460,-1,0,1,0,6
28184,2,2502,2467,35,0,255,0,6
28185,1,2436,2200,236,0,151,0,6
28186,1,2438,2529,-91,0,41,0,6
28187,2,2350,2443,-93,0,102,0,6
28188,1,2459,2415,44,0,118,0,6
28189,1,2563,2637,-74,0,107,0,6
28190,1,2538,2360,178,0,291,0,6
28191,2,2248,2422,-174,0,107,0,6
28192,1,2321,2465,-144,0,107,0,6
28193,1,2548,2533,15,0,13,1,6
28194,2,2541,2427,114,0,101,0,6
28195,3,2455,2306,149,0,191,0,6
28196,1,2521,2499,22,0,241,0,6
28197,1,2449,2402,47,0,43,1,6
28198,2,2329,2489,-160,0,44,0,6
28199,2,2543,2471,72,0,45,0,6
28200,2,2515,2448,67,0,241,0,6
28201,1,2485,2487,-2,0,0,0,6
28202,2,2407,2382,25,0,200,0,6
28203,1,2439,2404,35,0,247,0,6
28204,1,2404,2453,-49,0,112,0,6
28205,1,2595,2610,-15,0,194,0,6
28206,3,2471,2529,-58,0,106,0,6
28207,2,2337,2512,-175,0,406,1,6
28208,2,2438,2437,1,0,152,0,6
28209,2,2302,2435,-133,0,345,1,6
28210,2,2461,2518,-57,0,144,1,6
28211,2,2279,2416,-137,0,109,1,6
28212,1,2534,2599,-65,0,106,1,6
28213,2,2429,2408,21,0,40,0,6
28214,3,2477,2541,-64,0,112,0,6
28215,2,2432,2481,-49,0,212,1,6
28216,2,2523,2355,168,0,0,0,8
28217,2,2357,2422,-65,0,115,0,6
28218,3,2529,2452,77,0,4,0,6
28219,2,2516,2590,-74,0,45,0,6
28220,2,2291,2405,-114,0,41,0,6
28221,1,2479,2435,44,0,191,0,6
28222,1,2449,2340,109,0,16,1,6
28223,1,2407,2356,51,0,0,1,6
28224,2,2455,2440,15,0,8,0,6
28225,2,2241,2582,-341,0,292,0,8
28226,1,2447,2360,87,0,40,1,6
28227,2,2403,2505,-102,0,2,0,6
28228,1,2445,2356,89,0,350,0,6
28229,1,2453,2431,22,0,111,0,6
28230,2,2475,2438,37,0,300,1,6
28231,2,2392,2454,-62,0,242,1,6
28232,2,2282,2446,-164,0,241,0,6
28233,1,2481,2464,17,0,330,0,6
28234,1,2456,2455,1,0,300,1,6
28235,1,2727,2447,280,0,107,0,6
28236,1,2631,2512,119,0,142,1,6
28237,3,2548,2570,-22,0,15,0,6
28238,1,2455,2410,45,0,241,1,6
28239,1,2399,2527,-128,0,52,1,6
28240,1,2492,2435,57,0,106,0,6
28241,1,2522,2526,-4,0,129,0,6
28242,1,2410,2409,1,0,302,0,6
28243,1,2430,2381,49,0,101,1,6
28244,1,2454,2473,-19,0,337,0,6
28245,1,2494,2522,-28,0,54,0,6
28246,2,2309,2463,-154,0,123,0,6
28247,2,2608,2729,-121,0,102,1,6
28248,3,2401,2286,115,4,18,0,13
28249,1,2522,2445,77,0,261,0,6
28250,3,2415,2321,94,0,106,0,6
28251,2,2441,2508,-67,0,241,0,6
28252,2,2427,2352,75,0,220,0,6
28253,2,2478,2411,67,0,190,0,6
28254,3,2494,2526,-32,0,46,0,6
28255,2,2527,2320,207,0,5,1,6
28256,2,2263,2412,-149,0,100,0,6
28257,2,2449,2319,130,0,5,0,6
28258,2,2425,2319,106,0,106,0,6
28259,1,2515,2455,60,0,241,0,6
28260,2,2221,2459,-238,0,460,0,6
28261,3,2528,2407,121,0,302,0,6
28262,2,2285,2423,-138,0,118,0,6
28263,1,2604,2601,3,0,196,0,6
28264,3,2383,2459,-76,0,140,0,6
28265,1,2426,2331,95,0,301,0,6
28266,1,2388,2496,-108,0,290,0,6
28267,1,2541,2399,142,0,202,0,6
28268,1,2528,2553,-25,0,406,0,6
28269,2,2343,2402,-59,0,21,1,6
28270,1,2570,2384,186,0,138,0,6
28271,2,2540,2478,62,0,120,1,6
28272,1,2401,2261,140,0,15,0,6
28273,1,2486,2443,43,0,58,0,6
28274,2,2438,2293,145,0,255,0,6
28275,3,2466,2430,36,0,110,0,6
28276,3,2516,2595,-79,0,337,0,6
28277,3,2318,2467,-149,0,45,0,6
28278,2,2308,2453,-145,0,25,0,6
28279,1,2336,2453,-117,0,200,0,6
28280,1,2472,2451,21,0,104,1,6
28281,1,2467,2460,7,0,112,0,6
28282,2,2380,2416,-36,0,68,0,6
28283,2,2280,2444,-164,0,241,0,6
28284,1,2380,2511,-131,0,106,0,6
28285,1,2521,2528,-7,0,5,1,6
28286,1,2446,2388,58,0,36,0,6
28287,1,2459,2417,42,0,6,0,6
28288,2,2501,2512,-11,0,462,1,6
28289,2,2365,2400,-35,0,315,0,6
28290,1,2401,2230,171,0,277,0,6
28291,2,2513,2510,3,0,317,1,6
28292,1,2484,2400,84,0,130,0,6
28293,1,2601,2635,-34,0,460,0,6
28294,1,2363,2403,-40,0,50,0,6
28295,2,2409,2283,126,0,310,0,6
28296,1,2439,2323,116,0,4,0,6
28297,1,2497,2407,90,0,253,0,6
28298,2,2508,2405,103,0,107,0,6
28299,2,2446,2416,30,0,40,1,6
28300,1,2458,2350,108,0,411,0,6
28301,2,2560,2604,-44,0,400,0,6
28302,1,2424,2573,-149,0,454,1,6
28303,2,2447,2341,106,0,131,0,6
28304,2,2420,2527,-107,0,377,0,6
28305,1,2573,2489,84,0,13,0,6
28306,2,2344,2438,-94,0,123,0,6
28307,3,2526,2526,0,0,162,0,6
28308,2,2485,2307,178,4,5,0,11
28309,1,2421,2247,174,0,0,0,6
28310,2,2375,2441,-66,0,15,1,6
28311,1,2307,2426,-119,0,6,0,6
28312,1,2420,2275,145,0,57,0,6
28313,2,2394,2440,-46,0,45,0,6
28314,3,2533,2548,-15,0,16,0,6
28315,2,2527,2389,138,0,4,0,8
28316,1,2608,2472,136,0,386,0,6
28317,1,2396,2545,-149,0,3,0,6
28318,2,2419,2340,79,0,46,0,6
28319,1,2520,2395,125,0,132,1,6
28320,1,2252,2404,-152,0,34,0,6
28321,1,2484,2388,96,0,112,1,6
28322,1,2578,2450,128,0,18,0,6
28323,2,2450,2603,-153,0,57,1,6
28324,1,2381,2488,-107,0,106,0,6
28325,3,2277,2419,-142,4,36,0,13
28326,2,2595,2610,-15,0,194,0,6
28327,1,2583,2461,122,0,4,0,6
28328,1,2485,2534,-49,0,100,0,6
28329,2,2384,2451,-67,0,112,0,6
28331,1,2409,2338,71,0,337,0,6
28332,1,2398,2644,-246,0,245,0,6
28333,1,2410,2340,70,0,3,0,6
28334,1,2446,2343,103,0,163,0,6
28335,2,2369,2450,-81,0,146,0,6
28336,1,2428,2527,-99,0,115,0,6
28337,1,2239,2416,-177,0,107,1,8
28338,2,2394,2493,-99,0,102,1,6
28339,1,2473,2517,-44,0,107,0,6
28340,2,2594,2628,-34,0,135,1,6
28341,1,2454,2473,-19,0,236,0,6
28342,2,2412,2328,84,0,40,1,6
28343,2,2443,2427,16,0,190,0,6
28344,1,2416,2388,28,0,84,0,6
28345,2,2457,2503,-46,0,106,0,6
28346,2,2449,2460,-11,0,13,1,6
28348,1,2387,2484,-97,0,405,0,6
28349,2,2495,2507,-12,0,0,1,6
28350,2,2468,2612,-144,0,202,0,6
28351,1,2434,2429,5,0,125,0,6
28352,2,2446,2456,-10,0,302,1,6
28353,2,2422,2440,-18,0,325,0,6
28354,2,2404,2362,42,0,106,0,6
28355,1,2456,2379,77,0,14,0,6
28357,1,2331,2469,-138,0,150,1,6
28358,1,2609,2501,108,0,140,0,6
28359,1,2548,2587,-39,0,15,1,6
28360,2,2278,2424,-146,0,100,0,6
28361,2,2446,2370,76,0,4,1,6
28362,1,2458,2412,46,0,300,0,6
28363,1,2414,2373,41,0,49,0,6
28364,3,2521,2316,205,0,5,0,8
28365,2,2547,2534,13,0,4,1,6
28366,1,2527,2492,35,0,130,0,6
28367,2,2460,2565,-105,0,46,0,6
28368,1,2485,2515,-30,0,112,1,6
28369,3,2426,2286,140,0,127,0,6
28370,2,2441,2516,-75,0,110,0,6
28371,2,2402,2247,155,0,308,1,6
28372,2,2248,2607,-359,0,248,0,6
28373,3,2437,2424,13,0,243,0,6
28374,1,2413,2403,10,0,469,0,6
28375,2,2327,2489,-162,0,34,0,6
28376,2,2335,2465,-130,0,48,1,6
28377,1,2510,2404,106,0,330,0,6
28378,2,2438,2365,73,0,302,0,6
28379,2,2360,2455,-95,0,45,0,6
28380,1,2448,2361,87,0,311,1,6
28381,2,2457,2315,142,0,110,0,6
28382,2,2445,2331,114,0,101,1,6
28383,3,2524,2423,101,0,101,0,6
28384,2,2615,2590,25,0,196,0,6
28385,1,2481,2388,93,0,250,1,6
28386,2,2417,2394,23,0,456,0,6
28387,2,2339,2450,-111,0,101,0,6
28388,2,2477,2460,17,0,57,0,6
28389,2,2383,2421,-38,0,123,0,6
28390,3,2272,2423,-151,0,254,0,6
28391,2,2634,2404,230,0,337,0,6
28392,1,2460,2429,31,0,107,0,6
28393,2,2391,2466,-75,0,49,0,6
28394,1,2375,2461,-86,0,112,0,6
28395,1,2338,2414,-76,0,1,1,6
28396,2,2334,2570,-236,0,11,0,6
28397,1,2634,2521,113,0,140,0,6
28398,1,2428,2293,135,0,0,0,6
28399,2,2616,2464,152,0,386,1,6
28400,2,2487,2533,-46,0,112,0,6
28401,1,2275,2404,-129,0,101,1,6
28402,1,2588,2490,98,0,113,0,6
28403,1,2397,2425,-28,0,210,0,6
28404,2,2277,2431,-154,0,45,1,6
28405,1,2613,2624,-11,0,154,0,6
28406,2,2471,2638,-167,0,122,0,6
28407,2,2492,2441,51,0,241,0,6
28408,1,2596,2609,-13,0,194,0,6
28409,2,2392,2456,-64,0,0,0,6
28410,2,2508,2348,160,0,201,0,6
28411,1,2408,2247,161,0,300,0,8
28412,2,2356,2437,-81,0,45,1,6
28413,2,2407,2424,-17,0,303,0,6
28414,2,2454,2335,119,0,381,0,6
28415,1,2322,2435,-113,0,131,0,6
28416,1,2350,2405,-55,0,9,1,6
28417,1,2454,2339,115,0,306,0,6
28418,1,2435,2324,111,0,267,0,6
28419,2,2248,2453,-205,0,46,0,6
28420,2,2311,2430,-119,0,394,0,6
28421,2,2440,2580,-140,0,301,0,6
28422,3,2555,2466,89,0,4,0,6
28423,2,2438,2466,-28,0,18,0,6
28424,1,2471,2387,84,0,132,0,6
28425,1,2371,2411,-40,0,122,0,6
28426,2,2400,2515,-115,0,3,0,6
28427,2,2431,2377,54,0,411,0,6
28429,3,2384,2485,-101,0,106,0,6
28430,2,2529,2537,-8,0,101,0,6
28431,1,2538,2482,56,0,130,0,6
28432,1,2437,2265,172,0,190,0,6
28433,1,2437,2418,19,0,0,0,8
28434,2,2448,2274,174,0,300,0,6
28435,1,2608,2585,23,0,21,1,6
28436,3,2400,2296,104,0,13,0,6
28437,2,2424,2440,-16,0,15,0,6
28438,1,2500,2560,-60,0,250,0,6
28439,2,2404,2446,-42,0,210,0,6
28440,1,2603,2602,1,0,196,0,6
28441,3,2572,2486,86,0,341,0,6
28442,2,2401,2330,71,0,406,0,6
28443,2,2473,2608,-135,0,202,1,6
28444,1,2343,2446,-103,0,112,1,6
28445,1,2424,2405,19,0,112,0,6
28446,2,2413,2419,-6,0,395,0,6
28448,2,2304,2412,-108,0,122,1,6
28449,3,2519,2396,123,0,330,0,6
28450,2,2641,2662,-21,0,194,0,6
28451,1,2435,2440,-5,0,0,0,6
28452,2,2516,2378,138,0,313,0,6
28453,1,2584,2593,-9,0,4,0,6
28454,1,2346,2416,-70,4,385,0,13
28455,1,2401,2261,140,0,48,0,6
28456,1,2430,2440,-10,0,122,0,6
28457,3,2329,2584,-255,0,80,0,8
28458,2,2555,2672,-117,0,102,1,6
28459,1,2447,2485,-38,0,226,1,6
28460,2,2460,2302,158,0,112,0,6
28461,2,2468,2503,-35,0,121,1,6
28462,2,2328,2426,-98,0,306,0,6
28463,1,2441,2385,56,0,46,0,6
28464,1,2352,2461,-109,0,43,0,6
28465,1,2618,2470,148,0,474,0,6
28466,1,2461,2307,154,0,49,1,6
28467,1,2517,2472,45,0,110,0,6
28468,1,2314,2411,-97,0,41,0,8
28469,2,2456,2277,179,0,341,0,6
28470,1,2312,2431,-119,0,57,0,6
28471,2,2453,2382,71,0,49,0,6
28472,2,2378,2441,-63,0,5,0,8
28473,1,2584,2206,378,0,269,1,6
28474,2,2524,2553,-29,0,406,0,6
28475,1,2543,2619,-76,0,157,0,6
28476,1,2384,2439,-55,0,15,0,6
28477,1,2467,2454,13,0,121,0,6
28478,1,2483,2386,97,0,250,1,6
28479,2,2428,2451,-23,0,300,0,6
28480,2,2507,2491,16,0,311,0,6
28481,1,2342,2525,-183,0,101,0,8
28482,2,2412,2399,13,0,45,1,6
28485,1,2367,2456,-89,0,212,0,6
28486,1,2581,2308,273,0,20,0,8
28487,1,2434,2435,-1,0,242,1,6
28488,1,2550,2613,-63,0,105,0,6
28489,1,2434,2377,57,0,106,0,6
28490,1,2522,2394,128,0,285,0,6
28491,2,2337,2446,-109,0,337,0,6
28492,2,2429,2379,50,0,0,1,6
28493,2,2244,2429,-185,0,130,1,6
28494,1,2611,2469,142,0,45,0,6
28495,2,2324,2429,-105,0,414,1,6
28496,1,2402,2245,157,0,25,0,8
28497,1,2596,2609,-13,0,194,0,6
28498,3,2580,2571,9,0,487,0,6
28499,1,2443,2239,204,0,0,0,8
28500,2,2422,2399,23,0,113,0,6
28501,1,2381,2431,-50,0,106,0,6
28502,2,2587,2590,-3,0,113,1,6
28503,1,2541,2478,63,0,130,0,6
28504,2,2487,2517,-30,0,54,1,6
28505,2,2416,2351,65,0,369,0,6
28506,1,2479,2454,25,0,241,0,6
28507,3,2404,2322,82,0,45,0,8
28508,3,2317,2413,-96,4,227,0,13
28509,1,2467,2622,-155,0,464,1,6
28510,1,2668,2676,-8,0,40,0,6
28511,1,2446,2434,12,0,41,0,6
28512,2,2440,2324,116,0,327,0,6
28513,1,2576,2551,25,0,45,0,6
28514,1,2436,2407,29,0,40,0,6
28515,1,2464,2492,-28,0,4,0,6
28516,1,2611,2465,146,0,241,0,6
28517,2,2550,2414,136,0,135,1,6
28518,3,2376,2445,-69,0,40,0,6
28519,2,2292,2464,-172,0,292,1,6
28520,1,2406,2277,129,4,205,0,13
28521,1,2612,2519,93,0,104,0,6
28522,1,2422,2354,68,0,40,1,6
28523,2,2402,2278,124,0,4,0,6
28524,1,2456,2386,70,0,344,0,6
28525,1,2411,2319,92,4,256,0,13
28526,2,2382,2488,-106,0,106,0,6
28527,1,2360,2406,-46,0,484,0,6
28528,2,2405,2607,-202,0,106,0,6
28529,1,2449,2391,58,0,415,0,6
28530,2,2248,2412,-164,0,46,0,6
28531,3,2432,2316,116,0,135,0,6
28532,2,2246,2448,-202,0,46,0,6
28533,1,2472,2436,36,0,324,1,6
28534,2,2473,2546,-73,0,244,0,6
28535,2,2204,2466,-262,0,133,0,6
28536,2,2491,2498,-7,0,113,0,6
28537,1,2445,2444,1,0,310,0,6
28538,1,2430,2440,-10,0,122,1,6
28539,2,2277,2423,-146,0,1,0,6
28540,2,2449,2484,-35,0,226,0,6
28541,2,2398,2526,-128,0,3,0,6
28542,1,2446,2398,48,0,302,1,8
28543,3,2424,2461,-37,0,105,0,6
28544,1,2603,2602,1,0,196,0,6
28545,2,2297,2408,-111,0,170,0,6
28546,1,2546,2581,-35,0,337,1,6
28547,1,2271,2426,-155,0,15,0,6
28548,2,2670,2674,-4,0,0,0,6
28549,2,2317,2416,-99,0,426,1,6
28550,3,2372,2506,-134,0,303,0,6
28551,2,2408,2274,134,4,202,1,13
28552,2,2555,2615,-60,0,453,0,6
28553,2,2367,2439,-72,0,200,0,6
28554,1,2398,2449,-51,0,45,0,6
28555,1,2551,2469,82,0,130,0,6
28556,2,2399,2409,-10,0,10,0,6
28557,2,2581,2580,1,0,9,1,6
28558,2,2406,2522,-116,0,107,0,6
28559,1,2335,2454,-119,0,192,1,6
28560,2,2331,2405,-74,0,315,1,6
28561,2,2402,2265,137,0,453,0,6
28562,1,2454,2350,104,0,302,1,8
28564,2,2308,2571,-263,0,250,1,6
28565,1,2596,2433,163,0,8,0,6
28566,1,2269,2415,-146,0,245,0,6
28567,2,2262,2455,-193,0,142,1,6
28568,1,2317,2514,-197,0,102,1,6
28569,1,2454,2471,-17,0,448,1,6
28570,1,2609,2402,207,0,22,1,6
28571,3,2458,2403,55,0,8,0,6
28572,3,2414,2400,14,0,205,0,6
28573,2,2392,2452,-60,0,43,1,6
28574,1,2267,2444,-177,0,110,0,6
28575,1,2349,2427,-78,0,45,0,6
28576,1,2665,2617,48,0,0,0,6
28577,3,2356,2521,-165,0,315,0,8
28578,2,2519,2482,37,0,305,0,6
28579,1,2476,2332,144,0,101,0,6
28580,1,2468,2350,118,0,110,0,6
28581,2,2402,2478,-76,0,201,1,6
28582,1,2530,2394,136,0,210,1,6
28583,1,2430,2317,113,0,205,1,6
28584,1,2426,2340,86,0,0,1,6
28585,2,2237,2446,-209,0,100,0,8
28586,1,2403,2296,107,0,45,0,8
28587,1,2451,2221,230,0,335,0,6
28588,1,2519,2306,213,0,5,0,8
28589,2,2460,2378,82,0,108,0,6
28590,1,2597,2609,-12,0,194,0,6
28591,3,2586,2384,202,0,50,0,6
28592,2,2387,2415,-28,0,150,0,6
28593,1,2490,2444,46,0,107,1,6
28594,2,2240,2435,-195,4,49,0,8
28595,1,2486,2316,170,0,478,0,6
28596,1,2494,2389,105,0,57,0,6
28597,1,2487,2382,105,0,277,0,6
28598,1,2457,2398,59,0,40,1,6
28599,2,2472,2620,-148,0,386,0,6
28600,2,2432,2372,60,0,115,0,6
28601,2,2276,2436,-160,0,200,1,6
28602,2,2465,2555,-90,0,207,0,6
28603,1,2321,2418,-97,0,1,0,6
28604,2,2670,2575,95,0,0,0,6
28605,1,2569,2382,187,0,300,0,6
28606,1,2612,2542,70,0,101,1,6
28607,2,2586,2575,11,0,278,0,6
28608,2,2386,2417,-31,0,4,0,6
28609,3,2430,2432,-2,0,105,0,6
28610,1,2447,2406,41,0,81,0,6
28612,2,2402,2491,-89,0,200,0,6
28613,1,2405,2280,125,0,313,0,6
28614,1,2467,2352,115,0,20,0,6
28615,2,2465,2460,5,0,4,0,6
28616,1,2512,2526,-14,0,107,0,6
28617,2,2400,2470,-70,0,45,0,6
28618,1,2501,2480,21,0,320,0,6
28619,2,2327,2573,-246,0,487,0,6
28620,2,2300,2444,-144,0,40,0,6
28621,2,2488,2612,-124,0,53,1,6
28622,1,2421,2399,22,0,485,0,6
28623,1,2421,2458,-37,0,301,0,6
28624,1,2335,2403,-68,0,0,0,8
28625,3,2407,2277,130,0,46,0,6
28626,1,2407,2235,172,0,45,1,8
28627,2,2427,2422,5,0,39,0,6
28628,1,2442,2489,-47,0,105,0,6
28629,2,2425,2397,28,0,106,1,6
28630,2,2623,2398,225,0,130,0,6
28631,2,2378,2495,-117,0,331,0,6
28632,2,2381,2439,-58,0,9,0,6
28633,1,2463,2436,27,0,300,0,6
28634,1,2469,2541,-72,0,310,0,6
28635,2,2504,2374,130,0,106,1,6
28636,2,2603,2603,0,0,196,0,6
28637,1,2448,2234,214,0,0,0,8
28638,1,2434,2282,152,0,127,0,6
28639,1,2394,2427,-33,0,135,0,6
28640,1,2432,2436,-4,0,345,1,6
28641,2,2439,2454,-15,0,104,0,6
28642,3,2362,2427,-65,0,46,0,6
28643,1,2649,2577,72,0,107,0,6
28644,2,2404,2307,97,0,484,0,6
28645,1,2577,2422,155,0,300,0,6
28646,3,2608,2597,11,0,194,0,6
28647,1,2415,2457,-42,0,381,0,6
28648,3,2526,2460,66,0,130,0,6
28649,1,2397,2439,-42,0,380,1,6
28650,1,2653,2607,46,0,100,0,6
28651,2,2444,2452,-8,0,404,0,6
28652,1,2581,2580,1,0,194,0,6
28653,2,2465,2459,6,0,448,0,6
28654,1,2410,2310,100,0,2,1,6
28655,2,2582,2663,-81,0,40,0,6
28656,3,2432,2430,2,0,28,0,6
28657,1,2402,2413,-11,0,8,0,6
28658,1,2355,2424,-69,0,485,0,6
28659,1,2494,2343,151,4,101,0,13
28660,1,2403,2332,71,0,1,0,6
28662,1,2447,2408,39,0,118,0,6
28663,1,2412,2366,46,0,80,0,6
28664,2,2389,2483,-94,0,40,0,6
28665,1,2228,2474,-246,0,260,1,6
28666,2,2326,2449,-123,0,335,0,6
28667,1,2518,2616,-98,0,302,0,6
28668,1,2420,2275,145,0,110,0,6
28669,2,2267,2421,-154,0,56,0,6
28670,2,2385,2482,-97,0,102,1,6
28671,3,2528,2327,201,0,8,0,8
28672,2,2297,2474,-177,0,130,0,6
28673,1,2436,2353,83,0,131,0,6
28674,1,2576,2433,143,0,10,1,6
28675,1,2391,2555,-164,0,3,1,6
28676,3,2410,2351,59,0,373,0,6
28677,3,2430,2438,-8,0,241,0,6
28678,1,2330,2422,-92,0,247,0,6
28679,2,2375,2489,-114,0,411,0,6
28680,3,2364,2421,-57,0,194,0,6
28681,2,2534,2484,50,0,115,0,6
28682,2,2419,2369,50,0,34,0,6
28683,1,2419,2392,27,0,49,0,6
28684,1,2482,2404,78,0,49,0,6
28685,2,2450,2579,-129,0,121,0,6
28686,2,2499,2374,125,0,254,1,6
28687,1,2447,2422,25,0,253,0,6
28688,1,2303,2403,-100,0,46,0,6
28689,3,2352,2583,-231,0,151,0,6
28690,2,2574,2587,-13,0,247,0,6
28691,2,2402,2261,141,0,45,1,6
28692,2,2667,2578,89,0,1,0,6
28693,1,2609,2525,84,0,107,0,6
28694,2,2316,2414,-98,0,141,0,6
28695,1,2465,2460,5,0,4,0,6
28696,1,2399,2445,-46,0,45,0,6
28697,1,2332,2514,-182,0,40,0,8
28698,2,2400,2426,-26,0,245,1,6
28699,1,2370,2462,-92,0,43,1,6
28700,1,2433,2295,138,0,122,0,6
28701,1,2438,2424,14,0,7,0,6
28702,2,2430,2317,113,0,353,0,6
28703,1,2403,2393,10,0,4,0,6
28704,1,2774,2441,333,0,311,1,6
28705,2,2452,2498,-46,0,168,0,6
28706,2,2416,2306,110,0,130,1,6
28707,1,2325,2457,-132,0,245,0,6
28708,1,2419,2432,-13,0,112,0,6
28709,2,2417,2328,89,0,301,0,6
28710,1,2424,2399,25,0,1,0,6
28711,1,2602,2574,28,0,215,0,6
28712,2,2452,2442,10,0,40,0,6
28713,2,2593,2569,24,0,194,0,6
28714,2,2403,2214,189,0,302,0,6
28715,2,2456,2345,111,0,45,0,6
28716,1,2431,2242,189,0,241,0,6
28717,2,2456,2322,134,0,487,0,6
28718,2,2420,2538,-118,0,404,0,6
28719,1,2370,2408,-38,0,41,0,6
28720,1,2299,2436,-137,0,337,0,6
28721,3,2314,2447,-133,0,245,0,6
28722,3,2428,2310,118,0,14,0,6
28723,1,2375,2425,-50,0,4,1,6
28724,1,2310,2410,-100,0,107,1,8
28725,2,2444,2583,-139,0,130,0,6
28726,1,2382,2403,-21,0,57,0,6
28727,3,2470,2501,-31,0,330,0,6
28728,1,2385,2534,-149,0,45,0,6
28729,2,2493,2660,-167,0,4,0,6
28730,3,2449,2333,116,0,16,0,6
28731,1,2579,2381,198,0,37,1,6
28732,1,2354,2410,-56,0,125,1,6
28733,1,2288,2451,-163,0,115,1,8
28734,2,2430,2453,-23,0,302,0,6
28735,2,2406,2438,-32,0,305,0,6
28736,1,2409,2385,24,0,200,0,6
28737,1,2547,2399,148,0,13,0,6
28738,2,2345,2458,-113,0,108,0,6
28739,1,2525,2409,116,0,112,0,6
28740,2,2378,2507,-129,0,1,1,6
28741,1,2429,2320,109,0,110,0,6
28742,2,2401,2380,21,0,133,1,8
28743,2,2491,2487,4,0,210,0,6
28744,2,2399,2482,-83,0,202,0,6
28745,2,2491,2528,-37,0,313,0,6
28746,2,2290,2453,-163,0,203,0,6
28747,1,2325,2506,-181,0,100,0,8
28748,2,2432,2395,37,0,45,1,6
28749,1,2454,2471,-17,0,227,1,6
28750,2,2276,2444,-168,0,16,1,6
28751,1,2328,2407,-79,0,100,1,6
28752,1,2569,2614,-45,0,385,0,6
28753,1,2445,2299,146,0,121,1,6
28754,2,2394,2454,-60,0,43,0,6
28755,1,2423,2433,-10,0,310,1,6
28756,1,2252,2410,-158,0,107,0,6
28757,1,2418,2332,86,0,150,1,6
28758,2,2575,2587,-12,0,247,0,6
28759,1,2333,2405,-72,0,300,0,6
28760,2,2440,2529,-89,0,40,0,6
28761,3,2335,2448,-113,0,190,0,6
28762,2,2386,2458,-72,0,133,1,6
28763,2,2465,2542,-77,0,212,0,6
28764,2,2418,2379,39,0,70,1,6
28765,2,2432,2413,19,0,16,0,6
28766,1,2490,2324,166,0,148,0,6
28767,3,2379,2422,-43,0,130,0,6
28768,1,2410,2445,-35,0,123,0,6
28769,3,2416,2376,40,0,211,0,6
28770,2,2308,2407,-99,0,31,0,8
28771,2,2458,2424,34,0,107,0,6
28772,1,2663,2551,112,0,14,0,6
28773,1,2434,2298,136,0,150,0,6
28774,2,2232,2525,-293,0,267,0,8
28775,1,2402,2233,169,0,46,0,6
28776,2,2310,2460,-150,0,385,0,6
28777,2,2533,2486,47,0,132,1,6
28778,2,2396,2550,-154,0,3,0,6
28779,2,2380,2415,-35,0,148,1,6
28780,2,2284,2415,-131,0,153,0,6
28781,2,2443,2401,42,0,151,0,6
28782,2,2389,2582,-193,0,46,0,6
28783,2,2459,2378,81,0,49,0,6
28784,2,2416,2361,55,0,334,0,6
28785,1,2342,2486,-144,0,205,0,6
28786,3,2275,2491,-216,0,454,0,8
28787,1,2435,2395,40,0,42,0,6
28788,2,2439,2461,-22,0,106,0,6
28789,2,2462,2382,80,0,335,0,6
28790,1,2365,2401,-36,0,109,1,6
28791,2,2399,2469,-70,4,194,0,13
28792,1,2314,2409,-95,0,20,0,6
28793,2,2431,2452,-21,0,152,0,6
28794,2,2465,2407,58,0,9,0,6
28795,1,2417,2241,176,0,229,0,6
28796,1,2717,2575,142,0,6,1,6
28797,1,2451,2460,-9,0,110,0,6
28798,2,2358,2431,-73,0,13,0,6
28799,1,2547,2492,55,0,11,0,6
28800,1,2402,2302,100,0,127,0,6
28801,3,2403,2243,160,4,45,0,13
28802,1,2501,2393,108,0,122,1,6
28803,3,2540,2401,139,0,90,0,6
28804,1,2592,2569,23,0,194,0,6
28805,3,2533,2485,48,0,246,0,6
28806,2,2302,2447,-145,0,140,0,6
28807,2,2354,2493,-139,0,8,0,6
28808,2,2564,2598,-34,0,266,1,6
28809,2,2421,2430,-9,0,1,0,6
28810,2,2401,2426,-25,0,0,0,6
28811,2,2310,2427,-117,0,4,0,6
28812,2,2306,2479,-173,0,133,1,6
28813,2,2337,2420,-83,0,1,0,6
28814,2,2496,2319,177,0,310,0,8
28815,1,2428,2352,76,0,57,0,6
28816,2,2341,2500,-159,0,330,0,6
28817,1,2475,2327,148,0,121,1,6
28818,2,2398,2425,-27,0,4,0,6
28819,2,2417,2434,-17,0,100,0,6
28820,1,2413,2257,156,0,300,0,6
28821,1,2454,2457,-3,0,10,0,6
28822,1,2446,2336,110,0,491,0,6
28823,3,2521,2468,53,0,311,0,6
28824,1,2419,2267,152,0,335,0,6
28825,1,2431,2396,35,0,5,0,6
28826,2,2463,2403,60,0,90,0,6
28827,1,2297,2406,-109,0,0,0,6
28828,1,2487,2460,27,0,31,0,6
28829,1,2547,2667,-120,0,40,0,6
28830,2,2753,2307,446,0,311,0,6
28831,2,2385,2473,-88,0,153,1,6
28832,2,2320,2423,-103,0,28,0,6
28833,2,2497,2373,124,0,115,0,6
28834,2,2279,2449,-170,0,58,0,6
28835,1,2455,2533,-78,0,43,0,6
28836,1,2424,2361,63,0,123,0,6
28837,2,2552,2392,160,0,331,0,6
28838,1,2404,2538,-134,0,303,0,6
28839,1,2377,2415,-38,0,45,0,6
28840,1,2420,2246,174,0,172,0,6
28841,1,2443,2317,126,0,0,0,8
28842,1,2408,2437,-29,0,101,0,6
28843,2,2357,2458,-101,0,315,1,6
28844,2,2436,2414,22,0,299,0,6
28845,1,2549,2227,322,0,101,0,6
28846,2,2405,2373,32,0,46,0,6
28847,2,2312,2471,-159,0,41,0,6
28848,3,2432,2449,-17,0,190,0,6
28849,2,2331,2400,-69,0,211,0,6
28850,1,2478,2470,8,0,246,0,6
28851,2,2316,2403,-87,0,6,0,6
28852,3,2308,2457,-149,4,101,0,13
28853,2,2486,2532,-46,0,129,0,6
28854,1,2369,2437,-68,0,49,0,6
28855,1,2721,2373,348,0,1,0,6
28857,2,2453,2229,224,0,43,0,6
28858,2,2413,2392,21,4,38,0,13
28859,1,2305,2421,-116,0,300,1,6
28860,2,2333,2423,-90,0,56,0,6
28861,2,2407,2402,5,0,178,0,6
28862,1,2455,2330,125,0,152,0,6
28863,2,2585,2332,253,0,100,0,6
28864,1,2428,2295,133,0,152,0,6
28865,2,2386,2571,-185,0,7,1,8
28867,3,2457,2425,32,0,107,0,6
28868,2,2390,2492,-102,0,3,0,6
28869,2,2413,2371,42,0,484,0,6
28870,3,2436,2353,83,0,42,0,6
28871,2,2226,2458,-232,4,107,0,13
28872,3,2332,2450,-118,0,143,0,6
28873,2,2440,2298,142,0,111,0,6
28874,1,2425,2285,140,4,392,0,13
28875,2,2504,2526,-22,0,245,0,6
28876,2,2455,2572,-117,0,322,0,6
28877,1,2349,2405,-56,0,7,0,6
28878,1,2450,2430,20,0,8,0,6
28879,2,2420,2430,-10,0,465,1,6
28880,2,2424,2422,2,0,398,0,6
28881,1,2431,2259,172,0,122,0,6
28882,1,2377,2420,-43,0,271,0,8
28883,2,2401,2505,-104,0,3,0,6
28884,1,2389,2451,-62,0,304,0,6
28885,1,2559,2657,-98,0,201,0,6
28886,1,2429,2329,100,0,123,0,6
28887,2,2402,2321,81,0,138,1,6
28888,2,2439,2427,12,0,0,0,6
28889,2,2367,2410,-43,0,45,1,6
28890,1,2557,2291,266,0,190,0,6
28891,1,2391,2436,-45,0,0,1,6
28892,1,2470,2432,38,0,113,0,6
28893,1,2433,2316,117,0,484,0,6
28894,3,2453,2312,141,4,40,0,13
28895,2,2377,2443,-66,0,40,0,6
28896,2,2405,2501,-96,0,302,0,6
28897,1,2660,2554,106,0,0,0,6
28898,2,2318,2742,-424,0,122,0,6
28899,1,2532,2544,-12,0,100,0,6
28900,1,2444,2295,149,0,107,0,6
28901,1,2623,2520,103,0,41,1,6
28902,1,2410,2326,84,0,1,0,6
28903,1,2477,2450,27,0,113,0,6
28904,2,2236,2499,-263,0,11,0,6
28905,2,2256,2434,-178,0,242,0,6
28906,2,2424,2378,46,0,156,0,6
28907,2,2381,2456,-75,0,140,0,6
28908,2,2282,2448,-166,4,210,0,13
28909,2,2406,2448,-42,0,331,0,6
28910,1,2360,2448,-88,0,300,0,6
28911,2,2537,2481,56,0,337,0,6
28912,1,2497,2412,85,0,81,0,6
28913,2,2301,2403,-102,0,248,0,6
28914,2,2433,2398,35,0,317,1,6
28915,2,2456,2442,14,0,331,0,6
28916,3,2379,2469,-90,0,312,0,3
28917,1,2409,2576,-167,0,131,0,6
28918,2,2355,2723,-368,0,221,0,6
28919,2,2326,2427,-101,0,426,1,6
28920,1,2489,2472,17,0,269,0,6
28921,2,2530,2585,-55,0,406,0,6
28922,2,2342,2451,-109,0,1,0,6
28923,1,2475,2353,122,0,60,1,6
28924,1,2411,2339,72,0,40,0,6
28925,2,2407,2271,136,0,310,0,6
28926,2,2361,2429,-68,0,147,1,6
28927,1,2448,2334,114,0,190,0,6
28928,1,2260,2400,-140,4,110,0,13
28929,2,2408,2449,-41,0,120,0,6
28930,2,2291,2433,-142,0,384,0,6
28931,2,2532,2462,70,0,247,0,6
28932,1,2436,2273,163,0,7,0,6
28933,1,2538,2396,142,0,13,0,6
28934,1,2457,2312,145,0,106,0,6
28935,2,2386,2482,-96,0,231,0,6
28936,3,2496,2445,51,0,31,0,6
28937,1,2408,2216,192,0,135,0,6
28938,2,2299,2447,-148,0,311,0,8
28939,2,2319,2401,-82,0,389,1,6
28940,1,2506,2408,98,0,460,0,8
28941,2,2279,2445,-166,0,107,0,6
28942,1,2430,2224,206,0,130,0,6
28943,2,2407,2297,110,0,127,0,6
28944,1,2743,2317,426,0,203,0,6
28945,1,2418,2261,157,0,2,0,6
28946,1,2487,2462,25,0,243,0,6
28947,1,2503,2474,29,4,190,0,13
28948,1,2445,2417,28,0,125,1,6
28949,2,2517,2538,-21,0,338,1,6
28950,1,2428,2373,55,0,4,1,6
28951,1,2437,2382,55,0,123,0,6
28952,1,2403,2387,16,0,302,0,8
28953,2,2650,2566,84,0,447,0,6
28954,3,2567,2509,58,0,320,0,6
28955,2,2338,2488,-150,0,46,0,6
28956,1,2430,2397,33,0,1,1,6
28957,2,2414,2384,30,0,332,0,8
28958,1,2487,2267,220,0,200,0,8
28959,1,2537,2388,149,0,101,0,6
28960,2,2360,2431,-71,0,40,0,6
28961,1,2574,2383,191,0,211,1,8
28962,1,2467,2440,27,0,158,0,6
28963,1,2448,2242,206,0,300,0,6
28964,2,2488,2372,116,0,245,1,6
28965,1,2627,2550,77,0,300,0,6
28966,2,2436,2401,35,0,234,0,6
28967,1,2724,2382,342,0,190,0,6
28968,1,2664,2542,122,0,10,0,6
28969,2,2510,2335,175,0,310,0,8
28971,1,2440,2325,115,0,411,0,6
28972,1,2330,2452,-122,0,245,0,6
28973,2,2420,2400,20,0,56,1,6
28974,1,2455,2239,216,0,314,0,6
28975,2,2446,2422,24,0,143,0,6
28976,2,2304,2400,-96,0,398,0,6
28977,1,2471,2451,20,0,123,0,6
28978,1,2355,2435,-80,0,13,1,6
28979,1,2396,2501,-105,0,300,0,6
28980,1,2365,2418,-53,0,331,0,6
28981,1,2457,2492,-35,0,301,0,6
28982,2,2384,2460,-76,0,122,0,6
28983,2,2309,2405,-96,0,16,0,6
28984,2,2411,2301,110,0,106,0,6
28985,3,2384,2450,-66,0,41,0,6
28986,2,2541,2494,47,0,194,0,6
28987,1,2360,2510,-150,0,240,0,6
28988,2,2393,2531,-138,0,3,0,6
28989,1,2384,2479,-95,0,113,0,6
28990,2,2416,2454,-38,0,48,0,6
28991,1,2423,2442,-19,0,133,0,6
28992,1,2486,2463,23,0,242,0,6
28993,2,2458,2557,-99,0,118,0,6
28994,1,2431,2307,124,0,110,0,6
28995,3,2505,2402,103,0,4,0,6
28996,2,2445,2503,-58,0,157,1,6
28997,2,2444,2338,106,0,474,0,6
28998,2,2469,2525,-56,0,4,0,6
28999,1,2495,2388,107,0,311,0,6
29000,2,2573,2643,-70,0,218,0,6
29001,2,2459,2411,48,0,211,0,6
29002,3,2609,2570,39,0,130,0,6
29003,2,2315,2498,-183,0,4,0,6
29004,1,2303,2414,-111,0,115,0,6
29005,2,2513,2566,-53,0,301,0,6
29006,1,2504,2241,263,0,365,1,6
29007,2,2252,2425,-173,0,341,0,6
29008,1,2430,2517,-87,0,455,0,6
29009,1,2269,2453,-184,0,107,1,6
29010,1,2491,2337,154,0,143,0,6
29011,2,2501,2534,-33,0,302,0,6
29012,3,2428,2484,-56,0,267,0,6
29013,1,2486,2574,-88,0,330,0,6
29014,1,2684,2668,16,0,106,0,6
29015,2,2353,2418,-65,0,404,0,6
29016,2,2231,2409,-178,0,267,0,8
29017,2,2546,2632,-86,0,330,0,6
29018,2,2446,2392,54,0,127,0,6
29019,2,2433,2525,-92,0,255,1,6
29020,2,2543,2599,-56,0,110,1,6
29021,3,2468,2381,87,0,345,0,3
29022,1,2530,2476,54,0,120,0,6
29023,1,2506,2356,150,0,147,0,6
29024,2,2334,2484,-150,0,130,0,6
29025,1,2434,2360,74,0,44,1,6
29026,2,2402,2214,188,0,178,0,6
29027,1,2450,2349,101,0,0,0,8
29028,1,2494,2512,-18,0,331,0,6
29029,2,2435,2322,113,0,4,0,6
29030,2,2390,2408,-18,0,121,0,8
29031,1,2401,2390,11,0,84,0,6
29032,2,2412,2417,-5,0,131,0,6
29033,1,2547,2472,75,0,39,1,6
29035,1,2467,2480,-13,0,277,0,6
29036,3,2336,2401,-65,0,110,0,6
29037,2,2458,2491,-33,0,301,1,6
29038,1,2409,2309,100,0,41,0,6
29039,2,2305,2449,-144,0,11,0,6
29040,3,2382,2466,-84,0,250,0,3
29041,1,2396,2428,-32,0,305,0,6
29042,2,2559,2504,55,0,0,0,6
29043,1,2404,2300,104,0,127,0,6
29044,1,2608,2535,73,0,129,0,6
29045,1,2428,2362,66,0,135,0,6
29046,2,2392,2407,-15,0,132,0,6
29047,1,2300,2441,-141,0,136,0,6
29048,2,2593,2401,192,0,250,0,6
29049,1,2570,2510,60,0,302,0,6
29050,1,2303,2435,-132,0,106,0,6
29051,2,2451,2291,160,4,347,0,13
29052,2,2346,2437,-91,0,211,0,6
29053,2,2648,2569,79,0,310,0,6
29054,1,2510,2389,121,0,40,0,6
29055,3,2331,2423,-92,0,112,0,6
29056,3,2412,2371,41,0,326,0,6
29057,2,2326,2412,-86,0,45,0,6
29058,2,2301,2436,-135,0,0,0,6
29059,1,2409,2430,-21,0,389,1,6
29060,1,2495,2454,41,0,206,0,6
29061,1,2464,2414,50,0,33,1,6
29062,2,2367,2418,-51,0,45,0,6
29063,1,2571,2385,186,0,405,0,6
29064,2,2352,2510,-158,0,485,1,6
29065,2,2351,2422,-71,0,101,0,6
29066,2,2550,2429,121,0,46,0,6
29067,1,2467,2391,76,0,456,0,6
29068,2,2517,2473,44,0,302,0,6
29069,2,2487,2441,46,0,118,0,6
29070,3,2540,2636,-96,0,110,0,6
29071,2,2438,2496,-58,0,190,0,6
29072,2,2662,2689,-27,0,0,0,6
29073,2,2399,2451,-52,0,132,1,6
29074,2,2384,2427,-43,0,120,0,6
29075,1,2726,2362,364,0,352,0,6
29076,1,2403,2465,-62,0,1,0,6
29077,2,2400,2441,-41,0,121,0,6
29078,2,2422,2330,92,0,405,0,6
29079,1,2412,2210,202,0,7,0,8
29080,2,2500,2539,-39,0,344,0,6
29081,2,2474,2471,3,0,130,0,6
29082,1,2305,2413,-108,0,302,0,6
29083,1,2514,2468,46,0,80,0,6
29084,2,2439,2386,53,0,123,0,6
29085,1,2428,2259,169,0,145,0,6
29086,1,2412,2298,114,0,100,0,6
29087,2,2530,2613,-83,0,112,0,6
29088,1,2274,2437,-163,0,375,1,6
29089,2,2441,2229,212,4,380,1,13
29090,1,2413,2384,29,0,332,0,8
29091,1,2369,2406,-37,0,341,0,6
29092,2,2296,2408,-112,0,20,0,6
29093,3,2247,2454,-207,0,40,0,8
29094,2,2386,2519,-133,0,3,0,6
29095,3,2430,2484,-54,0,267,0,6
29096,1,2463,2433,30,0,2,0,6
29097,3,2441,2440,1,0,127,0,6
29098,2,2357,2432,-75,0,400,0,6
29099,2,2469,2343,126,4,241,0,13
29100,3,2575,2598,-23,0,405,0,6
29101,1,2402,2394,8,0,153,0,6
29103,2,2619,2562,57,0,453,0,6
29104,1,2339,2410,-71,0,120,0,6
29105,2,2500,2396,104,0,454,0,6
29106,2,2416,2509,-93,0,400,1,6
29107,2,2407,2381,26,0,13,0,6
29108,1,2546,2502,44,0,250,0,8
29109,2,2374,2439,-65,0,49,1,6
29110,1,2496,2453,43,0,242,0,6
29111,2,2322,2463,-141,0,300,0,6
29112,2,2450,2405,45,0,244,1,6
29113,1,2412,2294,118,0,148,0,6
29114,2,2405,2592,-187,0,4,0,6
29115,2,2519,2382,137,0,200,0,6
29116,2,2257,2534,-277,0,302,0,6
29117,1,2415,2349,66,0,102,0,6
29118,2,2447,2617,-170,0,398,0,6
29119,1,2635,2541,94,0,300,0,6
29120,1,2453,2270,183,0,190,1,6
29121,2,2481,2506,-25,0,132,1,6
29122,2,2387,2476,-89,0,125,1,6
29123,2,2410,2415,-5,0,310,1,6
29124,2,2469,2340,129,0,302,1,6
29125,2,2563,2539,24,0,13,0,6
29126,2,2437,2504,-67,0,40,0,6
29127,1,2549,2495,54,0,123,0,6
29128,3,2504,2394,110,0,323,0,6
29129,2,2401,2433,-32,0,130,0,6
29130,2,2423,2275,148,0,345,1,6
29131,1,2540,2337,203,0,118,0,6
29132,1,2497,2415,82,0,8,0,8
29133,1,2207,2551,-344,0,80,0,8
29134,2,2416,2252,164,0,109,0,6
29135,1,2513,2349,164,0,140,0,6
29136,2,2508,2479,29,0,331,0,6
29137,2,2275,2429,-154,0,337,0,6
29138,2,2530,2402,128,0,43,0,6
29139,2,2432,2501,-69,0,50,1,6
29140,3,2384,2465,-81,0,343,0,3
29141,1,2490,2558,-68,0,380,0,6
29142,2,2415,2574,-159,0,405,0,6
29143,2,2477,2469,8,0,125,0,6
29144,1,2494,2411,83,0,436,1,6
29145,2,2446,2434,12,0,205,0,6
29146,1,2415,2418,-3,0,311,0,6
29147,2,2567,2506,61,0,403,0,6
29148,3,2432,2372,60,0,106,0,6
29149,2,2339,2493,-154,0,1,0,6
29150,1,2657,2508,149,0,1,0,6
29152,2,2466,2468,-2,0,85,0,6
29153,1,2400,2375,25,0,241,0,6
29154,2,2406,2312,94,0,43,1,6
29155,1,2412,2292,120,0,127,0,6
29156,1,2440,2441,-1,0,192,1,6
29157,3,2410,2345,65,0,8,0,8
29158,2,2366,2504,-138,0,115,0,6
29159,2,2456,2461,-5,0,426,0,6
29160,2,2438,2394,44,0,123,0,6
29161,1,2612,2694,-82,0,463,1,6
29162,2,2361,2728,-367,0,134,1,6
29163,2,2296,2430,-134,0,46,0,6
29164,2,2267,2407,-140,0,331,0,6
29165,2,2430,2252,178,0,302,0,6
29166,2,2379,2489,-110,0,10,0,6
29167,1,2546,2497,49,0,120,0,6
29168,1,2548,2356,192,0,0,1,6
29169,2,2448,2502,-54,0,301,0,6
29170,2,2293,2401,-108,0,135,1,6
29171,1,2440,2440,0,0,106,0,6
29172,1,2418,2391,27,0,193,0,8
29173,3,2495,2508,-13,0,49,0,6
29174,2,2334,2547,-213,0,122,0,6
29175,1,2493,2396,97,0,44,0,6
29176,2,2598,2583,15,0,432,1,6
29177,1,2576,2530,46,0,80,0,6
29178,1,2412,2283,129,0,291,1,6
29179,1,2467,2485,-18,0,295,0,6
29180,1,2545,2556,-11,0,125,0,6
29181,1,2623,2639,-16,0,331,0,6
29182,2,2390,2537,-147,0,3,0,6
29183,1,2444,2496,-52,0,310,0,6
29184,1,2409,2385,24,0,46,0,6
29185,1,2325,2445,-120,0,45,0,6
29187,1,2620,2478,142,0,16,0,6
29188,3,2308,2421,-113,0,120,0,6
29189,1,2346,2412,-66,0,335,0,6
29190,1,2475,2471,4,0,131,0,6
29191,1,2456,2404,52,0,203,0,6
29192,1,2479,2237,242,0,180,0,6
29193,1,2401,2357,44,0,8,0,6
29194,2,2511,2516,-5,0,460,0,6
29195,1,2284,2408,-124,0,312,1,6
29196,2,2386,2497,-111,0,12,1,6
29197,2,2280,2438,-158,0,120,0,6
29198,1,2595,2660,-65,0,106,0,6
29199,2,2492,2554,-62,0,315,0,6
29200,1,2474,2461,13,0,3,0,6
29201,2,2367,2451,-84,0,100,0,8
29202,1,2430,2505,-75,0,45,1,6
29203,1,2432,2428,4,0,225,0,6
29204,1,2427,2421,6,0,286,0,6
29205,1,2570,2297,273,0,150,0,6
29206,2,2401,2408,-7,0,118,0,6
29207,1,2562,2488,74,0,246,0,6
29208,1,2473,2434,39,0,132,0,6
29209,1,2479,2451,28,0,131,0,6
29210,2,2467,2451,16,0,109,0,6
29211,1,2487,2421,66,0,15,1,6
29212,1,2373,2461,-88,0,120,0,6
29213,1,2596,2522,74,0,338,1,6
29214,1,2505,2412,93,0,122,0,6
29215,2,2436,2445,-9,0,21,0,6
29216,1,2507,2248,259,0,300,0,6
29217,1,2506,2443,63,0,242,0,6
29218,1,2444,2355,89,0,335,0,6
29219,2,2350,2536,-186,0,302,0,6
29220,1,2495,2540,-45,0,46,1,6
29221,1,2319,2411,-92,0,49,0,6
29222,3,2498,2421,77,0,49,0,6
29223,2,2300,2572,-272,0,33,0,6
29224,1,2408,2399,9,0,422,0,6
29225,1,2431,2271,160,4,255,0,13
29226,3,2407,2299,108,0,405,0,6
29227,3,2370,2406,-36,0,331,0,6
29228,2,2687,2654,33,0,4,0,6
29229,2,2438,2511,-73,0,301,0,6
29230,1,2480,2490,-10,0,3,0,6
29231,2,2461,2455,6,0,136,0,6
29232,1,2362,2406,-44,0,45,0,6
29233,2,2497,2676,-179,0,123,1,6
29234,2,2499,2392,107,0,80,0,6
29235,1,2589,2592,-3,0,427,0,6
29236,1,2476,2511,-35,0,335,0,6
29237,1,2525,2633,-108,0,36,0,6
29238,2,2330,2446,-116,0,0,1,6
29239,1,2419,2378,41,0,310,0,6
29240,1,2337,2467,-130,0,241,1,8
29241,3,2446,2385,61,0,285,0,6
29242,1,2501,2387,114,0,331,0,6
29243,3,2485,2624,-139,0,113,0,6
29244,1,2437,2471,-34,0,245,0,6
29245,1,2586,2595,-9,0,432,0,6
29246,1,2351,2429,-78,0,150,0,6
29247,2,2551,2478,73,0,300,0,6
29248,3,2464,2303,161,0,115,0,6
29249,2,2424,2553,-129,0,410,0,6
29250,2,2528,2581,-53,0,49,1,6
29251,2,2366,2405,-39,0,339,0,6
29252,2,2483,2570,-87,0,282,0,6
29253,1,2457,2409,48,0,175,1,6
29254,1,2380,2430,-50,0,49,1,6
29255,2,2415,2421,-6,0,40,0,6
29256,1,2442,2260,182,0,47,0,6
29257,1,2337,2433,-96,0,122,1,6
29258,1,2416,2386,30,0,15,1,6
29259,2,2379,2415,-36,0,250,1,6
29260,1,2451,2430,21,0,201,0,6
29261,2,2461,2488,-27,0,145,0,6
29262,1,2327,2400,-73,0,303,1,6
29263,2,2351,2729,-378,0,253,0,6
29264,1,2492,2497,-5,0,4,0,6
29265,1,2427,2395,32,0,127,0,6
29266,1,2539,2239,300,0,45,0,6
29267,3,2428,2480,-52,0,267,0,6
29268,2,2462,2475,-13,0,133,0,6
29269,3,2483,2358,125,0,22,0,6
29270,2,2516,2434,82,0,133,1,6
29271,2,2410,2437,-27,0,133,0,6
29272,1,2510,2288,222,0,337,1,6
29273,1,2465,2457,8,0,80,0,6
29274,2,2347,2400,-53,0,244,0,6
29275,2,2335,2492,-157,0,80,0,6
29276,2,2403,2351,52,0,45,0,6
29277,1,2652,2739,-87,0,152,0,6
29278,1,2444,2273,171,0,229,0,6
29279,2,2214,2445,-231,0,123,1,6
29280,2,2552,2437,115,0,16,1,6
29281,3,2479,2481,-2,0,131,0,6
29282,2,2323,2412,-89,0,180,0,6
29283,1,2562,2383,179,0,203,0,6
29284,2,2394,2423,-29,0,45,0,6
29285,1,2551,2421,130,0,310,0,6
29286,2,2484,2456,28,0,318,0,6
29287,1,2310,2461,-151,0,140,1,6
29288,2,2486,2422,64,0,2,0,6
29289,2,2231,2402,-171,4,453,0,13
29290,1,2456,2365,91,0,0,0,8
29291,2,2424,2480,-56,0,35,0,6
29292,2,2534,2501,33,0,107,1,6
29293,1,2432,2386,46,0,115,0,6
29294,2,2385,2406,-21,0,101,0,6
29295,3,2433,2481,-48,0,43,0,6
29296,3,2504,2487,17,0,251,0,6
29297,2,2363,2449,-86,0,41,1,6
29298,2,2622,2436,186,0,156,0,6
29299,1,2526,2373,153,0,440,1,6
29300,2,2396,2445,-49,0,101,0,6
29301,1,2422,2252,170,0,457,0,6
29302,2,2680,2660,20,0,4,1,6
29303,2,2518,2497,21,0,44,0,6
29304,2,2285,2437,-152,0,4,0,6
29305,2,2577,2456,121,0,125,0,6
29306,2,2267,2443,-176,0,130,0,6
29307,1,2381,2433,-52,0,43,0,6
29308,2,2493,2291,202,0,100,0,6
29309,2,2494,2544,-50,0,107,1,6
29310,2,2425,2456,-31,0,486,1,6
29311,1,2589,2592,-3,0,427,0,6
29312,1,2526,2462,64,0,244,0,6
29313,2,2471,2510,-39,0,300,0,6
29314,3,2417,2437,-20,0,327,0,6
29315,1,2371,2426,-55,0,245,0,8
29316,1,2410,2504,-94,0,265,0,6
29317,2,2487,2495,-8,0,105,1,6
29318,2,2277,2425,-148,0,4,0,8
29319,1,2441,2553,-112,0,122,1,6
29320,3,2712,2659,53,0,40,0,6
29321,3,2464,2385,79,0,345,0,3
29322,2,2543,2450,93,0,241,1,6
29323,2,2380,2568,-188,0,2,0,6
29324,2,2366,2421,-55,0,123,0,6
29325,1,2415,2353,62,0,335,0,6
29326,1,2460,2480,-20,0,255,0,6
29327,1,2512,2469,43,0,207,0,6
29328,1,2565,2586,-21,0,380,0,6
29329,1,2464,2342,122,4,200,1,13
29330,2,2466,2299,167,0,131,0,6
29331,1,2426,2334,92,0,107,1,6
29332,1,2405,2370,35,0,241,0,6
29333,2,2404,2539,-135,0,331,0,6
29334,1,2429,2479,-50,0,136,1,6
29335,2,2379,2481,-102,0,1,0,6
29336,2,2342,2460,-118,0,127,0,8
29337,3,2508,2528,-20,0,302,0,6
29338,3,2485,2369,116,0,35,0,6
29339,2,2418,2544,-126,0,16,0,6
29340,2,2361,2459,-98,0,41,0,8
29341,1,2587,2595,-8,0,432,1,6
29342,1,2240,2447,-207,0,128,1,6
29343,3,2501,2359,142,0,400,0,6
29344,1,2441,2509,-68,0,345,1,6
29345,2,2730,2354,376,0,1,0,6
29346,2,2426,2392,34,0,110,1,6
29347,1,2348,2458,-110,0,8,0,6
29348,2,2393,2411,-18,0,178,0,6
29349,3,2386,2462,-76,0,250,0,3
29350,2,2462,2485,-23,0,122,0,6
29351,3,2421,2299,122,0,157,0,6
29352,2,2437,2446,-9,0,122,0,6
29353,1,2423,2389,34,0,104,0,6
29354,1,2549,2565,-16,0,220,0,6
29355,1,2512,2466,46,0,406,0,6
29356,2,2666,2464,202,0,1,0,6
29357,1,2451,2338,113,0,138,0,6
29358,1,2289,2466,-177,0,246,0,6
29359,2,2318,2473,-155,0,221,0,6
29360,2,2308,2402,-94,0,120,1,6
29361,2,2457,2530,-73,0,127,0,6
29362,1,2575,2444,131,0,16,0,6
29363,1,2353,2415,-62,0,40,1,6
29364,2,2249,2426,-177,0,195,0,6
29365,1,2462,2420,42,0,125,1,6
29366,3,2228,2434,-206,0,5,0,6
29367,1,2337,2498,-161,0,319,1,6
29368,2,2444,2287,157,0,380,0,6
29369,1,2483,2348,135,0,15,0,6
29371,2,2527,2508,19,0,107,0,6
29372,2,2330,2417,-87,0,302,1,6
29373,1,2414,2437,-23,0,302,1,6
29374,1,2390,2451,-61,0,45,0,8
29375,2,2269,2442,-173,0,307,1,6
29376,2,2429,2448,-19,0,106,0,6
29377,3,2476,2575,-99,0,144,0,6
29378,2,2410,2321,89,0,152,1,6
29379,1,2674,2578,96,0,15,0,6
29380,1,2496,2555,-59,0,454,0,6
29381,3,2497,2436,61,0,45,0,6
29382,1,2436,2378,58,0,80,0,8
29383,1,2417,2413,4,0,143,0,6
29384,1,2548,2480,68,0,388,0,6
29385,1,2437,2353,84,4,254,0,13
29386,1,2485,2356,129,0,45,1,6
29387,1,2444,2398,46,0,9,1,6
29388,2,2512,2401,111,0,306,0,6
29389,2,2388,2566,-178,0,13,0,6
29390,1,2458,2231,227,0,244,0,6
29391,1,2439,2332,107,0,330,0,6
29392,1,2460,2310,150,0,21,1,6
29393,2,2490,2657,-167,0,40,0,6
29394,2,2382,2431,-49,0,201,0,6
29395,2,2453,2355,98,0,335,1,6
29396,2,2472,2678,-206,0,190,0,6
29397,1,2574,2472,102,0,122,0,6
29398,2,2404,2346,58,0,305,0,6
29399,2,2236,2573,-337,0,205,0,6
29400,1,2513,2417,96,0,45,0,6
29401,1,2320,2430,-110,0,45,0,6
29402,2,2441,2582,-141,0,301,0,6
29403,3,2410,2322,88,4,117,0,13
29404,1,2468,2376,92,0,30,0,6
29405,2,2334,2455,-121,0,10,1,6
29406,2,2589,2592,-3,0,427,0,6
29407,1,2542,2232,310,0,80,0,6
29408,1,2502,2362,140,0,345,0,6
29409,1,2379,2429,-50,0,131,0,6
29410,1,2502,2448,54,0,249,0,6
29411,2,2437,2384,53,0,386,0,6
29412,1,2380,2456,-76,0,121,0,8
29413,1,2535,2453,82,0,46,0,6
29414,2,2633,2619,14,0,45,0,6
29415,1,2569,2385,184,0,253,0,6
29416,2,2402,2295,107,0,213,0,6
29417,1,2406,2304,102,0,43,0,6
29418,1,2487,2504,-17,0,11,0,6
29419,1,2463,2322,141,0,8,0,8
29420,2,2301,2431,-130,0,15,0,6
29421,2,2365,2422,-57,0,136,0,6
29422,1,2429,2246,183,0,8,0,6
29423,2,2464,2298,166,0,8,1,8
29424,2,2415,2467,-52,0,140,1,6
29425,2,2376,2401,-25,0,46,0,6
29426,3,2403,2487,-84,0,46,0,6
29427,3,2204,2567,-363,0,404,0,6
29428,2,2436,2406,30,0,122,1,6
29429,1,2443,2332,111,0,108,0,6
29430,2,2453,2319,134,0,4,0,6
29431,1,2548,2377,171,0,106,0,6
29432,1,2345,2454,-109,0,40,1,6
29433,1,2431,2435,-4,0,226,0,6
29434,1,2514,2553,-39,0,49,1,6
29435,2,2280,2420,-140,0,101,0,6
29436,1,2478,2478,0,0,242,0,6
29438,2,2445,2328,117,0,15,1,6
29439,3,2404,2366,38,0,307,0,6
29440,1,2437,2302,135,0,205,1,6
29441,2,2395,2408,-13,0,45,0,6
29442,3,2544,2212,332,0,354,0,6
29443,2,2353,2719,-366,0,49,0,6
29444,2,2584,2625,-41,0,57,0,6
29445,2,2517,2420,97,0,15,0,6
29446,1,2458,2330,128,0,138,0,6
29448,1,2517,2278,239,0,45,0,6
29449,2,2458,2482,-24,0,311,0,6
29450,1,2521,2489,32,0,140,0,6
29451,2,2235,2403,-168,0,6,0,6
29452,1,2453,2464,-11,0,409,1,6
29453,3,2448,2539,-91,0,41,0,6
29454,2,2410,2333,77,0,485,0,6
29456,1,2589,2437,152,0,15,0,6
29457,1,2598,2551,47,0,4,0,6
29458,3,2575,2435,140,0,190,0,6
29459,1,2298,2460,-162,0,57,0,6
29460,1,2544,2252,292,0,40,0,6
29461,1,2515,2530,-15,0,110,0,6
29462,2,2444,2387,57,0,46,0,8
29463,3,2461,2388,73,0,250,0,3
29464,1,2498,2310,188,0,310,1,6
29465,2,2443,2507,-64,0,46,0,6
29466,1,2513,2486,27,0,119,1,6
29467,2,2381,2527,-146,0,101,1,6
29468,2,2390,2403,-13,0,50,0,6
29469,2,2372,2422,-50,0,45,0,6
29470,1,2427,2261,166,0,41,0,6
29471,2,2412,2468,-56,4,20,0,13
29472,2,2538,2450,88,0,255,0,6
29473,1,2252,2435,-183,0,125,0,6
29474,2,2258,2664,-406,0,304,0,6
29475,3,2426,2241,185,0,302,0,6
29476,2,2464,2426,38,0,114,0,6
29477,1,2437,2494,-57,0,130,0,6
29478,1,2401,2390,11,0,4,0,6
29479,1,2560,2493,67,0,269,1,6
29480,1,2429,2404,25,0,246,1,6
29481,3,2460,2464,-4,0,0,0,6
29482,2,2459,2438,21,0,43,0,6
29483,1,2408,2402,6,0,176,0,6
29484,1,2426,2396,30,0,485,0,6
29485,2,2666,2568,98,0,241,0,6
29486,1,2452,2444,8,0,45,0,6
29487,1,2478,2508,-30,0,301,0,6
29488,1,2401,2435,-34,0,112,0,6
29489,2,2492,2471,21,0,131,0,6
29490,2,2401,2392,9,0,110,0,6
29491,2,2498,2492,6,0,107,0,6
29492,3,2425,2427,-2,0,250,0,6
29493,2,2546,2561,-15,0,141,0,6
29494,2,2429,2429,0,0,490,0,6
29496,3,2518,2517,1,0,311,0,6
29497,2,2508,2506,2,0,103,0,6
29498,1,2545,2530,15,0,65,0,6
29499,2,2444,2454,-10,0,46,0,6
29500,1,2511,2515,-4,0,242,0,6
29502,1,2458,2461,-3,0,115,0,6
29504,2,2519,2526,-7,0,120,1,6
29505,2,2437,2432,5,0,409,1,6
29506,1,2683,2622,61,0,12,0,6
29507,2,2443,2438,5,0,311,1,6
29508,1,2590,2562,28,0,455,1,6
29509,3,2568,2608,-40,0,373,0,6
29510,1,2424,2417,7,0,120,1,6
29511,1,2608,2611,-3,0,265,0,6
29512,2,2403,2606,-203,0,190,0,6
29513,1,2438,2482,-44,0,4,0,6
29514,3,2499,2570,-71,0,211,0,6
29515,1,2391,2404,-13,0,391,0,6
29516,2,2401,2406,-5,0,122,1,6
29517,1,2490,2535,-45,0,409,0,6
29518,2,2402,2402,0,0,145,1,6
29519,2,2425,2424,1,0,112,0,6
29520,1,2429,2433,-4,0,226,0,6
29521,1,2459,2472,-13,0,400,1,6
29522,2,2599,2577,22,0,210,0,6
29523,3,2403,2419,-16,0,145,0,6
29524,2,2474,2480,-6,0,454,0,6
29525,2,2446,2488,-42,0,110,1,6
29526,3,2463,2478,-15,0,130,0,6
29527,2,2386,2401,-15,0,112,0,6
29528,2,2466,2517,-51,0,306,0,6
29529,2,2580,2573,7,0,118,0,6
29530,1,2472,2410,62,0,246,1,6
29531,3,2573,2238,335,0,133,0,6
29532,2,2368,2535,-167,0,150,0,6
29533,2,2477,2533,-56,0,45,1,6
29534,2,2396,2407,-11,0,109,0,6
29535,3,2413,2416,-3,0,145,0,6
29536,1,2451,2434,17,0,128,0,6
29537,1,2413,2469,-56,0,8,1,6
29538,2,2406,2405,1,0,315,1,6
29539,2,2342,2405,-63,0,81,1,6
29540,2,2510,2491,19,0,110,0,6
29541,2,2452,2357,95,0,3,0,6
29542,1,2470,2467,3,0,310,0,6
29543,2,2430,2353,77,0,121,1,6
29544,1,2489,2474,15,0,102,1,6
29545,2,2679,2524,155,0,210,1,6
29546,2,2572,2639,-67,0,113,0,6
29547,1,2419,2320,99,0,59,0,6
29548,1,2461,2506,-45,0,240,0,6
29549,3,2548,2212,336,0,190,0,6
29550,3,2298,2445,-147,0,167,0,6
29551,2,2462,2508,-46,0,36,0,6
29552,2,2577,2595,-18,0,46,0,6
29553,2,2561,2548,13,0,242,0,6
29554,2,2513,2472,41,0,2,0,6
29555,2,2537,2486,51,0,10,0,6
29556,1,2495,2450,45,0,395,0,6
29557,1,2381,2440,-59,0,131,1,6
29558,1,2491,2538,-47,0,9,0,6
29559,2,2488,2447,41,0,4,0,6
29560,1,2503,2460,43,0,161,1,6
29561,2,2363,2433,-70,0,140,0,6
29562,1,2418,2467,-49,0,201,1,6
29563,2,2420,2475,-55,0,5,0,6
29564,1,2691,2668,23,0,253,0,6
29565,2,2494,2557,-63,0,453,0,6
29566,2,2408,2443,-35,0,135,0,6
29567,2,2625,2665,-40,0,191,1,6
29568,1,2381,2438,-57,0,106,0,6
29569,2,2354,2419,-65,0,300,1,6
29570,1,2413,2443,-30,0,183,0,6
29571,2,2430,2477,-47,0,474,0,6
29572,2,2437,2371,66,0,106,1,6
29573,2,2416,2457,-41,0,335,0,6
29575,1,2549,2493,56,0,113,0,6
29576,2,2560,2539,21,0,116,0,6
29577,1,2279,2426,-147,0,334,1,6
29578,2,2448,2500,-52,0,11,1,6
29579,1,2303,2400,-97,0,13,0,6
29580,1,2536,2339,197,0,377,0,6
29581,1,2312,2423,-111,0,453,0,6
29582,1,2456,2332,124,0,300,0,6
29583,2,2446,2363,83,0,163,0,6
29584,1,2538,2368,170,0,454,0,6
29585,2,2517,2460,57,0,464,1,6
29586,2,2581,2612,-31,0,9,0,6
29587,2,2410,2409,1,0,250,1,6
29588,2,2509,2522,-13,0,0,0,6
29589,1,2414,2416,-2,0,240,0,6
29590,2,2379,2400,-21,0,415,1,6
29591,2,2484,2459,25,0,5,1,6
29592,1,2413,2324,89,0,0,0,6
29593,1,2317,2407,-90,0,46,0,6
29594,1,2387,2485,-98,0,39,0,6
29595,2,2414,2440,-26,0,263,0,6
29596,1,2370,2437,-67,0,147,1,6
29597,1,2568,2438,130,0,122,1,6
29598,1,2394,2525,-131,0,140,0,6
29599,2,2630,2658,-28,0,106,0,6
29600,2,2414,2492,-78,0,463,1,6
29601,2,2322,2482,-160,0,4,1,6
29602,1,2453,2409,44,0,250,0,6
29603,2,2374,2546,-172,0,100,0,6
29604,2,2232,2513,-281,0,100,0,6
29605,3,2501,2500,1,0,21,0,6
29607,3,2385,2430,-45,0,302,0,6
29608,1,2599,2584,15,0,302,0,6
29609,2,2335,2438,-103,0,40,0,6
29610,1,2403,2375,28,0,56,0,6
29611,2,2414,2389,25,0,492,0,6
29612,2,2298,2546,-248,0,113,0,6
29613,1,2374,2517,-143,0,200,1,6
29614,1,2551,2289,262,0,357,0,8
29615,2,2206,2540,-334,0,101,0,6
29616,2,2323,2443,-120,0,201,0,6
29617,1,2546,2374,172,0,21,0,6
29618,2,2512,2438,74,0,133,1,6
29619,3,2402,2232,170,0,1,0,6
29620,1,2423,2554,-131,0,469,0,6
29621,2,2346,2402,-56,0,110,1,6
29622,1,2488,2229,259,0,4,0,6
29623,3,2448,2549,-101,0,4,0,6
29624,1,2444,2507,-63,0,106,0,6
29625,2,2274,2439,-165,0,45,0,6
29626,1,2499,2460,39,0,7,0,6
29627,1,2389,2420,-31,0,56,1,6
29628,1,2586,2263,323,0,85,0,6
29629,1,2521,2436,85,0,200,0,6
29630,1,2468,2459,9,0,2,0,6
29631,3,2402,2388,14,0,476,0,6
29632,2,2458,2444,14,0,108,0,6
29633,1,2405,2234,171,4,320,0,13
29634,1,2403,2323,80,0,139,0,6
29635,1,2483,2302,181,0,195,0,6
29636,1,2524,2389,135,0,310,0,6
29637,1,2400,2345,55,0,112,1,6
29638,2,2567,2550,17,0,172,1,6
29639,1,2460,2284,176,0,43,0,6
29640,2,2663,2625,38,0,1,0,6
29641,1,2436,2339,97,0,46,0,6
29642,1,2466,2221,245,0,200,1,6
29643,1,2424,2465,-41,0,269,0,6
29644,2,2259,2500,-241,0,40,0,6
29645,1,2509,2445,64,0,236,0,6
29646,2,2438,2490,-52,0,302,0,6
29647,3,2507,2415,92,0,2,0,6
29648,1,2254,2452,-198,0,20,0,6
29649,2,2479,2480,-1,0,123,0,6
29650,1,2496,2419,77,0,190,1,6
29651,1,2530,2470,60,0,145,0,6
29652,2,2433,2457,-24,0,16,0,6
29653,2,2240,2665,-425,0,49,0,6
29654,1,2424,2373,51,0,106,0,6
29655,3,2467,2456,11,0,200,0,8
29656,1,2434,2501,-67,0,45,0,6
29657,1,2403,2226,177,0,52,0,6
29658,3,2424,2334,90,0,242,0,6
29659,1,2541,2286,255,0,330,0,6
29660,2,2413,2482,-69,0,13,1,6
29661,2,2315,2434,-119,0,350,1,8
29662,2,2502,2659,-157,0,300,0,6
29663,3,2575,2485,90,0,200,0,6
29664,3,2444,2386,58,0,474,0,6
29665,2,2320,2482,-162,0,123,0,6
29666,1,2435,2207,228,0,7,0,6
29667,2,2327,2424,-97,0,380,0,6
29668,2,2345,2444,-99,0,115,1,6
29669,1,2310,2565,-255,0,101,1,6
29670,2,2484,2519,-35,0,215,1,6
29671,1,2555,2500,55,0,122,0,6
29672,2,2469,2320,149,0,365,0,6
29673,2,2508,2487,21,0,34,0,6
29674,2,2371,2438,-67,0,345,0,6
29675,2,2432,2377,55,0,0,1,6
29676,2,2367,2525,-158,0,300,0,6
29677,1,2480,2603,-123,0,409,0,6
29678,1,2478,2278,200,0,369,0,6
29679,1,2513,2489,24,0,123,1,6
29680,1,2461,2277,184,0,102,0,6
29681,2,2255,2430,-175,0,302,0,6
29682,2,2493,2343,150,0,43,0,6
29683,2,2315,2425,-110,0,198,0,6
29684,1,2531,2287,244,0,13,0,6
29685,2,2220,2529,-309,0,253,0,6
29686,1,2332,2412,-80,0,107,0,6
29687,1,2427,2509,-82,0,85,0,6
29688,1,2443,2261,182,0,106,0,6
29689,1,2458,2350,108,0,45,1,6
29690,3,2450,2457,-7,0,354,0,6
29691,1,2339,2460,-121,0,18,0,6
29692,2,2541,2423,118,0,113,0,6
29693,1,2567,2378,189,0,122,0,6
29694,1,2429,2409,20,0,378,1,6
29695,2,2306,2618,-312,0,110,0,6
29696,1,2506,2424,82,0,107,0,6
29697,2,2412,2504,-92,0,389,0,8
29698,1,2290,2453,-163,0,4,0,6
29699,1,2446,2429,17,0,230,0,6
29700,2,2455,2341,114,0,161,0,6
29701,1,2490,2238,252,0,484,0,6
29702,1,2508,2398,110,0,102,0,6
29703,1,2268,2456,-188,0,56,0,6
29704,2,2395,2403,-8,0,405,0,6
29705,3,2443,2431,12,0,110,0,6
29706,1,2419,2353,66,0,101,0,6
29707,2,2421,2554,-133,0,37,1,6
29708,1,2418,2394,24,0,40,0,6
29709,2,2405,2476,-71,0,484,1,6
29710,1,2427,2317,110,0,16,0,6
29711,3,2518,2428,90,0,406,0,6
29712,2,2217,2482,-265,0,200,0,6
29713,1,2455,2486,-31,0,106,0,6
29714,2,2464,2377,87,0,157,1,6
29715,1,2455,2222,233,0,121,0,6
29716,1,2360,2690,-330,0,115,0,6
29717,2,2407,2257,150,0,315,0,6
29718,2,2503,2352,151,0,120,0,6
29719,1,2441,2348,93,0,110,0,6
29720,2,2493,2580,-87,0,300,1,6
29721,2,2203,2526,-323,0,41,0,6
29722,1,2412,2291,121,0,307,0,6
29723,1,2398,2411,-13,0,310,0,6
29724,2,2249,2545,-296,0,43,0,6
29725,1,2580,2284,296,0,484,1,6
29726,1,2408,2330,78,0,30,0,6
29727,1,2275,2460,-185,0,487,0,6
29728,2,2406,2280,126,0,200,0,6
29729,2,2464,2275,189,0,250,0,6
29730,2,2336,2404,-68,0,398,1,6
29731,1,2424,2295,129,0,110,0,6
29732,2,2404,2705,-301,0,141,0,6
29733,2,2434,2531,-97,0,118,0,6
29734,2,2523,2413,110,0,46,0,6
29735,1,2584,2497,87,0,4,1,6
29736,2,2251,2427,-176,0,121,0,6
29737,3,2411,2336,75,0,300,0,6
29738,2,2416,2472,-56,0,483,0,6
29739,1,2438,2238,200,0,200,0,6
29740,1,2376,2483,-107,0,20,0,6
29741,2,2514,2371,143,0,246,0,6
29742,2,2441,2262,179,0,227,0,6
29743,2,2366,2501,-135,0,40,0,6
29744,2,2489,2570,-81,0,5,1,6
29745,1,2513,2532,-19,0,300,0,6
29746,2,2596,2614,-18,0,315,0,6
29747,2,2260,2400,-140,0,190,1,6
29748,2,2546,2423,123,0,4,0,6
29749,2,2438,2396,42,0,48,0,8
29750,1,2267,2522,-255,0,27,1,6
29751,3,2310,2406,-96,0,110,0,6
29752,1,2500,2229,271,0,201,0,6
29753,2,2423,2263,160,0,404,0,6
29754,1,2485,2497,-12,0,200,0,6
29755,2,2411,2402,9,0,103,0,6
29756,3,2411,2350,61,0,52,0,6
29757,1,2463,2389,74,0,247,0,6
29758,2,2421,2334,87,0,112,0,6
29759,1,2459,2395,64,0,400,0,6
29760,1,2505,2224,281,0,310,0,6
29761,2,2339,2510,-171,0,330,0,6
29762,1,2467,2345,122,0,8,0,6
29763,2,2407,2569,-162,0,202,0,6
29764,1,2532,2202,330,0,455,1,6
29765,1,2294,2438,-144,0,40,1,6
29766,1,2607,2378,229,0,103,0,6
29767,1,2527,2347,180,0,245,0,6
29768,2,2410,2404,6,0,210,0,6
29769,3,2415,2420,-5,0,373,0,6
29770,2,2275,2430,-155,0,310,1,6
29771,1,2428,2307,121,0,153,0,6
29772,2,2346,2440,-94,0,45,1,6
29773,1,2408,2387,21,0,207,1,6
29774,1,2394,2596,-202,0,49,0,6
29775,3,2249,2570,-321,0,200,0,6
29776,2,2462,2620,-158,0,256,0,6
29777,1,2616,2235,381,0,487,1,6
29778,2,2464,2209,255,0,251,1,6
29779,2,2409,2529,-120,0,483,0,6
29780,2,2259,2610,-351,0,190,1,6
29781,1,2468,2262,206,0,246,1,6
29782,1,2438,2377,61,0,120,0,6
29783,2,2430,2495,-65,0,244,1,6
29784,1,2443,2294,149,0,4,0,6
29785,1,2478,2217,261,0,46,0,6
29786,3,2327,2463,-136,0,113,0,6
29787,1,2442,2489,-47,0,204,0,6
29788,1,2548,2350,198,0,45,1,6
29789,2,2495,2432,63,0,43,0,6
29790,1,2416,2354,62,0,255,1,6
29791,1,2442,2438,4,0,15,0,6
29792,1,2433,2311,122,0,48,0,6
29793,3,2578,2451,127,0,15,0,6
29794,2,2505,2720,-215,0,13,0,6
29795,3,2585,2388,197,0,400,0,6
29796,1,2454,2317,137,0,331,0,6
29797,1,2449,2473,-24,0,134,0,6
29798,2,2375,2463,-88,0,427,1,6
29799,2,2657,2850,-193,0,1,0,6
29800,3,2547,2316,231,0,201,0,6
29801,2,2485,2492,-7,0,112,0,6
29802,2,2400,2473,-73,0,302,0,6
29803,2,2307,2435,-128,0,30,1,6
29804,1,2535,2455,80,0,4,0,6
29805,1,2448,2306,142,0,150,0,6
29806,1,2225,2401,-176,0,218,1,6
29807,2,2373,2430,-57,0,253,0,6
29808,2,2518,2360,158,0,0,0,6
29809,1,2443,2321,122,0,104,0,6
29810,1,2450,2394,56,0,301,0,6
29811,1,2515,2360,155,0,302,0,6
29812,1,2451,2308,143,0,200,0,6
29813,1,2382,2480,-98,0,131,1,6
29814,2,2334,2423,-89,0,101,0,6
29815,1,2494,2468,26,0,110,1,6
29816,2,2477,2313,164,0,4,0,6
29817,2,2445,2505,-60,0,46,0,6
29818,2,2211,2418,-207,0,106,0,6
29819,2,2607,2535,72,0,101,0,6
29820,3,2491,2402,89,0,200,0,6
29821,1,2707,2491,216,0,46,0,6
29822,3,2430,2513,-83,0,154,0,6
29823,2,2437,2320,117,0,48,0,6
29824,2,2252,2570,-318,0,1,0,6
29825,1,2375,2428,-53,0,15,1,6
29826,1,2401,2407,-6,4,301,0,13
29827,3,2465,2603,-138,0,112,0,6
29828,2,2467,2471,-4,0,331,1,6
29829,2,2400,2452,-52,0,248,0,6
29830,1,2539,2230,309,0,354,0,6
29831,1,2657,2526,131,0,45,0,6
29832,1,2528,2364,164,0,10,0,6
29833,2,2662,2202,460,0,144,1,6
29834,2,2280,2439,-159,0,483,0,6
29835,1,2412,2394,18,0,106,0,6
29836,2,2404,2533,-129,0,140,0,6
29837,1,2376,2477,-101,0,115,1,6
29838,2,2620,2504,116,0,300,0,6
29839,1,2671,2406,265,0,222,0,6
29840,1,2473,2263,210,0,125,1,6
29841,1,2450,2446,4,0,4,0,6
29842,1,2560,2391,169,0,8,0,6
29843,2,2232,2448,-216,0,127,1,6
29844,3,2466,2457,9,0,300,0,6
29845,1,2500,2344,156,0,31,0,6
29846,2,2342,2504,-162,0,201,0,6
29847,1,2437,2380,57,0,133,1,6
29848,1,2574,2567,7,0,112,0,6
29849,2,2209,2440,-231,0,123,0,6
29850,1,2400,2476,-76,0,269,1,6
29851,2,2381,2479,-98,0,1,0,6
29852,2,2498,2206,292,0,46,0,6
29853,1,2487,2277,210,0,130,0,6
29854,3,2452,2273,179,0,311,0,6
29855,2,2285,2404,-119,0,373,1,6
29856,2,2261,2488,-227,0,145,0,6
29857,2,2431,2229,202,0,404,1,6
29858,1,2409,2424,-15,0,145,0,6
29859,2,2478,2213,265,0,4,0,6
29860,2,2368,2443,-75,0,45,0,6
29861,1,2537,2217,320,0,210,0,6
29862,1,2485,2237,248,0,110,0,6
29863,1,2428,2252,176,0,192,0,6
29864,1,2568,2204,364,0,106,0,6
29865,1,2384,2455,-71,0,8,0,6
29866,2,2306,2486,-180,0,66,0,6
29867,1,2290,2441,-151,0,46,1,6
29868,2,2296,2422,-126,0,263,0,6
29869,1,2757,2457,300,0,145,0,6
29870,1,2514,2350,164,0,120,0,6
29871,1,2425,2256,169,0,0,0,6
29872,1,2572,2404,168,0,150,0,6
29873,2,2284,2413,-129,0,40,1,6
29874,1,2499,2416,83,0,41,0,6
29875,1,2202,2405,-203,0,103,1,6
29876,3,2432,2443,-11,0,125,0,6
29877,1,2369,2448,-79,0,4,1,6
29878,1,2441,2539,-98,0,301,0,6
29879,2,2275,2426,-151,0,123,0,6
29880,2,2404,2301,103,0,103,0,6
29881,2,2387,2405,-18,0,105,0,6
29882,1,2439,2428,11,0,344,0,6
29883,3,2360,2506,-146,0,307,0,6
29884,1,2528,2519,9,0,40,0,6
29885,1,2296,2484,-188,0,100,0,6
29886,1,2639,2287,352,0,4,0,6
29887,2,2336,2439,-103,4,455,0,13
29888,1,2467,2383,84,0,13,0,6
29889,1,2539,2202,337,0,278,0,6
29890,1,2352,2477,-125,0,106,0,6
29891,3,2434,2359,75,0,308,0,6
29892,1,2528,2377,151,0,201,0,6
29893,1,2308,2400,-92,0,100,0,6
29894,1,2476,2446,30,0,89,0,6
29895,3,2424,2202,222,0,246,0,6
29896,1,2517,2544,-27,0,300,0,6
29897,2,2313,2401,-88,0,48,0,6
29898,2,2232,2446,-214,0,80,0,6
29899,1,2410,2233,177,0,300,0,6
29900,2,2513,2341,172,0,110,1,6
29901,1,2404,2336,68,0,365,0,6
29902,1,2431,2435,-4,0,200,0,6
29903,1,2431,2557,-126,0,41,0,6
29904,2,2234,2533,-299,0,46,0,6
29905,1,2573,2624,-51,0,289,0,6
29906,1,2244,2410,-166,0,123,0,6
29907,1,2563,2560,3,0,325,1,6
29908,2,2464,2450,14,0,122,0,6
29909,1,2451,2284,167,0,461,1,6
29910,1,2436,2446,-10,0,138,0,6
29911,2,2654,2479,175,0,16,0,6
29912,2,2467,2386,81,0,153,0,6
29913,1,2423,2435,-12,0,145,0,6
29914,1,2515,2278,237,0,46,0,6
29915,1,2315,2515,-200,0,409,0,6
29916,2,2236,2446,-210,0,200,1,6
29917,2,2317,2405,-88,0,0,0,6
29918,1,2722,2449,273,0,7,0,6
29919,2,2572,2502,70,0,107,1,6
29920,1,2430,2590,-160,0,113,0,6
29921,3,2316,2516,-200,0,415,0,6
29922,2,2467,2403,64,0,3,0,6
29923,1,2491,2455,36,0,47,0,6
29924,1,2446,2238,208,0,106,0,6
29925,1,2510,2301,209,0,302,1,8
29926,1,2419,2317,102,0,490,0,6
29927,1,2481,2401,80,0,111,1,6
29928,2,2253,2408,-155,0,320,0,6
29929,1,2565,2416,149,0,380,0,6
29930,1,2409,2207,202,0,213,0,6
29931,2,2489,2709,-220,0,420,0,6
29932,1,2484,2410,74,0,34,0,6
29933,1,2489,2230,259,0,4,0,6
29934,2,2235,2457,-222,0,335,0,6
29935,2,2524,2556,-32,0,245,0,6
29936,1,2452,2404,48,0,143,1,6
29937,2,2360,2447,-87,0,253,0,6
29938,2,2444,2220,224,0,10,1,6
29939,1,2431,2275,156,0,100,0,6
29940,1,2588,2617,-29,0,4,1,6
29941,1,2428,2380,48,0,48,0,6
29942,2,2456,2357,99,0,0,0,8
29943,1,2410,2369,41,0,326,0,6
29944,3,2439,2489,-50,0,43,0,6
29945,2,2403,2510,-107,0,17,1,6
29946,2,2223,2540,-317,0,123,1,6
29947,2,2527,2607,-80,0,247,0,6
29948,1,2388,2480,-92,0,48,1,6
29949,1,2429,2320,109,0,200,0,6
29950,1,2484,2355,129,0,31,0,6
29951,1,2619,2326,293,0,278,0,6
29952,1,2436,2573,-137,0,45,1,6
29953,2,2368,2429,-61,0,302,1,6
29954,1,2498,2490,8,0,4,0,6
29955,1,2328,2467,-139,0,212,0,6
29956,3,2368,2466,-98,0,41,0,8
29957,2,2431,2431,0,0,277,1,6
29958,1,2433,2313,120,0,112,0,6
29959,2,2250,2408,-158,0,150,0,6
29960,2,2276,2583,-307,0,16,1,6
29961,1,2513,2253,260,0,106,0,6
29962,1,2491,2558,-67,0,40,0,6
29963,2,2313,2457,-144,0,45,0,6
29964,2,2392,2413,-21,0,45,0,6
29965,3,2510,2441,69,0,130,0,6
29966,1,2344,2449,-105,0,405,1,6
29967,1,2482,2530,-48,0,125,0,6
29968,1,2382,2447,-65,0,40,1,6
29969,1,2611,2484,127,0,45,0,6
29971,2,2420,2285,135,0,106,0,6
29972,1,2410,2215,195,0,126,0,6
29973,2,2479,2449,30,0,106,0,6
29974,2,2236,2501,-265,0,221,1,6
29975,1,2405,2278,127,4,56,1,13
29976,1,2554,2535,19,0,116,0,6
29977,1,2534,2283,251,0,31,0,6
29978,1,2417,2352,65,0,43,0,6
29979,1,2602,2431,171,0,200,0,6
29980,1,2511,2395,116,0,118,0,6
29981,2,2409,2308,101,0,103,0,6
29982,1,2445,2325,120,0,115,0,6
29983,2,2415,2291,124,0,4,1,6
29984,2,2201,2564,-363,0,106,0,6
29985,1,2533,2443,90,0,455,0,6
29986,3,2430,2256,174,0,49,0,6
29987,2,2476,2372,104,0,120,1,6
29988,2,2322,2497,-175,0,40,1,6
29989,1,2469,2206,263,0,265,0,6
29990,2,2281,2517,-236,0,202,0,6
29991,1,2256,2420,-164,0,223,0,6
29992,2,2490,2522,-32,0,245,0,5
29993,1,2548,2357,191,0,244,0,6
29994,1,2542,2532,10,0,195,0,6
29995,1,2577,2343,234,0,13,0,6
29996,2,2317,2415,-98,0,245,0,6
29997,1,2463,2235,228,0,125,1,6
29998,2,2610,2534,76,0,151,0,6
29999,1,2463,2459,4,0,111,0,6
30000,1,2513,2385,128,0,48,1,6
30001,2,2284,2471,-187,0,22,0,6
30002,2,2406,2312,94,0,394,1,6
30003,1,2514,2480,34,0,45,0,6
30004,1,2448,2345,103,0,40,0,6
30005,2,2460,2510,-50,0,143,0,6
30006,1,2431,2391,40,0,101,0,6
30007,1,2611,2288,323,0,457,0,6
30008,2,2454,2440,14,0,106,1,6
30009,1,2444,2365,79,0,166,1,6
30010,2,2381,2433,-52,0,245,0,6
30011,2,2214,2579,-365,0,306,0,6
30012,2,2202,2561,-359,0,49,1,6
30013,3,2497,2397,100,0,0,0,8
30014,1,2311,2406,-95,0,107,0,6
30015,1,2576,2496,80,0,10,1,6
30016,2,2286,2409,-123,0,6,0,6
30017,2,2305,2469,-164,0,110,1,6
30018,1,2633,2426,207,0,140,0,6
30020,1,2724,2557,167,0,7,1,6
30021,3,2474,2569,-95,0,175,0,6
30022,1,2502,2434,68,0,310,0,6
30023,1,2476,2476,0,0,4,0,6
30024,3,2338,2421,-83,0,15,0,6
30025,1,2456,2451,5,0,106,0,6
30026,1,2457,2474,-17,0,409,0,6
30027,2,2365,2445,-80,0,16,0,6
30028,2,2455,2265,190,0,4,0,6
30029,2,2323,2432,-109,0,43,0,6
30030,2,2505,2759,-254,0,107,0,6
30031,2,2503,2430,73,0,200,0,6
30032,1,2456,2514,-58,0,121,0,6
30033,2,2442,2437,5,0,46,1,6
30034,3,2522,2532,-10,0,260,0,6
30035,2,2439,2326,113,0,241,0,6
30036,2,2342,2531,-189,0,106,0,6
30037,2,2352,2487,-135,0,394,0,6
30038,1,2313,2428,-115,0,13,0,6
30039,1,2429,2341,88,0,265,0,6
30040,3,2549,2426,123,0,337,0,6
30041,1,2575,2475,100,0,142,0,6
30042,2,2201,2565,-364,0,448,0,6
30043,2,2382,2676,-294,0,9,0,6
30044,2,2601,2600,1,0,4,0,6
30045,2,2404,2484,-80,0,40,0,6
30046,3,2291,2515,-224,0,4,0,6
30047,2,2295,2444,-149,0,267,0,6
30048,2,2247,2480,-233,0,210,0,6
30049,2,2246,2408,-162,0,100,0,6
30050,1,2448,2389,59,0,134,0,6
30051,1,2409,2284,125,0,15,0,6
30052,3,2318,2543,-225,0,211,0,6
30053,1,2468,2217,251,0,4,0,6
30054,2,2250,2423,-173,0,47,0,6
30055,2,2411,2365,46,0,125,0,6
30056,1,2620,2363,257,0,205,0,6
30057,1,2367,2442,-75,0,48,0,6
30058,2,2375,2421,-46,0,33,1,6
30059,1,2580,2395,185,0,107,0,6
30060,1,2485,2251,234,0,306,0,6
30061,2,2617,2438,179,0,145,0,6
30062,2,2422,2673,-251,0,474,0,6
30063,2,2313,2487,-174,0,210,0,6
30064,2,2255,2407,-152,0,80,0,6
30065,2,2664,2444,220,0,4,0,6
30066,1,2473,2449,24,0,122,0,6
30067,2,2490,2303,187,4,300,0,13
30068,1,2379,2472,-93,0,45,0,6
30069,1,2412,2372,40,0,8,0,6
30070,1,2652,2212,440,0,106,0,6
30071,1,2437,2488,-51,0,201,0,6
30072,1,2537,2550,-13,0,40,0,6
30073,2,2249,2524,-275,0,115,0,6
30074,1,2290,2525,-235,0,395,1,6
30075,1,2483,2513,-30,0,0,0,6
30076,3,2332,2475,-143,0,0,0,6
30077,2,2632,2585,47,0,106,0,6
30078,2,2306,2449,-143,0,100,0,8
30079,2,2421,2574,-153,0,112,0,6
30080,2,2317,2565,-248,0,57,0,6
30081,1,2540,2434,106,0,45,0,6
30082,1,2444,2404,40,0,212,0,6
30083,2,2444,2487,-43,0,121,1,6
30084,2,2461,2468,-7,0,20,0,6
30085,2,2409,2551,-142,0,43,0,6
30086,1,2295,2417,-122,0,203,0,6
30087,1,2455,2281,174,0,21,0,6
30088,1,2438,2336,102,0,335,1,6
30089,1,2510,2405,105,0,300,1,6
30090,1,2373,2508,-135,0,2,0,6
30091,2,2299,2419,-120,0,7,1,6
30092,3,2345,2517,-172,0,100,0,6
30093,1,2222,2443,-221,0,110,1,6
30094,1,2408,2258,150,0,456,0,6
30095,3,2334,2433,-99,0,101,0,6
30096,2,2420,2520,-100,0,38,0,6
30097,1,2272,2416,-144,0,125,0,6
30098,2,2220,2613,-393,0,120,0,6
30099,2,2228,2415,-187,0,415,0,6
30100,3,2501,2412,89,0,288,0,6
30101,2,2425,2615,-190,0,345,0,6
30102,1,2212,2401,-189,0,41,1,6
30103,2,2408,2274,134,0,320,0,6
30104,1,2404,2370,34,0,267,0,6
30105,2,2409,2359,50,0,7,1,6
30106,1,2413,2401,12,0,57,0,6
30107,3,2565,2502,63,0,7,0,6
30108,1,2361,2410,-49,0,20,0,6
30109,2,2239,2442,-203,0,456,0,6
30110,1,2471,2277,194,0,200,0,6
30111,1,2222,2445,-223,0,121,0,6
30112,1,2429,2461,-32,0,81,0,6
30113,1,2491,2435,56,0,12,0,6
30114,2,2314,2460,-146,0,353,0,6
30115,1,2402,2605,-203,0,115,0,6
30116,1,2428,2508,-80,0,241,0,6
30117,2,2315,2567,-252,0,58,0,6
30118,1,2488,2341,147,0,110,0,6
30119,1,2201,2452,-251,0,107,0,6
30120,1,2399,2409,-10,0,56,0,6
30121,3,2402,2305,97,0,120,0,6
30122,1,2419,2302,117,0,203,0,6
30123,2,2242,2464,-222,0,0,0,6
30124,2,2468,2414,54,0,373,0,6
30125,1,2463,2202,261,0,380,0,6
30126,2,2220,2457,-237,0,211,0,6
30127,2,2493,2405,88,0,456,1,6
30128,1,2450,2278,172,0,142,0,6
30129,2,2216,2455,-239,0,40,0,6
30130,2,2310,2587,-277,0,101,1,6
30131,3,2258,2469,-211,0,101,0,6
30132,1,2426,2487,-61,0,311,0,6
30133,1,2647,2485,162,0,218,1,5
30134,2,2555,2320,235,0,113,0,6
30135,2,2275,2487,-212,0,121,0,6
30136,1,2402,2578,-176,0,112,0,6
30137,1,2545,2249,296,0,122,1,6
30138,2,2505,2568,-63,0,330,0,6
30139,1,2524,2221,303,0,254,0,6
30140,1,2542,2303,239,0,203,0,6
30141,1,2410,2374,36,0,145,0,6
30142,1,2252,2413,-161,0,40,1,6
30143,1,2534,2504,30,0,18,0,6
30144,1,2272,2435,-163,0,300,0,6
30145,1,2761,2394,367,0,112,0,6
30146,2,2340,2502,-162,0,253,1,6
30147,1,2611,2373,238,0,15,0,6
30148,3,2366,2569,-203,0,300,0,6
30149,1,2360,2477,-117,0,331,0,6
30150,2,2405,2288,117,0,123,0,6
30151,2,2324,2455,-131,0,110,1,6
30152,2,2509,2350,159,0,45,1,6
30153,2,2399,2482,-83,0,190,0,6
30154,1,2537,2449,88,0,405,0,6
30155,3,2487,2609,-122,0,404,0,6
30156,1,2470,2447,23,0,140,0,6
30157,2,2231,2475,-244,0,302,0,6
30158,2,2218,2489,-271,0,7,1,6
30159,1,2551,2448,103,0,34,0,6
30160,3,2411,2301,110,0,300,0,6
30161,1,2498,2429,69,0,312,1,6
30162,1,2444,2466,-22,0,244,0,6
30163,1,2381,2489,-108,0,101,0,6
30164,2,2505,2620,-115,0,190,0,6
30165,2,2566,2517,49,0,461,1,6
30166,2,2454,2523,-69,0,123,0,6
30167,2,2302,2506,-204,0,123,0,6
30168,2,2365,2636,-271,0,415,0,6
30169,1,2287,2458,-171,0,207,1,6
30170,1,2538,2313,225,0,483,0,6
30171,1,2400,2252,148,0,302,1,6
30172,3,2398,2400,-2,0,22,0,6
30173,3,2653,2403,250,0,190,0,6
30174,2,2330,2407,-77,4,113,0,13
30175,2,2453,2336,117,0,378,0,6
30176,2,2337,2712,-375,0,43,0,6
30177,1,2675,2487,188,0,4,0,6
30178,2,2209,2583,-374,0,124,0,6
30179,2,2392,2449,-57,0,302,0,6
30180,2,2420,2444,-24,0,365,0,6
30181,1,2537,2655,-118,0,14,0,6
30182,1,2354,2557,-203,0,45,0,6
30183,1,2445,2385,60,0,106,0,6
30184,2,2339,2463,-124,0,43,0,6
30185,1,2385,2409,-24,0,45,0,6
30186,2,2278,2441,-163,0,106,0,6
30187,2,2436,2393,43,0,156,1,6
30188,2,2338,2426,-88,0,46,0,6
30189,2,2489,2255,234,0,180,0,6
30190,3,2585,2540,45,0,14,0,6
30191,1,2393,2486,-93,0,200,0,6
30192,1,2454,2256,198,0,115,0,6
30193,1,2422,2370,52,0,432,0,6
30194,2,2579,2510,69,0,203,0,6
30195,2,2366,2762,-396,0,309,0,6
30196,2,2209,2469,-260,0,474,0,6
30197,1,2400,2398,2,0,351,0,6
30198,1,2453,2494,-41,0,46,1,6
30199,2,2291,2407,-116,0,240,1,6
30201,1,2464,2386,78,0,13,0,6
30202,1,2443,2214,229,0,47,0,6
30203,2,2562,2581,-19,0,241,0,6
30204,3,2530,2200,330,0,45,0,6
30205,2,2544,2560,-16,0,300,1,6
30206,1,2467,2392,75,0,102,1,6
30207,3,2430,2270,160,0,48,0,6
30208,2,2343,2455,-112,0,45,0,6
30209,1,2441,2346,95,0,207,0,6
30210,1,2425,2304,121,0,335,0,6
30211,1,2436,2424,12,0,110,0,6
30212,2,2595,2595,0,0,4,0,6
30213,3,2441,2455,-14,0,30,0,6
30214,1,2510,2538,-28,0,8,0,6
30215,2,2439,2434,5,0,5,0,6
30216,1,2412,2273,139,0,296,0,6
30217,1,2357,2413,-56,0,10,0,6
30218,2,2273,2414,-141,0,303,0,6
30219,3,2277,2468,-191,0,112,0,6
30220,1,2212,2512,-300,0,112,0,6
30221,2,2473,2595,-122,0,112,0,6
30222,1,2444,2406,38,0,148,0,6
30223,2,2501,2570,-69,0,2,0,6
30224,1,2478,2435,43,0,215,0,6
30225,1,2483,2376,107,0,270,0,6
30226,1,2446,2500,-54,0,110,1,6
30227,1,2564,2538,26,0,106,0,6
30228,1,2418,2376,42,0,118,0,6
30229,1,2405,2246,159,0,0,0,6
30230,2,2267,2434,-167,0,2,0,6
30231,2,2420,2442,-22,0,152,0,6
30232,2,2441,2436,5,0,200,0,6
30233,2,2541,2728,-187,0,331,0,6
30234,1,2554,2250,304,0,414,0,6
30235,2,2201,2603,-402,0,375,0,6
30236,3,2443,2303,140,0,111,0,6
30237,1,2460,2377,83,0,202,0,6
30238,1,2568,2315,253,0,201,0,6
30239,1,2479,2512,-33,0,308,0,6
30240,2,2294,2436,-142,0,9,1,6
30241,1,2411,2254,157,0,142,1,6
30242,1,2525,2386,139,0,4,0,6
30243,1,2375,2474,-99,0,20,1,6
30244,1,2452,2486,-34,0,302,0,6
30245,1,2532,2522,10,0,122,0,6
30246,2,2454,2268,186,0,301,1,6
30247,1,2412,2216,196,0,310,0,6
30248,1,2271,2418,-147,0,40,0,6
30249,1,2619,2267,352,0,45,0,6
30250,2,2339,2580,-241,0,414,0,6
30251,1,2509,2428,81,0,115,0,6
30252,2,2412,2339,73,0,15,0,6
30253,2,2389,2444,-55,0,297,0,6
30254,2,2231,2548,-317,0,41,0,6
30255,2,2262,2444,-182,0,315,0,6
30256,2,2481,2360,121,0,80,0,6
30257,2,2413,2451,-38,0,4,1,6
30258,2,2281,2545,-264,0,127,1,6
30259,2,2420,2271,149,0,127,1,6
30260,1,2438,2246,192,0,250,0,6
30261,2,2358,2517,-159,0,100,1,6
30262,1,2476,2311,165,0,102,0,6
30263,1,2569,2545,24,0,80,1,6
30264,2,2354,2463,-109,0,131,1,6
30265,1,2647,2313,334,0,455,0,6
30266,1,2656,2208,448,0,11,0,6
30267,2,2227,2417,-190,0,106,0,6
30268,2,2258,2589,-331,0,107,0,6
30269,2,2400,2388,12,0,160,0,6
30270,2,2437,2351,86,0,40,1,6
30271,2,2482,2411,71,0,0,0,6
30272,1,2453,2462,-9,0,207,0,6
30273,2,2579,2527,52,0,474,0,6
30274,2,2280,2409,-129,4,245,0,13
30275,1,2614,2207,407,0,109,0,6
30276,1,2462,2426,36,0,50,0,6
30277,1,2369,2441,-72,0,217,0,6
30278,2,2239,2475,-236,0,46,0,6
30279,2,2317,2490,-173,0,123,0,6
30280,1,2501,2299,202,0,6,0,6
30281,1,2573,2387,186,0,344,0,6
30282,1,2423,2471,-48,0,203,1,6
30283,1,2455,2335,120,0,454,0,6
30284,3,2564,2398,166,0,4,0,6
30285,2,2201,2462,-261,0,140,1,6
30286,2,2263,2661,-398,0,153,0,6
30287,1,2548,2435,113,0,133,0,6
30288,1,2450,2230,220,0,277,1,6
30289,2,2265,2557,-292,0,46,0,6
30290,2,2586,2223,363,0,244,0,6
30291,1,2408,2564,-156,0,337,0,6
30292,1,2455,2431,24,0,2,0,6
30293,1,2501,2364,137,0,330,0,6
30294,2,2265,2482,-217,0,4,0,6
30295,1,2300,2549,-249,0,5,0,6
30296,2,2318,2461,-143,0,110,0,6
30297,1,2416,2203,213,0,337,0,6
30298,1,2489,2443,46,0,10,0,6
30299,1,2454,2211,243,0,40,0,6
30300,2,2431,2437,-6,0,265,0,6
30301,2,2375,2465,-90,0,107,0,8
30302,2,2382,2469,-87,0,45,0,6
30303,2,2413,2386,27,0,122,1,6
30304,1,2435,2209,226,0,130,0,6
30305,2,2440,2523,-83,0,100,0,6
30306,1,2361,2433,-72,0,120,0,6
30307,2,2503,2556,-53,0,11,0,6
30308,2,2624,2560,64,0,211,1,6
30309,1,2543,2214,329,0,210,1,6
30311,2,2212,2543,-331,0,9,0,6
30312,1,2478,2355,123,0,295,0,6
30313,1,2540,2649,-109,0,25,0,6
30314,2,2504,2506,-2,0,120,0,6
30315,2,2396,2607,-211,0,245,0,6
30316,1,2312,2490,-178,0,398,0,6
30317,2,2436,2415,21,0,0,1,6
30318,1,2449,2411,38,0,456,1,6
30319,2,2417,2405,12,0,5,1,6
30320,1,2597,2649,-52,0,123,0,6
30321,1,2592,2625,-33,0,57,0,6
30322,1,2408,2508,-100,0,203,1,6
30323,1,2418,2374,44,0,55,0,6
30325,1,2466,2383,83,0,400,0,6
30326,2,2287,2582,-295,0,13,1,6
30327,1,2236,2501,-265,0,302,1,6
30328,2,2516,2347,169,0,107,0,6
30329,2,2295,2520,-225,0,46,1,6
30330,1,2239,2446,-207,0,46,0,6
30331,1,2466,2436,30,0,45,0,6
30332,1,2583,2620,-37,0,6,0,6
30333,2,2548,2344,204,0,201,0,6
30334,3,2403,2492,-89,0,10,0,6
30335,1,2483,2479,4,0,122,0,6
30336,1,2430,2308,122,0,102,0,6
30337,1,2336,2439,-103,0,44,0,6
30338,3,2408,2378,30,0,303,0,6
30339,2,2408,2459,-51,0,0,0,6
30340,3,2460,2334,126,0,113,0,6
30341,1,2431,2442,-11,0,10,0,6
30342,1,2514,2338,176,0,106,0,6
30343,3,2450,2363,87,0,100,0,6
30344,1,2509,2439,70,0,45,0,6
30345,1,2408,2299,109,0,5,0,6
30346,1,2420,2283,137,0,49,0,6
30347,3,2527,2475,52,0,103,0,6
30348,2,2449,2383,66,0,0,0,6
30349,2,2638,2465,173,0,205,0,6
30350,1,2404,2305,99,0,50,0,6
30351,1,2541,2237,304,0,40,0,6
30352,1,2418,2271,147,0,49,0,6
30353,1,2542,2343,199,0,8,0,6
30354,1,2423,2334,89,0,4,1,6
30355,1,2713,2395,318,0,215,0,6
30356,2,2388,2526,-138,0,114,1,6
30357,1,2493,2414,79,0,200,1,6
30358,2,2280,2401,-121,0,337,1,6
30359,2,2533,2469,64,0,301,0,6
30360,1,2599,2401,198,0,9,0,6
30361,2,2499,2601,-102,0,210,0,6
30362,1,2495,2423,72,0,140,0,6
30363,1,2482,2356,126,0,40,1,6
30364,1,2509,2201,308,0,343,0,6
30365,3,2554,2378,176,0,221,0,6
30366,1,2542,2406,136,0,38,0,6
30367,3,2435,2262,173,0,335,0,6
30368,1,2662,2395,267,0,115,0,6
30369,1,2318,2509,-191,0,113,0,6
30370,1,2517,2442,75,0,202,0,6
30371,2,2364,2527,-163,0,4,0,6
30372,2,2244,2400,-156,0,107,0,6
30373,2,2374,2431,-57,0,129,0,6
30374,2,2311,2450,-139,0,4,0,6
30375,2,2592,2433,159,0,196,1,6
30376,2,2430,2507,-77,0,305,1,6
30377,2,2444,2306,138,0,456,0,6
30378,1,2506,2202,304,0,241,0,6
30379,1,2575,2542,33,0,118,1,6
30380,2,2432,2206,226,0,200,0,6
30381,1,2584,2485,99,0,116,0,6
30382,1,2468,2249,219,0,245,0,6
30383,1,2459,2399,60,0,204,0,6
30384,1,2455,2264,191,0,200,0,6
30385,2,2374,2431,-57,0,7,0,6
30386,1,2523,2613,-90,0,302,1,6
30387,1,2370,2642,-272,0,50,1,6
30388,1,2486,2202,284,0,388,1,6
30389,1,2412,2450,-38,0,145,0,6
30390,1,2561,2571,-10,0,269,0,6
30391,3,2260,2475,-215,0,15,0,6
30392,1,2505,2235,270,0,85,0,6
30393,3,2467,2382,85,0,122,0,6
30394,1,2444,2434,10,0,200,0,6
30395,2,2479,2453,26,0,131,0,6
30396,1,2365,2409,-44,0,254,0,6
30397,1,2288,2502,-214,0,380,0,6
30398,3,2437,2211,226,0,41,0,6
30399,2,2455,2441,14,0,100,0,6
30400,1,2422,2380,42,0,49,0,6
30401,2,2342,2591,-249,0,107,0,6
30402,2,2273,2557,-284,0,15,0,6
30403,1,2360,2459,-99,0,101,0,6
30404,1,2493,2214,279,0,1,0,6
30405,2,2575,2576,-1,0,345,0,6
30406,2,2315,2480,-165,0,132,0,6
30407,1,2632,2304,328,0,14,1,6
30408,1,2679,2516,163,0,4,0,6
30409,1,2531,2416,115,0,60,0,6
30410,2,2241,2549,-308,0,107,0,6
30411,1,2694,2606,88,0,4,0,6
30412,1,2413,2359,54,0,176,0,6
30413,3,2355,2409,-54,0,5,0,6
30414,2,2559,2259,300,0,150,0,6
30415,1,2465,2364,101,0,4,1,6
30416,1,2418,2348,70,0,190,1,6
30417,1,2418,2295,123,0,4,0,6
30418,2,2336,2468,-132,0,122,0,6
30419,2,2383,2489,-106,0,137,0,6
30420,2,2642,2528,114,0,37,0,6
30421,2,2474,2603,-129,0,111,0,6
30422,1,2400,2362,38,0,113,0,6
30423,3,2492,2317,175,0,103,0,6
30424,2,2325,2441,-116,0,148,0,6
30425,2,2243,2433,-190,0,133,0,6
30426,1,2508,2445,63,0,269,0,6
30427,3,2356,2556,-200,0,211,0,6
30428,2,2528,2764,-236,0,302,0,6
30429,1,2436,2231,205,0,228,0,6
30430,1,2426,2460,-34,0,80,1,6
30431,1,2302,2422,-120,0,337,0,6
30432,1,2517,2537,-20,0,260,0,6
30433,2,2555,2398,157,0,19,1,6
30434,2,2251,2657,-406,0,200,0,6
30435,2,2396,2545,-149,0,205,0,6
30436,1,2375,2459,-84,0,248,0,6
30437,1,2297,2474,-177,0,22,0,6
30438,2,2447,2548,-101,0,106,0,6
30439,3,2430,2605,-175,0,190,0,6
30440,1,2404,2556,-152,0,202,0,6
30441,1,2218,2417,-199,0,380,0,6
30442,2,2239,2436,-197,0,43,0,6
30443,2,2439,2635,-196,0,110,0,6
30444,2,2319,2536,-217,0,201,0,6
30445,1,2438,2291,147,0,301,0,6
30446,1,2442,2298,144,0,325,0,6
30447,3,2610,2425,185,0,101,0,6
30448,1,2678,2494,184,0,140,0,6
30449,2,2451,2310,141,0,464,1,6
30450,1,2547,2350,197,0,278,0,6
30451,2,2438,2498,-60,0,46,0,6
30452,1,2561,2308,253,0,414,0,6
30453,1,2538,2522,16,0,45,1,6
30454,2,2274,2468,-194,0,100,0,6
30455,3,2358,2471,-113,0,301,0,6
30456,1,2427,2457,-30,0,345,1,6
30457,2,2412,2443,-31,0,5,1,6
30458,2,2593,2731,-138,0,110,0,6
30459,2,2437,2325,112,0,46,1,6
30460,1,2448,2347,101,0,200,0,6
30461,2,2400,2447,-47,0,105,1,6
30462,2,2524,2513,11,0,330,0,6
30463,2,2370,2410,-40,0,101,0,6
30464,1,2447,2344,103,0,107,0,6
30465,1,2457,2247,210,0,380,0,6
30466,3,2452,2311,141,0,300,0,8
30467,1,2475,2368,107,0,202,0,6
30468,1,2426,2430,-4,0,4,0,6
30469,3,2604,2629,-25,0,111,0,6
30470,2,2380,2473,-93,0,140,0,6
30471,3,2494,2368,126,0,56,0,6
30472,2,2297,2407,-110,0,123,0,6
30473,1,2488,2459,29,0,354,0,6
30474,1,2443,2281,162,0,241,0,6
30475,2,2369,2423,-54,0,46,1,6
30476,1,2415,2423,-8,0,112,0,6
30477,3,2371,2437,-66,0,337,0,6
30478,3,2304,2431,-127,0,133,0,6
30479,2,2350,2535,-185,0,242,0,6
30480,2,2552,2619,-67,0,151,1,6
30481,2,2432,2422,10,0,297,1,6
30482,2,2341,2589,-248,0,45,0,6
30483,2,2401,2441,-40,0,46,0,6
30484,2,2299,2414,-115,0,8,0,6
30485,1,2306,2535,-229,0,302,0,6
30486,1,2516,2561,-45,0,120,0,6
30487,1,2448,2225,223,0,380,1,6
30488,2,2368,2467,-99,0,15,0,6
30489,2,2227,2542,-315,0,412,0,6
30490,2,2408,2421,-13,0,50,0,6
30491,2,2465,2322,143,0,455,1,6
30492,2,2335,2498,-163,0,178,0,6
30493,2,2613,2512,101,0,300,1,6
30494,1,2551,2432,119,0,4,0,6
30495,1,2474,2203,271,0,248,0,6
30496,2,2469,2498,-29,0,10,0,6
30497,2,2236,2484,-248,0,331,1,6
30498,1,2541,2638,-97,0,13,0,6
30499,2,2303,2414,-111,0,196,0,6
30500,1,2401,2571,-170,0,140,0,6
30501,2,2390,2429,-39,0,135,0,6
30502,3,2408,2499,-91,0,13,0,6
30503,2,2456,2346,110,0,255,0,6
30504,1,2297,2447,-150,0,315,1,6
30505,1,2446,2209,237,0,8,0,6
30506,2,2393,2420,-27,0,306,0,8
30507,1,2520,2413,107,0,145,1,6
30508,1,2340,2458,-118,0,201,0,6
30509,2,2336,2437,-101,0,334,0,6
30510,1,2413,2235,178,4,40,0,13
30511,2,2396,2449,-53,0,140,0,6
30512,2,2507,2428,79,0,0,0,6
30513,1,2410,2306,104,0,43,1,6
30514,2,2493,2320,173,0,485,0,6
30515,1,2538,2487,51,0,122,0,6
30516,2,2337,2406,-69,0,0,1,6
30517,2,2455,2392,63,0,456,1,6
30518,1,2415,2347,68,0,4,0,6
30519,2,2316,2572,-256,0,184,0,6
30520,3,2389,2418,-29,0,135,0,6
30521,1,2269,2472,-203,0,372,1,6
30522,2,2279,2403,-124,0,107,1,6
30523,1,2428,2268,160,0,492,0,6
30524,2,2352,2500,-148,0,315,1,6
30525,2,2222,2416,-194,0,140,0,6
30526,1,2393,2450,-57,0,310,0,6
30527,2,2320,2526,-206,0,46,0,6
30528,2,2361,2489,-128,0,300,0,6
30529,1,2446,2539,-93,0,476,0,6
30530,1,2500,2379,121,0,0,0,6
30531,2,2386,2566,-180,0,4,0,6
30532,1,2538,2435,103,0,8,1,6
30533,2,2317,2436,-119,0,106,0,6
30534,1,2493,2347,146,0,112,0,6
30535,1,2602,2699,-97,0,17,0,6
30536,1,2591,2352,239,0,4,1,6
30537,1,2618,2399,219,0,167,0,6
30538,1,2465,2273,192,0,121,1,6
30539,2,2492,2360,132,0,0,0,6
30540,2,2310,2507,-197,0,0,0,6
30541,2,2567,2439,128,0,43,0,6
30542,1,2286,2416,-130,0,250,1,6
30543,1,2431,2576,-145,0,9,0,6
30544,1,2602,2573,29,0,13,0,6
30545,1,2381,2429,-48,0,121,0,6
30546,1,2412,2549,-137,0,441,0,6
30547,1,2415,2235,180,0,130,0,6
30548,2,2320,2402,-82,0,122,0,6
30549,2,2454,2334,120,0,130,0,6
30551,3,2592,2484,108,0,43,0,6
30552,3,2472,2495,-23,0,123,0,6
30553,1,2439,2605,-166,0,200,0,6
30554,1,2408,2335,73,0,245,0,6
30555,2,2485,2411,74,0,108,0,6
30556,3,2353,2715,-362,0,141,0,6
30557,2,2428,2441,-13,0,415,0,6
30558,2,2586,2289,297,0,148,0,6
30559,1,2473,2448,25,0,192,0,6
30560,1,2471,2423,48,0,100,0,6
30561,1,2313,2471,-158,0,57,1,6
30562,1,2481,2361,120,4,101,0,13
30563,1,2531,2456,75,0,218,0,6
30564,2,2360,2403,-43,0,100,0,6
30565,2,2555,2440,115,0,54,0,6
30566,2,2467,2276,191,0,176,0,6
30567,2,2398,2534,-136,0,40,0,6
30568,2,2456,2472,-16,0,5,1,6
30569,2,2436,2552,-116,0,4,0,6
30570,2,2217,2410,-193,0,0,0,6
30571,1,2498,2415,83,0,200,0,6
30572,1,2433,2369,64,0,106,0,6
30573,2,2444,2612,-168,0,200,0,6
30574,1,2472,2242,230,0,150,0,6
30575,1,2630,2559,71,0,56,0,6
30576,2,2421,2423,-2,0,58,0,6
30577,2,2418,2391,27,0,113,0,6
30578,2,2481,2299,182,0,310,0,6
30579,2,2563,2566,-3,0,101,0,6
30580,2,2452,2245,207,0,112,0,6
30581,2,2359,2415,-56,0,3,1,6
30582,1,2485,2458,27,0,256,0,6
30583,3,2394,2591,-197,0,1,0,6
30584,1,2642,2232,410,0,112,0,6
30585,1,2664,2523,141,0,100,0,6
30586,1,2623,2392,231,0,197,0,6
30587,1,2462,2375,87,0,110,1,6
30588,1,2495,2470,25,0,1,0,6
30589,2,2493,2428,65,0,310,1,6
30590,1,2486,2384,102,0,206,0,6
30591,3,2548,2209,339,0,41,0,6
30592,1,2369,2549,-180,0,211,0,6
30593,2,2235,2504,-269,0,123,0,6
30594,1,2607,2213,394,0,115,0,6
30595,1,2402,2205,197,0,303,0,6
30596,3,2359,2545,-186,0,10,0,6
30597,2,2411,2548,-137,0,80,0,6
30598,1,2384,2584,-200,0,2,1,6
30599,2,2202,2413,-211,4,40,0,13
30600,2,2359,2526,-167,0,301,1,6
30601,1,2525,2432,93,0,1,0,6
30602,2,2476,2429,47,0,246,0,6
30603,2,2555,2420,135,0,7,1,6
30604,1,2553,2424,129,0,200,0,6
30605,1,2766,2555,211,0,106,0,6
30606,2,2441,2473,-32,0,426,0,6
30607,2,2523,2376,147,0,48,1,6
30608,2,2208,2418,-210,0,107,0,6
30609,1,2429,2359,70,0,44,0,6
30610,1,2491,2428,63,0,394,0,6
30611,1,2457,2419,38,0,45,0,6
30612,1,2572,2205,367,0,4,0,6
30613,2,2394,2405,-11,0,31,0,6
30614,3,2492,2511,-19,0,302,0,6
30615,2,2293,2408,-115,0,4,0,6
30616,2,2270,2458,-188,0,49,0,6
30617,2,2502,2422,80,0,140,0,6
30618,2,2292,2413,-121,0,109,0,6
30619,1,2411,2215,196,0,247,0,6
30620,2,2510,2583,-73,0,253,0,6
30621,2,2276,2604,-328,0,150,0,6
30622,2,2480,2476,4,0,143,0,6
30623,1,2734,2307,427,0,7,0,6
30624,2,2201,2629,-428,0,344,0,6
30625,1,2438,2277,161,0,10,1,6
30626,2,2250,2420,-170,0,163,0,6
30627,1,2466,2540,-74,0,101,0,6
30628,2,2452,2473,-21,0,46,0,6
30629,2,2313,2441,-128,0,317,1,6
30630,1,2405,2382,23,0,278,0,6
30631,2,2427,2325,102,0,300,0,6
30632,1,2543,2220,323,0,410,1,6
30633,1,2580,2442,138,0,0,0,6
30634,2,2329,2569,-240,0,60,0,6
30635,2,2439,2485,-46,0,110,0,6
30636,1,2537,2383,154,0,41,0,6
30637,1,2519,2244,275,0,4,0,6
30638,1,2559,2620,-61,0,456,1,6
30639,2,2516,2606,-90,0,151,0,6
30640,2,2476,2448,28,0,0,0,6
30641,1,2531,2543,-12,0,410,0,6
30642,2,2447,2513,-66,0,107,0,6
30643,1,2396,2684,-288,0,113,0,6
30644,2,2305,2402,-97,0,23,0,6
30645,1,2479,2314,165,0,48,0,6
30646,1,2432,2370,62,0,40,0,6
30647,1,2513,2415,98,0,45,0,6
30648,1,2441,2439,2,0,132,0,6
30649,1,2715,2632,83,0,4,0,6
30650,1,2523,2519,4,0,180,0,6
30652,2,2522,2586,-64,0,110,1,6
30653,1,2503,2313,190,0,123,0,6
30654,3,2569,2464,105,0,131,0,6
30655,2,2450,2462,-12,0,201,1,6
30656,2,2427,2402,25,0,380,0,6
30657,2,2288,2412,-124,0,240,1,6
30658,1,2402,2384,18,0,122,1,6
30659,2,2420,2284,136,0,11,0,6
30660,1,2632,2556,76,0,5,0,6
30661,1,2493,2317,176,0,105,0,6
30662,2,2347,2413,-66,0,9,0,6
30663,1,2445,2215,230,0,218,0,6
30664,2,2473,2496,-23,0,43,1,6
30665,1,2253,2448,-195,0,463,0,6
30666,2,2344,2681,-337,0,214,1,6
30667,2,2552,2399,153,0,456,1,6
30668,1,2307,2408,-101,0,295,0,6
30669,1,2491,2253,238,0,332,0,6
30670,1,2454,2432,22,0,3,0,6
30671,2,2289,2448,-159,0,106,0,6
30672,1,2542,2444,98,0,264,0,6
30673,2,2321,2502,-181,0,170,1,6
30674,3,2360,2401,-41,0,30,0,6
30675,1,2526,2388,138,0,87,0,6
30677,1,2469,2379,90,0,201,0,6
30678,1,2246,2423,-177,4,200,0,13
30679,2,2372,2538,-166,0,241,1,6
30680,1,2403,2512,-109,0,245,0,6
30681,1,2408,2419,-11,0,85,0,6
30682,2,2214,2659,-445,0,200,0,6
30683,1,2243,2477,-234,0,45,0,6
30684,2,2377,2439,-62,0,113,1,6
30685,1,2451,2227,224,0,4,1,6
30686,2,2529,2267,262,0,101,1,6
30687,3,2218,2458,-240,0,405,0,6
30688,1,2582,2635,-53,0,337,0,6
30689,2,2453,2501,-48,0,40,0,6
30690,2,2465,2573,-108,0,241,1,6
30691,2,2554,2539,15,0,100,0,6
30692,2,2396,2530,-134,0,4,0,6
30694,1,2446,2563,-117,0,152,1,6
30695,2,2594,2315,279,0,41,1,6
30696,1,2426,2403,23,0,118,0,6
30697,1,2296,2479,-183,0,344,0,6
30698,3,2408,2232,176,0,385,0,6
30699,1,2455,2472,-17,0,414,0,6
30700,1,2397,2447,-50,0,200,0,6
30701,1,2504,2410,94,0,52,0,6
30702,1,2503,2400,103,0,31,0,6
30703,1,2408,2436,-28,0,48,0,6
30704,2,2423,2333,90,0,115,0,6
30705,1,2486,2298,188,0,422,1,6
30706,2,2356,2608,-252,0,110,0,6
30707,2,2478,2506,-28,0,440,0,6
30708,2,2452,2417,35,0,15,0,6
30709,2,2360,2583,-223,0,242,0,6
30710,1,2435,2439,-4,0,120,1,6
30711,1,2556,2624,-68,0,123,0,6
30712,1,2523,2395,128,0,343,0,6
30713,1,2388,2461,-73,0,245,1,6
30714,3,2478,2436,42,0,195,0,6
30715,1,2387,2414,-27,0,203,0,6
30716,2,2216,2521,-305,0,31,0,6
30717,1,2371,2427,-56,0,41,0,6
30718,1,2291,2467,-176,0,106,0,6
30719,2,2508,2388,120,0,455,0,6
30720,1,2463,2568,-105,0,300,1,6
30721,2,2359,2556,-197,0,201,1,6
30723,1,2406,2356,50,0,200,0,6
30724,2,2484,2492,-8,0,315,1,6
30725,2,2247,2496,-249,0,201,0,6
30726,1,2341,2552,-211,0,13,0,6
30727,2,2272,2625,-353,0,154,0,6
30728,1,2408,2350,58,0,455,0,6
30729,3,2490,2548,-58,0,16,0,6
30730,1,2540,2607,-67,0,405,0,6
30731,1,2496,2422,74,0,40,0,6
30732,2,2545,2434,111,0,300,0,6
30733,3,2423,2312,111,0,200,0,6
30734,2,2206,2441,-235,0,106,0,6
30735,2,2447,2506,-59,0,224,0,6
30736,2,2405,2216,189,0,46,0,6
30737,2,2457,2229,228,0,40,0,6
30738,2,2330,2594,-264,0,343,0,6
30739,2,2434,2385,49,0,127,1,6
30740,2,2335,2416,-81,0,469,1,6
30741,2,2409,2254,155,0,316,1,6
30742,2,2461,2460,1,0,408,0,6
30743,2,2337,2403,-66,0,4,0,6
30744,2,2450,2357,93,0,123,0,6
30745,1,2428,2420,8,0,206,0,6
30746,2,2299,2451,-152,0,404,1,6
30747,2,2223,2615,-392,0,36,0,6
30748,2,2246,2405,-159,0,132,0,6
30749,1,2426,2384,42,0,404,0,6
30750,1,2531,2691,-160,0,101,0,6
30751,3,2511,2543,-32,0,229,0,6
30752,1,2482,2442,40,0,411,0,6
30753,1,2485,2266,219,0,6,0,6
30754,2,2412,2470,-58,0,101,0,6
30755,1,2430,2547,-117,0,335,0,6
30756,2,2374,2474,-100,0,215,1,6
30757,1,2365,2437,-72,0,7,0,6
30758,1,2450,2233,217,0,0,0,8
30759,2,2244,2460,-216,0,288,1,6
30760,3,2340,2539,-199,0,380,0,6
30761,2,2447,2423,24,0,454,1,6
30762,2,2461,2388,73,0,130,0,6
30763,1,2446,2321,125,0,110,0,6
30764,2,2403,2372,31,0,269,0,6
30765,1,2478,2544,-66,0,207,0,6
30766,2,2213,2451,-238,0,40,0,6
30767,1,2518,2538,-20,0,456,0,6
30768,3,2200,2502,-302,0,315,0,6
30769,1,2538,2442,96,0,4,0,6
30770,1,2634,2222,412,0,0,0,6
30771,1,2630,2292,338,0,101,1,6
30772,2,2611,2513,98,0,293,0,6
30773,1,2405,2286,119,0,113,0,6
30774,1,2543,2414,129,0,4,0,6
30775,1,2395,2526,-131,0,265,1,6
30776,2,2396,2487,-91,0,250,0,6
30777,2,2572,2588,-16,0,454,0,6
30778,2,2328,2410,-82,0,100,1,6
30779,3,2445,2317,128,0,121,0,8
30780,3,2415,2340,75,0,48,0,6
30781,2,2434,2616,-182,0,394,0,6
30782,2,2222,2465,-243,0,0,0,6
30783,2,2434,2609,-175,0,410,1,6
30784,1,2291,2436,-145,0,106,1,6
30785,1,2540,2261,279,0,374,0,6
30786,2,2423,2213,210,0,300,1,6
30787,2,2341,2439,-98,0,456,0,6
30788,2,2468,2547,-79,0,106,0,6
30789,1,2420,2333,87,0,46,1,6
30790,1,2533,2393,140,0,46,0,6
30791,2,2428,2392,36,0,395,0,6
30792,1,2419,2378,41,4,274,0,13
30793,2,2413,2543,-130,0,201,0,6
30794,2,2407,2462,-55,0,302,0,6
30795,2,2315,2429,-114,0,406,0,6
30796,2,2431,2544,-113,0,190,0,6
30797,2,2354,2461,-107,0,242,1,6
30798,2,2435,2420,15,0,300,0,6
30799,2,2438,2346,92,0,130,0,6
30800,1,2209,2408,-199,0,122,0,6
30801,2,2233,2482,-249,0,335,0,6
30802,1,2420,2447,-27,0,43,0,6
30803,2,2490,2328,162,0,43,0,6
30804,1,2597,2338,259,0,5,0,6
30805,1,2399,2424,-25,0,151,0,6
30806,1,2408,2396,12,0,110,0,6
30807,2,2354,2403,-49,4,302,0,13
30808,2,2476,2468,8,0,112,0,6
30809,1,2355,2402,-47,0,105,0,6
30810,2,2596,2671,-75,0,150,0,6
30811,1,2637,2505,132,0,5,0,6
30812,1,2735,2406,329,0,5,0,6
30813,1,2278,2440,-162,0,18,0,6
30815,1,2306,2419,-113,0,0,1,6
30816,1,2277,2415,-138,4,200,1,13
30817,2,2408,2470,-62,0,250,1,6
30818,3,2374,2448,-74,0,4,0,6
30819,2,2411,2412,-1,0,35,0,6
30820,1,2415,2354,61,0,101,0,6
30821,3,2414,2243,171,0,315,0,6
30822,1,2629,2502,127,0,461,0,6
30823,1,2589,2357,232,0,49,0,6
30824,2,2610,2468,142,0,300,0,6
30825,2,2368,2400,-32,0,302,1,6
30826,2,2404,2316,88,0,216,0,6
30827,1,2444,2406,38,0,120,1,6
30828,2,2433,2466,-33,0,112,0,6
30829,1,2422,2461,-39,0,112,0,6
30830,2,2482,2519,-37,0,100,1,6
30831,1,2473,2250,223,0,153,0,6
30832,3,2606,2470,136,0,103,0,6
30833,1,2435,2249,186,0,409,0,6
30834,1,2769,2668,101,0,190,0,6
30835,1,2417,2335,82,0,41,1,6
30836,2,2245,2440,-195,0,40,0,6
30837,1,2604,2572,32,0,15,1,6
30838,1,2467,2261,206,0,211,1,6
30839,1,2439,2489,-50,0,373,0,6
30840,1,2417,2710,-293,0,4,0,6
30841,1,2420,2370,50,0,46,0,6
30842,1,2480,2547,-67,0,101,0,6
30843,3,2345,2413,-68,0,0,0,6
30844,1,2572,2477,95,0,302,0,6
30845,2,2420,2438,-18,0,271,1,6
30846,1,2505,2234,271,0,46,0,6
30847,1,2249,2474,-225,0,100,0,6
30848,3,2461,2411,50,0,222,0,6
30849,2,2537,2411,126,0,380,0,6
30850,1,2427,2459,-32,0,4,0,6
30851,1,2434,2254,180,0,4,0,6
30852,3,2315,2552,-237,0,0,0,6
30853,2,2530,2424,106,0,146,0,6
30854,1,2423,2205,218,0,267,0,6
30855,1,2411,2208,203,0,45,0,6
30856,2,2288,2403,-115,0,405,0,6
30857,1,2455,2339,116,0,200,0,6
30858,2,2223,2492,-269,0,300,0,6
30859,2,2467,2373,94,0,106,1,6
30860,1,2400,2354,46,0,400,0,6
30861,1,2532,2303,229,0,122,0,6
30862,2,2211,2530,-319,0,112,0,6
30863,1,2444,2336,108,0,201,0,6
30864,1,2208,2504,-296,0,154,0,6
30865,1,2575,2446,129,0,243,0,6
30866,2,2282,2425,-143,0,0,0,6
30867,1,2596,2264,332,0,455,0,6
30868,3,2450,2247,203,0,380,0,6
30869,2,2296,2406,-110,0,1,0,6
30870,2,2313,2434,-121,0,125,0,6
30871,1,2563,2491,72,0,132,0,6
30872,1,2436,2453,-17,0,31,0,6
30873,3,2479,2513,-34,0,153,0,6
30874,3,2332,2546,-214,0,174,0,6
30875,2,2440,2291,149,0,434,0,6
30876,2,2384,2431,-47,0,102,0,6
30877,1,2537,2271,266,0,0,0,6
30878,1,2611,2421,190,0,46,0,6
30879,1,2475,2385,90,0,0,0,6
30880,1,2626,2389,237,0,163,0,6
30881,2,2269,2544,-275,0,123,0,6
30882,1,2544,2322,222,0,242,0,6
30883,2,2425,2372,53,0,3,0,6
30884,2,2523,2333,190,0,4,0,6
30885,1,2511,2214,297,0,210,0,6
30886,2,2245,2492,-247,0,46,0,6
30887,3,2286,2489,-203,0,464,0,6
30889,2,2205,2547,-342,0,111,1,6
30890,1,2506,2491,15,0,1,0,6
30891,1,2601,2487,114,0,191,0,6
30892,1,2547,2448,99,0,256,0,6
30893,1,2542,2517,25,0,17,0,6
30894,1,2617,2565,52,0,277,0,6
30895,2,2409,2421,-12,0,62,1,6
30896,2,2405,2289,116,0,128,0,6
30897,2,2392,2549,-157,0,2,0,6
30898,1,2545,2324,221,0,57,0,6
30899,2,2308,2644,-336,0,0,0,6
30900,1,2453,2496,-43,0,4,0,6
30901,2,2353,2482,-129,0,50,0,6
30902,2,2292,2430,-138,0,123,0,6
30903,1,2534,2383,151,0,256,0,6
30904,2,2386,2474,-88,0,123,0,6
30905,1,2576,2324,252,0,102,0,6
30907,1,2577,2490,87,0,80,1,6
30909,2,2318,2584,-266,0,156,1,6
30910,1,2438,2286,152,0,45,0,6
30911,1,2326,2596,-270,0,118,0,6
30912,1,2541,2449,92,0,1,0,6
30913,2,2370,2535,-165,0,22,0,6
30914,2,2443,2579,-136,0,210,0,6
30915,2,2344,2413,-69,0,106,0,6
30916,1,2416,2236,180,0,101,0,6
30917,2,2433,2407,26,0,112,1,6
30918,3,2385,2441,-56,0,190,0,6
30919,2,2542,2566,-24,0,344,0,6
30920,1,2438,2321,117,0,119,0,6
30921,2,2530,2477,53,0,70,0,6
30922,1,2279,2592,-313,0,113,0,6
30923,1,2683,2605,78,0,5,0,6
30924,2,2594,2402,192,0,121,0,6
30925,2,2416,2421,-5,0,101,0,6
30926,2,2465,2512,-47,0,25,1,6
30927,1,2543,2567,-24,0,250,0,6
30928,2,2467,2566,-99,0,45,0,6
30929,2,2505,2413,92,0,201,0,6
30930,2,2416,2432,-16,0,140,0,6
30931,1,2450,2410,40,0,46,0,6
30932,1,2547,2446,101,0,41,1,6
30933,2,2232,2426,-194,0,4,0,6
30934,2,2441,2454,-13,0,242,1,6
30935,1,2426,2206,220,0,101,0,6
30936,2,2256,2406,-150,0,133,0,6
30937,2,2300,2542,-242,0,106,0,6
30938,1,2433,2404,29,0,300,0,6
30939,3,2260,2411,-151,0,123,0,6
30940,1,2684,2346,338,0,300,0,6
30941,1,2531,2374,157,0,412,1,6
30942,2,2363,2524,-161,0,107,1,6
30943,1,2423,2252,171,0,135,0,6
30944,2,2498,2328,170,0,249,1,6
30945,3,2424,2597,-173,0,46,0,6
30946,1,2499,2239,260,0,2,0,6
30948,3,2425,2420,5,0,484,0,6
30949,2,2632,2433,199,0,320,0,6
30950,2,2498,2349,149,0,101,1,6
30951,1,2443,2493,-50,0,315,1,6
30952,1,2494,2289,205,0,404,0,6
30953,1,2445,2545,-100,0,200,0,6
30954,1,2283,2408,-125,0,130,0,6
30955,2,2428,2429,-1,0,466,0,6
30956,2,2408,2359,49,0,0,0,6
30957,2,2471,2599,-128,0,200,0,6
30958,2,2415,2228,187,0,123,0,6
30959,3,2353,2417,-64,0,150,0,6
30960,1,2411,2350,61,0,57,1,6
30961,2,2432,2438,-6,0,45,0,6
30962,2,2219,2555,-336,0,344,0,6
30963,1,2403,2225,178,0,101,0,6
30964,2,2200,2453,-253,0,106,0,6
30965,1,2420,2233,187,0,33,0,6
30966,2,2225,2536,-311,0,110,0,6
30967,2,2440,2398,42,0,15,1,6
30968,2,2241,2419,-178,0,240,0,6
30969,2,2346,2417,-71,0,345,0,6
30970,1,2448,2259,189,0,131,1,6
30971,2,2538,2450,88,0,300,1,6
30972,1,2418,2535,-117,0,476,0,6
30973,2,2442,2473,-31,0,210,0,6
30974,1,2519,2232,287,0,120,0,6
30975,3,2494,2340,154,0,102,0,6
30976,2,2401,2391,10,0,23,1,6
30977,2,2391,2552,-161,0,40,0,6
30978,1,2683,2540,143,0,4,0,6
30979,1,2376,2463,-87,0,102,1,6
30980,2,2456,2399,57,0,4,1,6
30981,2,2310,2476,-166,0,200,0,6
30982,2,2269,2421,-152,0,45,0,6
30983,1,2484,2368,116,0,89,0,6
30984,1,2416,2220,196,0,265,1,6
30985,1,2542,2299,243,0,9,0,6
30986,1,2349,2407,-58,0,123,0,6
30987,1,2396,2431,-35,0,273,0,6
30988,2,2305,2453,-148,0,100,1,8
30989,2,2400,2485,-85,0,20,0,6
30990,3,2479,2455,24,0,13,0,6
30991,2,2486,2591,-105,0,6,1,6
30992,2,2427,2603,-176,0,201,0,6
30993,1,2548,2287,261,0,459,0,6
30994,2,2476,2511,-35,0,331,0,6
30995,1,2429,2326,103,0,175,1,6
30996,1,2646,2389,257,0,13,0,6
30997,2,2556,2369,187,0,270,0,6
30998,1,2412,2346,66,0,40,0,6
30999,2,2445,2356,89,0,302,0,6
31000,2,2398,2552,-154,0,373,0,6
31001,1,2614,2578,36,0,490,0,6
31002,2,2549,2631,-82,0,8,0,6
31003,1,2318,2539,-221,0,0,1,6
31004,2,2291,2410,-119,0,41,0,6
31005,1,2321,2431,-110,0,12,0,6
31006,2,2223,2406,-183,0,45,0,6
31007,1,2545,2353,192,0,130,0,6
31009,1,2482,2406,76,0,310,0,6
31010,1,2418,2348,70,4,219,0,13
31011,1,2454,2262,192,0,464,1,6
31012,2,2471,2585,-114,0,484,0,6
31013,2,2349,2479,-130,0,129,0,6
31014,2,2546,2218,328,0,5,1,6
31015,2,2291,2494,-203,0,123,0,6
31016,1,2411,2516,-105,0,302,1,6
31017,1,2433,2249,184,0,40,1,6
31018,2,2430,2267,163,0,43,1,6
31019,1,2561,2276,285,0,109,0,6
31020,1,2645,2471,174,0,42,0,6
31021,2,2436,2355,81,0,306,1,6
31022,2,2274,2420,-146,0,80,0,6
31023,1,2402,2355,47,0,15,1,6
31024,1,2371,2498,-127,0,306,0,6
31025,1,2465,2217,248,0,4,0,6
31026,2,2431,2456,-25,0,230,0,6
31027,2,2361,2463,-102,0,107,1,6
31028,1,2379,2406,-27,0,36,0,6
31029,2,2629,2737,-108,0,112,0,6
31030,1,2424,2417,7,0,44,0,6
31031,1,2262,2405,-143,0,49,1,6
31032,2,2391,2432,-41,0,6,0,6
31033,3,2281,2413,-132,0,40,0,6
31034,1,2452,2271,181,0,45,0,6
31035,1,2701,2355,346,0,49,0,6
31036,1,2444,2492,-48,0,335,1,6
31037,1,2418,2344,74,0,241,0,6
31038,1,2460,2409,51,0,131,0,6
31039,1,2551,2426,125,0,200,0,6
31040,2,2303,2412,-109,0,102,0,6
31042,2,2365,2479,-114,0,0,0,6
31043,2,2484,2571,-87,0,201,0,6
31044,1,2546,2512,34,0,210,0,6
31045,2,2522,2204,318,0,247,0,6
31046,1,2677,2537,140,0,15,1,6
31047,1,2267,2570,-303,0,110,0,6
31048,3,2431,2424,7,0,40,0,6
31049,2,2498,2603,-105,0,380,0,6
31050,1,2584,2523,61,0,200,1,6
31051,1,2520,2475,45,0,106,1,6
31052,1,2475,2382,93,0,311,0,6
31053,1,2451,2451,0,0,342,0,6
31054,1,2411,2256,155,0,200,0,6
31055,1,2220,2443,-223,0,10,1,6
31056,2,2497,2612,-115,0,410,0,6
31057,2,2661,2347,314,0,36,0,6
31058,2,2233,2450,-217,0,0,0,6
31059,1,2462,2316,146,0,224,0,6
31060,1,2443,2516,-73,0,200,1,6
31061,2,2242,2459,-217,0,4,0,6
31062,1,2333,2420,-87,0,9,0,6
31063,3,2464,2478,-14,0,201,0,6
31064,1,2687,2467,220,0,112,0,6
31065,2,2483,2469,14,0,12,1,6
31066,1,2463,2624,-161,0,0,0,6
31068,1,2346,2428,-82,0,247,0,6
31069,2,2570,2589,-19,0,49,0,6
31070,2,2203,2479,-276,0,320,0,6
31071,3,2502,2442,60,0,255,0,6
31072,1,2472,2232,240,0,170,0,6
31073,1,2317,2425,-108,0,48,0,6
31074,2,2465,2350,115,0,6,1,6
31075,1,2536,2431,105,0,487,1,6
31076,3,2315,2486,-171,0,43,0,6
31077,1,2426,2372,54,0,203,0,6
31078,2,2521,2375,146,0,230,0,6
31079,2,2233,2468,-235,0,40,0,6
31080,2,2364,2429,-65,0,51,0,6
31081,1,2586,2425,161,0,100,0,6
31082,1,2420,2374,46,0,4,1,6
31083,2,2406,2509,-103,0,112,1,6
31084,1,2351,2485,-134,0,120,0,6
31085,2,2470,2687,-217,0,100,0,6
31086,2,2331,2422,-91,0,120,0,6
31087,1,2543,2207,336,0,277,0,6
31088,2,2322,2400,-78,0,242,0,6
31089,1,2307,2515,-208,0,46,0,6
31090,2,2323,2496,-173,0,43,0,6
31091,1,2664,2641,23,0,138,0,6
31092,2,2234,2773,-539,0,147,0,6
31093,2,2525,2314,211,0,106,0,6
31094,2,2616,2446,170,0,373,0,6
31095,1,2442,2311,131,0,43,1,6
31096,2,2232,2471,-239,0,124,0,6
31097,1,2460,2373,87,0,4,1,6
31098,1,2242,2467,-225,0,302,0,6
31099,2,2231,2409,-178,0,107,1,6
31100,1,2416,2428,-12,0,4,0,6
31101,1,2206,2415,-209,0,241,1,6
31103,3,2422,2325,97,0,140,0,6
31104,1,2460,2443,17,0,28,0,6
31105,1,2429,2435,-6,0,484,0,6
31106,2,2436,2422,14,0,125,0,6
31107,2,2442,2427,15,0,404,1,6
31108,2,2306,2470,-164,0,18,0,6
31109,2,2204,2437,-233,0,18,0,6
31110,1,2439,2431,8,0,302,0,6
31111,2,2213,2437,-224,0,454,0,6
31112,3,2586,2513,73,0,45,0,6
31113,3,2481,2474,7,0,0,0,6
31114,2,2296,2685,-389,0,247,0,6
31115,1,2508,2477,31,0,140,0,6
31116,1,2371,2503,-132,0,46,1,6
31117,1,2557,2535,22,0,57,0,6
31118,2,2414,2253,161,0,15,0,6
31119,2,2412,2352,60,0,203,1,6
31120,1,2548,2234,314,0,317,0,6
31121,1,2422,2249,173,0,48,0,6
31122,2,2497,2204,293,0,260,0,6
31123,1,2388,2648,-260,0,40,0,6
31124,3,2490,2232,258,0,120,0,6
31125,2,2421,2460,-39,0,106,1,6
31126,2,2232,2497,-265,0,0,1,6
31127,1,2401,2344,57,0,104,0,6
31128,2,2317,2537,-220,0,45,0,6
31129,2,2403,2556,-153,0,113,0,6
31130,1,2445,2355,90,0,101,1,6
31131,2,2342,2416,-74,0,49,0,6
31132,1,2484,2474,10,0,256,0,6
31133,2,2279,2488,-209,0,335,0,6
31134,2,2221,2546,-325,0,211,0,6
31135,1,2441,2255,186,0,115,0,6
31137,2,2615,2480,135,0,100,1,6
31138,2,2317,2487,-170,0,463,1,6
31139,1,2478,2513,-35,0,43,0,6
31140,1,2486,2450,36,0,43,1,6
31141,2,2532,2582,-50,0,45,0,6
31142,2,2234,2448,-214,0,41,0,6
31143,2,2427,2487,-60,0,140,0,6
31144,2,2209,2410,-201,0,1,0,6
31145,3,2413,2213,200,0,46,0,6
31146,3,2449,2394,55,0,337,0,6
31147,2,2424,2501,-77,0,241,0,6
31148,2,2291,2426,-135,0,145,0,6
31149,2,2312,2408,-96,0,308,1,8
31150,2,2272,2522,-250,0,351,1,6
31151,2,2234,2545,-311,0,41,1,6
31152,2,2470,2438,32,0,130,0,6
31153,1,2496,2444,52,0,305,1,6
31154,1,2555,2375,180,0,7,0,6
31156,2,2544,2378,166,0,4,0,6
31157,2,2576,2443,133,0,455,0,6
31158,1,2452,2505,-53,0,152,1,6
31159,1,2411,2281,130,0,200,1,6
31160,1,2517,2285,232,0,0,0,6
31161,1,2430,2287,143,0,337,0,6
31162,2,2423,2595,-172,0,317,0,6
31163,2,2460,2555,-95,0,453,0,6
31164,1,2550,2482,68,0,11,0,6
31165,1,2410,2369,41,0,247,0,6
31166,1,2455,2261,194,0,49,1,6
31167,1,2314,2547,-233,0,411,0,6
31168,3,2431,2301,130,4,311,0,13
31169,2,2446,2457,-11,0,415,0,6
31170,2,2260,2413,-153,0,342,0,6
31171,1,2434,2388,46,0,151,0,6
31172,1,2219,2468,-249,0,46,0,6
31173,2,2321,2449,-128,0,223,0,6
31174,2,2298,2429,-131,0,4,0,6
31175,1,2401,2230,171,0,40,0,6
31176,2,2580,2291,289,0,5,0,6
31177,2,2608,2485,123,0,491,0,6
31178,1,2573,2386,187,0,144,0,6
31179,2,2341,2474,-133,0,102,0,6
31180,1,2381,2435,-54,0,4,1,6
31181,2,2440,2619,-179,0,8,0,6
31182,3,2349,2455,-106,0,150,0,6
31183,1,2622,2578,44,0,33,0,6
31184,2,2491,2379,112,0,1,0,6
31185,2,2426,2403,23,0,380,1,6
31186,1,2561,2421,140,0,178,0,6
31187,2,2509,2549,-40,0,1,0,6
31188,2,2540,2345,195,0,121,0,6
31189,1,2479,2292,187,0,230,0,6
31190,2,2479,2426,53,0,200,0,6
31191,1,2453,2415,38,0,27,1,6
31192,2,2338,2473,-135,0,300,1,6
31193,1,2636,2431,205,0,0,0,6
31194,1,2413,2439,-26,0,255,0,6
31195,1,2336,2484,-148,0,310,0,6
31196,1,2507,2357,150,0,225,1,6
31197,2,2223,2498,-275,0,0,0,6
31198,2,2490,2598,-108,0,245,1,6
31199,1,2421,2439,-18,0,428,1,6
31200,2,2202,2430,-228,0,43,0,6
31201,1,2428,2365,63,0,335,0,6
31202,1,2430,2487,-57,0,15,0,6
31203,1,2438,2486,-48,0,45,1,6
31204,3,2398,2418,-20,0,41,0,6
31205,2,2443,2464,-21,0,121,0,6
31206,2,2491,2648,-157,0,302,0,6
31207,1,2427,2585,-158,0,302,1,6
31208,1,2514,2339,175,0,313,0,6
31209,1,2425,2361,64,0,62,0,6
31210,2,2384,2586,-202,0,380,0,6
31211,2,2356,2486,-130,0,4,0,6
31212,1,2606,2228,378,0,106,0,6
31213,3,2312,2527,-215,0,123,0,6
31214,2,2404,2702,-298,0,140,0,6
31215,3,2536,2565,-29,0,302,0,6
31216,2,2595,2590,5,0,107,0,6
31217,1,2313,2450,-137,0,112,0,6
31218,1,2513,2352,161,0,147,0,6
31219,2,2252,2545,-293,0,200,1,6
31220,2,2462,2290,172,0,131,0,6
31222,2,2363,2440,-77,0,122,0,6
31223,1,2538,2405,133,0,190,0,6
31224,1,2595,2506,89,0,4,0,6
31225,1,2419,2252,167,0,241,0,6
31226,1,2413,2280,133,0,43,0,6
31227,2,2222,2536,-314,0,107,0,6
31228,1,2687,2533,154,0,65,0,6
31229,1,2690,2225,465,0,107,0,6
31230,1,2527,2682,-155,0,150,0,6
31231,2,2387,2596,-209,0,61,0,6
31232,3,2428,2323,105,0,127,0,6
31233,1,2519,2295,224,0,51,0,6
31234,1,2441,2360,81,0,311,0,6
31235,2,2323,2492,-169,0,33,0,6
31236,2,2429,2465,-36,0,246,0,6
31237,2,2416,2435,-19,0,462,0,6
31238,2,2477,2690,-213,0,466,0,6
31239,2,2464,2487,-23,0,43,0,6
31240,3,2550,2608,-58,0,403,0,6
31242,2,2454,2214,240,0,4,0,6
31243,2,2269,2479,-210,0,4,0,6
31244,1,2409,2383,26,0,123,0,6
31245,1,2442,2474,-32,0,10,0,6
31246,1,2480,2380,100,0,113,0,6
31247,1,2507,2236,271,0,151,1,6
31248,2,2331,2551,-220,0,336,1,6
31249,1,2599,2307,292,0,245,0,6
31250,1,2506,2286,220,0,5,0,6
31251,2,2413,2348,65,0,100,0,6
31252,1,2316,2433,-117,0,373,0,6
31253,1,2684,2538,146,0,40,0,6
31254,2,2378,2547,-169,0,246,0,6
31255,1,2202,2494,-292,0,303,0,6
31256,3,2560,2373,187,0,120,0,6
31257,1,2356,2500,-144,0,267,0,6
31258,2,2416,2555,-139,0,4,0,6
31259,1,2474,2456,18,0,301,1,6
31260,2,2429,2504,-75,0,127,0,6
31261,1,2598,2554,44,0,325,0,6
31262,1,2421,2337,84,0,40,0,6
31263,1,2408,2402,6,0,46,0,6
31264,1,2438,2424,14,0,276,0,6
31265,1,2441,2310,131,0,49,1,6
31266,1,2516,2386,130,0,103,0,6
31267,1,2741,2449,292,0,4,0,6
31268,2,2405,2625,-220,0,4,0,6
31269,2,2323,2467,-144,0,0,0,6
31270,1,2275,2648,-373,0,200,0,6
31271,1,2400,2431,-31,0,307,0,6
31272,1,2488,2419,69,0,46,1,6
31273,1,2652,2434,218,0,134,0,6
31274,1,2411,2249,162,4,56,1,13
31275,1,2444,2386,58,0,242,0,6
31276,3,2403,2336,67,0,0,0,6
31277,3,2432,2343,89,0,107,0,6
31278,2,2421,2429,-8,0,102,0,6
31279,1,2326,2415,-89,0,7,0,6
31280,1,2457,2339,118,0,107,0,6
31281,1,2384,2436,-52,0,4,1,6
31282,2,2282,2692,-410,0,48,0,6
31283,2,2381,2422,-41,0,4,0,6
31284,2,2263,2531,-268,0,100,1,6
31285,1,2519,2474,45,0,0,0,6
31286,1,2457,2207,250,0,67,0,6
31287,1,2437,2202,235,0,335,0,6
31288,2,2397,2461,-64,0,211,1,6
31289,1,2483,2335,148,0,112,0,6
31290,3,2539,2432,107,0,192,0,6
31291,2,2338,2464,-126,0,121,0,6
31292,1,2397,2484,-87,0,206,0,6
31293,1,2634,2270,364,0,140,0,6
31295,2,2428,2314,114,0,101,0,6
31296,1,2218,2403,-185,0,463,1,6
31297,1,2445,2564,-119,0,6,0,6
31298,1,2415,2334,81,0,122,1,6
31299,2,2210,2404,-194,0,51,0,6
31300,2,2335,2501,-166,0,103,0,6
31301,1,2407,2343,64,0,13,0,6
31302,2,2440,2265,175,0,260,1,6
31303,2,2229,2441,-212,0,0,0,6
31304,1,2246,2475,-229,0,14,0,6
31305,1,2493,2368,125,0,101,0,6
31306,1,2477,2445,32,0,15,1,6
31307,2,2559,2468,91,0,4,0,6
31308,1,2689,2667,22,0,80,1,6
31309,3,2532,2622,-90,0,304,0,6
31310,1,2525,2379,146,0,219,1,6
31311,1,2500,2215,285,0,267,1,6
31312,1,2400,2261,139,0,123,0,6
31313,2,2372,2481,-109,0,321,0,6
31315,2,2271,2512,-241,0,107,0,6
31316,2,2470,2495,-25,0,255,0,6
31317,2,2230,2670,-440,0,101,0,6
31318,2,2452,2346,106,0,228,0,6
31319,2,2259,2557,-298,0,6,0,6
31320,2,2510,2547,-37,0,103,0,6
31321,1,2491,2238,253,0,248,1,6
31322,2,2439,2308,131,0,132,0,6
31323,1,2416,2433,-17,0,132,1,6
31324,2,2262,2531,-269,0,372,0,6
31325,2,2510,2289,221,0,303,0,6
31326,3,2292,2404,-112,0,114,0,6
31327,1,2434,2440,-6,0,1,0,6
31328,2,2565,2451,114,0,265,0,6
31329,1,2561,2417,144,0,134,0,6
31330,1,2470,2565,-95,0,101,0,6
31331,1,2325,2402,-77,0,140,1,6
31332,1,2425,2433,-8,0,330,0,6
31333,2,2445,2458,-13,0,302,0,6
31334,1,2549,2310,239,0,250,1,6
31335,1,2276,2434,-158,0,112,0,6
31336,1,2429,2294,135,0,315,1,6
31338,1,2418,2385,33,0,190,0,6
31339,3,2425,2639,-214,0,40,0,6
31340,1,2568,2276,292,0,176,0,6
31341,1,2457,2427,30,0,6,0,6
31342,1,2499,2291,208,0,343,0,6
31343,1,2492,2422,70,0,201,1,6
31344,1,2482,2405,77,0,150,0,6
31345,1,2443,2414,29,0,0,0,6
31346,1,2449,2364,85,0,250,1,6
31347,2,2337,2493,-156,0,242,0,6
31348,2,2281,2537,-256,0,40,0,6
31349,3,2335,2465,-130,0,40,0,6
31350,1,2491,2486,5,0,44,0,6
31351,1,2693,2602,91,0,5,1,6
31352,3,2424,2334,90,0,130,0,6
31353,1,2527,2551,-24,0,15,0,6
31354,3,2478,2635,-157,0,106,0,6
31355,2,2538,2501,37,0,453,0,6
31356,2,2433,2669,-236,0,461,0,6
31357,1,2464,2337,127,0,110,0,6
31358,1,2472,2383,89,0,125,0,6
31359,2,2370,2405,-35,0,301,0,6
31360,1,2501,2221,280,0,345,0,6
31361,2,2420,2576,-156,0,122,0,6
31362,2,2239,2423,-184,0,110,0,6
31363,2,2433,2423,10,0,47,0,6
31364,1,2395,2402,-7,0,120,0,6
31365,1,2516,2540,-24,0,302,0,6
31366,1,2320,2405,-85,0,102,0,6
31367,1,2273,2453,-180,0,0,1,6
31368,1,2639,2397,242,0,0,0,6
31369,2,2573,2387,186,0,210,0,6
31370,3,2466,2334,132,0,106,0,6
31371,1,2270,2569,-299,0,112,0,6
31372,1,2411,2446,-35,0,337,1,6
31373,2,2441,2424,17,0,484,0,6
31374,2,2402,2373,29,0,292,0,6
31375,2,2369,2451,-82,0,160,1,6
31376,1,2524,2425,99,0,201,0,6
31377,2,2476,2509,-33,0,41,0,6
31378,2,2425,2344,81,0,5,0,6
31379,2,2450,2380,70,0,455,0,6
31380,1,2467,2490,-23,0,5,0,6
31381,1,2325,2608,-283,0,48,0,6
31382,1,2258,2426,-168,0,45,1,6
31383,1,2690,2743,-53,0,300,0,6
31384,1,2447,2529,-82,0,104,0,6
31385,1,2404,2384,20,0,100,1,6
31386,1,2530,2430,100,0,335,0,6
31387,2,2603,2562,41,0,7,0,6
31388,1,2618,2364,254,0,133,0,6
31390,2,2335,2417,-82,0,136,1,6
31391,1,2502,2386,116,0,3,0,6
31392,2,2577,2599,-22,0,45,0,6
31393,1,2514,2273,241,0,110,0,6
31394,2,2523,2249,274,0,112,0,6
31395,2,2361,2439,-78,0,337,1,6
31396,2,2356,2600,-244,0,200,0,6
31397,1,2355,2493,-138,0,454,0,6
31398,2,2479,2540,-61,0,304,0,6
31400,1,2242,2409,-167,0,380,1,6
31401,1,2487,2368,119,0,101,0,6
31402,1,2374,2456,-82,0,102,0,6
31403,2,2485,2607,-122,0,123,0,6
31404,1,2490,2580,-90,0,142,0,6
31405,1,2495,2490,5,0,301,1,6
31406,2,2307,2449,-142,0,456,0,6
31407,2,2466,2355,111,0,300,1,6
31408,2,2395,2641,-246,0,40,0,6
31409,1,2360,2420,-60,0,426,0,6
31410,2,2406,2285,121,0,45,1,6
31411,2,2225,2635,-410,0,412,1,6
31412,1,2442,2347,95,0,130,0,6
31413,2,2475,2504,-29,0,156,0,6
31414,2,2412,2380,32,0,120,0,6
31415,1,2482,2257,225,0,123,0,6
31416,1,2433,2439,-6,0,211,0,6
31417,2,2227,2524,-297,0,141,0,6
31418,2,2469,2564,-95,0,484,0,6
31419,2,2223,2445,-222,0,106,0,6
31420,2,2410,2587,-177,0,46,0,6
31421,2,2413,2607,-194,0,343,0,6
31422,2,2466,2416,50,0,122,0,6
31423,1,2527,2427,100,0,45,1,6
31424,2,2268,2491,-223,0,45,0,6
31425,2,2627,2635,-8,0,112,0,6
31426,2,2364,2403,-39,0,341,0,6
31427,2,2490,2501,-11,0,453,0,6
31429,2,2509,2324,185,0,49,0,6
31430,2,2425,2332,93,0,140,1,6
31431,2,2509,2339,170,0,15,0,6
31432,3,2303,2403,-100,0,302,0,6
31433,2,2362,2457,-95,0,106,1,6
31434,2,2354,2551,-197,0,8,0,6
31435,2,2365,2496,-131,0,154,0,6
31436,2,2607,2589,18,0,43,0,6
31437,1,2596,2510,86,0,101,0,6
31438,1,2513,2415,98,0,406,0,6
31439,3,2671,2533,138,0,5,0,6
31440,2,2620,2535,85,0,4,0,6
31441,2,2307,2409,-102,0,41,0,6
31442,1,2286,2408,-122,0,39,0,6
31443,1,2461,2235,226,0,29,0,6
31444,2,2549,2557,-8,0,201,0,6
31445,1,2516,2439,77,0,248,0,6
31446,1,2363,2415,-52,0,305,0,6
31447,1,2422,2452,-30,0,136,0,6
31448,2,2239,2443,-204,0,271,1,6
31449,2,2338,2464,-126,0,133,0,6
31450,2,2409,2420,-11,0,131,0,6
31451,2,2407,2387,20,0,266,1,6
31452,2,2506,2431,75,0,3,0,6
31453,2,2317,2419,-102,0,15,0,6
31454,1,2433,2304,129,0,83,0,6
31455,2,2470,2534,-64,0,202,1,6
31456,2,2443,2423,20,0,100,0,6
31457,2,2473,2437,36,0,125,0,6
31458,2,2533,2603,-70,0,300,0,6
31459,1,2403,2261,142,0,115,0,6
31460,1,2579,2289,290,0,102,0,6
31461,2,2704,2451,253,0,191,1,6
31462,1,2406,2343,63,0,107,0,6
31463,2,2520,2529,-9,0,236,1,6
31464,1,2453,2375,78,0,0,0,6
31465,1,2427,2444,-17,0,0,1,6
31466,1,2377,2437,-60,0,300,0,6
31467,2,2259,2456,-197,0,100,1,8
31468,1,2557,2314,243,0,110,0,6
31469,2,2388,2541,-153,0,106,0,6
31470,1,2283,2453,-170,0,49,1,6
31471,2,2220,2491,-271,0,8,0,6
31472,1,2444,2409,35,0,125,1,6
31473,1,2414,2340,74,0,167,1,6
31474,2,2406,2367,39,0,424,1,6
31475,3,2537,2341,196,0,4,0,6
31476,2,2355,2449,-94,0,110,1,6
31477,1,2351,2451,-100,0,40,0,6
31478,1,2449,2360,89,0,0,0,6
31479,1,2408,2501,-93,0,46,0,6
31480,1,2627,2550,77,0,278,0,6
31481,1,2325,2569,-244,0,341,0,6
31482,2,2426,2230,196,0,462,1,6
31483,1,2558,2380,178,0,5,0,6
31484,1,2534,2572,-38,0,212,0,6
31485,2,2515,2382,133,0,211,1,6
31486,1,2595,2451,144,0,122,1,6
31487,2,2601,2479,122,0,35,0,6
31488,2,2458,2558,-100,0,84,0,6
31489,2,2449,2557,-108,0,41,1,6
31490,1,2654,2492,162,0,145,0,6
31491,2,2401,2414,-13,0,353,1,6
31492,2,2401,2430,-29,0,267,0,6
31493,1,2425,2269,156,0,106,0,6
31494,2,2535,2688,-153,0,40,0,6
31495,1,2433,2224,209,0,13,1,6
31496,1,2516,2440,76,0,106,1,6
31497,1,2307,2571,-264,0,110,0,6
31498,2,2576,2396,180,0,200,0,6
31499,2,2339,2546,-207,0,5,1,6
31500,2,2430,2267,163,0,17,0,6
31501,1,2610,2493,117,0,124,0,6
31502,3,2422,2239,183,0,265,0,6
31503,3,2411,2376,35,0,48,0,6
31504,2,2554,2587,-33,0,190,0,6
31505,2,2408,2611,-203,0,302,0,6
31506,1,2569,2481,88,0,320,0,6
31507,1,2691,2327,364,0,102,0,6
31508,2,2336,2599,-263,0,45,1,6
31509,1,2532,2521,11,0,315,0,6
31510,1,2452,2413,39,0,44,0,6
31511,1,2415,2206,209,0,200,0,6
31512,2,2459,2207,252,0,4,0,6
31513,2,2444,2378,66,0,0,1,6
31514,1,2468,2448,20,0,102,0,6
31515,2,2409,2341,68,0,300,0,6
31516,1,2485,2255,230,0,400,0,6
31517,2,2422,2435,-13,0,110,0,6
31519,1,2282,2407,-125,0,8,0,6
31520,1,2605,2341,264,0,15,0,6
31521,1,2289,2412,-123,0,123,0,6
31522,1,2479,2268,211,0,190,1,6
31523,3,2358,2473,-115,0,106,0,6
31524,3,2404,2445,-41,0,113,0,6
31525,2,2292,2507,-215,0,15,1,6
31526,1,2769,2573,196,0,150,0,6
31527,3,2306,2503,-197,0,140,0,6
31528,3,2477,2447,30,0,246,0,6
31529,2,2525,2511,14,0,122,0,6
31530,3,2506,2465,41,0,110,0,6
31531,1,2447,2279,168,0,484,0,6
31532,2,2292,2605,-313,0,206,0,6
31533,1,2568,2601,-33,0,241,0,6
31534,2,2316,2415,-99,0,4,0,6
31535,2,2435,2366,69,0,61,1,6
31536,2,2427,2545,-118,0,103,0,6
31537,3,2524,2275,249,0,113,0,6
31538,2,2233,2549,-316,0,0,0,6
31539,1,2500,2519,-19,0,6,0,6
31540,1,2422,2203,219,0,203,0,6
31541,2,2427,2453,-26,0,18,0,6
31542,3,2305,2493,-188,0,302,0,6
31543,2,2481,2220,261,0,112,0,6
31544,1,2539,2528,11,0,302,0,6
31545,1,2558,2608,-50,0,345,0,6
31546,2,2493,2496,-3,0,123,0,6
31547,1,2633,2437,196,0,5,0,6
31548,1,2474,2697,-223,0,245,0,6
31549,1,2480,2286,194,0,145,0,6
31550,1,2278,2457,-179,0,154,0,6
31551,2,2477,2736,-259,0,0,0,6
31552,1,2445,2255,190,0,106,0,6
31553,3,2480,2278,202,0,100,0,6
31554,1,2337,2467,-130,0,6,1,6
31555,1,2440,2390,50,0,415,0,6
31556,2,2485,2499,-14,0,0,0,6
31557,2,2234,2414,-180,0,106,0,6
31558,3,2335,2432,-97,0,48,0,6
31559,2,2566,2428,138,0,100,0,6
31560,2,2336,2540,-204,0,28,1,6
31561,1,2466,2393,73,0,108,0,6
31562,1,2662,2450,212,0,218,0,6
31563,2,2380,2420,-40,0,242,0,6
31564,2,2350,2551,-201,0,47,1,6
31565,1,2557,2363,194,0,7,0,6
31566,3,2605,2402,203,0,4,0,6
31567,1,2466,2395,71,0,107,1,6
31568,1,2242,2445,-203,0,310,1,6
31569,1,2528,2418,110,0,108,1,6
31570,1,2463,2403,60,0,102,0,6
31571,1,2351,2471,-120,0,327,0,6
31572,2,2455,2514,-59,0,42,0,6
31573,2,2390,2570,-180,0,1,0,6
31574,1,2453,2463,-10,0,200,0,6
31575,2,2266,2426,-160,0,122,0,6
31576,1,2418,2277,141,0,220,0,6
31577,2,2431,2399,32,0,156,1,6
31578,1,2562,2497,65,0,43,0,6
31579,1,2429,2283,146,0,140,0,6
31580,2,2471,2502,-31,0,101,0,6
31581,2,2232,2416,-184,0,112,0,6
31582,2,2379,2579,-200,0,1,0,6
31583,1,2439,2561,-122,0,125,0,6
31584,2,2470,2518,-48,0,203,0,6
31585,2,2281,2434,-153,0,196,0,6
31586,2,2363,2473,-110,0,40,0,6
31587,1,2485,2374,111,0,110,1,6
31588,1,2459,2449,10,0,130,0,6
31589,2,2433,2460,-27,0,101,1,6
31590,1,2440,2227,213,0,45,0,6
31591,1,2590,2593,-3,0,302,0,6
31592,3,2423,2329,94,0,247,0,6
31593,1,2487,2407,80,0,212,0,6
31594,1,2210,2419,-209,0,86,0,6
31595,1,2426,2266,160,0,45,0,6
31596,1,2479,2356,123,0,123,0,6
31597,2,2232,2502,-270,0,0,0,6
31598,1,2475,2381,94,0,165,0,6
31599,1,2489,2334,155,0,156,0,6
31601,2,2522,2266,256,0,46,1,6
31602,1,2494,2454,40,0,110,0,6
31603,1,2281,2468,-187,0,106,1,6
31604,2,2302,2602,-300,0,125,0,6
31605,1,2284,2419,-135,0,255,0,6
31606,1,2545,2551,-6,0,106,0,6
31607,1,2513,2218,295,0,454,0,6
31608,2,2207,2406,-199,0,125,0,6
31609,2,2423,2385,38,0,170,0,6
31610,2,2257,2539,-282,0,0,1,6
31611,2,2255,2482,-227,0,4,0,6
31612,2,2477,2473,4,0,46,0,6
31613,1,2320,2431,-111,0,306,0,6
31614,1,2401,2401,0,0,176,0,6
31615,1,2534,2270,264,0,121,0,6
31616,2,2394,2487,-93,0,145,0,6
31617,2,2388,2470,-82,0,200,0,6
31618,1,2344,2464,-120,0,459,1,6
31619,3,2672,2613,59,0,190,0,6
31620,3,2430,2363,67,0,331,0,6
31621,2,2330,2444,-114,0,46,0,6
31622,1,2543,2325,218,0,4,0,6
31623,1,2549,2298,251,0,358,0,6
31624,1,2413,2405,8,0,10,0,6
31625,1,2377,2476,-99,0,402,0,6
31626,1,2400,2366,34,0,263,0,6
31627,1,2443,2474,-31,0,10,0,6
31628,2,2237,2464,-227,0,127,0,6
31629,1,2340,2453,-113,0,122,0,6
31630,2,2364,2658,-294,0,324,0,6
31631,2,2437,2297,140,0,453,0,6
31632,2,2497,2384,113,0,437,0,6
31633,3,2595,2358,237,0,244,0,6
31634,1,2698,2410,288,0,153,0,6
31635,1,2355,2425,-70,0,140,0,6
31636,2,2200,2441,-241,0,1,0,6
31637,2,2418,2414,4,0,145,0,6
31638,2,2225,2545,-320,0,201,0,6
31639,2,2464,2526,-62,0,388,0,6
31640,1,2351,2417,-66,0,100,0,6
31641,2,2523,2561,-38,0,300,0,6
31642,2,2445,2317,128,0,44,0,6
31643,2,2598,2554,44,0,112,0,6
31644,1,2490,2305,185,0,83,0,6
31645,2,2332,2567,-235,0,345,0,6
31646,1,2691,2531,160,0,211,0,6
31647,2,2475,2310,165,0,161,0,6
31648,1,2447,2297,150,0,15,1,6
31649,2,2298,2453,-155,0,40,0,6
31650,2,2466,2575,-109,0,31,0,6
31651,1,2602,2429,173,0,304,0,6
31652,1,2505,2358,147,0,301,0,6
31653,1,2496,2364,132,0,45,0,6
31654,1,2559,2310,249,0,122,0,6
31655,2,2417,2357,60,0,154,0,6
31656,1,2440,2440,0,0,337,0,6
31657,2,2339,2444,-105,0,4,0,6
31658,2,2417,2417,0,0,6,0,6
31659,2,2545,2643,-98,0,106,0,6
31660,3,2493,2573,-80,0,211,0,6
31661,3,2331,2444,-113,0,404,0,6
31662,1,2455,2222,233,0,311,0,6
31663,2,2406,2325,81,0,150,1,6
31664,1,2496,2408,88,0,8,0,8
31665,1,2432,2426,6,0,36,0,6
31666,1,2589,2362,227,0,487,0,6
31667,1,2536,2300,236,0,41,0,6
31668,2,2500,2669,-169,0,30,1,6
31669,2,2222,2418,-196,0,1,0,6
31670,2,2325,2497,-172,0,31,0,6
31671,1,2459,2459,0,0,40,0,6
31672,2,2266,2444,-178,0,331,0,6
31673,2,2563,2564,-1,0,15,1,6
31674,1,2211,2471,-260,0,123,0,6
31675,1,2484,2218,266,0,101,0,6
31676,1,2450,2454,-4,0,338,0,6
31677,2,2327,2422,-95,0,41,0,6
31678,1,2419,2446,-27,0,106,0,6
31679,2,2546,2632,-86,0,172,0,6
31680,2,2265,2543,-278,0,200,1,6
31681,1,2563,2243,320,0,201,0,6
31682,1,2659,2341,318,0,241,0,6
31683,1,2504,2607,-103,0,3,0,6
31684,1,2485,2465,20,0,140,0,6
31685,1,2641,2558,83,0,209,0,6
31686,1,2622,2561,61,0,106,0,6
31687,2,2738,2688,50,0,14,0,6
31688,1,2475,2483,-8,0,111,1,6
31689,2,2549,2693,-144,0,400,0,6
31690,1,2516,2336,180,0,310,0,6
31691,2,2224,2551,-327,0,115,0,6
31692,1,2377,2537,-160,0,106,0,6
31693,1,2387,2469,-82,0,260,0,6
31694,2,2426,2404,22,0,216,0,6
31695,2,2503,2465,38,0,211,1,6
31696,2,2435,2521,-86,0,302,0,6
31697,2,2205,2531,-326,0,112,1,6
31698,1,2447,2420,27,0,15,0,6
31699,2,2229,2596,-367,0,4,0,6
31700,2,2394,2599,-205,0,460,0,6
31701,1,2606,2423,183,0,46,1,6
31703,2,2300,2561,-261,0,140,1,6
31704,2,2552,2504,48,0,4,0,6
31705,1,2401,2234,167,0,484,0,6
31706,1,2507,2446,61,0,46,1,6
31707,2,2421,2440,-19,0,120,0,6
31708,1,2333,2404,-71,0,301,0,6
31709,3,2344,2459,-115,0,405,0,6
31710,1,2350,2488,-138,0,45,0,6
31712,1,2600,2436,164,0,100,0,6
31714,3,2539,2567,-28,0,410,0,6
31715,1,2437,2467,-30,0,45,0,6
31716,2,2549,2695,-146,0,4,0,6
31717,1,2373,2400,-27,0,469,0,6
31718,2,2422,2537,-115,0,241,1,6
31719,1,2488,2443,45,0,45,0,6
31720,2,2361,2407,-46,0,122,1,6
31721,2,2502,2594,-92,0,168,0,6
31722,1,2489,2391,98,0,11,1,6
31723,2,2443,2416,27,0,41,0,6
31724,2,2320,2441,-121,0,7,1,6
31725,1,2494,2244,250,0,115,1,6
31726,1,2402,2265,137,0,127,0,6
31727,2,2249,2455,-206,0,484,0,6
31728,2,2515,2305,210,0,178,1,6
31729,2,2216,2481,-265,0,34,0,6
31730,1,2467,2419,48,0,46,0,6
31731,2,2493,2209,284,0,302,1,6
31732,2,2346,2418,-72,0,122,1,6
31733,2,2433,2424,9,0,4,1,6
31734,1,2443,2253,190,0,203,0,6
31735,1,2420,2284,136,0,4,0,6
31736,1,2352,2462,-110,0,106,1,6
31737,1,2490,2343,147,0,46,0,6
31738,1,2403,2265,138,0,458,0,6
31739,2,2367,2449,-82,0,474,1,6
31740,1,2772,2499,273,0,100,0,6
31741,3,2636,2519,117,0,8,0,6
31742,2,2333,2514,-181,0,108,0,6
31743,2,2447,2229,218,0,125,0,6
31744,1,2449,2535,-86,0,277,0,6
31745,2,2438,2446,-8,0,190,0,6
31746,2,2570,2286,284,0,335,0,6
31747,2,2435,2419,16,0,7,0,6
31748,1,2549,2310,239,0,7,0,6
31749,1,2461,2412,49,0,140,0,6
31750,2,2495,2286,209,0,40,0,6
31751,2,2333,2695,-362,0,100,0,6
31752,2,2224,2419,-195,0,4,1,6
31753,2,2233,2401,-168,0,337,1,6
31754,1,2404,2479,-75,0,405,0,6
31755,1,2637,2350,287,0,44,0,6
31756,1,2477,2362,115,0,80,0,6
31757,1,2418,2353,65,0,145,0,6
31758,1,2394,2414,-20,0,123,1,6
31759,1,2301,2506,-205,0,133,0,6
31760,3,2254,2447,-193,0,106,0,6
31761,2,2311,2477,-166,0,130,0,6
31762,2,2372,2436,-64,0,133,0,6
31763,2,2329,2494,-165,0,132,0,6
31764,1,2436,2445,-9,0,120,0,6
31765,1,2491,2207,284,0,143,0,6
31766,2,2498,2507,-9,0,197,0,6
31767,2,2476,2483,-7,0,104,0,6
31768,1,2582,2273,309,0,190,0,6
31769,1,2248,2486,-238,0,4,1,6
31770,1,2345,2432,-87,0,381,0,6
31771,3,2201,2487,-286,0,245,0,6
31772,1,2504,2255,249,0,386,0,6
31773,1,2453,2517,-64,0,335,0,6
31774,3,2421,2361,60,0,156,0,6
31775,1,2531,2541,-10,0,227,0,6
31776,1,2459,2509,-50,0,40,0,6
31777,2,2449,2472,-23,0,125,0,6
31778,2,2454,2229,225,0,242,1,6
31779,3,2402,2353,49,0,315,0,6
31780,1,2556,2339,217,0,30,1,6
31781,1,2246,2429,-183,0,113,0,6
31782,2,2200,2465,-265,0,469,0,6
31783,1,2408,2451,-43,0,350,0,6
31784,2,2341,2405,-64,0,49,0,6
31785,1,2601,2268,333,0,129,0,6
31786,1,2543,2417,126,0,103,0,6
31787,2,2509,2369,140,0,202,1,6
31788,3,2217,2521,-304,0,101,0,6
31789,2,2404,2523,-119,0,3,0,6
31790,1,2351,2426,-75,0,83,0,6
31791,1,2366,2440,-74,0,201,0,6
31792,2,2414,2367,47,0,4,0,6
31793,2,2398,2532,-134,0,15,1,6
31794,1,2471,2368,103,0,46,1,6
31795,2,2441,2393,48,0,6,1,6
31796,2,2269,2525,-256,0,218,1,6
31797,3,2278,2521,-243,0,201,0,6
31798,2,2285,2423,-138,0,120,0,6
31799,2,2510,2385,125,0,110,0,6
31800,3,2603,2529,74,0,107,0,6
31801,1,2732,2405,327,0,4,0,6
31802,1,2600,2216,384,0,317,0,6
31803,2,2413,2432,-19,0,250,0,6
31804,2,2366,2471,-105,0,13,0,6
31805,2,2449,2436,13,0,225,0,6
31806,2,2241,2405,-164,0,110,0,6
31807,2,2233,2564,-331,0,34,0,6
31808,1,2608,2462,146,0,115,0,6
31809,1,2579,2502,77,0,145,0,6
31810,2,2269,2480,-211,0,218,0,6
31811,3,2480,2459,21,0,56,0,6
31812,1,2352,2428,-76,0,102,1,6
31813,1,2246,2410,-164,4,406,0,13
31814,2,2360,2470,-110,0,140,1,6
31815,1,2457,2459,-2,0,104,0,6
31816,2,2283,2401,-118,0,484,0,6
31817,2,2460,2460,0,0,140,1,6
31818,1,2584,2545,39,0,190,0,6
31819,2,2355,2466,-111,0,140,0,6
31820,1,2297,2507,-210,0,0,0,6
31821,3,2613,2399,214,0,167,0,6
31822,1,2272,2419,-147,0,41,0,6
31823,1,2525,2323,202,0,112,0,6
31824,1,2697,2538,159,0,244,0,6
31825,2,2574,2242,332,0,101,0,6
31826,2,2411,2486,-75,0,394,1,6
31827,2,2408,2520,-112,0,302,0,6
31828,2,2570,2700,-130,0,17,0,6
31829,1,2560,2453,107,0,398,0,6
31830,2,2414,2591,-177,0,277,0,6
31831,1,2409,2476,-67,0,117,0,6
31832,2,2446,2510,-64,0,4,0,6
31833,1,2411,2325,86,0,418,0,6
31834,1,2606,2551,55,0,302,1,6
31835,1,2456,2537,-81,0,0,0,6
31836,1,2277,2426,-149,0,106,0,6
31837,1,2268,2406,-138,0,13,1,6
31838,2,2489,2382,107,0,134,0,6
31839,1,2281,2416,-135,0,200,0,6
31840,1,2599,2344,255,0,15,0,6
31841,2,2445,2512,-67,0,241,1,6
31842,2,2253,2441,-188,0,463,0,6
31843,2,2553,2513,40,0,45,0,6
31844,1,2671,2327,344,0,118,0,6
31845,2,2275,2614,-339,0,150,0,6
31846,1,2446,2423,23,0,43,0,6
31847,1,2462,2382,80,0,245,0,6
31848,2,2466,2491,-25,0,136,0,6
31849,1,2546,2220,326,0,250,0,6
31850,2,2403,2557,-154,0,80,0,6
31851,1,2327,2407,-80,0,300,0,6
31852,1,2448,2348,100,0,123,0,6
31853,2,2446,2423,23,0,332,0,6
31854,3,2416,2335,81,0,244,0,6
31855,2,2409,2373,36,0,247,0,6
31856,2,2259,2552,-293,0,0,0,6
31857,2,2376,2466,-90,0,14,0,6
31858,2,2546,2695,-149,0,4,0,6
31859,1,2569,2293,276,0,40,0,6
31860,3,2204,2513,-309,0,46,0,6
31861,2,2457,2627,-170,0,151,0,6
31862,2,2527,2557,-30,0,104,0,6
31863,2,2448,2354,94,0,337,0,6
31864,2,2417,2359,58,0,0,1,6
31865,2,2289,2428,-139,0,205,0,6
31866,2,2426,2497,-71,0,154,0,6
31867,2,2598,2612,-14,0,4,0,6
31868,1,2459,2605,-146,0,9,0,6
31869,1,2406,2270,136,0,8,0,6
31870,1,2481,2489,-8,0,45,1,6
31871,1,2492,2380,112,0,231,1,6
31872,2,2672,2661,11,0,154,1,6
31873,1,2447,2308,139,0,434,1,6
31874,2,2425,2238,187,0,122,0,6
31875,1,2695,2561,134,0,300,0,6
31876,1,2609,2429,180,0,123,0,6
31877,2,2296,2439,-143,0,244,0,6
31878,1,2330,2429,-99,0,48,0,6
31879,1,2426,2517,-91,0,100,0,6
31880,1,2449,2373,76,0,43,0,6
31881,2,2502,2385,117,0,45,0,6
31882,1,2456,2466,-10,0,343,0,6
31883,2,2566,2423,143,0,210,0,6
31884,2,2302,2480,-178,0,45,0,6
31885,3,2518,2427,91,0,300,0,6
31886,2,2325,2496,-171,0,103,1,6
31887,1,2459,2256,203,0,0,0,8
31888,1,2525,2462,63,0,200,0,6
31889,1,2535,2227,308,0,7,0,6
31890,2,2286,2639,-353,0,200,0,6
31891,2,2319,2424,-105,0,56,1,6
31892,2,2282,2496,-214,0,203,1,6
31893,2,2247,2493,-246,0,203,0,6
31894,2,2444,2391,53,0,140,0,6
31895,1,2480,2412,68,0,200,0,6
31896,1,2349,2458,-109,0,45,0,6
31897,2,2429,2310,119,0,311,0,6
31898,2,2514,2498,16,0,0,1,6
31899,1,2602,2486,116,0,106,0,6
31900,2,2348,2485,-137,0,253,1,6
31901,1,2598,2391,207,0,39,0,6
31902,2,2322,2469,-147,0,28,0,6
31903,2,2402,2489,-87,0,102,0,6
31904,2,2323,2610,-287,0,125,0,6
31905,3,2700,2547,153,0,200,0,6
31906,1,2411,2325,86,0,118,0,6
31907,2,2454,2382,72,0,100,0,6
31908,1,2535,2545,-10,0,10,0,6
31909,1,2280,2470,-190,0,434,0,6
31910,2,2607,2672,-65,0,5,0,6
31911,3,2413,2385,28,0,395,0,6
31912,1,2636,2542,94,0,405,1,6
31913,2,2388,2445,-57,0,332,0,6
31914,1,2371,2425,-54,0,343,0,6
31915,1,2541,2529,12,0,199,0,6
31916,2,2252,2431,-179,0,380,0,6
31917,1,2648,2471,177,0,1,0,6
31918,2,2250,2466,-216,0,300,0,6
31919,2,2446,2603,-157,0,203,0,6
31920,1,2446,2365,81,0,269,1,6
31922,2,2213,2483,-270,0,14,0,6
31923,2,2392,2489,-97,0,300,0,6
31924,1,2469,2316,153,0,100,1,6
31925,1,2594,2445,149,0,129,0,6
31926,2,2421,2537,-116,0,243,0,6
31927,1,2535,2502,33,0,122,0,6
31928,3,2553,2324,229,0,115,0,6
31929,3,2481,2589,-108,0,0,0,6
31930,1,2540,2214,326,0,246,0,6
31931,2,2304,2460,-156,0,106,1,6
31932,1,2433,2477,-44,0,108,0,6
31933,2,2430,2443,-13,0,49,0,6
31934,2,2262,2423,-161,0,106,0,6
31935,2,2467,2449,18,0,102,1,6
31936,2,2614,2305,309,0,50,0,6
31937,1,2402,2236,166,0,302,1,6
31938,1,2329,2437,-108,0,40,0,6
31939,1,2439,2561,-122,0,241,0,6
31940,2,2306,2442,-136,0,0,0,6
31941,2,2433,2552,-119,0,200,0,6
31942,1,2442,2269,173,0,107,0,6
31943,2,2384,2444,-60,0,145,0,6
31944,2,2402,2253,149,4,202,0,13
31945,1,2673,2309,364,0,330,0,6
31946,3,2497,2243,254,0,485,0,6
31948,2,2513,2591,-78,0,247,0,6
31949,2,2597,2566,31,0,43,0,6
31950,2,2408,2240,168,0,101,1,6
31951,1,2498,2495,3,0,40,0,6
31952,1,2583,2467,116,0,112,0,6
31953,2,2253,2681,-428,0,263,0,6
31954,2,2403,2289,114,0,255,0,6
31955,2,2393,2703,-310,0,469,0,6
31956,2,2406,2459,-53,0,426,0,6
31957,3,2431,2398,33,0,4,0,6
31958,1,2235,2471,-236,0,10,1,6
31959,1,2410,2362,48,0,0,0,6
31960,2,2411,2359,52,0,153,1,6
31961,2,2438,2421,17,0,302,0,6
31962,3,2401,2283,118,0,46,0,6
31963,1,2410,2420,-10,0,131,0,6
31964,1,2418,2341,77,0,10,0,6
31965,2,2441,2298,143,0,456,0,6
31966,1,2566,2517,49,0,101,0,6
31967,1,2249,2493,-244,0,335,0,6
31968,1,2563,2367,196,0,4,1,6
31969,3,2377,2545,-168,0,354,0,6
31970,1,2478,2527,-49,0,210,0,6
31971,2,2497,2522,-25,0,253,0,6
31972,1,2565,2328,237,0,123,0,6
31973,1,2520,2352,168,0,302,0,6
31974,1,2562,2774,-212,0,107,1,6
31975,1,2425,2347,78,0,335,1,6
31976,2,2294,2547,-253,0,113,1,6
31977,1,2497,2404,93,0,107,0,6
31978,1,2524,2416,108,0,1,0,6
31979,1,2457,2461,-4,0,124,0,6
31980,1,2518,2282,236,0,110,1,6
31981,1,2470,2485,-15,0,404,0,6
31982,2,2407,2231,176,0,200,0,6
31983,3,2438,2601,-163,0,15,0,6
31984,2,2289,2602,-313,0,7,0,6
31985,1,2347,2506,-159,0,145,0,6
31986,1,2483,2225,258,0,110,0,6
31987,2,2299,2425,-126,0,153,0,6
31988,2,2404,2420,-16,0,122,0,8
31989,1,2453,2463,-10,0,200,0,6
31990,1,2442,2424,18,0,152,1,6
31991,1,2500,2483,17,0,132,0,6
31992,2,2327,2420,-93,0,345,0,6
31993,1,2618,2503,115,0,123,0,6
31994,3,2548,2593,-45,0,7,0,6
31995,2,2489,2420,69,0,300,0,6
31996,2,2442,2312,130,0,207,0,6
31997,1,2553,2404,149,0,46,0,6
31998,1,2415,2246,169,0,5,0,6
31999,2,2646,2734,-88,0,112,0,6
32000,1,2466,2435,31,0,270,1,6
32001,1,2423,2280,143,0,107,1,6
32002,2,2441,2408,33,0,145,1,6
32003,2,2239,2401,-162,0,10,0,6
32004,2,2366,2512,-146,0,374,0,6
32005,1,2421,2410,11,0,374,0,6
32006,3,2339,2405,-66,0,1,0,6
32007,2,2221,2459,-238,0,49,0,6
32008,1,2447,2348,99,0,330,0,6
32009,1,2603,2351,252,0,289,0,6
32010,3,2426,2634,-208,0,5,0,6
32011,1,2557,2612,-55,0,43,0,6
32012,2,2423,2328,95,0,105,1,6
32013,3,2470,2430,40,0,107,0,6
32014,2,2471,2372,99,0,47,1,6
32016,2,2541,2356,185,0,211,0,6
32017,1,2472,2297,175,0,20,0,6
32018,1,2454,2201,253,0,45,1,6
32019,2,2415,2359,56,0,308,0,6
32020,3,2427,2444,-17,0,333,0,6
32021,1,2441,2493,-52,0,121,0,6
32022,1,2486,2696,-210,0,395,0,6
32023,1,2400,2210,190,0,40,0,6
32024,2,2560,2598,-38,0,10,0,6
32025,2,2382,2500,-118,0,100,0,8
32027,1,2425,2381,44,0,200,0,6
32028,1,2271,2445,-174,0,101,0,6
32029,2,2370,2449,-79,0,218,1,6
32030,1,2475,2400,75,0,380,1,6
32031,2,2587,2542,45,0,189,1,6
32032,2,2383,2483,-100,0,101,0,6
32033,2,2335,2449,-114,0,122,0,6
32034,1,2408,2267,141,0,48,1,6
32035,2,2342,2463,-121,0,112,0,6
32036,1,2482,2466,16,0,123,0,6
32037,1,2330,2432,-102,0,200,1,6
32038,1,2430,2428,2,0,41,0,6
32039,1,2274,2416,-142,0,414,0,6
32040,1,2440,2243,197,0,104,1,6
32041,1,2504,2347,157,0,334,0,6
32042,1,2571,2508,63,0,40,0,6
32043,2,2339,2445,-106,0,46,0,6
32044,2,2276,2605,-329,0,48,0,6
32045,2,2587,2403,184,0,200,0,6
32046,3,2705,2610,95,0,40,0,6
32047,1,2384,2407,-23,0,40,0,6
32048,1,2406,2265,141,0,226,1,6
32049,2,2551,2651,-100,0,106,1,6
32050,1,2501,2208,293,0,130,0,6
32051,2,2630,2698,-68,0,260,1,6
32052,2,2277,2498,-221,0,0,1,6
32053,1,2247,2442,-195,0,263,0,6
32054,1,2293,2453,-160,0,102,1,6
32055,1,2509,2413,96,0,341,0,6
32056,2,2417,2357,60,0,242,0,6
32057,2,2409,2368,41,0,45,0,6
32058,2,2450,2358,92,0,0,0,6
32059,2,2419,2390,29,0,302,0,6
32060,2,2320,2483,-163,0,389,1,6
32061,1,2682,2516,166,0,241,0,6
32062,2,2257,2453,-196,0,6,0,6
32063,2,2207,2412,-205,0,125,0,6
32064,2,2460,2591,-131,0,461,0,6
32065,1,2573,2528,45,0,13,0,6
32066,3,2461,2381,80,0,40,0,6
32067,2,2354,2518,-164,0,441,0,6
32068,1,2452,2399,53,0,123,0,6
32069,2,2468,2466,2,0,140,0,6
32070,1,2293,2433,-140,0,250,0,6
32071,1,2327,2407,-80,4,203,1,13
32072,3,2430,2312,118,4,301,0,13
32073,3,2474,2356,118,0,312,0,6
32074,3,2438,2427,11,0,34,0,6
32075,2,2441,2257,184,0,8,1,6
32076,1,2270,2409,-139,0,40,0,6
32077,3,2530,2502,28,0,453,0,6
32078,1,2616,2493,123,0,15,1,6
32079,1,2602,2378,224,0,244,0,6
32080,1,2420,2364,56,0,112,1,6
32081,2,2242,2411,-169,0,282,1,6
32082,2,2459,2484,-25,0,464,0,6
32083,3,2554,2382,172,0,190,0,6
32085,1,2461,2399,62,0,5,0,6
32086,3,2356,2484,-128,0,45,0,6
32087,3,2415,2521,-106,0,300,0,6
32088,1,2424,2542,-118,0,102,1,6
32089,3,2321,2416,-95,0,138,0,6
32090,1,2592,2462,130,0,43,1,6
32091,1,2327,2402,-75,0,109,0,6
32092,2,2449,2549,-100,0,36,0,6
32093,2,2512,2546,-34,0,107,0,6
32094,2,2406,2400,6,0,143,0,6
32095,1,2528,2266,262,0,5,1,6
32096,1,2549,2492,57,0,67,0,6
32097,2,2227,2520,-293,0,45,0,6
32098,1,2461,2388,73,0,107,0,6
32099,2,2677,2698,-21,0,297,1,6
32100,2,2612,2487,125,0,4,0,6
32101,2,2528,2597,-69,0,101,0,6
32102,1,2530,2555,-25,0,202,0,6
32103,3,2429,2423,6,0,152,0,6
32104,1,2275,2438,-163,0,106,1,6
32105,2,2475,2459,16,0,48,0,6
32106,1,2352,2444,-92,0,1,0,6
32107,1,2698,2505,193,0,132,0,6
32108,1,2469,2440,29,0,107,0,6
32109,2,2225,2407,-182,0,312,1,6
32110,3,2400,2600,-200,0,145,0,6
32111,2,2344,2536,-192,0,106,0,6
32112,1,2467,2501,-34,0,6,0,6
32113,2,2338,2541,-203,0,242,0,6
32114,1,2497,2415,82,0,268,0,6
32115,1,2451,2399,52,0,7,0,6
32116,1,2474,2546,-72,0,280,1,6
32117,2,2233,2501,-268,0,300,0,6
32118,2,2438,2293,145,0,15,0,6
32119,1,2460,2241,219,0,107,0,6
32120,2,2291,2664,-373,0,101,0,6
32121,1,2422,2329,93,0,19,0,6
32122,2,2738,2541,197,0,5,0,6
32123,2,2539,2641,-102,0,13,0,6
32124,1,2667,2367,300,0,267,0,6
32125,2,2523,2547,-24,0,101,0,6
32126,1,2400,2333,67,0,463,0,6
32127,2,2429,2428,1,0,375,0,6
32128,1,2537,2640,-103,0,267,0,6
32129,2,2421,2464,-43,0,40,1,6
32130,2,2525,2250,275,0,200,0,6
32131,1,2603,2420,183,0,15,0,6
32132,1,2431,2404,27,0,226,1,6
32133,3,2541,2411,130,0,211,0,6
32134,1,2555,2418,137,0,459,1,6
32135,2,2603,2579,24,0,246,0,6
32136,3,2462,2367,95,0,4,0,6
32137,1,2434,2249,185,0,337,0,6
32138,3,2205,2549,-344,0,108,0,6
32139,1,2483,2337,146,0,267,0,6
32140,2,2363,2487,-124,0,100,0,6
32141,2,2280,2403,-123,0,143,1,6
32142,1,2485,2256,229,0,85,0,6
32143,1,2446,2277,169,0,107,0,6
32144,2,2400,2631,-231,0,49,0,6
32145,1,2415,2433,-18,0,248,0,6
32146,1,2472,2429,43,0,123,1,6
32147,2,2510,2385,125,0,103,0,6
32148,2,2255,2557,-302,0,202,1,6
32149,1,2497,2209,288,0,107,0,6
32150,3,2515,2485,30,0,337,0,6
32151,1,2393,2421,-28,0,13,0,6
32152,2,2427,2566,-139,0,113,0,6
32153,2,2431,2448,-17,0,129,1,6
32154,3,2472,2380,92,0,153,0,6
32155,1,2559,2274,285,0,115,0,6
32156,2,2487,2489,-2,0,483,0,6
32157,1,2229,2482,-253,0,101,0,6
32158,1,2394,2457,-63,0,310,0,6
32159,2,2248,2454,-206,0,112,0,6
32160,1,2457,2281,176,0,15,1,6
32161,1,2237,2450,-213,0,36,0,6
32162,3,2403,2381,22,0,110,0,6
32163,2,2388,2664,-276,0,80,0,6
32164,1,2441,2410,31,0,302,1,6
32165,2,2364,2605,-241,0,150,0,6
32166,2,2545,2472,73,0,341,0,6
32167,1,2351,2414,-63,0,106,1,6
32168,2,2408,2238,170,0,205,0,6
32169,1,2498,2306,192,0,303,0,6
32170,1,2403,2497,-94,0,461,1,6
32171,1,2450,2207,243,0,269,0,6
32172,2,2498,2362,136,0,201,0,6
32173,1,2451,2408,43,0,44,0,6
32174,1,2523,2499,24,0,1,1,6
32175,2,2578,2622,-44,0,4,0,6
32176,3,2607,2455,152,0,122,0,6
32177,2,2473,2435,38,0,113,1,6
32178,3,2423,2421,2,0,45,0,6
32179,2,2221,2460,-239,0,310,0,6
32180,2,2352,2415,-63,0,45,1,6
32181,2,2239,2457,-218,0,4,0,6
32182,2,2606,2474,132,0,14,0,6
32183,2,2435,2443,-8,0,415,0,6
32184,2,2484,2503,-19,0,103,0,6
32185,1,2571,2248,323,0,106,0,6
32186,1,2500,2558,-58,0,24,0,6
32187,2,2331,2401,-70,0,194,0,6
32188,1,2508,2331,177,0,117,0,6
32189,1,2503,2302,201,0,123,0,6
32190,2,2284,2477,-193,0,307,0,6
32191,1,2523,2301,222,0,302,0,6
32192,1,2471,2361,110,0,111,0,6
32193,1,2530,2605,-75,0,386,0,6
32194,2,2401,2238,163,0,0,0,6
32195,1,2674,2390,284,0,4,0,6
32196,1,2428,2447,-19,0,138,0,6
32197,3,2486,2494,-8,0,110,0,6
32198,2,2275,2528,-253,0,111,0,6
32199,2,2341,2503,-162,0,45,0,6
32200,2,2414,2416,-2,0,405,1,6
32201,2,2399,2401,-2,0,40,0,6
32202,1,2431,2348,83,0,132,0,6
32203,1,2685,2426,259,0,131,0,6
32204,1,2513,2507,6,0,2,0,6
32205,2,2405,2365,40,0,5,0,6
32206,1,2427,2280,147,0,311,0,6
32207,1,2434,2554,-120,0,190,1,6
32208,2,2293,2439,-146,0,100,1,6
32209,1,2567,2262,305,0,243,0,6
32211,1,2449,2379,70,0,123,0,6
32212,2,2308,2536,-228,0,102,1,6
32213,1,2549,2424,125,0,213,0,6
32214,1,2462,2522,-60,0,107,0,6
32215,3,2416,2403,13,0,265,0,6
32216,1,2539,2286,253,0,122,0,6
32217,1,2473,2456,17,0,300,0,6
32218,1,2594,2238,356,0,40,0,6
32219,2,2424,2484,-60,0,240,0,6
32220,1,2599,2359,240,0,83,1,6
32221,1,2490,2440,50,0,484,1,6
32222,2,2681,2455,226,0,41,0,6
32223,2,2433,2251,182,0,333,1,6
32224,3,2453,2331,122,0,301,0,6
32225,2,2429,2461,-32,0,10,0,6
32226,1,2423,2478,-55,0,306,0,6
32227,2,2514,2503,11,0,46,0,6
32228,2,2549,2298,251,0,0,0,6
32229,2,2384,2596,-212,0,49,0,6
32230,1,2466,2379,87,0,202,0,6
32231,1,2766,2729,37,0,112,0,6
32232,3,2494,2564,-70,0,123,0,6
32233,2,2571,2525,46,0,103,0,6
32234,2,2607,2605,2,0,7,0,6
32235,3,2606,2523,83,0,247,0,6
32236,1,2666,2479,187,0,127,0,6
32237,1,2457,2459,-2,0,40,0,6
32238,3,2426,2261,165,0,200,0,6
32239,2,2423,2387,36,0,0,0,6
32240,1,2397,2501,-104,0,65,0,6
32241,2,2410,2361,49,0,103,0,6
32242,1,2570,2204,366,0,101,0,6
32243,2,2274,2410,-136,0,200,0,6
32244,3,2365,2433,-68,0,388,0,6
32245,1,2418,2266,152,0,200,0,8
32246,2,2515,2289,226,0,80,1,6
32248,2,2343,2576,-233,0,112,0,6
32249,1,2429,2432,-3,0,134,1,6
32250,1,2549,2429,120,0,415,1,6
32251,1,2463,2292,171,0,250,1,6
32252,1,2224,2447,-223,0,190,0,6
32253,3,2380,2522,-142,0,312,0,6
32254,1,2261,2493,-232,0,302,1,6
32255,2,2243,2569,-326,0,143,0,6
32256,1,2548,2418,130,0,246,1,6
32257,2,2414,2430,-16,0,268,1,6
32258,2,2495,2245,250,0,1,0,6
32259,2,2209,2430,-221,0,106,0,6
32260,1,2429,2363,66,0,226,1,6
32261,2,2446,2233,213,0,190,0,6
32262,2,2597,2596,1,0,398,1,6
32263,1,2530,2377,153,0,45,0,6
32264,2,2459,2403,56,0,484,1,6
32265,1,2391,2445,-54,0,344,0,6
32266,2,2371,2544,-173,0,339,0,6
32267,2,2254,2452,-198,0,1,1,6
32268,2,2452,2450,2,0,310,0,6
32269,1,2424,2377,47,0,104,1,6
32270,1,2503,2329,174,0,300,0,6
32271,1,2295,2400,-105,0,190,0,6
32272,2,2502,2701,-199,0,106,0,6
32273,1,2486,2394,92,0,3,0,6
32274,1,2339,2503,-164,0,36,1,6
32275,2,2581,2676,-95,0,190,0,6
32276,2,2552,2518,34,0,251,1,6
32277,2,2491,2518,-27,0,122,0,6
32278,1,2485,2555,-70,0,302,0,6
32279,2,2283,2457,-174,0,40,0,6
32280,2,2201,2417,-216,0,46,0,6
32281,2,2405,2521,-116,0,426,1,6
32282,2,2481,2561,-80,0,29,0,6
32283,3,2273,2553,-280,0,40,0,6
32284,1,2496,2249,247,0,123,0,6
32285,1,2296,2472,-176,0,157,0,6
32286,1,2510,2401,109,0,310,0,6
32287,1,2515,2321,194,0,107,0,6
32288,1,2329,2400,-71,0,4,0,6
32289,2,2246,2413,-167,0,240,1,6
32290,1,2274,2464,-190,0,248,1,6
32291,2,2348,2462,-114,0,265,0,8
32292,1,2449,2289,160,0,211,1,6
32293,2,2207,2625,-418,0,311,0,6
32294,1,2276,2531,-255,0,123,0,6
32295,1,2533,2399,134,0,9,0,6
32296,1,2703,2325,378,0,50,0,6
32297,1,2239,2410,-171,0,46,0,6
32298,1,2404,2291,113,0,106,1,6
32299,1,2275,2490,-215,0,124,1,6
32300,2,2326,2410,-84,0,453,0,6
32301,2,2209,2432,-223,0,1,0,6
32302,1,2551,2480,71,0,202,0,6
32303,2,2200,2427,-227,0,108,1,6
32304,2,2444,2480,-36,0,341,0,6
32305,1,2464,2340,124,0,104,0,6
32306,1,2212,2457,-245,0,201,0,6
32308,1,2252,2495,-243,0,129,0,6
32309,2,2404,2539,-135,0,242,1,6
32310,1,2504,2378,126,0,0,0,8
32311,2,2461,2481,-20,0,70,1,6
32312,2,2445,2499,-54,0,130,0,6
32313,2,2456,2467,-11,0,341,0,6
32314,1,2409,2354,55,0,334,0,6
32315,2,2506,2535,-29,0,241,1,6
32316,1,2520,2551,-31,0,45,0,6
32317,2,2475,2513,-38,0,155,0,6
32319,1,2431,2381,50,0,327,1,6
32320,1,2511,2479,32,0,247,0,6
32321,1,2333,2482,-149,0,15,1,6
32322,2,2340,2436,-96,0,334,1,6
32323,1,2437,2461,-24,0,106,0,6
32324,1,2433,2438,-5,0,404,0,8
32325,3,2410,2375,35,4,0,0,13
32326,1,2612,2627,-15,0,343,0,6
32327,2,2597,2704,-107,0,151,0,6
32328,1,2456,2435,21,0,322,0,6
32329,3,2585,2573,12,0,112,0,6
32330,1,2449,2309,140,0,120,1,6
32331,1,2497,2350,147,0,43,0,6
32332,2,2350,2454,-104,0,207,0,6
32333,1,2420,2282,138,0,103,0,6
32334,2,2381,2501,-120,0,210,0,6
32335,2,2407,2447,-40,0,310,0,6
32336,1,2405,2225,180,0,178,0,6
32337,2,2348,2688,-340,0,250,0,6
32338,2,2272,2429,-157,0,304,1,6
32339,1,2424,2443,-19,0,181,0,6
32340,1,2406,2221,185,0,13,0,6
32341,2,2265,2537,-272,0,455,0,6
32342,1,2501,2201,300,0,201,0,6
32343,3,2598,2398,200,0,15,0,6
32344,1,2771,2291,480,0,150,0,6
32345,2,2401,2724,-323,0,337,0,6
32346,1,2467,2463,4,0,145,0,6
32347,2,2459,2448,11,0,123,0,6
32348,1,2410,2247,163,0,400,0,6
32349,2,2363,2454,-91,0,20,0,6
32350,2,2332,2559,-227,0,17,0,6
32351,2,2228,2415,-187,0,0,0,6
32352,2,2226,2422,-196,0,107,0,6
32353,2,2207,2478,-271,0,101,0,6
32354,3,2451,2559,-108,0,86,0,6
32355,1,2221,2414,-193,0,123,0,6
32356,1,2485,2456,29,0,255,0,6
32357,2,2206,2439,-233,0,145,0,6
32358,1,2431,2336,95,0,140,0,6
32359,1,2502,2353,149,0,302,0,6
32360,2,2330,2519,-189,0,80,0,6
32361,1,2441,2421,20,0,200,0,6
32362,1,2502,2329,173,0,202,0,6
32363,1,2547,2704,-157,0,106,0,6
32364,1,2393,2427,-34,0,36,0,6
32365,1,2490,2324,166,0,111,0,6
32366,2,2559,2620,-61,0,311,0,6
32367,2,2633,2545,88,0,143,0,6
32368,1,2415,2409,6,0,0,0,6
32369,2,2547,2576,-29,0,125,0,6
32370,1,2463,2462,1,0,49,0,6
32371,1,2535,2432,103,0,15,0,6
32372,2,2309,2436,-127,0,121,0,6
32373,3,2352,2429,-77,0,4,0,6
32374,2,2495,2618,-123,0,212,0,6
32375,1,2621,2473,148,0,115,0,6
32376,1,2283,2454,-171,0,6,1,6
32377,2,2398,2425,-27,0,41,0,6
32378,1,2450,2326,124,0,330,0,6
32379,2,2263,2531,-268,0,404,1,6
32380,2,2532,2496,36,0,302,0,6
32381,2,2563,2671,-108,0,474,0,6
32382,1,2703,2540,163,0,200,1,6
32383,1,2477,2206,271,0,248,0,6
32384,2,2363,2565,-202,0,106,0,6
32385,1,2307,2424,-117,0,195,0,6
32386,2,2308,2626,-318,0,186,0,6
32387,1,2545,2266,279,0,210,1,6
32388,2,2372,2407,-35,0,101,1,6
32389,3,2501,2572,-71,0,200,0,6
32390,3,2432,2343,89,0,1,0,6
32391,1,2260,2419,-159,0,310,1,6
32392,1,2433,2249,184,0,247,0,6
32393,1,2489,2230,259,0,257,0,6
32394,1,2469,2301,168,0,143,0,6
32395,2,2437,2375,62,0,121,0,6
32396,2,2400,2539,-139,0,3,0,6
32397,2,2303,2556,-253,0,50,0,6
32398,1,2475,2492,-17,0,301,0,6
32399,1,2642,2280,362,0,43,0,6
32400,1,2472,2326,146,0,212,0,6
32401,1,2605,2404,201,0,122,0,6
32402,3,2547,2529,18,0,211,0,6
32403,2,2494,2541,-47,0,455,0,6
32404,3,2378,2402,-24,0,45,0,6
32405,2,2413,2358,55,0,315,0,6
32406,3,2287,2416,-129,0,65,0,6
32407,2,2245,2518,-273,0,84,1,6
32408,2,2401,2363,38,0,200,1,6
32409,2,2365,2469,-104,0,40,0,6
32410,1,2332,2426,-94,0,230,0,6
32411,1,2524,2610,-86,0,192,0,6
32412,1,2444,2207,237,0,394,0,6
32413,1,2604,2595,9,0,106,0,6
32414,1,2398,2402,-4,0,306,0,6
32415,2,2245,2430,-185,0,311,1,6
32416,2,2381,2402,-21,0,115,0,6
32417,2,2235,2488,-253,0,7,0,6
32418,1,2417,2347,70,0,308,0,6
32419,1,2606,2505,101,0,4,0,6
32420,1,2689,2349,340,0,110,0,6
32421,1,2295,2463,-168,0,310,0,6
32422,1,2261,2486,-225,0,131,0,6
32423,2,2314,2476,-162,0,335,0,6
32424,1,2669,2527,142,0,106,0,6
32425,2,2384,2452,-68,0,4,0,6
32426,1,2462,2438,24,0,122,0,6
32427,3,2410,2569,-159,0,303,0,6
32428,2,2655,2475,180,0,1,0,6
32429,1,2406,2219,187,0,109,0,6
32430,1,2607,2571,36,0,140,0,6
32431,2,2296,2517,-221,0,300,0,6
32432,2,2446,2682,-236,0,153,0,6
32433,1,2306,2577,-271,0,187,1,6
32434,2,2278,2474,-196,0,40,0,6
32435,2,2628,2486,142,0,100,0,6
32436,2,2381,2471,-90,0,46,0,6
32437,2,2464,2672,-208,0,10,1,6
32438,3,2473,2419,54,0,0,0,6
32439,3,2405,2379,26,0,201,0,6
32440,1,2482,2203,279,0,200,0,6
32441,2,2231,2598,-367,0,4,0,6
32442,3,2238,2405,-167,0,8,0,6
32443,1,2410,2399,11,0,456,0,6
32444,1,2573,2596,-23,0,1,0,6
32445,2,2592,2593,-1,0,46,0,6
32446,2,2265,2676,-411,0,1,0,6
32447,1,2464,2286,178,0,353,0,6
32448,1,2601,2585,16,0,5,0,6
32449,1,2708,2237,471,0,222,0,6
32450,2,2550,2509,41,0,123,1,6
32451,2,2456,2583,-127,0,204,0,6
32452,3,2462,2222,240,0,7,0,6
32453,2,2305,2438,-133,0,0,0,6
32454,2,2416,2610,-194,0,123,0,6
32455,2,2584,2447,137,0,5,0,6
32456,2,2493,2362,131,0,242,0,6
32457,2,2598,2320,278,0,50,0,6
32458,1,2313,2537,-224,0,49,0,6
32459,1,2504,2436,68,0,201,0,6
32460,3,2331,2440,-109,0,7,0,6
32461,1,2309,2402,-93,0,200,1,6
32462,1,2517,2386,131,0,226,0,6
32463,2,2489,2507,-18,0,80,0,6
32464,1,2419,2356,63,0,45,0,6
32465,1,2704,2499,205,0,133,0,6
32466,1,2549,2470,79,0,7,0,6
32467,2,2342,2457,-115,0,300,1,6
32468,2,2412,2624,-212,0,345,0,6
32469,2,2368,2442,-74,0,40,0,6
32470,1,2565,2271,294,0,101,0,6
32471,1,2436,2477,-41,0,148,0,6
32472,2,2425,2335,90,0,426,0,6
32473,1,2506,2250,256,0,133,0,6
32474,1,2504,2285,219,0,87,0,6
32476,2,2551,2506,45,0,21,0,6
32477,2,2427,2321,106,0,233,0,6
32478,1,2518,2414,104,0,42,1,6
32479,2,2696,2526,170,0,57,1,6
32480,1,2337,2470,-133,0,5,0,6
32481,1,2633,2482,151,0,4,0,6
32482,2,2204,2405,-201,0,335,0,6
32483,1,2552,2479,73,0,250,1,6
32484,2,2502,2555,-53,0,110,0,6
32485,2,2420,2381,39,0,0,1,6
32486,1,2451,2319,132,0,334,0,6
32487,2,2473,2690,-217,0,5,0,6
32488,1,2424,2442,-18,0,106,0,6
32489,1,2677,2239,438,0,131,1,6
32491,1,2414,2490,-76,0,133,1,6
32492,2,2270,2404,-134,0,15,0,6
32493,2,2367,2453,-86,0,5,0,6
32494,1,2409,2203,206,0,112,0,6
32495,1,2538,2388,150,0,255,0,6
32496,1,2565,2497,68,0,101,0,6
32497,2,2259,2520,-261,0,210,0,6
32498,2,2200,2416,-216,0,492,0,6
32499,2,2443,2446,-3,0,47,0,6
32500,3,2560,2612,-52,0,382,0,6
32501,2,2503,2314,189,0,200,0,6
32502,2,2290,2471,-181,0,126,1,6
32503,2,2559,2481,78,0,202,0,6
32504,2,2466,2300,166,0,300,0,8
32505,2,2495,2436,59,0,43,0,6
32506,2,2387,2489,-102,0,463,0,6
32507,1,2436,2484,-48,0,112,0,6
32508,1,2486,2314,172,0,302,0,6
32509,2,2509,2342,167,0,46,1,6
32510,3,2501,2503,-2,0,4,0,6
32511,1,2491,2610,-119,0,301,0,6
32512,2,2204,2482,-278,0,34,0,6
32513,1,2543,2402,141,0,46,0,6
32514,2,2336,2448,-112,0,15,1,6
32515,2,2431,2448,-17,0,201,0,6
32516,1,2480,2599,-119,0,229,0,6
32517,2,2478,2221,257,0,123,0,6
32518,1,2205,2586,-381,0,241,0,6
32519,1,2260,2567,-307,0,110,0,6
32520,1,2359,2451,-92,0,302,1,6
32521,1,2458,2434,24,0,10,0,6
32522,1,2525,2311,214,0,53,0,6
32523,1,2402,2335,67,0,388,1,6
32524,2,2455,2491,-36,0,0,0,6
32525,2,2228,2444,-216,0,122,0,6
32526,1,2684,2613,71,0,7,0,6
32527,1,2444,2413,31,0,200,0,6
32528,2,2484,2553,-69,0,331,1,6
32530,2,2440,2601,-161,0,206,0,6
32531,1,2433,2372,61,0,46,0,6
32532,1,2435,2380,55,0,101,0,6
32533,1,2621,2542,79,0,302,0,6
32534,1,2534,2251,283,0,106,0,6
32535,1,2452,2276,176,0,440,0,6
32536,1,2557,2400,157,0,456,0,6
32537,2,2486,2355,131,0,311,0,6
32538,2,2439,2352,87,0,30,0,6
32539,2,2250,2425,-175,0,398,1,6
32540,3,2441,2304,137,0,315,0,6
32541,2,2416,2361,55,0,225,0,6
32542,2,2403,2379,24,0,300,0,8
32543,1,2539,2569,-30,0,453,1,6
32544,1,2726,2455,271,0,373,0,6
32545,2,2407,2414,-7,0,103,0,6
32546,2,2399,2642,-243,0,112,0,6
32547,1,2519,2362,157,0,119,0,6
32548,1,2293,2446,-153,0,102,1,6
32549,2,2371,2428,-57,0,40,0,6
32550,1,2418,2259,159,0,140,1,6
32551,2,2266,2420,-154,0,4,1,6
32552,2,2590,2626,-36,0,40,0,6
32553,1,2579,2491,88,0,307,0,6
32554,1,2538,2426,112,0,0,0,6
32555,1,2403,2424,-21,0,122,0,6
32556,2,2335,2408,-73,0,302,1,6
32557,1,2522,2474,48,0,2,0,6
32558,2,2401,2351,50,0,49,0,6
32559,1,2595,2315,280,0,40,0,6
32560,2,2567,2554,13,0,8,0,6
32561,1,2381,2416,-35,0,135,0,6
32562,1,2495,2466,29,0,106,1,6
32563,2,2624,2771,-147,0,302,0,6
32564,1,2361,2424,-63,0,200,0,6
32565,1,2298,2437,-139,0,3,1,6
32566,2,2507,2454,53,0,305,0,6
32567,2,2454,2600,-146,0,106,0,6
32568,2,2237,2444,-207,0,15,0,8
32569,2,2394,2429,-35,0,335,0,6
32570,2,2469,2288,181,0,413,0,6
32571,1,2223,2457,-234,0,122,0,6
32572,1,2402,2211,191,0,8,0,6
32573,3,2549,2368,181,0,244,0,6
32574,2,2579,2412,167,0,109,0,6
32575,2,2567,2461,106,0,404,0,6
32576,2,2455,2457,-2,0,46,0,6
32577,2,2418,2408,10,0,265,0,6
32578,2,2454,2458,-4,0,6,0,6
32579,1,2537,2316,221,0,335,0,6
32580,2,2374,2505,-131,0,34,0,6
32581,2,2245,2412,-167,0,50,1,6
32582,3,2221,2528,-307,0,148,0,6
32583,3,2452,2331,121,0,145,0,6
32584,3,2364,2406,-42,0,150,0,6
32585,2,2413,2418,-5,0,398,0,6
32586,3,2446,2554,-108,0,40,0,6
32587,1,2236,2546,-310,0,106,0,6
32588,1,2489,2476,13,0,394,1,6
32589,1,2465,2363,102,0,485,0,6
32590,2,2257,2533,-276,0,119,0,6
32591,2,2445,2346,99,0,111,0,6
32592,3,2404,2369,35,0,193,0,6
32593,2,2490,2672,-182,0,302,0,6
32594,3,2523,2453,70,0,315,0,6
32595,1,2430,2455,-25,0,112,0,6
32596,1,2437,2309,128,0,104,0,6
32597,1,2475,2427,48,4,300,1,13
32598,1,2571,2282,289,0,120,0,6
32599,3,2608,2541,67,0,107,0,6
32600,1,2475,2391,84,0,202,0,6
32601,2,2567,2690,-123,0,112,0,6
32602,2,2441,2505,-64,0,100,0,6
32603,1,2436,2337,99,0,200,0,6
32604,2,2301,2500,-199,0,247,0,6
32605,2,2431,2439,-8,0,250,0,6
32606,2,2549,2509,40,0,4,0,6
32607,1,2489,2321,168,0,303,1,6
32608,2,2403,2514,-111,0,248,0,6
32609,2,2427,2375,52,0,148,1,6
32610,2,2405,2306,99,0,4,0,6
32611,2,2479,2670,-191,0,300,0,6
32612,1,2409,2285,124,0,127,0,6
32613,3,2557,2423,134,0,270,0,6
32614,2,2401,2494,-93,0,62,0,6
32615,2,2433,2425,8,0,10,0,6
32616,1,2608,2455,153,0,210,1,6
32617,2,2401,2467,-66,0,15,1,6
32618,1,2449,2399,50,0,46,0,6
32619,2,2463,2495,-32,0,158,0,6
32620,2,2309,2459,-150,0,241,1,6
32621,2,2380,2559,-179,0,122,0,6
32622,1,2376,2528,-152,0,135,0,6
32623,3,2522,2676,-154,0,460,0,6
32624,2,2436,2256,180,0,311,0,6
32625,2,2541,2509,32,0,102,1,6
32626,1,2381,2492,-111,0,331,1,6
32627,1,2497,2365,132,0,201,1,6
32628,1,2484,2356,128,0,180,0,6
32629,2,2247,2411,-164,0,130,0,6
32630,3,2380,2468,-88,0,199,0,6
32631,2,2552,2626,-74,0,1,0,6
32632,2,2493,2325,168,0,343,1,6
32633,2,2591,2561,30,0,191,0,6
32634,2,2408,2330,78,0,172,0,6
32635,1,2488,2583,-95,0,45,0,6
32636,1,2397,2457,-60,0,106,1,6
32637,2,2346,2500,-154,0,253,0,6
32638,2,2453,2265,188,0,120,0,6
32639,2,2693,2244,449,0,241,0,6
32640,2,2403,2338,65,0,109,1,6
32641,1,2666,2503,163,0,112,1,6
32642,2,2210,2423,-213,0,461,0,6
32643,1,2505,2481,24,0,45,0,6
32644,2,2414,2472,-58,0,40,0,6
32645,1,2420,2325,95,0,115,0,6
32646,3,2520,2248,272,0,245,0,6
32647,1,2269,2419,-150,0,277,0,6
32649,2,2493,2728,-235,0,0,0,6
32650,2,2453,2408,45,0,216,0,6
32651,1,2421,2270,151,0,242,0,6
32652,1,2399,2570,-171,0,19,0,6
32653,1,2483,2343,140,0,112,0,6
32654,2,2483,2353,130,0,255,0,6
32655,2,2432,2421,11,0,4,1,6
32656,1,2486,2320,166,0,122,0,6
32657,2,2576,2345,231,0,40,0,6
32658,1,2487,2216,271,0,213,0,6
32659,2,2429,2310,119,0,343,0,6
32660,3,2270,2425,-155,0,200,0,6
32661,2,2320,2580,-260,0,110,0,6
32662,2,2408,2637,-229,0,106,0,6
32663,2,2478,2202,276,0,237,0,6
32664,1,2707,2560,147,0,201,0,6
32665,1,2562,2485,77,0,4,0,6
32666,1,2334,2478,-144,0,343,0,6
32667,3,2513,2544,-31,0,107,0,6
32668,3,2489,2445,44,0,106,0,6
32669,2,2483,2558,-75,0,108,0,6
32670,2,2403,2461,-58,0,455,0,6
32671,2,2388,2461,-73,0,245,0,6
32672,2,2270,2508,-238,0,154,0,6
32673,1,2407,2230,177,4,341,0,13
32674,1,2386,2410,-24,0,153,0,6
32675,1,2322,2432,-110,0,190,1,6
32676,1,2563,2235,328,0,15,0,6
32677,2,2200,2403,-203,0,101,0,6
32678,2,2433,2373,60,0,311,1,6
32679,2,2467,2425,42,0,201,0,6
32680,2,2529,2585,-56,0,1,0,6
32681,2,2421,2627,-206,0,112,0,6
32682,2,2454,2410,44,0,205,0,6
32683,2,2567,2607,-40,0,14,0,6
32684,1,2547,2571,-24,0,255,0,6
32685,2,2283,2542,-259,0,101,0,6
32686,2,2202,2457,-255,0,48,0,6
32687,1,2313,2532,-219,0,395,0,6
32688,1,2597,2303,294,0,13,0,6
32689,1,2603,2365,238,0,9,0,6
32690,1,2419,2441,-22,0,8,1,6
32691,2,2313,2620,-307,0,187,0,6
32692,2,2494,2540,-46,0,100,0,6
32693,2,2454,2281,173,0,335,0,6
32694,1,2411,2498,-87,0,15,0,6
32695,1,2603,2342,261,0,15,0,6
32697,1,2475,2271,204,0,104,0,6
32698,1,2411,2366,45,0,200,0,6
32699,1,2207,2489,-282,0,1,0,6
32700,1,2433,2442,-9,0,57,0,6
32701,1,2465,2428,37,0,16,0,6
32702,1,2647,2707,-60,0,1,0,6
32703,1,2674,2461,213,0,105,1,6
32704,1,2556,2504,52,0,7,0,6
32705,1,2226,2522,-296,0,120,1,6
32706,1,2560,2397,163,0,453,0,6
32707,2,2631,2524,107,0,302,1,6
32708,2,2353,2499,-146,0,154,0,6
32709,1,2469,2438,31,0,337,0,6
32710,2,2590,2585,5,0,101,0,6
32711,1,2476,2325,151,0,152,0,6
32712,2,2511,2539,-28,0,45,0,6
32713,1,2688,2397,291,0,57,0,6
32714,1,2462,2237,225,0,155,0,6
32715,2,2589,2345,244,0,330,0,6
32716,1,2534,2644,-110,0,46,0,6
32717,1,2328,2425,-97,0,4,0,6
32718,3,2444,2375,69,0,101,0,6
32719,3,2501,2316,185,0,5,0,6
32720,2,2280,2503,-223,0,405,0,6
32721,1,2478,2322,156,0,125,0,6
32722,2,2528,2347,181,0,8,1,6
32723,1,2493,2442,51,0,296,0,6
32724,2,2441,2653,-212,0,106,0,6
32725,1,2409,2421,-12,0,484,1,6
32726,3,2404,2351,53,0,315,0,6
32727,1,2418,2409,9,0,218,1,6
32729,2,2397,2447,-50,0,408,0,6
32730,2,2469,2489,-20,0,6,0,6
32731,2,2257,2470,-213,0,125,1,6
32732,2,2255,2443,-188,0,150,1,6
32733,1,2359,2448,-89,0,40,0,6
32734,1,2303,2466,-163,0,120,0,6
32735,1,2574,2443,131,0,120,0,6
32736,2,2488,2658,-170,0,289,0,6
32737,1,2607,2561,46,0,220,0,6
32738,1,2410,2359,51,0,4,0,6
32739,1,2475,2360,115,0,315,1,6
32740,2,2437,2353,84,0,400,0,6
32741,3,2542,2557,-15,0,4,0,6
32742,2,2452,2522,-70,0,311,0,6
32743,2,2248,2403,-155,0,122,0,6
32744,1,2527,2263,264,0,3,0,6
32745,1,2469,2262,207,0,107,1,6
32746,3,2700,2846,-146,0,324,0,6
32747,2,2382,2413,-31,0,45,0,6
32748,2,2383,2606,-223,0,404,0,6
32749,2,2542,2521,21,0,201,0,6
32750,2,2374,2400,-26,0,246,0,6
32751,2,2380,2405,-25,0,15,0,6
32752,1,2312,2443,-131,0,10,0,6
32753,1,2432,2567,-135,0,138,0,6
32754,1,2553,2354,199,0,123,0,6
32755,1,2478,2452,26,0,12,0,6
32756,1,2667,2235,432,0,300,0,6
32757,1,2611,2490,121,0,101,0,6
32758,2,2470,2523,-53,0,193,0,6
32759,1,2730,2342,388,0,14,1,6
32760,1,2284,2409,-125,0,96,0,6
32761,1,2425,2308,117,0,118,0,6
32762,1,2476,2369,107,0,107,0,6
32763,1,2396,2463,-67,0,200,0,6
32764,2,2408,2265,143,0,140,0,6
32765,1,2458,2346,112,0,45,1,6
32766,1,2460,2437,23,0,123,0,6
32767,1,2423,2413,10,0,200,0,6
32768,2,2605,2388,217,0,405,0,6
32771,1,2542,2212,330,0,0,0,6
32772,2,2323,2510,-187,0,100,0,6
32773,1,2694,2545,149,0,49,0,6
32774,1,2474,2401,73,0,151,0,6
32775,1,2437,2287,150,0,147,1,6
32776,1,2489,2563,-74,0,120,0,6
32777,2,2258,2452,-194,0,106,0,6
32778,1,2501,2441,60,0,49,1,6
32779,1,2605,2438,167,0,326,0,6
32780,2,2236,2429,-193,0,210,0,6
32781,2,2453,2547,-94,0,249,1,6
32782,1,2260,2418,-158,0,122,0,6
32783,1,2603,2348,255,0,131,0,6
32784,1,2413,2249,164,0,302,0,6
32785,1,2425,2479,-54,0,426,0,6
32786,2,2557,2266,291,0,50,0,6
32787,2,2346,2419,-73,0,335,0,6
32788,1,2414,2621,-207,0,302,0,6
32789,1,2503,2211,292,0,253,0,6
32790,1,2418,2494,-76,0,130,1,6
32792,1,2469,2298,171,0,143,0,6
32793,1,2384,2428,-44,0,117,1,6
32794,1,2630,2612,18,0,123,0,6
32795,1,2418,2562,-144,0,190,0,6
32796,1,2470,2425,45,0,140,0,6
32797,1,2404,2331,73,0,43,0,6
32798,1,2346,2454,-108,0,113,0,6
32799,2,2369,2522,-153,0,106,0,6
32800,2,2491,2319,172,0,4,0,6
32801,1,2317,2418,-101,0,45,0,6
32802,2,2220,2510,-290,0,36,0,6
32803,2,2509,2515,-6,0,43,0,6
32804,2,2417,2542,-125,0,454,0,6
32805,3,2527,2514,13,0,153,0,6
32806,2,2291,2630,-339,0,201,0,6
32807,2,2370,2404,-34,0,380,1,6
32808,2,2357,2403,-46,0,311,0,6
32809,2,2343,2436,-93,0,455,0,6
32810,2,2418,2366,52,0,113,0,6
32811,2,2247,2424,-177,0,200,0,6
32812,2,2466,2502,-36,0,35,1,6
32813,2,2208,2428,-220,0,130,1,6
32814,1,2416,2351,65,0,176,0,6
32815,2,2765,2612,153,0,150,1,6
32816,1,2456,2556,-100,0,115,0,6
32817,2,2520,2521,-1,0,300,0,6
32818,2,2411,2401,10,0,4,0,6
32819,2,2238,2645,-407,0,454,0,6
32820,2,2433,2495,-62,0,145,0,6
32821,3,2474,2563,-89,0,338,0,6
32822,1,2504,2266,238,0,101,0,6
32823,1,2448,2326,122,0,194,0,6
32824,1,2477,2252,225,0,112,0,6
32825,1,2426,2421,5,0,14,0,6
32826,2,2457,2446,11,0,0,0,8
32827,1,2322,2480,-158,0,227,0,6
32828,2,2394,2449,-55,0,4,0,6
32829,2,2433,2319,114,0,14,1,6
32830,3,2464,2454,10,0,200,0,6
32831,2,2383,2493,-110,0,278,0,6
32832,1,2349,2445,-96,0,110,0,6
32833,1,2562,2479,83,0,414,0,6
32834,2,2387,2527,-140,0,327,0,6
32835,1,2331,2415,-84,0,138,0,6
32836,2,2361,2511,-150,0,122,0,6
32837,2,2306,2500,-194,0,3,0,6
32838,1,2563,2395,168,0,190,0,6
32839,1,2478,2385,93,0,301,1,6
32840,1,2414,2323,91,0,260,0,6
32841,2,2402,2280,122,0,48,0,6
32842,2,2462,2201,261,0,0,0,6
32843,3,2562,2307,255,0,490,0,6
32844,2,2499,2373,126,0,230,0,6
32845,1,2682,2498,184,0,130,0,6
32846,2,2387,2454,-67,0,140,0,6
32847,2,2319,2582,-263,0,110,1,6
32848,2,2246,2496,-250,0,227,1,6
32849,2,2584,2708,-124,0,455,0,6
32850,1,2567,2484,83,0,206,1,6
32851,2,2590,2441,149,0,312,0,6
32852,2,2202,2570,-368,0,134,0,6
32853,1,2439,2401,38,0,245,0,6
32854,1,2565,2576,-11,0,102,0,6
32855,1,2367,2439,-72,0,41,1,6
32856,2,2553,2611,-58,0,122,0,6
32857,2,2559,2452,107,0,343,0,6
32858,1,2536,2427,109,0,122,1,6
32859,1,2406,2365,41,0,315,0,6
32860,1,2488,2349,139,0,190,0,6
32861,2,2418,2516,-98,0,107,0,6
32862,1,2500,2261,239,0,257,0,6
32863,2,2247,2436,-189,0,200,0,6
32864,1,2622,2403,219,0,100,0,6
32865,2,2343,2500,-157,0,45,0,6
32866,2,2286,2505,-219,0,48,1,6
32867,2,2236,2524,-288,0,200,1,6
32868,2,2673,2312,361,0,240,0,6
32869,2,2438,2351,87,0,101,1,6
32870,3,2496,2458,38,0,130,0,6
32871,2,2383,2456,-73,0,115,0,6
32872,2,2674,2675,-1,0,150,0,6
32873,2,2476,2487,-11,0,45,0,6
32874,2,2231,2439,-208,0,2,0,6
32875,2,2253,2437,-184,0,43,0,6
32876,1,2430,2494,-64,0,123,1,6
32877,2,2228,2404,-176,0,258,0,6
32878,2,2450,2397,53,0,378,0,6
32879,1,2388,2437,-49,0,132,0,6
32880,1,2449,2226,223,0,386,0,6
32881,2,2397,2526,-129,0,3,0,6
32882,1,2287,2428,-141,0,106,0,6
32883,1,2300,2524,-224,0,30,0,6
32884,1,2523,2566,-43,0,106,0,6
32885,1,2637,2395,242,0,115,0,6
32886,2,2481,2342,139,0,4,1,6
32887,2,2606,2690,-84,0,260,1,6
32888,1,2424,2268,156,0,311,1,6
32889,1,2440,2476,-36,0,45,0,6
32890,2,2472,2426,46,0,122,0,6
32891,3,2297,2554,-257,0,4,0,6
32892,1,2346,2493,-147,0,113,0,6
32893,1,2605,2453,152,0,150,0,6
32894,1,2346,2529,-183,0,85,0,6
32895,2,2435,2505,-70,0,210,0,6
32896,2,2478,2632,-154,0,202,0,6
32897,2,2265,2487,-222,0,130,0,6
32898,2,2544,2407,137,0,121,1,6
32899,3,2447,2226,221,0,1,0,8
32900,1,2630,2548,82,0,277,0,6
32901,2,2406,2438,-32,0,302,1,6
32902,1,2415,2309,106,0,180,1,6
32903,2,2542,2496,46,0,43,0,6
32904,1,2556,2544,12,0,106,0,6
32905,2,2557,2542,15,0,241,0,6
32906,3,2450,2599,-149,0,0,0,6
32907,2,2318,2464,-146,0,453,1,6
32908,2,2438,2262,176,0,120,0,6
32909,2,2361,2527,-166,0,463,0,6
32911,1,2502,2375,127,0,171,0,6
32912,2,2211,2635,-424,0,145,0,6
32913,1,2317,2421,-104,0,470,1,6
32914,2,2458,2423,35,0,201,0,6
32915,1,2481,2366,115,0,117,0,6
32916,2,2319,2609,-290,0,302,0,6
32917,2,2435,2526,-91,0,1,0,6
32918,2,2524,2631,-107,0,241,1,6
32919,1,2418,2278,140,0,106,0,6
32920,1,2508,2471,37,0,150,0,6
32921,1,2443,2402,41,0,130,0,6
32922,1,2477,2270,207,0,0,1,6
32923,1,2485,2323,162,0,22,0,6
32924,1,2235,2433,-198,0,101,0,6
32925,2,2615,2710,-95,0,128,1,6
32926,2,2639,2425,214,0,5,0,6
32927,2,2435,2580,-145,0,242,0,6
32928,2,2276,2408,-132,0,45,0,6
32929,1,2562,2217,345,0,244,0,6
32930,1,2486,2391,95,0,0,0,6
32931,1,2405,2548,-143,0,113,0,6
32932,1,2449,2494,-45,0,307,0,6
32933,2,2447,2268,179,0,106,1,6
32934,3,2561,2407,154,0,456,0,6
32935,2,2582,2464,118,0,304,0,6
32936,2,2225,2476,-251,0,258,0,6
32937,2,2391,2547,-156,0,300,0,6
32938,3,2360,2409,-49,0,102,0,6
32939,1,2424,2270,154,0,100,0,6
32940,1,2436,2233,203,0,107,1,6
32941,1,2285,2492,-207,0,101,0,6
32942,1,2581,2485,96,0,130,0,6
32943,1,2480,2223,257,0,260,0,6
32944,1,2464,2566,-102,0,172,1,6
32945,1,2556,2548,8,0,241,0,6
32946,1,2475,2369,106,0,242,1,6
32947,2,2204,2424,-220,0,250,1,6
32948,1,2330,2403,-73,0,210,0,6
32949,1,2457,2398,59,0,344,0,6
32950,2,2452,2368,84,0,123,0,6
32951,1,2532,2416,116,0,1,0,6
32952,1,2308,2414,-106,0,0,0,6
32953,1,2313,2520,-207,0,200,0,6
32954,1,2423,2216,207,0,1,1,6
32955,1,2454,2262,192,0,4,0,6
32956,3,2544,2291,253,0,302,0,6
32957,1,2439,2376,63,0,46,0,6
32958,1,2529,2546,-17,0,131,0,6
32959,2,2560,2663,-103,0,457,0,6
32960,2,2322,2698,-376,0,150,0,6
32961,1,2541,2612,-71,0,305,0,6
32962,1,2418,2386,32,0,236,0,6
32963,1,2427,2265,162,0,345,0,6
32964,1,2410,2313,97,0,374,0,6
32965,1,2430,2281,149,0,200,0,6
32966,2,2269,2467,-198,0,106,0,6
32967,1,2324,2432,-108,0,58,1,6
32968,1,2556,2226,330,0,4,1,6
32969,1,2290,2420,-130,0,122,0,6
32970,2,2351,2475,-124,0,212,0,6
32971,1,2537,2343,194,0,107,0,6
32973,1,2483,2685,-202,0,227,1,6
32974,2,2437,2429,8,0,242,1,6
32975,2,2584,2521,63,0,80,0,6
32976,1,2495,2258,237,0,7,0,6
32977,1,2681,2471,210,0,135,0,6
32978,3,2518,2399,119,0,337,0,6
32979,1,2438,2379,59,0,123,0,6
32980,1,2479,2459,20,0,40,1,6
32981,2,2484,2534,-50,0,466,1,6
32982,2,2365,2441,-76,0,113,0,6
32983,1,2448,2472,-24,0,302,0,6
32984,2,2491,2261,230,0,58,0,6
32985,1,2390,2430,-40,0,4,1,6
32986,2,2527,2423,104,0,207,0,6
32987,1,2296,2431,-135,0,4,0,6
32988,2,2490,2269,221,0,245,0,6
32989,1,2444,2262,182,0,102,0,6
32990,2,2416,2578,-162,0,43,0,6
32991,2,2229,2426,-197,0,115,0,6
32992,1,2411,2331,80,0,0,1,6
32994,1,2404,2432,-28,0,101,0,6
32995,1,2842,2702,140,0,106,1,6
32996,2,2470,2446,24,0,241,0,6
32997,1,2205,2447,-242,0,19,0,6
32998,2,2200,2446,-246,0,45,0,6
32999,2,2364,2525,-161,0,40,0,6
33000,2,2472,2552,-80,0,6,0,6
33001,1,2503,2575,-72,0,461,0,6
33002,2,2432,2479,-47,0,263,0,6
33003,2,2411,2302,109,0,15,0,6
33004,1,2434,2324,110,0,97,0,6
33005,1,2503,2310,193,0,229,1,6
33006,1,2521,2358,163,0,122,0,6
33007,2,2402,2285,117,0,133,0,6
33008,1,2408,2207,201,0,48,0,6
33009,1,2451,2352,99,0,163,1,6
33010,2,2403,2266,137,0,202,0,8
33011,1,2408,2391,17,0,8,0,6
33012,3,2548,2731,-183,0,304,0,6
33013,1,2479,2356,123,0,248,0,6
33014,1,2421,2223,198,0,117,0,6
33015,2,2596,2216,380,0,0,0,6
33016,2,2358,2594,-236,0,53,1,6
33017,2,2433,2571,-138,0,277,0,6
33018,3,2528,2451,77,0,300,0,6
33020,1,2530,2254,276,0,123,1,6
33021,2,2473,2358,115,0,483,1,6
33023,2,2458,2319,139,0,175,0,6
33024,3,2213,2498,-285,0,121,0,6
33025,2,2256,2608,-352,0,45,0,6
33026,1,2287,2420,-133,0,409,1,8
33027,2,2451,2398,53,0,222,0,6
33028,2,2499,2358,141,0,45,0,6
33029,1,2421,2306,115,0,125,0,6
33030,2,2446,2483,-37,0,103,1,6
33031,2,2259,2503,-244,0,321,0,6
33032,2,2514,2481,33,0,386,0,6
33033,3,2361,2489,-128,0,139,0,6
33034,2,2485,2527,-42,0,31,1,6
33035,3,2540,2432,108,0,381,0,6
33036,2,2606,2667,-61,0,484,1,6
33037,2,2468,2478,-10,0,145,0,6
33038,1,2473,2405,68,0,20,0,6
33039,2,2407,2397,10,0,125,0,6
33040,2,2624,2757,-133,0,241,0,6
33041,3,2620,2491,129,0,101,0,6
33042,3,2401,2556,-155,0,1,0,6
33043,2,2329,2535,-206,0,0,0,6
33044,3,2329,2564,-235,0,414,0,6
33045,3,2426,2331,95,0,4,0,6
33046,1,2462,2323,139,0,107,1,6
33047,1,2493,2281,212,0,48,0,6
33048,1,2506,2573,-67,0,57,0,6
33049,1,2440,2485,-45,0,110,0,6
33050,1,2436,2410,26,0,211,1,6
33051,2,2487,2485,2,0,15,1,6
33052,3,2409,2226,183,0,330,0,6
33053,2,2569,2545,24,0,102,0,6
33054,2,2463,2350,113,0,80,0,6
33055,2,2310,2422,-112,0,136,0,6
33056,1,2400,2203,197,0,7,0,6
33057,2,2513,2563,-50,0,120,1,6
33058,3,2320,2440,-120,0,195,0,6
33059,3,2425,2370,55,0,4,0,6
33060,2,2530,2395,135,0,110,0,6
33061,2,2488,2483,5,0,464,1,6
33062,1,2337,2453,-116,0,300,0,6
33063,1,2483,2323,160,0,200,0,6
33064,1,2288,2421,-133,0,131,0,6
33065,2,2446,2667,-221,0,101,0,6
33066,1,2415,2431,-16,0,217,0,6
33067,2,2371,2432,-61,0,15,0,6
33068,2,2478,2536,-58,0,40,0,6
33069,2,2249,2444,-195,0,36,0,6
33070,3,2404,2498,-94,0,44,0,6
33071,2,2409,2712,-303,0,190,0,6
33072,2,2412,2545,-133,0,4,0,6
33073,1,2353,2559,-206,0,113,0,6
33074,1,2636,2580,56,0,0,0,6
33075,2,2546,2389,157,0,6,0,6
33076,2,2413,2448,-35,0,49,0,6
33077,1,2418,2410,8,0,218,0,6
33078,1,2448,2307,141,0,107,0,6
33079,1,2409,2365,44,0,110,0,6
33080,1,2514,2288,226,0,45,0,6
33081,1,2551,2414,137,0,112,0,6
33082,2,2216,2548,-332,0,107,0,6
33083,1,2293,2425,-132,0,123,1,6
33084,1,2540,2393,147,0,335,0,6
33085,3,2466,2364,102,0,29,0,6
33086,1,2289,2429,-140,0,233,0,6
33087,2,2394,2506,-112,0,121,1,6
33088,2,2436,2430,6,0,133,1,6
33089,1,2609,2494,115,0,300,0,6
33091,1,2468,2337,131,0,40,0,6
33092,3,2530,2684,-154,0,22,0,6
33093,1,2435,2309,126,0,469,0,6
33094,2,2357,2511,-154,0,140,0,6
33095,2,2433,2366,67,0,203,0,6
33096,1,2425,2255,170,0,36,0,6
33097,1,2433,2273,160,0,0,0,6
33098,1,2550,2606,-56,0,402,0,6
33099,1,2455,2281,174,0,143,0,6
33100,1,2442,2367,75,0,337,0,6
33101,1,2538,2265,273,0,53,0,6
33102,2,2408,2312,96,0,53,1,6
33103,2,2309,2414,-105,0,365,0,6
33104,2,2699,2562,137,0,8,0,6
33105,1,2504,2328,176,0,202,0,6
33106,2,2511,2480,31,0,45,0,6
33107,1,2408,2463,-55,0,40,1,6
33108,2,2376,2443,-67,4,1,0,13
33109,2,2327,2461,-134,0,1,0,6
33110,1,2509,2497,12,0,301,0,6
33111,3,2418,2418,0,0,395,0,6
33112,1,2375,2464,-89,0,4,0,6
33113,2,2679,2445,234,0,191,0,6
33114,2,2415,2332,83,0,152,1,6
33115,1,2403,2475,-72,0,254,0,6
33116,1,2518,2214,304,0,61,0,6
33117,2,2393,2479,-86,0,106,0,6
33118,1,2427,2272,155,0,50,0,6
33119,2,2334,2454,-120,0,112,0,6
33120,1,2424,2293,131,0,147,0,6
33121,1,2543,2493,50,0,300,0,6
33122,2,2322,2473,-151,0,57,0,6
33123,2,2531,2618,-87,0,197,0,6
33124,1,2466,2383,83,0,211,1,6
33125,2,2312,2611,-299,0,123,1,8
33126,1,2356,2409,-53,0,101,0,6
33127,2,2346,2492,-146,0,106,1,6
33128,1,2578,2312,266,0,45,0,6
33129,3,2527,2360,167,0,3,0,6
33130,2,2474,2392,82,0,241,0,6
33131,1,2398,2416,-18,0,200,1,6
33132,1,2245,2558,-313,0,10,0,6
33133,2,2501,2323,178,0,15,0,6
33134,3,2540,2439,101,0,341,0,6
33135,2,2506,2549,-43,0,242,0,6
33136,2,2479,2277,202,0,106,0,6
33137,2,2616,2347,269,0,112,0,6
33138,1,2512,2276,236,0,126,1,6
33139,2,2429,2452,-23,0,123,0,6
33140,2,2411,2354,57,0,13,1,6
33141,1,2524,2364,160,0,241,0,6
33142,1,2583,2601,-18,0,337,0,6
33143,2,2256,2431,-175,0,302,0,6
33144,2,2322,2546,-224,0,40,0,6
33145,1,2677,2254,423,0,241,0,6
33146,1,2610,2517,93,0,35,0,6
33147,2,2503,2609,-106,0,40,1,6
33148,1,2610,2338,272,0,409,0,6
33149,1,2449,2317,132,0,192,0,6
33150,2,2585,2670,-85,0,115,0,6
33151,2,2427,2411,16,0,218,0,6
33152,2,2373,2402,-29,0,10,1,8
33153,3,2433,2275,158,0,35,0,6
33154,1,2241,2411,-170,0,102,1,6
33155,1,2515,2231,284,0,463,0,6
33156,2,2575,2467,108,0,112,0,6
33157,1,2613,2572,41,0,302,0,6
33158,1,2384,2479,-95,0,201,0,6
33159,1,2488,2429,59,0,301,0,6
33160,3,2556,2456,100,0,302,0,6
33161,1,2441,2299,142,0,106,0,6
33162,3,2670,2550,120,0,241,0,6
33163,3,2444,2438,6,0,112,0,6
33164,2,2425,2408,17,0,200,0,6
33165,1,2453,2524,-71,0,150,1,6
33166,1,2597,2630,-33,0,106,1,6
33167,2,2508,2371,137,0,101,0,6
33168,1,2538,2639,-101,0,344,0,6
33169,1,2526,2483,43,0,40,1,6
33170,1,2434,2453,-19,0,4,0,6
33171,1,2327,2562,-235,0,190,0,6
33172,2,2279,2468,-189,0,389,0,6
33173,3,2270,2452,-182,0,41,0,6
33174,1,2266,2433,-167,0,106,0,6
33175,2,2336,2405,-69,0,113,0,6
33176,1,2458,2520,-62,0,203,0,6
33177,1,2484,2201,283,0,1,0,6
33178,1,2418,2309,109,0,0,0,6
33179,2,2424,2278,146,0,1,0,6
33180,1,2400,2335,65,0,215,0,6
33181,1,2438,2459,-21,0,41,0,6
33182,2,2409,2377,32,0,485,0,6
33183,3,2412,2295,117,0,0,0,6
33184,1,2200,2430,-230,0,113,0,6
33185,1,2548,2240,308,0,0,0,6
33186,2,2260,2552,-292,0,102,0,6
33187,1,2511,2270,241,0,112,0,6
33188,2,2234,2517,-283,0,135,0,6
33189,2,2386,2444,-58,0,211,1,6
33190,2,2286,2623,-337,0,123,0,6
33191,3,2304,2414,-110,0,242,0,6
33192,1,2416,2411,5,0,226,1,6
33195,2,2419,2309,110,0,112,1,6
33196,2,2338,2452,-114,0,319,0,6
33197,1,2635,2520,115,0,463,0,6
33198,1,2464,2426,38,0,201,1,6
33199,2,2568,2575,-7,0,404,0,6
33200,1,2402,2215,187,0,454,0,6
33201,2,2514,2345,169,0,325,0,6
33202,3,2446,2510,-64,0,87,0,6
33203,2,2478,2368,110,0,107,1,6
33204,1,2429,2350,79,0,335,0,6
33205,3,2566,2641,-75,0,46,0,6
33206,1,2306,2487,-181,0,45,0,6
33207,1,2581,2359,222,0,244,0,6
33208,2,2372,2413,-41,0,4,0,6
33209,1,2508,2496,12,0,56,0,6
33210,1,2256,2437,-181,0,139,0,6
33211,1,2345,2481,-136,0,50,0,6
33212,1,2309,2447,-138,0,374,0,6
33213,1,2365,2406,-41,0,43,0,8
33214,1,2414,2293,121,0,133,0,6
33215,1,2461,2251,210,0,0,0,6
33216,1,2536,2361,175,0,202,0,6
33217,3,2409,2394,15,0,311,0,6
33218,1,2522,2390,132,0,200,0,6
33219,1,2330,2507,-177,0,240,0,6
33220,1,2452,2285,167,0,315,0,6
33221,1,2715,2548,167,0,200,0,6
33222,1,2520,2611,-91,0,125,0,6
33223,2,2488,2535,-47,0,102,0,6
33224,1,2431,2503,-72,0,46,0,6
33225,1,2320,2426,-106,0,45,1,6
33226,1,2316,2438,-122,0,7,0,6
33227,2,2246,2404,-158,0,257,1,6
33228,2,2332,2445,-113,0,223,0,6
33229,1,2548,2246,302,0,490,0,6
33230,1,2441,2255,186,0,142,1,6
33231,1,2499,2340,159,0,176,0,6
33232,2,2384,2407,-23,0,310,0,6
33233,3,2491,2596,-105,0,41,0,6
33234,1,2482,2200,282,0,15,0,6
33235,1,2540,2225,315,0,1,0,6
33236,1,2473,2558,-85,0,40,0,6
33237,1,2362,2471,-109,0,216,1,6
33238,2,2286,2550,-264,0,118,0,6
33239,3,2421,2403,18,0,113,0,6
33240,1,2548,2454,94,0,302,1,6
33241,2,2481,2674,-193,0,112,1,6
33242,2,2381,2570,-189,0,211,0,6
33243,1,2691,2479,212,0,49,1,6
33244,1,2476,2362,114,0,103,0,6
33245,1,2517,2351,166,0,112,0,6
33246,2,2362,2417,-55,0,15,0,6
33247,1,2427,2462,-35,0,4,0,6
33248,2,2243,2580,-337,0,302,0,6
33249,1,2307,2496,-189,0,335,0,6
33250,3,2217,2401,-184,0,4,0,6
33251,1,2327,2409,-82,0,487,1,6
33252,3,2340,2585,-245,0,46,0,6
33253,2,2229,2520,-291,0,45,0,6
33254,1,2582,2443,139,0,122,0,6
33255,2,2527,2541,-14,0,45,1,6
33256,1,2448,2391,57,0,175,0,6
33257,1,2699,2849,-150,0,190,0,6
33258,2,2303,2403,-100,0,0,0,6
33259,1,2462,2206,256,0,151,0,6
33260,1,2553,2471,82,0,5,0,6
33261,2,2559,2403,156,0,40,0,6
33262,1,2434,2202,232,0,427,0,6
33263,1,2276,2401,-125,0,106,1,6
33264,1,2274,2484,-210,0,123,0,6
33265,1,2427,2370,57,0,203,1,6
33266,3,2424,2538,-114,0,314,0,6
33267,1,2471,2484,-13,0,140,0,6
33268,2,2362,2494,-132,0,310,0,6
33269,2,2404,2374,30,0,127,0,6
33270,1,2567,2273,294,0,242,0,6
33271,2,2287,2409,-122,0,4,0,6
33272,1,2557,2309,248,0,200,0,6
33273,1,2480,2473,7,0,125,0,6
33274,2,2559,2504,55,0,46,0,6
33275,2,2227,2451,-224,0,261,0,6
33276,1,2417,2220,197,0,45,1,6
33277,2,2486,2540,-54,0,230,0,6
33278,2,2302,2445,-143,0,85,1,6
33279,2,2422,2373,49,0,106,0,6
33280,2,2435,2456,-21,0,200,0,6
33281,1,2446,2431,15,0,484,0,6
33282,1,2242,2442,-200,0,45,0,6
33283,1,2249,2404,-155,0,200,1,6
33284,2,2444,2563,-119,0,211,0,6
33285,2,2286,2465,-179,0,206,0,6
33286,2,2550,2551,-1,0,100,1,6
33287,1,2729,2336,393,0,12,0,6
33288,2,2553,2538,15,0,253,0,6
33289,1,2528,2276,252,0,231,0,6
33290,1,2447,2326,121,0,100,0,6
33291,1,2440,2214,226,0,8,0,6
33292,2,2276,2419,-143,0,15,1,6
33293,1,2498,2525,-27,0,4,0,6
33294,3,2495,2359,136,0,118,0,6
33295,2,2267,2441,-174,0,115,0,6
33296,2,2257,2514,-257,0,241,0,6
33297,2,2257,2404,-147,0,30,0,6
33299,1,2516,2639,-123,0,131,0,6
33300,1,2290,2444,-154,0,50,0,8
33301,3,2322,2456,-134,0,49,0,6
33302,2,2441,2204,237,0,110,0,6
33303,2,2407,2563,-156,0,106,0,6
33304,2,2714,2475,239,0,112,0,6
33305,1,2400,2539,-139,0,150,0,6
33306,2,2581,2567,14,0,246,0,6
33307,2,2210,2491,-281,0,114,1,6
33308,2,2454,2676,-222,0,11,0,6
33309,3,2339,2418,-79,0,45,0,6
33310,1,2412,2452,-40,0,100,0,8
33311,2,2356,2527,-171,0,120,0,6
33312,1,2545,2431,114,0,103,0,6
33313,1,2623,2718,-95,0,247,0,6
33314,1,2277,2482,-205,0,43,0,6
33315,2,2344,2428,-84,0,335,1,6
33316,1,2426,2251,175,0,0,0,6
33317,1,2452,2288,164,0,106,1,6
33318,1,2678,2222,456,0,101,0,6
33319,1,2392,2425,-33,0,45,0,6
33320,2,2337,2421,-84,0,280,0,6
33321,1,2375,2418,-43,0,123,0,6
33322,2,2289,2414,-125,0,311,0,6
33323,3,2300,2506,-206,0,245,0,6
33324,2,2419,2365,54,0,107,0,6
33325,1,2294,2513,-219,0,213,0,6
33326,3,2451,2330,121,0,360,0,6
33327,3,2400,2392,8,0,0,0,6
33328,1,2225,2638,-413,0,20,0,6
33329,1,2550,2405,145,0,149,0,6
33330,2,2252,2466,-214,0,125,1,6
33331,1,2457,2472,-15,0,125,0,6
33332,1,2552,2403,149,0,400,0,6
33333,1,2496,2452,44,0,301,0,6
33334,3,2375,2456,-81,0,10,0,6
33335,2,2363,2448,-85,0,40,0,6
33336,2,2200,2612,-412,0,426,0,6
33337,3,2429,2437,-8,0,132,0,6
33338,2,2314,2522,-208,0,48,0,6
33339,1,2488,2401,87,0,101,0,6
33341,2,2540,2601,-61,0,302,0,6
33342,2,2568,2527,41,0,115,0,6
33343,2,2507,2322,185,0,202,1,6
33344,2,2483,2621,-138,0,123,0,6
33345,1,2761,2554,207,0,121,0,6
33346,1,2410,2508,-98,0,100,0,6
33347,1,2438,2288,150,0,123,0,6
33348,1,2672,2379,293,0,133,0,6
33349,2,2277,2614,-337,0,343,0,6
33350,3,2510,2326,184,0,49,0,6
33351,1,2400,2244,156,0,302,0,6
33352,1,2392,2414,-22,0,226,1,6
33353,1,2682,2569,113,0,115,0,6
33354,3,2266,2445,-179,0,123,0,6
33355,1,2523,2260,263,4,48,0,13
33356,2,2554,2277,277,0,38,0,6
33357,3,2357,2493,-136,0,100,0,6
33358,2,2424,2606,-182,0,4,0,6
33359,2,2455,2441,14,0,344,0,6
33360,1,2488,2385,103,0,20,0,6
33361,1,2385,2439,-54,0,120,0,6
33362,1,2415,2270,145,0,0,0,6
33363,2,2247,2484,-237,0,200,0,6
33364,1,2413,2303,110,0,100,0,6
33365,2,2604,2632,-28,0,110,0,6
33366,1,2546,2443,103,0,453,0,6
33367,1,2458,2500,-42,0,48,0,6
33368,1,2468,2301,167,0,201,1,6
33369,2,2384,2472,-88,0,127,1,6
33370,2,2437,2484,-47,0,13,0,6
33371,2,2404,2285,119,0,130,1,6
33372,1,2418,2236,182,0,202,0,6
33373,2,2538,2539,-1,0,373,0,6
33374,2,2301,2418,-117,0,132,0,6
33375,2,2455,2458,-3,0,112,0,6
33376,2,2353,2501,-148,0,151,0,6
33377,2,2567,2557,10,0,307,0,6
33378,2,2640,2554,86,0,242,0,6
33379,2,2293,2505,-212,0,108,1,6
33380,2,2219,2456,-237,0,331,1,6
33381,2,2251,2481,-230,0,147,1,6
33382,1,2426,2218,208,0,41,0,6
33383,1,2496,2359,137,0,255,0,6
33384,1,2438,2470,-32,0,248,0,6
33385,2,2533,2486,47,0,11,1,6
33386,1,2406,2269,137,0,8,0,6
33387,3,2436,2510,-74,0,242,0,6
33388,1,2581,2346,235,0,45,0,6
33389,1,2530,2526,4,0,200,0,6
33390,2,2238,2445,-207,0,10,1,6
33391,2,2457,2501,-44,0,40,0,6
33392,2,2599,2555,44,0,43,0,6
33393,1,2487,2448,39,0,122,0,6
33394,2,2595,2730,-135,0,112,0,6
33395,2,2279,2464,-185,0,48,0,6
33396,3,2322,2589,-267,0,0,0,6
33397,2,2335,2451,-116,0,102,0,6
33398,2,2434,2284,150,0,277,1,6
33399,1,2573,2214,359,0,14,0,6
33400,2,2317,2428,-111,0,83,0,6
33401,1,2492,2365,127,0,326,0,6
33402,1,2468,2257,211,0,112,0,6
33403,2,2357,2430,-73,0,18,0,6
33404,2,2277,2584,-307,0,200,0,6
33405,3,2361,2519,-158,0,90,0,6
33406,2,2504,2493,11,0,4,0,6
33407,2,2488,2686,-198,0,304,0,6
33408,2,2565,2399,166,0,107,0,6
33409,1,2453,2344,109,0,115,1,6
33410,1,2582,2613,-31,0,426,1,6
33411,2,2341,2415,-74,0,1,0,6
33412,2,2516,2517,-1,0,123,0,6
33413,2,2320,2460,-140,0,0,0,6
33414,1,2435,2256,179,0,7,0,6
33415,1,2465,2516,-51,0,152,0,6
33416,2,2227,2540,-313,0,178,0,6
33417,1,2513,2491,22,0,255,0,6
33418,1,2354,2486,-132,0,300,1,6
33419,2,2408,2343,65,0,101,1,6
33420,1,2531,2244,287,0,43,1,6
33422,1,2434,2364,70,0,61,0,6
33423,2,2428,2380,48,0,405,0,6
33424,2,2284,2668,-384,0,302,0,6
33425,1,2552,2439,113,0,112,1,6
33426,2,2374,2444,-70,0,315,0,6
33427,2,2366,2405,-39,0,344,1,6
33428,2,2377,2531,-154,0,358,0,6
33429,2,2282,2674,-392,0,483,0,6
33430,3,2323,2478,-155,0,302,0,6
33431,1,2503,2471,32,0,106,1,6
33432,1,2426,2499,-73,0,217,0,6
33433,1,2613,2452,161,0,4,0,6
33434,2,2431,2312,119,0,373,0,6
33435,1,2594,2362,232,0,5,1,6
33436,1,2405,2263,142,0,244,0,6
33437,2,2397,2413,-16,0,218,1,6
33438,2,2312,2559,-247,0,121,1,6
33439,2,2230,2449,-219,0,310,0,6
33440,2,2376,2575,-199,0,62,0,6
33441,3,2633,2480,153,0,250,0,6
33442,1,2561,2573,-12,0,255,0,6
33443,2,2551,2246,305,0,4,1,6
33444,2,2405,2251,154,0,4,1,6
33445,3,2411,2432,-21,0,201,0,6
33446,2,2444,2410,34,0,428,0,6
33447,1,2418,2311,107,0,107,1,6
33448,1,2434,2361,73,0,247,0,6
33449,2,2425,2312,113,0,130,0,6
33450,1,2467,2237,230,0,130,1,6
33451,2,2405,2630,-225,0,36,0,6
33452,2,2442,2520,-78,0,134,0,6
33453,2,2407,2464,-57,0,113,1,6
33454,1,2348,2492,-144,0,211,0,6
33455,1,2401,2517,-116,0,110,0,6
33456,1,2461,2317,144,0,43,0,6
33457,2,2433,2378,55,0,218,0,6
33459,1,2412,2254,158,0,373,0,6
33460,3,2404,2229,175,0,43,0,6
33461,1,2267,2419,-152,0,34,0,6
33462,1,2424,2321,103,0,4,1,6
33463,2,2418,2324,94,4,301,0,13
33464,2,2556,2369,187,0,398,0,6
33465,2,2618,2542,76,0,302,0,6
33466,3,2366,2567,-201,0,457,0,6
33467,1,2421,2274,147,0,102,0,6
33468,2,2460,2544,-84,0,121,0,6
33469,1,2463,2399,64,0,211,0,6
33470,2,2469,2533,-64,0,202,0,6
33471,1,2490,2581,-91,0,301,0,6
33472,1,2479,2444,35,0,200,1,6
33473,1,2265,2624,-359,0,106,0,6
33474,1,2711,2549,162,0,190,0,6
33475,3,2432,2603,-171,0,380,0,6
33476,1,2467,2624,-157,0,187,1,6
33477,1,2361,2427,-66,0,4,0,6
33478,1,2478,2310,168,0,11,0,6
33479,1,2522,2211,311,0,4,0,6
33480,2,2288,2455,-167,0,355,1,6
33481,2,2412,2401,11,0,263,0,6
33482,1,2280,2439,-159,0,242,0,6
33483,3,2453,2353,100,0,112,0,6
33484,1,2492,2586,-94,0,20,1,6
33485,1,2410,2340,70,4,49,0,13
33487,2,2386,2438,-52,0,268,0,6
33488,2,2609,2561,48,0,101,0,6
33489,2,2421,2630,-209,0,132,0,6
33490,3,2484,2563,-79,0,307,0,6
33491,1,2705,2593,112,0,153,0,6
33492,2,2446,2444,2,0,455,1,6
33493,1,2468,2455,13,0,40,0,6
33494,1,2398,2433,-35,0,106,0,6
33495,1,2449,2320,129,0,120,0,6
33496,3,2573,2544,29,0,46,0,6
33498,1,2480,2307,173,0,130,0,6
33499,1,2449,2467,-18,0,89,0,6
33500,2,2412,2286,126,0,5,1,6
33501,1,2575,2396,179,0,5,1,6
33502,1,2475,2213,262,0,359,0,6
33503,1,2486,2394,92,0,15,0,6
33504,2,2326,2412,-86,0,45,0,6
33505,2,2258,2419,-161,0,112,0,6
33506,1,2231,2421,-190,0,300,1,6
33507,3,2584,2679,-95,0,45,0,6
33508,1,2511,2395,116,0,40,0,6
33509,2,2204,2449,-245,0,315,1,6
33510,2,2504,2509,-5,0,145,0,6
33511,2,2578,2566,12,0,101,0,6
33512,1,2350,2447,-97,0,4,0,6
33513,2,2373,2404,-31,0,456,0,6
33514,2,2503,2202,301,0,311,0,6
33515,2,2200,2481,-281,0,7,0,6
33516,1,2545,2320,225,0,337,0,6
33517,1,2470,2264,206,0,112,0,6
33518,2,2591,2340,251,0,101,1,6
33519,1,2284,2441,-157,0,120,0,6
33520,2,2366,2426,-60,0,100,0,6
33521,1,2557,2733,-176,0,305,0,6
33522,1,2519,2380,139,0,45,0,6
33523,1,2411,2558,-147,0,1,0,6
33524,3,2537,2436,101,0,146,0,6
33525,1,2551,2592,-41,0,352,0,6
33526,1,2553,2435,118,0,302,0,6
33527,2,2251,2450,-199,0,3,0,6
33528,2,2400,2245,155,0,45,1,6
33529,1,2404,2553,-149,0,107,0,6
33530,2,2408,2336,72,0,46,1,6
33531,1,2464,2412,52,0,107,0,6
33532,2,2487,2421,66,0,51,0,6
33533,1,2499,2363,136,0,300,0,6
33534,3,2418,2260,158,0,46,0,6
33535,1,2516,2498,18,0,3,0,6
33536,2,2366,2403,-37,0,312,0,6
33537,3,2254,2415,-161,0,344,0,6
33538,1,2459,2612,-153,0,338,0,8
33539,1,2454,2236,218,0,5,0,6
33540,1,2374,2482,-108,0,127,0,6
33541,1,2422,2357,65,0,40,0,6
33542,2,2252,2549,-297,0,0,0,6
33543,1,2358,2444,-86,0,147,0,6
33544,1,2547,2449,98,0,122,0,6
33545,2,2343,2463,-120,0,106,1,6
33546,2,2387,2466,-79,0,131,0,6
33547,1,2455,2500,-45,0,100,1,6
33548,2,2394,2486,-92,0,106,0,6
33549,1,2419,2337,82,0,40,0,6
33550,1,2437,2299,138,0,100,0,6
33551,2,2256,2429,-173,0,45,0,6
33552,3,2455,2376,79,0,240,0,6
33553,1,2458,2334,124,0,133,1,6
33554,1,2678,2451,227,0,105,1,6
33555,2,2302,2484,-182,0,476,0,6
33556,1,2450,2348,102,4,101,0,13
33557,2,2375,2475,-100,0,302,0,6
33558,1,2402,2274,128,0,10,0,6
33559,1,2369,2410,-41,0,9,0,6
33560,2,2279,2419,-140,0,15,1,6
33561,3,2476,2477,-1,0,110,0,6
33562,2,2763,2694,69,0,150,1,6
33563,2,2606,2552,54,0,490,0,6
33564,2,2478,2530,-52,0,101,0,6
33565,3,2530,2536,-6,0,102,0,6
33566,1,2625,2292,333,0,45,0,6
33567,1,2407,2283,124,0,45,0,6
33568,1,2557,2534,23,0,106,0,6
33569,1,2669,2360,309,0,244,0,6
33570,2,2409,2554,-145,0,242,0,6
33571,2,2386,2522,-136,0,315,1,6
33572,2,2402,2368,34,0,469,0,6
33573,1,2508,2453,55,0,411,0,6
33574,2,2402,2536,-134,0,211,0,6
33575,2,2313,2448,-135,0,107,0,6
33576,2,2465,2616,-151,0,201,0,6
33577,1,2311,2427,-116,0,301,0,6
33578,1,2360,2505,-145,0,419,0,6
33579,2,2328,2503,-175,0,40,0,6
33580,1,2242,2424,-182,0,210,0,6
33581,2,2321,2410,-89,0,122,0,6
33582,2,2563,2324,239,0,11,0,6
33583,1,2453,2352,101,0,1,0,6
33584,2,2527,2438,89,0,337,1,6
33585,1,2544,2373,171,0,0,0,6
33586,1,2377,2484,-107,0,49,0,6
33587,1,2522,2241,281,0,45,0,6
33588,1,2535,2455,80,0,389,0,6
33589,2,2461,2432,29,0,245,0,6
33590,2,2521,2465,56,0,253,1,6
33591,2,2426,2432,-6,0,140,1,6
33592,1,2491,2589,-98,0,301,0,6
33593,1,2359,2709,-350,0,109,0,6
33594,2,2234,2453,-219,0,206,0,6
33595,2,2224,2490,-266,0,1,1,6
33596,1,2487,2393,94,0,40,0,6
33597,1,2303,2533,-230,0,205,0,6
33598,1,2545,2378,167,0,121,0,6
33599,2,2509,2585,-76,0,0,0,6
33600,2,2503,2510,-7,0,40,0,6
33601,2,2437,2364,73,0,217,0,6
33602,1,2523,2490,33,0,106,1,6
33603,1,2474,2382,92,0,8,0,6
33604,1,2519,2236,283,0,463,0,6
33605,1,2478,2439,39,0,331,0,6
33606,1,2382,2429,-47,0,65,0,6
33607,1,2585,2352,233,0,244,0,6
33608,2,2435,2305,130,0,14,0,6
33609,2,2439,2565,-126,0,5,0,6
33610,2,2725,2633,92,0,4,0,6
33611,2,2417,2599,-182,0,122,0,6
33612,3,2637,2550,87,0,106,0,6
33613,1,2302,2501,-199,0,0,1,6
33614,2,2431,2234,197,0,40,0,6
33615,2,2342,2538,-196,0,330,0,8
33616,2,2432,2457,-25,0,192,0,6
33617,1,2340,2419,-79,0,49,0,6
33618,2,2380,2428,-48,0,247,0,6
33619,1,2468,2611,-143,0,211,0,6
33620,2,2452,2603,-151,0,43,0,6
33621,2,2291,2567,-276,0,45,0,6
33622,1,2506,2419,87,0,45,0,6
33623,2,2633,2568,65,0,246,0,6
33624,3,2293,2407,-114,0,4,0,6
33625,1,2233,2469,-236,0,255,1,6
33626,1,2449,2310,139,0,41,0,6
33627,1,2458,2292,166,0,85,0,6
33628,2,2420,2308,112,0,30,0,6
33629,1,2677,2308,369,0,260,0,6
33630,3,2567,2552,15,0,205,0,6
33631,1,2432,2218,214,0,3,0,6
33632,2,2484,2355,129,0,180,1,6
33633,1,2433,2249,184,0,300,0,6
33634,2,2418,2437,-19,0,190,0,6
33635,1,2504,2294,210,0,122,0,6
33636,2,2297,2425,-128,0,337,0,6
33637,1,2534,2475,59,0,45,0,6
33638,2,2306,2498,-192,0,200,0,6
33639,1,2562,2402,160,0,103,1,6
33640,2,2330,2540,-210,0,115,1,6
33641,2,2408,2385,23,0,263,1,6
33642,1,2452,2290,162,0,210,0,6
33643,1,2430,2364,66,0,37,0,6
33644,2,2688,2671,17,0,101,0,6
33645,2,2358,2485,-127,0,9,0,6
33646,2,2350,2406,-56,0,122,0,6
33647,2,2393,2407,-14,0,263,1,6
33648,1,2452,2357,95,0,43,0,6
33649,1,2494,2523,-29,0,303,1,6
33650,2,2202,2499,-297,0,154,0,6
33651,2,2236,2468,-232,0,0,0,6
33652,1,2533,2354,179,0,43,0,6
33653,2,2515,2549,-34,0,40,0,6
33654,2,2358,2496,-138,0,40,0,6
33655,1,2574,2498,76,0,130,0,6
33656,3,2354,2458,-104,0,15,0,6
33657,2,2257,2421,-164,0,5,0,6
33658,3,2404,2471,-67,0,22,0,6
33659,3,2367,2508,-141,0,302,0,6
33660,2,2439,2201,238,0,4,0,6
33661,1,2417,2261,156,0,301,0,6
33662,2,2437,2248,189,0,0,1,6
33663,1,2545,2439,106,0,216,0,6
33664,1,2616,2714,-98,0,100,0,6
33665,1,2545,2485,60,0,101,0,6
33666,1,2586,2270,316,0,50,0,6
33667,1,2413,2293,120,0,123,0,6
33668,1,2315,2400,-85,0,260,1,6
33669,2,2449,2242,207,0,40,0,6
33670,2,2260,2473,-213,0,57,0,6
33671,2,2572,2581,-9,0,312,0,6
33672,2,2572,2498,74,0,307,0,6
33673,2,2304,2407,-103,0,210,1,6
33674,2,2352,2572,-220,0,5,0,6
33675,2,2476,2334,142,0,45,0,6
33676,1,2522,2430,92,0,3,0,6
33677,2,2526,2546,-20,0,16,0,6
33678,1,2418,2272,146,0,131,1,6
33679,3,2447,2515,-68,0,107,0,6
33680,2,2597,2508,89,0,4,0,6
33681,1,2360,2415,-55,0,7,0,6
33682,2,2437,2465,-28,0,331,0,6
33683,2,2391,2500,-109,0,2,0,6
33684,2,2640,2675,-35,0,123,0,6
33685,2,2464,2483,-19,0,46,0,6
33686,2,2420,2557,-137,0,311,0,6
33687,3,2585,2350,235,0,15,0,6
33688,2,2326,2718,-392,0,113,0,6
33689,1,2431,2320,111,0,311,0,6
33690,1,2469,2281,188,0,100,0,6
33691,1,2483,2297,186,0,230,0,6
33692,2,2418,2354,64,0,1,0,6
33693,2,2408,2294,114,0,45,1,8
33694,1,2453,2377,76,0,16,1,6
33695,2,2306,2464,-158,0,48,0,6
33696,1,2538,2547,-9,0,118,0,6
33697,2,2396,2464,-68,0,484,0,6
33698,1,2567,2449,118,0,211,1,6
33699,3,2378,2541,-163,0,217,0,6
33700,1,2256,2440,-184,0,106,0,6
33701,2,2387,2424,-37,0,216,0,6
33702,2,2606,2567,39,0,221,0,6
33703,2,2698,2508,190,0,4,0,6
33704,2,2443,2406,37,0,327,1,6
33705,2,2264,2493,-229,0,107,0,6
33706,2,2452,2409,43,0,222,0,6
33707,1,2409,2267,142,0,40,0,6
33708,1,2556,2259,297,0,122,0,6
33709,2,2264,2433,-169,0,190,0,6
33710,1,2626,2363,263,0,46,0,6
33711,2,2368,2435,-67,0,14,1,6
33712,2,2372,2600,-228,0,45,0,6
33713,1,2416,2242,174,0,200,0,6
33714,1,2453,2432,21,0,101,0,6
33715,2,2433,2462,-29,0,211,0,6
33716,1,2620,2440,180,0,8,0,6
33717,2,2203,2588,-385,0,46,0,6
33718,1,2607,2412,195,0,398,0,6
33719,2,2296,2492,-196,0,2,0,6
33720,1,2564,2219,345,0,101,0,6
33721,1,2338,2443,-105,0,432,0,6
33722,1,2293,2401,-108,0,122,0,6
33723,1,2419,2240,179,0,200,1,6
33724,2,2425,2480,-55,0,302,0,6
33725,2,2218,2423,-205,0,200,0,8
33726,1,2416,2233,183,0,201,0,6
33727,2,2320,2678,-358,0,5,0,6
33728,1,2423,2397,26,0,80,0,6
33729,1,2461,2319,142,0,374,0,6
33730,3,2486,2453,33,0,455,0,6
33731,2,2459,2268,191,0,302,0,6
33732,1,2519,2472,47,0,145,0,6
33733,1,2550,2549,1,0,5,0,6
33734,1,2545,2419,126,0,100,0,6
33735,2,2269,2481,-212,0,255,0,6
33736,1,2493,2357,136,0,100,0,6
33737,2,2307,2477,-170,0,40,0,6
33738,2,2480,2573,-93,0,0,0,6
33739,3,2475,2473,2,0,125,0,6
33740,2,2411,2376,35,0,80,0,6
33741,1,2562,2484,78,0,395,0,6
33742,1,2501,2485,16,0,115,0,6
33743,2,2445,2408,37,0,205,0,6
33744,1,2471,2378,93,0,483,1,6
33745,1,2474,2200,274,0,0,0,6
33746,2,2304,2431,-127,0,243,1,6
33747,1,2433,2347,86,0,110,0,6
33748,1,2353,2464,-111,0,48,0,6
33749,2,2262,2491,-229,0,305,0,6
33750,2,2451,2328,123,0,88,0,6
33751,1,2403,2232,171,0,5,0,6
33752,2,2613,2564,49,0,9,0,6
33753,1,2410,2360,50,0,1,1,6
33754,1,2438,2526,-88,0,380,0,6
33755,2,2334,2437,-103,0,463,0,6
33756,3,2477,2535,-58,0,101,0,6
33757,2,2435,2547,-112,0,107,0,6
33758,1,2422,2535,-113,0,43,0,6
33759,2,2243,2476,-233,0,4,1,6
33760,2,2370,2549,-179,0,339,0,6
33763,2,2424,2404,20,0,204,1,6
33764,1,2489,2452,37,0,40,0,6
33765,2,2359,2507,-148,0,140,0,6
33766,2,2291,2548,-257,0,265,1,6
33767,3,2495,2456,39,0,40,0,6
33768,1,2524,2260,264,0,455,0,6
33769,3,2401,2397,4,0,105,0,6
33770,3,2551,2375,176,0,122,0,6
33771,2,2431,2364,67,0,100,0,6
33772,1,2699,2396,303,0,140,0,6
33773,1,2327,2473,-146,0,125,1,6
33774,1,2616,2237,379,0,15,1,6
33775,2,2253,2470,-217,0,250,0,6
33776,2,2427,2416,11,0,107,0,6
33777,1,2602,2325,277,0,240,0,6
33778,1,2614,2338,276,0,400,0,6
33779,1,2346,2435,-89,0,102,1,6
33780,2,2384,2420,-36,0,4,0,6
33781,3,2719,2416,303,0,7,0,6
33782,2,2450,2427,23,0,41,1,6
33783,1,2474,2337,137,0,300,0,6
33784,2,2295,2551,-256,0,110,1,6
33785,2,2334,2416,-82,0,300,0,6
33786,2,2405,2290,115,0,1,0,6
33787,2,2359,2561,-202,0,131,0,6
33788,2,2400,2392,8,0,0,0,6
33789,2,2480,2317,163,0,112,0,6
33790,1,2476,2536,-60,0,459,1,6
33791,1,2511,2406,105,0,109,0,6
33792,1,2369,2411,-42,0,218,1,6
33793,1,2406,2412,-6,0,485,0,6
33794,1,2495,2325,170,0,49,0,6
33795,1,2455,2472,-17,0,243,1,6
33796,1,2558,2561,-3,0,170,0,6
33797,2,2405,2414,-9,0,4,0,6
33798,3,2680,2493,187,0,337,0,6
33799,2,2438,2461,-23,0,140,0,6
33800,2,2377,2441,-64,0,106,0,6
33801,2,2215,2451,-236,0,315,0,6
33802,2,2202,2435,-233,0,89,0,6
33803,2,2229,2441,-212,0,103,0,6
33804,2,2541,2317,224,0,253,0,8
33805,1,2433,2450,-17,0,58,1,6
33806,1,2501,2506,-5,0,474,0,6
33807,1,2455,2303,152,0,12,0,6
33808,2,2472,2521,-49,0,106,0,6
33809,1,2314,2435,-121,0,140,1,6
33810,1,2516,2343,173,0,124,0,6
33811,1,2411,2321,90,0,112,0,6
33812,2,2498,2402,96,0,46,0,6
33813,1,2432,2448,-16,0,40,0,6
33814,2,2554,2414,140,0,1,0,6
33815,2,2265,2476,-211,0,200,1,6
33816,1,2587,2557,30,0,483,0,6
33817,1,2470,2311,159,0,41,1,6
33818,1,2603,2513,90,0,303,0,6
33819,1,2566,2510,56,0,88,0,6
33820,1,2409,2351,58,0,141,0,6
33821,2,2427,2492,-65,0,7,0,6
33823,1,2610,2384,226,0,57,0,6
33824,1,2458,2290,168,0,40,0,6
33825,1,2473,2296,177,0,110,0,6
33826,3,2350,2528,-178,0,40,0,6
33827,2,2485,2562,-77,0,54,0,6
33828,2,2443,2492,-49,0,123,0,6
33829,1,2355,2421,-66,0,106,1,6
33830,2,2453,2281,172,0,131,0,6
33831,2,2435,2538,-103,0,7,0,6
33832,2,2569,2470,99,0,0,0,6
33833,2,2332,2599,-267,0,0,0,6
33834,1,2374,2424,-50,0,57,0,6
33835,1,2479,2333,146,0,40,0,6
33836,2,2413,2295,118,0,104,0,6
33837,1,2297,2428,-131,0,15,0,6
33838,1,2626,2391,235,0,200,0,6
33839,2,2575,2469,106,0,49,0,6
33840,1,2417,2392,25,0,23,0,6
33841,3,2415,2329,86,0,335,0,6
33842,2,2422,2307,115,0,10,1,6
33843,1,2437,2358,79,0,14,0,6
33844,2,2322,2429,-107,0,0,0,6
33845,3,2431,2757,-326,0,108,0,6
33846,1,2450,2354,96,0,46,0,6
33847,2,2551,2701,-150,0,9,1,6
33848,2,2364,2524,-160,0,127,0,6
33849,1,2539,2402,137,0,455,0,6
33850,1,2265,2436,-171,0,176,0,6
33851,1,2343,2418,-75,0,334,0,8
33852,3,2681,2524,157,0,199,0,6
33853,2,2378,2476,-98,0,130,0,6
33854,2,2509,2409,100,0,337,1,6
33855,1,2460,2548,-88,0,101,0,6
33856,1,2468,2375,93,0,190,0,6
33857,2,2307,2515,-208,0,151,1,6
33858,2,2340,2590,-250,0,4,0,6
33859,2,2456,2237,219,0,101,0,6
33860,1,2496,2217,279,0,107,1,6
33861,1,2399,2476,-77,0,337,0,6
33862,2,2375,2440,-65,0,200,0,6
33863,1,2467,2425,42,0,200,0,6
33864,2,2449,2464,-15,0,0,0,6
33865,2,2271,2682,-411,0,325,0,6
33866,1,2678,2378,300,0,150,1,6
33867,1,2495,2508,-13,0,15,0,6
33868,1,2707,2562,145,0,236,0,6
33869,2,2544,2530,14,0,197,0,6
33870,3,2577,2624,-47,0,311,0,6
33871,1,2478,2476,2,0,100,0,6
33872,2,2535,2556,-21,0,46,0,6
33873,1,2582,2565,17,0,143,0,6
33874,1,2427,2219,208,0,45,0,6
33875,3,2445,2271,174,0,0,0,8
33876,3,2436,2432,4,0,106,0,6
33878,1,2511,2588,-77,0,203,1,6
33879,2,2604,2476,128,0,3,0,8
33880,2,2361,2478,-117,0,40,0,6
33881,2,2394,2542,-148,0,395,0,6
33882,2,2538,2544,-6,0,5,1,6
33883,1,2525,2251,274,0,45,0,6
33884,1,2701,2565,136,0,100,0,6
33885,3,2501,2430,71,0,100,0,6
33886,2,2224,2553,-329,0,427,0,6
33887,2,2528,2341,187,0,117,0,6
33888,1,2322,2504,-182,0,122,0,6
33889,1,2455,2322,133,0,125,0,6
33890,1,2590,2374,216,0,40,0,6
33891,1,2494,2213,281,0,4,0,6
33892,1,2257,2494,-237,0,45,1,6
33893,3,2447,2558,-111,0,224,0,6
33894,2,2436,2395,41,0,151,0,6
33895,2,2360,2427,-67,0,133,0,6
33896,2,2411,2337,74,0,1,0,6
33897,1,2424,2521,-97,0,45,1,6
33898,2,2479,2578,-99,0,331,0,6
33899,2,2446,2452,-6,0,247,0,6
33900,2,2359,2513,-154,0,148,0,6
33903,2,2424,2440,-16,0,10,0,6
33905,1,2375,2515,-140,0,40,0,6
33906,2,2505,2402,103,0,301,1,6
33907,2,2244,2442,-198,0,16,0,6
33908,1,2414,2375,39,0,368,0,8
33909,1,2240,2437,-197,0,40,0,8
33910,1,2271,2407,-136,0,143,1,6
33911,1,2387,2514,-127,0,3,0,6
33912,1,2378,2471,-93,0,229,0,6
33913,1,2557,2244,313,0,302,0,6
33914,2,2536,2551,-15,0,106,1,6
33915,1,2636,2497,139,0,278,0,6
33916,1,2484,2336,148,0,11,0,6
33917,1,2492,2353,139,0,112,0,6
33918,1,2680,2526,154,0,241,0,6
33919,2,2391,2426,-35,0,120,0,6
33920,1,2412,2298,114,0,20,0,6
33921,1,2420,2398,22,0,190,1,6
33922,2,2318,2436,-118,0,461,1,6
33923,2,2399,2528,-129,0,150,0,6
33924,2,2445,2372,73,0,18,0,6
33925,1,2520,2363,157,0,37,0,6
33926,2,2506,2459,47,0,108,0,6
33927,2,2488,2623,-135,0,20,0,6
33928,2,2437,2500,-63,0,111,0,6
33929,2,2445,2600,-155,0,120,0,6
33930,1,2573,2571,2,0,122,0,6
33931,1,2218,2486,-268,0,324,0,6
33932,1,2392,2402,-10,0,105,1,6
33933,1,2478,2328,150,0,203,1,6
33934,2,2302,2543,-241,0,110,0,6
33935,2,2299,2587,-288,0,45,0,6
33936,1,2323,2538,-215,0,153,0,6
33937,2,2479,2604,-125,0,151,0,6
33938,1,2514,2448,66,0,45,1,6
33939,1,2564,2469,95,0,106,0,6
33940,2,2367,2425,-58,0,130,0,6
33941,1,2425,2405,20,0,194,0,6
33942,1,2470,2247,223,0,110,0,6
33943,2,2402,2282,120,0,301,0,6
33944,1,2690,2478,212,0,108,0,6
33945,2,2432,2476,-44,0,140,0,6
33946,3,2500,2507,-7,0,229,0,6
33947,2,2422,2521,-99,0,241,0,6
33948,2,2212,2463,-251,0,132,0,6
33949,2,2211,2421,-210,0,40,0,6
33950,1,2589,2380,209,0,85,0,6
33951,2,2517,2347,170,0,4,0,6
33952,2,2613,2422,191,0,398,0,6
33953,2,2480,2571,-91,0,6,0,6
33954,1,2436,2344,92,0,40,1,6
33955,2,2505,2506,-1,0,43,0,6
33956,3,2445,2561,-116,0,335,0,6
33957,1,2567,2564,3,0,107,0,6
33958,1,2237,2450,-213,0,335,0,6
33959,1,2545,2268,277,0,4,1,6
33960,1,2534,2466,68,0,230,1,6
33961,1,2480,2299,181,0,120,0,6
33962,1,2543,2470,73,0,79,0,6
33963,2,2405,2241,164,0,103,0,6
33964,1,2455,2478,-23,0,49,0,6
33965,2,2483,2431,52,0,190,0,6
33966,1,2603,2461,142,0,177,0,6
33967,1,2264,2419,-155,0,45,1,6
33968,1,2484,2334,150,0,0,0,6
33969,2,2526,2415,111,0,4,0,6
33970,2,2317,2472,-155,0,0,0,6
33971,2,2204,2428,-224,0,52,0,6
33972,3,2438,2428,10,0,201,0,6
33973,1,2496,2467,29,0,326,1,6
33974,1,2393,2548,-155,0,466,0,6
33975,1,2480,2546,-66,0,40,0,6
33976,2,2422,2566,-144,0,190,0,6
33977,1,2519,2526,-7,0,109,0,6
33978,1,2554,2548,6,0,406,0,6
33979,1,2416,2404,12,0,1,0,6
33980,2,2270,2405,-135,0,41,1,6
33981,2,2416,2355,61,0,8,0,6
33982,1,2464,2419,45,0,28,0,6
33983,1,2414,2412,2,0,327,0,6
33984,1,2502,2322,180,0,300,0,6
33985,2,2501,2618,-117,0,7,0,6
33986,2,2485,2467,18,0,404,0,6
33987,2,2465,2340,125,0,101,0,6
33988,2,2382,2439,-57,0,190,0,6
33989,2,2372,2704,-332,0,154,0,6
33990,1,2414,2246,168,0,131,0,6
33991,2,2566,2562,4,0,255,0,6
33992,1,2579,2629,-50,0,250,0,6
33993,2,2391,2401,-10,0,140,1,6
33994,2,2454,2395,59,0,41,0,6
33995,2,2422,2256,166,0,110,1,6
33996,2,2299,2489,-190,0,101,0,6
33997,2,2378,2494,-116,0,200,0,6
33998,1,2457,2592,-135,0,409,0,6
33999,1,2715,2564,151,0,373,0,6
34000,2,2295,2616,-321,0,106,0,6
34001,1,2555,2421,134,0,335,0,6
34002,1,2357,2484,-127,0,10,0,6
34003,1,2435,2420,15,0,100,1,6
34004,1,2313,2416,-103,0,49,0,6
34005,2,2242,2407,-165,0,315,1,6
34006,2,2524,2493,31,0,125,0,6
34007,1,2447,2314,133,0,80,0,6
34008,1,2485,2381,104,0,11,1,6
34009,1,2552,2442,110,0,0,0,6
34010,2,2507,2442,65,0,4,0,6
34011,1,2604,2383,221,0,112,0,6
34012,2,2301,2438,-137,0,106,1,6
34013,2,2393,2529,-136,0,162,0,6
34014,1,2555,2243,312,0,10,0,6
34015,1,2331,2404,-73,0,101,0,6
34016,2,2330,2459,-129,0,0,0,6
34017,2,2330,2445,-115,0,380,1,6
34018,2,2217,2475,-258,0,40,0,6
34019,2,2518,2442,76,0,245,1,6
34020,3,2601,2677,-76,0,484,0,6
34021,1,2440,2432,8,0,245,0,6
34022,1,2496,2467,29,0,102,1,6
34023,1,2489,2363,126,0,101,0,6
34024,1,2473,2425,48,0,121,0,6
34025,2,2403,2372,31,0,190,1,6
34026,2,2479,2506,-27,0,200,0,6
34027,1,2593,2221,372,0,48,0,6
34028,2,2526,2567,-41,0,18,0,6
34029,2,2470,2480,-10,0,45,0,6
34030,1,2472,2413,59,0,255,1,6
34031,1,2523,2394,129,0,3,0,6
34032,1,2421,2337,84,0,46,1,6
34033,2,2532,2405,127,0,223,1,6
34034,2,2263,2491,-228,0,200,0,6
34035,1,2427,2424,3,0,106,1,6
34036,1,2344,2461,-117,0,3,0,6
34037,1,2540,2262,278,0,244,0,6
34038,1,2592,2259,333,0,40,0,6
34039,1,2479,2401,78,0,102,0,6
34040,1,2420,2374,46,0,4,0,6
34041,2,2529,2435,94,0,216,0,6
34042,1,2753,2332,421,0,221,0,6
34043,2,2430,2280,150,0,190,0,6
34044,1,2225,2429,-204,0,131,0,6
34045,1,2395,2544,-149,0,2,0,6
34046,1,2440,2500,-60,0,50,1,6
34047,2,2377,2501,-124,0,414,0,6
34048,3,2415,2366,49,0,46,0,6
34049,1,2482,2410,72,0,40,0,6
34050,1,2294,2541,-247,0,40,0,6
34051,2,2354,2460,-106,0,404,0,6
34052,1,2545,2527,18,0,315,0,6
34053,1,2706,2486,220,0,222,0,6
34054,2,2472,2401,71,0,102,0,6
34055,1,2540,2370,170,0,398,0,6
34056,2,2386,2483,-97,0,407,1,6
34057,1,2560,2403,157,0,123,0,6
34058,2,2279,2588,-309,0,455,0,6
34059,1,2270,2405,-135,0,310,0,6
34060,1,2473,2205,268,0,102,0,6
34061,1,2554,2214,340,0,4,0,6
34062,1,2442,2684,-242,0,9,0,6
34063,3,2353,2469,-116,0,228,0,6
34064,2,2238,2473,-235,0,43,0,6
34065,2,2433,2232,201,0,40,0,6
34066,2,2278,2444,-166,0,207,0,6
34067,2,2462,2693,-231,0,100,1,6
34068,2,2462,2559,-97,0,40,1,6
34069,1,2430,2276,154,0,45,0,6
34070,2,2357,2447,-90,0,326,0,6
34071,2,2344,2731,-387,0,4,0,6
34072,1,2508,2431,77,0,216,0,6
34073,2,2476,2608,-132,0,211,0,6
34074,1,2567,2483,84,0,200,1,6
34075,1,2397,2469,-72,0,302,0,6
34076,1,2525,2329,196,0,245,0,6
34077,1,2418,2248,170,0,107,0,6
34078,1,2575,2349,226,0,5,0,6
34079,2,2509,2372,137,0,4,1,6
34080,2,2468,2230,238,0,200,0,6
34081,2,2362,2420,-58,0,300,0,6
34082,2,2396,2496,-100,0,100,0,6
34083,2,2487,2461,26,0,11,0,6
34084,2,2331,2547,-216,0,113,0,6
34085,3,2472,2606,-134,0,154,0,6
34086,1,2478,2458,20,0,248,0,6
34087,2,2465,2753,-288,0,0,0,6
34088,2,2238,2427,-189,0,139,0,6
34089,2,2481,2458,23,0,145,0,6
34090,3,2678,2607,71,0,100,0,6
34091,2,2377,2442,-65,0,2,0,6
34092,1,2422,2266,156,0,140,0,6
34093,1,2416,2290,126,0,120,0,6
34094,2,2485,2680,-195,0,302,0,6
34095,1,2684,2592,92,0,211,1,6
34096,2,2203,2459,-256,0,120,1,6
34097,1,2397,2427,-30,0,140,0,6
34098,1,2466,2377,89,0,255,0,6
34099,1,2549,2444,105,0,207,1,6
34100,2,2308,2533,-225,0,200,0,6
34101,1,2387,2482,-95,0,140,1,6
34102,1,2253,2430,-177,0,302,0,6
34103,2,2445,2362,83,0,62,1,6
34104,1,2414,2328,86,0,300,0,6
34106,1,2423,2349,74,0,161,0,6
34107,1,2390,2518,-128,0,41,1,6
34108,2,2387,2415,-28,0,190,1,6
34109,2,2270,2402,-132,0,241,1,6
34110,2,2361,2547,-186,0,5,0,6
34111,2,2558,2560,-2,0,46,0,6
34112,2,2543,2398,145,0,113,0,6
34113,3,2238,2480,-242,0,133,0,6
34114,2,2528,2381,147,0,45,0,6
34115,1,2710,2543,167,0,210,0,6
34116,1,2434,2290,144,0,151,0,6
34117,3,2461,2431,30,0,145,0,6
34118,2,2505,2414,91,0,48,1,6
34119,1,2411,2342,69,0,395,0,6
34120,1,2349,2604,-255,0,418,1,6
34121,2,2390,2433,-43,0,4,0,6
34122,1,2431,2330,101,0,112,1,6
34123,1,2528,2443,85,0,40,1,6
34124,2,2438,2320,118,0,101,0,6
34125,2,2447,2247,200,0,106,1,6
34126,1,2203,2417,-214,0,46,1,6
34127,1,2243,2458,-215,0,45,0,6
34128,1,2622,2476,146,0,115,0,6
34129,1,2576,2383,193,0,304,0,6
34130,1,2705,2477,228,0,4,0,6
34131,2,2438,2548,-110,0,4,0,6
34132,1,2430,2263,167,0,395,0,6
34133,1,2514,2321,193,0,405,0,6
34134,2,2363,2421,-58,0,201,0,6
34135,1,2518,2594,-76,0,267,0,6
34136,1,2304,2428,-124,0,140,0,6
34137,1,2267,2438,-171,0,247,0,6
34138,1,2423,2305,118,0,106,1,6
34139,1,2458,2361,97,0,332,1,6
34140,1,2207,2440,-233,0,40,0,6
34141,1,2481,2407,74,4,40,0,13
34142,1,2629,2308,321,0,474,0,6
34143,2,2311,2492,-181,0,0,1,6
34144,2,2499,2498,1,0,307,0,6
34145,1,2606,2586,20,0,242,0,6
34146,2,2381,2512,-131,0,43,0,6
34147,2,2409,2365,44,0,132,0,6
34148,2,2446,2533,-87,0,0,1,6
34149,1,2419,2327,92,0,400,0,6
34150,1,2566,2384,182,0,38,0,6
34151,2,2407,2380,27,0,215,0,6
34152,1,2390,2440,-50,0,247,1,6
34153,2,2344,2411,-67,0,80,0,6
34154,1,2556,2291,265,0,112,0,6
34155,1,2385,2449,-64,0,315,0,6
34156,1,2442,2578,-136,0,211,0,6
34157,2,2522,2530,-8,0,102,0,6
34158,2,2324,2500,-176,0,210,0,6
34159,1,2618,2427,191,0,46,0,6
34160,2,2275,2445,-170,0,4,0,6
34161,2,2304,2481,-177,0,123,0,6
34162,2,2647,2431,216,0,100,0,6
34163,1,2623,2561,62,0,104,0,6
34164,1,2422,2281,141,0,101,0,6
34165,2,2415,2498,-83,0,310,0,6
34166,1,2322,2584,-262,0,200,0,6
34167,3,2626,2465,161,0,4,0,6
34168,2,2536,2387,149,0,7,0,6
34169,1,2622,2315,307,0,5,0,6
34170,1,2505,2497,8,0,133,0,6
34171,1,2490,2271,219,0,204,0,6
34172,1,2422,2295,127,0,45,1,6
34173,1,2302,2400,-98,0,241,0,8
34174,2,2369,2542,-173,0,106,0,6
34175,1,2570,2260,310,0,20,0,6
34176,1,2755,2539,216,0,101,0,6
34177,1,2354,2464,-110,0,10,0,6
34178,2,2462,2589,-127,0,246,0,6
34179,1,2411,2443,-32,0,263,0,8
34180,2,2341,2502,-161,0,41,1,6
34181,3,2462,2329,133,0,101,0,6
34182,2,2436,2356,80,0,250,1,6
34183,2,2267,2402,-135,0,110,0,6
34184,1,2412,2422,-10,0,331,1,6
34185,2,2411,2235,176,0,203,0,6
34186,1,2527,2273,254,0,3,0,6
34187,2,2207,2409,-202,0,300,0,6
34188,1,2429,2380,49,0,48,0,6
34189,1,2519,2362,157,0,122,1,6
34190,2,2581,2551,30,0,208,0,6
34191,1,2456,2339,117,0,101,0,6
34192,1,2449,2560,-111,0,56,0,6
34193,2,2568,2556,12,0,140,0,6
34194,2,2419,2500,-81,0,101,0,6
34195,3,2520,2470,50,0,333,0,6
34196,2,2413,2474,-61,0,300,1,6
34197,1,2683,2314,369,0,154,0,6
34198,1,2440,2482,-42,0,398,0,6
34199,2,2420,2219,201,0,200,1,6
34200,3,2608,2640,-32,0,111,0,6
34201,2,2336,2478,-142,0,50,1,6
34203,1,2531,2475,56,0,218,0,6
34204,3,2557,2550,7,0,57,0,6
34205,3,2569,2359,210,0,127,0,6
34206,1,2239,2460,-221,0,1,1,6
34207,1,2411,2261,150,0,40,0,6
34208,2,2482,2428,54,0,0,0,6
34209,3,2300,2532,-232,0,366,0,6
34210,2,2432,2434,-2,0,114,0,6
34211,1,2356,2434,-78,0,46,0,6
34212,1,2524,2403,121,0,1,0,6
34213,1,2675,2465,210,0,42,0,6
34214,1,2486,2218,268,0,211,0,6
34215,3,2447,2435,12,0,41,0,6
34216,2,2403,2708,-305,0,466,0,6
34217,1,2593,2563,30,0,411,0,6
34218,1,2550,2561,-11,0,107,0,6
34219,1,2425,2476,-51,0,101,0,6
34220,3,2400,2348,52,0,15,0,6
34221,1,2449,2358,91,0,331,0,6
34222,1,2553,2328,225,0,227,0,6
34223,2,2566,2719,-153,0,331,0,6
34224,2,2494,2458,36,0,242,0,6
34225,2,2240,2499,-259,0,302,0,6
34226,2,2526,2500,26,0,45,0,6
34227,1,2475,2330,145,0,1,0,6
34228,1,2420,2459,-39,0,112,0,6
34229,3,2312,2416,-104,0,245,0,6
34230,1,2426,2457,-31,0,253,1,6
34231,1,2473,2520,-47,0,106,0,6
34232,3,2492,2209,283,0,302,0,6
34233,2,2373,2510,-137,0,40,0,6
34234,1,2479,2361,118,0,415,0,6
34235,2,2332,2513,-181,0,5,1,6
34236,1,2405,2326,79,0,40,1,6
34237,1,2543,2572,-29,0,1,0,6
34238,2,2314,2442,-128,0,106,1,6
34239,1,2551,2594,-43,0,398,0,6
34240,1,2479,2474,5,0,131,0,6
34241,1,2559,2522,37,0,0,1,6
34242,1,2491,2544,-53,0,83,0,8
34243,1,2485,2298,187,0,245,0,6
34244,1,2449,2301,148,0,123,0,6
34245,1,2559,2434,125,0,473,0,6
34246,2,2283,2510,-227,0,43,0,6
34247,1,2552,2536,16,0,103,0,6
34248,2,2217,2516,-299,0,335,0,6
34249,2,2430,2276,154,0,117,1,6
34250,1,2264,2418,-154,0,41,1,6
34251,2,2414,2469,-55,0,244,0,6
34252,3,2542,2301,241,0,10,0,6
34253,1,2368,2451,-83,0,435,0,6
34254,2,2380,2495,-115,0,201,0,6
34255,3,2417,2502,-85,0,267,0,6
34256,2,2312,2472,-160,0,64,0,6
34257,1,2429,2427,2,0,200,0,6
34258,3,2452,2438,14,0,43,0,6
34259,3,2597,2310,287,0,2,0,8
34260,1,2413,2295,118,0,264,0,6
34261,2,2290,2432,-142,0,180,0,6
34263,3,2588,2497,91,0,45,0,6
34264,1,2499,2386,113,0,202,1,6
34265,1,2572,2421,151,0,295,1,6
34266,2,2408,2521,-113,0,40,0,6
34267,1,2569,2347,222,0,101,0,6
34268,1,2535,2450,85,0,216,0,6
34269,2,2406,2602,-196,0,301,0,6
34270,2,2452,2398,54,0,106,0,6
34271,1,2676,2570,106,0,209,0,6
34272,2,2427,2578,-151,0,100,0,6
34273,3,2421,2493,-72,0,1,0,6
34274,2,2327,2487,-160,0,4,0,6
34275,1,2380,2470,-90,0,317,0,6
34276,2,2440,2385,55,0,265,0,6
34277,1,2483,2326,157,0,40,0,6
34278,2,2360,2464,-104,0,4,0,6
34279,2,2410,2440,-30,0,302,0,6
34280,2,2333,2404,-71,0,11,0,6
34281,2,2451,2323,128,0,112,0,6
34282,1,2433,2486,-53,0,4,0,6
34283,1,2418,2405,13,0,200,0,6
34284,2,2420,2447,-27,0,58,1,6
34285,2,2422,2373,49,0,7,0,6
34286,3,2477,2529,-52,0,241,0,6
34287,3,2415,2411,4,0,46,0,6
34288,1,2490,2454,36,0,14,0,6
34289,2,2474,2406,68,0,195,0,6
34290,2,2259,2423,-164,0,124,1,6
34291,1,2346,2494,-148,0,0,0,6
34292,1,2504,2554,-50,0,301,0,6
34293,1,2401,2366,35,0,100,0,6
34294,1,2351,2546,-195,0,106,0,6
34295,1,2333,2410,-77,0,311,1,6
34296,2,2417,2474,-57,0,49,0,6
34297,2,2386,2453,-67,0,146,0,6
34298,1,2604,2463,141,0,116,0,6
34299,1,2402,2443,-41,0,483,0,6
34300,1,2501,2418,83,0,302,0,6
34301,1,2528,2425,103,0,200,0,6
34302,1,2587,2260,327,0,4,1,6
34303,1,2467,2525,-58,0,492,0,6
34304,1,2435,2431,4,0,13,0,6
34305,1,2556,2342,214,0,36,0,6
34306,2,2514,2623,-109,0,301,1,6
34308,1,2386,2426,-40,0,112,0,6
34309,1,2464,2341,123,0,106,0,6
34310,1,2475,2426,49,0,176,0,6
34311,2,2375,2569,-194,0,41,0,6
34312,3,2259,2626,-367,0,110,0,6
34313,1,2335,2535,-200,0,106,0,6
34314,1,2265,2400,-135,0,46,1,6
34315,1,2439,2434,5,0,200,0,6
34316,1,2381,2463,-82,0,14,0,6
34317,1,2472,2572,-100,0,4,1,6
34318,1,2413,2257,156,0,330,1,6
34319,1,2423,2269,154,0,250,0,6
34320,3,2481,2215,266,0,33,0,6
34321,2,2456,2518,-62,0,123,0,6
34322,2,2467,2540,-73,0,302,1,6
34323,2,2556,2461,95,0,7,0,6
34324,1,2589,2362,227,0,15,0,6
34325,1,2555,2714,-159,0,25,1,6
34326,2,2326,2628,-302,0,120,0,6
34327,1,2624,2358,266,0,14,0,6
34328,1,2427,2332,95,0,132,1,6
34329,1,2595,2313,282,0,387,0,6
34330,1,2414,2380,34,0,57,0,6
34331,2,2327,2455,-128,0,27,0,6
34332,1,2420,2293,127,0,13,0,6
34333,1,2462,2321,141,0,300,0,6
34334,1,2433,2287,146,0,45,1,6
34335,1,2722,2475,247,0,373,0,6
34336,2,2309,2621,-312,0,0,0,6
34337,2,2424,2355,69,0,6,0,6
34338,3,2562,2707,-145,0,301,0,6
34339,1,2562,2364,198,0,104,0,6
34340,1,2440,2403,37,0,226,1,6
34341,2,2562,2611,-49,0,0,0,6
34342,1,2414,2612,-198,0,49,0,6
34343,2,2505,2580,-75,0,301,0,6
34344,1,2661,2443,218,0,270,0,6
34345,2,2306,2405,-99,0,147,0,6
34346,1,2291,2409,-118,0,15,1,6
34347,2,2505,2435,70,0,4,1,6
34348,2,2210,2501,-291,0,45,0,6
34349,3,2421,2338,83,0,112,0,6
34350,1,2397,2532,-135,0,40,0,6
34351,1,2421,2511,-90,0,454,0,6
34352,1,2494,2460,34,0,250,0,6
34353,3,2442,2263,179,0,226,0,6
34354,2,2426,2392,34,0,216,0,6
34355,2,2496,2241,255,0,133,0,6
34356,2,2328,2406,-78,0,11,0,6
34357,3,2241,2455,-214,0,300,0,6
34358,2,2514,2479,35,0,125,1,6
34359,2,2375,2416,-41,0,2,0,6
34360,1,2447,2438,9,0,80,0,6
34361,2,2336,2415,-79,4,202,0,13
34362,2,2677,2643,34,0,167,0,6
34363,1,2557,2377,180,0,0,0,6
34364,2,2516,2396,120,0,147,0,6
34365,2,2209,2445,-236,0,101,0,6
34366,1,2616,2549,67,0,331,0,6
34367,1,2566,2710,-144,0,15,0,6
34368,2,2371,2434,-63,0,247,0,6
34369,1,2477,2392,85,0,469,0,6
34370,1,2758,2364,394,0,101,0,6
34371,2,2440,2291,149,0,49,1,6
34372,2,2333,2488,-155,0,120,0,6
34373,1,2443,2309,134,0,176,1,6
34375,2,2413,2343,70,0,143,0,6
34376,2,2422,2201,221,0,210,0,6
34377,1,2502,2212,290,0,300,0,6
34378,2,2314,2631,-317,0,43,0,6
34379,3,2444,2488,-44,0,13,0,6
34380,1,2498,2225,273,0,380,0,6
34381,1,2575,2421,154,0,335,0,6
34382,1,2467,2232,235,0,137,0,6
34383,2,2411,2493,-82,0,469,0,6
34384,1,2468,2622,-154,0,106,0,6
34385,1,2500,2579,-79,0,120,1,6
34386,1,2551,2448,103,0,46,0,6
34387,1,2630,2556,74,0,112,1,6
34388,1,2446,2324,122,0,227,0,6
34389,3,2430,2557,-127,0,4,0,6
34390,2,2491,2356,135,0,101,1,6
34391,1,2563,2539,24,0,414,0,6
34392,2,2287,2408,-121,0,201,0,6
34393,1,2553,2402,151,0,102,0,6
34394,2,2360,2442,-82,0,107,0,6
34395,1,2487,2411,76,0,394,1,6
34396,2,2537,2382,155,0,312,0,6
34397,2,2265,2456,-191,0,115,1,6
34398,2,2350,2425,-75,0,57,1,6
34399,2,2436,2477,-41,0,490,0,6
34400,2,2450,2388,62,0,152,0,6
34401,2,2367,2432,-65,0,0,0,6
34402,2,2286,2422,-136,0,41,0,6
34403,2,2263,2555,-292,0,113,0,6
34404,1,2465,2239,226,0,334,0,6
34405,1,2439,2475,-36,0,13,0,6
34406,2,2555,2557,-2,0,241,0,6
34407,1,2558,2302,256,0,103,0,6
34408,1,2513,2204,309,0,112,0,6
34409,2,2337,2503,-166,0,45,0,6
34410,2,2363,2598,-235,0,484,0,6
34411,2,2530,2759,-229,0,459,0,6
34412,2,2361,2588,-227,0,398,0,6
34413,1,2409,2429,-20,0,111,0,6
34414,1,2565,2557,8,0,112,0,6
34415,1,2454,2378,76,0,13,0,6
34416,1,2400,2210,190,0,245,0,6
34417,2,2544,2351,193,0,4,0,6
34418,1,2528,2258,270,0,2,0,6
34419,2,2405,2478,-73,0,20,0,6
34420,1,2461,2382,79,0,125,1,6
34421,2,2233,2499,-266,0,60,0,6
34422,2,2469,2445,24,0,40,0,6
34423,2,2461,2501,-40,0,4,0,6
34424,1,2430,2387,43,0,201,0,6
34425,2,2431,2382,49,0,5,0,6
34426,1,2435,2242,193,0,45,1,6
34427,1,2477,2581,-104,0,355,0,6
34428,2,2438,2499,-61,0,200,0,6
34429,1,2420,2452,-32,0,400,0,6
34430,2,2468,2332,136,0,254,0,6
34431,2,2431,2211,220,0,134,1,6
34432,1,2678,2289,389,0,190,0,6
34433,2,2474,2621,-147,0,325,0,6
34434,1,2446,2443,3,0,0,0,6
34435,2,2333,2446,-113,0,382,0,6
34436,1,2452,2450,2,0,123,0,6
34437,1,2482,2398,84,0,103,0,6
34438,1,2273,2412,-139,0,46,1,6
34439,2,2523,2320,203,0,242,0,6
34440,2,2405,2639,-234,0,0,1,6
34441,2,2424,2323,101,0,4,0,6
34442,1,2436,2488,-52,0,133,0,6
34443,1,2270,2421,-151,0,304,0,6
34444,2,2319,2437,-118,0,190,1,6
34445,2,2307,2436,-129,0,6,0,6
34446,1,2626,2431,195,0,470,0,6
34447,2,2302,2462,-160,0,302,0,6
34448,1,2236,2437,-201,0,200,0,6
34449,2,2390,2427,-37,4,46,0,13
34450,2,2482,2470,12,0,200,0,6
34451,2,2415,2216,199,0,5,0,6
34452,3,2365,2626,-261,0,200,0,6
34453,3,2375,2557,-182,0,5,0,6
34454,2,2434,2575,-141,0,43,0,6
34455,3,2537,2387,150,0,201,0,6
34456,2,2572,2360,212,0,5,0,6
34457,1,2428,2372,56,0,277,0,6
34458,1,2367,2445,-78,0,150,0,6
34459,2,2439,2556,-117,0,57,0,6
34460,1,2566,2271,295,0,49,0,6
34461,2,2680,2608,72,0,162,0,6
34462,1,2626,2228,398,0,5,0,6
34463,2,2260,2404,-144,0,41,1,6
34464,1,2525,2245,280,0,18,0,6
34465,2,2533,2528,5,0,103,1,6
34466,2,2503,2362,141,0,373,0,6
34467,2,2385,2421,-36,0,140,0,6
34468,1,2379,2414,-35,0,13,0,6
34469,1,2492,2226,266,0,49,0,6
34470,2,2288,2487,-199,0,4,0,6
34471,1,2566,2353,213,0,131,1,6
34472,1,2495,2348,147,0,236,0,6
34473,3,2308,2426,-118,0,123,0,6
34474,1,2445,2246,199,0,40,0,6
34475,3,2374,2582,-208,0,300,0,6
34476,2,2348,2560,-212,0,140,1,6
34478,1,2267,2469,-202,0,302,0,6
34479,1,2423,2485,-62,0,201,0,6
34480,1,2362,2470,-108,0,206,0,6
34481,1,2470,2218,252,0,267,0,6
34482,1,2491,2724,-233,0,110,0,6
34483,2,2472,2536,-64,0,187,0,6
34484,2,2431,2478,-47,0,256,1,6
34485,1,2480,2518,-38,0,45,0,6
34486,3,2425,2440,-15,0,247,0,6
34487,2,2434,2444,-10,0,101,0,6
34488,1,2395,2476,-81,0,106,0,6
34489,2,2376,2400,-24,0,311,1,6
34491,2,2451,2474,-23,0,40,1,6
34492,2,2353,2420,-67,0,200,0,6
34493,1,2418,2353,65,0,347,0,6
34494,2,2518,2597,-79,0,200,0,6
34495,1,2500,2423,77,0,107,0,6
34497,1,2535,2229,306,0,4,1,6
34498,1,2347,2448,-101,0,106,0,6
34499,1,2458,2404,54,0,56,0,6
34500,3,2277,2434,-157,0,56,0,6
34501,1,2605,2432,173,0,490,0,6
34502,3,2528,2457,71,0,302,0,6
34503,1,2444,2762,-318,0,241,0,6
34504,1,2298,2402,-104,0,245,0,6
34505,1,2452,2377,75,0,256,0,6
34506,2,2555,2560,-5,0,47,0,6
34507,2,2499,2400,99,0,40,1,6
34508,1,2483,2328,155,0,101,1,6
34509,1,2685,2587,98,0,112,0,6
34510,1,2219,2511,-292,0,5,0,6
34511,1,2446,2379,67,0,277,0,6
34512,2,2677,2519,158,0,121,0,6
34513,1,2506,2483,23,0,301,1,6
34514,1,2313,2405,-92,0,331,0,6
34515,1,2560,2325,235,0,36,0,6
34516,2,2356,2444,-88,0,5,0,6
34517,1,2529,2316,213,0,102,0,6
34518,2,2539,2495,44,0,226,0,6
34519,1,2352,2416,-64,0,301,0,6
34520,2,2200,2421,-221,0,80,0,6
34521,2,2225,2471,-246,0,46,0,6
34522,2,2427,2393,34,0,4,0,6
34523,2,2442,2433,9,0,120,0,6
34524,2,2248,2589,-341,0,1,1,6
34525,1,2258,2503,-245,0,100,1,6
34526,1,2446,2498,-52,0,112,0,6
34527,1,2431,2426,5,0,272,0,6
34528,2,2372,2445,-73,0,134,1,6
34529,2,2487,2477,10,0,123,0,6
34530,1,2563,2568,-5,0,300,0,6
34531,3,2401,2399,2,0,4,0,6
34532,3,2536,2486,50,0,122,0,6
34533,2,2534,2527,7,0,103,0,6
34534,2,2458,2549,-91,0,0,0,6
34535,2,2507,2327,180,0,130,0,6
34536,2,2455,2499,-44,0,195,1,6
34537,2,2379,2510,-131,0,102,0,6
34538,3,2579,2471,108,0,302,0,6
34539,1,2597,2570,27,0,221,0,6
34540,3,2625,2591,34,0,242,0,6
34541,1,2517,2318,199,0,45,0,6
34542,3,2486,2564,-78,0,310,0,6
34543,3,2433,2298,135,0,145,0,6
34544,1,2513,2529,-16,0,459,1,6
34545,1,2627,2244,383,0,15,0,6
34546,2,2210,2434,-224,0,107,0,6
34547,2,2480,2460,20,0,145,0,6
34548,3,2360,2426,-66,0,210,0,6
34549,3,2403,2535,-132,0,124,0,6
34550,2,2447,2310,137,0,21,1,6
34551,3,2439,2297,142,0,83,0,6
34552,2,2320,2406,-86,0,352,1,6
34553,2,2650,2671,-21,0,150,1,6
34554,2,2255,2426,-171,0,36,0,6
34555,3,2422,2329,93,0,277,0,6
34556,1,2705,2564,141,0,178,0,6
34557,2,2469,2592,-123,0,0,0,6
34558,1,2359,2549,-190,0,483,0,6
34559,2,2285,2450,-165,0,9,0,6
34560,3,2287,2481,-194,0,132,0,6
34561,1,2449,2358,91,0,305,0,6
34562,1,2419,2205,214,0,345,1,6
34563,1,2451,2217,234,0,311,0,6
34564,1,2410,2317,93,0,103,1,6
34565,2,2419,2299,120,0,302,1,8
34566,3,2411,2377,34,0,40,0,6
34567,1,2403,2262,141,0,40,0,6
34568,1,2590,2545,45,0,331,0,6
34569,1,2437,2535,-98,0,455,0,6
34570,3,2389,2452,-63,0,41,0,6
34571,2,2459,2358,101,0,474,0,6
34572,2,2508,2621,-113,0,211,0,6
34573,3,2257,2507,-250,0,302,0,6
34574,3,2266,2416,-150,0,301,0,6
34575,2,2524,2291,233,0,101,0,6
34576,3,2323,2405,-82,0,108,0,6
34577,1,2402,2392,10,0,40,0,6
34578,3,2337,2468,-131,0,39,0,6
34579,1,2533,2477,56,0,43,0,6
34580,3,2614,2608,6,0,4,0,6
34581,2,2341,2627,-286,0,45,0,6
34582,1,2528,2563,-35,0,4,0,6
34583,2,2459,2280,179,0,1,0,6
34584,3,2393,2422,-29,0,100,0,6
34586,3,2491,2615,-124,0,158,0,6
34587,2,2274,2412,-138,0,102,1,6
34588,1,2514,2481,33,0,133,0,6
34589,3,2441,2375,66,0,52,0,6
34590,2,2315,2442,-127,0,181,0,6
34591,1,2497,2252,245,0,150,0,6
34592,1,2438,2273,165,0,102,1,6
34593,3,2463,2430,33,0,202,0,6
34594,2,2441,2407,34,0,385,1,6
34595,3,2272,2633,-361,0,386,0,6
34596,1,2625,2510,115,0,302,0,6
34597,3,2547,2504,43,0,123,0,6
34598,1,2415,2456,-41,0,245,0,6
34599,2,2430,2332,98,0,254,0,6
34600,2,2342,2575,-233,0,466,0,6
34601,3,2418,2466,-48,0,12,0,6
34603,1,2427,2212,215,0,204,0,6
34604,3,2500,2673,-173,0,190,0,6
34605,1,2396,2479,-83,0,49,0,6
34606,1,2444,2514,-70,0,150,0,6
34607,2,2472,2412,60,0,102,0,6
34608,2,2225,2432,-207,0,1,1,6
34609,2,2329,2715,-386,0,113,0,6
34610,3,2216,2507,-291,0,40,0,6
34611,2,2333,2452,-119,0,106,0,6
34612,2,2332,2421,-89,0,122,0,6
34613,1,2504,2424,80,0,49,0,6
34614,3,2433,2348,85,0,132,0,6
34615,3,2328,2422,-94,0,107,0,6
34616,2,2256,2403,-147,0,190,0,6
34617,2,2301,2563,-262,0,107,0,6
34618,2,2419,2266,153,0,300,0,6
34619,1,2423,2363,60,0,100,0,6
34620,1,2347,2505,-158,0,101,1,6
34621,3,2501,2262,239,0,46,0,6
34622,1,2469,2304,165,0,13,0,6
34623,1,2561,2454,107,0,40,0,6
34624,2,2479,2395,84,0,426,0,6
34625,2,2429,2549,-120,0,46,0,6
34626,1,2641,2566,75,0,140,0,6
34627,2,2601,2709,-108,0,309,0,6
34628,3,2544,2608,-64,0,338,0,6
34629,2,2324,2402,-78,0,106,0,6
34630,1,2415,2398,17,0,330,0,6
34631,2,2369,2436,-67,0,2,0,6
34632,1,2480,2252,228,4,56,0,13
34633,2,2549,2440,109,0,300,1,6
34634,2,2266,2679,-413,0,7,0,6
34635,2,2233,2557,-324,0,101,0,6
34636,1,2434,2202,232,0,103,0,6
34637,1,2496,2530,-34,0,4,0,6
34638,1,2393,2450,-57,0,226,0,6
34639,2,2304,2414,-110,0,141,1,6
34640,1,2624,2452,172,0,111,0,6
34641,3,2473,2564,-91,0,307,0,6
34642,3,2592,2577,15,0,101,0,6
34643,3,2366,2480,-114,0,310,0,6
34644,2,2228,2563,-335,0,302,0,6
34645,3,2327,2479,-152,0,0,0,6
34646,2,2424,2350,74,0,7,1,6
34647,2,2248,2453,-205,0,335,0,6
34648,1,2413,2207,206,0,308,0,6
34649,1,2465,2334,131,0,212,0,6
34650,3,2565,2445,120,0,200,0,6
34651,3,2527,2565,-38,0,244,0,6
34652,3,2299,2445,-146,0,121,0,6
34653,3,2595,2602,-7,0,302,0,6
34654,3,2540,2574,-34,0,43,0,6
34655,2,2476,2486,-10,0,4,1,6
34656,1,2508,2476,32,0,16,1,6
34657,2,2409,2375,34,0,45,1,6
34658,2,2444,2344,100,0,242,0,6
34659,1,2246,2418,-172,0,243,1,6
34660,2,2440,2629,-189,0,195,0,6
34661,1,2429,2417,12,0,490,1,6
34662,1,2305,2446,-141,0,150,0,6
34663,2,2446,2458,-12,0,242,1,6
34664,2,2507,2533,-26,0,45,0,6
34665,3,2574,2484,90,0,150,0,6
34666,1,2479,2329,150,0,150,1,6
34667,1,2624,2492,132,0,355,0,6
34668,1,2423,2436,-13,0,253,0,6
34669,3,2331,2471,-140,0,1,0,6
34670,2,2388,2420,-32,0,0,0,6
34671,2,2629,2451,178,0,102,0,6
34672,1,2494,2393,101,0,4,0,6
34673,2,2414,2505,-91,0,112,0,6
34675,1,2541,2415,126,0,301,0,6
34676,1,2410,2353,57,0,400,1,6
34677,1,2343,2401,-58,0,301,0,6
34678,2,2541,2669,-128,0,4,0,6
34679,2,2528,2413,115,0,301,1,6
34680,2,2456,2316,140,0,447,0,6
34681,2,2450,2470,-20,0,246,0,6
34683,2,2477,2512,-35,0,469,0,6
34684,2,2474,2353,121,0,448,1,6
34685,1,2677,2645,32,0,194,0,6
34686,1,2632,2437,195,0,344,0,6
34688,1,2282,2414,-132,0,301,0,6
34689,1,2673,2470,203,0,101,1,6
34690,1,2421,2343,78,0,10,0,6
34691,1,2449,2408,41,0,302,1,6
34692,3,2401,2339,62,0,4,0,6
34693,3,2440,2608,-168,0,335,0,6
34694,2,2515,2535,-20,0,302,1,6
34695,1,2441,2364,77,0,345,0,6
34696,1,2539,2400,139,0,201,0,6
34697,1,2307,2408,-101,0,267,1,6
34698,2,2447,2309,138,0,31,0,6
34699,1,2460,2477,-17,0,30,1,6
34700,1,2537,2551,-14,0,101,0,6
34701,1,2491,2470,21,0,100,0,6
34702,2,2438,2313,125,0,123,0,6
34703,2,2408,2397,11,0,45,0,6
34704,1,2407,2341,66,0,103,0,6
34705,1,2471,2513,-42,0,111,0,6
34706,2,2322,2420,-98,0,14,0,6
34707,1,2538,2501,37,0,46,0,6
34708,1,2434,2429,5,0,52,1,6
34709,1,2381,2464,-83,0,45,0,6
34710,2,2411,2426,-15,0,9,0,6
34711,1,2440,2498,-58,0,100,0,6
34712,2,2281,2403,-122,0,389,1,6
34713,2,2434,2635,-201,0,195,0,6
34714,1,2509,2409,100,0,15,0,6
34715,3,2602,2628,-26,0,111,0,6
34716,2,2288,2405,-117,0,194,0,6
34717,2,2439,2350,89,0,340,0,6
34718,1,2469,2333,136,0,40,1,6
34719,3,2415,2366,49,0,40,0,6
34720,2,2416,2597,-181,0,463,0,6
34721,1,2434,2545,-111,0,241,1,6
34722,2,2416,2532,-116,0,288,0,6
34723,2,2355,2422,-67,0,150,0,6
34724,2,2517,2472,45,0,11,0,6
34725,1,2410,2348,62,0,487,1,6
34726,1,2448,2432,16,0,57,0,6
34727,3,2536,2444,92,0,374,0,6
34728,2,2465,2497,-32,0,4,1,6
34729,2,2433,2480,-47,0,157,1,6
34730,1,2396,2528,-132,0,3,0,6
34731,2,2421,2369,52,0,330,0,6
34732,1,2411,2244,167,0,336,0,6
34733,2,2639,2682,-43,0,150,0,6
34734,1,2411,2329,82,0,7,0,8
34735,1,2425,2331,94,0,13,1,6
34736,1,2358,2482,-124,0,320,0,6
34737,1,2520,2436,84,0,213,0,6
34738,3,2280,2431,-151,0,13,0,6
34739,1,2545,2467,78,0,258,0,6
34740,1,2418,2322,96,0,5,0,6
34741,2,2464,2454,10,0,455,1,6
34742,1,2446,2535,-89,0,246,0,6
34743,1,2413,2318,95,0,40,0,6
34744,3,2570,2409,161,0,58,0,6
34745,1,2340,2400,-60,0,242,0,6
34746,3,2605,2443,162,0,120,0,6
34747,3,2289,2454,-165,0,278,0,6
34748,1,2434,2351,83,0,365,0,6
34749,2,2543,2628,-85,0,8,0,6
34750,2,2321,2431,-110,0,125,1,6
34751,1,2407,2575,-168,0,352,0,6
34752,1,2427,2323,104,0,354,0,6
34753,1,2439,2385,54,4,343,0,13
34754,1,2496,2251,245,0,354,0,6
34755,2,2514,2404,110,0,200,0,6
34756,1,2506,2477,29,0,453,0,6
34757,2,2403,2414,-11,0,49,0,6
34758,2,2373,2403,-30,0,152,1,6
34759,1,2475,2466,9,0,15,0,6
34760,2,2329,2490,-161,0,0,1,6
34761,1,2310,2411,-101,0,110,0,6
34762,2,2421,2423,-2,0,13,1,6
34763,2,2412,2567,-155,0,2,0,6
34764,1,2491,2464,27,0,8,0,6
34765,2,2440,2431,9,0,70,0,6
34766,2,2406,2259,147,0,20,1,6
34767,2,2411,2331,80,0,126,0,6
34768,2,2436,2280,156,0,3,0,6
34769,1,2431,2473,-42,0,280,0,6
34770,2,2354,2439,-85,0,302,0,6
34771,1,2388,2400,-12,0,45,0,6
34772,1,2479,2510,-31,0,80,0,6
34773,1,2687,2634,53,0,167,0,6
34774,1,2528,2453,75,0,373,0,6
34775,2,2538,2613,-75,0,301,0,6
34776,3,2513,2403,110,0,405,0,6
34777,2,2544,2395,149,0,53,0,8
34778,1,2550,2447,103,0,202,0,6
34779,1,2462,2346,116,0,28,0,6
34780,2,2503,2460,43,0,100,0,6
34781,2,2346,2432,-86,0,310,0,6
34782,1,2403,2356,47,0,114,0,6
34783,1,2571,2408,163,0,13,0,6
34784,2,2333,2429,-96,0,133,0,6
34785,2,2458,2438,20,0,15,0,6
34786,1,2460,2329,131,0,40,0,6
34787,3,2485,2604,-119,0,171,0,6
34788,1,2542,2439,103,0,113,1,6
34789,1,2401,2325,76,0,109,0,6
34790,1,2504,2485,19,0,1,0,6
34791,2,2543,2632,-89,0,110,0,6
34792,2,2419,2434,-15,0,454,0,6
34793,2,2437,2398,39,0,30,1,6
34794,2,2414,2318,96,0,250,0,6
34795,2,2272,2414,-142,0,406,0,6
34796,1,2382,2431,-49,0,189,0,6
34797,2,2472,2512,-40,0,0,0,6
34798,2,2390,2466,-76,0,337,1,6
34799,1,2415,2444,-29,0,40,0,6
34800,1,2241,2411,-170,0,222,0,6
34801,1,2520,2394,126,0,278,0,6
34802,2,2316,2527,-211,4,30,0,13
34803,2,2460,2481,-21,0,11,1,6
34804,2,2449,2532,-83,0,228,0,6
34805,2,2436,2614,-178,0,106,0,6
34806,3,2445,2603,-158,0,60,0,6
34807,2,2487,2533,-46,0,241,0,6
34808,1,2499,2541,-42,0,308,0,6
34809,2,2309,2418,-109,0,45,1,6
34810,2,2443,2554,-111,0,101,0,6
34811,2,2298,2414,-116,0,202,0,6
34812,1,2440,2440,0,0,312,1,6
34813,2,2459,2497,-38,0,100,0,6
34814,2,2443,2350,93,0,426,0,6
34815,1,2443,2326,117,0,242,0,6
34816,3,2356,2414,-58,0,45,0,6
34817,1,2507,2692,-185,0,312,0,6
34818,1,2365,2408,-43,0,120,0,6
34819,1,2428,2347,81,0,3,0,6
34820,1,2463,2346,117,0,313,0,6
34821,2,2405,2524,-119,0,3,0,6
34822,2,2390,2415,-25,0,300,0,6
34823,2,2372,2452,-80,0,312,0,6
34824,2,2438,2398,40,0,212,0,6
34825,1,2429,2418,11,0,201,0,6
34826,2,2438,2493,-55,0,110,1,6
34827,1,2557,2482,75,0,260,0,6
34828,2,2444,2464,-20,0,106,0,6
34829,1,2417,2326,91,0,106,1,6
34830,2,2537,2444,93,0,4,0,6
34831,1,2284,2400,-116,0,110,0,6
34832,2,2545,2480,65,0,53,0,6
34833,1,2457,2318,139,0,210,0,6
34834,2,2405,2512,-107,0,115,0,6
34835,1,2422,2416,6,0,7,0,6
34836,2,2420,2450,-30,4,405,1,13
34837,1,2325,2407,-82,0,27,0,6
34838,2,2603,2497,106,0,56,0,6
34839,1,2431,2534,-103,0,101,0,6
34840,2,2424,2388,36,0,438,1,6
34841,1,2617,2505,112,0,5,0,6
34842,2,2357,2436,-79,0,302,1,6
34843,1,2558,2439,119,0,202,1,6
34844,1,2467,2546,-79,0,125,1,6
34845,1,2456,2367,89,0,6,0,6
34846,2,2415,2401,14,0,40,0,6
34847,2,2414,2525,-111,0,0,0,6
34848,1,2486,2455,31,0,10,1,6
34849,2,2304,2401,-97,0,405,0,6
34850,1,2424,2445,-21,0,16,0,6
34851,2,2413,2388,25,0,13,1,6
34852,2,2398,2410,-12,0,0,0,6
34853,1,2403,2528,-125,0,388,0,8
34854,2,2403,2355,48,0,122,1,6
34855,1,2454,2467,-13,0,0,0,6
34857,2,2418,2294,124,0,241,0,6
34858,1,2476,2683,-207,0,187,1,6
34859,1,2489,2316,173,0,176,0,8
34860,1,2528,2499,29,0,15,0,6
34861,1,2525,2401,124,0,210,0,6
34862,1,2414,2281,133,0,52,0,6
34863,2,2401,2361,40,0,102,1,6
34864,2,2574,2564,10,0,394,1,6
34865,1,2603,2321,282,0,101,0,6
34866,2,2452,2529,-77,0,248,1,6
34867,1,2418,2270,148,0,331,0,6
34868,2,2322,2522,-200,0,413,1,6
34869,2,2426,2269,157,0,335,0,6
34870,1,2311,2439,-128,0,151,1,6
34871,1,2407,2434,-27,0,1,1,6
34872,1,2412,2231,181,0,487,0,6
34873,2,2528,2368,160,0,28,0,6
34874,2,2405,2299,106,0,152,0,6
34875,2,2511,2561,-50,0,278,0,6
34876,2,2487,2538,-51,0,127,0,6
34877,2,2364,2451,-87,4,241,1,13
34878,2,2394,2433,-39,0,202,0,6
34879,1,2461,2538,-77,0,241,0,6
34880,1,2448,2524,-76,0,338,0,6
34881,1,2527,2469,58,0,45,0,6
34882,1,2385,2533,-148,0,300,0,6
34883,1,2452,2314,138,0,201,1,6
34884,1,2321,2505,-184,0,1,1,6
34885,2,2492,2439,53,0,469,0,6
34886,2,2395,2418,-23,0,20,0,6
34887,2,2501,2621,-120,0,45,1,6
34888,1,2567,2396,171,0,133,0,6
34889,1,2440,2353,87,0,426,0,6
34890,2,2412,2417,-5,0,45,0,6
34891,2,2265,2446,-181,0,50,1,6
34892,2,2363,2461,-98,0,310,0,6
34893,2,2435,2562,-127,0,101,0,6
34894,3,2404,2230,174,0,380,0,6
34895,2,2266,2422,-156,0,112,0,6
34896,3,2438,2460,-22,0,354,0,6
34897,1,2464,2314,150,0,341,0,6
34898,2,2474,2532,-58,0,101,0,6
34899,2,2264,2433,-169,0,106,0,6
34900,1,2421,2375,46,0,40,0,6
34901,1,2498,2380,118,0,474,0,6
34902,2,2450,2450,0,0,102,0,6
34903,2,2405,2529,-124,0,43,0,6
34904,1,2400,2333,67,0,260,1,6
34905,1,2402,2294,108,0,300,0,6
34906,2,2570,2466,104,0,106,0,6
34907,2,2531,2539,-8,0,0,0,6
34908,2,2257,2433,-176,0,44,0,6
34909,1,2675,2603,72,0,133,0,6
34910,1,2589,2525,64,0,123,1,6
34911,3,2461,2620,-159,0,106,0,6
34912,3,2460,2438,22,0,404,0,6
34913,2,2467,2460,7,0,405,0,6
34914,1,2405,2411,-6,0,40,0,6
34915,2,2278,2410,-132,0,54,0,6
34916,2,2534,2447,87,0,373,0,6
34917,2,2506,2466,40,0,130,1,6
34918,1,2587,2439,148,0,152,0,6
34919,2,2397,2533,-136,0,3,1,6
34920,2,2415,2482,-67,0,143,1,6
34921,1,2431,2321,110,0,153,0,6
34922,2,2420,2470,-50,0,140,0,6
34923,1,2394,2465,-71,0,45,1,6
34924,3,2403,2492,-89,4,211,0,13
34925,1,2570,2393,177,0,414,0,6
34926,2,2405,2423,-18,0,302,0,6
34927,1,2469,2438,31,0,200,1,6
34928,2,2428,2381,47,0,372,1,6
34929,1,2566,2431,135,0,202,1,6
34930,2,2446,2497,-51,0,427,0,6
34931,2,2567,2537,30,0,101,0,6
34932,2,2411,2520,-109,0,131,0,6
34933,2,2513,2410,103,0,107,0,8
34934,2,2369,2407,-38,0,302,0,6
34935,2,2423,2392,31,0,43,0,6
34936,1,2428,2445,-17,0,143,1,6
34937,1,2517,2455,62,0,45,0,6
34938,1,2639,2563,76,0,0,0,6
34939,1,2566,2466,100,0,201,1,6
34940,3,2320,2499,-179,0,0,0,6
34941,2,2426,2411,15,0,13,0,6
34942,1,2496,2401,95,0,49,0,6
34943,3,2439,2459,-20,0,142,0,6
34944,2,2330,2476,-146,0,1,0,6
34945,2,2456,2445,11,0,13,1,6
34946,2,2502,2436,66,0,80,0,6
34947,2,2526,2546,-20,0,0,0,6
34948,1,2441,2435,6,0,58,0,6
34949,1,2502,2481,21,0,45,1,6
34950,1,2471,2309,162,0,40,1,6
34951,1,2264,2431,-167,0,125,0,6
34952,1,2326,2461,-135,0,255,0,6
34953,2,2403,2387,16,0,202,0,6
34954,1,2598,2679,-81,0,150,0,6
34955,1,2415,2354,61,0,62,0,6
34956,1,2389,2421,-32,0,201,0,6
34957,2,2294,2618,-324,0,106,1,6
34958,1,2456,2323,133,0,107,1,6
34959,3,2464,2516,-52,0,359,0,6
34960,1,2293,2448,-155,0,242,0,6
34961,1,2487,2305,182,0,415,1,6
34962,2,2485,2582,-97,0,240,1,6
34963,1,2478,2333,145,0,13,0,6
34964,2,2571,2543,28,0,45,0,6
34965,2,2429,2447,-18,0,177,0,6
34966,2,2345,2465,-120,0,4,1,6
34967,2,2444,2453,-9,0,300,0,6
34968,1,2475,2520,-45,0,302,0,6
34969,2,2454,2527,-73,0,248,0,6
34970,2,2472,2499,-27,0,140,0,6
34971,1,2456,2320,136,0,150,0,6
34972,1,2551,2594,-43,0,45,0,6
34973,1,2436,2261,175,0,106,0,6
34974,2,2437,2457,-20,0,320,0,6
34975,1,2412,2317,95,0,101,1,6
34976,1,2404,2323,81,0,14,0,6
34977,1,2635,2435,200,0,150,0,6
34978,1,2409,2366,43,0,380,1,6
34979,2,2408,2414,-6,0,36,0,6
34980,1,2525,2537,-12,0,104,1,6
34981,1,2414,2241,173,0,333,0,6
34982,2,2543,2402,141,0,45,0,6
34983,3,2425,2316,109,0,101,0,6
34984,2,2260,2433,-173,0,347,1,6
34985,1,2459,2301,158,0,202,1,6
34986,2,2304,2401,-97,0,406,0,6
34987,1,2516,2427,89,0,406,0,6
34988,3,2479,2333,146,0,226,0,6
34989,2,2273,2458,-185,0,330,0,6
34990,1,2481,2327,154,0,124,0,6
34991,2,2399,2429,-30,0,338,0,6
34992,1,2638,2394,244,0,210,0,6
34993,2,2559,2643,-84,0,123,0,6
34994,3,2459,2439,20,0,341,0,6
34995,2,2558,2569,-11,0,300,1,6
34996,2,2452,2432,20,0,50,1,6
34997,2,2390,2468,-78,0,45,0,6
34998,2,2402,2303,99,0,41,0,6
34999,1,2468,2505,-37,0,43,0,6
35000,1,2451,2450,1,0,102,1,6
35001,2,2439,2434,5,0,52,0,6
35002,2,2405,2300,105,0,152,1,6
35003,2,2415,2398,17,0,210,0,6
35004,1,2462,2477,-15,0,120,0,6
35005,2,2508,2672,-164,0,345,0,6
35006,2,2322,2482,-160,0,215,0,6
35007,2,2298,2486,-188,4,117,0,13
35008,1,2434,2333,101,0,441,0,6
35009,1,2511,2394,117,0,30,0,6
35010,2,2459,2439,20,0,111,0,6
35011,2,2442,2380,62,0,200,0,6
35012,1,2608,2571,37,0,247,0,6
35013,1,2558,2531,27,0,106,0,6
35014,2,2550,2565,-15,0,40,1,6
35015,2,2404,2319,85,0,101,0,6
35016,1,2625,2467,158,0,440,0,6
35017,2,2319,2460,-141,0,6,1,6
35018,1,2531,2450,81,0,8,0,6
35019,1,2619,2397,222,0,211,0,6
35020,2,2397,2464,-67,0,46,1,6
35021,1,2301,2407,-106,0,112,0,6
35022,2,2484,2506,-22,0,119,1,6
35023,2,2471,2323,148,0,106,0,6
35024,3,2464,2514,-50,0,241,0,6
35025,2,2482,2500,-18,0,56,0,6
35026,1,2486,2319,167,0,10,0,6
35027,1,2648,2554,94,0,128,0,6
35028,2,2370,2420,-50,0,302,0,6
35029,1,2421,2318,103,0,5,1,6
35030,1,2416,2403,13,0,101,1,6
35031,2,2370,2495,-125,0,160,0,6
35032,2,2445,2453,-8,0,106,0,6
35033,1,2535,2563,-28,0,45,0,6
35034,1,2526,2609,-83,0,200,0,6
35035,2,2323,2460,-137,0,84,0,6
35036,1,2417,2405,12,0,302,0,6
35037,2,2257,2417,-160,0,46,1,6
35038,2,2408,2641,-233,0,107,1,6
35039,1,2531,2392,139,0,200,0,6
35040,1,2335,2477,-142,0,130,0,6
35041,1,2423,2238,185,0,207,0,6
35042,3,2531,2629,-98,0,110,0,6
35043,2,2390,2436,-46,0,343,0,6
35044,2,2438,2515,-77,0,438,1,6
35045,2,2386,2417,-31,0,45,0,6
35046,1,2462,2432,30,0,256,0,6
35047,1,2676,2504,172,0,144,0,6
35048,1,2433,2361,72,0,0,0,6
35049,1,2469,2348,121,0,104,1,8
35050,2,2413,2390,23,0,398,1,6
35051,1,2419,2422,-3,0,1,0,6
35052,3,2439,2446,-7,0,118,0,6
35053,2,2439,2292,147,0,200,0,6
35054,2,2445,2536,-91,0,248,0,6
35055,1,2409,2362,47,0,45,0,6
35056,2,2458,2439,19,0,200,0,6
35057,1,2570,2544,26,0,232,0,6
35058,1,2273,2411,-138,0,48,0,6
35059,1,2469,2344,125,0,229,0,6
35060,1,2395,2575,-180,0,307,0,6
35061,1,2463,2325,138,0,243,0,6
35062,2,2270,2448,-178,0,52,1,6
35063,1,2441,2385,56,0,44,1,6
35064,3,2462,2365,97,0,153,0,6
35065,1,2533,2435,98,0,108,0,6
35066,2,2557,2652,-95,0,45,0,6
35067,2,2438,2541,-103,0,0,0,6
35068,2,2331,2466,-135,0,1,0,6
35069,2,2461,2415,46,4,8,0,13
35070,2,2382,2534,-152,0,102,1,6
35071,2,2408,2547,-139,0,135,0,6
35072,1,2420,2357,63,0,38,0,6
35073,1,2477,2414,63,0,324,0,6
35074,1,2622,2465,157,0,124,0,6
35075,2,2417,2457,-40,0,302,0,6
35076,3,2435,2425,10,0,415,0,6
35077,1,2384,2416,-32,4,49,0,13
35078,2,2473,2398,75,0,101,1,6
35079,1,2426,2394,32,0,203,0,6
35080,2,2422,2395,27,0,487,1,6
35081,2,2463,2443,20,0,101,1,6
35082,1,2513,2435,78,0,211,1,6
35083,2,2539,2576,-37,0,253,0,6
35084,2,2422,2380,42,0,395,0,6
35085,1,2643,2411,232,0,200,0,6
35086,2,2405,2324,81,4,107,0,13
35087,1,2398,2473,-75,0,46,1,6
35088,1,2420,2342,78,0,398,0,6
35089,1,2445,2452,-7,0,45,0,6
35090,1,2336,2434,-98,0,203,0,6
35091,2,2501,2679,-178,0,45,1,6
35092,1,2520,2461,59,0,301,0,6
35093,2,2357,2457,-100,4,46,0,13
35094,1,2408,2256,152,4,454,0,13
35095,2,2445,2439,6,0,61,0,6
35096,2,2441,2571,-130,0,118,0,6
35097,2,2553,2552,1,0,335,0,6
35098,3,2403,2545,-142,0,320,0,6
35099,2,2409,2481,-72,0,201,0,6
35100,2,2333,2434,-101,0,0,1,6
35101,1,2431,2537,-106,0,1,1,6
35102,1,2367,2401,-34,0,44,0,6
35103,2,2322,2460,-138,0,45,0,6
35104,1,2380,2425,-45,0,415,0,6
35105,3,2388,2626,-238,0,3,0,6
35106,1,2314,2446,-132,0,200,0,6
35107,1,2404,2281,123,0,90,0,6
35108,2,2293,2462,-169,0,146,0,6
35109,1,2522,2354,168,0,80,0,6
35110,1,2448,2328,120,0,343,0,6
35111,3,2462,2412,50,0,202,0,6
35112,2,2469,2330,139,0,15,1,6
35113,1,2538,2378,160,0,140,0,6
35114,3,2446,2551,-105,0,10,0,6
35115,2,2427,2468,-41,0,300,0,6
35116,1,2441,2425,16,0,37,0,6
35117,3,2641,2656,-15,0,447,0,6
35118,1,2405,2382,23,0,205,0,6
35119,1,2468,2437,31,0,330,0,6
35120,1,2461,2362,99,0,181,0,6
35121,1,2518,2645,-127,0,0,0,6
35122,2,2300,2432,-132,0,22,1,6
35123,3,2328,2416,-88,0,1,0,6
35124,1,2445,2440,5,0,195,0,6
35125,3,2473,2322,151,0,113,0,8
35126,2,2428,2351,77,0,45,1,6
35127,1,2466,2319,147,0,110,1,6
35128,3,2367,2457,-90,0,210,0,6
35129,2,2256,2414,-158,0,3,1,6
35130,1,2471,2426,45,0,46,0,6
35131,1,2471,2408,63,0,400,1,6
35132,1,2682,2498,184,0,241,0,6
35133,2,2384,2533,-149,0,0,0,6
35134,2,2656,2641,15,0,142,0,6
35135,3,2435,2560,-125,0,485,0,10
35136,3,2465,2373,92,0,112,0,6
35137,1,2457,2602,-145,0,245,0,6
35138,1,2471,2307,164,0,483,0,6
35139,1,2534,2387,147,0,236,0,6
35140,2,2323,2400,-77,0,463,0,6
35141,1,2419,2364,55,0,437,0,6
35142,1,2543,2486,57,0,330,0,6
35143,2,2341,2413,-72,0,331,1,6
35144,2,2303,2464,-161,0,130,0,6
35145,3,2622,2544,78,0,118,0,6
35146,1,2271,2400,-129,0,115,0,6
35147,2,2274,2404,-130,0,492,0,6
35148,1,2430,2306,124,0,241,0,6
35149,2,2377,2405,-28,0,320,0,6
35150,2,2315,2410,-95,0,101,0,6
35151,1,2535,2491,44,4,302,0,13
35152,2,2439,2438,1,0,128,0,6
35153,2,2413,2461,-48,0,305,0,6
35154,2,2335,2402,-67,0,406,0,6
35155,1,2387,2473,-86,0,50,1,6
35156,2,2338,2461,-123,0,115,1,6
35157,1,2541,2452,89,0,226,0,6
35158,2,2438,2375,63,0,50,0,6
35159,1,2508,2316,192,0,0,0,8
35160,2,2277,2407,-130,0,48,0,6
35161,2,2549,2462,87,0,315,0,6
35162,1,2448,2288,160,0,0,0,6
35163,1,2304,2410,-106,4,230,0,13
35164,1,2479,2432,47,0,253,1,6
35165,2,2351,2525,-174,0,338,0,6
35166,1,2407,2242,165,0,373,1,6
35167,1,2407,2476,-69,0,140,0,6
35168,1,2330,2447,-117,0,394,1,6
35169,3,2475,2535,-60,0,265,0,6
35170,2,2495,2685,-190,0,345,0,6
35171,2,2384,2538,-154,0,300,1,6
35172,1,2567,2561,6,0,140,0,6
35173,2,2536,2638,-102,0,132,0,6
35174,2,2420,2526,-106,0,22,1,6
35175,2,2375,2501,-126,0,106,1,6
35176,2,2404,2464,-60,0,15,0,6
35177,1,2492,2327,165,0,200,1,8
35178,1,2595,2410,185,0,56,0,6
35179,2,2397,2459,-62,0,106,0,6
35180,2,2424,2329,95,0,40,0,6
35181,1,2414,2470,-56,0,487,0,6
35182,2,2391,2546,-155,0,2,0,6
35183,3,2304,2417,-113,0,201,0,6
35184,1,2448,2399,49,0,436,0,6
35185,2,2434,2310,124,0,43,1,6
35186,1,2557,2343,214,0,307,0,6
35187,1,2592,2450,142,0,49,0,6
35188,1,2647,2650,-3,0,404,0,6
35189,1,2465,2548,-83,0,101,0,6
35190,2,2467,2476,-9,0,251,0,6
35191,3,2481,2474,7,0,302,0,6
35192,1,2435,2297,138,0,200,0,6
35193,2,2473,2422,51,0,122,0,6
35194,2,2391,2572,-181,0,45,0,6
35196,1,2349,2433,-84,0,41,0,6
35197,2,2533,2476,57,0,100,0,6
35198,2,2236,2412,-176,4,172,0,13
35199,3,2415,2264,151,0,154,0,6
35200,2,2480,2675,-195,0,80,0,6
35201,2,2447,2596,-149,0,280,1,6
35202,1,2470,2621,-151,0,455,0,6
35203,2,2542,2372,170,0,84,1,6
35204,1,2478,2341,137,0,58,0,6
35205,1,2345,2471,-126,0,41,1,8
35206,2,2213,2541,-328,4,122,0,13
35207,2,2549,2598,-49,0,150,0,6
35208,1,2407,2249,158,0,456,0,6
35209,1,2524,2388,136,0,94,1,6
35210,2,2411,2273,138,0,40,0,6
35211,3,2456,2402,54,0,201,0,6
35212,2,2407,2451,-44,0,106,0,6
35213,3,2346,2467,-121,0,106,0,6
35214,2,2530,2463,67,0,122,0,6
35215,1,2427,2484,-57,0,156,0,6
35216,1,2511,2513,-2,0,0,0,8
35217,1,2432,2417,15,0,122,0,6
35218,2,2483,2525,-42,0,260,1,6
35219,2,2466,2642,-176,0,132,0,6
35220,2,2416,2435,-19,0,1,1,6
35221,1,2449,2338,111,0,2,0,6
35222,1,2518,2492,26,0,148,1,6
35223,1,2613,2430,183,0,126,1,6
35224,1,2688,2478,210,0,211,0,6
35225,2,2239,2411,-172,0,133,1,6
35226,1,2535,2379,156,0,192,1,6
35227,1,2506,2472,34,0,131,0,6
35228,2,2520,2481,39,0,120,0,6
35229,1,2422,2462,-40,0,303,0,6
35230,1,2469,2325,144,0,242,0,6
35231,2,2371,2413,-42,0,46,0,6
35232,2,2426,2312,114,0,200,0,6
35233,1,2416,2355,61,0,43,1,6
35234,2,2509,2539,-30,0,63,1,6
35235,2,2426,2574,-148,0,307,0,6
35236,2,2337,2403,-66,0,1,0,6
35237,2,2644,2613,31,0,341,1,6
35238,2,2338,2437,-99,0,43,1,6
35240,2,2401,2366,35,0,474,0,6
35241,1,2541,2432,109,0,45,0,6
35242,2,2289,2442,-153,0,340,0,10
35243,2,2402,2419,-17,0,154,0,6
35244,1,2457,2315,142,0,0,0,6
35245,1,2412,2282,130,0,141,0,6
35246,2,2405,2544,-139,0,45,0,6
35247,1,2603,2443,160,0,330,0,6
35248,2,2311,2465,-154,0,31,0,6
35249,1,2428,2466,-38,0,320,0,6
35250,1,2288,2425,-137,0,51,0,6
35251,1,2436,2425,11,0,151,0,6
35252,2,2645,2523,122,0,241,1,6
35253,2,2470,2541,-71,0,4,0,6
35254,1,2475,2691,-216,0,302,0,6
35255,2,2351,2495,-144,0,100,0,8
35256,1,2478,2575,-97,0,15,0,6
35257,2,2431,2464,-33,0,48,0,6
35258,3,2400,2538,-138,0,46,0,6
35259,2,2546,2465,81,0,0,0,6
35260,1,2441,2472,-31,0,415,0,6
35261,1,2388,2439,-51,0,40,0,6
35262,1,2487,2523,-36,0,43,1,6
35263,1,2579,2423,156,0,0,0,6
35264,2,2409,2410,-1,0,43,0,6
35265,1,2548,2531,17,0,226,0,6
35266,3,2414,2235,179,0,45,0,6
35267,3,2427,2409,18,0,125,0,6
35268,1,2407,2380,27,0,140,0,6
35269,2,2370,2560,-190,0,32,1,6
35270,3,2506,2398,108,0,302,0,8
35271,2,2467,2616,-149,0,245,0,6
35272,1,2372,2422,-50,0,303,0,6
35273,1,2418,2332,86,0,1,0,6
35274,2,2383,2416,-33,0,300,1,6
35275,3,2434,2499,-65,0,107,0,6
35276,1,2590,2402,188,0,1,0,6
35277,1,2408,2375,33,0,392,0,6
35278,1,2620,2638,-18,0,153,0,6
35279,2,2281,2403,-122,0,48,0,6
35280,1,2270,2403,-133,0,16,1,6
35281,1,2455,2403,52,0,253,0,6
35282,1,2545,2463,82,0,45,0,6
35283,1,2494,2338,156,0,0,0,6
35284,1,2410,2427,-17,0,43,0,6
35285,2,2441,2321,120,0,320,0,6
35286,1,2420,2304,116,0,487,0,6
35287,3,2544,2384,160,0,200,0,6
35288,2,2342,2463,-121,0,107,0,8
35289,1,2432,2265,167,0,176,0,6
35290,1,2419,2481,-62,0,13,0,6
35291,1,2328,2423,-95,0,1,0,6
35292,1,2402,2283,119,0,101,0,6
35293,3,2575,2532,43,0,120,0,6
35294,2,2439,2607,-168,0,365,1,6
35295,1,2419,2297,122,0,101,0,6
35296,2,2354,2453,-99,4,46,0,13
35297,1,2426,2533,-107,0,4,1,6
35298,2,2411,2340,71,0,180,0,6
35299,2,2505,2463,42,0,120,1,6
35300,3,2447,2448,-1,0,405,0,6
35301,2,2420,2583,-163,0,60,0,6
35302,2,2466,2405,61,0,295,0,6
35303,3,2434,2265,169,0,45,0,6
35304,1,2278,2450,-172,0,46,0,6
35305,1,2680,2682,-2,0,190,1,6
35306,1,2536,2379,157,0,127,0,6
35307,2,2313,2426,-113,0,202,1,6
35308,2,2399,2593,-194,0,40,0,6
35309,1,2568,2473,95,0,107,0,6
35310,1,2401,2323,78,0,241,1,6
35311,1,2577,2425,152,0,215,1,6
35312,1,2457,2340,117,4,45,0,8
35313,2,2416,2312,104,0,205,0,6
35314,1,2403,2229,174,4,301,0,13
35315,2,2619,2486,133,0,101,0,6
35316,1,2517,2494,23,0,148,1,6
35317,3,2249,2426,-177,0,202,0,6
35318,2,2451,2462,-11,0,267,0,6
35319,2,2434,2386,48,0,466,1,6
35320,3,2460,2435,25,0,122,0,6
35321,2,2665,2553,112,0,43,0,6
35322,2,2238,2411,-173,0,133,1,6
35323,1,2370,2413,-43,0,4,1,6
35324,2,2233,2499,-266,0,100,0,8
35325,2,2415,2356,59,0,202,0,6
35326,2,2262,2436,-174,0,31,0,6
35327,2,2314,2553,-239,0,375,0,10
35328,2,2371,2436,-65,0,102,1,6
35329,1,2416,2460,-44,0,1,1,6
35330,2,2474,2525,-51,0,52,1,6
35331,2,2694,2549,145,0,300,1,6
35332,3,2421,2378,43,0,127,0,6
35333,3,2497,2435,62,0,398,0,6
35334,2,2484,2539,-55,0,46,0,6
35335,2,2416,2335,81,0,1,0,6
35336,2,2408,2423,-15,0,386,1,6
35337,2,2387,2542,-155,0,2,0,6
35338,2,2587,2416,171,0,0,0,6
35339,2,2293,2409,-116,0,234,0,6
35340,3,2469,2340,129,0,117,0,6
35341,1,2468,2572,-104,0,101,1,6
35342,2,2334,2411,-77,0,250,0,6
35343,2,2319,2436,-117,0,128,1,6
35344,2,2478,2464,14,0,101,1,6
35345,3,2441,2359,82,0,150,0,6
35346,1,2596,2396,200,0,1,0,6
35347,1,2574,2401,173,0,120,0,6
35348,1,2300,2401,-101,0,344,0,6
35349,1,2555,2204,351,0,102,1,10
35350,1,2430,2312,118,0,322,0,10
35351,1,2539,2525,14,0,153,1,6
35352,1,2424,2434,-10,0,306,0,6
35353,2,2499,2453,46,0,200,1,6
35354,1,2470,2531,-61,0,241,0,6
35355,2,2448,2342,106,0,331,0,6
35356,1,2466,2370,96,4,107,0,13
35357,1,2400,2298,102,0,103,1,8
35358,1,2432,2408,24,0,200,0,6
35359,1,2340,2421,-81,0,46,0,6
35360,1,2676,2527,149,0,196,0,6
35361,2,2284,2433,-149,0,226,1,6
35362,2,2393,2599,-206,0,45,0,6
35363,2,2545,2384,161,0,40,0,6
35364,1,2398,2457,-59,0,45,1,6
35365,2,2426,2268,158,0,244,0,6
35366,2,2463,2577,-114,0,400,1,6
35367,1,2428,2287,141,0,48,1,6
35368,2,2342,2409,-67,0,1,0,6
35369,1,2511,2427,84,0,215,1,6
35370,1,2488,2522,-34,0,43,1,6
35371,1,2558,2627,-69,0,41,0,6
35372,1,2392,2400,-8,0,463,1,6
35373,2,2436,2495,-59,0,107,0,6
35374,2,2425,2577,-152,0,80,0,6
35375,1,2377,2418,-41,0,13,0,6
35376,2,2413,2290,123,0,5,0,6
35377,2,2561,2524,37,0,123,1,6
35378,2,2496,2679,-183,0,312,0,6
35379,1,2602,2391,211,0,1,0,6
35380,2,2421,2379,42,0,127,1,6
35381,2,2282,2612,-330,0,30,0,6
35382,1,2306,2424,-118,0,40,0,6
35383,1,2467,2522,-55,0,200,0,8
35384,1,2544,2414,130,0,133,0,6
35385,2,2453,2533,-80,0,190,0,6
35386,1,2581,2421,160,0,0,0,6
35387,1,2395,2434,-39,0,151,0,6
35388,3,2470,2479,-9,0,311,0,6
35389,1,2410,2375,35,0,122,0,6
35390,3,2363,2400,-37,0,415,0,6
35391,1,2403,2339,64,0,31,0,6
35392,3,2531,2613,-82,0,107,0,6
35393,1,2524,2440,84,0,301,0,6
35394,2,2339,2472,-133,0,469,0,6
35395,2,2385,2429,-44,0,37,0,6
35396,2,2388,2604,-216,0,45,0,6
35397,2,2440,2423,17,0,107,0,6
35398,1,2476,2450,26,0,241,1,6
35399,2,2416,2406,10,0,301,0,6
35400,1,2504,2431,73,0,320,1,6
35401,3,2421,2244,177,4,106,0,13
35402,2,2413,2337,76,0,1,0,6
35403,2,2414,2519,-105,0,43,0,6
35404,2,2264,2437,-173,0,300,0,6
35405,2,2310,2493,-183,0,80,0,6
35406,2,2334,2408,-74,0,0,0,6
35407,1,2440,2362,78,0,110,0,6
35408,1,2437,2318,119,0,107,0,6
35409,1,2475,2313,162,0,193,1,6
35410,2,2349,2438,-89,0,30,0,6
35411,2,2392,2537,-145,0,2,0,6
35412,3,2477,2520,-43,0,168,0,6
35413,2,2607,2386,221,0,1,1,6
35414,2,2308,2423,-115,0,44,0,6
35415,2,2638,2449,189,0,130,0,6
35416,2,2297,2405,-108,0,234,0,6
35417,1,2447,2345,102,0,6,0,10
35418,1,2406,2320,86,0,43,1,6
35419,1,2564,2460,104,0,45,1,6
35420,1,2411,2310,101,0,140,0,6
35421,1,2434,2383,51,0,16,0,6
35422,1,2516,2495,21,0,147,0,6
35423,1,2683,2493,190,0,295,0,6
35424,1,2394,2415,-21,0,33,0,6
35425,1,2382,2441,-59,0,243,0,6
35426,1,2544,2392,152,0,201,0,6
35427,1,2333,2414,-81,0,45,1,6
35428,2,2435,2460,-25,0,326,0,6
35429,2,2407,2385,22,0,462,1,6
35430,3,2552,2555,-3,0,102,0,6
35431,1,2398,2494,-96,0,337,0,6
35432,1,2530,2657,-127,0,64,0,6
35433,1,2315,2443,-128,0,100,1,6
35434,1,2411,2548,-137,0,395,1,6
35435,2,2344,2407,-63,0,1,0,6
35436,1,2470,2444,26,0,46,0,6
35437,1,2412,2330,82,0,31,0,6
35438,2,2479,2531,-52,0,302,0,6
35439,2,2270,2523,-253,0,265,0,6
35440,1,2528,2629,-101,0,0,0,6
35441,1,2541,2388,153,0,200,0,6
35442,2,2345,2431,-86,0,400,0,6
35443,1,2276,2418,-142,0,240,0,6
35444,1,2434,2395,39,0,278,1,6
35445,2,2364,2431,-67,0,4,0,6
35446,1,2429,2434,-5,0,1,0,6
35447,2,2440,2327,113,0,168,1,6
35448,2,2249,2404,-155,0,120,1,8
35449,3,2557,2435,122,0,339,0,10
35450,2,2380,2400,-20,0,487,1,6
35452,2,2443,2548,-105,0,211,0,6
35453,1,2427,2466,-39,0,0,0,6
35455,2,2410,2496,-86,0,405,0,6
35456,2,2277,2439,-162,0,45,0,6
35457,2,2490,2685,-195,0,300,0,6
35458,1,2520,2516,4,0,56,1,6
35459,1,2378,2420,-42,0,399,0,6
35460,2,2437,2475,-38,0,331,0,6
35461,1,2489,2522,-33,0,43,0,6
35462,2,2622,2477,145,0,120,0,6
35463,2,2391,2575,-184,0,190,1,6
35464,2,2445,2569,-124,0,6,1,6
35465,1,2395,2598,-203,0,45,0,6
35466,3,2411,2340,71,0,1,0,6
35467,1,2454,2353,101,0,145,1,6
35468,1,2414,2282,132,0,386,0,6
35469,2,2470,2398,72,4,207,0,13
35470,2,2311,2487,-176,4,41,0,13
35471,1,2467,2338,129,0,102,1,6
35472,2,2361,2442,-81,0,130,1,6
35473,2,2476,2301,175,0,241,1,8
35474,2,2597,2634,-37,0,33,0,6
35475,2,2402,2434,-32,0,4,0,6
35476,2,2430,2364,66,0,154,0,6
35477,1,2536,2405,131,0,0,0,6
35478,3,2612,2652,-40,0,124,0,6
35479,1,2478,2435,43,0,110,0,6
35480,1,2415,2474,-59,0,315,1,6
35481,1,2414,2410,4,0,42,0,6
35482,2,2476,2427,49,0,320,1,6
35483,3,2291,2428,-137,0,241,0,6
35484,2,2318,2437,-119,0,302,0,10
35485,2,2325,2417,-92,0,110,0,6
35486,1,2459,2322,137,0,107,1,6
35487,2,2436,2360,76,0,4,0,6
35488,1,2552,2439,113,0,150,0,6
35489,1,2537,2485,52,0,131,0,6
35490,2,2284,2433,-149,0,106,0,6
35491,2,2515,2496,19,0,241,0,6
35492,2,2446,2614,-168,0,107,0,6
35493,2,2500,2435,65,0,106,1,6
35494,2,2390,2581,-191,0,112,1,6
35495,1,2688,2487,201,0,295,0,6
35496,1,2400,2351,49,0,240,1,6
35497,1,2589,2403,186,0,1,0,6
35498,3,2465,2430,35,0,140,0,6
35499,1,2406,2375,31,0,8,0,6
35500,2,2526,2493,33,0,109,1,6
35501,2,2402,2408,-6,0,304,0,6
35502,2,2414,2385,29,0,183,0,6
35503,2,2385,2510,-125,0,3,1,6
35504,2,2441,2308,133,0,62,0,6
35505,2,2404,2424,-20,0,45,1,6
35507,3,2286,2421,-135,0,47,0,6
35508,2,2480,2431,49,0,46,0,6
35509,1,2371,2467,-96,0,302,0,6
35510,2,2325,2439,-114,0,0,0,6
35511,1,2446,2357,89,0,4,0,6
35512,2,2439,2397,42,0,100,0,6
35513,2,2341,2410,-69,0,1,0,6
35514,2,2225,2473,-248,0,295,1,6
35515,3,2441,2452,-11,0,360,0,10
35516,1,2572,2540,32,0,306,0,6
35517,1,2429,2389,40,0,96,0,6
35518,2,2421,2321,100,0,135,0,6
35519,2,2401,2458,-57,0,300,0,6
35520,1,2349,2430,-81,0,112,0,6
35521,2,2502,2509,-7,0,43,0,6
35522,2,2367,2429,-62,0,138,0,6
35523,1,2617,2437,180,0,103,0,6
35524,1,2415,2336,79,0,106,1,6
35525,1,2440,2388,52,0,45,1,6
35526,2,2435,2556,-121,0,211,0,6
35527,3,2618,2652,-34,0,131,0,6
35528,2,2436,2367,69,0,45,0,6
35529,2,2470,2476,-6,0,464,0,6
35530,2,2463,2573,-110,0,244,0,6
35531,2,2401,2592,-191,0,40,0,6
35532,1,2406,2233,173,0,337,0,6
35533,1,2351,2408,-57,0,106,0,6
35534,2,2556,2613,-57,0,225,0,6
35535,1,2337,2468,-131,0,311,0,6
35536,1,2480,2683,-203,0,184,1,6
35537,1,2542,2433,109,0,1,0,6
35538,1,2412,2388,24,0,21,0,6
35539,1,2408,2223,185,4,301,0,13
35540,3,2490,2464,26,4,41,0,13
35541,1,2391,2407,-16,0,400,1,6
35542,3,2443,2534,-91,0,263,0,6
35543,2,2432,2578,-146,0,101,1,6
35544,3,2362,2493,-131,0,4,0,6
35545,2,2414,2434,-20,0,241,1,6
35546,1,2377,2483,-106,0,321,0,6
35547,2,2384,2546,-162,0,1,0,6
35548,2,2369,2474,-105,0,141,1,6
35549,1,2499,2346,153,0,240,0,6
35550,2,2426,2294,132,0,241,0,6
35551,1,2584,2691,-107,0,120,0,6
35552,2,2353,2451,-98,0,121,1,6
35553,2,2433,2520,-87,0,156,0,6
35554,1,2482,2464,18,0,112,1,6
35555,1,2439,2317,122,0,40,1,6
35556,3,2393,2410,-17,0,310,0,6
35557,2,2304,2434,-130,0,36,0,6
35558,1,2429,2620,-191,0,0,0,6
35559,1,2406,2236,170,0,4,0,6
35560,3,2419,2374,45,0,344,0,6
35561,1,2391,2403,-12,0,121,0,6
35562,1,2600,2396,204,0,10,0,6
35563,1,2451,2295,156,0,192,0,10
35564,2,2421,2311,110,0,43,0,6
35565,1,2560,2432,128,0,150,0,6
35566,1,2595,2398,197,0,312,1,6
35567,1,2402,2317,85,0,205,0,6
35568,1,2290,2418,-128,0,7,1,6
35569,1,2384,2445,-61,0,247,0,6
35570,2,2514,2381,133,0,210,0,6
35571,2,2468,2293,175,0,105,0,8
35572,1,2556,2441,115,0,4,0,10
35573,2,2392,2429,-37,0,45,1,6
35574,1,2444,2546,-102,0,301,0,6
35575,1,2515,2496,19,0,148,0,6
35576,2,2424,2311,113,0,134,0,6
35577,3,2469,2429,40,0,320,0,6
35578,2,2440,2524,-84,0,57,1,6
35579,1,2549,2466,83,0,380,0,6
35580,1,2332,2419,-87,0,1,0,6
35581,2,2612,2451,161,0,103,1,6
35582,3,2460,2496,-36,0,1,0,6
35583,1,2393,2602,-209,0,45,0,6
35584,2,2302,2416,-114,0,241,1,8
35586,1,2438,2399,39,0,112,0,6
35587,1,2406,2459,-53,0,255,1,6
35588,1,2410,2339,71,0,131,1,6
35589,1,2675,2526,149,0,167,1,6
35590,1,2344,2491,-147,0,46,0,6
35591,2,2258,2401,-143,0,112,1,6
35592,2,2467,2532,-65,0,315,1,6
35593,1,2429,2364,65,0,190,0,6
35595,1,2374,2459,-85,0,109,0,8
35596,1,2533,2489,44,0,0,0,6
35597,2,2304,2445,-141,0,80,0,6
35598,2,2451,2503,-52,0,43,0,6
35599,1,2440,2396,44,0,90,0,6
35600,2,2430,2464,-34,0,256,0,6
35602,2,2390,2544,-154,0,101,1,6
35603,1,2313,2462,-149,0,375,0,6
35604,1,2553,2393,160,0,406,0,6
35605,2,2459,2487,-28,0,40,1,6
35606,1,2419,2252,167,0,40,1,6
35607,2,2478,2485,-7,0,46,1,6
35608,2,2443,2434,9,0,50,0,6
35609,2,2233,2410,-177,0,112,1,6
35610,2,2434,2375,59,0,45,0,6
35611,3,2617,2365,252,0,211,0,6
35612,2,2340,2503,-163,0,487,0,6
35613,1,2684,2581,103,0,101,1,6
35614,2,2412,2339,73,0,1,1,6
35615,1,2491,2521,-30,0,43,0,6
35616,2,2398,2539,-141,0,315,1,6
35617,1,2454,2321,133,0,121,0,6
35618,1,2593,2402,191,0,0,0,6
35619,1,2430,2469,-39,0,115,0,6
35620,3,2301,2419,-118,0,251,0,6
35621,2,2428,2564,-136,0,414,0,6
35622,2,2337,2560,-223,0,133,0,10
35623,1,2592,2478,114,0,120,1,6
35624,3,2335,2453,-118,0,45,0,6
35625,1,2410,2330,80,0,409,0,6
35626,1,2529,2650,-121,0,301,0,6
35627,1,2552,2324,228,0,4,0,6
35628,2,2436,2538,-102,0,306,0,6
35629,2,2316,2434,-118,0,0,1,6
35630,1,2472,2604,-132,0,130,1,6
35631,2,2462,2436,26,0,406,0,6
35632,2,2381,2428,-47,0,1,0,6
35633,1,2519,2484,35,0,398,1,6
35634,1,2483,2387,96,0,113,0,6
35635,2,2208,2455,-247,0,13,1,10
35636,2,2389,2571,-182,0,3,0,6
35637,2,2211,2425,-214,0,245,0,6
35638,1,2381,2405,-24,0,119,0,6
35639,1,2522,2353,169,0,406,0,6
35640,1,2397,2401,-4,0,5,1,6
35641,1,2360,2416,-56,0,112,0,6
35642,2,2271,2418,-147,4,308,0,13
35643,1,2319,2416,-97,0,196,0,6
35644,2,2451,2337,114,0,112,0,6
35645,1,2678,2557,121,0,287,0,6
35646,1,2508,2397,111,0,211,0,6
35647,2,2506,2458,48,0,386,0,6
35648,2,2452,2298,154,0,102,0,8
35649,1,2441,2437,4,0,233,1,6
35650,2,2317,2456,-139,0,57,0,6
35651,1,2537,2485,52,0,220,0,6
35652,2,2487,2472,15,0,130,0,6
35653,2,2322,2554,-232,0,343,0,6
35654,1,2555,2304,251,0,135,0,8
35655,1,2387,2422,-35,0,115,0,6
35656,1,2614,2592,22,0,126,0,6
35657,2,2736,2577,159,0,101,1,6
35658,1,2346,2405,-59,0,1,0,6
35659,2,2514,2497,17,0,241,0,6
35660,2,2394,2443,-49,0,45,1,6
35661,1,2688,2567,121,0,211,0,6
35662,2,2365,2415,-50,0,315,1,6
35663,1,2438,2335,103,0,44,0,10
35664,2,2442,2456,-14,0,115,0,6
35665,2,2492,2399,93,0,122,1,6
35666,1,2542,2386,156,0,201,0,6
35667,1,2433,2394,39,0,43,1,6
35668,1,2542,2596,-54,0,301,1,6
35669,1,2409,2326,83,0,28,0,6
35670,1,2347,2414,-67,0,42,1,6
35671,2,2493,2629,-136,0,302,1,6
35672,1,2470,2425,45,0,115,1,6
35673,1,2413,2474,-61,0,153,1,6
35674,2,2349,2438,-89,0,49,0,6
35675,1,2402,2352,50,0,278,1,6
35676,2,2596,2487,109,0,245,1,6
35677,1,2342,2525,-183,0,130,0,6
35678,3,2344,2443,-99,0,225,0,6
35679,1,2306,2444,-138,0,108,0,8
35680,2,2312,2464,-152,0,245,0,6
35681,2,2432,2500,-68,0,474,0,6
35682,1,2479,2553,-74,0,254,0,6
35683,1,2419,2264,155,0,463,0,6
35684,1,2457,2295,162,0,117,0,10
35685,1,2396,2403,-7,0,0,0,6
35687,2,2409,2426,-17,0,205,0,6
35688,2,2513,2431,82,0,127,0,6
35689,1,2564,2692,-128,0,150,1,6
35690,1,2437,2478,-41,0,122,1,6
35691,1,2557,2320,237,0,373,0,6
35692,1,2503,2508,-5,0,43,0,6
35693,2,2585,2404,181,0,327,0,6
35694,1,2442,2323,119,0,322,0,10
35695,1,2517,2383,134,0,92,0,6
35696,1,2461,2437,24,0,406,0,6
35697,1,2546,2546,0,0,484,0,6
35698,3,2504,2348,156,0,135,0,6
35699,1,2480,2543,-63,0,260,0,6
35700,1,2322,2460,-138,0,216,1,6
35701,1,2420,2313,107,0,64,0,6
35702,1,2407,2485,-78,0,40,1,6
35703,2,2391,2453,-62,0,6,1,6
35704,2,2352,2427,-75,0,128,1,6
35705,2,2473,2345,128,0,53,0,6
35706,2,2437,2385,52,0,101,0,8
35707,1,2577,2442,135,0,45,0,6
35708,2,2438,2412,26,0,324,1,6
35709,1,2460,2563,-103,0,4,0,10
35710,1,2486,2549,-63,0,244,0,6
35711,2,2547,2619,-72,0,27,0,6
35712,2,2466,2589,-123,0,113,0,6
35713,2,2383,2400,-17,0,386,0,6
35714,2,2329,2505,-176,0,190,1,6
35715,2,2438,2280,158,0,422,0,6
35716,3,2442,2346,96,0,112,0,6
35717,1,2468,2309,159,0,101,0,6
35718,1,2495,2319,176,0,120,0,6
35719,1,2422,2281,141,0,380,0,6
35720,2,2467,2432,35,0,140,1,6
35721,2,2289,2465,-176,0,253,0,6
35722,1,2534,2353,181,0,241,0,6
35723,1,2489,2521,-32,0,46,0,6
35724,2,2421,2349,72,0,409,0,6
35725,2,2317,2559,-242,0,316,1,6
35726,1,2684,2571,113,0,132,0,6
35727,1,2394,2415,-21,0,133,0,6
35728,1,2508,2472,36,0,13,1,6
35729,1,2411,2448,-37,0,1,1,6
35730,1,2536,2487,49,0,246,0,6
35731,1,2632,2211,421,0,140,1,6
35732,2,2542,2728,-186,0,301,0,6
35733,1,2432,2467,-35,0,115,0,6
35734,2,2407,2347,60,0,143,0,6
35735,2,2360,2445,-85,0,107,0,6
35736,1,2552,2493,59,0,337,0,6
35737,1,2413,2280,133,0,13,0,6
35738,2,2467,2272,195,4,30,0,11
35739,2,2379,2515,-136,0,2,0,6
35740,1,2531,2530,1,0,104,0,6
35741,2,2402,2375,27,0,310,0,6
35742,1,2392,2430,-38,0,152,0,8
35743,2,2495,2503,-8,0,43,0,6
35744,2,2350,2438,-88,0,1,1,6
35745,2,2502,2330,172,0,107,0,6
35746,2,2458,2386,72,0,55,0,6
35747,1,2432,2369,63,0,40,0,6
35748,1,2294,2556,-262,0,49,0,10
35749,3,2559,2525,34,0,121,0,6
35750,2,2316,2404,-88,0,110,0,6
35751,3,2419,2323,96,0,100,0,6
35752,2,2498,2589,-91,0,120,0,6
35753,1,2409,2400,9,0,483,0,6
35754,2,2405,2378,27,0,122,0,6
35755,2,2289,2430,-141,0,1,0,6
35756,2,2731,2688,43,0,184,1,6
35757,1,2462,2539,-77,0,250,0,6
35758,1,2593,2540,53,0,120,0,6
35759,1,2348,2440,-92,0,226,0,6
35760,1,2333,2469,-136,0,190,0,10
35761,1,2389,2425,-36,0,4,0,6
35762,1,2316,2417,-101,0,306,0,6
35763,1,2461,2438,23,0,406,0,6
35764,2,2354,2400,-46,0,40,0,6
35765,2,2509,2432,77,0,145,0,6
35766,2,2307,2624,-317,0,107,0,6
35767,2,2424,2345,79,0,40,1,6
35768,2,2488,2508,-20,0,140,0,6
35769,1,2557,2490,67,0,335,0,6
35770,1,2407,2567,-160,0,145,1,6
35771,1,2561,2315,246,0,373,1,6
35772,2,2554,2541,13,0,256,0,6
35774,2,2428,2444,-16,0,102,0,6
35775,2,2438,2467,-29,0,311,0,6
35776,2,2277,2435,-158,0,154,0,6
35777,2,2442,2418,24,0,100,0,6
35778,1,2240,2424,-184,0,130,0,8
35779,1,2461,2494,-33,0,230,1,6
35780,2,2593,2612,-19,0,200,0,6
35781,2,2626,2636,-10,0,123,0,6
35782,2,2291,2449,-158,0,127,0,6
35783,2,2338,2494,-156,0,113,1,6
35784,2,2424,2559,-135,0,117,0,6
35785,2,2364,2436,-72,0,140,0,6
35786,2,2376,2502,-126,0,2,0,6
35787,1,2439,2305,134,0,84,0,6
35788,2,2323,2561,-238,0,434,0,6
35789,1,2325,2417,-92,0,1,0,6
35790,2,2446,2346,100,0,106,0,6
35791,1,2537,2565,-28,0,121,1,6
35792,3,2434,2394,40,0,127,0,6
35793,1,2405,2325,80,0,103,1,8
35794,1,2532,2464,68,0,301,0,6
35795,1,2461,2320,141,0,6,0,10
35796,3,2394,2415,-21,0,115,0,6
35797,2,2297,2420,-123,0,492,0,6
35798,1,2524,2359,165,0,0,0,6
35799,1,2598,2438,160,0,120,0,6
35800,3,2433,2466,-33,0,115,0,6
35801,1,2695,2724,-29,0,194,1,6
35802,1,2434,2285,149,0,483,0,6
35803,3,2443,2274,169,0,264,0,6
35804,2,2473,2433,40,0,337,0,6
35805,1,2367,2415,-48,0,463,0,8
35806,1,2537,2382,155,0,200,1,6
35807,2,2408,2376,32,0,112,0,6
35808,1,2558,2402,156,0,219,0,8
35809,1,2514,2483,31,0,145,1,6
35810,1,2649,2561,88,0,228,0,6
35811,3,2438,2425,13,0,6,0,6
35812,2,2446,2443,3,0,318,0,6
35813,1,2433,2417,16,0,244,0,6
35814,1,2431,2410,21,0,110,0,6
35815,1,2620,2320,300,0,107,0,6
35816,2,2641,2588,53,0,46,0,6
35817,1,2414,2366,48,0,414,0,6
35818,2,2411,2430,-19,0,8,1,6
35819,1,2547,2557,-10,0,228,0,6
35820,2,2313,2564,-251,0,14,0,6
35821,1,2653,2563,90,0,113,1,6
35822,1,2409,2297,112,0,8,1,8
35823,1,2450,2394,56,0,88,1,6
35824,1,2300,2442,-142,0,140,1,6
35825,2,2326,2497,-171,0,306,0,6
35826,1,2505,2372,133,0,210,0,6
35827,2,2439,2335,104,0,241,1,6
35828,2,2353,2449,-96,0,1,0,6
35829,1,2410,2332,78,0,1,0,6
35830,1,2488,2468,20,0,120,0,6
35832,1,2537,2421,116,0,301,0,6
35833,1,2718,2701,17,0,184,0,6
35834,2,2356,2528,-172,0,101,0,6
35835,2,2414,2395,19,0,487,0,6
35836,1,2465,2433,32,0,320,0,6
35837,2,2466,2543,-77,0,469,0,6
35838,1,2435,2439,-4,0,110,0,6
35839,1,2440,2360,80,0,211,1,6
35840,2,2258,2459,-201,4,147,1,11
35841,1,2358,2424,-66,0,100,0,6
35842,2,2276,2476,-200,0,250,0,6
35843,2,2559,2618,-59,0,203,0,6
35844,2,2463,2478,-15,0,263,0,6
35845,2,2478,2519,-41,0,140,0,6
35846,1,2551,2439,112,0,380,1,6
35847,1,2594,2635,-41,0,140,0,6
35848,1,2405,2437,-32,0,415,1,6
35849,2,2541,2460,81,0,120,0,6
35850,2,2262,2412,-150,0,331,0,6
35851,2,2507,2515,-8,0,122,0,6
35852,1,2398,2426,-28,0,46,0,6
35853,1,2566,2311,255,0,373,0,6
35854,2,2407,2276,131,4,8,0,13
35855,2,2493,2435,58,0,228,1,6
35856,3,2351,2431,-80,0,283,0,6
35857,2,2389,2455,-66,0,353,1,6
35858,1,2462,2405,57,0,150,0,6
35859,1,2349,2422,-73,0,1,1,6
35860,1,2373,2540,-167,0,415,0,6
35861,2,2401,2408,-7,0,115,1,6
35862,2,2386,2435,-49,0,45,0,6
35863,1,2449,2295,154,0,302,0,6
35864,1,2696,2724,-28,0,164,1,6
35865,2,2553,2658,-105,0,123,1,6
35866,1,2286,2419,-133,0,34,0,6
35867,2,2342,2432,-90,0,100,1,6
35868,1,2462,2458,4,0,315,1,6
35869,1,2484,2441,43,0,122,0,6
35870,1,2445,2461,-16,0,142,1,6
35871,2,2329,2414,-85,0,106,1,6
35872,3,2402,2361,41,0,265,0,6
35873,1,2434,2442,-8,0,106,0,6
35874,1,2288,2441,-153,0,132,1,6
35875,1,2629,2601,28,0,46,0,6
35876,2,2308,2568,-260,0,310,1,6
35877,1,2305,2401,-96,0,487,0,6
35878,3,2428,2471,-43,0,115,0,6
35879,1,2524,2473,51,0,201,0,6
35880,1,2415,2434,-19,0,461,0,6
35881,1,2430,2353,77,0,147,0,6
35882,1,2424,2221,203,0,63,1,6
35883,2,2410,2399,11,0,123,0,6
35884,2,2521,2547,-26,0,20,0,6
35885,2,2431,2411,20,0,110,1,6
35886,3,2624,2622,2,0,241,0,6
35887,2,2376,2502,-126,0,156,0,6
35888,1,2460,2384,76,0,380,0,6
35889,1,2531,2353,178,0,1,0,6
35890,1,2442,2266,176,0,300,1,6
35891,1,2486,2467,19,0,120,0,6
35892,2,2413,2517,-104,0,40,0,8
35893,1,2467,2298,169,0,101,1,6
35894,1,2439,2610,-171,0,152,0,6
35895,2,2436,2489,-53,0,40,0,6
35896,2,2414,2395,19,0,121,0,6
35897,2,2417,2389,28,0,1,0,6
35898,1,2582,2541,41,0,227,0,6
35899,2,2436,2338,98,0,241,1,6
35900,2,2470,2429,41,0,406,1,6
35901,2,2596,2634,-38,0,127,0,6
35902,2,2419,2325,94,0,57,0,6
35903,1,2415,2356,59,0,106,0,6
35904,2,2355,2451,-96,0,30,0,6
35905,2,2452,2381,71,0,40,1,6
35906,1,2455,2468,-13,0,13,0,6
35907,3,2468,2529,-61,0,123,0,6
35908,1,2462,2492,-30,0,200,0,6
35909,1,2702,2549,153,0,270,1,6
35910,1,2408,2290,118,0,101,0,6
35911,2,2535,2433,102,0,153,0,6
35912,3,2348,2434,-86,0,253,0,6
35913,3,2281,2427,-146,0,16,0,6
35914,1,2570,2306,264,0,40,0,6
35915,1,2373,2446,-73,0,0,0,6
35916,3,2580,2536,44,0,241,0,6
35917,2,2428,2421,7,0,110,1,6
35918,2,2624,2623,1,0,301,0,6
35919,1,2506,2555,-49,0,225,0,6
35920,1,2380,2465,-85,0,278,0,6
35921,2,2418,2352,66,0,40,1,6
35922,1,2531,2485,46,0,115,0,6
35923,1,2433,2350,83,0,157,0,6
35924,1,2420,2318,102,0,206,1,6
35925,1,2332,2412,-80,0,241,0,6
35926,2,2328,2486,-158,0,107,1,6
35927,2,2401,2408,-7,0,115,1,6
35928,1,2553,2448,105,0,110,0,6
35929,2,2578,2380,198,0,453,0,6
35930,1,2319,2409,-90,0,150,0,8
35932,1,2494,2431,63,0,128,0,6
35933,1,2591,2390,201,0,181,0,6
35934,1,2471,2299,172,0,190,0,6
35935,1,2345,2429,-84,0,132,1,6
35936,2,2295,2474,-179,0,106,0,6
35937,1,2521,2402,119,0,0,0,8
35938,1,2435,2464,-29,0,115,0,6
35939,1,2541,2444,97,0,310,0,6
35940,3,2425,2534,-109,0,104,0,6
35941,2,2440,2557,-117,0,25,0,6
35942,2,2528,2469,59,0,145,1,6
35943,2,2235,2411,-176,0,212,1,6
35944,1,2514,2330,184,0,101,0,6
35945,3,2388,2439,-51,0,45,0,6
35946,1,2563,2228,335,0,202,0,8
35947,1,2419,2339,80,0,151,0,6
35948,2,2551,2776,-225,0,201,0,6
35949,2,2239,2402,-163,0,119,0,6
35950,1,2427,2499,-72,0,45,1,6
35951,3,2537,2705,-168,0,0,0,6
35952,2,2304,2572,-268,0,343,1,6
35953,1,2474,2356,118,0,156,1,6
35955,1,2358,2411,-53,0,1,1,6
35956,2,2458,2387,71,0,380,0,6
35957,1,2388,2411,-23,0,296,0,6
35958,1,2548,2545,3,0,300,0,6
35959,2,2388,2549,-161,0,7,1,6
35960,1,2414,2273,141,0,240,0,6
35961,1,2479,2593,-114,0,131,0,6
35962,3,2345,2437,-92,0,283,0,6
35963,2,2370,2525,-155,0,10,1,8
35964,2,2282,2447,-165,0,138,0,6
35965,3,2480,2580,-100,0,373,0,6
35966,2,2388,2424,-36,0,104,0,6
35967,2,2366,2569,-203,0,49,0,6
35968,1,2427,2393,34,0,330,1,6
35969,2,2334,2436,-102,0,151,1,6
35970,1,2414,2396,18,0,121,0,6
35971,1,2405,2489,-84,0,106,0,6
35972,1,2482,2477,5,0,106,1,6
35973,1,2414,2339,75,0,315,1,6
35974,1,2452,2368,84,0,15,0,6
35975,2,2546,2664,-118,0,15,0,6
35976,2,2422,2354,68,0,202,0,6
35977,2,2274,2439,-165,0,48,1,6
35978,3,2458,2442,16,0,406,0,6
35979,1,2476,2522,-46,0,140,1,6
35980,2,2389,2418,-29,0,300,0,6
35981,1,2574,2302,272,0,39,1,6
35982,3,2316,2461,-145,0,15,0,6
35983,2,2424,2594,-170,0,6,0,6
35984,2,2586,2487,99,0,213,0,6
35985,1,2292,2430,-138,0,227,0,6
35986,1,2404,2365,39,0,40,1,6
35987,2,2572,2383,189,0,335,1,6
35988,1,2429,2383,46,0,102,0,6
35989,1,2433,2478,-45,0,365,1,6
35990,1,2405,2343,62,0,453,1,6
35991,2,2540,2554,-14,0,107,1,6
35992,2,2269,2425,-156,0,45,0,6
35993,2,2394,2475,-81,0,289,0,6
35994,3,2436,2347,89,0,157,0,6
35995,1,2552,2578,-26,0,313,0,6
35996,1,2390,2419,-29,0,133,0,6
35997,1,2482,2310,172,0,101,1,6
35998,2,2325,2412,-87,0,40,0,6
35999,2,2540,2432,108,0,211,0,6
36000,2,2259,2414,-155,0,200,0,6
36001,1,2532,2426,106,0,1,0,6
36002,3,2405,2281,124,0,134,0,6
36003,2,2441,2404,37,0,190,0,6
36004,1,2416,2320,96,0,1,0,6
36005,1,2463,2235,228,4,16,0,11
36006,1,2472,2333,139,0,450,0,6
36007,2,2333,2453,-120,0,107,0,6
36008,2,2442,2613,-171,0,311,0,6
36009,2,2413,2397,16,0,483,0,6
36010,1,2558,2488,70,0,335,0,6
36012,1,2415,2384,31,0,200,0,6
36013,1,2402,2260,142,0,51,1,6
36014,1,2515,2482,33,0,145,1,6
36015,2,2442,2457,-15,0,115,0,6
36016,1,2618,2542,76,0,130,0,6
36017,2,2403,2407,-4,0,133,0,6
36018,1,2438,2298,140,0,1,0,6
36019,1,2494,2579,-85,0,135,0,6
36020,2,2316,2421,-105,0,41,0,6
36021,1,2354,2429,-75,0,215,0,6
36022,1,2423,2307,116,0,106,0,6
36023,2,2471,2379,92,0,200,0,6
36024,1,2360,2622,-262,0,1,0,6
36025,2,2483,2434,49,0,102,0,6
36026,1,2409,2420,-11,0,43,0,6
36027,2,2425,2312,113,0,1,0,6
36028,1,2483,2425,58,0,112,0,6
36029,1,2563,2532,31,0,7,0,6
36030,1,2392,2410,-18,0,291,1,6
36031,1,2344,2528,-184,0,252,0,8
36032,2,2427,2440,-13,0,118,0,6
36033,1,2457,2451,6,0,112,1,6
36034,1,2390,2419,-29,0,8,0,6
36035,1,2320,2417,-97,0,106,0,6
36036,1,2534,2569,-35,0,225,0,6
36037,1,2520,2352,168,0,0,1,8
36038,2,2527,2448,79,0,0,0,6
36039,1,2414,2414,0,0,253,0,6
36040,1,2414,2245,169,0,57,0,6
36041,2,2563,2393,170,0,332,0,6
36042,1,2464,2347,117,0,1,0,6
36043,2,2537,2623,-86,0,10,0,6
36044,2,2477,2520,-43,0,140,0,6
36045,2,2415,2249,166,0,152,1,6
36046,1,2463,2436,27,0,320,1,6
36047,2,2357,2406,-49,0,196,0,6
36048,1,2575,2572,3,0,317,0,6
36049,2,2410,2327,83,0,1,0,6
36050,1,2410,2562,-152,0,227,0,6
36051,1,2413,2397,16,0,487,0,6
36052,1,2335,2422,-87,0,201,0,6
36053,2,2280,2422,-142,0,4,0,6
36054,2,2613,2541,72,0,220,0,6
36055,2,2418,2403,15,0,335,1,6
36056,2,2466,2520,-54,0,1,0,6
36057,1,2617,2441,176,0,444,1,6
36058,3,2488,2396,92,0,120,0,6
36059,1,2627,2532,95,0,131,1,6
36060,1,2422,2536,-114,0,151,0,6
36061,3,2525,2454,71,0,0,0,6
36062,2,2275,2429,-154,0,113,1,6
36063,1,2415,2398,17,0,346,0,6
36064,3,2434,2348,86,0,250,0,6
36065,2,2370,2415,-45,0,1,0,6
36066,2,2445,2488,-43,0,360,0,6
36067,1,2420,2353,67,0,9,0,6
36068,2,2340,2404,-64,0,440,1,6
36069,1,2450,2440,10,0,128,1,6
36070,3,2525,2472,53,0,145,0,6
36071,1,2407,2420,-13,0,151,1,6
36072,1,2402,2411,-9,0,190,0,6
36073,2,2480,2555,-75,0,341,1,6
36074,1,2445,2462,-17,0,426,0,6
36075,3,2334,2403,-69,0,41,0,6
36076,1,2406,2491,-85,0,312,0,6
36077,2,2402,2335,67,0,1,0,6
36078,2,2296,2409,-113,0,4,0,6
36079,3,2566,2581,-15,0,114,0,6
36080,3,2606,2554,52,0,250,0,6
36081,2,2344,2406,-62,0,301,1,6
36082,2,2392,2418,-26,0,133,0,6
36083,1,2431,2468,-37,0,115,0,6
36084,1,2548,2685,-137,0,101,0,6
36085,2,2324,2411,-87,0,123,0,6
36086,1,2398,2528,-130,0,5,0,6
36087,2,2425,2426,-1,0,15,0,6
36088,1,2486,2438,48,0,20,0,6
36089,1,2400,2337,63,0,1,0,6
36090,2,2420,2365,55,0,40,0,6
36091,2,2524,2632,-108,0,300,1,6
36092,3,2350,2433,-83,0,245,0,6
36093,1,2309,2457,-148,0,106,1,6
36094,1,2420,2491,-71,0,455,0,6
36095,2,2405,2264,141,0,153,0,6
36096,1,2493,2440,53,0,112,1,6
36097,1,2689,2605,84,0,213,0,6
36098,3,2555,2546,9,0,459,0,6
36099,2,2405,2408,-3,0,334,0,6
36100,1,2327,2472,-145,0,245,1,6
36101,2,2434,2559,-125,0,335,0,6
36102,1,2414,2414,0,0,253,1,6
36103,3,2473,2525,-52,0,140,0,6
36104,2,2333,2405,-72,0,1,0,6
36105,1,2409,2328,81,0,405,0,6
36106,2,2602,2456,146,0,244,1,6
36107,1,2451,2366,85,0,67,0,6
36108,1,2581,2567,14,0,420,0,6
36109,1,2409,2291,118,0,277,1,6
36110,3,2225,2412,-187,0,212,0,6
36111,2,2371,2414,-43,0,1,0,6
36112,1,2462,2438,24,0,354,0,6
36113,2,2411,2292,119,0,101,1,6
36114,1,2382,2529,-147,0,5,0,6
36115,2,2424,2386,38,0,483,1,6
36116,1,2410,2328,82,0,1,0,6
36117,2,2413,2455,-42,0,250,1,6
36118,1,2433,2491,-58,0,195,1,6
36119,2,2536,2406,130,0,311,1,6
36120,1,2678,2555,123,0,300,1,6
36121,3,2431,2462,-31,0,143,0,6
36122,1,2419,2351,68,0,332,1,6
36123,3,2541,2636,-95,0,453,0,6
36124,3,2432,2351,81,0,157,0,6
36125,1,2417,2356,61,0,57,0,6
36126,3,2577,2514,63,0,4,0,6
36127,2,2436,2498,-62,0,360,1,6
36128,1,2324,2414,-90,0,0,0,6
36129,1,2601,2333,268,0,0,0,6
36130,1,2361,2456,-95,0,111,0,6
36131,1,2484,2555,-71,0,312,0,6
36132,1,2413,2563,-150,0,341,0,6
36133,3,2407,2419,-12,0,151,0,6
36134,2,2431,2399,32,0,426,0,6
36135,1,2402,2298,104,0,6,0,6
36136,2,2419,2366,53,0,40,0,6
36137,2,2524,2474,50,0,189,1,6
36138,2,2561,2586,-25,0,114,0,6
36139,2,2427,2422,5,0,219,0,6
36140,1,2468,2233,235,4,128,0,13
36141,2,2407,2331,76,0,1,0,6
36142,1,2453,2404,49,0,1,1,6
36143,1,2393,2418,-25,0,133,0,6
36144,1,2347,2413,-66,0,215,1,6
36145,2,2318,2421,-103,0,440,0,6
36146,1,2432,2543,-111,0,246,0,6
36147,2,2634,2778,-144,0,200,0,6
36148,2,2485,2439,46,0,102,0,6
36149,2,2408,2520,-112,0,241,1,6
36150,2,2552,2682,-130,0,102,1,6
36151,1,2338,2400,-62,0,80,0,6
36152,3,2432,2445,-13,0,253,0,6
36153,3,2352,2430,-78,0,283,0,6
36154,1,2461,2413,48,0,304,0,6
36155,1,2287,2457,-170,0,40,0,6
36156,1,2472,2358,114,0,331,0,6
36157,2,2462,2603,-141,0,241,1,6
36158,2,2284,2404,-120,0,45,1,6
36159,2,2486,2454,32,0,112,1,6
36160,2,2291,2460,-169,0,244,1,6
36161,3,2290,2448,-158,0,306,0,6
36162,2,2310,2455,-145,0,211,0,6
36163,1,2449,2369,80,0,331,0,6
36164,1,2406,2425,-19,0,331,0,6
36165,2,2503,2431,72,0,112,0,6
36166,1,2384,2555,-171,0,250,1,6
36167,2,2373,2412,-39,0,1,0,6
36168,1,2548,2389,159,0,335,0,6
36169,2,2591,2556,35,0,386,1,6
36170,2,2480,2517,-37,0,122,0,6
36171,2,2403,2335,68,0,1,0,6
36172,2,2403,2421,-18,0,333,0,6
36173,1,2411,2399,12,0,121,1,6
36174,1,2298,2417,-119,0,40,1,6
36175,2,2319,2401,-82,0,211,1,6
36176,3,2782,2631,151,0,373,0,6
36177,2,2399,2458,-59,0,140,0,6
36178,1,2515,2576,-61,0,10,0,6
36179,1,2412,2404,8,0,315,1,6
36180,2,2446,2524,-78,0,241,1,6
36181,1,2536,2627,-91,0,308,0,6
36182,1,2401,2282,119,0,337,0,6
36183,1,2418,2368,50,0,40,0,6
36184,2,2364,2453,-89,0,337,0,6
36186,1,2466,2480,-14,0,40,1,6
36187,1,2408,2275,133,0,170,0,6
36188,2,2419,2412,7,0,121,0,6
36189,2,2464,2440,24,0,331,0,6
36190,1,2440,2260,180,0,35,0,6
36191,2,2552,2458,94,0,433,0,6
36192,2,2363,2423,-60,0,1,0,6
36193,2,2259,2428,-169,0,373,0,6
36194,1,2597,2252,345,0,101,0,6
36195,2,2242,2402,-160,0,210,0,6
36196,1,2438,2378,60,0,340,0,6
36197,1,2496,2427,69,0,103,0,6
36198,2,2633,2780,-147,0,200,0,6
36199,3,2523,2475,48,0,145,0,6
36200,1,2562,2585,-23,0,215,0,6
36201,2,2547,2389,158,0,331,0,6
36202,1,2418,2413,5,0,331,0,6
36204,1,2409,2391,18,0,0,0,6
36205,2,2539,2630,-91,0,380,0,6
36206,1,2398,2443,-45,0,250,0,6
36207,1,2251,2407,-156,0,463,0,6
36208,2,2422,2500,-78,0,330,0,6
36209,1,2457,2360,97,0,317,1,6
36210,1,2446,2543,-97,0,248,0,6
36211,1,2425,2278,147,0,473,0,6
36212,1,2397,2424,-27,0,300,0,6
36213,1,2327,2458,-131,0,1,0,6
36214,1,2374,2438,-64,0,45,0,6
36215,1,2405,2358,47,0,106,0,6
36216,2,2407,2423,-16,0,0,0,6
36217,1,2606,2465,141,0,124,1,6
36218,2,2409,2450,-41,0,7,1,6
36219,3,2431,2544,-113,0,466,0,6
36220,1,2429,2402,27,0,41,1,6
36221,1,2406,2297,109,0,6,0,6
36222,2,2279,2415,-136,0,100,1,6
36223,1,2585,2215,370,4,106,0,13
36224,2,2389,2598,-209,0,335,1,6
36225,1,2570,2374,196,0,8,0,6
36226,2,2634,2453,181,0,245,0,6
36227,2,2476,2522,-46,0,140,0,6
36228,2,2459,2296,163,0,21,1,6
36229,1,2419,2283,136,0,1,0,6
36230,1,2345,2474,-129,0,302,0,6
36231,2,2417,2394,23,0,487,0,6
36232,2,2536,2505,31,0,403,0,6
36233,2,2443,2350,93,0,157,0,6
36234,2,2436,2404,32,0,40,0,6
36235,2,2463,2418,45,0,9,0,6
36236,2,2418,2405,13,0,313,0,6
36237,1,2527,2471,56,0,145,0,6
36238,1,2267,2410,-143,0,45,0,6
36239,1,2356,2428,-72,0,446,0,6
36240,2,2466,2462,4,0,15,1,6
36241,2,2397,2434,-37,0,0,1,6
36242,2,2511,2447,64,0,100,0,6
36243,1,2353,2543,-190,0,1,0,6
36244,2,2201,2592,-391,4,335,0,13
36245,1,2528,2352,176,0,160,0,6
36246,2,2366,2412,-46,0,12,1,6
36247,1,2418,2430,-12,0,0,0,6
36248,1,2410,2411,-1,0,45,0,6
36249,1,2455,2462,-7,0,106,0,6
36250,1,2402,2275,127,0,211,1,6
36251,2,2400,2411,-11,0,0,1,6
36252,1,2405,2284,121,0,200,0,6
36253,2,2371,2573,-202,0,249,0,6
36254,2,2367,2532,-165,0,487,0,6
36255,2,2229,2448,-219,0,123,0,6
36256,1,2466,2532,-66,0,120,0,6
36257,2,2456,2461,-5,0,201,0,6
36258,1,2461,2283,178,0,13,0,6
36259,1,2468,2534,-66,0,118,0,6
36260,3,2422,2363,59,0,331,0,6
36261,1,2440,2391,49,0,41,0,6
36262,2,2259,2436,-177,0,228,0,6
36263,2,2272,2406,-134,0,41,1,6
36264,1,2603,2417,186,0,310,0,6
36265,1,2416,2424,-8,0,40,0,6
36266,2,2405,2490,-85,0,122,0,6
36267,1,2424,2362,62,0,40,0,6
36268,2,2361,2437,-76,0,30,0,6
36269,2,2417,2310,107,0,40,0,6
36270,2,2416,2395,21,0,461,0,6
36271,1,2535,2364,171,0,405,0,6
36272,1,2525,2473,52,0,177,0,6
36273,2,2451,2477,-26,0,260,0,6
36274,2,2291,2461,-170,4,80,1,8
36275,2,2364,2445,-81,0,300,0,6
36276,2,2387,2445,-58,0,426,1,6
36277,1,2441,2450,-9,0,210,0,6
36278,2,2520,2559,-39,0,210,0,6
36279,1,2527,2475,52,0,440,1,6
36281,2,2369,2410,-41,0,301,0,6
36282,1,2357,2429,-72,0,1,1,6
36283,1,2468,2530,-62,0,138,0,6
36284,1,2419,2422,-3,0,0,0,6
36285,1,2495,2388,107,0,317,1,6
36287,1,2449,2356,93,0,448,0,6
36288,1,2558,2232,326,0,200,1,6
36289,3,2322,2456,-134,0,207,0,6
36290,1,2401,2410,-9,0,115,0,6
36291,1,2363,2464,-101,0,400,1,6
36292,3,2335,2421,-86,0,1,0,6
36293,1,2620,2538,82,0,45,1,6
36294,2,2454,2447,7,0,45,0,6
36295,2,2384,2424,-40,0,100,0,6
36296,1,2523,2475,48,0,201,0,6
36297,1,2340,2401,-61,0,269,1,6
36298,1,2421,2267,154,0,57,0,6
36299,2,2449,2416,33,0,331,0,6
36300,1,2445,2451,-6,0,42,0,6
36301,2,2287,2413,-126,0,40,0,6
36302,1,2451,2362,89,0,10,0,6
36303,1,2457,2537,-80,4,246,1,13
36304,2,2415,2312,103,0,84,0,6
36305,1,2457,2360,97,0,48,0,6
36306,1,2470,2565,-95,0,101,0,6
36307,1,2532,2380,152,0,341,0,6
36308,2,2293,2405,-112,0,14,0,6
36309,2,2279,2445,-166,0,123,1,6
36310,1,2603,2417,186,0,65,0,6
36311,2,2410,2386,24,0,48,0,6
36312,1,2422,2443,-21,0,45,0,6
36313,3,2454,2422,32,0,112,0,6
36314,1,2345,2440,-95,0,3,1,6
36315,1,2364,2560,-196,0,1,0,6
36316,1,2404,2407,-3,0,125,0,6
36317,1,2430,2251,179,0,0,0,6
36318,1,2355,2431,-76,0,106,1,6
36319,1,2424,2279,145,0,474,0,6
36320,2,2470,2528,-58,0,202,0,6
36321,2,2536,2453,83,0,56,0,6
36322,1,2451,2457,-6,0,246,0,6
36323,2,2437,2428,9,0,331,0,6
36324,3,2448,2415,33,0,29,0,6
36325,2,2316,2482,-166,0,43,0,5
36326,1,2477,2519,-42,0,206,0,6
36327,2,2558,2609,-51,0,100,0,6
36328,2,2453,2606,-153,0,106,1,6
36329,2,2423,2419,4,0,461,1,6
36330,3,2434,2431,3,0,45,0,6
36331,1,2439,2307,132,0,35,0,6
36332,2,2453,2405,48,0,132,0,6
36333,1,2342,2421,-79,0,300,0,6
36334,2,2533,2466,67,0,145,1,6
36335,1,2433,2352,81,0,85,1,6
36336,2,2339,2478,-139,0,380,0,6
36337,1,2427,2322,105,0,218,0,6
36338,1,2401,2410,-9,0,115,0,6
36339,2,2248,2433,-185,0,100,1,6
36340,1,2381,2529,-148,0,483,0,6
36341,2,2461,2553,-92,0,107,0,6
36342,2,2403,2373,30,0,40,0,6
36343,2,2407,2271,136,0,4,0,6
36344,1,2464,2254,210,4,394,0,13
36345,1,2451,2434,17,0,17,1,6
36346,2,2457,2553,-96,0,101,0,6
36347,3,2275,2428,-153,0,43,0,6
36348,1,2323,2407,-84,0,105,0,6
36349,1,2451,2323,128,0,4,0,6
36350,2,2585,2421,164,0,394,1,6
36351,2,2414,2329,85,0,100,0,6
36352,1,2407,2219,188,0,214,0,6
36353,2,2431,2434,-3,0,331,0,6
36354,2,2416,2362,54,0,45,0,6
36355,3,2596,2534,62,0,337,0,6
36356,2,2447,2362,85,0,164,0,6
36357,1,2417,2459,-42,0,357,0,6
36358,2,2424,2388,36,0,300,1,6
36359,3,2472,2526,-54,0,140,0,6
36360,1,2557,2456,101,0,100,0,6
36361,1,2401,2354,47,0,101,0,6
36362,1,2467,2315,152,0,152,0,6
36363,2,2348,2438,-90,0,3,0,6
36364,1,2482,2336,146,0,45,1,6
36365,1,2512,2414,98,0,123,0,6
36366,1,2436,2245,191,0,0,1,6
36367,1,2509,2379,130,0,106,0,6
36368,1,2409,2396,13,0,381,1,6
36369,1,2403,2407,-4,0,18,0,6
36370,1,2557,2453,104,0,257,1,6
36371,2,2456,2449,7,0,10,0,6
36372,1,2429,2305,124,0,14,0,6
36373,2,2452,2561,-109,0,106,0,6
36374,2,2376,2513,-137,0,1,0,6
36375,1,2440,2426,14,0,45,0,6
36376,2,2376,2416,-40,0,113,0,6
36377,2,2482,2455,27,0,143,1,6
36378,1,2553,2642,-89,0,302,0,6
36379,1,2430,2423,7,0,345,1,6
36380,1,2452,2394,58,0,380,0,6
36381,1,2565,2448,117,0,56,1,6
36382,2,2382,2426,-44,0,178,0,6
36383,2,2369,2405,-36,0,132,1,6
36384,3,2440,2431,9,0,48,0,6
36385,3,2410,2517,-107,0,216,0,6
36386,1,2409,2312,97,0,484,0,6
36387,1,2525,2473,52,0,145,0,6
36388,1,2442,2343,99,0,80,1,6
36389,1,2401,2240,161,0,241,0,6
36390,3,2298,2410,-112,0,88,0,6
36391,1,2457,2349,108,0,344,0,6
36392,3,2280,2465,-185,4,41,0,13
36393,2,2410,2343,67,0,84,1,6
36394,1,2431,2377,54,0,190,0,6
36395,2,2474,2535,-61,0,188,0,6
36396,1,2243,2439,-196,0,100,1,6
36397,2,2372,2517,-145,0,1,0,6
36398,3,2468,2530,-62,0,140,0,6
36399,2,2420,2446,-26,0,331,0,6
36400,1,2422,2269,153,0,242,0,6
36401,1,2455,2451,4,0,277,1,6
36402,2,2433,2426,7,0,107,1,6
36403,1,2449,2561,-112,0,100,1,6
36404,1,2421,2350,71,0,200,0,6
36405,2,2388,2418,-30,0,45,0,6
36406,2,2515,2411,104,0,115,0,6
36407,1,2394,2436,-42,0,406,0,6
36408,2,2418,2560,-142,0,426,0,6
36409,3,2236,2410,-174,4,211,0,13
36410,2,2444,2569,-125,0,106,0,6
36411,2,2426,2415,11,0,338,0,6
36412,1,2413,2294,119,0,300,0,6
36413,2,2404,2347,57,0,58,0,6
36414,1,2400,2288,112,0,147,0,6
36415,1,2520,2413,107,0,145,0,6
36416,1,2339,2446,-107,0,245,1,6
36417,2,2369,2469,-100,0,1,0,6
36419,1,2423,2430,-7,0,40,0,6
36420,1,2383,2528,-145,0,211,0,6
36421,2,2465,2534,-69,0,140,0,6
36422,1,2311,2461,-150,0,200,1,6
36423,2,2345,2426,-81,0,315,0,6
36424,1,2471,2414,57,0,114,0,6
36425,3,2431,2318,113,0,218,0,6
36426,2,2432,2564,-132,0,301,0,6
36427,2,2445,2427,18,0,17,0,6
36428,1,2454,2519,-65,0,1,0,6
36429,2,2421,2420,1,0,382,0,6
36430,2,2573,2441,132,0,45,0,6
36431,2,2401,2400,1,0,484,0,6
36432,1,2462,2219,243,4,108,0,0
36433,2,2395,2417,-22,0,216,1,6
36434,2,2430,2341,89,0,102,1,6
36435,1,2461,2456,5,0,28,0,6
36436,1,2408,2247,161,4,150,0,13
36437,1,2439,2347,92,0,82,0,6
36438,1,2419,2524,-105,0,106,0,6
36439,2,2567,2369,198,0,48,0,6
36440,1,2478,2365,113,0,40,1,6
36442,1,2473,2311,162,0,138,0,6
36443,1,2432,2288,144,0,258,1,6
36444,1,2424,2429,-5,0,0,1,6
36445,2,2426,2415,11,0,196,1,6
36446,1,2410,2405,5,0,80,1,6
36447,3,2395,2476,-81,0,236,0,6
36448,2,2462,2232,230,4,106,0,13
36449,2,2342,2443,-101,0,127,0,6
36450,1,2359,2402,-43,0,338,0,6
36451,1,2554,2454,100,0,251,0,6
36452,1,2320,2430,-110,0,459,1,6
36453,2,2464,2317,147,0,311,0,6
36454,2,2390,2422,-32,0,201,0,6
36455,2,2451,2467,-16,0,141,0,6
36456,1,2343,2520,-177,0,131,1,6
36457,2,2423,2406,17,0,133,0,6
36458,2,2404,2405,-1,0,404,0,6
36459,1,2284,2435,-151,0,380,1,6
36460,1,2543,2461,82,0,190,1,6
36461,1,2424,2430,-6,0,40,1,6
36462,1,2678,2534,144,0,280,0,6
36463,3,2415,2429,-14,0,107,0,6
36464,2,2427,2386,41,0,418,0,6
36465,1,2421,2399,22,0,414,0,6
36466,1,2475,2445,30,0,260,0,6
36467,3,2406,2338,68,0,100,0,6
36468,1,2447,2338,109,0,45,1,6
36469,1,2565,2395,170,0,338,1,6
36470,2,2450,2558,-108,0,101,1,6
36471,1,2427,2512,-85,0,487,0,6
36472,3,2475,2461,14,0,57,0,6
36473,1,2526,2377,149,0,481,0,6
36474,2,2424,2429,-5,0,0,1,6
36475,3,2375,2423,-48,0,88,0,6
36476,2,2427,2293,134,0,252,0,6
36477,2,2435,2394,41,0,56,1,6
36478,1,2361,2404,-43,0,1,0,6
36479,1,2505,2539,-34,0,152,0,6
36480,1,2457,2547,-90,0,277,0,6
36481,1,2456,2391,65,0,57,0,6
36482,1,2411,2255,156,4,192,1,13
36483,1,2422,2327,95,0,218,0,6
36484,3,2429,2421,8,0,80,0,6
36485,1,2334,2451,-117,0,127,0,6
36486,2,2234,2401,-167,0,331,0,6
36487,1,2512,2351,161,0,308,0,6
36488,2,2477,2529,-52,0,211,0,6
36489,2,2480,2314,166,0,213,1,6
36490,1,2393,2427,-34,0,151,0,6
36491,1,2559,2437,122,0,4,0,6
36492,2,2440,2581,-141,0,241,0,6
36493,2,2383,2554,-171,0,140,0,6
36494,1,2562,2446,116,0,251,1,6
36495,1,2404,2230,174,0,50,0,6
36496,2,2337,2475,-138,0,36,0,6
36497,1,2529,2367,162,0,40,0,6
36498,1,2422,2376,46,0,153,0,6
36499,1,2419,2357,62,0,0,0,6
36500,2,2473,2473,0,0,28,0,6
36501,1,2461,2312,149,0,40,0,6
36502,2,2408,2428,-20,0,345,0,6
36503,1,2420,2400,20,0,414,0,6
36504,3,2464,2512,-48,0,267,0,6
36505,1,2585,2428,157,0,41,0,6
36506,1,2444,2342,102,0,4,0,6
36508,2,2377,2480,-103,0,101,1,6
36509,1,2468,2321,147,0,123,0,6
36510,1,2442,2566,-124,0,101,1,6
36511,2,2371,2430,-59,0,88,0,6
36512,2,2394,2426,-32,0,110,0,6
36513,2,2267,2507,-240,0,332,1,6
36514,2,2308,2596,-288,0,153,0,7
36515,1,2438,2272,166,0,201,1,7
36516,1,2424,2425,-1,0,0,0,6
36517,1,2478,2588,-110,0,241,0,6
36518,1,2431,2389,42,0,58,1,6
36519,1,2434,2305,129,0,335,0,6
36520,2,2395,2402,-7,0,122,1,6
36521,3,2419,2465,-46,0,45,0,6
36522,2,2322,2429,-107,0,10,0,6
36523,2,2338,2448,-110,0,127,0,6
36524,3,2401,2340,61,0,102,0,6
36525,2,2275,2414,-139,4,202,0,13
36526,2,2234,2405,-171,0,388,1,6
36527,2,2246,2474,-228,0,210,0,6
36528,1,2511,2337,174,0,241,0,6
36529,2,2465,2478,-13,0,106,1,6
36530,1,2490,2400,90,0,302,0,6
36531,1,2420,2406,14,0,114,0,6
36532,1,2438,2366,72,0,121,0,6
36533,1,2527,2244,283,4,41,1,13
36534,1,2433,2373,60,0,0,1,6
36535,2,2581,2707,-126,0,469,0,6
36536,1,2400,2364,36,0,106,0,6
36537,3,2558,2486,72,0,252,0,6
36538,2,2392,2437,-45,0,313,1,6
36539,2,2392,2532,-140,0,190,0,6
36540,1,2334,2408,-74,0,2,0,6
36541,1,2438,2240,198,0,49,0,6
36542,1,2514,2390,124,0,212,0,6
36543,1,2436,2294,142,0,492,0,6
36544,2,2396,2495,-99,0,150,0,6
36545,2,2359,2405,-46,0,1,0,6
36546,2,2421,2475,-54,0,308,0,6
36547,1,2569,2426,143,0,241,0,6
36548,2,2454,2370,84,0,6,1,6
36549,2,2450,2536,-86,0,125,1,6
36550,2,2310,2438,-128,0,40,0,6
36551,2,2353,2402,-49,0,196,0,6
36552,2,2292,2404,-112,0,106,0,6
36553,2,2516,2392,124,0,102,0,6
36554,2,2401,2440,-39,0,120,0,6
36555,2,2459,2557,-98,0,101,1,6
36556,1,2449,2281,168,0,300,0,6
36557,1,2711,2482,229,0,341,0,6
36558,2,2367,2418,-51,0,190,0,6
36559,3,2379,2442,-63,0,302,0,7
36560,1,2598,2299,299,0,15,0,7
36561,2,2386,2518,-132,0,229,0,6
36562,1,2356,2410,-54,0,46,1,6
36563,2,2401,2341,60,0,80,0,6
36564,1,2445,2364,81,0,101,1,6
36565,2,2300,2439,-139,0,331,1,6
36566,3,2418,2261,157,4,117,0,13
36567,1,2499,2392,107,0,263,0,6
36568,1,2442,2320,122,0,0,1,6
36569,2,2573,2415,158,0,45,1,6
36570,3,2422,2416,6,0,201,0,6
36571,3,2337,2403,-66,0,280,0,6
36572,1,2408,2315,93,0,43,0,6
36573,1,2305,2446,-141,0,200,1,6
36574,1,2479,2521,-42,0,469,0,6
36575,2,2480,2713,-233,0,270,0,6
36576,1,2407,2445,-38,0,118,0,6
36577,1,2446,2561,-115,0,101,0,6
36578,1,2452,2533,-81,0,45,0,6
36579,3,2404,2270,134,0,102,0,6
36580,2,2247,2403,-156,0,360,1,6
36581,1,2519,2486,33,0,112,0,6
36582,1,2413,2396,17,0,106,0,6
36583,3,2452,2455,-3,0,121,0,6
36584,1,2388,2503,-115,0,426,1,6
36585,2,2443,2387,56,0,11,0,6
36586,1,2424,2459,-35,0,404,0,6
36587,2,2481,2647,-166,0,300,1,6
36588,2,2524,2446,78,0,100,1,6
36589,3,2423,2441,-18,0,123,0,6
36590,1,2416,2296,120,0,466,1,6
36591,1,2439,2413,26,0,60,0,6
36592,1,2400,2480,-80,0,40,0,6
36593,2,2357,2456,-99,0,123,0,6
36594,1,2715,2562,153,0,337,0,6
36595,1,2408,2351,57,0,2,0,6
36596,1,2569,2408,161,0,343,0,6
36597,2,2402,2280,122,0,4,0,6
36598,1,2280,2418,-138,0,106,1,6
36599,1,2436,2287,149,0,15,1,6
36600,2,2559,2719,-160,0,4,0,6
36601,1,2441,2600,-159,0,123,0,7
36602,2,2394,2452,-58,0,151,0,6
36603,1,2408,2444,-36,0,122,0,6
36604,1,2572,2455,117,0,50,0,6
36605,1,2408,2244,164,0,67,0,6
36606,1,2453,2461,-8,0,300,0,6
36607,1,2453,2517,-64,0,0,0,6
36608,2,2420,2430,-10,0,53,1,6
36609,2,2429,2292,137,0,484,0,6
36610,1,2651,2478,173,0,130,0,6
36611,2,2464,2350,114,0,334,0,6
36612,2,2459,2389,70,0,100,1,6
36613,2,2532,2232,300,0,130,1,6
36614,1,2438,2415,23,0,60,0,6
36615,1,2410,2274,136,0,302,1,6
36616,3,2315,2505,-190,0,140,0,6
36617,3,2310,2485,-175,0,110,0,6
36618,1,2476,2275,201,0,43,0,6
36619,3,2505,2414,91,0,101,0,6
36620,1,2398,2443,-45,0,106,0,6
36621,1,2368,2531,-163,0,7,0,6
36622,1,2362,2485,-123,0,245,0,6
36623,1,2722,2556,166,0,125,0,6
36624,2,2337,2439,-102,0,301,0,6
36625,1,2424,2288,136,0,135,0,6
36626,2,2425,2404,21,0,103,1,6
36627,2,2553,2725,-172,0,45,0,6
36628,1,2443,2421,22,0,41,0,6
36629,2,2460,2370,90,0,0,1,6
36630,1,2237,2414,-177,0,203,0,6
36631,1,2421,2393,28,0,405,1,6
36632,2,2477,2729,-252,0,106,1,6
36633,1,2444,2333,111,0,21,0,6
36634,2,2396,2450,-54,0,100,1,6
36635,2,2436,2654,-218,0,40,0,6
36636,2,2429,2279,150,0,394,1,6
36637,2,2422,2495,-73,0,122,0,6
36638,2,2414,2312,102,0,43,1,6
36639,1,2520,2459,61,0,132,0,6
36640,2,2405,2436,-31,0,40,0,6
36641,2,2380,2400,-20,0,20,1,6
36642,2,2339,2467,-128,0,46,1,6
36643,3,2410,2419,-9,0,337,0,6
36644,2,2283,2427,-144,0,199,1,6
36645,2,2660,2612,48,0,15,0,6
36646,3,2503,2313,190,0,157,0,6
36647,1,2449,2302,147,0,335,0,6
36648,1,2464,2453,11,0,100,1,6
36649,1,2282,2406,-124,0,101,1,6
36650,1,2329,2448,-119,0,233,0,6
36651,2,2381,2427,-46,0,45,0,6
36652,1,2381,2426,-45,0,131,0,6
36653,3,2500,2418,82,0,389,0,6
36654,1,2592,2269,323,0,113,0,7
36655,2,2236,2449,-213,0,210,0,7
36656,2,2353,2407,-54,0,127,0,6
36657,2,2219,2400,-181,0,306,0,6
36658,2,2354,2457,-103,0,1,1,6
36659,2,2432,2376,56,0,338,0,6
36660,1,2502,2234,268,0,281,0,6
36661,1,2485,2294,191,0,101,0,6
36662,2,2418,2411,7,0,103,0,6
36663,1,2731,2475,256,0,341,1,6
36664,1,2298,2452,-154,0,190,0,6
36665,1,2386,2421,-35,0,300,1,6
36666,2,2406,2374,32,0,453,0,6
36667,2,2449,2653,-204,0,40,1,6
36668,1,2372,2431,-59,0,75,0,6
36669,2,2447,2433,14,0,0,1,6
36670,1,2344,2471,-127,0,3,1,6
36671,2,2330,2425,-95,0,268,1,6
36672,1,2411,2453,-42,0,302,0,6
36673,1,2419,2499,-80,0,15,0,6
36674,1,2444,2307,137,0,335,0,6
36675,2,2462,2350,112,0,106,0,6
36676,2,2473,2526,-53,0,435,0,6
36677,2,2619,2733,-114,0,40,0,6
36678,2,2416,2420,-4,0,307,0,6
36679,2,2470,2396,74,0,345,0,6
36680,2,2269,2504,-235,0,0,0,6
36681,1,2517,2230,287,4,106,1,13
36682,2,2381,2400,-19,0,20,0,6
36683,2,2427,2448,-21,0,312,0,6
36684,1,2524,2225,299,0,302,0,6
36685,2,2404,2542,-138,0,418,1,6
36686,3,2656,2576,80,0,107,0,6
36687,1,2444,2311,133,0,113,0,6
36688,1,2490,2364,126,0,15,0,6
36689,1,2656,2446,210,0,45,0,6
36690,2,2378,2452,-74,0,88,0,6
36691,1,2510,2387,123,0,113,0,6
36692,1,2463,2352,111,0,85,0,6
36693,1,2737,2615,122,0,455,0,6
36694,2,2352,2441,-89,0,100,1,6
36695,2,2463,2470,-7,0,405,0,6
36696,1,2263,2429,-166,0,46,0,6
36697,3,2224,2526,-302,0,404,0,6
36698,2,2504,2577,-73,0,107,0,6
36699,2,2362,2418,-56,0,1,0,6
36700,1,2425,2411,14,0,102,0,6
36701,2,2353,2400,-47,0,128,1,6
36702,1,2447,2422,25,0,200,0,6
36703,2,2403,2492,-89,0,194,0,6
36704,1,2303,2448,-145,0,119,0,6
36705,1,2458,2439,19,0,111,1,6
36706,1,2403,2302,101,0,40,0,6
36707,1,2348,2467,-119,0,140,1,6
36708,1,2455,2363,92,0,125,1,8
36709,1,2417,2327,90,0,302,0,6
36710,2,2384,2514,-130,0,288,1,6
36711,2,2405,2375,30,0,453,0,6
36712,2,2440,2423,17,0,106,0,6
36713,1,2358,2401,-43,0,1,1,6
36714,1,2310,2502,-192,0,110,0,6
36715,2,2269,2407,-138,0,101,0,6
36716,1,2582,2659,-77,0,41,0,6
36717,2,2276,2594,-318,0,404,1,7
36718,1,2212,2415,-203,0,310,1,6
36719,1,2611,2741,-130,0,104,0,6
36720,2,2416,2452,-36,0,398,0,6
36721,3,2426,2463,-37,0,302,0,6
36722,1,2446,2348,98,0,8,1,6
36723,2,2310,2457,-147,0,8,0,6
36724,1,2546,2499,47,0,263,0,6
36725,1,2207,2448,-241,0,106,1,6
36726,1,2440,2311,129,0,335,0,6
36727,1,2421,2405,16,0,47,0,6
36728,2,2410,2302,108,0,45,0,6
36729,1,2414,2402,12,0,107,1,6
36730,1,2384,2401,-17,0,312,0,6
36731,1,2421,2446,-25,0,101,0,6
36732,2,2539,2540,-1,0,46,0,6
36733,1,2424,2502,-78,0,192,0,6
36734,2,2359,2422,-63,0,440,0,6
36735,2,2454,2635,-181,0,415,1,6
36736,2,2437,2419,18,0,300,1,6
36737,2,2307,2444,-137,0,190,0,6
36738,2,2315,2434,-119,0,332,1,6
36739,2,2406,2308,98,0,42,0,6
36740,1,2451,2436,15,0,45,1,6
36741,3,2369,2543,-174,0,37,0,6
36742,2,2336,2428,-92,0,221,1,6
36743,2,2308,2469,-161,0,45,1,6
36744,2,2459,2356,103,0,85,1,6
36745,1,2434,2402,32,0,311,1,6
36746,2,2451,2465,-14,0,80,0,6
36747,1,2417,2200,217,0,108,0,6
36748,1,2434,2411,23,0,468,0,6
36749,2,2275,2429,-154,0,106,0,6
36750,2,2239,2481,-242,0,250,0,6
36751,1,2496,2399,97,0,46,0,6
36752,1,2552,2458,94,0,45,1,6
36753,2,2476,2461,15,0,131,0,6
36754,2,2420,2248,172,0,148,0,6
36755,1,2400,2427,-27,0,406,0,6
36756,1,2495,2317,178,0,16,0,6
36757,1,2733,2619,114,0,112,0,6
36758,2,2443,2525,-82,0,301,1,6
36759,2,2406,2439,-33,0,394,0,6
36760,1,2289,2403,-114,0,101,0,6
36761,1,2232,2427,-195,0,8,1,6
36763,3,2439,2342,97,0,201,0,6
36764,2,2344,2450,-106,0,127,0,6
36765,3,2426,2652,-226,0,115,0,6
36766,1,2325,2427,-102,0,424,0,6
36767,3,2338,2404,-66,0,123,0,6
36768,2,2300,2408,-108,0,311,0,6
36769,1,2531,2416,115,0,474,0,6
36770,2,2324,2546,-222,0,171,0,6
36771,1,2447,2304,143,0,50,0,6
36772,2,2397,2444,-47,0,45,1,6
36773,1,2273,2485,-212,0,200,0,6
36774,1,2411,2200,211,0,264,0,6
36776,1,2363,2452,-89,0,140,1,6
36777,2,2395,2500,-105,0,194,0,6
36778,1,2393,2427,-34,0,131,1,6
36779,3,2438,2203,235,0,301,0,6
36780,2,2219,2432,-213,0,490,1,6
36781,1,2453,2557,-104,0,101,0,6
36782,1,2615,2737,-122,0,485,0,6
36783,1,2393,2467,-74,0,353,0,6
36784,2,2372,2540,-168,0,36,1,6
36785,1,2435,2470,-35,0,400,0,6
36786,2,2419,2314,105,0,135,0,6
36787,2,2334,2460,-126,0,100,0,8
36788,2,2454,2340,114,0,353,1,6
36789,2,2406,2440,-34,0,314,0,6
36790,2,2259,2441,-182,0,101,1,6
36791,2,2306,2424,-118,0,0,1,6
36792,2,2449,2396,53,0,312,0,6
36793,1,2304,2473,-169,0,250,0,6
36794,1,2601,2261,340,0,454,0,6
36795,2,2207,2414,-207,0,48,0,6
36796,2,2430,2589,-159,0,101,0,6
36797,2,2300,2451,-151,0,190,0,6
36798,2,2530,2470,60,0,176,1,6
36799,2,2399,2497,-98,0,150,0,6
36800,2,2476,2282,194,0,142,1,6
36801,2,2257,2410,-153,0,277,0,6
36802,1,2403,2392,11,0,45,1,6
36803,1,2246,2417,-171,0,150,0,6
36804,1,2315,2451,-136,0,129,0,6
36805,1,2549,2461,88,0,45,1,6
36806,2,2648,2463,185,0,45,0,6
36807,1,2445,2370,75,0,85,0,6
36808,2,2296,2413,-117,0,115,0,6
36809,2,2322,2538,-216,0,36,1,6
36810,2,2291,2492,-201,0,61,0,6
36811,2,2505,2391,114,0,344,1,6
36812,1,2427,2293,134,0,311,0,6
36814,2,2313,2414,-101,0,107,0,6
36815,1,2385,2420,-35,0,131,0,6
36816,1,2460,2439,21,0,405,0,6
36817,1,2361,2568,-207,0,302,0,6
36818,1,2400,2235,165,0,57,0,6
36819,1,2533,2358,175,0,84,0,6
36820,1,2458,2375,83,0,300,1,6
36821,2,2269,2603,-334,0,6,0,6
36822,2,2413,2291,122,0,121,1,6
36823,2,2369,2454,-85,0,1,0,6
36824,1,2483,2229,254,0,281,0,6
36825,2,2246,2559,-313,0,113,1,6
36826,2,2347,2446,-99,0,40,0,6
36827,1,2336,2443,-107,0,29,1,6
36828,2,2366,2450,-84,0,140,1,6
36829,1,2322,2401,-79,0,102,0,6
36830,2,2420,2376,44,0,40,0,6
36831,1,2436,2255,181,0,242,0,6
36832,3,2440,2357,83,0,131,0,6
36833,2,2537,2444,93,0,101,1,6
36834,1,2409,2249,160,0,101,0,6
36835,2,2472,2374,98,0,280,0,6
36836,2,2426,2640,-214,0,115,0,6
36837,1,2481,2244,237,0,102,0,6
36838,2,2316,2420,-104,0,45,0,6
36839,3,2313,2434,-121,0,241,0,6
36840,1,2325,2431,-106,0,483,0,6
36841,2,2333,2639,-306,0,2,1,6
36842,2,2207,2502,-295,0,45,0,6
36843,2,2210,2544,-334,0,123,0,6
36844,1,2466,2345,121,0,345,0,6
36845,2,2418,2309,109,0,202,0,6
36846,2,2418,2209,209,0,210,0,6
36847,2,2624,2728,-104,0,1,1,6
36848,2,2466,2313,153,0,246,0,6
36849,1,2361,2428,-67,0,4,1,6
36850,3,2497,2451,46,0,45,0,6
36851,1,2458,2319,139,0,125,0,6
36852,1,2434,2450,-16,0,46,1,6
36853,1,2459,2364,95,0,73,0,6
36854,1,2436,2424,12,0,192,0,6
36855,1,2464,2224,240,0,311,0,6
36856,1,2495,2356,139,0,190,0,6
36857,1,2451,2343,108,0,6,1,6
36858,2,2209,2407,-198,0,337,0,6
36859,2,2485,2253,232,0,0,0,5
36860,2,2400,2529,-129,0,108,0,6
36861,2,2420,2350,70,0,373,1,6
36862,1,2220,2418,-198,0,300,1,6
36863,1,2435,2326,109,0,466,1,6
36864,1,2475,2305,170,0,131,1,6
36865,1,2321,2456,-135,0,0,0,6
36866,1,2286,2469,-183,0,200,0,6
36867,2,2496,2452,44,0,463,1,6
36868,2,2414,2392,22,0,112,0,6
36869,1,2454,2362,92,0,436,0,6
36870,1,2562,2335,227,0,0,1,6
36871,2,2419,2393,26,0,310,1,6
36872,2,2442,2249,193,0,250,0,6
36873,1,2432,2234,198,0,40,1,6
36874,1,2360,2463,-103,0,1,0,6
36875,2,2605,2396,209,0,219,1,6
36876,2,2677,2643,34,0,41,0,6
36877,2,2218,2546,-328,0,42,0,6
36878,1,2412,2465,-53,0,46,1,6
36879,2,2447,2397,50,0,190,0,6
36880,2,2265,2453,-188,0,121,1,6
36881,2,2480,2469,11,0,125,1,6
36882,1,2533,2252,281,0,226,0,6
36883,1,2503,2258,245,0,106,0,6
36885,1,2424,2461,-37,0,1,0,6
36886,1,2425,2206,219,0,301,0,6
36887,1,2285,2409,-124,0,178,0,6
36888,2,2418,2316,102,0,490,0,6
36889,2,2457,2299,158,0,301,1,6
36890,3,2307,2419,-112,0,311,0,6
36891,1,2732,2620,112,0,116,0,6
36892,1,2327,2439,-112,0,43,0,6
36893,1,2456,2368,88,0,40,0,6
36894,1,2260,2441,-181,0,228,0,6
36895,1,2444,2393,51,0,7,0,6
36896,3,2377,2527,-150,0,4,0,6
36897,2,2432,2440,-8,0,312,0,6
36898,2,2318,2444,-126,0,50,0,6
36899,1,2261,2430,-169,0,135,0,6
36900,2,2371,2681,-310,0,0,0,6
36901,1,2542,2213,329,0,46,1,6
36902,1,2255,2456,-201,0,5,0,6
36903,2,2506,2535,-29,0,205,0,6
36904,2,2339,2455,-116,0,100,1,6
36905,1,2444,2368,76,0,46,0,6
36906,1,2231,2414,-183,0,123,1,6
36907,1,2445,2426,19,0,406,0,6
36908,1,2357,2458,-101,0,110,1,6
36909,2,2286,2413,-127,0,1,0,6
36910,1,2501,2222,279,0,312,0,6
36911,1,2363,2460,-97,0,1,0,6
36912,2,2448,2307,141,0,117,0,6
36913,2,2458,2490,-32,0,45,1,6
36914,1,2433,2246,187,0,112,0,6
36916,1,2402,2293,109,0,153,0,6
36917,1,2565,2356,209,0,30,0,6
36918,1,2548,2213,335,0,4,1,6
36919,2,2542,2670,-128,0,0,0,6
36920,2,2256,2408,-152,0,151,1,6
36921,2,2302,2642,-340,0,45,1,6
36922,1,2499,2326,173,0,163,0,6
36923,2,2237,2433,-196,0,130,1,6
36924,1,2683,2369,314,0,409,0,6
36925,2,2256,2435,-179,0,131,0,6
36926,2,2240,2410,-170,0,273,0,6
36927,3,2616,2736,-120,0,43,0,6
36928,2,2349,2406,-57,0,192,0,6
36929,1,2256,2440,-184,0,101,0,6
36930,1,2655,2458,197,0,418,0,6
36931,2,2323,2449,-126,0,463,0,6
36932,2,2411,2205,206,0,135,0,6
36933,2,2232,2526,-294,0,108,1,6
36934,1,2541,2416,125,0,453,0,6
36935,2,2212,2501,-289,0,46,0,6
36936,1,2459,2335,124,0,13,1,6
36937,2,2200,2457,-257,0,100,1,6
36938,1,2436,2273,163,0,133,0,6
36939,2,2421,2451,-30,0,312,1,6
36940,3,2409,2453,-44,0,46,0,6
36941,1,2526,2216,310,0,45,0,6
36942,2,2370,2406,-36,0,4,0,6
36943,3,2258,2401,-143,0,258,0,6
36944,2,2349,2408,-59,0,311,0,6
36945,1,2331,2449,-118,0,26,0,6
36946,2,2329,2502,-173,0,344,1,6
36947,1,2498,2398,100,0,110,0,6
36948,2,2413,2317,96,0,57,0,6
36949,2,2431,2544,-113,0,145,0,6
36950,3,2220,2476,-256,0,453,0,6
36951,1,2244,2503,-259,0,455,0,6
36952,2,2285,2476,-191,0,7,0,5
36953,2,2473,2434,39,0,177,1,6
36954,2,2437,2344,93,0,45,1,6
36955,2,2495,2453,42,0,463,0,6
36956,1,2592,2539,53,0,4,0,6
36957,1,2410,2329,81,0,101,0,6
36958,1,2474,2387,87,0,302,0,6
36959,1,2300,2449,-149,0,45,1,6
36960,2,2438,2358,80,0,144,0,6
36961,1,2414,2316,98,0,227,0,6
36962,2,2456,2658,-202,0,130,0,6
36963,2,2453,2365,88,0,4,1,6
36964,3,2734,2618,116,0,53,0,6
36965,1,2395,2545,-150,0,150,0,6
36966,1,2430,2311,119,0,300,1,6
36967,2,2367,2684,-317,0,0,1,6
36968,1,2375,2528,-153,0,4,0,6
36969,2,2396,2597,-201,0,124,0,6
36970,1,2436,2405,31,0,202,0,6
36971,1,2412,2265,147,0,1,0,6
36972,1,2325,2414,-89,0,48,0,6
36973,1,2411,2310,101,0,250,0,6
36974,2,2412,2287,125,0,4,0,6
36975,1,2456,2479,-23,0,311,1,6
36976,2,2262,2427,-165,0,38,0,6
36977,1,2506,2548,-42,0,162,0,6
36978,1,2332,2463,-131,0,100,0,6
36979,3,2569,2418,151,0,300,0,6
36980,2,2248,2412,-164,0,190,1,6
36981,2,2394,2504,-110,0,242,0,6
36982,2,2383,2441,-58,0,106,0,6
36983,1,2452,2632,-180,0,310,0,6
36984,1,2263,2400,-137,0,376,0,6
36985,2,2255,2473,-218,0,264,0,6
36986,2,2213,2537,-324,0,45,0,6
36987,1,2415,2403,12,0,107,0,6
36988,1,2409,2318,91,0,4,0,6
36989,1,2430,2326,104,0,454,0,6
36990,2,2459,2489,-30,0,45,1,6
36991,1,2404,2422,-18,0,10,0,6
36992,3,2413,2307,106,0,49,0,6
36993,2,2520,2317,203,0,41,0,6
36994,1,2443,2404,39,0,171,0,6
36995,1,2431,2349,82,0,201,0,6
36996,1,2620,2732,-112,0,40,1,6
36997,1,2443,2396,47,0,106,0,6
36998,1,2430,2220,210,0,45,0,6
36999,1,2301,2461,-160,0,123,0,6
37000,1,2624,2534,90,0,404,0,6
37001,2,2357,2600,-243,0,180,0,6
37002,1,2440,2285,155,0,180,0,6
37003,1,2441,2313,128,0,133,0,6
37004,1,2453,2372,81,0,240,1,6
37005,2,2206,2449,-243,0,100,0,6
37006,1,2250,2421,-171,0,221,0,6
37007,2,2538,2232,306,0,455,0,6
37008,2,2400,2378,22,0,253,1,6
37009,2,2661,2558,103,0,106,0,6
37010,2,2276,2446,-170,0,140,0,6
37011,2,2403,2360,43,0,40,0,6
37012,2,2400,2566,-166,0,110,0,6
37013,3,2414,2320,94,0,192,0,6
37014,1,2280,2433,-153,0,4,0,6
37015,1,2542,2323,219,0,102,0,6
37016,2,2334,2512,-178,0,190,1,6
37017,2,2451,2270,181,0,335,1,6
37018,1,2425,2279,146,0,56,0,8
37019,2,2643,2303,340,0,131,0,6
37020,3,2392,2403,-11,0,41,0,6
37021,2,2364,2436,-72,0,40,1,6
37022,1,2455,2339,116,0,190,1,6
37023,3,2345,2458,-113,0,300,0,6
37024,2,2473,2353,120,0,315,1,6
37025,1,2440,2317,123,0,0,0,6
37026,2,2394,2449,-55,0,139,0,6
37027,1,2561,2439,122,0,100,1,6
37028,1,2539,2259,280,0,148,0,6
37029,2,2412,2545,-133,0,121,0,6
37030,3,2266,2415,-149,0,4,0,6
37031,2,2462,2597,-135,0,41,0,6
37032,2,2329,2492,-163,0,147,0,6
37033,1,2422,2307,115,0,218,0,6
37034,1,2309,2406,-97,0,330,1,6
37035,2,2434,2322,112,0,454,0,6
37036,1,2573,2653,-80,0,13,0,6
37037,1,2603,2212,391,0,278,1,6
37038,2,2473,2429,44,0,101,0,6
37039,1,2275,2456,-181,0,107,1,6
37040,1,2287,2412,-125,0,110,0,6
37041,2,2290,2432,-142,0,0,0,6
37042,1,2471,2314,157,0,45,1,6
37043,2,2390,2450,-60,0,151,0,6
37044,1,2725,2628,97,0,53,1,6
37045,1,2529,2513,16,0,0,1,6
37046,2,2318,2403,-85,0,4,0,6
37047,3,2453,2392,61,0,255,0,6
37048,1,2416,2410,6,0,226,0,6
37049,1,2450,2308,142,0,58,0,6
37050,1,2453,2309,144,0,52,0,6
37051,1,2247,2413,-166,0,107,0,6
37052,2,2218,2529,-311,0,107,1,6
37053,2,2261,2548,-287,0,211,0,6
37054,1,2377,2406,-29,0,107,0,6
37055,2,2417,2315,102,0,1,0,6
37056,1,2528,2222,306,0,4,0,6
37057,1,2515,2411,104,0,277,0,6
37058,2,2457,2653,-196,0,65,1,6
37059,1,2244,2435,-191,0,45,0,6
37060,2,2449,2384,65,0,305,1,6
37061,2,2427,2312,115,0,412,0,6
37062,1,2440,2479,-39,0,4,0,5
37063,2,2368,2457,-89,0,2,0,6
37064,1,2401,2213,188,0,43,0,6
37065,2,2293,2402,-109,0,4,0,6
37066,1,2336,2459,-123,0,127,1,6
37067,1,2494,2331,163,0,129,0,6
37068,2,2440,2310,130,0,130,0,6
37069,1,2378,2465,-87,0,312,1,6
37070,3,2495,2211,284,0,110,0,6
37071,3,2570,2240,330,0,36,0,6
37072,2,2402,2362,40,0,106,1,6
37074,1,2457,2385,72,0,300,0,6
37075,1,2343,2428,-85,0,335,0,6
37076,2,2405,2324,81,0,153,0,6
37077,3,2221,2436,-215,0,107,0,6
37078,2,2229,2507,-278,0,455,1,6
37079,2,2459,2404,55,0,311,0,6
37080,1,2550,2452,98,0,345,1,6
37081,1,2403,2286,117,0,460,1,6
37082,2,2435,2565,-130,0,44,1,6
37083,1,2414,2227,187,0,112,0,6
37084,1,2317,2458,-141,0,107,0,6
37085,1,2405,2433,-28,0,46,0,6
37086,1,2407,2299,108,0,347,0,6
37087,3,2441,2270,171,0,46,0,6
37088,1,2519,2259,260,0,288,0,6
37089,2,2243,2491,-248,0,0,0,6
37090,2,2456,2501,-45,0,88,0,6
37091,1,2448,2239,209,0,190,1,6
37092,1,2323,2456,-133,0,100,0,6
37093,2,2624,2729,-105,0,365,1,6
37094,1,2474,2247,227,0,300,0,6
37095,2,2536,2426,110,0,6,0,6
37096,3,2633,2333,300,0,200,0,6
37097,2,2249,2430,-181,0,140,1,8
37098,2,2411,2329,82,0,470,0,6
37099,1,2507,2324,183,0,466,0,6
37100,1,2357,2406,-49,0,302,0,6
37101,2,2276,2448,-172,0,40,0,6
37102,2,2290,2419,-129,0,248,0,6
37103,1,2474,2298,176,0,206,1,6
37104,1,2509,2220,289,0,46,1,6
37105,1,2451,2343,108,0,6,1,6
37106,1,2317,2629,-312,0,62,0,6
37107,3,2404,2421,-17,0,11,0,6
37108,1,2356,2454,-98,0,245,0,6
37109,1,2363,2443,-80,0,2,0,6
37110,2,2347,2407,-60,0,47,0,6
37111,1,2656,2451,205,0,151,0,6
37112,1,2566,2350,216,0,15,0,6
37113,2,2328,2497,-169,0,152,0,6
37114,2,2391,2469,-78,0,200,0,6
37115,1,2304,2466,-162,0,317,0,6
37116,2,2220,2496,-276,0,151,0,6
37117,3,2436,2494,-58,0,45,0,6
37118,2,2407,2604,-197,0,404,0,6
37119,2,2408,2521,-113,0,150,1,6
37120,1,2451,2276,175,0,0,0,6
37121,2,2227,2531,-304,0,5,0,6
37122,1,2628,2452,176,0,118,0,6
37123,3,2434,2263,171,0,108,0,6
37124,1,2418,2328,90,0,301,0,6
37125,1,2400,2338,62,0,343,1,6
37126,2,2339,2406,-67,0,424,0,6
37127,1,2216,2454,-238,0,100,0,6
37128,2,2263,2423,-160,0,40,0,6
37129,3,2554,2395,159,0,125,0,6
37130,3,2421,2385,36,0,15,0,6
37131,3,2283,2450,-167,0,455,0,6
37132,3,2309,2569,-260,0,327,0,6
37133,2,2431,2510,-79,0,301,0,6
37134,3,2380,2533,-153,0,26,0,6
37135,2,2306,2411,-105,0,228,0,6
37136,2,2474,2344,130,0,40,0,6
37137,3,2733,2620,113,0,190,0,6
37138,3,2324,2417,-93,0,22,0,6
37139,2,2224,2477,-253,0,13,0,6
37140,1,2449,2322,127,0,132,0,6
37141,1,2501,2325,176,0,129,0,6
37142,2,2361,2448,-87,0,414,1,6
37143,1,2344,2477,-133,0,138,0,6
37144,2,2339,2455,-116,0,127,0,6
37145,1,2401,2363,38,0,40,0,6
37146,1,2448,2659,-211,0,60,0,6
37147,1,2436,2370,66,0,83,0,6
37148,2,2396,2515,-119,0,207,0,6
37149,1,2515,2567,-52,0,106,0,6
37150,3,2519,2392,127,0,307,0,6
37151,1,2322,2504,-182,0,152,0,6
37152,2,2379,2476,-97,0,304,0,6
37153,2,2449,2401,48,0,352,0,6
37154,1,2448,2287,161,0,136,0,6
37155,1,2415,2309,106,0,62,0,6
37156,1,2621,2732,-111,0,246,0,6
37157,1,2526,2631,-105,0,352,0,6
37158,2,2479,2265,214,0,300,0,6
37159,2,2358,2407,-49,0,1,0,6
37160,1,2431,2330,101,0,102,1,6
37161,2,2246,2411,-165,0,112,1,6
37162,1,2400,2423,-23,0,151,0,6
37163,1,2478,2379,99,0,244,0,6
37164,3,2227,2451,-224,0,20,0,6
37165,1,2366,2441,-75,0,2,0,6
37166,3,2289,2404,-115,0,143,0,6
37167,1,2459,2335,124,0,4,0,6
37168,2,2412,2353,59,0,4,1,6
37169,1,2650,2457,193,0,112,0,6
37170,1,2449,2230,219,0,110,0,6
37171,1,2415,2329,86,0,107,0,6
37172,2,2410,2443,-33,0,46,0,6
37173,1,2360,2419,-59,0,315,0,6
37174,3,2453,2293,160,0,153,0,6
37175,1,2455,2653,-198,0,310,1,6
37176,2,2724,2629,95,0,112,0,6
37177,1,2412,2345,67,0,111,0,6
37178,1,2559,2522,37,0,245,0,6
37179,2,2518,2427,91,0,15,0,6
37180,1,2667,2620,47,0,181,0,6
37181,2,2408,2483,-75,0,150,0,6
37182,2,2506,2541,-35,0,31,0,6
37183,1,2413,2276,137,0,375,0,6
37184,1,2394,2444,-50,0,43,1,6
37185,2,2463,2373,90,0,0,1,6
37186,2,2346,2476,-130,0,48,0,6
37187,1,2360,2405,-45,0,1,0,6
37188,1,2488,2403,85,0,241,0,6
37189,1,2454,2217,237,0,200,1,6
37190,1,2451,2263,188,0,45,0,6
37191,1,2323,2419,-96,0,131,0,6
37192,2,2335,2406,-71,4,16,0,13
37193,2,2448,2405,43,0,317,1,6
37194,1,2480,2515,-35,0,1,0,6
37195,2,2636,2717,-81,0,485,0,6
37196,2,2386,2435,-49,0,136,1,6
37197,1,2417,2406,11,0,112,0,6
37198,3,2383,2517,-134,0,267,0,6
37199,1,2547,2501,46,0,1,0,6
37200,1,2416,2259,157,0,308,0,6
37201,2,2353,2493,-140,0,10,0,6
37202,1,2645,2463,182,0,338,0,6
37203,2,2380,2456,-76,0,2,0,6
37204,2,2461,2399,62,0,403,0,6
37205,1,2510,2434,76,0,56,0,6
37206,2,2367,2401,-34,0,354,0,6
37207,2,2557,2475,82,0,0,0,6
37208,2,2472,2322,150,0,121,0,6
37209,1,2456,2230,226,0,101,0,6
37210,2,2460,2648,-188,0,484,0,6
37211,2,2552,2672,-120,0,101,1,6
37212,1,2721,2632,89,0,123,1,6
37213,1,2454,2496,-42,0,88,0,6
37214,1,2406,2441,-35,0,200,0,6
37215,2,2412,2455,-43,0,136,0,6
37216,1,2457,2338,119,0,0,0,6
37217,1,2440,2367,73,0,242,0,6
37218,2,2497,2349,148,0,103,0,6
37219,3,2300,2411,-111,4,224,0,13
37220,1,2430,2515,-85,0,301,0,6
37221,2,2461,2376,85,0,240,1,6
37222,1,2421,2450,-29,0,308,0,6
37223,1,2406,2363,43,0,315,0,6
37224,1,2269,2445,-176,0,302,1,6
37225,2,2369,2459,-90,0,100,1,6
37226,2,2388,2464,-76,0,254,0,6
37227,2,2550,2330,220,0,194,0,6
37228,2,2274,2443,-169,0,13,0,6
37230,1,2651,2457,194,0,110,0,6
37231,2,2468,2435,33,0,241,0,6
37232,1,2628,2726,-98,0,485,0,6
37233,1,2455,2654,-199,0,88,1,6
37234,2,2344,2495,-151,0,101,0,8
37235,1,2489,2370,119,0,121,0,6
37236,2,2357,2408,-51,0,123,0,6
37237,3,2460,2334,126,0,45,0,6
37238,1,2402,2548,-146,0,7,0,6
37239,1,2676,2615,61,0,100,1,6
37240,2,2400,2422,-22,0,143,1,6
37241,1,2383,2453,-70,0,3,1,6
37242,2,2412,2601,-189,0,107,0,6
37243,3,2385,2411,-26,0,358,0,6
37244,2,2429,2415,14,0,277,0,6
37245,2,2442,2446,-4,0,406,0,6
37246,2,2384,2462,-78,0,388,0,6
37247,2,2426,2487,-61,0,80,0,6
37248,1,2604,2409,195,0,335,1,6
37249,2,2355,2541,-186,0,7,0,6
37250,2,2531,2387,144,0,245,1,6
37251,2,2719,2635,84,0,20,0,6
37252,2,2400,2335,65,0,4,1,6
37253,1,2288,2427,-139,0,65,1,6
37254,1,2645,2463,182,0,14,0,6
37255,1,2540,2384,156,0,8,0,6
37256,2,2270,2409,-139,0,300,0,6
37257,2,2222,2458,-236,0,43,0,6
37258,1,2610,2681,-71,0,3,0,6
37259,1,2447,2390,57,0,1,0,6
37260,2,2393,2569,-176,0,43,0,6
37261,2,2410,2386,24,0,5,1,6
37262,1,2465,2352,113,0,0,1,6
37263,1,2303,2408,-105,0,10,0,6
37264,1,2436,2408,28,0,456,0,6
37265,2,2492,2352,140,0,310,1,6
37266,1,2544,2632,-88,0,128,0,6
37267,1,2428,2395,33,0,112,1,6
37268,1,2309,2429,-120,0,151,0,6
37269,1,2572,2541,31,0,147,0,6
37270,2,2406,2607,-201,0,106,0,6
37271,1,2367,2421,-54,0,115,1,6
37272,2,2642,2711,-69,0,338,0,6
37273,1,2686,2777,-91,0,131,0,6
37274,2,2460,2648,-188,0,89,0,6
37275,2,2363,2452,-89,0,143,0,6
37276,2,2385,2452,-67,0,3,0,6
37277,1,2395,2411,-16,0,278,0,6
37278,2,2405,2444,-39,0,277,0,6
37279,2,2674,2558,116,0,145,1,6
37280,2,2407,2441,-34,0,14,0,6
37281,1,2437,2508,-71,0,45,0,6
37282,1,2460,2336,124,0,300,1,6
37283,1,2401,2441,-40,0,107,0,6
37284,2,2332,2425,-93,0,106,0,6
37285,1,2245,2469,-224,0,200,0,6
37286,2,2312,2484,-172,0,103,1,6
37287,1,2536,2552,-16,0,143,0,6
37288,3,2716,2638,78,0,210,0,6
37289,3,2609,2467,142,0,40,0,6
37290,1,2402,2404,-2,0,305,0,6
37291,1,2651,2457,194,0,110,0,6
37292,1,2456,2351,105,0,41,0,6
37293,2,2416,2320,96,0,225,0,6
37294,1,2390,2433,-43,0,143,0,6
37295,2,2422,2265,157,0,200,1,6
37296,1,2456,2380,76,0,4,1,6
37297,2,2401,2435,-34,0,210,0,6
37298,2,2429,2328,101,0,1,1,6
37299,1,2501,2444,57,0,100,0,6
37300,2,2405,2446,-41,0,352,0,6
37301,2,2420,2546,-126,0,260,1,6
37302,2,2303,2470,-167,0,20,0,6
37303,2,2639,2715,-76,0,268,0,6
37304,2,2398,2420,-22,0,272,0,6
37305,1,2460,2366,94,0,121,0,6
37306,1,2413,2225,188,0,154,1,6
37307,2,2414,2502,-88,0,6,1,6
37308,3,2487,2335,152,0,476,0,6
37309,2,2455,2654,-199,0,61,0,6
37310,2,2461,2326,135,0,0,1,6
37311,1,2249,2419,-170,0,205,0,8
37312,2,2770,2694,76,0,22,1,6
37313,2,2439,2506,-67,0,106,0,6
37314,2,2358,2460,-102,0,141,0,6
37315,1,2566,2542,24,0,0,0,6
37316,1,2657,2452,205,0,110,0,6
37317,1,2335,2422,-87,0,40,1,6
37318,1,2396,2414,-18,0,184,0,6
37319,1,2435,2265,170,0,28,0,6
37320,3,2452,2441,11,0,348,0,6
37321,2,2719,2634,85,0,190,0,6
37322,1,2438,2407,31,0,8,0,6
37323,1,2292,2425,-133,0,258,1,6
37324,1,2549,2393,156,0,1,0,6
37325,3,2402,2417,-15,0,300,0,6
37326,2,2485,2354,131,0,302,0,6
37327,2,2334,2453,-119,0,40,0,6
37328,1,2389,2553,-164,0,140,0,6
37329,1,2473,2396,77,0,325,1,6
37330,1,2507,2402,105,0,107,0,6
37331,1,2642,2712,-70,0,485,0,6
37332,2,2510,2435,75,0,100,0,6
37333,1,2449,2659,-210,0,90,0,6
37334,2,2464,2457,7,0,10,1,6
37335,1,2441,2408,33,0,302,0,6
37336,1,2451,2402,49,0,357,0,6
37337,3,2415,2477,-62,0,105,0,6
37338,1,2702,2763,-61,0,21,0,6
37339,2,2402,2511,-109,0,40,0,6
37340,2,2417,2294,123,0,331,0,6
37341,1,2556,2365,191,0,177,0,6
37342,1,2545,2504,41,0,49,1,6
37343,3,2426,2334,92,0,107,0,6
37344,2,2402,2398,4,0,337,0,6
37345,2,2401,2364,37,0,106,1,6
37346,1,2401,2261,140,0,25,0,6
37347,1,2651,2458,193,0,110,0,6
37348,1,2355,2403,-48,0,205,0,8
37349,1,2403,2446,-43,0,200,0,6
37350,2,2385,2463,-78,0,127,0,6
37351,1,2402,2221,181,0,121,0,6
37352,1,2482,2397,85,0,398,1,6
37353,1,2515,2559,-44,0,90,0,6
37354,2,2404,2276,128,0,200,0,6
37355,1,2476,2456,20,0,404,0,6
37356,2,2394,2416,-22,0,106,0,6
37357,2,2380,2410,-30,0,9,1,6
37358,2,2537,2659,-122,0,326,1,6
37359,2,2249,2546,-297,0,101,0,6
37360,1,2615,2654,-39,0,153,1,6
37361,2,2392,2405,-13,0,101,0,6
37362,2,2383,2550,-167,0,45,1,6
37363,1,2757,2709,48,0,337,0,6
37364,1,2647,2623,24,0,130,0,6
37366,1,2456,2303,153,0,107,1,6
37367,1,2467,2293,174,0,0,0,6
37368,1,2451,2446,5,0,108,1,6
37369,2,2393,2421,-28,0,278,0,6
37370,1,2415,2252,163,0,334,1,6
37371,2,2426,2375,51,0,13,0,6
37372,1,2411,2386,25,0,320,0,6
37373,1,2617,2653,-36,0,153,0,6
37374,1,2427,2424,3,0,8,1,6
37375,2,2553,2662,-109,0,101,0,6
37376,2,2471,2390,81,0,8,1,6
37377,1,2407,2387,20,0,253,0,6
37378,1,2274,2440,-166,0,46,1,6
37379,1,2579,2457,122,0,53,1,6
37380,1,2666,2549,117,0,122,0,6
37381,2,2646,2625,21,0,230,0,6
37382,2,2382,2418,-36,0,311,0,6
37383,1,2704,2762,-58,0,380,0,6
37384,3,2424,2504,-80,0,102,0,6
37385,1,2419,2432,-13,0,100,0,6
37386,2,2389,2521,-132,0,153,0,6
37387,2,2432,2378,54,0,5,1,6
37388,2,2397,2464,-67,0,4,1,6
37389,1,2440,2308,132,0,150,0,6
37390,2,2295,2412,-117,0,190,1,6
37391,1,2617,2583,34,0,0,0,6
37392,2,2470,2453,17,0,118,0,6
37393,1,2545,2425,120,0,1,0,6
37394,1,2298,2401,-103,0,4,0,6
37395,2,2382,2461,-79,0,136,0,6
37396,2,2632,2640,-8,0,153,0,6
37397,1,2586,2430,156,0,123,0,6
37398,1,2525,2463,62,0,389,0,6
37399,1,2458,2377,81,0,438,0,6
37400,2,2425,2385,40,0,39,1,6
37401,2,2426,2425,1,0,1,1,6
37402,2,2466,2408,58,0,167,0,6
37403,1,2578,2535,43,0,123,0,6
37404,1,2353,2429,-76,0,4,1,6
37405,1,2755,2711,44,0,395,0,6
37406,1,2468,2393,75,0,140,0,6
37407,1,2416,2291,125,0,1,0,6
37408,3,2622,2558,64,0,2,0,6
37409,3,2470,2333,137,0,300,0,6
37410,2,2424,2378,46,0,335,1,6
37411,2,2459,2549,-90,0,332,0,6
37412,1,2646,2625,21,0,100,0,6
37413,1,2458,2331,127,0,138,0,6
37414,3,2533,2621,-88,0,101,0,6
37415,1,2372,2463,-91,0,45,1,6
37416,2,2619,2652,-33,0,0,1,6
37417,2,2388,2473,-85,0,4,0,6
37418,1,2391,2436,-45,0,110,0,6
37419,1,2431,2421,10,0,105,0,6
37420,2,2459,2583,-124,0,216,0,6
37421,1,2553,2455,98,0,4,0,6
37422,1,2415,2252,163,0,300,0,6
37423,2,2335,2468,-133,0,201,0,6
37424,2,2427,2328,99,0,222,1,6
37425,3,2706,2760,-54,0,13,0,6
37426,2,2462,2420,42,0,150,0,6
37427,2,2305,2417,-112,0,20,0,6
37428,2,2530,2503,27,0,102,0,6
37429,3,2519,2384,135,0,300,0,6
37430,1,2589,2456,133,0,207,0,6
37431,1,2358,2430,-72,0,310,1,6
37432,1,2477,2384,93,0,140,0,6
37433,1,2620,2534,86,0,4,1,6
37434,2,2415,2436,-21,0,8,0,6
37435,1,2418,2465,-47,0,45,0,6
37436,2,2379,2456,-77,0,455,0,6
37437,1,2657,2614,43,0,101,0,6
37438,1,2472,2376,96,0,40,0,6
37439,2,2335,2464,-129,0,369,0,6
37440,1,2451,2455,-4,0,305,0,6
37441,1,2386,2426,-40,0,162,1,6
37442,3,2475,2517,-42,0,46,0,6
37443,1,2509,2524,-15,0,4,0,6
37444,1,2374,2476,-102,0,200,0,6
37445,3,2380,2482,-102,0,40,0,6
37446,2,2456,2313,143,0,466,1,6
37447,1,2587,2421,166,0,61,0,6
37448,1,2309,2424,-115,0,386,0,6
37449,2,2401,2458,-57,0,101,0,6
37450,1,2608,2662,-54,0,45,0,6
37451,2,2442,2460,-18,0,130,0,6
37452,2,2423,2375,48,0,45,0,6
37453,1,2759,2707,52,0,167,0,6
37454,2,2469,2591,-122,0,45,0,6
37455,1,2575,2593,-18,0,180,0,6
37456,1,2558,2465,93,0,13,0,6
37457,1,2518,2595,-77,0,0,0,6
37458,1,2463,2397,66,0,46,1,6
37459,2,2516,2456,60,0,45,0,6
37461,2,2461,2562,-101,0,300,0,6
37462,2,2393,2448,-55,0,141,0,6
37463,1,2420,2308,112,0,1,1,6
37464,1,2480,2381,99,0,242,0,6
37465,3,2286,2472,-186,0,107,0,6
37466,2,2476,2331,145,0,345,0,6
37467,1,2466,2436,30,0,180,0,6
37468,2,2382,2417,-35,0,107,0,6
37469,1,2509,2359,150,0,40,0,6
37470,1,2418,2457,-39,0,331,0,6
37471,2,2393,2566,-173,0,304,1,6
37472,1,2377,2484,-107,0,40,0,6
37473,2,2371,2461,-90,0,134,0,6
37474,2,2702,2764,-62,0,132,0,6
37475,2,2418,2655,-237,0,133,0,6
37476,2,2392,2468,-76,0,101,0,6
37477,2,2567,2450,117,0,13,0,6
37478,2,2422,2376,46,0,45,0,6
37479,1,2339,2419,-80,0,10,1,6
37480,1,2431,2471,-40,0,133,1,6
37481,2,2406,2513,-107,0,41,0,6
37482,2,2587,2581,6,0,226,0,6
37483,1,2360,2453,-93,0,1,1,6
37484,1,2446,2483,-37,0,46,0,6
37485,2,2658,2667,-9,0,233,1,6
37486,2,2280,2431,-151,0,6,0,6
37487,2,2493,2388,105,0,277,0,6
37488,1,2472,2387,85,0,46,0,6
37489,2,2389,2424,-35,0,7,0,6
37490,2,2569,2390,179,0,200,0,6
37491,2,2477,2385,92,0,140,1,6
37492,3,2383,2477,-94,0,101,0,6
37493,2,2319,2525,-206,0,242,1,6
37494,1,2458,2440,18,0,300,0,6
37495,2,2465,2267,198,0,4,0,6
37496,2,2465,2438,27,0,268,0,6
37497,2,2412,2396,16,0,45,0,6
37498,3,2429,2395,34,0,1,0,6
37499,2,2434,2463,-29,0,40,0,6
37500,1,2446,2383,63,0,18,0,6
37501,2,2398,2561,-163,0,304,1,6
37502,3,2672,2652,20,0,196,0,6
37503,1,2423,2368,55,0,41,1,6
37504,2,2392,2470,-78,0,61,0,6
37505,2,2210,2469,-259,4,140,0,11
37506,1,2475,2385,90,0,406,1,6
37507,2,2378,2450,-72,0,45,0,6
37508,1,2769,2697,72,0,64,0,6
37509,1,2581,2403,178,0,115,0,6
37510,1,2469,2444,25,0,300,0,6
37511,2,2359,2482,-123,0,295,0,6
37512,2,2376,2476,-100,0,255,0,6
37513,2,2296,2429,-133,0,151,0,6
37514,2,2653,2672,-19,0,233,0,6
37515,1,2439,2474,-35,0,202,0,6
37516,1,2474,2388,86,0,43,1,6
37517,1,2564,2395,169,0,40,0,6
37518,1,2265,2428,-163,0,56,0,6
37519,1,2421,2278,143,4,41,0,13
37520,3,2572,2503,69,0,151,0,6
37521,1,2452,2308,144,0,110,0,6
37522,2,2303,2401,-98,4,30,0,13
37523,1,2455,2374,81,0,18,0,6
37525,2,2692,2774,-82,0,487,0,6
37526,1,2647,2468,179,0,218,0,6
37527,2,2369,2460,-91,0,13,0,6
37528,3,2396,2555,-159,0,101,0,6
37529,1,2481,2398,83,0,11,0,6
37530,2,2571,2677,-106,0,249,0,6
37531,2,2369,2432,-63,0,300,0,6
37532,1,2383,2479,-96,0,4,0,6
37533,2,2465,2650,-185,0,43,0,6
37534,1,2504,2459,45,0,130,0,6
37535,1,2424,2448,-24,0,30,0,6
37536,2,2265,2453,-188,0,58,0,6
37537,1,2433,2340,93,0,132,0,6
37538,1,2454,2510,-56,0,194,0,6
37539,1,2434,2307,127,0,454,1,6
37540,2,2409,2355,54,0,142,0,6
37541,2,2462,2566,-104,0,300,0,6
37542,2,2518,2257,261,0,346,0,6
37543,1,2565,2395,170,0,201,0,6
37544,1,2445,2403,42,0,147,0,6
37545,3,2459,2267,192,0,4,0,6
37546,1,2553,2416,137,0,17,0,6
37547,1,2614,2701,-87,0,365,0,6
37548,1,2368,2485,-117,0,264,0,6
37549,1,2471,2391,80,0,121,0,6
37550,2,2492,2398,94,0,398,1,6
37551,3,2682,2567,115,0,265,0,6
37552,1,2437,2415,22,0,253,0,6
37553,2,2778,2688,90,0,28,0,6
37554,2,2340,2415,-75,0,151,1,6
37555,2,2424,2371,53,0,49,0,6
37556,2,2663,2653,10,0,330,1,6
37557,1,2464,2433,31,0,13,0,6
37558,1,2289,2431,-142,0,331,1,6
37559,2,2503,2460,43,0,135,0,6
37560,1,2450,2437,13,0,170,1,6
37561,1,2598,2568,30,0,335,0,6
37562,2,2406,2403,3,0,300,0,6
37563,1,2391,2402,-11,0,304,0,6
37564,2,2362,2422,-60,0,211,0,6
37565,1,2570,2412,158,0,124,0,6
37566,2,2569,2680,-111,0,101,0,6
37567,2,2269,2510,-241,0,4,0,6
37568,2,2443,2522,-79,0,112,1,6
37569,1,2402,2264,138,0,412,0,6
37570,2,2307,2476,-169,0,4,0,6
37571,2,2302,2425,-123,4,312,1,13
37572,1,2467,2297,170,0,226,0,6
37573,1,2563,2500,63,0,312,0,6
37574,2,2463,2477,-14,0,265,1,6
37575,1,2694,2621,73,0,102,0,6
37576,2,2241,2457,-216,0,138,0,6
37577,2,2372,2456,-84,0,102,0,6
37578,1,2467,2497,-30,0,194,0,6
37579,3,2684,2565,119,0,265,0,6
37580,1,2659,2657,2,0,152,1,6
37581,2,2376,2416,-40,0,288,0,6
37582,1,2409,2427,-18,0,200,0,6
37583,1,2494,2456,38,0,52,1,6
37584,2,2320,2514,-194,0,143,0,6
37585,1,2406,2412,-6,0,106,0,6
37586,2,2414,2507,-93,0,40,0,6
37587,1,2307,2415,-108,0,311,0,6
37588,2,2397,2479,-82,0,40,1,6
37589,3,2526,2624,-98,0,127,0,6
37590,2,2527,2438,89,0,190,0,6
37591,3,2460,2513,-53,0,9,0,6
37592,1,2409,2298,111,0,29,1,6
37593,2,2573,2567,6,0,123,0,6
37594,2,2415,2453,-38,0,200,0,6
37595,1,2392,2439,-47,0,313,0,6
37596,2,2567,2682,-115,0,151,1,6
37597,2,2490,2473,17,0,130,0,6
37598,2,2480,2436,44,0,307,0,6
37599,1,2651,2608,43,0,455,1,6
37600,1,2665,2604,61,0,110,0,6
37601,2,2501,2384,117,0,50,1,6
37602,2,2451,2651,-200,0,100,0,6
37603,3,2208,2459,-251,0,123,0,6
37604,2,2336,2460,-124,0,45,1,6
37605,2,2420,2510,-90,0,122,0,6
37606,1,2483,2359,124,0,485,1,6
37607,1,2429,2563,-134,0,40,0,6
37608,1,2622,2528,94,0,0,0,6
37609,2,2445,2520,-75,0,112,0,6
37610,1,2410,2502,-92,0,4,1,6
37611,2,2337,2404,-67,0,40,0,6
37612,2,2484,2393,91,0,6,1,6
37613,1,2379,2573,-194,0,122,0,6
37614,2,2617,2698,-81,0,476,1,6
37615,1,2527,2448,79,0,25,0,6
37616,2,2297,2412,-115,0,133,0,6
37617,1,2555,2599,-44,0,405,0,6
37618,1,2473,2437,36,0,343,0,6
37619,1,2512,2462,50,0,311,0,6
37621,3,2457,2400,57,0,41,0,6
37622,1,2479,2484,-5,0,153,0,6
37623,2,2402,2410,-8,0,58,0,6
37624,3,2388,2403,-15,0,31,0,6
37625,2,2565,2491,74,0,14,1,6
37626,2,2771,2695,76,0,52,0,6
37627,1,2524,2627,-103,0,101,0,6
37628,1,2469,2359,110,0,327,0,6
37629,1,2408,2317,91,0,110,0,6
37630,2,2562,2531,31,0,106,0,6
37631,1,2600,2656,-56,0,45,0,6
37632,1,2524,2441,83,0,191,1,6
37633,1,2518,2315,203,0,319,0,6
37634,2,2308,2428,-120,0,100,0,6
37635,1,2400,2476,-76,0,40,1,6
37636,1,2464,2433,31,0,100,0,6
37637,1,2545,2425,120,0,113,1,6
37638,1,2469,2329,140,0,466,0,6
37639,1,2432,2478,-46,0,313,0,6
37640,1,2512,2531,-19,0,414,1,6
37641,3,2703,2612,91,0,102,0,6
37642,2,2416,2293,123,0,106,0,6
37643,1,2329,2447,-118,0,22,1,6
37644,1,2432,2388,44,0,1,0,6
37645,3,2403,2517,-114,0,337,0,6
37646,1,2457,2304,153,0,15,0,6
37647,3,2410,2413,-3,0,227,0,6
37648,2,2444,2556,-112,0,41,0,6
37649,1,2415,2537,-122,0,106,0,6
37650,2,2479,2485,-6,0,135,0,6
37651,1,2487,2251,236,0,11,1,6
37652,2,2605,2666,-61,0,150,0,6
37653,3,2425,2384,41,0,49,0,6
37654,1,2473,2357,116,0,49,1,6
37655,3,2592,2558,34,0,335,0,6
37656,2,2702,2764,-62,0,131,0,6
37657,1,2356,2404,-48,0,315,0,6
37658,1,2448,2423,25,0,43,0,6
37659,2,2344,2416,-72,0,131,0,6
37660,2,2422,2495,-73,0,385,0,6
37661,1,2470,2407,63,0,200,0,6
37662,2,2436,2529,-93,0,112,0,6
37663,1,2650,2471,179,0,398,0,6
37664,2,2333,2492,-159,0,113,0,6
37665,1,2313,2440,-127,0,369,0,6
37666,1,2401,2427,-26,0,100,0,6
37667,1,2440,2336,104,0,80,1,6
37668,1,2472,2438,34,0,343,0,6
37669,2,2312,2460,-148,0,301,1,6
37670,2,2413,2308,105,0,125,0,6
37671,1,2549,2456,93,0,200,0,6
37672,2,2202,2445,-243,0,101,0,6
37673,1,2285,2400,-115,0,122,0,6
37674,1,2559,2525,34,0,15,0,6
37675,1,2499,2320,179,0,411,0,6
37676,1,2671,2592,79,0,110,0,6
37677,1,2397,2560,-163,0,448,0,6
37678,1,2518,2340,178,0,123,1,6
37679,2,2417,2405,12,0,0,0,6
37680,1,2614,2702,-88,0,476,0,6
37681,2,2249,2489,-240,0,343,0,6
37682,1,2403,2474,-71,0,40,0,6
37683,1,2533,2432,101,0,317,0,6
37684,1,2418,2515,-97,0,245,0,6
37685,1,2829,2769,60,0,301,1,6
37686,2,2311,2406,-95,0,102,0,6
37687,1,2495,2477,18,0,113,0,6
37688,3,2551,2552,-1,0,324,0,6
37689,2,2587,2675,-88,0,433,0,6
37690,1,2432,2320,112,0,246,0,6
37691,2,2332,2444,-112,0,25,0,6
37692,2,2486,2332,154,0,60,0,6
37693,1,2717,2698,19,0,15,0,6
37694,1,2520,2564,-44,0,145,0,6
37695,2,2485,2589,-104,0,315,1,6
37696,1,2395,2453,-58,0,31,0,6
37697,1,2410,2460,-50,0,314,1,6
37698,2,2695,2621,74,0,102,0,6
37699,1,2425,2411,14,0,110,0,6
37700,2,2521,2525,-4,0,414,1,6
37701,1,2407,2303,104,0,110,0,6
37702,1,2428,2207,221,0,0,0,6
37703,1,2421,2452,-31,0,200,1,6
37704,1,2410,2287,123,0,43,1,6
37705,2,2468,2410,58,0,200,1,6
37706,2,2306,2482,-176,0,80,1,6
37707,3,2304,2582,-278,4,485,0,13
37708,2,2515,2511,4,0,156,0,6
37709,1,2428,2416,12,0,102,0,6
37710,1,2692,2724,-32,0,306,1,6
37711,2,2314,2492,-178,0,255,0,6
37712,1,2400,2401,-1,0,33,0,6
37713,2,2472,2501,-29,0,46,0,6
37714,1,2583,2552,31,0,320,0,6
37715,3,2552,2595,-43,0,354,0,6
37716,1,2446,2295,151,0,1,1,6
37717,2,2316,2436,-120,0,201,0,6
37718,1,2350,2402,-52,0,312,0,6
37719,2,2299,2447,-148,0,241,1,6
37720,2,2312,2491,-179,0,4,0,6
37721,2,2448,2417,31,0,300,0,6
37722,3,2680,2653,27,0,151,0,6
37723,3,2521,2557,-36,0,395,0,6
37724,1,2406,2431,-25,0,45,0,6
37725,2,2420,2241,179,4,122,0,13
37726,2,2537,2593,-56,0,241,1,6
37727,2,2403,2378,25,0,112,1,6
37728,2,2835,2764,71,0,300,0,6
37729,2,2429,2425,4,0,250,1,6
37730,1,2434,2342,92,0,1,0,6
37731,2,2370,2477,-107,0,190,1,6
37733,1,2467,2443,24,0,302,0,6
37734,2,2320,2485,-165,0,102,0,6
37735,2,2416,2461,-45,0,40,0,6
37736,1,2417,2308,109,0,380,0,6
37737,1,2559,2475,84,0,20,0,6
37738,1,2717,2699,18,0,130,0,6
37739,1,2455,2312,143,0,107,0,6
37740,2,2628,2688,-60,0,474,0,6
37741,1,2442,2433,9,0,242,0,6
37742,2,2547,2595,-48,0,0,0,6
37743,2,2653,2679,-26,0,89,1,6
37744,1,2522,2349,173,0,132,1,6
37745,2,2313,2404,-91,0,487,0,6
37746,3,2506,2425,81,0,30,0,6
37747,2,2239,2433,-194,0,4,1,6
37748,2,2506,2531,-25,0,190,0,6
37749,2,2474,2412,62,0,4,1,6
37750,2,2261,2507,-246,0,202,0,8
37751,2,2507,2424,83,0,112,0,6
37752,1,2246,2441,-195,0,4,0,6
37753,2,2598,2610,-12,0,107,0,6
37754,3,2771,2827,-56,0,464,0,6
37755,1,2472,2438,34,0,317,0,6
37756,1,2466,2318,148,0,6,1,6
37757,1,2488,2369,119,0,311,0,6
37758,2,2287,2454,-167,0,312,0,6
37759,1,2693,2723,-30,0,21,0,6
37760,2,2299,2437,-138,0,389,1,6
37761,2,2692,2623,69,0,103,0,6
37762,2,2299,2450,-151,0,56,0,6
37763,2,2446,2404,42,0,133,0,6
37764,2,2274,2450,-176,0,9,0,6
37765,2,2358,2447,-89,0,113,0,6
37766,1,2400,2308,92,0,315,1,6
37767,1,2427,2408,19,0,310,0,6
37768,2,2648,2685,-37,0,46,1,6
37769,2,2297,2423,-126,0,102,1,6
37770,2,2353,2430,-77,0,250,0,6
37771,3,2396,2403,-7,0,202,0,6
37772,1,2542,2501,41,0,132,1,6
37773,3,2431,2419,12,0,4,0,6
37774,1,2467,2361,106,0,4,0,6
37775,2,2557,2566,-9,0,140,0,6
37776,2,2457,2284,173,0,14,0,6
37777,2,2363,2452,-89,0,267,0,6
37778,2,2291,2416,-125,4,21,1,13
37779,1,2616,2357,259,0,250,0,6
37780,2,2426,2469,-43,0,200,0,6
37781,2,2433,2477,-44,0,101,0,6
37782,1,2471,2409,62,0,6,0,6
37783,3,2289,2409,-120,0,310,0,6
37784,2,2716,2700,16,0,0,0,6
37785,1,2407,2205,202,0,242,0,6
37786,2,2454,2411,43,0,311,1,6
37787,1,2402,2230,172,0,111,0,6
37788,2,2411,2440,-29,0,207,1,6
37789,2,2772,2826,-54,0,310,0,6
37790,2,2234,2427,-193,0,301,1,6
37791,2,2388,2521,-133,0,127,0,8
37792,1,2607,2284,323,0,338,0,6
37793,1,2402,2490,-88,0,300,0,6
37794,2,2249,2404,-155,0,395,0,6
37795,2,2419,2476,-57,0,40,0,6
37796,1,2536,2547,-11,0,0,0,6
37797,2,2435,2349,86,0,41,0,6
37798,1,2532,2403,129,0,110,0,6
37799,2,2389,2431,-42,0,110,0,6
37800,2,2690,2643,47,0,370,0,6
37801,2,2475,2500,-25,0,5,1,6
37802,1,2630,2686,-56,0,45,0,6
37803,2,2410,2335,75,0,0,0,6
37804,1,2551,2378,173,0,45,0,6
37805,2,2394,2453,-59,0,7,1,6
37806,1,2482,2428,54,0,317,1,6
37807,1,2405,2421,-16,0,150,0,6
37808,2,2541,2536,5,0,143,0,6
37809,1,2489,2414,75,0,45,0,6
37810,1,2447,2356,91,0,48,0,6
37811,2,2456,2552,-96,0,207,0,6
37812,2,2224,2424,-200,0,46,0,8
37813,3,2375,2408,-33,0,132,0,6
37814,3,2554,2416,138,0,1,0,6
37815,2,2332,2525,-193,0,0,1,8
37816,1,2410,2283,127,0,304,1,6
37817,2,2421,2609,-188,0,150,0,6
37818,1,2434,2357,77,0,132,0,6
37819,1,2436,2376,60,0,15,0,6
37820,3,2428,2336,92,0,46,0,6
37821,2,2262,2402,-140,0,42,0,6
37822,1,2527,2536,-9,0,277,0,6
37823,2,2415,2403,12,0,101,0,6
37824,1,2372,2469,-97,0,4,1,6
37825,1,2650,2684,-34,0,61,0,6
37826,2,2483,2541,-58,0,45,0,6
37827,1,2459,2404,55,0,107,0,6
37828,1,2440,2378,62,0,9,1,6
37829,1,2380,2506,-126,0,487,0,6
37830,1,2407,2445,-38,0,4,0,6
37831,2,2337,2433,-96,0,301,0,6
37832,3,2423,2487,-64,0,101,0,6
37833,1,2832,2767,65,0,301,1,6
37834,2,2385,2439,-54,0,343,1,6
37835,2,2235,2585,-350,0,469,1,6
37836,2,2369,2456,-87,0,22,0,6
37837,1,2407,2264,143,0,406,1,6
37838,1,2410,2409,1,0,49,1,6
37839,2,2418,2552,-134,0,115,0,6
37840,2,2437,2333,104,0,112,1,6
37841,2,2556,2530,26,0,344,0,6
37842,2,2405,2354,51,0,268,0,6
37843,1,2379,2474,-95,0,200,0,6
37844,2,2347,2468,-121,0,40,0,6
37845,1,2347,2418,-71,0,5,0,6
37846,2,2450,2313,137,0,1,1,6
37847,2,2420,2307,113,4,131,0,13
37848,2,2679,2637,42,0,4,0,6
37849,1,2546,2677,-131,0,21,0,6
37850,2,2411,2270,141,0,52,0,8
37851,1,2522,2368,154,0,16,1,6
37852,2,2279,2413,-134,0,110,1,6
37853,2,2323,2462,-139,0,302,1,6
37854,1,2549,2483,66,0,255,1,6
37855,1,2460,2307,153,0,18,0,6
37856,3,2400,2478,-78,0,112,0,6
37857,2,2366,2445,-79,0,302,0,6
37858,2,2542,2533,9,0,121,0,6
37859,1,2498,2388,110,0,242,1,6
37860,2,2501,2352,149,0,15,1,6
37861,2,2400,2464,-64,0,22,0,6
37862,2,2539,2444,95,0,242,0,6
37863,1,2387,2537,-150,0,302,0,8
37864,2,2472,2344,128,0,0,0,6
37865,3,2337,2426,-89,0,261,0,6
37866,1,2564,2412,152,0,357,0,6
37867,2,2486,2424,62,0,317,0,6
37868,1,2403,2308,95,0,4,0,6
37869,1,2466,2415,51,0,466,0,6
37870,1,2516,2524,-8,0,485,0,6
37871,2,2670,2536,134,0,278,1,6
37872,1,2386,2550,-164,0,41,0,6
37873,2,2439,2414,25,0,310,0,6
37874,2,2245,2430,-185,0,29,0,6
37875,1,2556,2414,142,0,330,0,6
37876,3,2420,2471,-51,0,302,0,6
37877,1,2411,2408,3,0,357,0,6
37878,2,2411,2374,37,0,343,0,6
37879,1,2464,2407,57,0,45,0,6
37880,1,2417,2276,141,0,302,1,6
37881,2,2394,2536,-142,0,128,0,6
37882,3,2472,2430,42,0,337,0,6
37883,1,2411,2362,49,0,150,1,6
37884,1,2451,2361,90,0,132,0,6
37885,2,2417,2532,-115,0,46,0,6
37886,1,2431,2480,-49,0,101,0,6
37887,1,2466,2399,67,0,200,0,6
37888,2,2488,2500,-12,0,470,1,6
37889,1,2427,2452,-25,0,241,0,6
37890,1,2384,2502,-118,0,487,0,6
37891,1,2477,2416,61,0,45,0,6
37892,2,2352,2464,-112,0,1,0,6
37893,3,2588,2573,15,0,58,0,6
37894,2,2403,2411,-8,0,105,1,6
37895,2,2643,2673,-30,0,192,0,6
37896,2,2315,2493,-178,0,389,1,6
37897,2,2331,2403,-72,0,120,1,8
37898,1,2408,2258,150,0,16,1,6
37899,3,2431,2472,-41,0,122,0,6
37900,1,2618,2478,140,0,255,0,6
37901,1,2373,2560,-187,0,112,0,6
37902,2,2340,2438,-98,0,302,0,6
37903,2,2420,2433,-13,0,4,0,6
37904,3,2433,2242,191,0,115,0,6
37905,1,2358,2503,-145,0,4,1,6
37906,1,2380,2441,-61,0,460,0,6
37907,2,2405,2404,1,0,8,0,6
37908,1,2763,2837,-74,0,106,0,6
37909,1,2544,2601,-57,0,380,0,6
37910,1,2469,2395,74,0,81,1,6
37911,2,2401,2397,4,0,80,0,8
37912,1,2247,2429,-182,0,43,1,8
37913,1,2662,2469,193,0,133,0,6
37914,2,2536,2470,66,0,201,1,6
37915,2,2506,2402,104,0,127,0,6
37916,2,2446,2359,87,0,327,1,6
37917,1,2553,2514,39,0,101,1,6
37918,1,2540,2391,149,0,121,0,6
37919,1,2412,2509,-97,0,46,1,6
37920,2,2395,2482,-87,0,300,1,6
37921,1,2470,2303,167,0,415,0,6
37922,2,2291,2455,-164,0,247,0,6
37923,1,2522,2449,73,0,351,0,6
37924,3,2495,2392,103,0,105,0,6
37925,2,2573,2588,-15,0,115,0,6
37926,2,2333,2410,-77,0,140,0,6
37927,1,2272,2421,-149,0,115,0,6
37928,1,2678,2638,40,0,267,0,6
37929,1,2417,2322,95,0,0,1,6
37930,2,2475,2567,-92,0,469,1,6
37931,1,2408,2279,129,0,302,0,6
37932,1,2430,2457,-27,0,200,1,6
37933,1,2322,2425,-103,0,245,0,6
37934,2,2397,2496,-99,0,265,1,6
37935,2,2413,2433,-20,0,48,0,6
37936,3,2255,2411,-156,0,128,0,6
37937,1,2471,2554,-83,0,60,1,6
37938,3,2829,2770,59,0,6,0,6
37939,1,2438,2415,23,0,289,0,6
37940,1,2404,2209,195,0,106,0,6
37941,3,2459,2498,-39,0,101,0,6
37942,2,2495,2366,129,0,215,0,6
37943,2,2474,2372,102,0,0,1,6
37944,1,2551,2518,33,0,267,0,6
37945,1,2466,2665,-199,0,43,0,6
37946,2,2343,2487,-144,0,13,0,6
37947,3,2477,2374,103,0,201,0,6
37948,2,2414,2526,-112,0,255,0,6
37949,1,2410,2302,108,0,326,0,6
37950,1,2434,2395,39,0,304,1,6
37951,1,2287,2406,-119,0,484,0,6
37952,1,2525,2554,-29,0,49,0,6
37953,2,2528,2403,125,0,130,0,8
37954,1,2486,2388,98,0,300,0,6
37955,2,2441,2382,59,0,107,0,5
37956,2,2438,2386,52,0,311,0,6
37957,3,2294,2473,-179,0,20,0,6
37958,1,2393,2493,-100,0,1,0,6
37959,1,2448,2419,29,0,106,0,6
37960,1,2525,2424,101,0,41,0,6
37961,2,2515,2280,235,0,57,0,6
37962,1,2541,2413,128,0,110,1,6
37963,2,2443,2449,-6,0,132,0,6
37964,2,2504,2378,126,0,102,1,6
37965,1,2486,2401,85,0,242,1,6
37966,3,2292,2436,-144,0,400,0,6
37967,1,2316,2421,-105,0,2,0,6
37968,2,2450,2543,-93,0,4,0,6
37969,2,2409,2284,125,0,0,1,6
37970,2,2501,2393,108,0,278,1,6
37971,1,2459,2292,167,0,106,0,6
37972,1,2413,2498,-85,0,101,0,6
37973,1,2376,2476,-100,0,13,0,6
37974,1,2443,2295,148,0,140,0,6
37975,2,2383,2490,-107,0,200,0,6
37976,1,2656,2475,181,0,403,0,6
37977,1,2414,2420,-6,0,41,1,6
37978,2,2470,2682,-212,0,200,0,6
37979,2,2390,2439,-49,0,40,0,6
37980,1,2548,2491,57,0,113,0,6
37981,2,2403,2473,-70,0,8,0,6
37982,1,2414,2360,54,0,40,0,6
37983,1,2400,2308,92,0,306,0,6
37984,1,2446,2309,137,0,100,1,6
37985,2,2502,2468,34,0,210,1,6
37986,1,2684,2599,85,0,253,0,6
37987,1,2283,2451,-168,0,45,1,6
37988,1,2431,2345,86,0,204,0,6
37989,1,2383,2400,-17,0,483,0,6
37990,1,2434,2478,-44,0,101,0,6
37991,1,2555,2529,26,0,140,0,6
37992,2,2420,2545,-125,0,40,0,6
37993,1,2421,2243,178,0,7,0,6
37994,2,2204,2440,-236,0,46,0,8
37995,1,2512,2421,91,0,405,0,8
37996,2,2771,2828,-57,0,106,0,6
37997,1,2496,2307,189,0,140,0,6
37998,1,2358,2409,-51,0,128,0,6
37999,2,2458,2530,-72,0,112,0,6
38000,1,2446,2419,27,0,8,0,6
38001,1,2396,2490,-94,0,49,0,6
38002,1,2432,2463,-31,0,242,0,6
38003,2,2408,2401,7,0,487,0,6
38004,1,2380,2491,-111,0,0,0,6
38005,1,2400,2493,-93,0,265,0,6
38006,2,2434,2460,-26,0,404,0,6
38007,2,2444,2378,66,0,176,0,6
38008,2,2385,2463,-78,0,411,1,6
38009,2,2385,2495,-110,0,112,1,6
38010,2,2379,2659,-280,0,132,0,6
38011,1,2456,2476,-20,0,122,1,6
38012,1,2549,2486,63,0,120,0,6
38013,1,2402,2416,-14,0,45,0,6
38014,2,2418,2471,-53,0,46,0,6
38015,1,2385,2437,-52,0,194,0,6
38016,1,2465,2452,13,0,53,0,6
38017,2,2414,2524,-110,0,45,0,6
38018,3,2258,2414,-156,0,132,0,6
38019,1,2474,2682,-208,0,325,0,6
38020,1,2414,2389,25,0,203,0,6
38021,1,2595,2428,167,0,202,0,6
38022,1,2461,2274,187,0,302,1,6
38023,2,2488,2514,-26,0,40,1,6
38024,2,2293,2507,-214,0,117,0,6
38025,1,2438,2445,-7,0,101,1,6
38026,1,2547,2450,97,0,36,0,6
38027,2,2615,2568,47,0,302,1,6
38028,1,2431,2391,40,0,176,0,6
38029,1,2661,2378,283,0,151,0,6
38030,3,2535,2454,81,0,345,0,6
38031,3,2834,2766,68,0,4,0,6
38032,1,2483,2404,79,0,105,1,6
38033,2,2417,2243,174,0,10,1,8
38034,1,2391,2407,-16,0,1,0,6
38035,1,2483,2408,75,0,249,0,6
38036,1,2386,2436,-50,0,196,0,6
38037,1,2486,2411,75,0,380,0,6
38038,1,2446,2408,38,0,5,0,6
38039,1,2337,2462,-125,0,236,0,6
38040,2,2392,2553,-161,0,0,0,6
38041,2,2481,2517,-36,0,107,0,6
38042,2,2306,2472,-166,0,46,1,6
38043,1,2499,2381,118,0,45,1,6
38044,2,2410,2392,18,0,40,0,6
38045,2,2528,2689,-161,0,270,1,6
38046,1,2476,2413,63,0,316,1,6
38047,2,2424,2557,-133,0,106,0,6
38048,2,2467,2551,-84,0,45,0,6
38049,2,2384,2419,-35,0,13,0,6
38050,1,2663,2560,103,0,45,0,6
38051,1,2430,2393,37,0,176,0,6
38052,1,2455,2452,3,0,190,0,6
38053,2,2412,2424,-12,0,46,1,6
38054,1,2673,2376,297,0,2,0,6
38055,1,2438,2440,-2,0,4,0,6
38056,2,2519,2483,36,0,315,0,6
38057,2,2349,2404,-55,0,41,0,6
38058,1,2534,2483,51,0,267,0,6
38059,2,2511,2333,178,0,354,0,8
38060,3,2406,2467,-61,0,201,0,6
38061,2,2305,2401,-96,0,464,0,6
38062,3,2295,2429,-134,0,46,0,5
38063,2,2579,2667,-88,0,61,0,6
38064,2,2556,2404,152,0,200,1,6
38065,2,2388,2435,-47,0,112,0,6
38066,3,2488,2475,13,0,112,0,6
38067,2,2399,2487,-88,0,1,0,6
38068,1,2403,2532,-129,0,241,1,6
38069,1,2432,2297,135,0,4,1,6
38070,2,2271,2434,-163,0,123,0,6
38071,1,2464,2296,168,0,302,0,6
38072,1,2424,2379,45,0,241,0,6
38073,1,2517,2561,-44,0,4,0,6
38075,2,2278,2512,-234,0,357,1,6
38076,1,2405,2421,-16,0,37,0,6
38077,1,2434,2444,-10,0,300,0,6
38078,1,2524,2464,60,0,277,0,6
38079,2,2608,2692,-84,0,248,0,6
38080,2,2444,2424,20,0,190,0,6
38081,2,2404,2351,53,4,156,0,13
38082,1,2552,2539,13,0,106,1,6
38083,3,2461,2489,-28,0,121,0,6
38084,2,2409,2447,-38,0,0,0,6
38085,1,2374,2463,-89,0,140,0,6
38086,2,2407,2286,121,0,302,0,6
38087,2,2767,2832,-65,0,106,0,6
38088,1,2534,2411,123,0,456,0,6
38089,3,2407,2383,24,0,201,0,6
38090,2,2440,2539,-99,0,140,0,6
38091,1,2318,2406,-88,0,132,0,6
38092,1,2556,2369,187,0,25,1,6
38093,1,2403,2393,10,0,40,1,8
38094,1,2672,2478,194,0,9,0,6
38095,2,2415,2411,4,0,106,0,6
38096,1,2428,2466,-38,0,100,0,6
38097,1,2492,2395,97,0,242,0,6
38098,2,2438,2440,-2,0,186,1,6
38099,1,2488,2396,92,0,200,0,6
38100,2,2417,2311,106,0,484,0,6
38101,1,2475,2438,37,0,37,0,6
38102,1,2480,2287,193,0,408,1,6
38103,1,2376,2548,-172,0,104,1,6
38104,1,2389,2412,-23,0,101,0,6
38105,2,2318,2461,-143,0,243,0,6
38106,2,2460,2489,-29,0,400,0,6
38107,2,2420,2378,42,0,122,0,6
38108,1,2374,2429,-55,0,4,0,6
38109,2,2454,2311,143,0,45,1,8
38110,2,2524,2529,-5,0,15,0,6
38111,1,2430,2438,-8,0,4,0,6
38112,2,2262,2432,-170,0,331,0,6
38113,2,2408,2414,-6,0,304,1,6
38114,2,2456,2411,45,0,300,0,6
38115,2,2481,2554,-73,0,20,0,6
38116,2,2604,2567,37,0,101,0,6
38117,2,2427,2286,141,0,152,0,5
38118,1,2697,2601,96,0,125,0,6
38119,2,2293,2404,-111,0,41,0,6
38120,2,2417,2409,8,0,0,1,6
38121,3,2386,2400,-14,0,315,0,6
38123,1,2494,2674,-180,0,46,1,6
38124,1,2454,2381,73,0,311,0,6
38125,1,2557,2378,179,0,248,0,6
38126,3,2491,2482,9,0,101,0,6
38127,2,2475,2559,-84,0,60,0,6
38128,1,2318,2410,-92,0,4,0,6
38129,2,2427,2384,43,0,301,1,6
38130,2,2762,2838,-76,0,40,0,6
38131,1,2534,2314,220,0,332,0,6
38132,1,2447,2407,40,0,36,0,6
38133,1,2425,2255,170,0,120,0,8
38134,2,2543,2436,107,0,211,0,6
38135,1,2434,2533,-99,0,106,0,6
38136,1,2345,2465,-120,0,302,0,6
38137,2,2248,2432,-184,0,45,0,6
38138,2,2433,2480,-47,0,1,0,6
38139,1,2364,2406,-42,0,245,0,6
38140,2,2391,2496,-105,0,485,1,6
38141,2,2490,2314,176,0,337,1,6
38142,1,2446,2432,14,0,181,0,6
38143,1,2535,2518,17,0,189,0,6
38144,2,2415,2413,2,0,8,0,6
38145,2,2457,2331,126,0,172,0,6
38146,3,2407,2538,-131,0,113,0,6
38147,1,2406,2515,-109,0,107,1,6
38148,1,2540,2536,4,0,140,0,6
38149,2,2467,2432,35,0,414,0,6
38150,3,2444,2478,-34,0,130,0,6
38151,2,2377,2459,-82,0,244,0,6
38152,2,2396,2532,-136,0,15,0,6
38153,2,2408,2402,6,0,310,0,6
38154,2,2291,2452,-161,0,4,0,6
38155,2,2384,2427,-43,0,167,0,6
38156,1,2483,2436,47,0,375,0,6
38157,1,2451,2289,162,0,150,0,6
38158,3,2475,2381,94,0,6,0,6
38159,2,2674,2471,203,0,227,1,6
38160,2,2485,2563,-78,0,35,1,6
38161,1,2284,2401,-117,0,209,0,6
38162,2,2415,2411,4,0,100,0,6
38163,1,2257,2403,-146,0,176,0,6
38164,1,2666,2598,68,0,458,0,6
38165,2,2417,2536,-119,0,288,1,6
38166,2,2392,2454,-62,0,138,0,6
38168,2,2390,2416,-26,0,150,0,6
38169,2,2413,2504,-91,0,13,0,8
38170,1,2337,2449,-112,0,147,1,6
38171,1,2418,2250,168,0,301,1,6
38172,2,2239,2409,-170,0,135,0,6
38173,2,2574,2616,-42,0,242,0,6
38174,2,2254,2403,-149,0,250,0,6
38175,2,2302,2428,-126,0,22,0,5
38176,1,2540,2408,132,0,192,0,6
38177,1,2372,2523,-151,0,300,0,6
38178,3,2459,2323,136,0,130,0,6
38179,1,2842,2758,84,0,301,0,6
38180,2,2530,2382,148,0,140,0,6
38181,1,2380,2428,-48,0,306,0,8
38182,2,2406,2380,26,0,334,0,6
38183,1,2561,2386,175,0,250,0,6
38184,2,2286,2402,-116,0,41,0,6
38185,2,2428,2362,66,0,1,0,6
38186,2,2400,2221,179,0,250,0,6
38187,2,2508,2408,100,0,386,0,6
38188,1,2414,2395,19,0,106,0,6
38189,1,2499,2671,-172,0,113,0,6
38190,1,2480,2299,181,0,331,0,6
38191,1,2478,2444,34,0,40,0,6
38192,1,2286,2437,-151,0,337,0,6
38193,2,2513,2478,35,0,400,0,6
38194,2,2432,2330,102,0,327,0,6
38195,1,2403,2203,200,4,300,0,13
38196,2,2441,2359,82,0,106,0,6
38197,1,2500,2387,113,0,105,1,6
38198,2,2433,2482,-49,0,302,0,6
38199,1,2526,2411,115,0,0,0,6
38200,1,2417,2409,8,0,4,1,6
38201,1,2408,2302,106,0,45,0,8
38202,3,2539,2488,51,0,278,0,6
38203,2,2328,2474,-146,0,152,0,6
38204,1,2434,2394,40,0,125,0,6
38205,2,2349,2481,-132,0,20,0,6
38206,1,2301,2421,-120,0,45,0,6
38207,2,2325,2457,-132,0,112,0,6
38208,2,2438,2536,-98,0,86,0,6
38209,1,2383,2414,-31,0,300,0,6
38210,1,2501,2480,21,0,398,0,6
38211,2,2540,2666,-126,0,345,0,6
38212,1,2427,2413,14,0,354,0,6
38213,1,2429,2271,158,0,311,1,6
38214,3,2404,2426,-22,0,106,0,6
38215,2,2517,2475,42,0,15,1,6
38216,1,2426,2477,-51,0,3,1,6
38217,1,2770,2599,171,0,335,0,6
38218,1,2512,2500,12,0,104,0,6
38219,2,2400,2383,17,0,4,1,6
38220,1,2344,2414,-70,0,105,0,6
38221,1,2439,2261,178,0,246,0,6
38222,1,2508,2344,164,0,353,1,8
38223,1,2530,2409,121,0,0,0,6
38224,1,2515,2380,135,0,121,1,6
38225,2,2461,2428,33,0,9,1,6
38226,1,2412,2379,33,0,334,0,6
38227,1,2400,2389,11,0,317,1,6
38228,1,2408,2403,5,0,40,0,6
38229,2,2289,2406,-117,0,41,0,6
38230,1,2432,2287,145,0,200,0,5
38231,1,2662,2621,41,0,4,0,6
38232,1,2429,2424,5,0,4,1,6
38233,1,2506,2566,-60,0,398,0,6
38234,1,2485,2346,139,0,46,0,6
38235,1,2461,2284,177,0,4,0,6
38236,2,2753,2847,-94,0,106,0,6
38237,1,2596,2614,-18,0,101,0,6
38238,2,2413,2566,-153,0,0,0,6
38239,1,2474,2669,-195,0,443,0,6
38240,2,2404,2423,-19,0,113,0,6
38241,1,2540,2434,106,0,406,1,6
38242,2,2210,2422,-212,0,101,0,6
38243,1,2531,2450,81,0,150,0,6
38244,2,2398,2534,-136,0,4,1,6
38245,1,2351,2530,-179,0,151,0,6
38246,1,2405,2432,-27,0,20,0,6
38247,1,2297,2432,-135,0,335,0,6
38248,2,2408,2464,-56,0,113,0,6
38249,1,2406,2243,163,0,40,0,6
38250,1,2460,2321,139,0,337,0,6
38251,2,2548,2488,60,0,110,1,6
38252,2,2410,2404,6,0,394,0,6
38253,2,2433,2426,7,0,3,0,6
38254,2,2471,2593,-122,0,14,0,6
38255,2,2616,2668,-52,0,120,1,6
38256,1,2494,2442,52,0,6,1,6
38257,1,2518,2568,-50,0,35,0,6
38258,2,2301,2569,-268,0,46,0,6
38259,1,2410,2365,45,0,455,0,6
38260,1,2608,2675,-67,0,154,0,6
38261,1,2435,2455,-20,0,302,0,6
38262,1,2404,2269,135,0,253,0,6
38263,2,2661,2483,178,0,300,1,6
38264,2,2377,2519,-142,0,300,0,6
38265,3,2544,2417,127,0,341,0,6
38266,1,2476,2292,184,4,123,0,23
38267,2,2428,2387,41,0,0,0,6
38268,1,2400,2288,112,0,48,1,6
38270,3,2429,2439,-10,0,250,0,6
38271,1,2419,2389,30,0,106,0,6
38272,1,2489,2539,-50,0,463,1,6
38273,2,2298,2469,-171,0,292,0,6
38274,1,2426,2411,15,0,101,0,6
38275,1,2673,2602,71,0,4,0,6
38276,1,2523,2373,150,0,121,0,6
38277,2,2467,2283,184,0,6,0,6
38278,1,2413,2411,2,0,1,0,6
38279,2,2383,2422,-39,0,80,0,6
38280,2,2525,2524,1,0,354,0,6
38281,2,2240,2409,-169,0,316,0,6
38282,2,2394,2469,-75,0,4,1,6
38283,2,2424,2219,205,0,309,0,6
38284,2,2424,2387,37,0,46,1,6
38285,2,2438,2271,167,0,340,1,8
38286,1,2483,2449,34,0,445,0,6
38287,1,2403,2441,-38,0,210,1,6
38289,1,2568,2481,87,0,101,1,6
38290,1,2463,2388,75,0,315,1,6
38291,2,2410,2537,-127,0,106,1,6
38292,1,2495,2340,155,0,45,1,6
38293,1,2612,2541,71,0,120,1,6
38294,1,2473,2350,123,0,469,0,6
38295,3,2415,2437,-22,0,40,0,6
38296,1,2526,2614,-88,0,120,0,6
38297,1,2432,2427,5,0,50,0,6
38298,3,2668,2556,112,0,278,0,6
38299,1,2571,2415,156,0,140,0,6
38300,1,2386,2427,-41,0,100,1,6
38301,1,2288,2458,-170,0,172,0,6
38302,1,2455,2372,83,0,106,0,6
38303,2,2384,2424,-40,0,1,0,6
38304,1,2652,2508,144,0,106,0,6
38305,1,2483,2481,2,0,373,0,6
38306,2,2406,2432,-26,0,30,1,6
38307,1,2413,2290,123,0,305,0,6
38308,2,2522,2382,140,0,40,0,6
38309,2,2406,2419,-13,0,49,0,6
38310,2,2444,2488,-44,0,300,0,6
38311,1,2519,2394,125,0,100,0,6
38312,1,2406,2216,190,4,335,0,13
38313,2,2530,2685,-155,0,406,1,6
38314,2,2598,2677,-79,0,150,0,6
38315,1,2532,2496,36,0,290,0,6
38316,1,2411,2259,152,0,22,0,6
38317,2,2415,2464,-49,0,302,0,6
38318,1,2435,2409,26,0,302,0,6
38319,1,2453,2370,83,0,125,0,6
38320,2,2429,2379,50,0,127,1,6
38321,1,2425,2400,25,0,1,0,6
38322,2,2476,2489,-13,0,111,0,6
38323,1,2403,2437,-34,0,310,1,6
38324,1,2413,2418,-5,0,1,1,6
38325,1,2558,2542,16,0,255,1,6
38326,2,2477,2573,-96,0,310,0,6
38327,1,2575,2407,168,0,101,0,6
38328,2,2539,2523,16,0,241,0,6
38329,1,2413,2237,176,0,46,0,6
38330,2,2383,2579,-196,0,41,0,6
38331,3,2370,2457,-87,0,15,0,6
38332,2,2607,2534,73,0,107,0,6
38333,1,2541,2441,100,0,0,0,6
38334,3,2536,2419,117,0,244,0,6
38335,2,2255,2476,-221,0,337,0,6
38336,2,2319,2450,-131,0,176,1,6
38337,2,2493,2616,-123,0,40,1,6
38338,1,2408,2350,58,0,102,0,8
38339,1,2423,2339,84,0,297,0,6
38340,2,2499,2378,121,0,6,0,6
38341,2,2390,2439,-49,0,4,0,6
38342,1,2438,2504,-66,0,40,0,6
38343,2,2656,2667,-11,0,154,1,6
38344,2,2421,2421,0,0,48,1,6
38345,2,2459,2382,77,0,106,0,6
38346,2,2558,2682,-124,0,33,0,6
38347,1,2396,2514,-118,0,241,0,6
38348,1,2593,2688,-95,0,108,0,6
38349,1,2437,2401,36,0,101,0,6
38350,1,2409,2395,14,0,14,0,6
38351,2,2594,2554,40,0,320,0,6
38352,2,2460,2449,11,0,247,0,6
38353,1,2395,2430,-35,0,49,1,6
38354,1,2365,2457,-92,0,107,0,6
38355,2,2407,2685,-278,0,267,0,6
38356,3,2360,2479,-119,0,406,0,6
38357,2,2545,2407,138,0,0,0,6
38358,1,2404,2440,-36,0,210,0,6
38359,1,2234,2416,-182,0,319,1,6
38360,2,2385,2423,-38,0,1,0,6
38361,2,2386,2431,-45,0,302,0,5
38362,3,2446,2382,64,0,326,0,6
38363,3,2381,2410,-29,0,380,0,6
38364,2,2470,2529,-59,0,241,0,6
38365,2,2379,2449,-70,0,205,0,6
38366,1,2517,2314,203,0,80,0,6
38367,2,2577,2473,104,0,113,0,6
38368,2,2498,2303,195,0,41,0,6
38369,2,2290,2409,-119,0,41,0,6
38370,1,2295,2430,-135,0,267,1,8
38371,2,2496,2301,195,0,155,0,6
38372,2,2455,2371,84,0,216,1,6
38373,1,2582,2492,90,0,102,0,6
38374,1,2541,2600,-59,0,101,0,6
38375,1,2648,2656,-8,0,154,0,6
38376,2,2431,2386,45,0,202,0,6
38377,1,2404,2255,149,0,212,1,6
38378,2,2415,2578,-163,0,28,0,6
38379,2,2335,2427,-92,0,43,0,6
38381,1,2404,2315,89,0,130,0,6
38382,1,2620,2498,122,0,106,1,6
38383,2,2402,2445,-43,0,109,0,6
38384,3,2672,2681,-9,0,108,0,6
38385,2,2396,2442,-46,0,30,0,6
38386,2,2333,2517,-184,4,30,0,13
38387,1,2489,2457,32,0,315,0,6
38388,1,2434,2411,23,0,302,0,6
38389,2,2311,2520,-209,0,142,0,6
38390,2,2358,2448,-90,0,16,0,6
38391,2,2535,2650,-115,0,110,0,6
38392,1,2428,2380,48,0,40,0,6
38393,2,2345,2526,-181,0,106,0,6
38394,2,2437,2450,-13,0,107,0,6
38395,1,2351,2416,-65,0,156,1,6
38396,2,2480,2570,-90,0,6,0,6
38397,1,2286,2412,-126,0,43,0,6
38398,2,2537,2521,16,0,0,1,6
38399,2,2373,2487,-114,0,102,0,6
38400,1,2415,2587,-172,0,101,1,6
38401,3,2439,2483,-44,2,347,0,25
38402,2,2490,2495,-5,0,117,0,6
38403,3,2369,2454,-85,0,400,0,6
38404,1,2466,2290,176,0,152,0,6
38405,2,2780,2687,93,0,33,0,6
38406,2,2410,2355,55,0,49,0,6
38407,1,2534,2405,129,0,184,0,6
38408,3,2253,2439,-186,0,331,0,6
38409,1,2413,2311,102,0,45,0,6
38410,2,2286,2408,-122,0,300,1,6
38411,1,2473,2517,-44,0,255,1,6
38412,2,2393,2424,-31,0,300,1,6
38413,1,2407,2242,165,0,46,0,6
38414,1,2422,2465,-43,0,388,0,6
38415,1,2594,2548,46,0,241,0,6
38416,1,2681,2587,94,0,13,1,6
38417,3,2228,2582,-354,0,46,0,6
38418,1,2454,2378,76,0,332,0,6
38419,2,2310,2488,-178,0,132,0,6
38420,2,2537,2564,-27,0,336,1,6
38421,2,2650,2654,-4,0,453,1,6
38422,1,2447,2391,56,0,405,0,6
38423,1,2375,2433,-58,0,1,1,6
38424,1,2523,2308,215,0,80,0,6
38425,1,2505,2417,88,0,45,0,6
38426,1,2531,2518,13,0,203,0,6
38427,1,2654,2600,54,0,132,0,6
38428,1,2455,2381,74,0,311,0,6
38429,1,2494,2493,1,0,131,0,6
38430,2,2543,2599,-56,0,101,0,6
38431,2,2306,2402,-96,4,40,0,13
38432,2,2365,2411,-46,0,48,0,6
38433,1,2531,2379,152,0,121,0,6
38434,2,2476,2495,-19,0,331,0,6
38435,1,2239,2411,-172,0,318,1,6
38436,2,2436,2294,142,0,131,0,5
38437,2,2405,2529,-124,0,113,0,6
38438,1,2432,2321,111,0,331,0,6
38439,1,2459,2428,31,0,200,0,6
38440,2,2285,2470,-185,0,46,1,6
38441,2,2404,2408,-4,0,8,0,6
38442,1,2502,2386,116,0,230,0,8
38443,2,2417,2268,149,0,45,0,6
38444,1,2436,2256,180,0,267,0,6
38445,3,2377,2460,-83,0,310,0,6
38446,1,2452,2403,49,0,5,0,6
38447,1,2567,2423,144,0,130,0,6
38448,1,2416,2537,-121,0,241,0,6
38449,1,2453,2369,84,0,134,0,6
38450,1,2527,2534,-7,0,302,1,6
38451,3,2561,2485,76,0,21,0,6
38452,1,2406,2376,30,0,337,0,6
38453,1,2512,2537,-25,0,48,1,6
38454,2,2458,2293,165,0,320,0,6
38455,2,2436,2624,-188,0,242,0,6
38456,3,2466,2412,54,0,172,0,6
38457,2,2603,2672,-69,0,123,0,6
38458,2,2398,2531,-133,0,455,1,6
38459,2,2510,2480,30,0,334,0,6
38460,1,2426,2382,44,0,487,0,6
38462,2,2420,2571,-151,0,106,0,6
38463,2,2500,2403,97,0,140,0,6
38464,1,2660,2644,16,0,123,0,6
38465,1,2430,2334,96,0,202,0,6
38466,2,2364,2487,-123,0,15,0,6
38467,2,2465,2307,158,0,433,1,6
38468,1,2685,2596,89,0,13,0,6
38469,1,2457,2325,132,0,117,0,6
38470,2,2377,2431,-54,0,1,0,6
38471,3,2253,2439,-186,0,344,0,6
38472,2,2246,2578,-332,0,110,1,6
38473,2,2604,2583,21,0,115,0,6
38474,2,2410,2411,-1,0,212,1,6
38475,1,2524,2221,303,4,250,0,13
38476,2,2409,2302,107,4,334,0,13
38477,1,2530,2701,-171,0,248,0,6
38478,3,2401,2450,-49,0,123,0,6
38479,2,2284,2409,-125,0,4,0,6
38480,1,2423,2464,-41,0,388,0,6
38481,2,2413,2369,44,0,45,0,6
38482,1,2533,2378,155,0,315,1,6
38483,2,2423,2401,22,0,249,0,6
38484,3,2342,2422,-80,0,40,0,6
38485,1,2453,2457,-4,0,2,1,6
38486,1,2473,2294,179,0,133,0,6
38487,1,2443,2436,7,0,43,0,6
38488,1,2486,2368,118,0,200,0,6
38489,2,2416,2599,-183,0,112,0,6
38490,1,2569,2531,38,0,115,0,6
38491,3,2344,2459,-115,0,6,0,6
38492,1,2492,2659,-167,0,41,0,6
38493,2,2399,2493,-94,0,40,0,6
38494,1,2449,2343,106,0,112,0,6
38495,3,2653,2639,14,0,382,0,6
38496,2,2464,2528,-64,0,128,1,6
38497,1,2690,2533,157,0,9,0,6
38498,1,2413,2387,26,0,200,0,6
38499,1,2436,2372,64,0,40,1,6
38500,2,2428,2349,79,0,115,0,5
38501,2,2531,2518,13,0,114,0,6
38502,1,2511,2461,50,0,344,0,6
38503,1,2465,2486,-21,0,485,0,6
38504,2,2627,2517,110,0,106,0,6
38505,1,2427,2432,-5,0,151,1,6
38506,1,2437,2256,181,0,176,0,6
38507,2,2535,2598,-63,0,0,0,6
38508,2,2316,2506,-190,0,123,0,8
38509,2,2508,2394,114,0,45,0,6
38510,2,2437,2538,-101,0,241,1,6
38511,1,2576,2356,220,4,106,0,13
38512,3,2306,2413,-107,2,33,0,18
38513,2,2497,2358,139,0,131,0,6
38514,1,2639,2677,-38,0,123,0,6
38515,2,2477,2398,79,0,197,0,6
38516,3,2348,2414,-66,0,256,0,6
38517,1,2248,2412,-164,0,176,0,8
38518,2,2375,2421,-46,0,40,1,6
38519,2,2693,2589,104,0,1,1,6
38520,2,2430,2536,-106,0,312,1,6
38521,1,2449,2282,167,0,414,0,6
38522,2,2445,2457,-12,0,385,0,6
38523,2,2458,2404,54,0,8,0,6
38524,1,2364,2490,-126,0,4,0,6
38525,1,2361,2418,-57,0,245,1,6
38526,1,2487,2385,102,0,100,0,6
38527,1,2451,2430,21,0,4,0,6
38528,3,2417,2492,-75,0,80,0,6
38529,2,2408,2459,-51,0,136,0,6
38530,2,2529,2693,-164,0,46,1,6
38531,2,2671,2651,20,0,115,0,6
38532,1,2375,2418,-43,0,310,0,6
38533,1,2602,2413,189,0,227,0,6
38534,2,2262,2402,-140,0,101,0,6
38535,1,2358,2410,-52,0,250,0,6
38536,1,2391,2471,-80,0,122,0,6
38537,2,2525,2548,-23,0,140,0,6
38538,1,2533,2453,80,0,200,1,6
38539,2,2500,2389,111,0,300,0,6
38540,2,2366,2402,-36,0,46,0,6
38541,2,2253,2440,-187,0,331,0,6
38542,1,2639,2653,-14,0,302,0,6
38543,1,2418,2516,-98,0,106,1,6
38544,1,2456,2343,113,0,255,0,6
38545,1,2646,2619,27,0,240,0,6
38546,1,2524,2480,44,0,107,0,6
38547,2,2410,2605,-195,0,107,0,6
38548,1,2580,2415,165,0,101,0,6
38549,2,2376,2491,-115,0,40,0,6
38550,1,2400,2358,42,0,302,1,6
38551,2,2368,2441,-73,0,1,0,6
38552,2,2425,2430,-5,0,140,0,6
38553,2,2426,2572,-146,0,20,1,6
38554,1,2645,2645,0,0,382,0,6
38555,1,2412,2388,24,0,101,1,6
38556,2,2489,2456,33,0,253,0,6
38557,1,2542,2603,-61,0,101,1,6
38558,2,2252,2406,-154,0,101,0,6
38559,1,2665,2549,116,0,42,0,6
38560,1,2521,2574,-53,0,8,0,6
38561,1,2464,2399,65,0,5,0,6
38562,2,2439,2526,-87,0,245,0,6
38563,1,2314,2413,-99,0,330,0,6
38564,1,2407,2319,88,4,127,0,13
38565,2,2282,2453,-171,0,170,0,6
38566,2,2403,2545,-142,0,288,0,6
38567,1,2471,2464,7,0,10,0,6
38568,2,2299,2413,-114,0,255,0,6
38569,1,2491,2381,110,0,311,0,6
38570,2,2475,2529,-54,0,106,1,6
38571,3,2614,2651,-37,0,120,0,6
38572,1,2669,2530,139,0,132,0,6
38573,2,2418,2318,100,0,344,1,6
38574,1,2413,2483,-70,0,81,1,6
38575,1,2371,2407,-36,0,190,0,6
38576,2,2257,2421,-164,0,46,0,5
38577,1,2361,2405,-44,0,101,0,6
38578,1,2443,2250,193,0,176,0,6
38579,2,2412,2451,-39,0,200,0,6
38580,1,2696,2526,170,0,9,0,6
38581,1,2685,2530,155,0,0,0,6
38582,1,2404,2322,82,0,106,0,8
38583,1,2458,2477,-19,0,2,0,6
38585,2,2550,2426,124,0,100,0,6
38586,2,2371,2493,-122,0,46,1,6
38587,2,2443,2538,-95,0,128,1,6
38588,1,2608,2407,201,0,311,0,6
38589,1,2447,2482,-35,0,187,0,6
38590,2,2363,2405,-42,0,1,0,6
38591,2,2483,2466,17,0,113,0,6
38592,2,2264,2426,-162,0,0,0,6
38593,2,2548,2463,85,0,228,0,6
38594,2,2456,2321,135,0,15,1,6
38595,2,2509,2540,-31,0,405,0,6
38596,2,2364,2436,-72,0,123,0,6
38597,1,2423,2469,-46,0,10,0,6
38598,2,2351,2580,-229,4,0,0,13
38599,1,2231,2409,-178,0,46,0,8
38600,1,2650,2615,35,0,242,1,6
38601,2,2560,2463,97,0,453,0,6
38602,3,2418,2295,123,0,302,0,6
38603,2,2457,2399,58,0,335,1,6
38604,3,2383,2469,-86,0,374,0,6
38605,1,2596,2549,47,0,241,0,6
38606,1,2554,2526,28,0,130,0,6
38607,3,2247,2445,-198,0,289,0,6
38608,3,2457,2495,-38,0,102,0,6
38609,3,2267,2411,-144,0,303,0,6
38610,1,2361,2425,-64,0,326,0,5
38611,2,2368,2477,-109,0,106,0,6
38612,1,2464,2456,8,0,3,0,6
38613,1,2470,2527,-57,0,106,0,6
38614,2,2441,2360,81,0,0,0,6
38616,2,2446,2339,107,0,309,1,6
38617,2,2351,2412,-61,0,255,0,6
38618,1,2280,2420,-140,0,41,0,6
38619,1,2376,2476,-100,0,4,0,6
38620,1,2230,2430,-200,0,100,1,6
38621,2,2407,2364,43,0,455,0,6
38622,2,2523,2542,-19,0,46,0,6
38623,1,2545,2454,91,0,464,1,6
38624,2,2504,2359,145,0,311,1,6
38625,1,2407,2345,62,0,120,0,6
38626,1,2542,2434,108,0,200,0,6
38627,3,2377,2403,-26,0,132,0,6
38628,2,2373,2429,-56,0,40,0,6
38629,1,2470,2418,52,0,4,0,6
38630,2,2535,2395,140,0,107,1,6
38631,2,2469,2353,116,0,106,1,6
38633,2,2262,2584,-322,0,118,0,6
38634,1,2376,2505,-129,0,4,0,6
38635,2,2403,2477,-74,0,312,0,6
38636,1,2530,2471,59,0,404,0,6
38637,2,2462,2448,14,0,466,0,6
38638,2,2395,2464,-69,0,300,0,6
38639,1,2429,2378,51,0,103,0,6
38640,2,2222,2401,-179,0,101,0,6
38641,1,2414,2434,-20,0,100,0,6
38642,1,2327,2430,-103,0,268,0,8
38643,2,2367,2439,-72,0,152,0,6
38644,1,2494,2384,110,0,405,0,6
38645,2,2580,2559,21,0,57,1,6
38646,1,2450,2470,-20,0,4,0,6
38647,3,2460,2469,-9,0,46,0,6
38648,1,2477,2406,71,0,302,0,6
38649,2,2434,2368,66,0,0,0,6
38650,2,2392,2426,-34,0,44,0,6
38651,2,2550,2475,75,0,310,0,6
38652,1,2388,2413,-25,0,275,0,6
38653,2,2292,2468,-176,0,100,0,6
38654,1,2412,2347,65,0,45,0,6
38655,1,2413,2209,204,4,5,0,17
38656,2,2401,2457,-56,0,4,0,6
38657,1,2470,2346,124,0,426,0,6
38658,1,2600,2545,55,0,241,0,6
38659,2,2529,2400,129,0,344,0,8
38660,1,2547,2482,65,0,136,0,6
38661,1,2425,2546,-121,0,184,0,6
38662,1,2332,2412,-80,0,341,0,6
38663,1,2640,2656,-16,0,409,0,6
38664,1,2349,2415,-66,0,40,0,6
38665,2,2297,2416,-119,0,2,0,6
38666,2,2369,2553,-184,0,277,0,6
38667,3,2243,2404,-161,0,209,0,6
38668,1,2438,2384,54,0,331,0,6
38669,2,2464,2456,8,0,3,0,6
38670,3,2524,2518,6,0,302,0,6
38671,1,2428,2496,-68,0,373,0,6
38672,1,2528,2384,144,0,4,0,6
38673,1,2454,2346,108,0,25,0,6
38674,3,2403,2360,43,0,122,0,6
38675,1,2352,2439,-87,0,140,0,6
38676,2,2283,2431,-148,0,312,0,6
38677,1,2417,2240,177,0,1,1,6
38678,2,2411,2584,-173,4,194,1,13
38679,2,2299,2461,-162,0,106,0,6
38680,1,2505,2401,104,0,300,1,6
38681,2,2297,2434,-137,0,125,0,6
38682,3,2502,2518,-16,0,0,0,6
38683,3,2464,2373,91,0,120,0,6
38684,2,2409,2586,-177,0,13,0,6
38685,1,2482,2466,16,0,302,0,6
38687,1,2498,2469,29,0,80,0,6
38688,1,2416,2318,98,0,122,0,6
38689,2,2258,2427,-169,0,40,0,6
38690,1,2417,2374,43,0,45,0,6
38691,1,2462,2396,66,0,152,0,6
38692,2,2481,2469,12,0,303,0,6
38693,1,2482,2543,-61,0,8,0,6
38694,1,2578,2425,153,0,120,1,6
38695,1,2540,2605,-65,0,340,1,6
38696,1,2489,2364,125,0,130,0,6
38697,1,2650,2646,4,0,125,0,6
38698,2,2314,2434,-120,0,140,0,6
38699,2,2435,2395,40,0,57,1,6
38700,1,2477,2438,39,0,103,0,6
38701,1,2443,2287,156,0,112,0,6
38702,1,2363,2449,-86,0,242,0,6
38703,2,2432,2400,32,0,110,0,6
38704,1,2573,2500,73,0,330,0,6
38705,3,2346,2413,-67,0,386,0,8
38706,2,2355,2443,-88,0,301,0,6
38707,1,2468,2316,152,4,100,0,8
38708,2,2477,2532,-55,0,112,0,6
38709,2,2458,2441,17,0,3,0,6
38710,2,2309,2442,-133,0,302,1,6
38711,2,2364,2538,-174,0,128,0,6
38712,1,2309,2438,-129,0,484,1,6
38713,2,2421,2268,153,0,0,0,8
38714,1,2463,2408,55,0,120,0,6
38715,1,2421,2320,101,0,202,0,6
38716,1,2527,2517,10,0,331,0,6
38717,2,2576,2521,55,0,13,0,6
38718,1,2387,2493,-106,0,45,1,6
38719,1,2640,2655,-15,0,453,0,6
38721,2,2431,2307,124,0,0,0,6
38722,1,2468,2479,-11,0,120,0,6
38723,2,2408,2388,20,0,253,0,8
38724,1,2259,2403,-144,0,45,0,6
38725,3,2397,2475,-78,0,242,0,6
38726,2,2269,2422,-153,0,107,0,6
38727,1,2523,2549,-26,0,244,1,6
38728,2,2460,2487,-27,0,394,0,6
38729,3,2283,2446,-163,0,344,0,6
38730,2,2448,2509,-61,0,242,1,6
38731,2,2537,2472,65,0,138,0,6
38732,2,2366,2422,-56,0,62,0,6
38733,2,2542,2360,182,0,121,1,6
38734,1,2488,2469,19,0,7,0,6
38735,1,2598,2547,51,0,241,1,6
38736,2,2367,2484,-117,0,200,1,6
38737,2,2473,2373,100,0,45,0,6
38738,1,2391,2467,-76,0,8,0,6
38739,2,2423,2333,90,0,0,0,6
38740,2,2428,2271,157,0,402,0,6
38741,2,2401,2426,-25,0,140,1,6
38742,2,2406,2362,44,0,374,0,6
38743,3,2417,2252,165,0,419,0,6
38744,2,2496,2578,-82,0,49,0,6
38745,1,2443,2286,157,0,190,0,6
38746,2,2434,2399,35,0,335,0,6
38747,1,2589,2374,215,0,200,0,6
38748,1,2650,2646,4,0,125,0,6
38749,1,2462,2361,101,0,4,0,6
38750,2,2453,2452,1,0,127,0,6
38751,2,2582,2582,0,0,101,1,6
38752,1,2403,2468,-65,0,228,1,6
38753,1,2446,2387,59,0,101,0,6
38754,1,2512,2532,-20,0,302,0,6
38755,2,2306,2425,-119,0,107,0,6
38756,2,2400,2482,-82,0,126,1,6
38757,1,2385,2401,-16,0,255,0,6
38758,2,2441,2484,-43,0,106,0,6
38759,1,2425,2318,107,0,122,0,6
38760,1,2430,2390,40,0,107,1,6
38761,2,2565,2582,-17,0,228,0,6
38762,3,2444,2283,161,0,320,0,6
38763,1,2591,2400,191,0,131,0,6
38764,1,2463,2287,176,0,45,0,6
38765,1,2526,2518,8,0,311,0,6
38766,1,2420,2364,56,0,485,0,6
38767,1,2486,2494,-8,0,303,1,6
38768,1,2474,2299,175,0,466,1,6
38769,1,2416,2340,76,0,193,0,6
38770,1,2422,2416,6,0,200,0,6
38771,2,2640,2655,-15,0,192,0,6
38772,1,2410,2409,1,0,252,0,6
38773,2,2399,2437,-38,0,61,0,6
38774,3,2411,2356,55,0,46,0,8
38775,2,2283,2447,-164,0,344,0,6
38776,1,2530,2549,-19,0,202,0,6
38777,2,2362,2426,-64,0,310,0,6
38778,1,2353,2443,-90,0,35,0,6
38779,1,2394,2402,-8,0,414,0,8
38780,1,2430,2429,1,0,426,1,6
38781,2,2400,2514,-114,0,302,0,6
38782,2,2343,2454,-111,0,202,0,6
38783,1,2489,2488,1,0,18,0,6
38784,1,2369,2430,-61,0,101,0,6
38785,1,2458,2442,16,0,3,1,6
38786,2,2363,2466,-103,0,242,0,6
38787,1,2542,2603,-61,0,101,0,6
38788,1,2381,2424,-43,0,49,0,6
38789,1,2409,2295,114,0,113,0,6
38790,1,2255,2414,-159,0,132,0,6
38791,2,2491,2483,8,0,43,0,6
38792,2,2533,2431,102,0,122,1,6
38793,2,2512,2532,-20,0,40,0,6
38794,1,2451,2294,157,0,277,0,6
38795,2,2405,2422,-17,0,101,0,6
38796,2,2588,2399,189,0,112,0,6
38797,1,2396,2427,-31,0,118,0,6
38798,2,2357,2413,-56,0,1,0,6
38799,2,2442,2448,-6,0,0,0,6
38800,2,2376,2425,-49,0,130,0,6
38801,1,2466,2302,164,0,45,1,6
38802,3,2271,2594,-323,0,301,0,6
38803,2,2286,2467,-181,0,0,1,6
38804,1,2470,2512,-42,0,46,0,6
38805,2,2281,2461,-180,0,107,0,6
38806,3,2518,2537,-19,0,45,0,6
38807,1,2410,2435,-25,0,123,1,6
38808,1,2357,2427,-70,0,218,0,6
38809,2,2253,2421,-168,0,327,0,6
38810,2,2661,2635,26,0,372,0,6
38811,2,2414,2485,-71,0,330,0,6
38812,1,2489,2349,140,0,200,0,6
38813,2,2429,2582,-153,0,45,0,6
38814,1,2458,2339,119,0,302,1,6
38815,1,2423,2535,-112,0,202,0,6
38816,2,2376,2436,-60,0,188,1,6
38817,1,2437,2262,175,0,0,1,6
38818,1,2457,2495,-38,0,302,1,6
38819,1,2590,2408,182,0,101,0,6
38820,2,2352,2410,-58,0,1,0,6
38821,1,2435,2488,-53,0,244,0,6
38822,1,2403,2393,10,0,100,0,6
38823,2,2389,2416,-27,0,40,0,6
38824,2,2518,2431,87,0,43,0,6
38825,3,2367,2415,-48,0,46,0,6
38826,2,2596,2549,47,0,245,0,6
38827,2,2537,2507,30,0,331,1,6
38828,3,2427,2395,32,0,206,0,6
38829,1,2432,2464,-32,0,127,0,6
38830,2,2528,2560,-32,0,132,0,6
38831,2,2400,2406,-6,0,207,1,6
38832,1,2452,2383,69,0,40,1,6
38833,2,2285,2477,-192,0,17,0,6
38834,1,2267,2468,-201,4,200,0,13
38835,1,2439,2300,139,0,177,0,6
38836,2,2296,2454,-158,0,247,1,6
38837,1,2415,2430,-15,0,0,0,6
38838,1,2487,2502,-15,0,207,0,6
38839,2,2378,2464,-86,0,107,0,6
38840,1,2588,2408,180,4,205,1,13
38841,1,2400,2351,49,0,310,1,8
38842,2,2526,2438,88,0,102,1,6
38843,1,2477,2408,69,0,300,0,6
38844,1,2470,2374,96,0,111,0,6
38845,3,2470,2383,87,0,40,0,6
38846,1,2565,2523,42,0,100,0,6
38847,2,2408,2579,-171,0,224,0,6
38848,1,2249,2421,-172,0,111,0,6
38849,1,2340,2413,-73,0,135,0,6
38850,1,2340,2423,-83,0,255,0,6
38852,2,2311,2401,-90,0,45,0,8
38853,1,2429,2395,34,0,11,0,6
38854,1,2481,2416,65,0,41,0,6
38855,2,2351,2521,-170,0,476,1,6
38856,2,2537,2518,19,0,110,0,6
38857,2,2489,2467,22,0,5,0,6
38858,1,2470,2401,69,0,205,0,6
38859,1,2364,2491,-127,0,300,1,6
38860,3,2457,2444,13,0,207,0,6
38861,1,2511,2474,37,0,335,0,6
38862,2,2556,2590,-34,0,134,1,6
38863,1,2441,2393,48,0,490,0,6
38864,1,2442,2560,-118,0,143,0,6
38865,1,2413,2569,-156,0,100,1,6
38866,3,2370,2440,-70,0,46,0,6
38867,2,2424,2426,-2,0,41,0,6
38868,1,2422,2379,43,0,46,1,6
38869,1,2606,2592,14,0,250,0,6
38870,2,2244,2411,-167,0,15,0,6
38871,1,2482,2586,-104,0,5,1,6
38872,2,2405,2441,-36,0,224,0,6
38873,2,2422,2409,13,0,227,0,6
38874,1,2418,2348,70,0,106,1,6
38875,2,2427,2314,113,0,143,0,6
38876,1,2513,2531,-18,0,302,0,6
38877,2,2239,2470,-231,0,113,0,8
38878,2,2347,2481,-134,0,226,0,6
38879,2,2578,2583,-5,0,123,0,6
38880,1,2403,2303,100,0,4,0,6
38881,1,2405,2253,152,0,205,0,8
38882,1,2458,2399,59,0,190,0,6
38883,2,2410,2371,39,0,106,0,6
38884,2,2222,2417,-195,0,269,0,5
38885,2,2394,2420,-26,0,80,0,6
38886,1,2445,2394,51,0,221,1,6
38887,1,2489,2519,-30,0,301,0,6
38888,1,2469,2402,67,0,229,0,6
38889,2,2446,2474,-28,0,202,0,6
38890,3,2448,2414,34,0,113,0,6
38891,1,2534,2468,66,0,440,0,6
38892,2,2474,2222,252,0,8,0,6
38893,2,2388,2446,-58,0,156,0,6
38894,2,2586,2611,-25,0,454,0,6
38895,1,2556,2370,186,0,311,0,6
38896,1,2524,2421,103,0,0,0,6
38897,1,2367,2407,-40,0,8,0,6
38898,1,2441,2479,-38,0,143,0,6
38899,1,2415,2388,27,0,132,0,6
38900,2,2469,2516,-47,0,194,0,6
38901,2,2411,2489,-78,0,330,0,6
38902,1,2432,2434,-2,0,45,1,6
38903,2,2390,2419,-29,0,7,0,6
38904,2,2345,2486,-141,0,8,0,6
38905,2,2265,2594,-329,0,61,1,6
38906,1,2480,2323,157,0,44,0,6
38907,2,2477,2524,-47,0,346,1,6
38908,2,2395,2439,-44,0,45,1,6
38909,3,2423,2348,75,0,112,0,6
38910,1,2553,2412,141,0,21,0,6
38911,2,2471,2510,-39,0,7,0,6
38912,1,2444,2457,-13,0,136,0,6
38913,1,2473,2237,236,0,1,0,8
38914,2,2595,2551,44,0,245,1,6
38915,2,2484,2583,-99,0,48,1,6
38916,1,2365,2464,-99,0,138,0,6
38918,1,2485,2391,94,0,45,0,6
38919,1,2423,2305,118,0,485,0,6
38920,1,2405,2308,97,0,414,0,8
38922,2,2528,2588,-60,0,0,0,6
38923,2,2489,2419,70,0,302,1,6
38924,2,2352,2421,-69,0,112,0,6
38925,3,2407,2491,-84,0,327,0,6
38926,1,2206,2407,-201,0,101,0,6
38927,1,2371,2462,-91,0,242,0,6
38928,2,2415,2393,22,0,101,1,6
38929,2,2378,2416,-38,0,373,0,6
38930,2,2343,2423,-80,0,1,0,6
38931,2,2403,2450,-47,0,46,0,6
38932,1,2377,2404,-27,0,57,0,6
38933,2,2473,2315,158,0,454,1,6
38934,2,2473,2448,25,0,229,0,6
38935,2,2626,2641,-15,0,45,0,6
38936,1,2493,2407,86,0,483,0,6
38937,1,2395,2502,-107,0,303,0,6
38938,2,2513,2386,127,0,102,1,6
38939,1,2389,2489,-100,0,242,0,6
38940,2,2258,2438,-180,0,41,0,6
38941,2,2416,2347,69,0,106,0,6
38942,2,2451,2454,-3,0,3,0,6
38943,2,2412,2424,-12,0,312,0,6
38944,2,2401,2385,16,0,474,0,6
38945,1,2424,2293,131,0,46,0,6
38946,1,2302,2401,-99,0,115,0,6
38947,1,2429,2383,46,0,15,0,6
38948,1,2342,2450,-108,0,6,0,6
38949,1,2402,2243,159,4,45,0,13
38950,1,2390,2427,-37,0,45,0,6
38951,1,2339,2421,-82,0,1,0,6
38952,2,2336,2464,-128,0,320,0,6
38953,2,2265,2507,-242,0,404,1,6
38954,2,2367,2556,-189,0,60,0,6
38955,2,2354,2529,-175,0,242,0,6
38956,2,2557,2589,-32,0,122,1,6
38957,2,2487,2444,43,0,45,1,6
38958,3,2380,2409,-29,0,254,0,8
38959,2,2454,2469,-15,0,244,0,6
38960,3,2337,2467,-130,0,405,0,6
38961,2,2364,2480,-116,0,53,0,6
38962,1,2483,2402,81,0,261,0,6
38964,1,2457,2378,79,0,147,1,6
38965,1,2404,2520,-116,0,122,0,6
38966,1,2409,2370,39,0,115,0,8
38967,2,2308,2466,-158,0,5,0,6
38968,1,2432,2329,103,4,115,1,13
38969,1,2228,2402,-174,0,103,0,6
38970,2,2379,2434,-55,0,64,0,6
38971,2,2363,2426,-63,0,307,0,6
38972,1,2520,2525,-5,0,46,0,6
38973,1,2455,2482,-27,0,310,0,6
38974,2,2455,2445,10,0,277,0,6
38975,1,2381,2427,-46,0,484,0,6
38976,2,2235,2475,-240,0,113,0,8
38977,2,2561,2593,-32,0,374,0,6
38978,2,2274,2426,-152,0,330,0,6
38979,1,2647,2620,27,0,311,0,6
38980,1,2596,2389,207,0,118,0,6
38981,1,2482,2483,-1,0,45,0,6
38982,2,2441,2418,23,0,45,0,6
38983,2,2336,2465,-129,0,380,1,6
38984,2,2327,2427,-100,0,13,0,6
38985,2,2414,2285,129,0,0,1,6
38986,2,2477,2448,29,0,302,0,6
38987,1,2421,2397,24,0,245,0,6
38988,2,2464,2446,18,0,136,1,6
38989,1,2421,2409,12,0,242,0,6
38990,2,2402,2498,-96,0,302,0,6
38991,2,2394,2429,-35,0,302,0,6
38992,1,2255,2411,-156,0,241,0,6
38993,1,2269,2410,-141,0,463,1,6
38994,1,2505,2545,-40,0,106,0,6
38995,1,2414,2220,194,0,135,0,6
38996,2,2610,2581,29,0,374,0,6
38997,2,2450,2406,44,0,0,1,6
38998,2,2346,2464,-118,0,1,0,6
38999,3,2431,2334,97,0,240,0,6
39000,2,2532,2484,48,0,45,0,6
39001,2,2443,2387,56,0,121,0,6
39002,1,2391,2531,-140,0,103,0,6
39003,1,2587,2389,198,0,112,0,6
39004,1,2594,2552,42,0,245,0,6
39005,1,2587,2604,-17,0,107,0,6
39006,1,2468,2435,33,0,106,0,6
39007,1,2435,2266,169,0,327,0,6
39008,1,2431,2433,-2,0,204,0,6
39010,1,2389,2461,-72,0,45,0,6
39011,3,2519,2525,-6,0,330,0,6
39012,1,2439,2398,41,0,14,0,6
39013,2,2519,2511,8,0,332,0,6
39014,1,2468,2333,135,0,344,0,6
39015,3,2409,2408,1,0,122,0,6
39016,1,2471,2341,130,0,101,0,6
39017,1,2558,2444,114,0,16,1,6
39018,1,2400,2354,46,0,5,0,6
39020,1,2399,2459,-60,0,4,1,6
39021,1,2462,2466,-4,0,441,0,6
39022,2,2240,2405,-165,4,140,0,13
39023,1,2429,2330,99,0,45,0,6
39024,1,2486,2474,12,0,201,0,6
39025,2,2401,2275,126,0,212,1,6
39026,2,2301,2428,-127,0,113,0,6
39027,2,2469,2488,-19,0,45,0,6
39028,2,2455,2468,-13,0,253,0,6
39029,2,2403,2531,-128,0,122,0,6
39030,1,2547,2599,-52,0,340,0,6
39032,2,2284,2426,-142,0,102,0,6
39033,2,2409,2265,144,0,414,0,8
39034,1,2407,2318,89,0,0,0,6
39035,2,2485,2568,-83,0,46,0,6
39036,1,2468,2421,47,0,40,0,6
39037,1,2517,2513,4,0,140,1,6
39038,1,2379,2426,-47,0,40,1,6
39039,1,2403,2393,10,0,100,0,6
39040,3,2408,2427,-19,0,123,0,6
39041,1,2411,2429,-18,0,0,0,6
39042,1,2526,2382,144,0,45,0,6
39043,1,2490,2313,177,0,332,0,6
39044,2,2227,2402,-175,0,49,0,6
39045,2,2389,2444,-55,0,4,0,6
39046,1,2456,2337,119,4,101,0,13
39047,1,2429,2347,82,0,40,0,6
39048,1,2637,2419,218,0,470,0,6
39049,2,2493,2598,-105,0,45,0,6
39050,1,2477,2232,245,0,1,0,8
39051,1,2476,2449,27,0,10,0,6
39052,1,2368,2437,-69,0,101,0,6
39053,1,2506,2346,160,0,108,0,6
39054,3,2598,2759,-161,0,409,0,6
39055,1,2430,2562,-132,0,141,0,6
39056,2,2363,2440,-77,0,123,0,6
39057,2,2414,2511,-97,0,122,0,6
39058,2,2383,2436,-53,0,101,0,6
39059,3,2417,2387,30,0,101,0,6
39060,1,2593,2554,39,0,267,0,6
39061,1,2359,2468,-109,0,156,0,6
39062,2,2483,2386,97,0,310,1,6
39063,2,2480,2351,129,0,40,0,6
39064,1,2410,2408,2,0,133,0,6
39065,1,2539,2423,116,0,9,0,6
39066,2,2403,2263,140,0,0,0,6
39067,1,2573,2520,53,0,62,0,6
39068,1,2436,2621,-185,0,241,0,6
39069,2,2392,2529,-137,0,242,1,6
39070,3,2535,2469,66,0,49,0,6
39071,1,2492,2478,14,0,123,1,6
39072,1,2466,2473,-7,0,385,0,6
39073,2,2444,2484,-40,0,253,1,6
39074,1,2414,2591,-177,0,300,1,6
39075,1,2250,2405,-155,0,106,1,6
39076,1,2444,2351,93,0,13,0,6
39077,1,2423,2382,41,0,115,0,6
39078,1,2424,2307,117,0,132,0,6
39079,1,2516,2490,26,0,167,0,8
39080,2,2640,2460,180,0,335,0,6
39081,1,2493,2336,157,0,302,0,6
39082,1,2574,2559,15,0,255,1,6
39083,1,2523,2489,34,0,256,1,6
39084,2,2440,2513,-73,0,45,0,6
39085,2,2349,2409,-60,0,255,0,6
39086,1,2420,2409,11,0,250,0,6
39087,1,2602,2519,83,0,380,0,6
39088,2,2289,2449,-160,0,100,0,6
39089,1,2401,2234,167,0,56,0,8
39090,3,2515,2409,106,0,409,0,6
39091,1,2601,2507,94,0,411,0,6
39092,2,2416,2468,-52,0,123,0,6
39093,2,2509,2438,71,0,103,0,6
39094,2,2227,2406,-179,0,455,0,6
39095,1,2756,2590,166,0,316,0,6
39096,1,2343,2416,-73,0,122,0,6
39097,1,2549,2598,-49,0,310,0,6
39098,2,2430,2460,-30,0,123,0,6
39099,1,2615,2656,-41,0,45,0,6
39100,1,2430,2396,34,0,110,0,6
39101,2,2403,2415,-12,0,123,0,6
39102,2,2348,2613,-265,0,1,0,6
39103,1,2441,2534,-93,0,121,0,6
39104,1,2454,2327,127,0,132,0,6
39105,3,2422,2593,-171,4,474,0,13
39106,2,2276,2470,-194,0,245,0,6
39107,2,2435,2453,-18,0,106,0,6
39108,3,2515,2578,-63,0,101,0,6
39109,1,2469,2632,-163,0,192,0,6
39110,1,2421,2476,-55,0,101,0,6
39111,1,2568,2265,303,0,394,0,8
39112,1,2402,2377,25,0,21,0,6
39114,1,2431,2297,134,0,150,1,6
39115,1,2362,2595,-233,0,448,0,6
39116,2,2320,2402,-82,0,41,0,6
39117,2,2388,2497,-109,0,141,0,6
39118,2,2473,2435,38,0,307,0,6
39119,3,2393,2449,-56,0,45,0,6
39120,1,2491,2439,52,0,16,0,6
39121,1,2336,2436,-100,0,233,0,6
39122,1,2465,2302,163,0,107,0,6
39123,1,2515,2607,-92,0,112,0,6
39124,3,2325,2440,-115,4,302,0,13
39125,1,2469,2428,41,0,127,0,6
39126,2,2396,2429,-33,0,277,0,6
39127,3,2360,2481,-121,0,40,0,6
39128,2,2650,2479,171,0,1,0,6
39129,1,2484,2385,99,0,300,0,6
39130,1,2409,2437,-28,0,101,0,6
39131,1,2264,2404,-140,0,264,1,8
39132,2,2528,2622,-94,0,110,0,6
39134,3,2399,2409,-10,0,45,0,6
39135,2,2516,2503,13,0,0,0,6
39136,2,2292,2419,-127,0,211,0,6
39137,2,2411,2514,-103,0,122,0,6
39138,2,2371,2407,-36,0,45,0,6
39139,2,2477,2510,-33,0,181,0,6
39140,2,2591,2555,36,0,267,0,6
39141,1,2386,2426,-40,0,373,0,6
39142,1,2403,2387,16,0,100,0,6
39143,1,2386,2442,-56,0,40,0,6
39144,1,2409,2336,73,4,215,0,13
39145,1,2465,2422,43,0,120,0,6
39146,2,2592,2585,7,0,43,1,6
39147,2,2332,2570,-238,0,142,0,8
39148,2,2291,2448,-157,0,121,0,6
39149,2,2458,2429,29,0,103,0,6
39150,1,2474,2321,153,0,100,0,6
39151,1,2406,2315,91,0,107,1,6
39152,1,2354,2408,-54,0,414,1,6
39153,2,2385,2471,-86,0,302,0,6
39154,3,2346,2428,-82,0,300,0,6
39155,1,2466,2455,11,0,365,0,6
39156,1,2413,2312,101,0,455,0,6
39157,2,2220,2587,-367,0,46,0,6
39158,1,2434,2497,-63,0,1,0,6
39159,1,2431,2213,218,0,40,0,6
39160,2,2297,2425,-128,0,269,0,6
39161,3,2371,2485,-114,0,330,0,8
39162,2,2435,2393,42,0,105,0,6
39163,1,2600,2522,78,0,125,0,6
39164,2,2605,2641,-36,0,40,0,6
39165,1,2413,2329,84,0,16,1,6
39166,1,2439,2304,135,0,341,0,6
39167,1,2488,2587,-99,0,240,0,6
39168,1,2409,2293,116,0,15,1,6
39169,2,2399,2501,-102,0,45,0,6
39170,2,2405,2473,-68,0,101,0,6
39171,1,2652,2737,-85,0,41,1,6
39172,2,2384,2488,-104,0,242,0,6
39173,1,2529,2497,32,0,300,0,6
39174,1,2423,2474,-51,0,118,0,6
39175,2,2394,2469,-75,0,45,0,6
39176,2,2378,2508,-130,0,45,1,6
39177,1,2330,2448,-118,0,50,1,6
39178,1,2299,2466,-167,0,16,1,6
39179,1,2381,2472,-91,0,310,0,6
39180,1,2442,2305,137,0,207,0,6
39181,1,2479,2362,117,0,153,0,6
39182,2,2320,2460,-140,0,200,1,6
39183,3,2588,2372,216,0,250,0,6
39184,1,2515,2472,43,0,46,0,6
39185,1,2626,2524,102,0,300,0,6
39186,3,2510,2600,-90,0,386,0,6
39187,2,2509,2647,-138,0,40,1,6
39188,2,2562,2585,-23,0,101,1,6
39189,2,2476,2391,85,0,143,0,6
39190,2,2327,2434,-107,0,14,0,6
39191,2,2308,2417,-109,0,140,1,6
39192,2,2203,2416,-213,0,134,1,6
39193,2,2452,2445,7,0,101,0,6
39194,1,2473,2288,185,0,459,0,6
39195,3,2449,2477,-28,0,112,0,6
39197,2,2419,2409,10,0,240,1,6
39198,1,2505,2392,113,0,46,0,6
39200,1,2489,2320,169,0,15,0,6
39201,1,2452,2303,149,0,140,0,6
39202,1,2468,2429,39,0,45,0,6
39203,2,2443,2425,18,0,4,0,6
39204,1,2417,2478,-61,0,300,1,6
39205,1,2573,2370,203,0,40,0,8
39206,1,2438,2400,38,0,345,1,6
39207,1,2414,2344,70,0,106,0,6
39208,2,2493,2441,52,0,270,0,6
39209,2,2293,2435,-142,0,113,0,6
39210,2,2488,2591,-103,0,43,1,6
39211,1,2413,2275,138,0,13,0,6
39212,1,2292,2478,-186,4,386,0,8
39213,2,2518,2604,-86,0,130,0,6
39214,2,2300,2456,-156,0,106,0,6
39215,1,2659,2445,214,0,46,0,6
39216,2,2391,2520,-129,0,122,0,6
39217,1,2419,2262,157,0,122,0,6
39218,2,2351,2473,-122,0,121,0,6
39219,2,2579,2630,-51,0,112,0,6
39220,1,2451,2390,61,0,111,0,6
39221,2,2458,2492,-34,0,54,0,6
39222,1,2398,2441,-43,0,48,1,6
39223,2,2426,2380,46,0,278,0,6
39224,2,2358,2483,-125,0,40,0,6
39225,2,2440,2308,132,0,20,1,6
39226,1,2417,2323,94,0,337,0,6
39227,2,2399,2469,-70,0,331,0,6
39228,1,2420,2240,180,0,176,0,6
39229,1,2453,2310,143,4,101,0,13
39230,3,2423,2255,168,0,359,0,6
39231,2,2555,2467,88,0,21,0,6
39232,2,2650,2495,155,0,1,0,6
39233,1,2476,2387,89,0,337,0,6
39234,3,2410,2201,209,2,326,0,25
39235,1,2383,2464,-81,0,0,0,6
39236,3,2476,2450,26,0,45,0,6
39237,1,2424,2473,-49,0,247,1,6
39238,2,2505,2511,-6,0,61,1,6
39239,2,2285,2411,-126,0,4,0,8
39240,2,2591,2556,35,0,245,0,6
39241,1,2402,2295,107,0,101,0,6
39242,3,2481,2510,-29,0,453,0,6
39243,2,2438,2321,117,0,250,0,6
39244,2,2387,2453,-66,0,132,0,6
39245,1,2416,2492,-76,0,200,0,6
39246,1,2385,2403,-18,0,45,0,6
39247,1,2442,2470,-28,0,245,1,6
39248,1,2448,2486,-38,0,4,0,6
39249,2,2392,2437,-45,0,302,1,6
39250,2,2405,2364,41,0,241,0,6
39251,3,2599,2574,25,0,306,0,6
39252,1,2443,2431,12,0,487,1,6
39253,2,2419,2207,212,4,306,1,13
39254,2,2374,2409,-35,0,129,0,6
39255,1,2609,2514,95,0,207,1,6
39256,2,2271,2416,-145,0,113,0,6
39257,2,2490,2354,136,0,152,0,6
39258,1,2318,2470,-152,0,278,0,6
39259,1,2462,2344,118,0,101,0,6
39260,1,2635,2601,34,0,45,0,6
39261,2,2595,2483,112,0,45,0,6
39262,1,2258,2422,-164,0,270,1,6
39263,2,2209,2575,-366,0,141,0,8
39264,1,2414,2406,8,0,113,0,6
39265,2,2319,2421,-102,0,4,0,6
39266,1,2477,2392,85,0,52,1,6
39268,1,2457,2439,18,0,210,0,6
39269,1,2453,2391,62,0,315,1,6
39270,2,2296,2452,-156,0,268,0,6
39271,2,2498,2642,-144,0,40,0,6
39272,2,2450,2475,-25,0,210,0,6
39273,2,2485,2394,91,0,37,0,6
39274,2,2322,2414,-92,0,43,0,8
39275,2,2563,2584,-21,0,348,0,6
39276,2,2383,2462,-79,0,263,1,6
39277,1,2480,2454,26,0,133,1,6
39278,3,2433,2342,91,0,10,0,6
39279,1,2410,2398,12,0,46,0,6
39280,3,2329,2430,-101,0,302,0,6
39281,1,2583,2517,66,0,221,0,6
39282,2,2260,2481,-221,0,31,0,6
39283,1,2332,2463,-131,4,136,0,13
39284,2,2473,2466,7,0,200,1,6
39285,2,2474,2502,-28,0,141,0,6
39286,2,2485,2445,40,0,30,0,6
39287,1,2423,2462,-39,0,200,0,6
39288,2,2493,2500,-7,0,43,0,6
39289,2,2512,2588,-76,0,241,0,6
39290,1,2411,2434,-23,0,200,0,6
39291,1,2662,2719,-57,0,330,0,6
39292,2,2459,2443,16,0,152,0,6
39293,1,2430,2340,90,0,442,0,6
39294,1,2442,2323,119,0,40,0,6
39295,1,2509,2483,26,0,20,0,6
39296,3,2464,2448,16,0,102,0,6
39297,2,2273,2404,-131,0,250,0,6
39298,2,2393,2416,-23,0,8,1,6
39299,1,2427,2449,-22,0,133,0,6
39300,2,2234,2406,-172,0,250,0,6
39301,1,2595,2640,-45,0,331,0,6
39302,2,2509,2613,-104,0,200,0,6
39303,2,2493,2588,-95,0,43,0,6
39304,1,2317,2439,-122,0,114,0,6
39305,2,2646,2456,190,0,22,0,6
39306,3,2494,2425,69,0,45,0,6
39307,2,2482,2385,97,0,487,1,6
39308,3,2592,2464,128,0,200,0,6
39309,2,2299,2449,-150,0,46,1,6
39310,2,2508,2533,-25,0,242,0,6
39311,3,2451,2474,-23,0,106,0,6
39313,1,2478,2368,110,0,20,0,6
39314,1,2329,2458,-129,0,15,0,6
39315,3,2507,2469,38,0,337,0,6
39316,1,2414,2267,147,0,122,0,6
39317,3,2590,2557,33,0,267,0,6
39318,2,2443,2378,65,0,278,0,6
39319,2,2496,2528,-32,0,300,1,6
39320,2,2372,2440,-68,0,410,0,6
39321,1,2362,2429,-67,0,332,0,6
39323,3,2429,2383,46,0,198,0,6
39324,1,2391,2456,-65,0,7,0,6
39325,2,2712,2669,43,0,107,0,6
39326,1,2344,2472,-128,0,1,0,6
39327,1,2577,2377,200,0,337,1,8
39328,1,2405,2269,136,0,348,0,6
39329,1,2456,2465,-9,0,107,0,6
39330,2,2421,2293,128,0,469,1,6
39331,1,2428,2443,-15,0,302,0,6
39332,1,2419,2264,155,0,241,0,8
39333,1,2487,2448,39,0,103,1,6
39334,1,2515,2637,-122,0,106,0,6
39335,3,2464,2403,61,0,120,0,6
39336,2,2418,2274,144,0,100,0,6
39337,2,2387,2482,-95,0,200,0,6
39338,2,2473,2451,22,0,373,0,6
39339,1,2478,2355,123,0,4,0,6
39340,2,2503,2689,-186,0,130,1,6
39341,1,2410,2237,173,0,5,1,6
39342,2,2401,2421,-20,0,218,0,6
39343,3,2347,2430,-83,0,14,0,6
39344,1,2467,2374,93,0,127,0,6
39345,2,2592,2488,104,0,45,0,6
39346,2,2602,2493,109,0,459,0,6
39347,1,2634,2598,36,0,45,0,6
39348,1,2426,2474,-48,0,189,0,6
39349,1,2409,2295,114,0,419,1,6
39350,2,2437,2306,131,0,488,0,6
39351,1,2457,2288,169,4,118,0,13
39352,1,2470,2542,-72,0,162,0,6
39353,2,2434,2492,-58,0,88,1,6
39354,1,2282,2410,-128,0,426,0,6
39355,1,2520,2342,178,0,121,1,6
39356,2,2266,2485,-219,0,278,0,6
39357,2,2390,2422,-32,0,226,0,6
39358,2,2558,2589,-31,0,101,1,6
39359,2,2675,2706,-31,0,404,1,6
39360,2,2350,2453,-103,0,138,1,6
39361,1,2487,2362,125,0,140,0,6
39362,1,2428,2373,55,0,426,0,6
39363,1,2369,2540,-171,0,337,0,6
39364,1,2408,2269,139,0,302,1,6
39365,1,2630,2450,180,0,16,0,6
39366,2,2472,2522,-50,0,31,0,6
39367,2,2316,2437,-121,0,394,0,6
39368,1,2411,2430,-19,0,49,1,6
39369,1,2351,2523,-172,0,128,1,6
39370,2,2395,2432,-37,0,126,0,6
39371,2,2373,2422,-49,0,45,0,8
39372,1,2482,2375,107,0,39,0,6
39373,2,2446,2462,-16,0,206,0,6
39374,2,2272,2405,-133,4,141,0,13
39375,1,2384,2404,-20,0,404,1,6
39376,2,2463,2392,71,0,123,1,6
39377,2,2286,2437,-151,0,125,0,6
39378,1,2593,2639,-46,0,112,0,6
39379,1,2501,2371,130,0,43,0,6
39380,1,2454,2340,114,4,201,0,13
39381,1,2458,2370,88,0,135,0,6
39382,1,2654,2484,170,0,120,0,6
39383,2,2425,2461,-36,0,49,0,6
39384,3,2310,2497,-187,0,190,0,6
39385,1,2486,2357,129,0,13,0,6
39386,2,2585,2500,85,0,45,0,6
39387,1,2497,2491,6,0,43,1,6
39388,3,2354,2429,-75,0,6,0,6
39389,2,2468,2433,35,0,127,0,6
39390,1,2428,2372,56,0,201,0,6
39391,3,2426,2595,-169,0,49,0,6
39392,1,2442,2206,236,0,1,1,6
39393,1,2445,2411,34,0,46,0,6
39394,1,2507,2672,-165,0,404,1,6
39395,3,2467,2355,112,0,115,0,6
39396,2,2401,2530,-129,0,129,0,6
39397,1,2388,2467,-79,0,484,0,6
39398,2,2282,2413,-131,0,334,0,6
39399,3,2545,2424,121,0,132,0,6
39400,3,2377,2491,-114,0,469,0,6
39401,1,2554,2525,29,0,62,0,6
39402,2,2462,2436,26,0,190,0,6
39403,1,2497,2490,7,0,200,0,6
39404,2,2467,2429,38,0,373,0,6
39405,1,2595,2553,42,0,245,0,6
39406,1,2533,2440,93,0,284,0,6
39407,1,2385,2532,-147,0,225,0,6
39408,1,2530,2447,83,0,372,0,6
39409,1,2458,2238,220,0,411,1,6
39410,2,2336,2457,-121,0,40,0,6
39411,3,2711,2568,143,0,301,0,6
39412,3,2515,2572,-57,0,101,0,6
39413,1,2424,2423,1,0,150,0,6
39414,2,2490,2417,73,0,211,0,6
39415,1,2539,2360,179,0,106,0,6
39416,2,2507,2578,-71,0,207,0,6
39417,2,2292,2402,-110,0,269,1,6
39418,1,2571,2504,67,0,27,0,6
39419,2,2227,2430,-203,4,125,0,13
39420,1,2348,2439,-91,0,300,1,6
39421,1,2406,2253,153,0,300,0,6
39422,2,2426,2374,52,0,121,0,6
39423,1,2487,2357,130,0,4,1,6
39424,1,2427,2317,110,0,381,0,8
39425,3,2417,2279,138,0,41,0,6
39426,1,2398,2450,-52,0,34,0,6
39427,2,2481,2657,-176,0,100,1,6
39428,2,2443,2433,10,0,343,1,6
39429,1,2439,2462,-23,0,216,0,6
39430,1,2404,2275,129,0,115,1,6
39431,2,2428,2516,-88,0,327,1,6
39432,2,2420,2368,52,0,40,0,8
39433,2,2437,2368,69,0,211,1,6
39434,2,2500,2633,-133,0,300,1,6
39435,1,2367,2533,-166,0,44,0,6
39436,1,2543,2460,83,0,102,1,6
39437,2,2427,2291,136,0,192,0,6
39438,2,2524,2385,139,0,4,1,6
39439,2,2317,2406,-89,0,405,0,6
39440,2,2466,2393,73,0,132,0,6
39441,2,2476,2489,-13,0,5,1,6
39442,1,2590,2336,254,4,207,0,13
39443,1,2426,2485,-59,0,43,0,6
39444,1,2548,2600,-52,0,335,1,6
39445,2,2352,2539,-187,0,426,1,6
39446,2,2436,2380,56,0,10,0,6
39447,1,2575,2435,140,0,202,1,6
39448,2,2374,2406,-32,0,40,1,8
39449,1,2570,2709,-139,0,125,0,6
39450,2,2582,2502,80,0,45,0,6
39451,1,2592,2503,89,0,455,0,6
39452,1,2355,2461,-106,0,4,0,6
39453,1,2411,2243,168,0,305,0,6
39454,2,2525,2376,149,0,43,0,6
39455,1,2484,2355,129,0,28,0,6
39456,1,2501,2377,124,0,4,1,6
39457,2,2600,2598,2,0,133,1,6
39458,2,2416,2359,57,0,40,1,6
39459,2,2407,2494,-87,0,46,0,6
39460,2,2420,2403,17,0,456,0,6
39461,2,2495,2395,100,0,35,1,6
39462,1,2355,2464,-109,0,132,0,6
39463,1,2478,2542,-64,0,243,0,6
39464,2,2461,2392,69,4,205,1,13
39465,1,2410,2426,-16,0,45,1,6
39466,2,2505,2506,-1,0,463,1,6
39467,2,2437,2446,-9,0,462,0,6
39468,2,2439,2432,7,0,380,0,6
39469,1,2424,2379,45,0,405,1,6
39470,1,2520,2429,91,0,101,1,6
39471,1,2491,2328,163,0,373,1,6
39472,1,2516,2331,185,0,4,0,6
39473,1,2461,2346,115,0,110,0,6
39474,2,2299,2432,-133,0,48,1,6
39475,1,2506,2395,111,0,301,0,6
39476,1,2434,2296,138,0,330,0,6
39477,2,2384,2517,-133,0,107,1,6
39478,2,2496,2367,129,0,463,0,6
39479,2,2451,2456,-5,0,141,0,6
39480,1,2410,2313,97,0,202,0,6
39481,1,2351,2442,-91,0,440,0,6
39482,1,2317,2496,-179,0,54,0,6
39483,1,2593,2636,-43,0,320,0,6
39484,1,2251,2430,-179,0,418,0,6
39485,2,2451,2376,75,0,45,0,6
39486,2,2488,2471,17,0,300,0,6
39487,3,2387,2459,-72,0,335,0,6
39488,2,2364,2542,-178,0,157,0,6
39489,3,2318,2458,-140,0,121,0,6
39490,1,2593,2554,39,0,245,0,6
39491,1,2393,2510,-117,0,9,0,6
39492,2,2456,2432,24,0,310,1,6
39493,3,2357,2403,-46,0,373,0,6
39494,2,2375,2415,-40,0,250,0,6
39495,1,2409,2262,147,4,45,0,13
39496,2,2664,2701,-37,0,20,1,6
39497,2,2393,2411,-18,0,15,1,6
39498,2,2509,2485,24,0,310,0,6
39499,2,2371,2485,-114,0,45,1,6
39500,3,2400,2456,-56,0,225,0,6
39501,1,2284,2421,-137,0,426,0,6
39502,1,2494,2507,-13,0,201,0,6
39503,2,2378,2488,-110,0,45,0,6
39504,2,2462,2460,2,0,315,1,6
39505,2,2498,2594,-96,0,373,0,6
39506,1,2488,2446,42,0,487,0,6
39507,1,2431,2420,11,0,384,0,8
39508,2,2380,2428,-48,0,241,0,6
39509,2,2549,2598,-49,0,344,0,6
39510,2,2452,2596,-144,0,207,1,6
39511,1,2604,2537,67,0,310,0,6
39512,2,2304,2444,-140,0,153,0,6
39513,2,2519,2357,162,0,5,0,6
39514,1,2527,2578,-51,0,21,0,6
39515,1,2233,2401,-168,0,107,0,6
39516,1,2630,2600,30,0,45,0,6
39517,2,2357,2458,-101,0,42,0,6
39518,3,2269,2494,-225,0,258,0,6
39519,1,2482,2316,166,0,40,0,6
39520,1,2425,2524,-99,0,128,0,6
39521,1,2521,2429,92,0,130,0,6
39522,1,2559,2417,142,0,64,0,6
39523,2,2389,2500,-111,0,123,0,6
39524,1,2435,2388,47,0,335,0,6
39525,1,2382,2416,-34,0,7,1,6
39526,1,2437,2482,-45,0,54,0,6
39527,1,2413,2296,117,0,20,1,6
39528,1,2477,2464,13,0,7,1,6
39529,2,2546,2515,31,0,125,0,6
39530,2,2308,2415,-107,0,405,0,6
39531,3,2385,2401,-16,0,61,0,6
39532,1,2447,2465,-18,0,40,0,6
39533,2,2310,2458,-148,0,205,0,6
39534,1,2417,2380,37,0,131,1,6
39535,1,2450,2361,89,0,140,0,6
39536,2,2438,2438,0,0,43,0,6
39537,2,2384,2454,-70,0,337,0,6
39538,1,2462,2353,109,0,1,0,6
39539,2,2417,2459,-42,0,302,0,8
39540,3,2430,2460,-30,0,210,0,6
39541,2,2491,2503,-12,0,100,0,6
39542,1,2400,2409,-9,0,7,0,6
39543,3,2706,2598,108,0,300,0,6
39544,2,2441,2455,-14,0,247,0,6
39545,1,2353,2593,-240,4,184,0,13
39546,1,2461,2357,104,0,107,0,6
39547,1,2402,2349,53,0,40,0,6
39548,2,2466,2401,65,0,130,0,6
39549,2,2302,2498,-196,0,107,0,6
39550,2,2603,2544,59,0,245,0,6
39551,1,2419,2304,115,0,202,0,6
39552,2,2465,2457,8,0,206,0,6
39553,2,2300,2591,-291,0,343,0,6
39554,1,2594,2635,-41,0,30,0,6
39555,1,2492,2315,177,0,10,0,6
39556,2,2383,2504,-121,0,143,0,6
39557,1,2299,2424,-125,0,315,0,6
39558,1,2525,2454,71,0,46,0,6
39559,2,2417,2357,60,0,344,0,6
39560,2,2446,2349,97,0,1,0,6
39561,2,2421,2511,-90,0,330,0,6
39562,1,2407,2517,-110,0,302,1,6
39563,1,2461,2344,117,0,40,0,6
39564,1,2456,2358,98,0,112,1,6
39565,1,2659,2534,125,0,130,0,6
39566,3,2435,2464,-29,0,247,0,6
39567,1,2489,2344,145,0,11,0,6
39568,1,2417,2290,127,0,288,1,6
39570,1,2475,2444,31,0,46,0,6
39571,1,2563,2572,-9,0,132,0,6
39572,1,2299,2491,-192,0,33,0,6
39573,1,2509,2486,23,0,310,1,6
39574,2,2301,2423,-122,0,51,0,6
39575,1,2444,2432,12,0,313,1,6
39576,1,2449,2345,104,0,111,0,6
39577,1,2417,2292,125,0,409,1,6
39578,2,2364,2417,-53,0,153,0,6
39579,1,2492,2234,258,0,130,0,6
39580,2,2400,2352,48,0,5,1,6
39581,1,2482,2459,23,0,5,0,6
39582,2,2469,2461,8,0,45,1,6
39583,1,2521,2615,-94,0,345,0,6
39584,1,2483,2378,105,0,4,0,6
39585,2,2307,2417,-110,0,315,0,6
39586,1,2348,2464,-116,0,245,0,8
39587,1,2441,2307,134,0,140,0,6
39588,1,2410,2389,21,0,46,0,6
39589,2,2358,2553,-195,0,490,0,6
39590,2,2600,2705,-105,0,138,1,6
39592,2,2463,2460,3,0,202,0,6
39593,3,2508,2477,31,0,335,0,6
39594,2,2407,2515,-108,0,226,0,6
39595,2,2551,2597,-46,0,300,0,6
39596,2,2465,2436,29,0,462,0,6
39597,2,2463,2495,-32,0,57,0,6
39598,2,2252,2417,-165,0,1,0,6
39599,1,2219,2475,-256,0,46,0,8
39600,1,2422,2267,155,0,454,0,8
39601,3,2538,2570,-32,0,120,0,6
39602,1,2366,2417,-51,0,466,1,6
39603,1,2454,2488,-34,0,11,0,6
39604,2,2358,2459,-101,0,215,0,6
39605,3,2520,2535,-15,0,43,0,6
39606,2,2322,2421,-99,0,150,0,6
39607,2,2539,2497,42,0,101,0,6
39608,3,2273,2413,-140,0,21,0,6
39609,2,2462,2442,20,0,127,0,6
39610,1,2530,2662,-132,0,46,1,6
39611,1,2569,2535,34,0,101,0,6
39612,2,2439,2481,-42,0,242,1,6
39613,2,2348,2414,-66,0,456,0,6
39614,1,2510,2350,160,0,200,0,6
39615,2,2291,2428,-137,0,62,1,8
39616,2,2359,2414,-55,0,106,1,6
39617,1,2369,2444,-75,0,459,0,6
39618,1,2480,2514,-34,0,100,0,6
39619,1,2304,2421,-117,0,315,0,6
39621,1,2424,2246,178,0,337,1,6
39622,2,2288,2421,-133,0,302,0,6
39623,2,2427,2487,-60,0,46,0,6
39624,1,2376,2493,-117,0,476,1,6
39625,3,2519,2583,-64,0,7,0,6
39626,1,2408,2501,-93,0,9,0,6
39627,2,2344,2459,-115,0,45,0,6
39628,2,2571,2491,80,0,106,0,6
39629,2,2566,2394,172,0,202,0,6
39630,2,2540,2617,-77,0,321,0,6
39631,1,2464,2318,146,0,226,0,6
39632,1,2477,2508,-31,0,112,0,6
39633,3,2404,2356,48,0,456,0,6
39634,3,2305,2453,-148,0,46,0,6
39635,2,2315,2437,-122,0,226,0,8
39636,2,2467,2481,-14,0,315,0,6
39637,2,2420,2249,171,0,0,0,6
39638,3,2449,2353,96,0,4,0,6
39639,1,2393,2494,-101,0,5,0,6
39640,1,2709,2513,196,0,301,0,6
39641,2,2602,2546,56,0,201,1,6
39642,2,2596,2374,222,0,270,0,6
39643,2,2385,2419,-34,0,145,0,6
39644,2,2411,2373,38,0,201,0,6
39645,2,2448,2456,-8,0,0,1,6
39646,1,2483,2577,-94,0,101,0,6
39647,1,2283,2406,-123,0,190,0,6
39648,2,2328,2416,-88,0,122,0,6
39649,1,2402,2441,-39,0,41,0,6
39650,1,2425,2318,107,0,10,0,6
39652,1,2538,2502,36,0,113,1,6
39653,1,2615,2273,342,0,114,0,6
39654,2,2504,2413,91,0,130,0,6
39655,1,2397,2431,-34,0,269,1,6
39656,1,2622,2500,122,0,7,0,6
39657,1,2460,2312,148,0,8,0,6
39658,2,2437,2348,89,0,100,1,6
39659,2,2297,2418,-121,0,112,0,6
39660,1,2508,2487,21,0,135,0,6
39661,1,2463,2340,123,0,311,1,6
39662,3,2619,2575,44,0,2,0,6
39663,2,2278,2453,-175,0,404,1,6
39664,2,2486,2434,52,0,46,0,6
39665,3,2411,2488,-77,0,1,0,6
39666,2,2478,2419,59,0,109,1,6
39667,1,2558,2391,167,0,310,0,6
39668,1,2411,2272,139,0,123,1,6
39669,2,2425,2422,3,0,200,0,6
39670,2,2284,2492,-208,0,302,0,6
39671,2,2368,2451,-83,0,188,0,6
39672,1,2582,2520,62,0,335,0,6
39673,1,2440,2479,-39,0,242,1,6
39674,1,2412,2350,62,0,0,0,6
39675,2,2402,2487,-85,0,0,0,6
39676,1,2463,2462,1,0,255,0,6
39677,1,2279,2429,-150,0,15,0,6
39678,2,2408,2376,32,0,415,0,6
39679,2,2300,2440,-140,0,4,0,6
39680,2,2655,2712,-57,0,332,1,6
39681,1,2510,2501,9,0,110,0,6
39682,1,2397,2448,-51,0,43,0,6
39683,2,2462,2443,19,0,127,0,6
39684,2,2339,2522,-183,0,8,1,8
39685,2,2481,2514,-33,0,100,0,6
39686,1,2587,2434,153,0,176,0,6
39687,2,2553,2595,-42,0,124,1,6
39688,2,2470,2601,-131,0,346,0,6
39689,2,2304,2471,-167,0,129,0,6
39690,2,2420,2380,40,0,337,0,6
39691,1,2491,2521,-30,0,107,0,6
39692,1,2494,2382,112,0,6,1,6
39693,1,2449,2456,-7,0,0,0,6
39694,2,2282,2430,-148,0,302,1,6
39695,1,2466,2404,62,0,40,0,6
39696,1,2435,2496,-61,0,466,0,6
39697,1,2451,2398,53,0,487,0,6
39698,3,2351,2412,-61,0,484,0,6
39699,1,2424,2404,20,0,241,0,6
39700,3,2415,2495,-80,0,314,0,6
39701,3,2401,2264,137,0,8,0,6
39702,3,2444,2329,115,0,131,0,6
39703,1,2555,2383,172,0,45,0,6
39704,1,2417,2308,109,0,0,0,6
39705,2,2345,2403,-58,0,302,0,6
39706,1,2575,2456,119,0,101,0,6
39707,1,2384,2422,-38,0,8,0,6
39708,2,2447,2515,-68,0,332,0,6
39709,3,2419,2491,-72,0,246,0,6
39710,2,2428,2469,-41,0,46,1,6
39711,1,2450,2455,-5,0,123,1,6
39712,1,2455,2383,72,0,392,0,6
39713,2,2494,2256,238,0,212,0,6
39714,3,2459,2323,136,0,226,0,6
39715,1,2516,2587,-71,0,4,0,6
39716,1,2521,2361,160,0,217,0,8
39717,2,2473,2447,26,0,46,0,6
39718,2,2271,2420,-149,0,332,0,6
39719,1,2425,2300,125,4,330,0,13
39720,2,2332,2414,-82,0,211,1,6
39721,2,2321,2412,-91,0,308,0,8
39722,2,2444,2520,-76,0,321,0,6
39723,2,2432,2386,46,0,286,1,6
39724,3,2417,2402,15,0,13,0,6
39725,1,2409,2587,-178,0,414,0,6
39726,1,2441,2432,9,0,4,0,8
39727,1,2501,2527,-26,0,45,0,6
39728,1,2456,2300,156,0,140,0,6
39729,1,2600,2548,52,0,241,0,6
39730,1,2420,2366,54,0,20,1,6
39731,1,2524,2524,0,0,128,1,6
39732,2,2293,2459,-166,0,190,0,6
39733,2,2321,2493,-172,0,104,0,6
39734,1,2515,2519,-4,0,411,0,6
39735,1,2590,2497,93,0,130,0,6
39736,2,2485,2383,102,0,211,0,6
39737,1,2434,2307,127,0,36,0,6
39738,1,2521,2351,170,0,310,0,6
39739,1,2453,2467,-14,0,242,0,6
39740,2,2277,2444,-167,0,40,0,6
39741,2,2427,2279,148,0,61,0,6
39742,1,2304,2421,-117,0,200,0,6
39743,3,2490,2411,79,0,315,0,6
39744,1,2498,2278,220,0,152,1,6
39745,2,2400,2577,-177,0,129,0,6
39746,3,2507,2415,92,0,300,0,6
39747,2,2558,2544,14,0,46,0,6
39748,1,2300,2460,-160,0,156,0,6
39749,2,2580,2523,57,0,335,1,6
39750,2,2449,2456,-7,0,0,0,6
39751,2,2301,2423,-122,0,222,0,6
39752,2,2402,2359,43,0,240,0,6
39753,1,2409,2367,42,0,331,0,6
39754,1,2579,2548,31,0,205,0,6
39755,2,2331,2442,-111,0,4,0,6
39756,2,2420,2256,164,0,227,0,6
39757,2,2452,2490,-38,0,315,0,6
39758,2,2302,2419,-117,0,110,0,6
39759,2,2400,2453,-53,0,106,0,6
39760,1,2415,2292,123,0,375,0,6
39761,2,2376,2474,-98,0,200,0,6
39762,2,2425,2471,-46,0,406,0,6
39763,2,2325,2419,-94,0,138,1,6
39764,2,2513,2660,-147,0,45,0,6
39765,2,2456,2382,74,0,313,0,6
39766,1,2461,2459,2,0,46,0,6
39767,1,2427,2423,4,0,202,0,6
39768,1,2519,2442,77,0,241,0,6
39769,2,2455,2353,102,0,245,0,6
39770,1,2405,2398,7,0,48,1,6
39771,2,2513,2493,20,0,414,1,6
39772,2,2619,2520,99,0,3,0,6
39773,1,2420,2259,161,0,305,0,6
39774,2,2463,2287,176,0,140,0,6
39775,2,2463,2460,3,0,48,1,6
39776,2,2393,2412,-19,0,154,1,6
39777,1,2350,2452,-102,0,302,0,6
39778,2,2255,2403,-148,0,302,0,6
39779,1,2498,2438,60,0,153,0,6
39780,2,2287,2442,-155,0,190,0,6
39781,1,2489,2413,76,0,145,1,6
39782,1,2438,2523,-85,0,128,1,6
39783,1,2362,2404,-42,0,61,0,6
39784,2,2529,2574,-45,0,4,0,6
39785,2,2384,2453,-69,0,4,1,6
39786,1,2550,2552,-2,0,200,0,6
39787,2,2495,2524,-29,0,49,1,6
39788,1,2351,2421,-70,0,51,0,6
39789,1,2446,2327,119,0,131,0,6
39790,1,2406,2433,-27,0,373,0,6
39791,2,2559,2590,-31,0,241,0,6
39792,2,2447,2584,-137,0,107,0,6
39793,1,2347,2419,-72,0,200,1,6
39794,1,2478,2372,106,0,192,0,6
39795,1,2424,2561,-137,0,321,0,6
39796,1,2354,2497,-143,0,113,0,6
39797,1,2579,2525,54,0,13,0,6
39798,1,2420,2354,66,0,310,1,6
39799,1,2385,2476,-91,0,302,0,6
39800,1,2352,2425,-73,0,300,0,6
39801,2,2427,2412,15,0,102,0,6
39802,1,2453,2467,-14,0,242,1,6
39803,2,2467,2351,116,0,150,1,6
39804,1,2417,2432,-15,0,456,0,6
39805,2,2489,2358,131,0,10,0,6
39806,1,2616,2538,78,0,102,1,6
39807,1,2468,2357,111,0,337,0,6
39808,1,2470,2389,81,0,110,1,6
39809,1,2408,2334,74,0,48,0,6
39810,2,2302,2467,-165,0,134,0,6
39811,1,2433,2418,15,0,15,0,6
39812,2,2504,2467,37,0,302,1,6
39813,1,2457,2397,60,0,140,0,6
39814,2,2365,2496,-131,0,102,0,6
39815,1,2466,2507,-41,0,45,0,6
39816,1,2469,2473,-4,0,110,0,6
39817,1,2313,2419,-106,0,248,1,6
39818,1,2430,2263,167,0,211,0,6
39820,1,2444,2433,11,0,242,0,6
39821,3,2381,2449,-68,0,34,0,6
39822,2,2360,2446,-86,0,130,1,6
39823,1,2547,2555,-8,0,36,0,6
39824,2,2387,2493,-106,0,265,0,6
39825,2,2334,2431,-97,4,201,0,13
39826,1,2579,2516,63,0,123,0,6
39827,2,2521,2588,-67,0,410,0,6
39828,3,2425,2376,49,0,411,0,6
39829,2,2470,2384,86,0,301,0,6
39830,1,2501,2529,-28,0,112,0,6
39831,1,2443,2468,-25,0,22,1,6
39832,1,2490,2423,67,0,5,0,6
39833,2,2409,2472,-63,0,343,0,6
39834,1,2423,2390,33,0,41,0,6
39835,1,2388,2418,-30,0,40,0,6
39836,1,2584,2517,67,0,484,0,6
39838,2,2395,2424,-29,0,407,0,6
39839,1,2412,2303,109,0,130,0,6
39840,1,2412,2445,-33,0,302,0,6
39841,1,2478,2462,16,0,106,0,6
39842,1,2553,2472,81,0,300,0,6
39843,2,2303,2454,-151,0,192,0,6
39844,2,2327,2419,-92,0,310,0,6
39845,1,2421,2406,15,0,106,0,6
39846,2,2354,2412,-58,0,153,1,6
39848,1,2349,2432,-83,0,107,1,6
39849,2,2445,2556,-111,0,224,0,6
39850,2,2335,2442,-107,0,212,0,6
39851,2,2476,2328,148,0,455,1,6
39852,2,2357,2520,-163,0,7,0,6
39853,1,2610,2670,-60,0,120,1,6
39854,1,2404,2382,22,0,15,0,6
39856,2,2369,2450,-81,0,46,0,6
39857,2,2477,2498,-21,0,102,0,6
39858,1,2427,2438,-11,0,313,0,6
39859,1,2538,2433,105,0,56,0,6
39861,1,2511,2499,12,0,256,0,6
39862,2,2433,2391,42,4,113,1,13
39863,1,2458,2475,-17,0,11,0,6
39864,2,2390,2463,-73,0,307,0,6
39865,2,2407,2342,65,0,106,0,6
39866,3,2429,2483,-54,0,302,0,6
39867,2,2593,2497,96,0,104,0,6
39868,2,2516,2595,-79,0,278,0,6
39869,1,2390,2468,-78,0,302,0,6
39870,1,2500,2563,-63,0,245,0,6
39871,1,2481,2282,199,4,125,0,23
39872,1,2365,2460,-95,0,203,1,6
39873,2,2419,2523,-104,0,456,1,6
39874,2,2404,2383,21,0,354,0,6
39875,1,2429,2391,38,0,406,0,6
39876,2,2401,2362,39,0,103,0,6
39877,1,2276,2412,-136,0,302,1,6
39878,2,2530,2507,23,0,453,0,6
39879,1,2423,2323,100,0,277,0,6
39880,1,2485,2588,-103,0,191,0,6
39881,2,2458,2358,100,0,44,0,6
39882,1,2449,2374,75,0,190,0,6
39883,3,2298,2446,-148,0,46,0,6
39884,1,2416,2237,179,0,190,1,6
39885,1,2439,2367,72,0,87,0,6
39886,1,2458,2297,161,0,140,0,6
39887,1,2264,2412,-148,0,242,1,6
39888,2,2454,2450,4,0,441,1,6
39890,2,2462,2413,49,0,44,0,6
39891,2,2429,2517,-88,0,300,0,6
39892,2,2556,2507,49,0,130,0,6
39893,2,2425,2353,72,0,40,1,6
39894,2,2392,2553,-161,0,46,0,6
39895,2,2335,2434,-99,0,2,0,6
39896,1,2560,2523,37,0,288,0,6
39897,2,2400,2441,-41,0,101,0,6
39898,2,2305,2464,-159,0,85,0,6
39899,1,2337,2433,-96,0,260,0,6
39900,3,2426,2388,38,0,380,0,8
39901,2,2468,2524,-56,0,398,1,6
39902,2,2429,2472,-43,0,48,0,6
39903,1,2431,2346,85,0,4,0,6
39904,3,2388,2434,-46,0,406,0,6
39905,3,2380,2456,-76,0,138,0,6
39906,3,2528,2616,-88,0,40,0,6
39907,1,2451,2356,95,0,230,1,6
39908,2,2390,2492,-102,0,260,0,6
39909,2,2469,2459,10,0,106,0,6
39910,3,2474,2513,-39,0,453,0,6
39911,3,2461,2389,72,0,211,0,6
39912,2,2414,2385,29,0,54,0,6
39913,1,2521,2560,-39,0,221,0,6
39914,1,2629,2581,48,0,45,0,6
39915,2,2482,2464,18,0,396,1,6
39916,2,2369,2414,-45,0,146,0,6
39917,1,2417,2395,22,0,345,1,6
39918,1,2415,2404,11,0,302,0,6
39919,2,2527,2368,159,0,455,0,6
39920,2,2444,2284,160,0,45,0,6
39921,2,2363,2444,-81,0,244,1,6
39922,2,2372,2438,-66,0,4,0,6
39923,2,2518,2419,99,0,8,0,6
39924,1,2419,2459,-40,0,15,0,6
39925,1,2438,2367,71,0,4,0,6
39926,1,2291,2461,-170,0,192,0,6
39927,1,2378,2456,-78,0,202,0,6
39928,2,2456,2449,7,0,38,0,6
39929,1,2383,2446,-63,0,101,0,6
39930,1,2540,2405,135,0,227,0,6
39931,2,2411,2378,33,0,312,0,6
39932,2,2380,2425,-45,0,300,0,6
39933,1,2605,2548,57,0,241,0,6
39934,2,2465,2463,2,0,226,0,6
39935,1,2556,2420,136,0,44,0,6
39936,2,2477,2424,53,0,132,0,6
39937,1,2476,2271,205,0,337,0,6
39939,2,2404,2289,115,0,133,0,6
39940,1,2528,2572,-44,0,40,0,6
39941,1,2273,2408,-135,0,204,0,6
39942,2,2316,2508,-192,0,4,0,6
39943,1,2469,2426,43,0,34,0,6
39944,2,2513,2615,-102,0,240,0,6
39945,2,2362,2473,-111,0,1,0,6
39946,1,2500,2511,-11,0,337,0,6
39947,2,2385,2418,-33,0,141,0,6
39948,2,2495,2576,-81,0,5,1,6
39949,2,2455,2548,-93,0,140,0,6
39950,2,2576,2634,-58,0,331,0,6
39951,1,2536,2337,199,0,48,0,6
39952,1,2255,2419,-164,0,302,0,6
39953,2,2429,2358,71,0,85,1,6
39954,1,2435,2363,72,0,4,1,6
39955,1,2528,2420,108,0,200,1,6
39956,1,2427,2346,81,0,140,0,6
39957,2,2207,2505,-298,0,454,0,5
39958,2,2455,2450,5,0,331,1,6
39959,2,2430,2453,-23,0,218,0,6
39960,1,2430,2375,55,0,300,0,6
39961,2,2543,2610,-67,0,21,0,6
39962,3,2344,2426,-82,0,163,0,6
39963,1,2524,2509,15,0,51,0,6
39964,1,2554,2519,35,0,112,1,6
39965,2,2443,2376,67,0,455,0,6
39966,1,2436,2370,66,0,45,1,6
39967,1,2505,2457,48,0,4,0,6
39968,1,2477,2327,150,0,49,0,6
39969,2,2421,2474,-53,0,130,0,6
39970,1,2506,2449,57,0,310,0,6
39971,2,2400,2265,135,0,311,0,6
39972,1,2403,2448,-45,0,226,0,6
39973,1,2389,2518,-129,0,41,0,6
39974,2,2389,2423,-34,0,152,0,6
39975,2,2358,2530,-172,0,0,0,6
39976,2,2256,2440,-184,0,106,0,6
39978,1,2516,2378,138,0,302,0,6
39979,2,2426,2324,102,0,316,0,8
39980,2,2268,2488,-220,0,278,0,6
39981,1,2427,2372,55,0,46,1,6
39982,1,2402,2225,177,0,60,0,6
39983,3,2419,2272,147,2,13,0,18
39984,1,2447,2457,-10,0,112,0,6
39985,1,2416,2380,36,0,284,0,6
39986,3,2412,2296,116,0,101,0,6
39987,2,2425,2371,54,0,121,0,6
39988,2,2470,2565,-95,0,106,0,6
39989,1,2478,2296,182,0,400,0,6
39990,1,2455,2393,62,0,200,0,6
39991,1,2619,2509,110,0,120,0,6
39992,1,2292,2403,-111,0,108,0,6
39993,1,2289,2464,-175,0,106,0,6
39994,1,2528,2374,154,0,403,0,6
39995,1,2639,2572,67,0,45,0,6
39997,1,2370,2435,-65,0,300,0,6
39998,1,2444,2491,-47,0,310,0,6
39999,2,2411,2481,-70,0,381,0,6
40000,2,2431,2511,-80,0,110,0,6
40001,1,2440,2375,65,0,398,0,6
40002,3,2554,2403,151,0,267,0,6
40003,2,2383,2529,-146,0,40,0,6
40004,2,2443,2363,80,0,300,1,6
40005,2,2416,2410,6,0,302,1,6
40006,2,2304,2436,-132,0,305,1,6
40007,1,2433,2326,107,0,48,0,6
40008,2,2441,2479,-38,0,302,0,6
40009,2,2456,2449,7,0,45,0,6
40010,2,2416,2400,16,0,140,0,6
40011,2,2450,2451,-1,0,113,1,6
40012,1,2453,2531,-78,0,118,0,6
40013,2,2392,2419,-27,0,103,1,6
40014,2,2422,2467,-45,0,113,0,6
40015,1,2514,2404,110,0,40,0,6
40016,1,2559,2538,21,0,315,0,6
40017,1,2441,2258,183,0,40,0,6
40018,2,2288,2444,-156,0,400,0,6
40019,2,2567,2643,-76,0,331,0,6
40020,2,2498,2266,232,0,365,0,6
40021,2,2359,2405,-46,0,310,0,6
40022,1,2428,2384,44,0,345,0,6
40023,1,2494,2374,120,0,45,0,6
40024,2,2400,2396,4,0,10,0,6
40025,1,2518,2383,135,0,5,0,6
40026,1,2456,2298,158,0,0,1,6
40027,1,2288,2440,-152,0,150,0,6
40028,1,2374,2442,-68,0,253,1,6
40029,1,2577,2313,264,0,40,1,8
40030,1,2552,2277,275,0,4,1,6
40031,1,2569,2464,105,0,120,0,6
40032,1,2519,2376,143,0,454,0,6
40033,2,2332,2403,-71,0,191,0,6
40034,2,2423,2503,-80,0,102,1,6
40035,1,2533,2484,49,0,303,0,6
40036,1,2516,2427,89,0,315,0,6
40037,2,2386,2451,-65,0,20,0,6
40038,2,2406,2551,-145,0,142,0,6
40039,1,2533,2380,153,0,112,0,6
40040,1,2505,2623,-118,0,242,0,6
40041,1,2479,2422,57,0,7,0,6
40042,2,2460,2366,94,0,110,0,6
40043,2,2467,2538,-71,0,106,0,6
40044,1,2507,2415,92,0,112,0,5
40045,1,2502,2359,143,0,145,0,5
40046,2,2466,2403,63,0,4,0,6
40047,1,2379,2433,-54,0,152,0,6
40048,1,2406,2334,72,0,190,0,6
40049,1,2455,2450,5,0,15,1,6
40050,1,2524,2460,64,0,15,1,6
40051,1,2440,2300,140,0,38,1,6
40052,2,2565,2609,-44,0,380,0,6
40053,1,2377,2536,-159,0,48,0,6
40054,2,2402,2371,31,0,302,0,6
40055,2,2444,2472,-28,0,313,0,6
40056,2,2275,2464,-189,0,278,0,6
40057,2,2250,2425,-175,0,385,1,6
40058,2,2484,2301,183,0,301,0,6
40059,1,2556,2402,154,0,4,1,6
40060,1,2437,2258,179,0,310,0,5
40061,1,2288,2462,-174,0,102,0,5
40062,2,2272,2417,-145,0,150,1,6
40063,2,2404,2366,38,0,106,0,6
40064,1,2424,2353,71,0,202,1,6
40065,1,2648,2563,85,0,45,0,6
40066,2,2460,2574,-114,0,131,0,6
40067,1,2663,2522,141,0,455,0,6
40068,1,2451,2429,22,0,331,0,6
40069,2,2381,2444,-63,0,122,0,6
40070,2,2465,2463,2,0,110,0,6
40071,2,2388,2569,-181,0,4,0,6
40072,2,2435,2355,80,0,455,1,8
40073,1,2459,2346,113,0,4,1,6
40074,2,2352,2452,-100,0,389,0,6
40075,1,2455,2381,74,0,10,0,6
40076,1,2616,2513,103,0,120,1,6
40077,1,2475,2272,203,0,453,0,6
40078,2,2543,2369,174,0,45,1,6
40079,1,2370,2436,-66,0,100,0,6
40080,1,2416,2365,51,0,302,1,6
40081,2,2343,2423,-80,0,107,0,6
40082,1,2520,2502,18,0,373,0,6
40083,1,2730,2682,48,0,85,1,6
40084,2,2518,2484,34,0,300,1,6
40085,2,2609,2560,49,0,302,0,6
40086,3,2432,2296,136,0,411,0,6
40087,2,2362,2437,-75,0,302,0,6
40088,1,2421,2274,147,0,302,1,6
40089,2,2311,2414,-103,0,205,0,6
40090,1,2419,2369,50,0,310,0,6
40091,2,2393,2410,-17,0,46,0,6
40092,3,2667,2615,52,0,45,0,6
40093,2,2368,2443,-75,0,374,0,6
40094,2,2402,2345,57,0,409,0,6
40095,2,2324,2422,-98,0,45,0,6
40096,1,2477,2296,181,0,5,0,6
40097,2,2295,2402,-107,0,107,0,6
40098,2,2444,2460,-16,0,216,0,6
40099,1,2478,2439,39,0,43,1,6
40100,1,2410,2282,128,0,41,0,6
40101,2,2399,2475,-76,0,41,0,6
40102,2,2343,2418,-75,0,301,0,8
40103,1,2420,2249,171,0,485,0,6
40104,1,2614,2529,85,0,398,0,6
40105,1,2558,2652,-94,0,13,0,6
40106,1,2377,2429,-52,0,145,0,6
40107,2,2400,2348,52,0,40,1,6
40108,2,2453,2459,-6,0,140,0,6
40109,3,2578,2457,121,0,213,0,6
40110,2,2486,2455,31,0,57,0,6
40111,1,2427,2396,31,0,107,0,6
40112,2,2533,2372,161,0,102,0,6
40113,1,2399,2497,-98,0,162,0,6
40114,1,2400,2309,91,0,301,1,6
40115,2,2454,2599,-145,0,250,0,6
40116,2,2449,2387,62,0,1,0,6
40117,3,2416,2389,27,0,173,0,6
40118,1,2469,2459,10,0,40,0,6
40119,2,2377,2460,-83,0,20,0,6
40120,2,2269,2484,-215,0,280,0,6
40121,1,2453,2293,160,0,28,1,6
40122,2,2337,2480,-143,0,112,0,6
40123,1,2509,2620,-111,0,240,1,6
40124,1,2378,2414,-36,0,4,0,6
40125,2,2424,2491,-67,0,310,0,6
40126,2,2457,2381,76,0,406,0,6
40127,2,2677,2773,-96,0,103,1,6
40128,2,2424,2386,38,0,398,0,6
40129,2,2254,2428,-174,0,36,0,6
40130,2,2466,2439,27,0,392,1,6
40131,2,2435,2390,45,0,190,0,6
40132,3,2525,2566,-41,0,300,0,6
40133,2,2384,2603,-219,0,107,0,6
40134,2,2483,2490,-7,0,310,0,6
40135,2,2344,2485,-141,0,45,0,6
40136,2,2298,2463,-165,0,106,1,6
40137,2,2425,2459,-34,0,41,0,6
40138,1,2435,2282,153,0,343,0,6
40139,1,2307,2432,-125,0,389,0,6
40140,2,2390,2525,-135,0,46,0,6
40141,2,2465,2448,17,0,260,0,6
40142,2,2363,2512,-149,0,253,0,6
40143,2,2523,2580,-57,0,330,1,6
40144,1,2468,2362,106,0,254,1,6
40145,2,2453,2429,24,0,105,0,6
40146,3,2406,2616,-210,0,218,0,6
40147,3,2477,2390,87,0,41,0,8
40148,2,2411,2274,137,0,104,0,5
40149,1,2512,2388,124,0,210,0,5
40150,1,2429,2506,-77,0,333,0,5
40151,1,2480,2364,116,0,101,0,6
40152,1,2487,2232,255,0,345,0,6
40153,1,2468,2428,40,0,318,1,6
40154,2,2462,2480,-18,0,106,1,6
40155,3,2448,2442,6,0,14,0,6
40156,2,2576,2618,-42,0,133,0,6
40157,2,2355,2458,-103,0,1,1,6
40158,1,2409,2409,0,0,300,0,6
40159,2,2348,2484,-136,0,301,0,6
40160,2,2298,2430,-132,0,106,0,6
40161,1,2493,2267,226,0,348,0,6
40162,1,2454,2459,-5,0,140,1,6
40163,1,2410,2355,55,0,122,0,6
40164,1,2735,2666,69,0,453,0,6
40165,1,2464,2372,92,0,426,0,6
40166,3,2410,2417,-7,0,311,0,6
40167,1,2380,2533,-153,0,456,0,6
40168,2,2308,2456,-148,0,387,0,6
40169,2,2301,2416,-115,0,122,0,6
40170,1,2777,2673,104,0,85,0,6
40171,1,2454,2475,-21,0,110,0,6
40172,3,2419,2402,17,0,331,0,6
40173,1,2616,2446,170,0,122,1,6
40174,1,2390,2404,-14,0,112,0,6
40175,1,2526,2450,76,0,13,0,6
40176,1,2612,2516,96,0,120,0,6
40177,2,2408,2324,84,0,416,0,6
40178,1,2529,2402,127,0,151,0,6
40179,1,2586,2396,190,0,131,0,5
40180,2,2219,2440,-221,0,127,0,5
40181,2,2289,2402,-113,0,250,0,6
40182,1,2445,2460,-15,0,216,1,6
40183,1,2401,2438,-37,0,341,0,6
40184,1,2605,2584,21,0,380,0,6
40185,3,2477,2421,56,0,310,0,6
40186,1,2496,2503,-7,0,4,0,6
40187,2,2389,2482,-93,0,46,0,6
40188,1,2512,2617,-105,0,242,0,6
40189,1,2464,2485,-21,0,40,0,6
40190,1,2516,2425,91,0,58,0,6
40191,2,2475,2389,86,0,487,0,6
40192,1,2365,2431,-66,0,207,0,8
40193,2,2358,2472,-114,0,200,1,6
40194,1,2613,2409,204,0,21,0,6
40195,2,2264,2501,-237,0,311,0,6
40196,2,2495,2448,47,0,405,0,6
40197,1,2402,2290,112,0,152,0,6
40198,2,2382,2423,-41,0,226,1,6
40199,2,2460,2396,64,0,16,0,6
40200,2,2445,2396,49,0,50,0,6
40201,2,2476,2571,-95,0,53,0,6
40202,2,2336,2446,-110,0,46,0,8
40203,2,2280,2456,-176,0,4,0,6
40204,2,2406,2357,49,0,106,0,6
40205,1,2419,2448,-29,0,133,0,6
40206,2,2466,2377,89,0,13,0,6
40207,1,2417,2351,66,0,40,1,6
40208,1,2662,2600,62,0,311,0,6
40209,1,2324,2400,-76,0,296,0,6
40210,2,2463,2453,10,0,487,0,6
40211,2,2368,2469,-101,0,20,0,6
40212,1,2575,2472,103,0,110,0,6
40213,2,2669,2781,-112,0,121,1,6
40214,3,2474,2447,27,0,45,0,6
40215,2,2479,2470,9,0,41,0,6
40216,2,2410,2619,-209,0,326,0,6
40217,1,2403,2363,40,0,8,0,6
40218,1,2420,2375,45,0,20,0,6
40219,1,2508,2262,246,0,455,0,6
40220,1,2401,2288,113,0,463,1,6
40221,2,2468,2579,-111,0,32,0,6
40222,2,2443,2486,-43,0,288,0,6
40223,2,2469,2460,9,0,487,0,6
40225,2,2406,2392,14,4,380,0,13
40226,2,2433,2295,138,0,421,1,6
40227,1,2566,2740,-174,0,265,1,6
40228,2,2622,2623,-1,0,122,0,6
40229,1,2454,2451,3,0,58,0,6
40230,1,2402,2408,-6,0,234,0,6
40231,1,2499,2283,216,0,112,0,5
40232,3,2206,2515,-309,0,247,0,5
40233,1,2272,2436,-164,0,33,1,5
40234,1,2401,2371,30,0,10,0,6
40235,1,2421,2611,-190,0,484,0,6
40236,2,2422,2308,114,0,43,0,6
40237,1,2423,2385,38,0,310,0,6
40238,2,2609,2520,89,0,120,0,6
40239,1,2525,2396,129,0,45,0,6
40240,2,2407,2616,-209,0,210,0,6
40241,1,2420,2380,40,0,0,0,6
40242,2,2239,2428,-189,0,107,0,8
40243,2,2403,2361,42,0,0,1,6
40244,1,2361,2520,-159,0,45,0,6
40245,1,2421,2459,-38,0,140,0,6
40246,1,2406,2408,-2,0,131,0,6
40247,2,2279,2418,-139,0,200,0,6
40248,2,2476,2354,122,0,249,0,6
40249,3,2442,2352,90,0,15,0,6
40250,1,2408,2360,48,0,4,0,6
40251,2,2428,2377,51,0,63,0,6
40252,2,2378,2400,-22,4,133,0,13
40253,1,2473,2364,109,0,426,0,6
40254,2,2455,2489,-34,0,157,0,6
40255,2,2422,2420,2,0,51,1,6
40256,1,2432,2236,196,0,45,0,8
40257,3,2459,2457,2,0,200,0,6
40258,2,2378,2474,-96,0,4,0,6
40259,1,2437,2346,91,0,211,0,6
40260,2,2263,2425,-162,0,122,0,6
40261,2,2317,2426,-109,0,304,0,6
40262,2,2618,2666,-48,0,301,0,6
40263,1,2473,2314,159,0,201,0,6
40264,2,2595,2602,-7,0,242,0,6
40265,1,2618,2665,-47,0,112,0,6
40266,2,2329,2440,-111,0,406,0,6
40267,3,2430,2408,22,0,122,0,6
40268,2,2353,2405,-52,0,4,0,6
40269,1,2583,2529,54,0,140,0,6
40270,1,2460,2464,-4,0,112,1,6
40271,1,2259,2515,-256,0,278,0,6
40272,2,2445,2460,-15,0,251,0,6
40273,2,2436,2411,25,0,245,0,6
40274,3,2415,2404,11,0,302,0,6
40275,3,2376,2413,-37,0,9,0,6
40276,2,2406,2412,-6,0,17,0,6
40277,1,2402,2329,73,0,140,0,6
40278,1,2316,2427,-111,0,302,0,6
40279,1,2608,2590,18,0,120,0,6
40280,1,2512,2369,143,0,23,0,6
40281,2,2376,2534,-158,0,1,0,6
40282,1,2616,2468,148,0,110,0,6
40283,2,2290,2451,-161,0,100,1,6
40284,1,2366,2430,-64,0,260,0,6
40285,2,2289,2548,-259,0,245,0,5
40286,1,2442,2232,210,0,469,0,5
40287,1,2380,2416,-36,0,242,1,6
40288,2,2340,2447,-107,0,190,0,6
40289,3,2290,2433,-143,0,245,0,6
40290,1,2466,2463,3,0,110,0,6
40291,1,2629,2574,55,0,326,0,6
40292,2,2384,2422,-38,0,226,1,6
40293,2,2392,2426,-34,0,265,0,8
40294,1,2360,2477,-117,0,11,0,6
40295,2,2428,2367,61,0,386,0,6
40296,3,2305,2477,-172,0,106,0,6
40297,2,2303,2426,-123,0,150,0,6
40298,1,2481,2373,108,0,190,0,6
40299,2,2603,2527,76,0,130,1,6
40300,2,2428,2413,15,0,14,1,6
40301,2,2294,2440,-146,0,51,1,6
40302,1,2402,2379,23,0,40,0,6
40303,2,2410,2348,62,0,463,0,6
40304,2,2302,2426,-124,4,150,0,13
40305,2,2288,2416,-128,0,133,0,6
40306,2,2353,2425,-72,0,5,0,8
40307,2,2407,2426,-19,0,260,1,6
40308,1,2571,2515,56,0,112,0,6
40309,1,2375,2414,-39,0,113,0,6
40310,1,2404,2401,3,0,106,0,6
40311,1,2658,2451,207,0,267,0,6
40312,1,2444,2377,67,0,412,1,6
40314,2,2459,2476,-17,0,41,1,6
40315,1,2453,2370,83,0,153,0,6
40316,1,2418,2434,-16,0,101,0,6
40317,2,2358,2428,-70,0,250,0,6
40318,1,2524,2588,-64,0,46,1,6
40319,1,2409,2430,-21,0,200,0,6
40320,1,2465,2440,25,0,22,0,6
40321,2,2625,2465,160,0,341,1,6
40322,2,2536,2441,95,0,15,0,6
40323,2,2420,2233,187,0,143,0,6
40324,2,2423,2373,50,0,485,0,6
40325,1,2422,2316,106,0,56,0,6
40326,1,2488,2269,219,0,348,0,6
40327,1,2323,2442,-119,0,40,0,6
40328,1,2584,2613,-29,0,242,0,6
40329,1,2457,2368,89,0,331,0,6
40330,2,2305,2430,-125,0,305,0,6
40331,3,2445,2398,47,0,4,0,6
40332,2,2458,2465,-7,0,405,0,6
40333,1,2474,2373,101,0,96,0,6
40334,2,2340,2442,-102,0,309,0,6
40335,3,2428,2511,-83,0,4,0,5
40336,1,2410,2386,24,0,7,1,6
40337,3,2448,2468,-20,0,250,0,6
40338,3,2479,2419,60,0,150,0,6
40339,2,2438,2408,30,0,315,0,6
40340,2,2348,2420,-72,0,1,1,6
40341,1,2286,2405,-119,0,262,0,6
40342,2,2600,2503,97,0,28,0,6
40343,1,2266,2431,-165,0,409,0,8
40344,1,2539,2577,-38,0,1,0,6
40345,2,2381,2417,-36,0,330,0,6
40346,2,2413,2410,3,0,311,0,6
40347,1,2427,2379,48,0,63,0,6
40348,3,2379,2417,-38,0,101,0,6
40349,2,2569,2511,58,0,253,1,6
40350,1,2403,2279,124,0,442,0,8
40351,2,2380,2490,-110,0,152,0,6
40352,1,2469,2388,81,0,202,0,6
40353,1,2421,2415,6,0,350,0,6
40354,2,2410,2295,115,0,35,0,6
40355,1,2246,2403,-157,0,26,0,6
40356,2,2457,2472,-15,0,106,0,6
40357,3,2440,2485,-45,0,4,0,6
40358,2,2249,2421,-172,0,37,1,6
40359,1,2365,2485,-120,0,120,1,6
40360,1,2429,2299,130,0,4,0,6
40361,1,2341,2458,-117,0,121,0,6
40362,1,2402,2432,-30,0,461,0,6
40363,2,2266,2496,-230,0,278,1,6
40364,2,2634,2534,100,0,398,0,6
40365,1,2401,2299,102,0,200,0,6
40366,1,2522,2337,185,0,4,0,8
40367,1,2435,2471,-36,0,258,1,6
40368,1,2419,2351,68,0,199,0,6
40369,1,2363,2428,-65,0,4,0,6
40370,1,2579,2306,273,0,221,1,8
40371,2,2372,2449,-77,0,13,0,6
40372,1,2419,2425,-6,0,4,0,6
40373,2,2359,2434,-75,0,448,0,6
40374,2,2375,2562,-187,0,337,0,6
40375,2,2581,2478,103,0,253,1,6
40376,3,2434,2473,-39,0,300,0,6
40377,2,2302,2478,-176,0,7,1,6
40378,2,2534,2473,61,0,300,0,6
40379,2,2449,2528,-79,0,130,0,6
40380,1,2494,2376,118,0,103,0,6
40381,1,2431,2420,11,0,45,0,6
40382,1,2482,2454,28,0,0,0,6
40383,1,2446,2331,115,0,40,0,6
40384,2,2607,2591,16,0,120,0,6
40385,3,2398,2425,-27,4,122,0,13
40386,1,2639,2671,-32,0,386,1,6
40387,1,2425,2408,17,0,321,0,6
40388,1,2374,2432,-58,0,112,1,6
40389,1,2425,2479,-54,0,107,0,6
40390,1,2571,2366,205,0,13,0,6
40391,2,2449,2473,-24,0,241,0,6
40392,1,2452,2400,52,0,130,0,6
40393,3,2416,2425,-9,0,190,0,6
40394,1,2384,2473,-89,0,327,0,6
40395,1,2405,2301,104,0,319,0,6
40396,1,2517,2568,-51,0,317,1,6
40397,1,2472,2495,-23,0,40,0,6
40398,2,2416,2380,36,0,483,0,6
40399,2,2401,2525,-124,0,310,1,8
40400,2,2361,2405,-44,0,302,0,6
40401,1,2229,2473,-244,0,156,0,5
40402,1,2551,2287,264,0,171,0,5
40403,3,2445,2591,-146,0,432,0,5
40404,1,2459,2450,9,0,338,0,6
40405,2,2563,2528,35,0,41,1,6
40406,2,2480,2581,-101,0,463,0,6
40407,2,2449,2468,-19,0,111,0,6
40408,1,2327,2425,-98,0,406,1,6
40409,2,2403,2405,-2,0,10,1,6
40410,3,2477,2452,25,0,101,0,6
40411,1,2502,2264,238,0,404,0,6
40412,1,2541,2596,-55,0,245,1,6
40413,2,2265,2429,-164,0,153,1,5
40414,3,2510,2503,7,0,130,0,5
40415,2,2464,2441,23,0,392,1,6
40416,1,2421,2264,157,0,288,1,6
40417,1,2416,2404,12,0,4,1,6
40418,1,2326,2435,-109,0,144,1,6
40419,2,2411,2372,39,0,43,0,6
40420,1,2312,2426,-114,0,214,0,6
40421,1,2439,2574,-135,0,4,1,6
40422,1,2364,2419,-55,0,45,0,6
40423,2,2247,2433,-186,0,318,0,6
40424,1,2424,2478,-54,0,241,1,6
40425,2,2296,2443,-147,0,335,0,6
40426,2,2295,2433,-138,0,150,0,6
40427,2,2451,2443,8,0,267,1,6
40428,2,2372,2669,-297,0,131,1,6
40429,2,2403,2451,-48,0,58,0,6
40430,1,2529,2309,220,4,278,0,8
40431,1,2410,2386,24,0,484,0,6
40432,2,2486,2574,-88,0,32,0,6
40433,1,2424,2416,8,0,4,0,6
40434,2,2500,2627,-127,0,15,0,6
40435,1,2449,2457,-8,0,84,1,6
40436,2,2414,2472,-58,0,40,0,6
40437,2,2406,2365,41,0,1,0,6
40438,2,2432,2407,25,0,112,0,6
40439,2,2509,2397,112,0,107,0,6
40440,2,2261,2509,-248,0,278,0,6
40442,1,2665,2511,154,0,311,1,6
40443,2,2398,2410,-12,0,128,0,6
40444,1,2425,2356,69,0,40,0,6
40445,2,2444,2399,45,0,37,0,6
40446,3,2429,2238,191,4,325,0,13
40447,2,2401,2465,-64,0,484,1,6
40448,1,2441,2308,133,0,35,1,6
40449,2,2399,2494,-95,0,107,0,6
40450,1,2489,2479,10,0,242,0,6
40451,2,2484,2489,-5,0,10,0,6
40452,1,2298,2402,-104,0,216,0,6
40453,1,2433,2381,52,0,454,0,6
40454,3,2280,2452,-172,0,211,0,6
40455,1,2524,2523,1,0,310,0,6
40456,2,2597,2626,-29,0,127,0,6
40457,2,2442,2443,-1,0,10,0,6
40458,1,2408,2314,94,4,245,0,13
40459,3,2412,2370,42,0,8,0,6
40460,2,2534,2394,140,0,302,0,6
40461,1,2593,2556,37,0,338,0,6
40462,1,2410,2343,67,0,48,0,6
40463,1,2417,2410,7,0,310,1,6
40464,2,2356,2407,-51,0,1,1,6
40465,2,2419,2395,24,0,41,0,6
40466,1,2477,2447,30,0,123,0,6
40467,1,2441,2426,15,0,8,1,6
40468,1,2366,2411,-45,0,140,0,6
40469,2,2428,2458,-30,0,45,0,6
40470,1,2481,2348,133,0,34,0,6
40471,3,2351,2430,-79,0,302,0,6
40472,2,2452,2477,-25,0,106,0,6
40473,1,2405,2283,122,0,13,0,6
40474,3,2430,2302,128,4,135,0,13
40475,3,2566,2548,18,0,0,0,6
40476,2,2416,2447,-31,0,101,1,6
40477,2,2275,2425,-150,0,180,0,6
40478,1,2673,2334,339,0,43,0,6
40479,3,2472,2436,36,0,4,0,6
40480,1,2438,2392,46,0,404,0,6
40481,2,2376,2520,-144,0,143,1,6
40482,1,2394,2445,-51,0,245,0,6
40483,3,2499,2370,129,0,5,0,6
40484,1,2481,2543,-62,0,100,0,6
40485,3,2589,2630,-41,0,208,0,6
40486,2,2453,2495,-42,0,40,0,6
40487,2,2449,2436,13,0,40,0,6
40488,2,2374,2400,-26,0,107,0,6
40489,1,2731,2578,153,0,0,1,6
40490,1,2514,2259,255,0,103,0,6
40491,2,2450,2441,9,0,460,0,6
40492,2,2496,2453,43,0,13,1,6
40493,1,2525,2383,142,0,45,0,6
40494,2,2405,2487,-82,0,107,0,6
40495,1,2443,2398,45,0,302,0,6
40496,2,2510,2293,217,0,216,0,5
40497,1,2503,2292,211,0,113,0,5
40498,2,2437,2292,145,0,4,0,6
40499,1,2360,2530,-170,0,469,1,6
40500,1,2412,2333,79,0,128,0,6
40501,2,2591,2676,-85,0,145,1,6
40502,1,2568,2429,139,0,103,0,6
40504,1,2501,2377,124,0,0,0,8
40505,1,2412,2371,41,0,302,0,6
40506,1,2507,2426,81,0,190,0,6
40507,1,2452,2311,141,0,226,0,6
40508,1,2342,2485,-143,0,4,1,6
40509,1,2664,2551,113,0,278,0,6
40510,1,2598,2430,168,0,18,0,6
40511,1,2487,2455,32,0,245,0,6
40512,1,2410,2409,1,0,127,0,6
40513,2,2301,2424,-123,0,172,0,6
40514,1,2442,2482,-40,0,315,1,6
40515,2,2450,2471,-21,0,251,1,6
40516,2,2405,2439,-34,0,277,0,6
40517,2,2536,2548,-12,0,21,0,6
40518,2,2464,2357,107,0,100,0,6
40519,1,2471,2445,26,0,4,0,6
40520,2,2590,2379,211,0,112,0,6
40521,2,2421,2411,10,0,202,0,6
40522,1,2436,2479,-43,0,49,0,6
40523,2,2482,2447,35,0,101,0,6
40524,1,2452,2411,41,0,4,1,6
40525,1,2329,2404,-75,0,492,1,5
40526,2,2300,2447,-147,0,122,0,5
40527,2,2588,2553,35,0,246,0,5
40528,2,2405,2367,38,0,49,0,6
40529,1,2456,2384,72,0,438,0,6
40530,1,2442,2443,-1,0,45,0,6
40531,1,2463,2393,70,0,1,0,6
40532,2,2277,2445,-168,0,337,1,6
40533,1,2372,2448,-76,0,101,0,6
40534,1,2473,2217,256,0,40,0,8
40535,1,2371,2411,-40,0,15,0,6
40536,1,2428,2432,-4,0,288,0,6
40537,2,2630,2735,-105,0,312,1,6
40538,2,2449,2575,-126,0,46,0,6
40539,1,2417,2415,2,0,302,0,6
40540,1,2616,2448,168,0,18,1,6
40541,2,2400,2490,-90,0,102,0,6
40542,3,2427,2447,-20,0,4,0,6
40543,1,2255,2415,-160,0,300,0,6
40544,3,2287,2431,-144,4,86,0,13
40545,1,2444,2327,117,0,337,0,6
40546,2,2388,2687,-299,0,46,0,6
40547,2,2396,2449,-53,0,112,0,6
40548,1,2241,2402,-161,0,112,0,6
40549,2,2554,2531,23,0,245,0,6
40550,2,2505,2346,159,0,201,0,6
40551,1,2419,2422,-3,0,301,0,6
40552,1,2635,2505,130,0,40,0,8
40553,1,2522,2369,153,0,426,0,6
40554,2,2255,2426,-171,4,205,0,13
40555,2,2422,2468,-46,0,40,1,6
40556,1,2286,2415,-129,0,302,0,6
40557,1,2533,2348,185,0,115,0,6
40558,1,2453,2476,-23,0,40,0,6
40559,1,2430,2476,-46,0,107,1,6
40560,1,2399,2477,-78,0,0,0,6
40561,1,2468,2388,80,0,43,0,6
40562,2,2587,2587,0,0,33,0,6
40563,2,2416,2339,77,0,140,0,6
40564,1,2547,2581,-34,0,277,1,6
40565,1,2461,2351,110,0,346,0,6
40566,1,2361,2403,-42,0,45,0,6
40567,2,2288,2432,-144,0,335,0,6
40568,1,2421,2380,41,0,313,0,6
40569,2,2323,2496,-173,0,207,0,6
40570,2,2295,2402,-107,0,253,0,8
40571,1,2579,2445,134,0,110,0,6
40572,3,2386,2441,-55,0,308,0,6
40574,2,2399,2487,-88,0,484,0,6
40575,1,2419,2524,-105,0,184,0,6
40576,1,2277,2440,-163,0,485,1,6
40577,1,2624,2477,147,0,212,0,6
40578,1,2482,2358,124,0,363,0,6
40579,1,2437,2401,36,0,41,0,6
40580,2,2366,2448,-82,0,46,0,6
40582,2,2426,2354,72,0,305,0,6
40583,2,2428,2493,-65,0,132,0,6
40584,2,2427,2416,11,0,456,0,6
40585,3,2437,2448,-11,0,46,0,6
40586,1,2424,2425,-1,0,142,0,6
40587,2,2390,2465,-75,0,45,0,6
40588,3,2398,2428,-30,0,15,0,6
40589,1,2349,2414,-65,4,131,0,13
40590,2,2545,2626,-81,0,45,1,6
40591,2,2381,2427,-46,0,192,0,6
40592,2,2384,2488,-104,0,110,0,6
40593,2,2456,2280,176,0,112,1,6
40594,1,2537,2548,-11,0,145,0,6
40595,2,2403,2351,52,0,31,0,6
40596,1,2480,2300,180,0,6,0,6
40597,2,2525,2505,20,0,365,0,6
40598,1,2403,2221,182,0,116,0,5
40599,1,2268,2501,-233,0,267,0,5
40600,1,2302,2505,-203,0,300,0,5
40601,1,2407,2299,108,0,107,0,6
40602,1,2472,2443,29,0,11,0,6
40603,1,2401,2221,180,0,57,0,6
40604,2,2739,2700,39,0,301,0,6
40605,1,2434,2378,56,0,131,0,6
40606,1,2460,2472,-12,0,426,0,6
40607,1,2320,2466,-146,0,203,0,6
40608,1,2593,2619,-26,0,106,0,6
40609,1,2470,2459,11,0,101,1,6
40610,2,2406,2507,-101,0,201,0,6
40611,1,2470,2351,119,0,41,0,6
40612,3,2422,2383,39,0,235,0,6
40613,1,2491,2395,96,0,154,0,6
40614,2,2440,2304,136,0,40,0,6
40615,1,2409,2387,22,0,246,0,6
40616,2,2206,2425,-219,0,343,1,6
40617,3,2233,2491,-258,0,48,0,6
40618,2,2243,2525,-282,0,300,1,6
40619,1,2695,2265,430,0,325,0,6
40620,2,2262,2602,-340,0,21,0,6
40621,2,2202,2407,-205,0,113,0,6
40622,2,2346,2430,-84,0,207,0,6
40623,1,2285,2429,-144,4,113,0,13
40624,2,2441,2583,-142,0,15,0,6
40625,1,2406,2299,107,0,119,1,6
40626,2,2501,2311,190,0,226,0,8
40627,1,2513,2500,13,0,265,0,6
40628,2,2434,2348,86,0,167,0,6
40629,2,2424,2381,43,0,156,1,6
40630,1,2456,2506,-50,0,4,0,6
40631,2,2333,2493,-160,0,107,1,6
40632,3,2323,2459,-136,0,55,0,6
40633,2,2500,2376,124,0,250,1,6
40634,2,2267,2432,-165,0,344,0,6
40635,1,2509,2470,39,0,45,0,6
40636,3,2543,2397,146,0,111,0,6
40637,2,2495,2350,145,0,331,0,6
40638,1,2422,2417,5,0,6,0,6
40639,2,2367,2458,-91,0,320,0,6
40640,3,2289,2582,-293,0,114,0,5
40641,3,2559,2451,108,0,127,0,5
40642,1,2494,2518,-24,0,108,0,6
40643,1,2421,2458,-37,0,313,1,6
40644,3,2414,2386,28,0,200,0,6
40645,1,2362,2408,-46,0,45,1,6
40647,2,2452,2443,9,0,45,1,6
40648,1,2259,2419,-160,0,300,0,6
40649,1,2453,2382,71,0,300,0,6
40650,2,2469,2342,127,0,147,1,6
40651,3,2491,2399,92,0,0,0,6
40652,1,2543,2523,20,0,225,0,6
40653,2,2434,2385,49,0,112,0,6
40654,2,2347,2474,-127,0,40,0,6
40655,1,2415,2327,88,0,357,0,6
40656,2,2402,2366,36,0,15,0,6
40657,1,2518,2669,-151,0,199,0,6
40658,2,2289,2448,-159,0,45,0,6
40659,1,2458,2332,126,0,100,0,6
40660,1,2425,2374,51,0,46,0,6
40661,2,2630,2560,70,0,107,0,6
40662,1,2519,2483,36,0,453,0,6
40663,2,2511,2408,103,0,152,0,6
40664,2,2386,2601,-215,0,45,0,6
40665,2,2373,2497,-124,0,130,0,6
40666,1,2402,2297,105,0,57,1,6
40667,2,2500,2613,-113,0,45,0,6
40669,3,2466,2383,83,0,343,0,6
40670,1,2466,2326,140,0,58,1,6
40671,1,2427,2457,-30,0,146,1,6
40672,2,2423,2563,-140,0,277,0,6
40673,1,2439,2365,74,0,13,0,6
40674,2,2297,2435,-138,0,46,1,6
40675,1,2564,2599,-35,0,123,0,6
40676,2,2478,2428,50,0,466,1,6
40677,2,2436,2318,118,0,41,0,6
40678,2,2416,2412,4,0,344,1,6
40679,2,2429,2446,-17,0,46,0,8
40680,2,2323,2419,-96,0,67,0,6
40681,1,2512,2500,12,0,103,0,6
40682,2,2247,2407,-160,0,300,0,8
40683,2,2377,2422,-45,0,40,0,6
40684,3,2449,2512,-63,0,200,0,6
40685,2,2393,2670,-277,0,45,0,6
40686,2,2334,2483,-149,0,16,0,6
40687,1,2586,2438,148,0,45,0,6
40688,2,2294,2410,-116,0,302,1,6
40689,1,2451,2286,165,0,112,0,6
40690,2,2399,2541,-142,0,404,0,6
40691,2,2454,2476,-22,0,40,0,6
40692,2,2456,2444,12,0,125,0,6
40693,1,2478,2465,13,0,107,0,6
40694,3,2437,2478,-41,0,49,0,6
40695,1,2436,2388,48,0,4,0,6
40696,1,2400,2286,114,0,400,0,6
40697,2,2214,2442,-228,0,100,0,8
40698,1,2430,2295,135,0,485,0,6
40699,2,2384,2492,-108,0,106,0,6
40700,1,2510,2510,0,0,110,0,6
40701,2,2496,2384,112,0,300,0,6
40702,2,2384,2401,-17,0,45,0,6
40703,1,2398,2462,-64,0,45,1,6
40704,1,2617,2554,63,0,338,0,6
40705,2,2369,2455,-86,0,201,0,6
40706,2,2405,2372,33,4,245,0,13
40707,2,2253,2402,-149,0,213,1,6
40709,3,2370,2495,-125,0,332,0,6
40710,2,2732,2707,25,0,20,0,6
40711,2,2381,2524,-143,0,260,0,6
40712,2,2391,2496,-105,0,484,0,6
40713,2,2283,2454,-171,0,45,0,6
40714,1,2358,2487,-129,0,240,0,6
40715,2,2497,2278,219,0,140,0,5
40716,3,2299,2406,-107,0,125,0,5
40717,1,2567,2402,165,0,122,0,6
40718,1,2427,2449,-22,0,4,1,6
40719,2,2460,2483,-23,0,4,0,6
40720,2,2661,2623,38,0,453,0,6
40721,1,2466,2452,14,0,8,0,6
40722,1,2457,2368,89,0,4,0,6
40723,2,2380,2465,-85,0,277,0,6
40724,1,2369,2430,-61,0,130,0,6
40725,2,2496,2378,118,0,113,0,6
40726,2,2434,2590,-156,0,42,0,6
40727,3,2504,2427,77,0,1,0,6
40728,2,2518,2344,174,0,51,0,6
40729,1,2460,2426,34,0,140,0,6
40730,3,2404,2394,10,0,100,0,6
40731,3,2355,2504,-149,0,373,0,6
40732,2,2526,2570,-44,0,115,0,6
40733,1,2415,2334,81,0,4,0,6
40734,1,2424,2490,-66,0,311,0,6
40735,1,2486,2438,48,0,302,1,6
40736,2,2361,2430,-69,0,302,0,6
40737,1,2487,2272,215,0,211,0,6
40738,1,2527,2275,252,0,343,0,6
40739,1,2604,2282,322,0,455,0,6
40740,2,2281,2454,-173,0,115,1,6
40741,2,2288,2519,-231,0,37,0,6
40742,2,2287,2696,-409,0,190,1,6
40743,2,2257,2438,-181,0,45,0,6
40744,2,2446,2433,13,0,45,0,6
40745,1,2411,2326,85,0,106,0,6
40746,1,2470,2424,46,0,45,0,6
40747,1,2249,2404,-155,0,470,0,6
40748,1,2495,2469,26,0,45,1,6
40749,1,2493,2544,-51,0,422,0,6
40750,1,2421,2273,148,0,115,0,6
40751,1,2451,2396,55,0,1,0,6
40752,2,2402,2368,34,0,13,0,6
40753,2,2344,2516,-172,0,4,0,6
40754,2,2439,2440,-1,0,331,0,6
40755,2,2481,2449,32,0,101,0,6
40756,2,2294,2471,-177,0,106,0,6
40757,1,2409,2265,144,0,3,0,6
40758,1,2291,2448,-157,0,53,0,6
40759,2,2381,2424,-43,0,46,0,8
40760,1,2444,2211,233,0,0,0,8
40761,1,2581,2593,-12,0,193,1,6
40762,1,2414,2280,134,0,211,0,6
40763,2,2406,2363,43,0,310,0,8
40764,3,2290,2475,-185,0,106,0,6
40765,1,2479,2366,113,0,331,0,6
40766,1,2414,2294,120,0,150,0,6
40767,2,2497,2528,-31,0,455,0,6
40768,2,2360,2446,-86,0,46,1,6
40769,3,2518,2488,30,0,107,0,6
40770,2,2418,2477,-59,0,46,0,6
40771,1,2423,2376,47,0,40,0,6
40772,2,2428,2381,47,0,245,0,6
40773,1,2502,2357,145,0,127,1,6
40774,3,2403,2356,47,4,240,0,13
40775,2,2693,2692,1,0,39,0,6
40776,1,2391,2456,-65,0,140,0,6
40777,2,2391,2489,-98,0,5,0,6
40778,2,2344,2401,-57,0,374,0,6
40779,1,2454,2431,23,0,225,0,6
40780,1,2549,2503,46,0,40,0,6
40781,2,2570,2530,40,0,122,0,6
40782,1,2469,2294,175,0,313,1,6
40783,1,2457,2279,178,0,112,0,6
40784,1,2445,2490,-45,0,454,0,6
40785,2,2627,2403,224,0,246,0,6
40786,1,2455,2395,60,0,205,1,6
40787,1,2593,2431,162,0,115,0,6
40788,2,2226,2401,-175,0,456,0,5
40789,1,2578,2245,333,0,277,0,5
40790,2,2260,2558,-298,0,222,0,5
40791,1,2452,2341,111,0,41,0,5
40792,2,2467,2390,77,0,125,1,5
40793,3,2394,2496,-102,0,302,0,6
40794,3,2529,2419,110,0,45,0,6
40795,2,2593,2628,-35,0,42,0,6
40796,1,2519,2388,131,0,33,1,6
40797,2,2425,2381,44,0,442,1,6
40798,1,2453,2460,-7,0,107,1,6
40799,1,2489,2302,187,0,101,0,6
40800,1,2446,2475,-29,0,40,1,6
40801,1,2500,2387,113,0,154,0,6
40802,1,2579,2386,193,0,119,0,6
40803,1,2421,2376,45,0,235,0,6
40804,2,2498,2575,-77,0,123,0,6
40805,1,2654,2521,133,0,371,0,6
40806,3,2416,2408,8,0,304,0,6
40807,2,2389,2420,-31,0,140,1,6
40808,1,2424,2619,-195,0,127,0,6
40809,1,2443,2472,-29,0,125,0,6
40810,1,2503,2433,70,0,459,0,6
40811,2,2630,2550,80,0,398,0,6
40812,1,2493,2477,16,0,485,0,6
40813,2,2494,2398,96,0,485,0,6
40814,2,2391,2439,-48,0,1,0,6
40815,1,2416,2311,105,0,190,1,6
40816,2,2412,2396,16,0,3,0,6
40817,2,2472,2440,32,0,45,1,6
40818,1,2293,2431,-138,0,302,0,6
40819,2,2406,2332,74,4,37,0,13
40820,1,2464,2500,-36,0,463,0,6
40821,2,2575,2481,94,0,45,0,6
40822,1,2426,2351,75,0,0,1,6
40823,2,2259,2418,-159,0,343,0,6
40824,2,2489,2623,-134,0,45,0,6
40825,2,2610,2444,166,0,246,0,6
40826,3,2281,2449,-168,0,370,0,6
40827,2,2324,2433,-109,0,230,0,6
40828,3,2540,2517,23,0,48,0,6
40829,1,2449,2387,62,0,100,0,6
40830,2,2209,2446,-237,0,100,0,8
40831,2,2313,2433,-120,0,2,0,6
40832,2,2483,2533,-50,0,49,0,6
40833,2,2428,2596,-168,0,42,0,6
40834,2,2358,2493,-135,0,253,0,6
40835,1,2557,2537,20,0,101,0,6
40836,1,2497,2390,107,0,244,0,6
40837,1,2587,2661,-74,0,112,1,6
40838,1,2451,2460,-9,0,6,0,6
40839,2,2277,2445,-168,0,202,1,6
40840,1,2462,2602,-140,0,130,0,6
40841,1,2383,2428,-45,0,300,0,6
40842,2,2371,2426,-55,0,102,1,6
40843,2,2485,2526,-41,0,40,1,6
40844,2,2406,2293,113,0,106,0,6
40845,2,2402,2361,41,0,46,0,6
40846,3,2561,2627,-66,0,120,0,6
40847,1,2382,2454,-72,0,1,0,6
40848,1,2493,2301,192,0,42,0,5
40849,1,2404,2488,-84,0,147,0,5
40850,1,2428,2311,117,0,4,1,5
40851,2,2362,2483,-121,0,240,0,6
40852,2,2437,2485,-48,0,107,0,6
40853,1,2435,2356,79,0,211,0,6
40854,2,2389,2414,-25,0,111,0,6
40855,2,2455,2475,-20,0,40,0,6
40856,2,2483,2451,32,0,0,0,6
40857,2,2430,2344,86,4,409,0,13
40858,2,2339,2447,-108,0,201,0,6
40859,3,2411,2398,13,0,398,0,6
40860,1,2418,2325,93,0,0,0,6
40861,2,2333,2460,-127,0,45,0,6
40862,2,2554,2582,-28,0,380,0,6
40863,1,2421,2359,62,0,156,0,6
40864,2,2440,2299,141,0,4,1,6
40865,1,2491,2324,167,0,48,0,6
40866,2,2299,2492,-193,0,106,0,6
40867,2,2405,2406,-1,0,221,0,6
40868,2,2617,2588,29,0,226,0,6
40869,1,2470,2301,169,0,432,1,6
40870,2,2454,2487,-33,0,102,1,6
40871,1,2523,2472,51,0,13,0,6
40872,2,2441,2459,-18,0,5,0,6
40873,3,2496,2354,142,0,112,0,6
40874,2,2373,2419,-46,0,332,0,6
40875,1,2594,2479,115,0,250,0,6
40876,2,2600,2425,175,0,45,0,6
40877,1,2405,2366,39,0,20,0,6
40878,2,2580,2536,44,0,123,0,6
40879,2,2446,2452,-6,0,14,0,6
40880,2,2455,2456,-1,0,101,0,6
40881,2,2426,2385,41,0,278,1,6
40882,2,2550,2517,33,0,49,0,6
40883,1,2502,2449,53,0,43,1,6
40884,2,2432,2357,75,0,106,0,6
40885,1,2425,2383,42,0,85,0,6
40887,2,2531,2562,-31,0,267,1,6
40888,3,2480,2450,30,0,101,0,6
40889,2,2448,2429,19,0,1,0,6
40890,2,2512,2503,9,0,265,0,6
40891,2,2314,2421,-107,0,389,1,8
40892,3,2218,2404,-186,4,0,0,13
40893,2,2390,2415,-25,0,245,0,6
40894,1,2444,2354,90,0,101,0,6
40895,1,2322,2441,-119,0,4,1,6
40896,1,2411,2374,37,0,426,0,6
40898,1,2369,2424,-55,0,45,0,6
40899,2,2462,2449,13,0,6,1,6
40900,1,2490,2341,149,0,110,0,6
40901,1,2441,2316,125,0,299,0,6
40902,2,2396,2403,-7,0,257,0,6
40903,3,2356,2529,-173,0,256,0,6
40904,2,2457,2332,125,0,203,0,6
40905,2,2521,2353,168,0,13,1,6
40906,2,2415,2605,-190,0,4,1,6
40907,1,2697,2430,267,0,311,0,6
40908,2,2489,2568,-79,0,215,0,6
40909,1,2466,2360,106,0,331,1,6
40910,2,2366,2400,-34,0,0,0,8
40911,1,2424,2307,117,0,487,1,6
40912,2,2398,2494,-96,0,265,0,6
40913,1,2347,2411,-64,0,302,0,6
40914,1,2468,2528,-60,0,487,0,6
40915,2,2450,2480,-30,0,40,0,6
40916,1,2472,2498,-26,0,20,0,6
40917,2,2438,2283,155,0,222,0,6
40918,1,2587,2540,47,0,1,0,6
40919,1,2524,2222,302,0,487,0,6
40920,1,2458,2477,-19,0,41,0,6
40921,2,2249,2401,-152,0,300,0,6
40922,2,2538,2549,-11,0,326,0,6
40923,1,2471,2368,103,0,302,0,6
40924,2,2654,2594,60,0,278,1,6
40925,2,2626,2594,32,0,315,0,6
40926,2,2464,2448,16,0,205,0,6
40927,1,2345,2439,-94,0,100,0,6
40928,1,2446,2423,23,0,45,0,6
40929,1,2431,2366,65,0,4,0,6
40930,2,2556,2394,162,0,198,0,6
40931,2,2452,2274,178,0,106,1,8
40932,3,2433,2591,-158,0,107,0,6
40933,2,2543,2560,-17,0,4,1,6
40934,1,2449,2348,101,0,277,0,6
40935,2,2350,2422,-72,0,121,0,6
40936,1,2231,2409,-178,0,130,0,6
40937,3,2699,2531,168,0,210,0,6
40938,2,2451,2296,155,0,1,0,6
40939,1,2480,2219,261,4,120,0,13
40940,2,2420,2390,30,0,310,0,6
40941,1,2427,2408,19,0,112,0,6
40942,1,2377,2458,-81,0,193,1,6
40943,1,2428,2268,160,0,332,0,6
40944,1,2494,2394,100,0,131,0,6
40945,2,2269,2417,-148,0,46,0,6
40946,1,2485,2445,40,0,102,0,6
40947,1,2335,2425,-90,0,300,0,6
40948,2,2357,2464,-107,0,122,0,6
40949,1,2449,2300,149,0,40,0,8
40950,2,2382,2530,-148,0,247,0,6
40951,1,2713,2671,42,0,133,0,6
40952,2,2369,2435,-66,0,45,1,6
40953,1,2568,2466,102,0,130,1,6
40954,3,2471,2464,7,0,45,0,6
40955,1,2505,2474,31,0,278,0,6
40956,2,2444,2505,-61,0,303,1,6
40957,1,2399,2558,-159,0,10,0,6
40958,1,2509,2506,3,0,260,0,6
40959,1,2449,2395,54,0,112,0,6
40960,2,2340,2419,-79,0,301,0,6
40961,2,2543,2461,82,0,341,0,6
40962,2,2493,2521,-28,0,394,0,6
40963,1,2602,2417,185,0,1,1,6
40964,1,2378,2430,-52,0,127,1,6
40965,2,2309,2425,-116,0,311,1,6
40966,1,2372,2461,-89,0,108,0,6
40968,1,2548,2380,168,0,13,0,6
40969,3,2402,2443,-41,0,46,0,6
40970,2,2352,2496,-144,0,249,0,5
40971,1,2279,2411,-132,0,140,1,5
40972,1,2432,2230,202,0,110,0,5
40973,1,2453,2394,59,0,277,1,6
40974,1,2573,2484,89,0,45,0,6
40975,2,2456,2574,-118,0,487,0,6
40976,2,2275,2428,-153,0,45,0,6
40977,2,2535,2531,4,0,411,0,6
40978,1,2441,2455,-14,0,1,1,6
40979,3,2435,2345,90,0,4,0,6
40980,1,2433,2363,70,0,190,0,6
40981,2,2458,2342,116,0,490,1,6
40982,2,2426,2430,-4,0,80,0,6
40983,1,2600,2620,-20,0,198,1,6
40984,2,2396,2470,-74,0,226,0,6
40985,2,2469,2353,116,0,112,0,6
40986,2,2283,2425,-142,0,343,1,6
40987,2,2377,2551,-174,0,187,0,6
40988,3,2532,2361,171,0,50,0,6
40989,2,2352,2439,-87,0,338,0,6
40990,1,2398,2400,-2,0,0,1,6
40991,1,2418,2297,121,0,46,1,6
40992,2,2459,2418,41,0,375,0,6
40993,1,2524,2555,-31,0,250,0,6
40994,2,2498,2480,18,0,210,0,6
40995,1,2589,2436,153,0,125,0,6
40996,2,2420,2532,-112,0,0,0,6
40997,2,2573,2648,-75,0,113,0,6
40998,1,2443,2413,30,0,1,0,6
40999,2,2326,2484,-158,0,374,1,6
41000,1,2568,2538,30,0,140,0,6
41001,2,2342,2405,-63,0,45,0,6
41002,1,2476,2333,143,0,101,0,8
41003,1,2343,2435,-92,0,100,0,6
41004,2,2527,2360,167,0,58,0,6
41005,1,2431,2424,7,0,131,1,6
41006,3,2277,2414,-137,0,344,0,6
41007,1,2534,2536,-2,0,46,0,6
41008,2,2393,2538,-145,0,211,0,6
41009,2,2396,2410,-14,0,40,0,6
41010,1,2492,2326,166,0,41,0,6
41011,2,2286,2423,-137,4,201,1,13
41012,2,2358,2452,-94,0,300,0,6
41013,3,2478,2365,113,0,13,0,6
41014,1,2435,2403,32,0,100,0,6
41015,2,2438,2417,21,0,143,1,6
41016,1,2461,2572,-111,0,301,0,6
41017,3,2532,2575,-43,0,4,0,6
41018,1,2536,2527,9,0,121,0,6
41019,2,2464,2471,-7,0,41,0,6
41020,2,2306,2488,-182,0,41,1,6
41021,2,2361,2443,-82,0,103,0,8
41022,2,2468,2495,-27,0,106,0,6
41023,1,2422,2288,134,0,46,0,6
41024,1,2726,2577,149,0,43,0,6
41025,2,2432,2592,-160,0,241,0,6
41026,1,2398,2521,-123,0,117,1,6
41027,2,2425,2314,111,0,456,0,8
41028,1,2515,2480,35,0,260,1,6
41029,1,2460,2439,21,0,46,0,6
41030,1,2452,2335,117,0,0,0,8
41031,2,2388,2469,-81,0,46,0,6
41032,1,2429,2335,94,0,231,0,6
41033,1,2529,2534,-5,0,47,1,6
41034,2,2351,2405,-54,4,45,0,13
41035,1,2601,2607,-6,0,105,1,6
41036,2,2473,2421,52,0,313,0,6
41037,1,2302,2411,-109,0,338,0,6
41038,2,2391,2487,-96,0,30,0,6
41039,1,2474,2453,21,0,302,0,6
41040,1,2449,2276,173,0,260,1,6
41041,2,2408,2356,52,0,101,1,6
41042,2,2526,2330,196,0,43,0,6
41043,2,2366,2493,-127,0,131,0,6
41044,1,2312,2513,-201,0,30,0,6
41045,1,2401,2412,-11,0,49,1,6
41046,2,2445,2699,-254,0,180,0,6
41047,1,2608,2361,247,0,172,0,6
41048,1,2454,2346,108,0,30,0,6
41049,2,2431,2390,41,0,288,1,6
41050,1,2602,2458,144,0,62,0,6
41051,2,2294,2464,-170,0,241,1,6
41052,1,2569,2581,-12,0,154,0,6
41053,3,2461,2485,-24,0,455,0,6
41054,2,2366,2420,-54,0,1,0,6
41055,1,2408,2279,129,0,11,0,6
41056,1,2564,2530,34,0,115,0,6
41057,2,2286,2454,-168,0,310,0,6
41058,2,2403,2248,155,0,110,1,6
41059,2,2570,2537,33,0,152,0,6
41060,1,2614,2448,166,0,45,0,6
41061,3,2474,2410,64,0,409,0,6
41062,1,2414,2318,96,0,426,1,6
41063,1,2384,2492,-108,0,465,0,6
41064,1,2512,2337,175,0,115,0,6
41065,2,2434,2466,-32,0,312,0,6
41066,1,2367,2457,-90,0,50,1,6
41067,1,2423,2347,76,0,0,0,6
41068,2,2428,2351,77,0,344,0,6
41069,1,2427,2391,36,0,310,0,6
41070,1,2448,2463,-15,0,278,0,6
41071,2,2331,2433,-102,0,300,0,6
41072,2,2378,2522,-144,0,200,1,6
41073,1,2574,2729,-155,0,455,0,6
41074,1,2469,2458,11,0,110,0,6
41075,1,2412,2279,133,0,345,0,6
41076,2,2278,2510,-232,0,132,1,8
41078,1,2487,2294,193,0,463,0,6
41079,1,2418,2386,32,0,140,0,6
41080,1,2548,2531,17,0,246,0,6
41081,2,2379,2554,-175,0,145,0,6
41082,1,2485,2309,176,0,338,0,6
41083,1,2310,2440,-130,0,325,1,6
41084,1,2316,2461,-145,0,459,0,6
41085,1,2283,2400,-117,4,36,0,13
41086,1,2383,2460,-77,0,45,0,6
41087,1,2574,2533,41,0,140,0,6
41088,2,2491,2387,104,0,47,1,6
41089,1,2423,2432,-9,0,48,0,6
41090,1,2596,2429,167,0,200,0,6
41091,2,2477,2371,106,0,0,0,6
41092,1,2280,2458,-178,0,106,0,6
41093,2,2280,2500,-220,0,48,0,5
41094,1,2403,2592,-189,0,453,0,6
41095,2,2491,2454,37,0,404,1,6
41096,1,2476,2273,203,0,100,0,6
41097,3,2475,2520,-45,0,265,0,6
41098,1,2484,2469,15,0,241,0,6
41099,2,2391,2411,-20,0,490,0,6
41100,1,2721,2582,139,0,300,0,6
41101,1,2457,2454,3,0,428,1,6
41102,1,2471,2429,42,0,40,0,6
41103,3,2407,2336,71,0,332,0,6
41104,2,2350,2418,-68,0,16,1,6
41105,1,2304,2400,-96,0,310,0,8
41106,1,2448,2480,-32,0,474,0,8
41107,1,2466,2480,-14,0,45,1,6
41108,2,2404,2290,114,0,395,0,6
41109,1,2413,2425,-12,0,46,0,6
41110,2,2412,2525,-113,0,45,1,6
41111,1,2575,2569,6,0,257,0,6
41112,3,2396,2416,-20,0,288,0,6
41113,2,2439,2617,-178,0,151,0,6
41114,3,2331,2581,-250,0,47,0,8
41115,1,2457,2495,-38,0,265,1,6
41116,2,2292,2456,-164,0,100,0,8
41117,2,2544,2453,91,0,311,0,6
41118,2,2376,2424,-48,0,300,1,6
41119,2,2579,2515,64,0,40,0,6
41120,2,2339,2463,-124,0,40,0,8
41121,2,2538,2557,-19,0,400,0,6
41122,1,2434,2369,65,0,0,1,6
41123,3,2554,2658,-104,0,380,0,6
41124,2,2364,2473,-109,0,54,0,6
41125,2,2525,2563,-38,0,405,0,6
41126,2,2364,2411,-47,0,130,0,6
41127,2,2441,2431,10,0,152,0,6
41128,1,2538,2353,185,0,300,1,6
41129,1,2358,2421,-63,0,100,1,6
41130,1,2488,2479,9,0,454,0,6
41131,2,2385,2557,-172,0,45,1,6
41132,2,2342,2437,-95,0,220,0,6
41133,2,2475,2423,52,0,250,1,6
41134,1,2450,2275,175,0,121,1,6
41135,2,2392,2404,-12,0,106,0,6
41136,2,2501,2386,115,0,10,0,6
41137,2,2307,2450,-143,0,122,0,6
41138,2,2378,2469,-91,0,106,0,6
41139,1,2453,2532,-79,0,303,0,6
41140,1,2451,2419,32,0,2,1,6
41141,1,2421,2357,64,0,459,0,6
41142,2,2502,2620,-118,0,7,0,6
41143,3,2578,2725,-147,0,40,0,6
41144,2,2433,2325,108,0,255,1,6
41145,1,2599,2475,124,0,247,0,6
41146,2,2554,2387,167,0,195,1,6
41147,1,2443,2302,141,0,101,1,6
41148,2,2513,2299,214,0,111,1,6
41149,1,2411,2215,196,4,152,0,13
41150,2,2224,2421,-197,0,45,0,6
41151,1,2349,2407,-58,0,4,0,6
41152,2,2543,2388,155,0,110,0,6
41153,2,2484,2462,22,0,4,0,6
41154,1,2498,2341,157,0,40,0,6
41155,2,2426,2429,-3,0,1,1,6
41156,1,2298,2476,-178,0,302,0,6
41157,2,2367,2453,-86,0,278,0,6
41158,2,2564,2581,-17,0,151,0,6
41159,1,2424,2461,-37,0,7,0,6
41160,1,2456,2365,91,0,16,0,6
41161,2,2537,2520,17,0,312,0,6
41162,3,2419,2494,-75,0,46,0,6
41163,1,2569,2382,187,0,102,0,6
41164,1,2287,2402,-115,0,4,0,6
41165,1,2518,2453,65,0,490,0,6
41166,1,2359,2430,-71,0,116,0,6
41167,3,2294,2443,-149,0,113,0,6
41168,3,2365,2497,-132,0,130,0,6
41169,2,2263,2407,-144,0,300,0,6
41170,1,2701,2611,90,0,300,1,6
41171,1,2467,2603,-136,0,461,1,6
41172,2,2294,2475,-181,0,265,0,6
41173,1,2473,2374,99,0,0,0,6
41174,1,2477,2364,113,0,315,0,6
41175,3,2341,2459,-118,0,255,0,8
41176,1,2485,2306,179,0,483,1,6
41177,3,2474,2336,138,0,45,0,6
41178,1,2460,2460,0,0,54,1,6
41179,2,2212,2415,-203,4,52,0,13
41180,1,2532,2346,186,0,118,0,6
41181,2,2415,2243,172,0,382,1,6
41182,2,2531,2592,-61,0,404,0,6
41183,2,2454,2448,6,0,264,0,6
41184,3,2439,2430,9,0,200,0,6
41185,1,2470,2298,172,0,201,0,8
41186,1,2414,2364,50,0,0,0,6
41187,2,2429,2360,69,0,293,1,6
41188,2,2400,2417,-17,0,120,0,6
41189,1,2416,2371,45,0,4,1,6
41190,2,2408,2511,-103,0,40,1,6
41191,2,2624,2656,-32,0,380,0,6
41192,2,2541,2373,168,0,45,0,6
41193,1,2489,2404,85,0,139,0,6
41194,1,2423,2410,13,0,38,0,6
41195,3,2449,2464,-15,0,234,0,6
41196,2,2400,2433,-33,0,253,0,6
41197,2,2529,2556,-27,0,330,0,6
41198,2,2341,2468,-127,0,130,1,6
41199,1,2307,2454,-147,0,46,1,6
41200,1,2442,2304,138,0,101,0,6
41201,1,2474,2371,103,0,202,0,8
41202,2,2478,2559,-81,0,255,0,6
41203,2,2356,2481,-125,0,331,0,6
41204,3,2581,2569,12,0,45,0,6
41205,2,2430,2456,-26,0,80,0,6
41206,1,2382,2425,-43,0,300,0,6
41207,1,2370,2478,-108,0,106,0,6
41208,1,2442,2333,109,0,256,0,6
41209,1,2519,2450,69,0,265,1,6
41210,2,2360,2460,-100,0,414,1,6
41211,1,2518,2546,-28,0,101,0,6
41212,3,2390,2440,-50,0,45,0,6
41213,2,2490,2535,-45,0,112,0,6
41214,1,2428,2321,107,4,215,0,13
41215,1,2436,2386,50,0,222,0,5
41216,2,2466,2338,128,0,45,0,6
41217,2,2542,2361,181,0,112,0,6
41218,2,2396,2469,-73,0,207,0,6
41219,2,2330,2429,-99,0,6,0,6
41220,2,2334,2490,-156,0,45,0,6
41221,1,2418,2209,209,4,242,0,13
41222,3,2393,2426,-33,0,46,0,6
41223,1,2485,2461,24,0,46,1,6
41224,2,2360,2419,-59,0,100,1,6
41225,2,2337,2475,-138,0,40,0,8
41226,1,2563,2473,90,0,248,0,6
41227,2,2330,2405,-75,0,4,1,6
41228,2,2595,2483,112,0,246,1,6
41229,2,2530,2597,-67,0,190,0,6
41230,1,2431,2420,11,0,343,0,6
41231,1,2493,2373,120,0,11,0,6
41232,3,2469,2567,-98,0,248,0,6
41233,2,2454,2430,24,0,45,1,6
41234,2,2269,2416,-147,0,343,0,6
41235,1,2366,2445,-79,0,300,0,6
41236,1,2527,2619,-92,0,454,0,6
41237,1,2457,2473,-16,0,190,0,6
41238,2,2395,2425,-30,0,140,0,6
41239,2,2438,2394,44,0,201,0,6
41240,2,2329,2446,-117,0,41,1,6
41241,2,2425,2302,123,0,4,1,6
41242,2,2292,2422,-130,0,100,0,6
41243,2,2366,2449,-83,0,62,0,6
41244,1,2359,2513,-154,0,9,1,8
41245,1,2454,2395,59,0,123,0,6
41246,2,2404,2424,-20,0,4,1,6
41247,1,2540,2494,46,0,224,1,6
41248,2,2430,2533,-103,0,242,0,6
41249,2,2260,2400,-140,0,106,0,6
41250,2,2407,2471,-64,0,404,0,6
41251,2,2498,2535,-37,0,5,0,6
41252,3,2317,2433,-116,4,369,0,13
41253,2,2389,2413,-24,0,40,1,6
41254,2,2309,2419,-110,0,107,0,6
41255,2,2404,2488,-84,0,300,1,6
41256,1,2426,2319,107,4,40,0,13
41257,1,2348,2468,-120,0,121,0,6
41258,1,2375,2504,-129,0,111,0,6
41259,2,2393,2464,-71,0,46,0,6
41260,1,2400,2411,-11,0,385,0,6
41261,1,2474,2371,103,0,130,0,6
41262,1,2446,2392,54,0,357,0,6
41263,2,2207,2421,-214,4,380,0,13
41264,2,2470,2377,93,0,0,0,6
41265,2,2228,2458,-230,0,10,0,8
41266,2,2369,2534,-165,0,130,1,6
41267,3,2569,2580,-11,0,207,0,6
41268,2,2471,2304,167,0,302,0,6
41269,1,2453,2428,25,0,142,0,6
41270,2,2426,2298,128,0,200,0,6
41271,2,2401,2432,-31,0,270,1,6
41272,1,2493,2462,31,0,136,0,6
41273,1,2372,2502,-130,0,302,1,6
41274,2,2346,2406,-60,0,302,0,6
41275,1,2498,2539,-41,0,300,0,6
41276,2,2566,2471,95,0,248,0,6
41277,1,2465,2423,42,0,21,0,6
41278,3,2478,2469,9,0,50,0,6
41279,1,2561,2572,-11,0,43,0,6
41280,3,2365,2425,-60,0,119,0,6
41281,1,2438,2373,65,0,100,0,6
41282,1,2402,2285,117,0,101,0,6
41283,1,2469,2446,23,0,302,0,6
41284,1,2602,2482,120,0,345,0,6
41285,1,2413,2296,117,0,243,1,6
41286,1,2410,2359,51,0,113,1,6
41287,3,2385,2463,-78,0,106,0,6
41288,1,2442,2496,-54,0,277,0,6
41290,1,2498,2588,-90,0,460,1,6
41291,3,2501,2360,141,0,242,0,6
41292,1,2490,2355,135,0,46,0,6
41293,2,2367,2401,-34,0,0,0,6
41294,2,2478,2401,77,0,127,0,6
41295,2,2344,2448,-104,0,247,1,6
41296,1,2436,2437,-1,0,124,1,6
41297,3,2383,2494,-111,0,302,0,6
41298,2,2275,2506,-231,0,45,0,6
41299,1,2423,2260,163,0,6,0,6
41300,2,2314,2409,-95,0,30,0,6
41301,1,2495,2411,84,0,115,0,6
41302,2,2441,2295,146,0,14,0,6
41303,2,2328,2522,-194,0,325,1,6
41304,1,2606,2367,239,0,101,0,6
41305,2,2343,2706,-363,0,50,1,6
41306,1,2405,2424,-19,0,20,1,6
41307,1,2527,2518,9,0,45,0,6
41308,2,2390,2459,-69,0,4,0,6
41309,1,2457,2499,-42,0,2,0,6
41310,1,2362,2485,-123,0,455,0,6
41311,1,2403,2361,42,0,100,0,6
41312,1,2480,2220,260,0,245,0,8
41313,1,2474,2493,-19,0,302,0,6
41314,2,2411,2341,70,0,100,0,6
41315,2,2402,2419,-17,0,40,1,6
41316,1,2530,2494,36,0,240,0,6
41317,1,2593,2534,59,0,132,1,6
41318,2,2418,2384,34,0,112,0,6
41320,2,2580,2468,112,0,100,0,6
41321,3,2502,2492,10,0,315,0,6
41322,1,2418,2470,-52,0,131,0,6
41323,2,2387,2437,-50,0,270,0,6
41324,2,2368,2443,-75,0,40,1,6
41325,1,2467,2392,75,0,25,0,6
41326,3,2469,2478,-9,0,453,0,6
41327,2,2424,2492,-68,0,313,0,6
41328,2,2313,2407,-94,0,248,0,6
41329,2,2429,2384,45,0,366,0,6
41330,2,2463,2391,72,0,241,1,6
41331,1,2606,2490,116,0,395,0,6
41332,1,2451,2484,-33,0,129,1,6
41333,2,2492,2463,29,0,136,0,6
41334,2,2537,2367,170,0,300,1,6
41335,1,2348,2415,-67,0,245,0,6
41336,1,2472,2494,-22,0,13,0,6
41337,1,2462,2386,76,0,0,0,6
41338,1,2403,2355,48,0,0,0,6
41339,3,2493,2218,275,0,140,0,5
41340,2,2302,2441,-139,0,154,0,5
41341,1,2467,2526,-59,0,338,1,6
41342,2,2477,2370,107,0,277,1,6
41343,2,2460,2287,173,0,45,0,8
41344,2,2292,2411,-119,0,30,0,6
41345,1,2327,2478,-151,0,45,0,8
41346,2,2435,2509,-74,0,4,0,6
41347,1,2408,2285,123,0,310,0,6
41349,1,2406,2336,70,0,107,0,6
41350,2,2376,2524,-148,0,1,1,6
41351,2,2540,2524,16,0,28,1,6
41352,3,2496,2383,113,0,246,0,6
41353,2,2533,2566,-33,0,140,0,6
41354,1,2431,2430,1,0,151,0,6
41355,2,2442,2415,27,0,303,0,6
41356,2,2559,2408,151,0,15,0,6
41357,1,2487,2449,38,0,7,0,6
41358,3,2410,2317,93,0,330,0,6
41359,1,2418,2411,7,0,246,1,6
41360,2,2460,2486,-26,0,190,0,6
41361,1,2341,2405,-64,0,150,0,6
41362,1,2489,2447,42,0,30,1,6
41363,1,2425,2258,167,4,245,0,13
41364,1,2412,2396,16,0,211,0,6
41365,2,2529,2602,-73,0,4,0,6
41366,2,2426,2390,36,0,315,0,6
41367,1,2355,2463,-108,0,201,0,6
41368,2,2419,2354,65,0,302,0,6
41369,1,2497,2424,73,0,40,0,6
41370,1,2291,2403,-112,0,204,0,6
41371,2,2379,2422,-43,0,277,0,6
41372,1,2486,2391,95,0,15,0,6
41373,2,2401,2450,-49,0,45,0,6
41374,1,2408,2417,-9,0,145,1,6
41375,1,2424,2424,0,0,131,0,6
41376,2,2411,2306,105,0,51,0,6
41377,1,2463,2292,171,0,116,0,6
41378,1,2566,2573,-7,0,13,0,6
41379,1,2201,2417,-216,0,221,0,8
41380,2,2385,2470,-85,0,354,0,6
41381,3,2458,2393,65,0,106,0,6
41382,1,2382,2448,-66,0,145,0,6
41383,1,2478,2469,9,0,15,0,6
41384,1,2489,2414,75,0,81,1,6
41385,1,2444,2366,78,0,440,1,6
41386,3,2565,2492,73,0,267,0,6
41387,1,2491,2327,164,0,114,1,6
41388,2,2346,2475,-129,0,0,0,6
41389,2,2406,2348,58,0,0,0,8
41391,1,2514,2529,-15,0,242,0,6
41392,2,2475,2480,-5,0,4,0,6
41393,2,2405,2310,95,0,41,1,8
41394,2,2290,2407,-117,0,344,0,6
41395,2,2528,2377,151,0,251,1,6
41396,2,2476,2480,-4,0,302,0,6
41397,2,2260,2413,-153,0,205,0,6
41398,2,2431,2319,112,4,256,0,13
41399,3,2412,2378,34,0,45,0,6
41400,3,2571,2566,5,0,151,0,6
41401,1,2454,2315,139,0,40,0,8
41402,3,2471,2453,18,0,120,0,6
41403,2,2387,2408,-21,0,40,0,6
41404,2,2237,2484,-247,0,106,0,8
41405,1,2545,2471,74,0,123,0,6
41406,2,2492,2470,22,0,45,0,6
41407,1,2466,2362,104,0,0,0,6
41408,1,2451,2452,-1,0,45,0,6
41409,1,2400,2300,100,0,151,0,6
41410,2,2527,2436,91,0,369,1,6
41411,3,2423,2311,112,0,150,0,6
41412,2,2349,2478,-129,0,10,0,6
41413,2,2335,2421,-86,0,84,0,6
41414,1,2427,2304,123,0,306,1,6
41415,2,2308,2431,-123,0,43,0,6
41416,3,2366,2433,-67,0,102,0,6
41417,2,2386,2493,-107,0,48,0,6
41418,1,2567,2571,-4,0,454,0,6
41419,3,2348,2476,-128,0,153,0,6
41420,2,2420,2282,138,0,0,0,6
41421,2,2204,2412,-208,0,315,0,6
41422,2,2462,2550,-88,0,2,0,6
41423,2,2415,2410,5,0,485,0,6
41424,1,2388,2433,-45,0,110,0,6
41425,2,2368,2426,-58,0,110,0,6
41426,1,2413,2325,88,0,395,1,6
41427,3,2508,2348,160,0,14,0,6
41428,2,2499,2609,-110,0,269,1,6
41429,1,2525,2342,183,0,415,0,6
41430,1,2406,2297,109,0,80,1,6
41431,3,2450,2333,117,0,146,0,6
41432,1,2707,2369,338,0,343,1,6
41433,2,2519,2525,-6,0,141,0,6
41434,1,2398,2457,-59,0,45,0,6
41435,2,2279,2419,-140,0,332,1,6
41436,2,2441,2389,52,0,277,1,6
41437,1,2488,2299,189,0,88,1,6
41438,1,2405,2424,-19,0,85,1,6
41439,1,2523,2444,79,0,45,0,6
41440,1,2378,2455,-77,0,189,0,6
41441,2,2400,2243,157,0,40,1,6
41442,1,2457,2396,61,0,300,0,6
41443,1,2446,2460,-14,0,311,1,6
41444,2,2437,2495,-58,0,190,0,6
41445,3,2416,2467,-51,0,315,0,6
41446,1,2414,2430,-16,0,302,0,6
41447,2,2324,2411,-87,0,312,0,6
41448,1,2341,2414,-73,0,203,0,6
41449,2,2452,2274,178,0,0,0,8
41450,2,2442,2494,-52,0,211,0,6
41451,1,2484,2463,21,0,49,0,6
41452,2,2411,2331,80,0,40,1,6
41453,2,2410,2400,10,0,242,0,6
41454,2,2493,2612,-119,0,4,1,6
41455,1,2432,2288,144,0,13,1,6
41456,1,2479,2396,83,0,302,1,6
41457,3,2490,2564,-74,0,457,0,6
41458,2,2386,2456,-70,0,373,0,6
41459,2,2486,2591,-105,0,453,0,6
41460,1,2416,2280,136,2,400,0,25
41461,1,2406,2404,2,0,49,0,6
41462,3,2662,2471,191,0,311,0,6
41463,1,2408,2409,-1,0,100,0,6
41464,1,2548,2418,130,0,490,0,6
41465,2,2416,2453,-37,0,150,0,6
41466,1,2534,2564,-30,0,7,0,6
41467,2,2394,2497,-103,0,5,0,6
41468,2,2420,2390,30,0,49,0,6
41469,1,2378,2425,-47,0,214,0,6
41470,3,2333,2417,-84,0,194,0,6
41471,2,2476,2486,-10,0,112,1,6
41472,2,2358,2471,-113,0,106,0,6
41473,1,2490,2342,148,0,485,1,6
41474,3,2525,2566,-41,0,302,0,6
41475,1,2369,2401,-32,0,265,0,6
41476,2,2474,2433,41,0,312,0,6
41477,2,2468,2350,118,0,7,0,6
41478,2,2448,2385,63,0,487,1,6
41479,2,2366,2429,-63,0,190,0,6
41480,1,2290,2461,-171,4,120,0,13
41481,2,2453,2412,41,0,2,0,6
41482,1,2300,2431,-131,0,0,0,6
41483,3,2451,2660,-209,0,211,0,6
41484,1,2415,2520,-105,0,0,0,6
41485,1,2499,2437,62,0,29,0,6
41486,2,2415,2230,185,0,80,0,6
41487,1,2409,2360,49,0,327,0,6
41488,2,2420,2566,-146,0,241,0,6
41490,2,2463,2381,82,0,326,0,6
41491,1,2460,2358,102,0,102,0,6
41492,1,2391,2468,-77,0,45,0,6
41493,1,2416,2408,8,0,180,0,6
41494,1,2482,2342,140,0,13,0,6
41495,1,2450,2319,131,0,112,0,6
41496,1,2424,2280,144,0,306,0,6
41497,2,2415,2552,-137,0,112,0,6
41498,2,2360,2424,-64,0,107,0,6
41499,2,2394,2520,-126,0,170,0,6
41500,2,2418,2412,6,0,337,0,6
41501,1,2454,2338,116,0,10,0,6
41502,2,2407,2528,-121,0,242,0,6
41503,3,2409,2491,-82,0,202,0,6
41504,2,2423,2455,-32,0,210,0,6
41505,1,2456,2359,97,0,375,0,6
41506,1,2396,2434,-38,0,242,1,6
41507,1,2501,2390,111,0,106,0,6
41508,1,2388,2415,-27,0,385,1,6
41509,2,2595,2440,155,0,5,0,6
41510,2,2348,2437,-89,0,122,0,6
41511,2,2244,2426,-182,0,4,0,6
41513,2,2419,2492,-73,0,46,1,6
41514,2,2377,2434,-57,0,122,0,6
41515,1,2349,2446,-97,0,302,1,6
41516,2,2397,2403,-6,0,46,1,6
41517,1,2416,2381,35,0,8,0,6
41518,2,2474,2659,-185,0,4,1,6
41519,1,2412,2427,-15,0,46,0,6
41520,2,2406,2368,38,0,115,0,6
41521,1,2411,2407,4,0,113,0,6
41522,2,2490,2558,-68,0,8,1,6
41523,2,2398,2433,-35,0,0,0,6
41524,1,2397,2461,-64,0,120,0,6
41525,2,2355,2471,-116,0,491,0,6
41526,2,2553,2450,103,0,224,0,6
41527,1,2565,2526,39,0,331,0,6
41528,1,2440,2423,17,0,310,0,6
41529,1,2460,2430,30,0,200,1,6
41530,1,2475,2354,121,0,0,0,6
41531,2,2401,2421,-20,0,100,0,6
41532,1,2418,2357,61,0,345,0,6
41533,3,2587,2540,47,0,315,0,6
41534,1,2392,2441,-49,0,216,1,6
41535,2,2443,2278,165,0,1,0,8
41536,1,2561,2529,32,0,110,0,6
41537,1,2458,2413,45,0,14,0,6
41538,1,2492,2417,75,0,320,0,6
41539,2,2435,2417,18,0,15,0,6
41540,2,2461,2385,76,0,440,0,6
41541,1,2534,2558,-24,0,468,1,6
41542,1,2513,2513,0,0,138,0,6
41543,1,2404,2293,111,0,1,0,6
41544,1,2505,2523,-18,0,138,0,6
41545,2,2524,2566,-42,0,130,0,6
41546,2,2204,2426,-222,0,106,1,6
41547,1,2431,2370,61,0,304,1,6
41548,1,2368,2417,-49,0,259,1,6
41549,1,2301,2495,-194,0,15,1,6
41550,2,2335,2506,-171,0,430,0,6
41551,1,2613,2410,203,0,106,0,6
41552,1,2708,2528,180,0,330,0,6
41553,1,2523,2571,-48,0,455,0,6
41554,2,2354,2411,-57,0,156,0,6
41555,1,2376,2471,-95,0,302,0,6
41556,1,2418,2412,6,0,483,1,6
41557,2,2421,2351,70,0,101,0,6
41558,2,2365,2458,-93,0,103,0,8
41559,2,2429,2356,73,0,100,0,6
41560,1,2429,2485,-56,0,120,1,6
41561,2,2400,2566,-166,0,9,0,6
41562,2,2256,2407,-151,0,103,0,6
41563,2,2489,2334,155,0,341,1,8
41564,2,2361,2438,-77,0,111,0,6
41565,1,2428,2465,-37,0,122,0,6
41566,1,2418,2259,159,0,100,1,6
41567,1,2328,2478,-150,0,41,1,6
41568,1,2454,2403,51,0,474,0,6
41569,1,2401,2326,75,0,302,1,6
41570,2,2378,2499,-121,0,321,0,6
41571,1,2409,2418,-9,0,288,0,6
41572,1,2330,2406,-76,0,106,0,6
41573,1,2536,2614,-78,0,0,0,6
41574,1,2414,2392,22,0,40,0,6
41575,1,2570,2542,28,0,332,0,6
41576,1,2372,2428,-56,0,45,0,6
41577,1,2381,2427,-46,0,2,0,6
41578,1,2657,2535,122,0,203,0,6
41579,1,2452,2437,15,0,400,0,6
41580,1,2496,2398,98,0,11,0,6
41581,1,2497,2531,-34,4,302,0,13
41582,1,2416,2363,53,0,113,0,6
41583,2,2475,2351,124,0,208,1,6
41584,1,2483,2519,-36,0,302,1,6
41585,3,2349,2410,-61,0,245,0,6
41586,1,2562,2362,200,0,226,0,6
41587,1,2571,2519,52,0,110,1,6
41588,1,2418,2485,-67,0,302,0,6
41589,2,2414,2332,82,0,140,0,6
41590,3,2459,2396,63,0,200,0,6
41591,2,2550,2541,9,0,210,1,6
41592,2,2289,2408,-119,0,90,0,6
41593,1,2425,2392,33,0,1,0,6
41594,1,2504,2463,41,0,448,0,6
41595,3,2348,2430,-82,0,306,0,6
41596,1,2472,2471,1,0,300,0,6
41597,2,2442,2423,19,0,170,1,6
41598,2,2571,2619,-48,0,211,0,6
41599,2,2435,2399,36,0,459,0,6
41600,2,2414,2445,-31,0,302,0,6
41601,2,2458,2586,-128,0,49,0,6
41602,2,2374,2435,-61,0,248,1,6
41603,2,2467,2521,-54,0,101,0,6
41604,1,2409,2358,51,0,302,0,6
41605,2,2392,2454,-62,0,210,0,6
41606,1,2276,2435,-159,0,101,0,8
41607,2,2443,2565,-122,0,132,0,6
41608,1,2414,2406,8,0,110,0,6
41609,2,2511,2552,-41,0,151,0,6
41610,1,2464,2353,111,0,41,0,6
41611,1,2345,2444,-99,0,0,0,6
41612,1,2412,2337,75,0,122,0,6
41613,2,2422,2299,123,0,151,0,6
41614,1,2418,2349,69,0,42,0,6
41615,1,2293,2400,-107,0,226,0,6
41616,2,2336,2400,-64,0,41,1,6
41617,1,2565,2481,84,0,300,0,6
41618,1,2373,2459,-86,0,195,0,6
41619,2,2415,2378,37,0,154,1,6
41620,2,2350,2407,-57,0,153,0,6
41621,2,2423,2429,-6,0,53,0,6
41622,1,2490,2344,146,0,302,0,6
41623,1,2536,2575,-39,0,415,0,6
41624,2,2412,2530,-118,0,455,0,6
41625,1,2397,2458,-61,0,140,1,6
41626,1,2478,2409,69,0,5,1,6
41627,2,2420,2410,10,0,200,0,6
41628,2,2407,2314,93,0,45,1,6
41629,1,2563,2458,105,0,311,0,6
41630,2,2255,2407,-152,0,120,1,6
41631,2,2260,2438,-178,0,256,1,6
41632,1,2344,2423,-79,0,354,0,6
41633,2,2355,2455,-100,0,436,0,6
41634,2,2608,2424,184,0,315,0,6
41635,2,2477,2569,-92,0,43,0,6
41636,2,2452,2470,-18,0,41,0,6
41637,1,2507,2394,113,0,300,0,6
41638,1,2570,2661,-91,0,4,0,6
41639,1,2500,2474,26,0,11,0,6
41640,1,2590,2419,171,0,327,0,6
41641,1,2359,2467,-108,0,40,1,6
41642,2,2435,2624,-189,0,112,1,6
41643,1,2406,2248,158,0,46,0,6
41644,1,2429,2313,116,0,110,0,6
41645,2,2380,2421,-41,0,167,0,6
41646,2,2514,2576,-62,0,108,0,6
41647,1,2569,2490,79,0,101,0,6
41648,2,2436,2299,137,0,2,0,6
41649,2,2308,2454,-146,0,43,0,6
41650,2,2348,2506,-158,0,368,0,6
41651,2,2469,2557,-88,0,122,0,6
41652,2,2563,2461,102,0,152,0,6
41653,1,2569,2543,26,0,332,0,6
41654,1,2527,2377,150,0,0,0,6
41655,1,2447,2388,59,0,40,0,6
41656,1,2439,2369,70,0,234,0,6
41657,3,2452,2253,199,4,120,0,13
41658,2,2398,2436,-38,0,195,0,6
41659,2,2302,2454,-152,0,247,0,6
41660,3,2412,2285,127,0,1,0,6
41661,1,2562,2418,144,0,241,0,6
41662,2,2573,2472,101,0,300,0,6
41663,2,2465,2413,52,0,45,0,6
41664,1,2415,2379,36,0,102,0,6
41665,1,2566,2506,60,0,228,0,6
41666,3,2412,2327,85,0,152,0,6
41667,2,2417,2387,30,0,409,0,6
41668,1,2429,2593,-164,0,45,0,6
41669,3,2346,2435,-89,0,102,0,6
41670,2,2416,2345,71,0,306,0,6
41671,1,2459,2351,108,0,456,0,6
41672,3,2434,2429,5,0,172,0,6
41673,1,2365,2408,-43,0,277,0,6
41674,1,2628,2516,112,0,40,1,6
41675,1,2460,2211,249,0,301,0,5
41676,2,2209,2488,-279,0,111,0,5
41677,1,2580,2213,367,0,210,0,5
41678,1,2610,2509,101,0,120,0,6
41679,2,2534,2433,101,0,250,0,6
41680,2,2402,2389,13,0,366,1,6
41681,1,2303,2450,-147,0,0,0,8
41682,2,2416,2599,-183,0,190,0,6
41683,2,2459,2343,116,0,335,0,6
41684,1,2412,2382,30,0,211,1,6
41685,1,2502,2483,19,0,11,0,6
41686,1,2416,2381,35,0,45,0,6
41687,2,2339,2422,-83,0,48,0,6
41688,2,2380,2573,-193,0,130,0,6
41689,2,2289,2415,-126,0,344,0,6
41690,1,2441,2433,8,0,102,0,6
41691,3,2366,2411,-45,0,127,0,6
41692,2,2408,2336,72,0,305,0,6
41693,2,2429,2374,55,0,245,0,6
41694,1,2509,2346,163,0,9,0,6
41695,2,2525,2356,169,0,415,0,6
41696,3,2436,2616,-180,0,6,0,6
41697,3,2450,2712,-262,0,113,0,6
41698,2,2572,2532,40,0,25,0,6
41699,2,2427,2277,150,0,0,0,8
41700,1,2511,2393,118,0,70,0,6
41701,2,2390,2522,-132,0,41,0,6
41702,2,2352,2411,-59,0,150,0,6
41703,2,2375,2409,-34,0,245,0,6
41704,1,2426,2451,-25,0,200,1,6
41705,2,2420,2548,-128,0,104,0,6
41706,1,2433,2309,124,0,400,0,6
41707,1,2509,2394,115,0,297,1,6
41708,1,2403,2405,-2,0,51,1,6
41709,1,2402,2432,-30,0,109,0,6
41710,2,2455,2428,27,0,288,1,6
41711,2,2245,2415,-170,0,121,1,6
41712,1,2366,2409,-43,0,315,1,6
41713,1,2537,2575,-38,0,415,0,6
41714,2,2284,2409,-125,0,106,0,6
41715,2,2505,2573,-68,0,101,0,6
41716,2,2528,2614,-86,0,4,0,6
41717,1,2544,2571,-27,0,143,1,6
41718,2,2412,2485,-73,0,3,0,6
41719,3,2500,2452,48,0,341,0,6
41720,1,2561,2555,6,0,456,0,6
41721,1,2434,2299,135,0,140,0,6
41722,1,2602,2413,189,0,265,0,6
41723,2,2422,2501,-79,0,46,0,6
41724,1,2619,2438,181,0,110,0,6
41725,2,2441,2296,145,0,46,1,6
41726,1,2429,2400,29,0,45,1,6
41727,2,2421,2463,-42,0,46,0,6
41728,2,2370,2483,-113,0,300,0,6
41729,3,2450,2470,-20,0,313,0,6
41730,2,2523,2503,20,4,4,0,13
41731,1,2400,2389,11,0,190,0,6
41732,2,2478,2458,20,0,7,0,6
41733,2,2515,2504,11,0,41,1,6
41734,1,2508,2542,-34,0,13,0,6
41735,1,2669,2591,78,0,15,0,6
41736,1,2458,2654,-196,0,46,0,6
41737,1,2380,2515,-135,0,20,0,6
41738,2,2632,2511,121,0,373,0,6
41739,1,2578,2512,66,0,107,0,6
41740,2,2362,2440,-78,0,121,0,6
41741,2,2416,2500,-84,0,107,0,6
41742,2,2414,2411,3,0,113,0,6
41743,2,2420,2380,40,0,337,0,6
41744,2,2439,2310,129,0,401,0,6
41745,2,2512,2347,165,0,330,1,6
41746,2,2437,2431,6,0,455,0,6
41747,3,2577,2563,14,0,304,0,6
41748,1,2578,2581,-3,0,334,0,6
41749,1,2483,2440,43,0,216,1,6
41750,3,2502,2490,12,0,6,0,6
41751,3,2651,2635,16,0,310,0,6
41752,3,2582,2595,-13,0,7,0,6
41754,2,2427,2396,31,0,11,0,6
41755,3,2635,2518,117,0,255,0,6
41756,1,2633,2651,-18,0,474,0,6
41757,3,2598,2303,295,0,256,0,6
41758,3,2331,2421,-90,0,45,0,6
41759,3,2287,2410,-123,0,90,0,6
41760,1,2593,2449,144,4,42,0,13
41761,3,2353,2418,-65,0,192,0,6
41762,2,2563,2479,84,0,15,1,6
41763,1,2501,2577,-76,0,7,0,6
41764,1,2377,2468,-91,0,140,0,6
41765,2,2539,2581,-42,0,200,0,6
41766,2,2334,2416,-82,0,302,0,6
41767,2,2345,2519,-174,0,453,0,6
41768,2,2305,2473,-168,0,110,0,6
41769,1,2408,2388,20,0,118,0,6
41770,2,2568,2544,24,0,14,0,6
41771,1,2507,2425,82,0,476,0,6
41772,1,2513,2472,41,0,250,1,6
41773,1,2428,2409,19,0,43,0,6
41774,1,2387,2552,-165,0,45,0,6
41775,2,2359,2584,-225,0,120,0,6
41776,1,2336,2496,-160,0,310,0,6
41777,2,2386,2472,-86,0,138,1,6
41778,2,2526,2377,149,0,118,0,6
41779,1,2310,2444,-134,0,0,1,6
41780,2,2309,2410,-101,0,103,0,6
41781,2,2445,2435,10,0,310,0,6
41782,2,2452,2499,-47,0,43,0,6
41783,2,2410,2605,-195,0,190,0,6
41784,2,2434,2347,87,0,15,0,6
41785,1,2351,2411,-60,0,194,0,6
41786,1,2552,2438,114,0,411,0,6
41787,2,2390,2453,-63,0,395,1,6
41788,2,2505,2505,0,0,46,1,6
41789,2,2234,2403,-169,0,113,0,6
41790,1,2418,2326,92,0,296,1,6
41791,2,2320,2487,-167,0,311,0,6
41792,2,2307,2598,-291,0,7,0,6
41793,1,2432,2320,112,0,199,0,6
41794,2,2402,2403,-1,0,181,0,6
41795,2,2250,2406,-156,0,278,0,6
41796,2,2568,2430,138,0,201,0,6
41797,2,2469,2418,51,0,132,0,6
41798,2,2488,2508,-20,0,112,0,6
41799,2,2368,2503,-135,0,320,0,6
41800,1,2302,2494,-192,0,145,0,6
41801,2,2407,2414,-7,0,244,1,6
41803,1,2624,2451,173,0,310,0,6
41804,1,2520,2317,203,0,456,0,6
41805,2,2326,2639,-313,0,102,0,6
41806,1,2322,2414,-92,0,122,0,6
41807,1,2445,2383,62,0,392,0,6
41808,2,2260,2429,-169,0,101,1,7
41809,1,2421,2330,91,0,107,0,6
41810,1,2435,2282,153,0,6,1,6
41811,2,2422,2583,-161,0,204,0,6
41812,1,2441,2439,2,0,300,0,6
41813,3,2311,2462,-151,0,2,0,5
41814,2,2226,2582,-356,0,448,0,5
41815,1,2490,2313,177,0,331,0,5
41816,2,2641,2633,8,0,476,0,6
41817,1,2298,2421,-123,0,40,0,6
41818,1,2461,2384,77,0,255,0,6
41819,1,2562,2551,11,0,331,0,6
41820,1,2420,2365,55,0,150,0,6
41821,2,2356,2449,-93,0,153,0,6
41822,1,2645,2308,337,0,107,0,6
41824,2,2434,2504,-70,0,315,0,6
41825,3,2435,2355,80,0,345,0,6
41826,1,2447,2379,68,0,474,0,6
41827,1,2414,2402,12,0,319,1,6
41828,2,2464,2433,31,0,303,0,6
41829,1,2510,2331,179,0,14,0,6
41830,2,2328,2576,-248,0,104,0,6
41831,2,2550,2562,-12,0,415,0,6
41832,2,2587,2622,-35,0,102,0,6
41833,2,2255,2447,-192,0,106,0,6
41835,2,2223,2437,-214,0,463,0,6
41836,1,2430,2211,219,0,31,1,6
41837,2,2435,2344,91,0,152,0,6
41838,1,2488,2385,103,0,111,0,6
41839,1,2452,2449,3,0,345,0,6
41840,3,2374,2401,-27,0,167,0,6
41841,2,2230,2494,-264,0,415,0,6
41842,1,2463,2342,121,0,394,0,6
41843,3,2647,2571,76,0,106,0,6
41844,2,2556,2378,178,0,39,0,6
41845,2,2304,2433,-129,0,315,1,6
41846,3,2349,2448,-99,0,311,0,6
41847,1,2521,2518,3,0,49,0,6
41848,2,2409,2354,55,0,140,1,6
41849,1,2422,2268,154,0,4,0,6
41850,2,2410,2517,-107,0,244,1,6
41851,3,2308,2401,-93,0,4,0,6
41852,1,2454,2357,97,0,106,0,6
41853,3,2613,2512,101,0,33,0,6
41854,1,2488,2374,114,0,178,0,6
41855,2,2365,2439,-74,0,116,0,6
41856,2,2317,2708,-391,0,8,0,6
41857,1,2467,2436,31,0,5,0,6
41858,2,2392,2512,-120,0,49,0,6
41859,1,2421,2348,73,0,115,0,6
41860,2,2455,2465,-10,0,202,1,6
41861,1,2544,2447,97,0,150,1,6
41862,2,2267,2406,-139,0,112,0,6
41863,2,2556,2533,23,0,307,0,6
41864,3,2487,2551,-64,0,4,0,6
41865,2,2639,2578,61,0,146,0,6
41866,1,2333,2635,-302,0,104,0,6
41867,1,2608,2407,201,0,203,0,6
41868,1,2427,2365,62,0,334,0,6
41869,2,2395,2457,-62,0,45,0,6
41870,1,2490,2310,180,0,44,1,6
41871,2,2372,2515,-143,0,302,0,6
41872,2,2511,2380,131,0,403,0,6
41873,2,2408,2466,-58,0,43,1,6
41874,2,2431,2458,-27,0,133,0,6
41875,3,2394,2499,-105,0,43,0,6
41876,2,2436,2476,-40,0,278,1,6
41877,1,2567,2530,37,0,457,0,6
41878,3,2515,2587,-72,0,455,0,6
41879,1,2422,2316,106,0,120,1,6
41880,1,2645,2431,214,0,45,0,6
41881,2,2462,2628,-166,0,133,1,6
41882,1,2424,2569,-145,0,41,0,6
41883,1,2487,2361,126,0,454,0,6
41884,1,2448,2402,46,0,4,0,6
41885,2,2351,2550,-199,0,100,0,6
41886,2,2326,2488,-162,0,102,0,6
41887,1,2400,2342,58,0,46,0,6
41888,2,2448,2540,-92,0,101,0,6
41889,1,2515,2357,158,4,9,0,13
41890,1,2356,2407,-51,0,43,1,6
41891,3,2576,2367,209,0,110,0,6
41892,1,2601,2307,294,0,123,0,6
41893,3,2203,2433,-230,0,345,0,6
41894,1,2400,2572,-172,0,106,0,6
41895,1,2486,2310,176,0,302,0,6
41896,2,2401,2419,-18,0,381,0,6
41897,1,2417,2281,136,0,70,0,6
41898,1,2418,2270,148,0,105,0,6
41899,1,2586,2401,185,0,112,0,6
41900,3,2553,2524,29,0,304,0,6
41901,2,2209,2548,-339,0,154,0,6
41902,2,2626,2348,278,0,43,0,6
41903,2,2463,2353,110,0,313,1,6
41904,1,2477,2348,129,0,345,1,6
41905,1,2516,2517,-1,0,4,0,6
41906,1,2568,2545,23,0,13,0,6
41907,1,2357,2491,-134,0,260,1,6
41908,2,2507,2317,190,0,101,0,6
41909,2,2531,2458,73,0,302,0,6
41910,1,2380,2518,-138,0,130,0,6
41911,2,2328,2524,-196,0,245,0,6
41912,2,2439,2513,-74,0,304,0,6
41913,2,2352,2467,-115,0,245,0,6
41914,1,2522,2486,36,0,46,0,6
41915,2,2404,2611,-207,0,107,0,6
41916,2,2454,2415,39,0,391,0,6
41917,1,2356,2429,-73,0,200,0,6
41918,2,2317,2424,-107,0,466,0,6
41919,1,2383,2402,-19,0,106,0,6
41920,2,2409,2370,39,0,303,0,6
41921,2,2513,2527,-14,0,107,0,6
41922,1,2278,2421,-143,0,61,1,6
41923,1,2416,2360,56,0,8,0,6
41924,2,2510,2388,122,0,36,0,6
41925,2,2425,2520,-95,0,101,1,6
41926,1,2405,2550,-145,0,440,0,6
41927,3,2491,2602,-111,0,5,0,6
41928,2,2381,2518,-137,0,41,0,6
41929,2,2648,2438,210,0,201,0,6
41930,3,2510,2472,38,0,311,0,6
41931,2,2290,2443,-153,0,111,0,6
41932,2,2446,2497,-51,0,41,0,6
41933,1,2635,2550,85,0,40,0,6
41934,2,2323,2632,-309,0,195,0,6
41935,2,2508,2448,60,0,404,0,6
41936,2,2428,2430,-2,0,4,0,6
41937,1,2582,2561,21,0,241,0,6
41938,1,2439,2453,-14,0,41,0,6
41939,1,2431,2439,-8,0,270,0,6
41940,2,2439,2398,41,0,129,0,6
41941,1,2589,2432,157,0,122,0,6
41942,1,2460,2266,194,0,107,0,5
41943,2,2229,2493,-264,0,45,0,5
41944,3,2601,2516,85,0,115,0,6
41945,1,2564,2616,-52,0,49,0,6
41946,2,2366,2493,-127,0,156,0,6
41947,3,2409,2350,59,0,490,0,6
41948,1,2586,2370,216,0,112,0,6
41949,2,2481,2426,55,0,153,0,6
41950,2,2443,2444,-1,0,191,1,6
41951,1,2548,2507,41,0,132,1,6
41952,1,2544,2511,33,0,148,0,6
41953,3,2527,2599,-72,0,321,0,6
41954,2,2412,2228,184,0,110,0,6
41955,1,2539,2573,-34,0,470,0,6
41956,1,2634,2408,226,0,250,0,6
41957,2,2553,2517,36,0,46,0,6
41958,2,2307,2489,-182,0,129,0,6
41959,1,2360,2431,-71,0,103,1,6
41960,2,2541,2550,-9,0,0,1,6
41961,3,2353,2453,-100,4,330,0,13
41962,2,2202,2492,-290,0,176,0,6
41963,1,2612,2236,376,0,140,0,6
41964,3,2497,2586,-89,0,37,0,6
41965,2,2521,2447,74,0,253,0,6
41966,1,2497,2340,157,0,110,0,6
41967,1,2374,2404,-30,0,13,0,6
41968,2,2400,2378,22,0,118,0,6
41969,1,2520,2366,154,4,21,0,13
41970,2,2456,2458,-2,0,313,0,6
41971,1,2478,2572,-94,0,193,0,6
41972,1,2444,2521,-77,0,224,1,6
41973,1,2471,2342,129,0,320,0,6
41974,1,2443,2459,-16,0,144,0,6
41975,1,2524,2528,-4,0,302,0,6
41976,3,2355,2547,-192,0,40,0,6
41977,2,2588,2353,235,0,199,1,6
41978,1,2363,2470,-107,0,405,1,6
41979,1,2418,2298,120,0,0,0,6
41980,2,2545,2312,233,0,15,1,6
41981,2,2378,2610,-232,0,15,0,6
41982,1,2306,2639,-333,0,463,0,6
41983,1,2574,2571,3,0,101,0,6
41984,1,2483,2365,118,0,123,0,6
41985,1,2614,2402,212,0,242,0,6
41986,2,2556,2525,31,0,13,1,6
41987,1,2498,2347,151,0,9,0,6
41988,3,2585,2599,-14,0,210,0,6
41989,3,2524,2490,34,0,4,0,6
41990,3,2518,2390,128,0,7,0,6
41991,2,2384,2481,-97,0,41,0,6
41992,2,2433,2437,-4,0,6,0,6
41993,2,2389,2593,-204,0,211,0,6
41994,1,2403,2334,69,0,48,0,6
41995,1,2429,2464,-35,0,40,1,6
41996,2,2405,2433,-28,0,115,0,6
41997,1,2428,2413,15,0,40,0,6
41998,3,2441,2294,147,0,140,0,6
41999,1,2479,2359,120,0,176,0,6
42000,1,2411,2265,146,0,253,0,6
42001,1,2502,2512,-10,0,343,0,6
42002,2,2253,2403,-150,0,10,1,6
42003,1,2435,2501,-66,0,86,1,6
42004,1,2375,2431,-56,0,156,0,6
42005,3,2542,2509,33,0,401,0,6
42006,1,2403,2389,14,0,7,0,6
42007,1,2585,2358,227,0,190,0,6
42008,2,2319,2599,-280,0,100,1,6
42009,2,2472,2527,-55,0,7,0,6
42010,2,2447,2465,-18,0,7,0,6
42011,1,2445,2415,30,0,15,0,6
42012,1,2421,2348,73,0,306,0,6
42013,1,2353,2426,-73,0,110,0,6
42014,2,2331,2406,-75,0,354,0,6
42015,1,2521,2393,128,0,324,0,6
42016,3,2378,2611,-233,0,302,0,6
42017,2,2443,2458,-15,0,304,0,6
42018,3,2514,2316,198,0,474,0,6
42019,3,2709,2492,217,0,1,0,6
42020,2,2487,2395,92,0,4,1,6
42021,3,2419,2326,93,0,302,0,6
42022,2,2362,2439,-77,0,474,0,6
42023,2,2296,2637,-341,0,190,0,6
42024,2,2310,2406,-96,0,284,0,6
42025,1,2567,2546,21,0,13,0,6
42026,1,2449,2451,-2,0,121,0,6
42027,1,2356,2580,-224,0,73,0,6
42028,3,2587,2501,86,0,102,0,6
42029,2,2343,2629,-286,0,4,0,6
42030,1,2408,2465,-57,0,302,1,6
42031,3,2397,2481,-84,0,15,0,6
42032,1,2453,2474,-21,0,131,1,6
42033,1,2365,2404,-39,0,2,1,6
42034,2,2449,2400,49,0,128,0,6
42035,1,2492,2304,188,0,300,0,6
42036,1,2335,2426,-91,0,9,0,6
42037,2,2405,2322,83,0,120,0,6
42038,1,2506,2553,-47,0,104,0,6
42039,2,2400,2271,129,4,33,0,13
42040,1,2394,2418,-24,0,212,0,6
42041,3,2522,2545,-23,0,461,0,6
42042,2,2579,2372,207,0,222,0,6
42043,3,2410,2530,-120,0,406,0,6
42044,1,2423,2306,117,0,241,0,6
42045,2,2512,2502,10,0,4,0,6
42046,1,2466,2516,-50,0,277,0,6
42047,1,2443,2427,16,0,270,0,6
42048,2,2528,2638,-110,0,9,1,6
42049,2,2501,2508,-7,0,40,0,6
42050,1,2473,2406,67,0,267,0,6
42051,1,2454,2392,62,0,354,0,6
42052,2,2450,2327,123,0,107,0,6
42053,3,2365,2412,-47,0,253,0,6
42054,3,2243,2446,-203,4,42,0,13
42055,3,2394,2615,-221,0,159,0,6
42056,1,2493,2338,155,0,120,1,6
42057,2,2324,2489,-165,0,46,0,6
42058,1,2520,2524,-4,0,45,0,6
42059,1,2540,2572,-32,0,415,0,6
42060,1,2515,2381,134,0,474,1,6
42061,1,2339,2437,-98,0,300,1,6
42062,3,2545,2503,42,0,326,0,6
42063,3,2523,2586,-63,0,404,0,6
42064,2,2555,2616,-61,0,151,0,6
42065,2,2207,2494,-287,0,9,0,8
42066,1,2425,2639,-214,0,211,0,6
42067,2,2443,2411,32,0,284,0,6
42068,2,2425,2367,58,0,484,0,6
42069,1,2491,2595,-104,0,312,0,6
42070,3,2514,2442,72,0,241,0,6
42071,2,2408,2396,12,0,0,0,6
42072,2,2447,2577,-130,0,202,0,6
42073,1,2438,2400,38,0,409,0,6
42074,1,2462,2408,54,0,202,1,6
42075,1,2330,2482,-152,0,190,0,6
42076,1,2422,2448,-26,0,254,0,6
42077,1,2302,2475,-173,0,43,0,6
42078,2,2536,2380,156,0,1,0,6
42079,1,2538,2632,-94,0,453,0,6
42080,1,2457,2435,22,0,125,0,6
42081,2,2343,2460,-117,0,110,1,6
42082,2,2542,2529,13,0,404,0,6
42083,2,2470,2468,2,0,300,0,6
42084,1,2587,2568,19,0,9,0,6
42085,2,2585,2544,41,0,100,0,6
42086,1,2504,2545,-41,0,4,0,6
42087,2,2624,2524,100,0,302,0,6
42088,2,2344,2571,-227,0,7,0,6
42089,3,2495,2584,-89,0,4,0,5
42090,1,2381,2463,-82,0,43,0,5
42091,2,2485,2510,-25,0,300,0,6
42092,2,2494,2524,-30,0,31,0,6
42093,1,2445,2442,3,0,313,0,6
42094,1,2598,2524,74,4,156,0,13
42095,1,2433,2435,-2,0,13,0,6
42096,2,2547,2455,92,0,127,1,6
42097,1,2566,2317,249,0,312,0,6
42098,1,2601,2365,236,0,121,0,6
42099,2,2305,2451,-146,0,123,0,6
42100,2,2337,2501,-164,0,440,0,6
42101,3,2492,2403,89,0,485,0,6
42102,2,2531,2590,-59,0,217,0,6
42103,3,2531,2568,-37,0,345,0,6
42104,2,2381,2617,-236,0,45,0,6
42105,2,2526,2513,13,0,57,1,6
42106,2,2451,2504,-53,0,147,0,6
42107,2,2533,2636,-103,0,45,0,6
42108,1,2463,2425,38,0,440,1,6
42109,2,2458,2397,61,0,43,0,6
42110,1,2621,2551,70,0,280,1,6
42111,2,2380,2423,-43,0,130,0,6
42112,3,2363,2427,-64,0,205,0,6
42113,1,2567,2524,43,0,43,0,6
42114,3,2642,2532,110,0,255,0,6
42115,1,2532,2518,14,0,15,1,6
42116,2,2509,2472,37,0,454,0,6
42117,3,2302,2579,-277,0,104,0,6
42118,2,2377,2459,-82,0,144,0,6
42119,1,2361,2442,-81,0,150,0,6
42120,1,2399,2443,-44,0,100,0,6
42121,2,2508,2459,49,0,250,0,6
42122,1,2566,2547,19,0,332,0,6
42123,1,2457,2403,54,0,270,0,6
42124,1,2489,2404,85,0,49,0,6
42125,1,2443,2509,-66,4,112,0,13
42126,1,2402,2477,-75,0,286,0,6
42127,2,2480,2369,111,0,455,0,6
42128,1,2430,2463,-33,0,46,1,6
42129,1,2573,2380,193,0,140,0,6
42130,2,2385,2456,-71,0,80,0,8
42131,2,2351,2529,-178,0,107,1,6
42132,1,2381,2535,-154,0,242,0,6
42133,2,2430,2536,-106,0,191,0,6
42134,2,2640,2386,254,0,140,0,6
42135,3,2451,2346,105,0,4,0,6
42136,2,2541,2572,-31,0,415,0,6
42137,3,2417,2539,-122,0,80,0,6
42138,3,2534,2437,97,0,368,0,6
42139,3,2640,2510,130,0,106,0,6
42140,2,2287,2441,-154,0,101,1,6
42141,2,2588,2534,54,0,100,0,6
42142,1,2486,2368,118,0,48,0,6
42143,1,2442,2517,-75,0,45,0,6
42144,2,2515,2480,35,0,46,1,6
42145,2,2518,2442,76,0,8,0,6
42146,3,2537,2315,222,0,15,0,6
42147,1,2419,2312,107,0,13,0,6
42148,1,2609,2321,288,0,130,0,6
42149,1,2492,2497,-5,0,120,0,6
42150,1,2519,2379,140,0,4,0,6
42151,3,2550,2573,-23,0,302,0,6
42152,2,2620,2603,17,0,40,0,6
42153,2,2351,2474,-123,0,190,0,6
42154,1,2349,2454,-105,0,101,0,6
42155,2,2403,2386,17,0,7,1,6
42156,2,2474,2509,-35,0,4,0,6
42157,2,2453,2631,-178,0,2,0,6
42158,1,2388,2489,-101,0,80,0,6
42159,1,2627,2491,136,0,103,0,6
42160,1,2511,2382,129,0,411,0,6
42161,1,2411,2360,51,0,106,0,6
42162,1,2403,2369,34,0,305,1,6
42163,2,2319,2525,-206,0,13,0,6
42164,2,2608,2463,145,0,45,0,6
42165,3,2366,2706,-340,0,107,0,6
42166,3,2496,2438,58,0,116,0,6
42167,1,2563,2592,-29,0,414,0,6
42168,2,2247,2415,-168,0,110,0,6
42169,2,2571,2575,-4,0,108,0,6
42170,1,2424,2312,112,0,106,0,6
42171,2,2577,2536,41,0,218,0,6
42172,2,2423,2638,-215,0,318,0,6
42173,2,2426,2512,-86,0,103,0,6
42174,1,2486,2462,24,0,120,0,6
42175,2,2539,2524,15,0,101,0,6
42176,1,2626,2527,99,0,45,0,6
42177,1,2417,2284,133,0,110,0,6
42178,2,2339,2566,-227,0,277,1,6
42179,1,2412,2309,103,0,44,0,6
42180,3,2274,2405,-131,0,135,0,6
42181,2,2587,2629,-42,0,107,0,6
42182,2,2322,2435,-113,0,154,0,6
42183,2,2374,2418,-44,0,255,1,6
42184,2,2487,2339,148,0,6,0,6
42185,1,2526,2631,-105,0,326,0,6
42186,1,2520,2479,41,0,45,1,6
42187,1,2466,2502,-36,0,487,1,6
42188,2,2404,2380,24,0,130,0,6
42189,2,2225,2403,-178,4,251,0,13
42190,2,2450,2449,1,0,45,0,6
42191,2,2609,2532,77,0,248,0,6
42192,2,2438,2614,-176,0,100,0,6
42193,1,2510,2449,61,0,100,0,6
42194,2,2472,2463,9,0,21,0,6
42195,2,2342,2422,-80,0,373,0,6
42196,3,2516,2573,-57,0,302,0,6
42197,1,2576,2359,217,0,151,0,6
42198,2,2355,2490,-135,4,46,0,13
42199,1,2398,2457,-59,0,246,0,6
42200,1,2397,2513,-116,0,129,0,6
42201,1,2537,2385,152,0,101,0,6
42202,2,2437,2503,-66,0,13,0,6
42203,1,2586,2569,17,0,172,0,6
42204,2,2400,2228,172,0,27,0,6
42205,1,2457,2436,21,0,125,1,6
42206,2,2319,2576,-257,0,247,0,6
42207,3,2314,2534,-220,0,40,0,6
42208,1,2455,2308,147,0,48,0,6
42209,1,2321,2462,-141,0,418,0,6
42210,1,2428,2375,53,0,5,1,6
42211,1,2430,2405,25,0,332,0,6
42212,1,2523,2630,-107,0,20,1,6
42213,2,2463,2465,-2,0,112,0,6
42214,2,2352,2572,-220,0,487,0,6
42215,2,2321,2411,-90,0,307,0,6
42216,1,2504,2334,170,0,101,0,6
42217,1,2419,2387,32,0,320,0,6
42218,3,2493,2317,176,0,302,0,6
42219,1,2426,2449,-23,0,414,1,6
42220,1,2540,2426,114,0,311,0,6
42221,2,2312,2421,-109,0,284,0,6
42222,3,2641,2523,118,0,115,0,6
42223,1,2482,2331,151,0,377,0,6
42224,1,2269,2400,-131,0,0,0,6
42225,2,2400,2395,5,0,7,0,6
42226,1,2418,2233,185,0,302,0,6
42227,1,2519,2500,19,0,106,0,6
42228,1,2581,2471,110,0,122,0,6
42229,1,2486,2509,-23,0,1,0,6
42230,1,2470,2501,-31,0,102,0,6
42231,1,2410,2420,-10,0,260,0,6
42232,3,2323,2490,-167,0,46,0,6
42233,3,2329,2597,-268,0,104,0,6
42234,1,2552,2602,-50,0,11,0,6
42235,3,2539,2519,20,0,329,0,6
42236,3,2251,2409,-158,0,21,0,8
42237,1,2454,2377,77,0,57,0,6
42238,1,2543,2571,-28,0,415,0,6
42239,2,2348,2457,-109,0,25,0,6
42240,2,2360,2541,-181,0,108,0,6
42241,1,2583,2388,195,0,241,0,5
42242,1,2456,2348,108,0,83,1,5
42243,1,2581,2579,2,0,101,0,6
42244,2,2207,2566,-359,0,485,0,6
42245,1,2631,2439,192,0,147,0,6
42246,1,2447,2381,66,0,102,0,6
42247,1,2497,2205,292,0,131,0,8
42248,1,2595,2542,53,0,3,1,6
42249,1,2574,2426,148,0,49,0,6
42250,1,2478,2350,128,0,190,1,6
42251,1,2454,2329,125,0,107,0,6
42252,2,2491,2306,185,0,225,0,6
42253,1,2612,2498,114,0,130,0,6
42254,2,2356,2437,-81,0,113,0,6
42255,2,2327,2461,-134,0,46,0,8
42256,2,2373,2511,-138,0,245,0,6
42257,2,2418,2445,-27,0,49,0,6
42258,1,2508,2432,76,0,4,0,6
42259,2,2617,2412,205,0,310,1,6
42260,1,2457,2492,-35,0,101,0,6
42261,1,2468,2534,-66,0,5,0,6
42262,2,2392,2530,-138,0,307,0,6
42263,1,2439,2369,70,0,132,0,6
42264,2,2465,2430,35,0,107,0,6
42265,3,2282,2403,-121,0,212,0,6
42266,2,2479,2515,-36,0,6,1,6
42267,2,2382,2424,-42,0,250,0,6
42268,2,2428,2364,64,0,100,0,6
42269,1,2596,2593,3,0,111,0,6
42270,1,2531,2558,-27,0,10,0,6
42271,1,2469,2439,30,0,153,0,6
42273,2,2385,2458,-73,0,131,0,6
42274,2,2282,2423,-141,0,140,0,6
42275,1,2316,2414,-98,0,1,1,6
42276,1,2401,2307,94,0,9,0,6
42277,2,2359,2586,-227,0,334,0,6
42278,3,2437,2306,131,0,140,0,6
42279,1,2345,2404,-59,0,106,1,6
42280,2,2495,2472,23,0,245,0,6
42281,1,2443,2569,-126,0,146,0,6
42282,2,2513,2505,8,0,112,0,6
42283,2,2512,2492,20,0,103,1,6
42284,3,2578,2355,223,0,168,0,6
42285,2,2565,2549,16,0,200,0,6
42286,2,2501,2444,57,0,45,1,6
42287,1,2624,2534,90,0,122,0,6
42288,2,2268,2422,-154,0,150,1,6
42289,1,2519,2578,-59,0,313,0,6
42290,2,2608,2539,69,0,344,0,6
42291,2,2364,2421,-57,0,6,0,6
42292,2,2405,2527,-122,0,102,1,6
42293,1,2458,2475,-17,0,310,0,6
42294,2,2495,2431,64,0,46,0,6
42295,1,2639,2339,300,0,253,0,6
42296,1,2524,2312,212,0,41,0,6
42297,1,2390,2477,-87,0,48,1,6
42298,2,2370,2433,-63,0,301,1,6
42299,1,2404,2435,-31,0,46,0,6
42300,2,2524,2509,15,0,190,0,6
42301,1,2485,2416,69,0,404,1,6
42302,2,2634,2622,12,0,45,0,6
42303,1,2401,2394,7,0,40,0,6
42304,2,2422,2574,-152,0,43,0,6
42305,1,2493,2492,1,0,45,0,6
42306,1,2531,2427,104,0,20,0,6
42307,2,2443,2432,11,0,152,0,6
42308,2,2463,2586,-123,0,211,1,6
42309,2,2589,2374,215,0,112,1,6
42310,1,2436,2461,-25,0,307,1,6
42311,1,2544,2515,29,0,311,1,6
42312,2,2377,2513,-136,0,241,0,6
42313,2,2552,2601,-49,0,0,0,6
42314,1,2527,2537,-10,0,4,1,6
42315,2,2309,2567,-258,0,463,1,6
42316,1,2416,2634,-218,0,190,1,6
42317,1,2627,2672,-45,0,320,0,6
42318,1,2463,2335,128,0,39,0,6
42319,2,2470,2459,11,0,4,0,6
42320,1,2423,2369,54,0,15,0,6
42321,2,2428,2512,-84,0,398,0,6
42322,2,2476,2511,-35,0,106,1,6
42323,3,2414,2441,-27,0,336,0,6
42324,2,2534,2474,60,0,132,0,6
42325,1,2544,2388,156,0,9,0,6
42326,2,2460,2332,128,0,46,0,6
42327,1,2536,2600,-64,0,200,0,6
42328,1,2582,2592,-10,0,150,0,6
42329,2,2470,2429,41,0,466,1,6
42330,2,2494,2338,156,0,120,0,6
42331,2,2315,2619,-304,0,53,0,6
42332,1,2451,2549,-98,0,344,0,6
42333,2,2307,2476,-169,0,304,1,8
42334,1,2326,2492,-166,0,0,0,6
42335,3,2324,2526,-202,0,152,0,6
42336,2,2381,2474,-93,0,102,0,6
42337,2,2520,2660,-140,0,100,0,6
42338,1,2494,2404,90,0,140,0,6
42339,1,2407,2401,6,0,202,0,6
42340,2,2437,2429,8,0,278,0,6
42341,3,2371,2444,-73,0,300,0,6
42342,3,2366,2482,-116,0,190,0,6
42343,1,2422,2425,-3,0,107,1,6
42344,2,2403,2443,-40,0,0,1,6
42345,2,2428,2277,151,0,133,0,6
42346,1,2402,2388,14,0,102,1,6
42347,2,2488,2529,-41,0,15,0,6
42348,1,2466,2342,124,0,176,0,6
42349,1,2523,2547,-24,0,4,0,6
42350,1,2606,2421,185,0,107,0,6
42351,2,2484,2303,181,0,40,0,6
42352,1,2385,2464,-79,0,398,1,6
42353,1,2517,2423,94,0,4,0,6
42354,2,2365,2491,-126,0,49,0,6
42355,2,2555,2559,-4,0,415,1,6
42356,1,2377,2478,-101,0,440,1,6
42357,2,2528,2440,88,0,306,0,6
42358,3,2572,2641,-69,0,312,0,6
42359,2,2362,2426,-64,0,277,0,6
42360,2,2319,2426,-107,0,119,0,6
42361,2,2559,2504,55,0,248,1,6
42362,2,2331,2467,-136,0,302,0,6
42363,1,2335,2519,-184,4,426,0,13
42364,1,2498,2386,112,0,455,1,5
42365,2,2320,2586,-266,0,45,0,5
42366,2,2220,2460,-240,0,135,1,5
42367,2,2506,2547,-41,0,200,0,6
42368,1,2628,2628,0,0,106,0,6
42369,1,2502,2338,164,0,41,1,6
42370,2,2352,2434,-82,0,194,0,6
42371,1,2531,2327,204,0,0,0,6
42372,3,2577,2533,44,0,110,0,6
42373,1,2435,2419,16,0,278,0,6
42374,1,2575,2201,374,0,147,0,6
42375,2,2420,2404,16,0,130,0,8
42376,1,2561,2507,54,0,394,0,6
42377,2,2422,2469,-47,0,11,0,6
42378,3,2546,2580,-34,0,57,0,6
42379,1,2527,2451,76,0,100,0,6
42380,2,2341,2401,-60,0,153,0,6
42381,2,2455,2324,131,0,211,1,6
42382,1,2488,2376,112,0,354,0,6
42383,2,2481,2438,43,0,125,0,6
42384,2,2487,2460,27,0,15,1,6
42385,1,2589,2666,-77,0,122,1,6
42386,1,2531,2362,169,0,200,1,6
42387,3,2407,2306,101,0,11,0,6
42388,2,2315,2529,-214,0,201,0,6
42389,1,2400,2370,30,0,105,0,6
42390,3,2386,2529,-143,0,36,0,6
42391,2,2506,2586,-80,0,4,1,6
42392,2,2389,2407,-18,0,7,0,6
42393,3,2425,2542,-117,0,112,0,6
42394,1,2499,2363,136,0,110,1,6
42395,3,2474,2516,-42,0,123,0,6
42396,1,2470,2328,142,0,30,0,6
42397,2,2464,2611,-147,0,111,0,6
42398,1,2465,2317,148,0,200,0,8
42399,1,2510,2518,-8,0,57,0,6
42400,2,2317,2433,-116,0,45,0,6
42401,2,2319,2454,-135,0,15,0,6
42402,3,2579,2431,148,0,277,0,6
42403,2,2357,2546,-189,0,415,0,6
42404,1,2569,2376,193,0,153,0,6
42405,3,2560,2462,98,0,119,0,6
42406,2,2311,2470,-159,0,236,1,6
42407,2,2419,2521,-102,0,247,0,6
42408,1,2475,2388,87,0,212,0,6
42409,1,2343,2432,-89,0,400,0,6
42410,1,2516,2560,-44,0,150,0,6
42411,2,2439,2299,140,0,241,1,6
42412,1,2471,2493,-22,0,131,1,6
42413,2,2277,2426,-149,0,260,0,6
42414,1,2464,2411,53,0,205,1,6
42415,1,2390,2534,-144,0,40,1,6
42416,1,2324,2474,-150,0,129,0,6
42417,2,2464,2420,44,0,46,0,6
42418,1,2442,2372,70,0,100,0,6
42419,1,2322,2403,-81,0,13,0,6
42420,2,2465,2582,-117,0,147,1,6
42421,3,2502,2350,152,4,45,0,13
42422,1,2380,2422,-42,0,124,1,6
42423,2,2507,2542,-35,0,195,0,6
42424,1,2412,2454,-42,0,4,0,6
42425,3,2527,2577,-50,0,37,0,6
42426,2,2324,2576,-252,0,247,0,6
42427,3,2433,2640,-207,0,312,0,6
42428,3,2541,2573,-32,0,1,0,6
42429,1,2406,2326,80,0,0,1,6
42430,1,2525,2415,110,0,8,0,6
42431,2,2321,2490,-169,0,80,1,6
42432,1,2466,2332,134,0,141,0,6
42433,2,2388,2494,-106,0,245,0,6
42434,2,2428,2340,88,0,210,0,6
42435,2,2413,2602,-189,0,455,0,6
42436,1,2609,2440,169,0,201,0,6
42437,3,2419,2234,185,0,151,0,6
42438,2,2396,2483,-87,0,242,0,6
42439,1,2352,2622,-270,0,46,0,6
42440,1,2486,2313,173,0,226,0,6
42441,1,2517,2373,144,0,112,0,6
42442,1,2528,2435,93,0,278,0,6
42443,2,2203,2500,-297,0,9,0,8
42444,1,2318,2438,-120,0,0,0,6
42445,1,2576,2577,-1,0,101,0,6
42446,1,2534,2528,6,0,327,0,6
42447,1,2437,2429,8,0,4,0,6
42448,1,2450,2246,204,4,120,0,13
42449,2,2446,2532,-86,0,300,0,6
42450,2,2338,2408,-70,0,43,1,6
42451,1,2454,2442,12,0,123,0,6
42452,1,2501,2281,220,0,404,0,8
42453,2,2623,2634,-11,0,151,0,6
42454,3,2481,2549,-68,0,278,0,6
42455,1,2410,2450,-40,0,80,0,6
42456,1,2467,2467,0,0,125,0,6
42457,1,2320,2467,-147,0,485,0,6
42458,2,2348,2463,-115,0,101,0,6
42459,2,2449,2492,-43,0,102,0,6
42460,2,2454,2392,62,0,256,0,6
42461,1,2411,2529,-118,0,248,0,6
42462,1,2358,2436,-78,0,250,0,6
42463,3,2637,2578,59,0,247,0,6
42464,1,2471,2393,78,0,106,0,6
42465,2,2549,2535,14,0,404,0,6
42466,1,2287,2457,-170,0,344,0,6
42467,1,2515,2552,-37,0,330,0,6
42468,2,2558,2530,28,0,132,0,6
42469,1,2441,2415,26,0,260,0,6
42470,3,2523,2582,-59,0,28,0,6
42471,2,2571,2539,32,0,110,0,6
42473,2,2313,2442,-129,0,112,1,6
42474,1,2412,2460,-48,0,303,0,6
42475,2,2365,2501,-136,0,200,0,6
42476,1,2566,2397,169,0,469,0,6
42477,2,2444,2474,-30,0,483,1,6
42478,2,2464,2466,-2,0,45,0,6
42479,2,2573,2572,1,0,49,0,6
42480,1,2475,2542,-67,0,100,0,6
42481,1,2586,2588,-2,0,330,0,6
42482,2,2429,2481,-52,0,111,0,6
42483,1,2534,2567,-33,0,302,0,6
42484,2,2540,2596,-56,0,318,0,6
42485,2,2502,2425,77,0,110,0,6
42486,2,2358,2427,-69,0,317,0,6
42487,2,2307,2405,-98,0,424,1,6
42488,2,2605,2420,185,0,365,0,6
42489,1,2659,2547,112,0,104,0,6
42490,2,2593,2496,97,0,46,0,6
42491,1,2431,2261,170,0,13,0,6
42492,2,2329,2470,-141,0,302,0,6
42493,1,2429,2482,-53,0,43,0,6
42494,3,2523,2426,97,0,108,0,6
42495,2,2425,2376,49,0,206,0,6
42496,2,2504,2399,105,0,253,1,6
42497,2,2590,2576,14,0,253,1,6
42498,1,2336,2405,-69,0,143,1,6
42499,1,2479,2302,177,0,0,0,8
42500,2,2541,2564,-23,0,14,1,6
42501,3,2548,2546,2,0,406,0,6
42502,2,2437,2468,-31,0,21,0,6
42503,1,2640,2617,23,0,106,0,6
42504,2,2423,2443,-20,0,58,0,6
42505,1,2500,2451,49,0,15,1,6
42506,3,2270,2420,-150,0,1,0,6
42507,1,2370,2520,-150,0,241,0,6
42508,1,2398,2481,-83,0,459,0,6
42509,2,2386,2552,-166,0,302,0,6
42510,1,2621,2458,163,0,111,0,6
42511,1,2502,2344,158,0,154,0,6
42512,1,2487,2493,-6,0,88,0,6
42513,2,2330,2577,-247,0,13,0,6
42514,1,2302,2405,-103,0,453,0,6
42515,3,2613,2210,403,0,125,0,6
42516,2,2497,2607,-110,0,106,1,6
42517,2,2449,2298,151,0,45,1,6
42518,1,2586,2461,125,0,180,0,6
42519,3,2588,2280,308,0,101,0,5
42520,1,2462,2502,-40,0,301,0,5
42521,2,2402,2444,-42,0,0,0,6
42522,2,2431,2533,-102,0,57,0,6
42523,1,2473,2325,148,0,141,0,6
42524,2,2429,2258,171,0,46,0,6
42525,1,2453,2323,130,4,101,0,13
42526,2,2438,2548,-110,0,278,0,6
42527,1,2546,2566,-20,0,302,0,6
42528,1,2407,2367,40,0,40,0,6
42529,1,2564,2592,-28,0,414,0,6
42530,2,2315,2469,-154,0,144,0,6
42531,2,2417,2384,33,0,46,0,6
42532,2,2412,2386,26,0,196,0,6
42533,3,2578,2636,-58,0,4,0,6
42534,1,2475,2363,112,0,176,0,6
42535,3,2436,2567,-131,0,106,0,6
42536,3,2579,2379,200,0,147,0,6
42537,2,2536,2442,94,0,100,0,6
42538,2,2322,2477,-155,0,302,0,6
42539,1,2468,2410,58,0,115,0,6
42540,1,2476,2475,1,0,210,0,6
42541,2,2215,2597,-382,0,466,1,6
42542,3,2429,2608,-179,0,0,0,6
42543,2,2391,2490,-99,0,129,0,6
42544,3,2488,2222,266,0,112,0,6
42545,2,2274,2447,-173,0,4,0,6
42546,1,2526,2557,-31,0,404,1,6
42547,1,2521,2419,102,0,4,0,6
42548,2,2565,2357,208,0,337,0,6
42549,2,2319,2438,-119,0,245,0,6
42550,2,2453,2419,34,0,112,0,6
42551,1,2561,2554,7,0,112,0,6
42552,1,2302,2437,-135,0,147,0,6
42553,2,2318,2467,-149,0,455,0,6
42554,1,2413,2323,90,0,0,0,6
42555,1,2504,2360,144,0,1,0,6
42556,2,2623,2582,41,0,341,1,6
42557,1,2486,2425,61,0,31,0,6
42558,1,2427,2379,48,0,302,0,6
42559,2,2605,2581,24,0,211,0,6
42560,1,2431,2524,-93,0,0,0,6
42561,1,2612,2663,-51,0,6,0,6
42562,1,2543,2450,93,0,490,1,6
42563,2,2480,2586,-106,0,200,1,6
42564,2,2560,2331,229,0,0,0,6
42565,2,2472,2458,14,0,188,0,6
42566,2,2306,2445,-139,0,112,1,6
42567,1,2432,2393,39,0,200,0,6
42568,2,2536,2512,24,0,31,0,6
42569,2,2409,2446,-37,0,335,1,6
42570,1,2354,2422,-68,0,375,1,6
42571,2,2339,2401,-62,0,245,0,6
42573,2,2427,2431,-4,0,102,0,6
42574,2,2410,2303,107,0,310,0,6
42575,3,2635,2442,193,0,250,0,6
42576,1,2536,2579,-43,0,48,1,6
42577,1,2657,2536,121,0,148,0,6
42578,2,2239,2481,-242,0,130,0,6
42579,3,2357,2457,-100,0,343,0,6
42580,2,2477,2497,-20,0,215,1,6
42581,1,2480,2318,162,0,107,0,6
42582,2,2406,2473,-67,0,394,0,6
42583,2,2415,2526,-111,0,248,0,6
42584,2,2258,2415,-157,0,245,1,6
42585,3,2586,2532,54,0,300,0,6
42586,2,2398,2471,-73,0,22,1,6
42587,1,2528,2359,169,0,455,0,6
42588,1,2380,2551,-171,0,43,0,6
42589,1,2458,2215,243,0,135,1,6
42590,1,2582,2584,-2,0,151,0,6
42591,2,2297,2421,-124,0,45,1,6
42592,1,2450,2397,53,0,106,0,6
42593,1,2580,2327,253,0,201,1,6
42594,3,2449,2490,-41,0,110,0,6
42595,1,2598,2323,275,0,335,0,6
42596,2,2313,2404,-91,0,156,0,6
42597,2,2533,2472,61,0,147,0,6
42598,1,2505,2500,5,0,46,0,6
42599,2,2537,2427,110,0,264,0,6
42600,3,2420,2487,-67,0,81,0,6
42601,2,2535,2552,-17,0,337,0,6
42602,2,2474,2358,116,0,134,0,6
42603,1,2552,2405,147,0,334,0,6
42604,2,2323,2434,-111,0,200,0,6
42605,2,2261,2504,-243,0,337,0,8
42606,2,2493,2315,178,0,45,0,6
42607,1,2494,2352,142,0,44,0,6
42608,2,2556,2439,117,0,43,1,6
42609,1,2552,2516,36,0,4,0,6
42610,2,2479,2335,144,0,176,0,6
42611,1,2611,2619,-8,0,405,0,6
42612,3,2449,2418,31,0,4,0,6
42613,1,2502,2201,301,0,133,0,6
42614,1,2375,2455,-80,0,123,1,6
42615,3,2343,2419,-76,0,145,0,6
42616,1,2406,2324,82,0,242,0,6
42617,1,2341,2506,-165,0,112,1,6
42618,2,2306,2416,-110,0,426,0,6
42619,2,2311,2407,-96,0,250,0,6
42620,1,2548,2425,123,0,15,0,6
42621,1,2438,2342,96,0,192,0,6
42622,2,2599,2543,56,0,0,0,6
42623,1,2587,2367,220,0,190,0,6
42624,1,2573,2395,178,0,222,0,6
42625,2,2297,2482,-185,0,15,0,8
42626,1,2543,2356,187,0,250,0,6
42627,3,2445,2388,57,0,338,0,6
42628,2,2632,2531,101,0,123,0,6
42629,1,2420,2408,12,0,244,0,6
42630,1,2350,2412,-62,0,200,0,6
42631,1,2374,2432,-58,0,310,1,6
42632,2,2449,2556,-107,0,300,0,6
42633,2,2600,2467,133,0,58,0,6
42634,2,2511,2593,-82,0,9,0,6
42635,3,2550,2557,-7,0,46,0,6
42636,2,2484,2607,-123,0,107,0,6
42637,1,2494,2216,278,0,102,0,6
42638,3,2437,2422,15,0,455,0,6
42639,2,2516,2484,32,0,300,1,6
42640,1,2400,2569,-169,0,269,0,6
42641,3,2530,2497,33,0,15,0,6
42642,1,2313,2410,-97,0,245,0,6
42643,1,2435,2430,5,0,311,0,6
42644,2,2551,2536,15,0,253,0,6
42645,1,2613,2617,-4,0,4,0,6
42646,1,2389,2550,-161,0,45,0,6
42647,3,2557,2444,113,0,4,0,6
42648,1,2374,2494,-120,0,245,0,6
42649,2,2466,2476,-10,0,242,0,6
42650,1,2464,2283,181,0,123,0,6
42651,1,2436,2450,-14,0,245,0,6
42652,1,2483,2374,109,0,302,0,6
42653,1,2496,2284,212,0,5,0,5
42654,1,2469,2584,-115,0,301,0,5
42655,2,2422,2438,-16,0,46,0,6
42656,2,2552,2617,-65,0,15,0,6
42657,1,2402,2382,20,0,45,0,6
42658,1,2577,2359,218,0,176,0,6
42659,1,2262,2400,-138,0,245,0,6
42660,2,2423,2547,-124,0,403,0,6
42661,1,2437,2338,99,0,200,0,6
42662,2,2512,2378,134,0,45,0,6
42663,1,2335,2456,-121,0,122,0,6
42664,1,2444,2442,2,0,4,0,6
42665,3,2479,2660,-181,0,6,0,6
42666,1,2276,2429,-153,0,302,0,6
42667,2,2388,2402,-14,0,405,0,6
42668,1,2475,2471,4,0,255,0,6
42669,1,2365,2576,-211,0,487,0,6
42670,2,2360,2530,-170,0,110,0,6
42671,1,2478,2502,-24,0,200,1,6
42672,1,2255,2401,-146,0,140,0,6
42674,1,2466,2402,64,0,22,0,6
42675,1,2475,2588,-113,0,271,0,6
42676,2,2551,2532,19,0,5,1,6
42677,1,2338,2625,-287,0,0,0,6
42678,3,2539,2556,-17,0,20,0,6
42679,1,2542,2590,-48,0,46,1,6
42680,2,2401,2397,4,0,4,0,6
42681,1,2449,2536,-87,0,102,0,6
42682,3,2420,2427,-7,0,151,0,6
42683,1,2445,2526,-81,0,440,0,6
42684,1,2479,2325,154,0,207,0,6
42685,3,2349,2443,-94,4,196,0,13
42686,3,2555,2557,-2,0,4,0,6
42687,2,2475,2539,-64,0,190,0,6
42688,1,2381,2549,-168,0,106,0,6
42689,1,2446,2546,-100,0,0,1,6
42690,2,2486,2481,5,0,404,0,6
42691,2,2425,2405,20,0,212,1,6
42692,1,2580,2318,262,0,100,1,6
42693,2,2589,2590,-1,0,200,0,6
42694,2,2397,2467,-70,0,60,0,6
42695,2,2470,2477,-7,0,13,0,6
42696,3,2315,2421,-106,0,305,0,6
42697,1,2498,2416,82,0,49,0,6
42698,3,2444,2411,33,0,133,0,6
42699,3,2419,2339,80,0,5,0,6
42700,1,2451,2404,47,0,260,0,6
42701,1,2490,2529,-39,0,45,0,6
42702,3,2597,2567,30,0,123,0,6
42703,2,2429,2315,114,0,395,0,6
42704,1,2449,2372,77,0,4,0,6
42705,1,2432,2357,75,0,40,0,6
42706,2,2232,2405,-173,0,305,0,6
42707,1,2403,2361,42,0,181,0,6
42708,3,2507,2585,-78,0,106,0,6
42709,3,2560,2445,115,0,31,0,6
42710,2,2293,2409,-116,0,15,0,6
42711,1,2509,2457,52,0,453,0,6
42712,2,2424,2388,36,0,106,0,6
42713,3,2497,2597,-100,0,49,0,6
42714,1,2568,2396,172,0,156,0,6
42715,3,2541,2355,186,0,49,0,6
42716,2,2611,2619,-8,0,483,0,6
42717,1,2357,2508,-151,0,387,0,6
42718,1,2391,2488,-97,0,300,0,6
42719,1,2581,2483,98,0,111,0,6
42720,1,2546,2566,-20,0,43,0,6
42721,3,2403,2348,55,0,45,0,6
42722,1,2615,2396,219,0,107,1,6
42723,3,2345,2582,-237,0,4,0,6
42724,2,2433,2510,-77,0,48,0,6
42725,2,2332,2491,-159,0,131,0,6
42726,2,2351,2435,-84,0,386,0,6
42727,1,2408,2547,-139,0,11,0,6
42728,2,2487,2382,105,0,121,0,6
42729,1,2613,2214,399,0,102,1,6
42730,3,2425,2425,0,0,31,0,6
42731,1,2526,2480,46,0,80,1,6
42732,3,2561,2497,64,0,461,0,6
42733,1,2382,2407,-25,0,404,0,6
42734,1,2487,2412,75,0,375,0,6
42735,2,2387,2502,-115,0,45,1,6
42736,2,2419,2448,-29,0,58,0,6
42737,1,2472,2481,-9,0,102,0,6
42738,1,2407,2483,-76,0,377,0,6
42739,2,2414,2222,192,0,412,0,8
42740,1,2422,2441,-19,0,150,0,6
42741,2,2658,2466,192,0,260,0,6
42742,1,2235,2498,-263,0,117,1,5
42743,2,2318,2476,-158,0,106,0,5
42744,1,2555,2581,-26,0,9,0,6
42745,1,2506,2514,-8,0,41,0,6
42746,3,2386,2504,-118,0,112,0,6
42747,2,2402,2484,-82,0,394,0,6
42748,1,2396,2496,-100,0,206,1,6
42749,1,2384,2510,-126,0,45,0,6
42750,1,2421,2324,97,0,152,0,6
42752,1,2519,2453,66,0,5,0,6
42753,1,2538,2545,-7,0,245,1,6
42754,2,2570,2583,-13,0,335,1,6
42755,2,2416,2482,-66,0,46,1,6
42756,2,2621,2649,-28,0,325,0,6
42757,2,2418,2405,13,0,48,0,6
42758,3,2474,2540,-66,0,102,0,6
42759,3,2419,2322,97,0,303,0,6
42760,2,2453,2558,-105,0,211,0,6
42761,2,2320,2413,-93,0,1,0,6
42762,3,2525,2463,62,0,45,0,6
42763,1,2411,2361,50,0,49,0,6
42764,1,2447,2558,-111,0,300,0,6
42765,2,2422,2497,-75,0,310,0,6
42766,3,2560,2584,-24,0,45,0,6
42767,1,2475,2289,186,0,0,1,6
42768,2,2435,2428,7,0,257,0,6
42769,2,2375,2408,-33,0,40,0,6
42770,2,2503,2481,22,0,132,0,6
42771,2,2624,2606,18,0,0,0,6
42772,2,2354,2503,-149,0,414,1,6
42773,2,2452,2508,-56,0,250,0,6
42774,2,2293,2402,-109,0,112,1,6
42775,2,2366,2425,-59,0,151,0,6
42776,3,2437,2450,-13,0,112,0,6
42777,1,2585,2398,187,0,277,0,6
42778,1,2342,2428,-86,0,122,0,6
42779,1,2494,2514,-20,0,45,0,6
42780,3,2489,2540,-51,0,113,0,6
42781,2,2401,2329,72,0,45,0,6
42782,1,2448,2319,129,0,104,0,6
42783,2,2399,2456,-57,0,335,1,6
42784,2,2509,2479,30,0,245,0,6
42785,1,2288,2475,-187,0,107,0,6
42786,1,2412,2288,124,0,46,0,6
42787,1,2395,2403,-8,0,249,0,6
42788,1,2407,2476,-69,0,40,1,6
42789,2,2654,2478,176,0,118,0,6
42790,2,2475,2575,-100,0,302,1,6
42791,2,2492,2659,-167,0,395,1,6
42792,1,2405,2403,2,0,107,0,6
42793,2,2355,2451,-96,0,156,0,6
42794,1,2454,2324,130,0,14,1,6
42795,1,2418,2326,92,0,202,0,6
42796,2,2443,2506,-63,0,2,0,6
42797,3,2397,2401,-4,0,115,0,6
42798,2,2431,2445,-14,0,303,0,6
42799,1,2414,2419,-5,0,6,0,6
42800,2,2408,2408,0,0,277,0,6
42801,2,2606,2600,6,0,221,0,6
42802,2,2483,2521,-38,0,302,0,6
42803,1,2475,2272,203,0,101,1,6
42804,1,2411,2423,-12,0,148,0,6
42805,1,2395,2445,-50,0,15,0,6
42806,2,2531,2502,29,0,453,0,6
42807,1,2406,2271,135,0,302,0,8
42808,3,2454,2331,123,0,106,0,6
42809,2,2409,2577,-168,0,264,0,6
42810,2,2323,2425,-102,0,247,0,6
42811,1,2449,2562,-113,0,190,0,6
42812,3,2383,2422,-39,0,40,0,6
42813,1,2506,2460,46,0,49,0,6
42814,1,2509,2529,-20,0,101,1,6
42815,1,2503,2388,115,0,112,0,6
42816,2,2419,2329,90,0,101,0,8
42817,2,2325,2401,-76,0,45,0,6
42818,1,2417,2398,19,0,269,0,6
42819,1,2403,2268,135,0,291,0,6
42820,1,2404,2345,59,0,398,0,6
42821,2,2316,2438,-122,0,40,0,6
42822,2,2448,2524,-76,0,440,0,6
42823,1,2517,2450,67,0,58,1,6
42824,1,2539,2463,76,0,7,1,6
42825,3,2500,2365,135,0,108,0,6
42826,2,2612,2618,-6,0,469,0,6
42827,2,2415,2539,-124,0,60,0,6
42828,3,2453,2326,127,0,151,0,6
42829,2,2544,2583,-39,0,106,1,6
42830,3,2317,2418,-101,0,302,0,6
42831,1,2204,2416,-212,0,140,0,6
42832,1,2561,2476,85,0,45,1,6
42833,2,2406,2411,-5,0,11,1,6
42834,1,2393,2487,-94,0,414,0,6
42835,1,2504,2419,85,0,150,0,6
42836,2,2411,2385,26,0,45,0,8
42837,2,2577,2239,338,0,130,1,5
42838,1,2480,2244,236,0,300,0,5
42839,2,2551,2646,-95,0,20,0,6
42840,2,2478,2639,-161,0,0,0,6
42841,1,2486,2409,77,0,145,0,6
42842,2,2413,2332,81,0,405,0,6
42843,2,2434,2429,5,0,150,0,6
42844,1,2401,2392,9,0,1,0,6
42845,1,2422,2399,23,0,0,0,6
42846,1,2588,2452,136,0,191,0,6
42847,2,2524,2384,140,0,315,0,6
42848,2,2489,2506,-17,0,200,1,6
42849,3,2327,2416,-89,0,112,0,6
42850,2,2564,2513,51,0,37,0,6
42851,2,2429,2615,-186,0,250,0,6
42852,1,2413,2560,-147,0,330,0,6
42853,1,2486,2447,39,0,140,0,6
42854,1,2432,2323,109,0,400,0,6
42855,3,2498,2485,13,0,368,0,6
42856,3,2374,2469,-95,0,40,0,6
42857,2,2532,2616,-84,0,191,0,6
42858,1,2409,2414,-5,0,110,0,6
42859,1,2450,2395,55,0,216,0,6
42860,2,2279,2403,-124,0,409,0,6
42861,2,2471,2500,-29,0,311,0,6
42862,2,2455,2400,55,0,4,0,6
42863,1,2508,2407,101,0,7,0,6
42864,2,2315,2480,-165,0,15,1,6
42865,1,2263,2425,-162,0,302,0,6
42866,2,2579,2468,111,0,310,0,6
42867,3,2327,2501,-174,0,118,0,6
42868,1,2455,2420,35,0,457,0,6
42869,3,2457,2473,-16,0,132,0,6
42870,1,2523,2405,118,0,10,0,6
42871,1,2406,2225,181,0,40,0,8
42872,1,2489,2444,45,0,394,0,6
42873,1,2419,2314,105,0,301,1,6
42874,2,2417,2364,53,0,45,1,6
42875,2,2233,2455,-222,0,212,0,6
42876,2,2455,2547,-92,0,43,1,6
42877,1,2650,2662,-12,0,267,0,6
42878,1,2571,2417,154,0,45,0,6
42879,2,2448,2336,112,0,132,0,6
42880,2,2200,2401,-201,0,314,0,6
42881,1,2282,2406,-124,0,46,0,6
42882,2,2476,2592,-116,0,405,0,6
42883,3,2436,2543,-107,0,33,0,6
42884,1,2508,2411,97,0,129,0,6
42885,1,2409,2403,6,0,61,1,6
42886,1,2520,2558,-38,0,151,0,6
42887,2,2441,2428,13,4,52,0,13
42888,2,2313,2442,-129,0,4,0,6
42889,2,2624,2606,18,0,1,0,6
42890,1,2493,2575,-82,0,409,0,6
42891,2,2252,2418,-166,0,444,0,6
42892,1,2444,2491,-47,0,332,0,6
42893,1,2466,2298,168,0,122,1,6
42894,2,2527,2525,2,0,107,1,6
42895,3,2400,2396,4,0,8,0,6
42896,2,2349,2400,-51,0,300,1,6
42897,1,2400,2377,23,0,122,0,6
42898,3,2471,2565,-94,0,215,0,6
42899,2,2402,2529,-127,0,42,0,6
42900,2,2363,2427,-64,0,40,0,6
42901,2,2607,2200,407,0,466,0,6
42902,2,2350,2527,-177,0,46,0,6
42903,1,2460,2200,260,0,28,0,6
42904,2,2464,2544,-80,0,245,1,6
42905,2,2417,2503,-86,0,453,0,6
42906,2,2513,2304,209,0,302,0,6
42907,1,2299,2420,-121,0,107,0,6
42908,2,2306,2400,-94,0,30,1,6
42909,1,2589,2521,68,0,45,0,6
42910,1,2539,2620,-81,0,196,0,6
42911,2,2408,2484,-76,0,45,0,6
42912,1,2486,2392,94,0,40,1,6
42914,1,2254,2414,-160,0,202,0,6
42915,1,2530,2390,140,0,20,0,6
42916,2,2442,2319,123,0,107,0,6
42917,1,2286,2451,-165,0,23,0,6
42918,2,2403,2313,90,0,122,0,6
42919,2,2421,2453,-32,0,380,0,6
42920,3,2551,2526,25,0,380,0,6
42921,1,2442,2491,-49,0,300,1,6
42922,1,2376,2435,-59,0,315,0,6
42923,1,2486,2628,-142,0,326,0,6
42924,1,2499,2365,134,0,101,0,6
42925,1,2473,2457,16,0,254,0,6
42926,1,2372,2466,-94,0,88,0,6
42927,2,2485,2450,35,0,466,1,6
42928,2,2440,2255,185,0,37,0,8
42929,3,2498,2355,143,0,465,0,6
42930,1,2425,2312,113,0,200,0,6
42931,1,2564,2473,91,0,45,0,6
42932,1,2619,2426,193,0,310,0,6
42933,1,2596,2575,21,0,101,0,6
42934,3,2441,2407,34,0,218,0,6
42935,1,2448,2311,137,0,4,0,6
42936,1,2458,2254,204,0,112,0,6
42937,1,2372,2506,-134,0,310,0,6
42938,1,2474,2483,-9,0,7,1,6
42939,2,2483,2534,-51,0,277,0,6
42940,1,2452,2369,83,0,0,0,6
42941,2,2525,2504,21,0,343,0,6
42942,2,2307,2475,-168,0,310,0,6
42943,2,2339,2514,-175,0,101,0,6
42944,2,2546,2656,-110,0,325,0,6
42945,1,2412,2332,80,0,130,1,8
42946,1,2551,2450,101,0,31,0,6
42947,1,2568,2406,162,0,4,1,6
42948,1,2562,2512,50,0,113,0,6
42949,2,2274,2455,-181,0,210,0,6
42950,1,2484,2450,34,0,106,1,6
42951,1,2421,2310,111,0,241,0,6
42952,1,2476,2215,261,0,249,0,8
42953,1,2446,2310,136,0,454,0,6
42954,2,2371,2490,-119,0,344,0,6
42955,1,2613,2618,-5,0,406,1,6
42956,1,2398,2451,-53,0,0,0,6
42957,1,2541,2517,24,0,134,0,6
42958,1,2367,2498,-131,0,40,1,6
42959,3,2594,2435,159,4,374,0,13
42960,1,2532,2398,134,0,130,0,6
42961,2,2602,2248,354,0,133,0,6
42962,2,2435,2513,-78,0,70,0,6
42963,2,2425,2342,83,0,140,0,6
42964,1,2538,2356,182,0,85,1,6
42965,1,2343,2405,-62,0,245,0,6
42966,2,2404,2385,19,0,330,0,6
42967,1,2516,2554,-38,0,200,0,6
42968,3,2430,2432,-2,0,122,0,6
42969,1,2567,2223,344,0,102,1,5
42970,3,2311,2482,-171,0,123,0,5
42971,2,2310,2403,-93,0,40,1,6
42972,1,2429,2383,46,0,200,1,6
42973,2,2299,2407,-108,0,101,1,8
42974,1,2656,2494,162,0,49,1,6
42975,2,2548,2453,95,0,8,1,6
42976,1,2468,2568,-100,0,215,0,6
42977,1,2326,2405,-79,0,49,0,6
42978,1,2513,2403,110,0,3,0,6
42979,1,2489,2404,85,0,110,0,6
42980,1,2360,2406,-46,0,1,0,6
42981,2,2373,2409,-36,0,4,0,6
42982,1,2361,2427,-66,0,101,1,6
42983,2,2325,2452,-127,0,144,1,6
42984,1,2354,2410,-56,4,426,0,13
42985,2,2569,2413,156,0,310,0,6
42986,2,2308,2429,-121,0,1,0,6
42987,3,2458,2314,144,0,140,0,6
42988,1,2535,2506,29,0,201,0,6
42989,1,2503,2348,155,0,388,0,6
42990,2,2304,2420,-116,0,212,0,6
42991,1,2478,2299,179,0,3,1,6
42992,1,2527,2551,-24,0,141,0,6
42993,2,2353,2539,-186,0,130,0,6
42994,2,2334,2413,-79,0,300,0,6
42995,2,2484,2487,-3,0,132,0,6
42996,1,2410,2234,176,0,4,0,6
42997,2,2449,2508,-59,0,373,0,6
42998,1,2457,2347,110,0,0,0,6
42999,1,2633,2612,21,0,213,0,6
43000,2,2344,2480,-136,0,145,0,6
43001,2,2294,2506,-212,4,260,0,13
43002,3,2427,2321,106,0,201,0,6
43003,1,2446,2555,-109,0,301,1,6
43004,1,2494,2377,117,0,40,1,6
43005,1,2215,2402,-187,0,48,0,6
43006,1,2478,2305,173,0,200,0,6
43007,2,2452,2258,194,0,122,0,6
43008,1,2660,2467,193,0,104,0,6
43009,2,2306,2449,-143,0,4,0,6
43010,2,2479,2478,1,0,132,0,6
43011,2,2418,2472,-54,0,49,1,6
43012,2,2517,2561,-44,0,3,1,6
43013,1,2274,2403,-129,0,15,1,6
43014,1,2480,2567,-87,0,8,1,6
43015,3,2294,2469,-175,0,100,0,6
43016,2,2477,2408,69,0,40,1,6
43017,1,2498,2504,-6,0,45,0,6
43018,3,2391,2591,-200,0,150,0,6
43019,1,2440,2343,97,0,110,0,6
43020,1,2404,2299,105,0,302,0,8
43021,1,2394,2544,-150,0,267,0,6
43022,3,2431,2506,-75,0,130,0,6
43024,1,2586,2542,44,0,132,0,6
43025,1,2511,2539,-28,0,46,0,6
43026,1,2456,2333,123,0,121,0,6
43027,2,2402,2479,-77,0,382,0,6
43028,2,2545,2533,12,0,368,0,6
43029,2,2607,2639,-32,0,1,0,6
43030,1,2618,2561,57,0,302,0,6
43031,2,2456,2445,11,0,131,1,6
43032,2,2210,2517,-307,0,13,0,6
43033,1,2252,2410,-158,0,277,0,6
43034,1,2568,2387,181,0,315,0,6
43035,2,2286,2425,-139,0,311,0,6
43036,3,2414,2493,-79,0,106,0,6
43037,1,2400,2430,-30,0,303,0,6
43038,2,2334,2517,-183,0,404,1,6
43039,2,2445,2490,-45,0,56,0,6
43040,2,2376,2445,-69,0,192,1,6
43041,1,2458,2433,25,0,241,0,6
43042,1,2523,2384,139,0,10,0,6
43043,2,2201,2460,-259,0,415,0,6
43044,1,2331,2461,-130,0,475,0,6
43045,1,2459,2371,88,0,4,0,6
43046,2,2396,2431,-35,0,133,1,8
43047,3,2625,2630,-5,0,151,0,6
43048,1,2421,2541,-120,0,461,0,6
43049,1,2480,2213,267,0,202,0,8
43050,2,2542,2344,198,0,10,0,6
43051,2,2298,2423,-125,0,310,0,8
43052,2,2471,2476,-5,0,46,1,6
43053,1,2460,2541,-81,0,344,1,6
43054,1,2453,2303,150,0,4,0,6
43055,2,2490,2660,-170,0,335,1,6
43056,1,2361,2424,-63,0,270,0,6
43057,2,2461,2455,6,0,0,0,6
43058,1,2378,2434,-56,0,302,0,6
43059,2,2508,2416,92,0,420,1,6
43060,2,2498,2634,-136,0,14,0,6
43061,2,2200,2449,-249,0,162,0,6
43062,1,2408,2333,75,0,41,1,6
43063,1,2504,2333,171,0,45,0,6
43064,2,2481,2355,126,0,277,1,6
43065,2,2279,2455,-176,0,454,0,6
43066,3,2528,2377,151,0,300,0,6
43067,2,2521,2473,48,0,246,0,6
43068,2,2306,2479,-173,0,330,0,6
43069,2,2257,2409,-152,0,16,0,8
43070,2,2533,2622,-89,0,380,0,6
43071,1,2417,2224,193,0,203,0,6
43072,1,2548,2454,94,0,31,1,6
43073,3,2425,2333,92,0,143,0,6
43074,2,2519,2493,26,0,125,0,6
43075,2,2539,2539,0,0,141,0,6
43076,3,2399,2443,-44,0,101,0,6
43077,1,2267,2483,-216,0,123,0,6
43078,1,2597,2340,257,0,445,0,6
43079,2,2226,2416,-190,0,406,0,8
43080,2,2323,2429,-106,0,27,1,6
43081,2,2512,2663,-151,0,122,0,6
43082,2,2512,2505,7,0,311,0,6
43083,2,2533,2444,89,0,345,0,6
43084,3,2282,2424,-142,0,204,0,6
43085,3,2557,2406,151,0,45,0,6
43086,2,2311,2482,-171,0,20,0,6
43087,1,2434,2455,-21,0,46,0,6
43088,1,2483,2461,22,0,20,1,6
43089,2,2415,2470,-55,0,330,0,6
43090,2,2223,2453,-230,0,212,0,6
43091,2,2566,2623,-57,0,40,0,6
43092,1,2470,2533,-63,0,139,0,6
43093,1,2459,2322,137,0,310,1,6
43094,2,2560,2487,73,0,248,0,6
43095,2,2526,2402,124,0,22,1,6
43096,1,2591,2429,162,0,210,1,6
43097,2,2219,2421,-202,0,153,0,6
43098,1,2419,2529,-110,0,404,0,6
43100,1,2485,2492,-7,0,58,0,6
43101,1,2480,2515,-35,0,129,0,6
43102,1,2396,2625,-229,0,106,0,6
43103,2,2339,2408,-69,0,4,1,6
43104,2,2571,2537,34,0,132,0,6
43105,2,2299,2456,-157,0,485,0,6
43106,1,2478,2371,107,0,150,0,6
43108,1,2262,2451,-189,0,28,0,6
43109,1,2520,2528,-8,0,241,0,6
43110,1,2449,2435,14,0,148,0,6
43111,1,2432,2430,2,0,170,0,6
43112,2,2217,2452,-235,0,156,0,6
43113,2,2271,2442,-171,0,28,1,6
43114,2,2418,2368,50,0,143,0,6
43115,1,2495,2387,108,0,113,0,6
43116,2,2330,2459,-129,0,487,0,6
43117,2,2435,2534,-99,0,280,0,6
43118,1,2490,2445,45,0,1,0,6
43119,1,2418,2276,142,0,110,0,6
43120,2,2429,2297,132,0,264,1,6
43121,1,2473,2477,-4,0,4,0,5
43122,1,2427,2384,43,0,200,1,6
43123,1,2482,2361,121,0,412,0,6
43124,1,2494,2507,-13,0,11,0,6
43125,2,2481,2340,141,0,4,0,6
43126,1,2425,2526,-101,0,428,0,6
43127,2,2449,2414,35,0,0,1,6
43128,1,2526,2553,-27,0,449,0,6
43129,2,2467,2297,170,0,211,1,6
43130,2,2494,2474,20,0,7,1,6
43131,1,2437,2368,69,0,101,0,6
43132,1,2383,2443,-60,0,40,0,6
43133,1,2629,2626,3,0,150,0,6
43134,2,2243,2410,-167,0,203,0,6
43135,1,2456,2341,115,0,112,0,6
43136,3,2444,2484,-40,0,365,0,6
43137,3,2499,2554,-55,0,101,0,6
43138,2,2317,2423,-106,0,45,0,6
43139,1,2509,2486,23,0,330,0,6
43140,2,2419,2392,27,0,224,1,8
43141,1,2507,2429,78,0,107,0,6
43142,2,2408,2477,-69,0,40,0,6
43143,2,2432,2329,103,0,300,0,6
43144,1,2545,2529,16,0,20,0,6
43145,1,2442,2260,182,0,113,0,6
43146,2,2423,2338,85,0,112,0,6
43147,1,2517,2393,124,0,337,0,8
43148,2,2454,2318,136,0,306,0,6
43149,2,2626,2487,139,0,140,0,6
43150,1,2463,2359,104,0,8,0,6
43151,2,2403,2226,177,4,9,0,13
43152,1,2433,2319,114,0,354,1,6
43153,3,2297,2412,-115,0,392,0,8
43154,2,2410,2512,-102,0,330,0,6
43155,1,2422,2451,-29,0,492,0,6
43156,1,2414,2335,79,0,311,0,6
43157,2,2462,2359,103,0,4,0,6
43158,1,2628,2561,67,0,43,1,6
43159,2,2273,2422,-149,0,4,0,6
43160,2,2210,2424,-214,0,111,0,6
43161,1,2438,2403,35,4,200,0,13
43162,1,2511,2456,55,0,123,1,6
43163,2,2255,2403,-148,0,107,0,6
43164,1,2522,2526,-4,0,46,0,6
43165,1,2544,2565,-21,0,398,0,6
43166,2,2460,2296,164,0,15,0,6
43167,1,2410,2486,-76,0,128,0,6
43168,3,2337,2463,-126,0,43,0,6
43169,2,2347,2500,-153,0,245,0,6
43170,2,2375,2411,-36,0,106,0,6
43171,1,2572,2276,296,0,49,1,6
43172,1,2361,2434,-73,0,151,0,6
43173,1,2652,2637,15,0,112,0,6
43174,2,2486,2385,101,0,437,0,6
43175,1,2491,2390,101,0,310,0,6
43176,1,2522,2501,21,0,123,0,6
43177,2,2569,2445,124,0,12,1,6
43178,2,2211,2484,-273,0,184,0,8
43179,1,2439,2495,-56,0,40,0,6
43180,1,2455,2460,-5,0,127,0,6
43181,3,2413,2358,55,0,43,0,8
43182,3,2425,2425,0,0,210,0,6
43183,2,2471,2292,179,4,16,0,11
43184,1,2482,2404,78,0,380,0,6
43185,1,2423,2460,-37,0,315,0,6
43186,3,2425,2512,-87,0,47,0,6
43187,2,2533,2594,-61,0,112,0,6
43188,2,2452,2436,16,0,4,0,6
43189,2,2399,2467,-68,0,45,0,6
43190,1,2446,2383,63,0,113,0,6
43191,2,2425,2499,-74,0,45,0,6
43192,2,2491,2319,172,0,40,0,6
43193,1,2424,2355,69,0,267,1,6
43194,2,2481,2514,-33,0,112,0,6
43195,2,2418,2439,-21,0,40,0,6
43196,1,2423,2360,63,0,6,0,6
43197,1,2618,2663,-45,0,21,0,6
43198,2,2343,2512,-169,0,216,1,6
43199,2,2540,2417,123,0,300,0,6
43200,1,2421,2553,-132,0,321,0,6
43201,1,2265,2400,-135,0,469,0,6
43202,1,2578,2516,62,0,103,1,6
43203,2,2363,2443,-80,0,100,0,6
43204,3,2379,2432,-53,0,315,0,6
43205,2,2406,2420,-14,0,468,0,6
43206,2,2485,2488,-3,0,310,1,6
43207,1,2480,2305,175,0,241,1,6
43208,2,2235,2481,-246,0,40,0,5
43209,2,2547,2532,15,0,114,0,6
43210,2,2218,2459,-241,0,212,0,6
43211,2,2305,2459,-154,0,101,1,6
43212,1,2427,2282,145,0,207,0,6
43213,2,2403,2421,-18,0,27,0,6
43214,2,2524,2550,-26,0,419,0,6
43215,1,2425,2269,156,0,262,0,6
43216,3,2245,2404,-159,0,211,0,6
43217,1,2520,2528,-8,0,326,0,6
43218,2,2330,2479,-149,0,45,0,6
43219,1,2451,2393,58,0,245,0,6
43220,1,2455,2345,110,0,14,0,6
43221,2,2402,2438,-36,0,331,0,6
43222,2,2225,2402,-177,0,262,0,6
43223,1,2504,2422,82,0,455,0,6
43224,2,2470,2370,100,0,101,1,6
43225,1,2315,2428,-113,0,11,0,6
43226,1,2416,2370,46,0,1,1,6
43227,2,2299,2419,-120,0,244,0,6
43228,2,2541,2556,-15,0,200,0,6
43229,2,2389,2530,-141,0,245,0,6
43230,2,2565,2538,27,0,369,0,6
43231,2,2445,2442,3,0,127,0,6
43232,3,2523,2408,115,0,41,0,8
43233,3,2295,2473,-178,0,80,0,6
43234,2,2245,2416,-171,0,45,0,6
43235,1,2496,2378,118,0,315,1,6
43236,1,2559,2550,9,0,100,0,6
43237,1,2400,2527,-127,0,307,0,6
43238,2,2289,2429,-140,0,43,0,6
43239,2,2307,2459,-152,0,262,0,6
43240,2,2426,2461,-35,0,194,0,6
43241,1,2495,2415,80,0,106,0,6
43242,2,2296,2411,-115,0,479,0,8
43243,1,2403,2295,108,0,306,0,6
43244,2,2244,2423,-179,0,463,0,6
43245,1,2454,2425,29,0,210,0,6
43246,3,2399,2487,-88,0,40,0,6
43247,2,2267,2429,-162,0,18,0,6
43248,2,2546,2511,35,0,45,1,6
43249,1,2656,2625,31,0,456,0,6
43250,2,2450,2447,3,0,100,0,6
43251,2,2279,2425,-146,0,411,0,6
43252,1,2379,2412,-33,0,111,0,6
43253,1,2442,2327,115,0,120,0,6
43254,1,2266,2429,-163,0,4,1,6
43255,2,2349,2464,-115,0,172,0,6
43256,1,2403,2367,36,0,466,0,6
43258,1,2462,2341,121,0,202,0,6
43259,2,2475,2426,49,0,103,0,6
43260,2,2426,2574,-148,0,303,0,6
43261,1,2406,2219,187,0,4,0,6
43262,1,2478,2519,-41,0,115,0,6
43263,1,2483,2396,87,0,426,0,6
43264,2,2336,2428,-92,0,5,0,6
43265,2,2483,2425,58,0,58,0,6
43266,1,2401,2238,163,0,15,0,6
43267,2,2428,2599,-171,0,46,0,6
43268,1,2556,2518,38,0,203,0,6
43269,2,2448,2348,100,0,406,0,6
43270,1,2482,2459,23,0,145,0,6
43271,2,2352,2431,-79,0,424,0,6
43272,2,2336,2403,-67,0,244,1,6
43273,1,2362,2404,-42,0,40,0,6
43274,1,2278,2421,-143,0,49,0,6
43275,2,2433,2286,147,0,40,1,6
43276,2,2269,2408,-139,0,40,0,6
43277,1,2511,2544,-33,0,3,0,6
43278,1,2485,2401,84,0,110,0,6
43279,1,2409,2331,78,0,3,0,6
43280,1,2432,2293,139,0,151,0,6
43281,2,2339,2492,-153,0,277,0,6
43282,2,2450,2472,-22,0,190,0,6
43283,1,2405,2395,10,0,330,1,6
43284,2,2385,2559,-174,0,45,1,6
43285,2,2530,2494,36,0,246,0,6
43286,2,2288,2437,-149,0,377,0,8
43287,1,2544,2565,-21,0,0,0,6
43288,2,2453,2323,130,0,0,1,6
43289,2,2620,2480,140,0,122,1,6
43290,1,2412,2286,126,0,43,0,8
43291,1,2431,2380,51,0,134,1,6
43292,2,2432,2462,-30,0,50,0,6
43293,1,2583,2483,100,0,404,0,6
43294,2,2361,2402,-41,0,45,1,6
43295,2,2312,2570,-258,0,111,0,5
43296,2,2201,2483,-282,0,31,0,5
43297,1,2466,2296,170,0,277,0,6
43298,1,2563,2219,344,0,4,0,6
43299,1,2205,2626,-421,0,107,1,6
43300,1,2393,2403,-10,0,463,0,6
43301,2,2522,2519,3,0,307,1,6
43302,1,2518,2408,110,0,2,0,6
43303,1,2421,2367,54,0,56,0,6
43305,1,2456,2538,-82,0,119,0,6
43306,1,2513,2561,-48,0,404,0,6
43307,2,2516,2432,84,0,15,0,6
43308,1,2448,2388,60,0,226,0,6
43309,1,2249,2411,-162,0,4,1,6
43310,1,2391,2527,-136,0,120,0,6
43311,1,2562,2536,26,0,300,1,6
43312,2,2429,2347,82,0,151,0,6
43313,2,2420,2460,-40,0,462,0,6
43314,2,2524,2500,24,0,124,0,6
43315,2,2377,2463,-86,0,320,0,6
43316,3,2488,2209,279,0,249,0,8
43317,1,2410,2321,89,0,15,0,8
43318,3,2423,2430,-7,0,218,0,6
43319,2,2280,2403,-123,0,344,0,6
43320,1,2513,2484,29,0,129,0,6
43321,2,2365,2500,-135,0,133,0,6
43322,2,2421,2385,36,0,106,0,6
43323,2,2462,2303,159,0,200,0,6
43325,2,2476,2469,7,0,400,0,6
43326,2,2433,2463,-30,0,111,0,6
43327,2,2508,2410,98,0,15,0,6
43328,1,2415,2465,-50,0,49,1,6
43329,2,2495,2602,-107,0,444,1,6
43330,1,2559,2550,9,0,100,0,6
43331,2,2404,2539,-135,0,308,0,6
43332,2,2364,2404,-40,0,255,0,6
43333,1,2517,2358,159,0,7,0,6
43334,2,2348,2413,-65,0,40,1,6
43335,2,2396,2490,-94,0,40,0,6
43336,1,2329,2425,-96,0,302,0,6
43337,2,2274,2421,-147,0,312,0,6
43338,2,2324,2421,-97,0,277,1,6
43339,2,2214,2466,-252,0,453,0,6
43340,2,2364,2459,-95,0,102,0,6
43341,1,2492,2519,-27,0,357,0,6
43342,1,2515,2517,-2,0,345,0,6
43343,3,2381,2572,-191,0,13,0,6
43344,2,2479,2518,-39,0,107,1,6
43345,1,2453,2469,-16,0,151,0,6
43346,1,2466,2203,263,0,48,0,6
43347,2,2293,2454,-161,0,300,0,6
43348,1,2293,2461,-168,0,484,0,6
43349,3,2417,2313,104,0,48,0,6
43350,2,2508,2658,-150,0,112,0,6
43351,1,2467,2487,-20,0,260,0,6
43352,2,2397,2471,-74,0,315,0,6
43353,1,2545,2564,-19,0,0,1,6
43354,1,2450,2222,228,0,483,0,6
43355,2,2323,2431,-108,0,306,0,6
43356,2,2294,2425,-131,0,43,0,6
43357,1,2463,2470,-7,0,245,0,6
43358,1,2285,2407,-122,0,45,1,6
43359,2,2426,2475,-49,0,300,0,6
43360,2,2415,2308,107,0,40,0,6
43361,2,2393,2417,-24,0,145,1,6
43362,2,2432,2321,111,0,241,0,6
43363,1,2400,2283,117,0,0,0,6
43364,3,2468,2445,23,0,123,0,6
43365,1,2375,2436,-61,0,312,0,6
43366,1,2467,2373,94,0,101,0,6
43367,3,2468,2428,40,0,335,0,6
43368,2,2494,2392,102,0,110,0,6
43369,2,2421,2601,-180,0,247,0,6
43370,2,2316,2415,-99,0,302,0,6
43371,2,2555,2520,35,0,203,0,6
43372,1,2453,2361,92,0,143,0,6
43373,1,2557,2562,-5,0,5,0,6
43374,2,2266,2578,-312,0,300,0,6
43375,3,2423,2275,148,0,303,0,6
43377,2,2307,2400,-93,4,310,0,13
43378,2,2391,2503,-112,0,124,0,6
43379,1,2516,2505,11,0,46,0,6
43380,1,2661,2620,41,0,106,1,6
43381,2,2519,2612,-93,0,211,0,6
43382,2,2400,2506,-106,0,414,0,6
43383,1,2409,2271,138,0,328,0,6
43384,2,2402,2587,-185,0,385,0,6
43385,3,2423,2281,142,0,207,0,6
43386,1,2477,2408,69,0,4,0,6
43387,1,2459,2576,-117,0,122,0,6
43388,1,2512,2548,-36,0,152,0,6
43389,1,2530,2567,-37,0,215,1,6
43390,2,2443,2486,-43,0,300,0,6
43391,2,2415,2364,51,0,69,0,8
43392,2,2425,2309,116,0,395,0,6
43393,1,2375,2404,-29,0,102,0,6
43394,1,2357,2457,-100,0,282,0,6
43395,2,2410,2270,140,0,484,0,6
43396,2,2389,2405,-16,0,300,1,6
43397,2,2520,2387,133,0,426,0,6
43398,2,2312,2454,-142,0,304,0,6
43399,1,2458,2422,36,0,200,1,6
43400,2,2468,2316,152,0,112,0,6
43401,2,2479,2385,94,0,200,0,6
43402,1,2403,2233,170,0,305,0,8
43403,2,2274,2441,-167,4,360,1,13
43404,2,2261,2421,-160,0,204,0,6
43405,3,2311,2480,-169,0,255,0,6
43406,1,2587,2661,-74,0,0,0,6
43407,1,2420,2306,114,0,2,0,6
43408,2,2546,2501,45,0,248,0,6
43409,1,2606,2465,141,0,250,0,6
43410,1,2400,2453,-53,0,40,1,6
43411,2,2205,2416,-211,0,415,0,8
43412,1,2402,2273,129,0,335,0,8
43413,2,2542,2518,24,0,345,0,6
43414,2,2435,2383,52,0,190,1,6
43415,1,2425,2320,105,0,140,1,6
43416,2,2300,2402,-102,0,302,0,6
43417,1,2403,2396,7,0,217,1,6
43418,1,2499,2522,-23,0,140,1,6
43419,1,2481,2466,15,0,127,1,6
43420,1,2604,2416,188,0,210,0,6
43421,1,2392,2438,-46,0,45,1,6
43422,2,2317,2494,-177,0,126,0,6
43423,2,2381,2479,-98,0,461,0,6
43424,1,2328,2425,-97,0,8,1,6
43425,2,2213,2400,-187,0,4,0,6
43426,3,2430,2382,48,0,107,0,6
43427,2,2364,2419,-55,0,128,1,6
43428,1,2429,2290,139,0,40,0,6
43429,1,2661,2510,151,0,167,0,6
43430,2,2423,2430,-7,0,46,0,6
43431,2,2446,2291,155,0,0,1,6
43432,1,2419,2351,68,0,104,0,6
43433,2,2461,2467,-6,0,50,0,6
43434,1,2286,2431,-145,0,133,0,6
43435,1,2502,2401,101,0,87,0,6
43436,1,2558,2551,7,0,100,0,6
43437,2,2590,2610,-20,0,410,0,6
43438,3,2601,2241,360,0,337,0,6
43439,2,2413,2383,30,0,411,1,6
43440,2,2507,2509,-2,0,11,1,6
43441,1,2428,2468,-40,0,373,0,6
43442,1,2437,2399,38,0,61,0,6
43443,1,2556,2366,190,0,338,0,6
43444,2,2369,2462,-93,0,1,0,8
43445,2,2368,2471,-103,0,242,0,6
43446,1,2611,2271,340,0,140,0,6
43447,2,2438,2388,50,0,181,0,6
43448,1,2475,2569,-94,0,0,0,6
43449,1,2470,2346,124,0,2,0,8
43450,1,2408,2282,126,0,241,0,6
43451,2,2316,2452,-136,0,123,0,6
43452,2,2420,2459,-39,0,132,0,6
43453,3,2413,2607,-194,0,301,0,6
43454,1,2572,2226,346,0,102,1,5
43455,1,2481,2279,202,0,197,1,8
43456,1,2404,2381,23,0,134,0,6
43457,3,2387,2512,-125,0,226,0,6
43458,2,2267,2417,-150,0,312,0,6
43459,2,2401,2377,24,0,15,0,6
43460,1,2491,2438,53,0,100,0,6
43461,2,2561,2537,24,0,40,0,6
43462,1,2457,2556,-99,0,122,0,6
43463,2,2403,2290,113,0,455,0,6
43464,2,2445,2424,21,0,204,0,6
43465,2,2318,2406,-88,0,485,0,8
43466,1,2479,2308,171,0,7,0,5
43467,2,2269,2475,-206,0,5,0,6
43468,2,2507,2353,154,0,45,0,6
43469,1,2469,2262,207,0,302,1,6
43470,1,2507,2406,101,0,392,0,6
43471,2,2304,2457,-153,0,106,0,6
43472,1,2423,2357,66,0,373,0,6
43473,1,2407,2258,149,0,111,1,6
43474,1,2410,2237,173,0,300,0,8
43475,1,2522,2425,97,0,49,0,8
43476,1,2330,2429,-99,0,345,0,6
43477,2,2417,2464,-47,0,49,0,6
43478,2,2402,2393,9,0,0,0,6
43479,1,2404,2524,-120,0,304,0,6
43480,1,2359,2413,-54,0,312,0,6
43481,2,2326,2580,-254,0,338,0,6
43482,2,2404,2482,-78,0,382,0,6
43483,2,2293,2426,-133,0,56,0,8
43484,2,2316,2429,-113,0,45,1,6
43485,2,2346,2424,-78,0,83,0,6
43486,2,2477,2516,-39,0,203,0,6
43487,2,2526,2667,-141,0,325,0,6
43488,2,2287,2432,-145,0,43,0,6
43489,1,2435,2411,24,0,344,0,6
43490,1,2487,2472,15,0,147,0,6
43491,1,2391,2408,-17,0,46,1,6
43492,2,2473,2428,45,0,57,0,6
43493,2,2322,2460,-138,0,49,1,6
43494,1,2456,2349,107,0,462,1,6
43495,3,2401,2287,114,0,4,0,6
43496,2,2430,2394,36,0,52,0,6
43497,2,2432,2263,169,0,110,1,6
43498,1,2468,2506,-38,0,130,0,6
43499,3,2296,2402,-106,0,211,0,6
43500,2,2464,2319,145,0,122,0,6
43501,1,2374,2461,-87,0,106,0,6
43502,1,2421,2287,134,0,5,0,6
43503,3,2397,2418,-21,0,216,0,6
43504,2,2323,2438,-115,0,100,0,6
43505,3,2354,2502,-148,0,46,0,6
43506,2,2283,2416,-133,0,257,0,6
43507,1,2475,2364,111,0,101,0,6
43508,1,2461,2435,26,0,433,0,6
43509,2,2330,2486,-156,0,463,0,6
43510,1,2545,2615,-70,0,143,0,6
43511,1,2389,2450,-61,0,40,0,6
43512,2,2571,2435,136,0,137,0,6
43513,1,2686,2666,20,0,162,0,6
43514,3,2208,2428,-220,0,241,0,6
43515,2,2411,2311,100,0,6,0,6
43516,2,2333,2441,-108,0,100,0,6
43517,2,2523,2511,12,0,442,0,6
43518,1,2464,2402,62,0,300,0,6
43519,2,2363,2424,-61,0,319,0,6
43520,1,2435,2319,116,0,44,0,6
43521,1,2497,2386,111,0,58,0,6
43522,1,2417,2282,135,0,46,1,6
43523,1,2458,2308,150,0,201,0,6
43524,2,2345,2435,-90,4,5,0,13
43525,2,2399,2429,-30,0,117,0,6
43526,2,2670,2505,165,0,190,1,6
43527,1,2454,2441,13,0,100,0,6
43528,1,2527,2529,-2,0,45,0,6
43529,1,2404,2383,21,0,127,1,6
43530,2,2387,2410,-23,0,330,0,6
43531,3,2583,2597,-14,0,453,0,6
43532,1,2407,2385,22,0,56,1,6
43533,2,2446,2543,-97,0,101,0,6
43534,2,2527,2532,-5,0,109,0,6
43535,2,2543,2555,-12,0,200,1,6
43536,2,2466,2455,11,0,277,1,6
43537,1,2428,2424,4,0,12,1,6
43538,1,2464,2201,263,0,292,0,6
43539,2,2416,2401,15,0,301,0,6
43540,2,2440,2409,31,0,15,0,8
43541,2,2499,2492,7,0,45,0,6
43542,2,2439,2406,33,0,339,0,8
43543,2,2413,2252,161,2,109,0,23
43544,2,2333,2422,-89,0,320,0,6
43545,1,2436,2283,153,0,40,0,6
43546,1,2425,2335,90,0,46,0,6
43547,1,2478,2413,65,0,302,1,6
43548,1,2525,2335,190,0,115,0,6
43549,1,2418,2412,6,0,210,0,6
43550,1,2438,2469,-31,0,127,0,6
43551,1,2305,2482,-177,0,52,0,5
43552,2,2604,2517,87,0,112,0,6
43553,2,2433,2312,121,0,101,0,6
43554,3,2362,2479,-117,0,242,0,6
43555,2,2407,2361,46,0,8,0,6
43556,2,2345,2460,-115,0,46,1,6
43557,2,2393,2421,-28,0,272,0,6
43558,2,2435,2511,-76,0,456,0,6
43559,1,2269,2612,-343,0,38,0,6
43560,1,2514,2354,160,0,150,0,6
43561,1,2391,2472,-81,0,246,0,6
43562,1,2342,2493,-151,0,40,0,8
43563,1,2456,2445,11,0,121,0,6
43564,2,2407,2410,-3,0,202,0,6
43565,3,2384,2499,-115,0,45,0,6
43566,1,2475,2412,63,0,40,0,6
43567,1,2420,2311,109,4,101,0,13
43568,2,2500,2254,246,0,305,0,6
43569,2,2416,2389,27,0,106,0,6
43570,1,2581,2415,166,0,40,0,6
43571,2,2454,2469,-15,0,101,0,6
43572,2,2411,2473,-62,0,264,0,6
43573,2,2400,2378,22,0,17,0,6
43574,2,2426,2274,152,0,133,0,6
43575,1,2382,2424,-42,0,311,0,6
43576,2,2430,2467,-37,0,302,1,6
43577,1,2426,2351,75,0,200,0,6
43578,2,2234,2413,-179,0,45,1,8
43579,1,2446,2309,137,0,0,0,6
43580,2,2308,2457,-149,0,151,1,6
43581,2,2426,2499,-73,0,395,0,6
43582,2,2280,2439,-159,0,43,0,6
43583,2,2447,2424,23,0,474,0,6
43584,1,2358,2448,-90,0,40,0,6
43585,1,2608,2517,91,0,253,1,6
43586,2,2474,2428,46,0,300,1,6
43587,2,2437,2365,72,0,40,0,8
43588,3,2278,2420,-142,0,195,0,6
43589,1,2465,2402,63,0,200,1,6
43590,2,2308,2483,-175,0,311,0,6
43591,1,2661,2691,-30,0,352,0,6
43592,3,2549,2265,284,0,484,0,6
43593,2,2445,2359,86,0,4,1,6
43594,1,2400,2274,126,0,1,0,6
43595,1,2457,2281,176,0,315,0,6
43596,2,2552,2559,-7,0,474,0,6
43597,2,2425,2253,172,0,177,1,6
43598,1,2407,2480,-73,0,125,1,6
43599,3,2401,2526,-125,0,300,0,8
43600,1,2403,2231,172,0,486,0,6
43601,3,2498,2442,56,0,112,0,6
43602,1,2449,2298,151,0,0,0,6
43603,1,2278,2403,-125,0,107,0,6
43604,1,2318,2412,-94,0,257,0,6
43605,2,2441,2594,-153,0,306,0,6
43606,1,2417,2249,168,0,43,0,6
43607,1,2508,2347,161,4,487,0,13
43608,2,2379,2412,-33,0,311,0,6
43609,1,2662,2665,-3,0,115,0,6
43610,1,2418,2303,115,0,52,1,6
43611,2,2293,2407,-114,4,7,0,13
43612,2,2320,2425,-105,0,277,0,6
43613,1,2462,2205,257,0,345,0,8
43614,2,2403,2434,-31,0,226,0,6
43615,1,2560,2538,22,0,46,0,6
43616,1,2445,2229,216,4,45,1,13
43617,1,2562,2393,169,0,12,0,6
43618,1,2463,2448,15,0,0,1,6
43620,2,2437,2460,-23,0,17,1,6
43621,1,2439,2398,41,0,200,0,6
43622,1,2602,2280,322,0,45,0,6
43623,1,2443,2277,166,0,40,0,6
43624,2,2269,2426,-157,0,130,0,6
43625,2,2397,2511,-114,0,46,0,6
43626,2,2528,2430,98,0,110,0,6
43627,1,2295,2403,-108,0,207,0,6
43628,1,2418,2515,-97,0,112,0,6
43629,1,2540,2521,19,0,49,0,6
43630,2,2264,2428,-164,0,268,0,6
43631,1,2421,2365,56,0,395,1,6
43632,1,2478,2364,114,0,153,1,6
43633,1,2382,2501,-119,0,278,0,6
43634,3,2241,2466,-225,0,288,0,6
43635,2,2417,2374,43,0,56,0,6
43636,2,2416,2401,15,0,301,0,6
43637,1,2364,2401,-37,0,202,0,6
43638,1,2478,2388,90,0,299,0,6
43639,1,2490,2410,80,0,7,0,6
43640,1,2463,2406,57,0,311,0,6
43641,2,2410,2298,112,0,292,0,6
43642,2,2504,2500,4,0,28,0,6
43643,2,2565,2547,18,0,4,0,6
43644,1,2396,2424,-28,0,226,1,6
43645,1,2442,2460,-18,0,45,0,6
43646,1,2472,2425,47,0,487,0,6
43647,2,2470,2430,40,0,132,0,6
43648,2,2248,2425,-177,0,107,0,6
43649,2,2257,2440,-183,4,154,0,13
43650,2,2415,2434,-19,0,102,0,8
43651,1,2506,2486,20,0,311,0,6
43652,2,2305,2461,-156,0,107,0,6
43653,2,2417,2329,88,0,211,0,6
43654,1,2597,2403,194,0,410,0,6
43655,1,2270,2583,-313,0,253,1,6
43656,1,2435,2468,-33,0,101,0,6
43657,1,2613,2497,116,0,253,0,6
43658,2,2668,2633,35,0,107,0,6
43659,2,2513,2659,-146,0,85,0,6
43660,1,2396,2412,-16,0,269,1,8
43661,2,2541,2518,23,0,110,1,6
43662,1,2439,2260,179,0,111,1,6
43663,2,2335,2459,-124,0,1,0,6
43664,3,2293,2612,-319,0,107,0,6
43665,1,2473,2414,59,0,201,0,6
43666,1,2439,2398,41,0,143,0,6
43667,1,2532,2566,-34,0,215,0,6
43668,2,2358,2453,-95,0,4,0,6
43669,1,2407,2410,-3,0,202,0,6
43670,1,2461,2329,132,0,200,0,6
43671,3,2685,2810,-125,0,278,0,6
43672,2,2402,2331,71,0,2,0,6
43673,1,2485,2282,203,0,43,0,6
43674,2,2404,2475,-71,0,129,0,6
43675,1,2476,2484,-8,0,4,1,6
43676,1,2322,2401,-79,0,461,0,6
43677,2,2400,2436,-36,0,8,0,6
43678,1,2524,2416,108,0,151,0,6
43679,2,2278,2604,-326,0,88,0,6
43680,2,2384,2509,-125,0,368,0,6
43681,2,2401,2425,-24,0,133,0,6
43682,1,2430,2316,114,0,130,1,6
43683,1,2546,2218,328,0,9,0,6
43684,2,2468,2515,-47,0,103,0,6
43685,2,2229,2403,-174,0,10,0,6
43686,3,2381,2411,-30,0,130,0,6
43687,2,2407,2386,21,0,334,0,6
43688,2,2360,2432,-72,0,10,0,6
43689,1,2382,2466,-84,0,426,0,6
43690,1,2443,2333,110,4,427,0,13
43691,2,2423,2465,-42,0,102,0,8
43692,1,2654,2437,217,0,436,0,6
43693,2,2667,2783,-116,0,380,0,6
43694,3,2418,2383,35,0,5,0,6
43695,1,2432,2303,129,0,0,0,6
43696,2,2560,2539,21,0,45,0,6
43697,2,2396,2439,-43,0,117,0,6
43698,1,2405,2306,99,0,415,0,6
43699,1,2461,2441,20,0,300,0,6
43700,1,2530,2445,85,0,378,1,6
43701,1,2360,2482,-122,0,242,0,6
43702,1,2422,2333,89,0,40,0,6
43703,2,2468,2505,-37,0,302,0,6
43704,1,2410,2381,29,0,56,0,6
43705,2,2360,2400,-40,0,483,0,6
43706,1,2446,2351,95,0,118,0,6
43707,2,2441,2498,-57,0,225,1,6
43708,2,2528,2662,-134,0,151,1,6
43709,1,2597,2552,45,0,0,0,6
43710,3,2372,2476,-104,0,80,0,8
43711,1,2365,2430,-65,0,65,0,8
43712,1,2420,2477,-57,0,118,0,6
43713,2,2494,2433,61,0,373,0,6
43714,1,2402,2213,189,0,7,0,6
43715,1,2509,2449,60,0,310,0,6
43716,1,2385,2548,-163,0,191,0,6
43717,1,2534,2325,209,0,45,1,6
43718,3,2412,2494,-82,0,133,0,6
43719,1,2662,2553,109,0,132,0,6
43720,2,2480,2323,157,0,0,0,6
43721,1,2304,2431,-127,0,120,0,6
43722,1,2436,2444,-8,0,15,0,6
43723,2,2545,2554,-9,0,200,0,6
43724,2,2283,2464,-181,0,245,0,6
43725,2,2430,2436,-6,0,105,0,6
43726,2,2428,2303,125,0,152,0,6
43727,3,2448,2396,52,0,277,0,6
43728,1,2409,2478,-69,0,268,0,6
43729,1,2429,2281,148,0,48,0,6
43730,1,2457,2313,144,0,0,1,6
43731,1,2474,2368,106,0,153,0,6
43732,3,2464,2301,163,0,36,0,6
43733,1,2404,2413,-9,0,45,0,6
43734,3,2277,2486,-209,0,190,0,8
43735,1,2721,2617,104,0,4,0,6
43736,1,2421,2378,43,0,101,0,6
43737,1,2439,2410,29,0,10,1,8
43738,1,2489,2208,281,0,49,0,6
43739,1,2366,2444,-78,0,311,1,6
43740,1,2564,2535,29,0,128,0,6
43741,2,2808,2687,121,0,428,1,6
43742,2,2463,2600,-137,0,242,1,6
43743,2,2493,2539,-46,0,265,0,6
43744,2,2266,2444,-178,0,485,1,6
43745,1,2476,2389,87,0,45,1,6
43746,2,2294,2459,-165,0,301,0,6
43747,1,2463,2432,31,0,217,0,6
43748,1,2520,2380,140,0,345,1,6
43749,2,2531,2380,151,0,320,0,6
43750,3,2392,2443,-51,0,45,0,6
43751,1,2312,2433,-121,0,255,0,6
43752,2,2300,2436,-136,0,40,1,6
43753,1,2406,2226,180,0,170,0,6
43754,1,2787,2663,124,0,330,1,6
43755,2,2267,2467,-200,0,301,0,6
43756,1,2532,2390,142,0,300,0,6
43757,2,2433,2394,39,0,40,0,6
43758,1,2347,2450,-103,0,101,1,6
43759,1,2524,2355,169,0,248,0,6
43760,3,2480,2280,200,0,197,0,8
43761,3,2418,2433,-15,0,418,0,6
43762,1,2426,2510,-84,0,302,0,6
43763,2,2471,2416,55,0,201,0,6
43764,1,2376,2416,-40,0,310,1,6
43765,1,2388,2427,-39,0,311,1,6
43766,3,2510,2447,63,4,203,0,13
43767,2,2338,2516,-178,0,49,0,8
43768,2,2329,2437,-108,0,40,1,6
43769,2,2350,2463,-113,0,301,0,6
43770,1,2420,2327,93,0,103,0,6
43771,1,2425,2333,92,0,46,0,6
43772,1,2301,2423,-122,0,46,1,6
43773,2,2333,2406,-73,0,302,1,8
43774,1,2296,2464,-168,0,250,0,6
43775,1,2593,2530,63,0,300,0,6
43776,2,2295,2467,-172,0,300,1,6
43777,2,2463,2212,251,0,93,1,6
43778,1,2356,2488,-132,0,153,0,6
43779,1,2463,2302,161,0,31,0,6
43780,1,2608,2308,300,0,469,0,6
43781,2,2535,2524,11,0,347,0,6
43782,1,2521,2442,79,0,175,0,6
43783,1,2492,2435,57,0,1,0,6
43784,2,2331,2426,-95,0,124,0,6
43785,1,2470,2537,-67,0,115,0,6
43786,2,2543,2665,-122,0,320,1,6
43787,2,2383,2421,-38,0,241,0,6
43788,2,2364,2478,-114,0,242,0,6
43789,1,2425,2472,-47,0,101,0,6
43790,2,2559,2539,20,0,201,0,6
43791,1,2423,2464,-41,0,242,0,6
43792,2,2241,2554,-313,0,43,0,6
43793,2,2332,2460,-128,0,100,0,6
43794,1,2442,2380,62,0,16,0,6
43795,2,2549,2598,-49,0,245,1,6
43796,2,2290,2404,-114,0,70,0,6
43797,2,2289,2455,-166,0,45,1,6
43798,1,2407,2410,-3,0,202,0,6
43799,1,2435,2429,6,0,330,0,6
43800,1,2415,2383,32,0,152,0,6
43801,1,2468,2488,-20,0,247,0,6
43802,1,2634,2532,102,0,152,0,6
43803,2,2284,2540,-256,0,101,0,6
43804,1,2493,2335,158,0,200,0,8
43805,1,2527,2258,269,0,85,0,6
43806,2,2354,2431,-77,0,112,0,6
43807,2,2545,2725,-180,0,106,0,6
43808,3,2210,2490,-280,0,40,0,6
43809,2,2508,2535,-27,0,242,0,6
43810,2,2288,2453,-165,0,455,0,6
43811,2,2387,2421,-34,0,44,0,6
43812,2,2478,2581,-103,0,106,1,6
43813,2,2519,2416,103,0,389,0,8
43814,1,2613,2417,196,0,42,1,6
43815,2,2315,2480,-165,0,0,1,6
43816,1,2364,2426,-62,0,487,0,6
43817,3,2292,2457,-165,0,11,0,6
43818,1,2426,2329,97,0,402,0,6
43819,2,2382,2413,-31,0,192,0,6
43820,1,2375,2524,-149,0,107,0,6
43821,2,2448,2386,62,0,43,0,6
43822,1,2447,2286,161,0,16,0,6
43823,1,2482,2439,43,0,200,0,6
43824,2,2427,2350,77,0,58,0,6
43825,1,2659,2695,-36,0,448,1,6
43826,3,2418,2274,144,0,5,0,6
43827,3,2350,2549,-199,0,253,0,6
43828,3,2492,2322,170,0,302,0,6
43829,1,2218,2448,-230,4,213,0,13
43830,1,2446,2239,207,0,302,0,6
43831,2,2545,2553,-8,0,215,1,6
43832,2,2355,2480,-125,0,115,0,6
43833,1,2791,2579,212,0,409,1,6
43834,1,2404,2210,194,0,0,0,6
43835,2,2559,2433,126,0,211,0,6
43836,2,2484,2351,133,0,405,0,6
43837,1,2409,2382,27,0,56,0,6
43838,1,2404,2413,-9,0,300,1,6
43839,2,2503,2434,69,0,241,0,6
43840,1,2431,2318,113,0,80,0,6
43841,1,2467,2325,142,0,133,1,6
43842,1,2441,2352,89,0,226,0,6
43843,1,2420,2257,163,0,300,0,6
43844,1,2363,2410,-47,0,335,0,6
43845,1,2439,2438,1,0,302,1,6
43846,1,2598,2526,72,0,307,1,6
43847,2,2370,2525,-155,0,4,0,6
43848,1,2404,2267,137,0,151,1,6
43849,2,2426,2301,125,0,140,0,6
43850,2,2301,2470,-169,0,289,0,6
43851,1,2474,2340,134,0,152,0,8
43852,2,2360,2431,-71,0,302,1,6
43853,2,2420,2315,105,0,100,1,6
43854,1,2291,2431,-140,0,58,0,6
43855,2,2206,2481,-275,0,333,0,6
43856,1,2428,2530,-102,0,111,0,6
43857,2,2474,2405,69,0,2,0,8
43858,1,2500,2353,147,0,90,0,6
43859,2,2482,2474,8,0,127,1,6
43861,2,2530,2477,53,0,409,1,6
43862,1,2498,2375,123,0,106,0,6
43863,1,2404,2445,-41,0,45,0,8
43864,1,2466,2360,106,0,0,0,6
43865,1,2482,2529,-47,0,131,0,6
43866,2,2379,2408,-29,0,172,0,6
43867,1,2556,2288,268,0,120,0,6
43868,1,2669,2497,172,0,133,0,6
43869,2,2312,2450,-138,0,103,0,6
43870,3,2352,2538,-186,0,341,0,6
43871,2,2603,2540,63,0,333,0,6
43872,1,2417,2227,190,0,46,0,6
43873,1,2350,2466,-116,0,4,0,6
43874,2,2440,2441,-1,0,277,0,6
43875,2,2377,2415,-38,0,130,1,6
43876,2,2531,2391,140,0,300,0,6
43877,2,2408,2502,-94,0,202,1,6
43878,3,2342,2403,-61,0,112,0,6
43879,2,2541,2404,137,0,45,0,6
43880,1,2410,2360,50,0,413,0,6
43881,1,2728,2542,186,0,397,0,6
43882,1,2441,2287,154,0,404,1,6
43883,2,2434,2321,113,0,0,0,6
43884,2,2546,2596,-50,0,331,0,6
43885,1,2496,2329,167,0,102,1,8
43886,2,2326,2457,-131,0,201,0,6
43887,1,2411,2281,130,0,53,1,8
43888,1,2404,2487,-83,0,200,1,6
43889,1,2321,2413,-92,0,196,1,6
43890,2,2516,2473,43,0,337,0,6
43891,2,2383,2420,-37,0,241,0,6
43892,1,2585,2496,89,0,253,0,6
43893,2,2295,2400,-105,0,200,0,6
43894,1,2402,2275,127,4,140,1,13
43895,2,2559,2440,119,0,45,0,6
43896,2,2576,2794,-218,0,15,0,6
43897,1,2615,2489,126,0,242,0,6
43898,2,2302,2418,-116,0,201,0,6
43899,2,2441,2470,-29,0,335,1,6
43900,1,2454,2389,65,0,13,1,6
43901,2,2643,2666,-23,0,194,0,6
43902,1,2445,2470,-25,0,110,0,6
43903,2,2260,2424,-164,0,201,0,6
43904,1,2432,2254,178,0,11,0,6
43905,1,2430,2384,46,0,380,1,6
43906,1,2445,2333,112,0,110,0,6
43907,1,2348,2443,-95,0,44,0,6
43908,2,2228,2431,-203,0,40,0,6
43909,2,2426,2311,115,0,46,1,6
43910,1,2601,2541,60,0,218,0,6
43911,2,2435,2320,115,0,253,1,6
43912,1,2333,2411,-78,0,404,1,6
43913,1,2395,2486,-91,0,461,0,6
43914,1,2523,2343,180,0,460,0,6
43915,2,2514,2533,-19,0,346,0,6
43916,1,2422,2234,188,0,331,0,6
43917,2,2502,2339,163,0,102,0,6
43918,1,2796,2573,223,0,57,0,6
43919,1,2512,2329,183,0,80,0,8
43920,1,2523,2422,101,0,113,0,6
43921,1,2484,2322,162,0,40,1,6
43922,2,2480,2509,-29,0,207,0,6
43923,2,2218,2558,-340,0,43,0,6
43924,1,2696,2480,216,0,127,0,6
43925,1,2476,2540,-64,0,101,0,6
43926,1,2291,2406,-115,0,130,1,6
43927,1,2439,2376,63,0,194,0,6
43928,1,2427,2449,-22,0,0,0,6
43929,1,2528,2355,173,0,180,0,6
43930,1,2420,2372,48,0,43,0,6
43931,1,2461,2225,236,0,140,0,6
43932,2,2433,2320,113,0,100,0,6
43933,1,2446,2434,12,0,331,1,6
43934,3,2667,2619,48,0,121,0,6
43935,1,2400,2301,99,0,418,0,6
43936,1,2485,2390,95,0,206,0,6
43937,3,2399,2526,-127,0,14,0,6
43938,1,2671,2638,33,0,40,0,6
43939,2,2494,2527,-33,0,300,1,6
43940,1,2522,2509,13,0,57,0,6
43941,2,2480,2474,6,0,112,1,6
43942,2,2407,2509,-102,0,20,0,6
43943,1,2538,2527,11,0,300,0,6
43944,1,2278,2419,-141,0,0,0,6
43945,3,2461,2410,51,0,300,0,6
43946,1,2421,2475,-54,0,104,1,8
43947,1,2482,2283,199,0,114,0,6
43948,2,2414,2581,-167,0,12,0,6
43949,1,2424,2246,178,0,302,0,8
43950,1,2633,2676,-43,0,246,1,6
43951,2,2448,2358,90,4,461,0,13
43952,1,2492,2405,87,0,192,0,6
43953,2,2589,2426,163,0,241,0,6
43954,1,2448,2551,-103,0,43,0,6
43955,2,2476,2378,98,0,5,0,6
43956,1,2441,2279,162,0,111,0,6
43957,2,2333,2445,-112,0,177,0,6
43958,2,2275,2436,-161,0,101,0,6
43959,2,2355,2446,-91,0,483,0,6
43960,2,2306,2448,-142,0,212,0,6
43961,2,2480,2451,29,0,140,0,6
43962,3,2571,2799,-228,0,205,0,6
43963,2,2223,2411,-188,0,45,0,6
43964,1,2529,2431,98,0,256,0,6
43965,2,2200,2417,-217,4,102,0,13
43966,2,2407,2427,-20,0,202,0,6
43967,1,2438,2411,27,0,20,0,8
43968,2,2524,2297,227,0,300,0,6
43969,2,2458,2570,-112,0,11,0,6
43970,1,2276,2402,-126,0,414,0,6
43971,1,2467,2428,39,0,45,0,6
43972,1,2537,2606,-69,0,331,0,6
43973,1,2527,2451,76,0,151,1,6
43974,1,2545,2600,-55,0,134,1,6
43975,1,2379,2435,-56,0,58,0,6
43976,1,2480,2451,29,0,8,1,6
43977,2,2326,2515,-189,0,101,0,8
43978,1,2314,2445,-131,0,45,0,6
43979,1,2445,2464,-19,0,121,0,6
43980,2,2547,2528,19,0,403,0,6
43981,3,2352,2539,-187,0,293,0,6
43982,2,2524,2487,37,0,400,0,6
43983,2,2341,2489,-148,0,302,0,6
43984,2,2301,2419,-118,0,190,0,6
43985,1,2432,2478,-46,0,484,0,6
43986,1,2404,2340,64,0,102,0,6
43987,1,2414,2218,196,0,40,0,6
43988,2,2514,2475,39,0,212,0,6
43989,2,2504,2415,89,0,49,1,6
43990,2,2506,2574,-68,0,314,0,6
43991,1,2433,2362,71,0,0,0,6
43992,1,2436,2454,-18,0,90,1,6
43993,3,2418,2318,100,0,65,0,6
43994,2,2476,2386,90,0,110,1,6
43995,3,2334,2500,-166,0,46,0,8
43996,1,2286,2455,-169,0,463,0,6
43997,1,2449,2559,-110,0,202,0,6
43998,1,2437,2329,108,0,1,0,6
43999,2,2365,2520,-155,0,45,0,8
44000,1,2421,2279,142,4,41,0,13
44001,2,2435,2620,-185,0,406,1,6
44002,2,2367,2425,-58,0,9,0,6
44003,1,2579,2501,78,0,463,0,6
44004,3,2666,2581,85,0,0,0,6
44005,1,2426,2403,23,0,46,1,6
44006,1,2522,2443,79,0,4,0,6
44007,2,2301,2508,-207,0,207,0,6
44008,2,2386,2404,-18,0,202,0,6
44009,2,2496,2513,-17,0,192,0,6
44010,1,2404,2293,111,0,291,1,6
44011,1,2532,2515,17,0,300,0,6
44012,1,2451,2303,148,0,103,0,6
44013,2,2395,2489,-94,0,311,0,6
44014,2,2426,2280,146,0,110,1,6
44015,1,2474,2351,123,0,243,0,6
44016,2,2285,2452,-167,0,386,0,6
44017,1,2439,2271,168,0,301,0,6
44018,2,2231,2422,-191,0,41,1,6
44019,2,2424,2297,127,0,306,0,6
44020,1,2468,2331,137,0,310,0,8
44021,2,2670,2639,31,0,492,1,6
44022,2,2544,2456,88,0,45,0,6
44023,2,2584,2544,40,0,334,0,6
44024,2,2332,2423,-91,0,122,1,6
44025,1,2497,2377,120,0,352,1,6
44026,1,2493,2338,155,0,131,0,6
44027,2,2355,2426,-71,0,302,1,6
44028,2,2297,2418,-121,0,420,0,6
44029,2,2438,2403,35,0,120,0,6
44030,1,2370,2441,-71,0,106,0,6
44031,1,2334,2465,-131,0,206,0,6
44032,1,2514,2566,-52,0,101,0,6
44033,1,2423,2452,-29,0,157,0,6
44034,2,2493,2497,-4,0,1,0,6
44035,2,2406,2444,-38,0,375,1,8
44036,1,2491,2473,18,0,293,0,6
44037,1,2518,2503,15,0,490,1,6
44038,1,2428,2385,43,0,453,0,6
44039,1,2458,2409,49,0,28,1,6
44040,1,2530,2355,175,0,180,0,6
44041,1,2439,2457,-18,0,469,0,6
44042,2,2518,2217,301,0,352,0,6
44043,2,2440,2383,57,0,123,0,6
44044,2,2593,2532,61,0,200,0,6
44045,2,2439,2453,-14,0,338,0,6
44046,2,2623,2486,137,0,133,0,6
44047,2,2471,2475,-4,0,247,1,6
44048,2,2300,2455,-155,0,301,0,6
44049,1,2582,2431,151,0,140,1,6
44050,1,2333,2448,-115,0,253,1,6
44051,2,2430,2362,68,0,404,1,6
44052,2,2375,2417,-42,0,337,1,6
44053,1,2410,2460,-50,0,354,1,6
44054,1,2497,2404,93,0,315,0,6
44055,3,2423,2583,-160,0,171,0,6
44056,1,2390,2434,-44,0,302,1,6
44057,1,2260,2402,-142,0,120,0,6
44058,1,2401,2398,3,0,203,0,6
44059,2,2277,2400,-123,0,483,0,6
44060,1,2503,2478,25,0,0,0,6
44061,1,2267,2442,-175,0,128,1,6
44062,1,2347,2468,-121,0,411,1,6
44063,2,2384,2456,-72,0,468,0,6
44064,1,2427,2421,6,0,205,0,6
44065,2,2427,2275,152,0,300,0,8
44066,1,2473,2487,-14,0,112,0,6
44067,2,2339,2508,-169,0,102,0,6
44068,2,2305,2429,-124,0,143,0,6
44069,1,2409,2301,108,0,80,0,6
44070,1,2397,2526,-129,0,112,0,6
44071,1,2299,2400,-101,0,453,0,6
44072,1,2494,2508,-14,0,245,0,6
44073,2,2404,2351,53,0,253,0,6
44074,2,2459,2342,117,0,302,0,6
44075,3,2646,2664,-18,0,246,0,6
44076,2,2314,2479,-165,0,205,1,6
44077,1,2464,2323,141,0,101,0,6
44078,2,2328,2482,-154,0,1,1,6
44079,1,2496,2432,64,0,203,0,6
44080,2,2550,2578,-28,0,43,0,6
44081,2,2534,2402,132,0,242,0,6
44082,2,2457,2384,73,0,130,1,6
44083,2,2632,2635,-3,0,167,0,6
44084,2,2400,2288,112,0,112,0,6
44085,1,2548,2614,-66,0,285,0,6
44086,2,2297,2432,-135,0,45,0,6
44087,2,2322,2502,-180,0,190,0,6
44088,2,2317,2409,-92,0,163,0,6
44089,1,2497,2391,106,0,317,0,6
44091,2,2318,2434,-116,0,311,0,6
44092,1,2433,2289,144,0,10,0,6
44093,1,2462,2354,108,0,241,1,6
44095,1,2478,2479,-1,0,400,0,6
44096,2,2280,2434,-154,0,241,0,6
44097,2,2494,2644,-150,0,176,1,6
44098,1,2404,2463,-59,0,120,0,6
44099,1,2615,2664,-49,0,110,1,6
44100,1,2497,2396,101,0,120,0,6
44101,2,2458,2296,162,0,201,0,6
44102,2,2447,2452,-5,0,150,1,6
44103,1,2645,2469,176,0,0,0,6
44104,3,2352,2540,-188,0,253,0,6
44105,2,2332,2503,-171,0,265,0,6
44106,2,2462,2378,84,0,101,0,6
44107,1,2520,2496,24,0,335,0,6
44108,2,2395,2553,-158,0,200,0,6
44109,1,2511,2334,177,0,0,0,6
44110,1,2559,2475,84,0,345,0,6
44111,1,2548,2502,46,0,226,1,6
44112,1,2416,2391,25,0,315,0,6
44113,1,2434,2445,-11,0,31,0,6
44114,1,2451,2498,-47,0,5,1,6
44116,1,2311,2446,-135,2,138,0,28
44117,1,2400,2380,20,0,49,0,6
44118,2,2314,2515,-201,0,111,0,6
44119,2,2410,2264,146,0,104,0,6
44120,1,2519,2296,223,0,120,0,6
44121,2,2447,2289,158,0,241,0,6
44122,2,2466,2405,61,0,247,1,6
44123,2,2418,2551,-133,0,250,0,6
44124,2,2333,2408,-75,0,302,0,6
44125,1,2664,2646,18,0,263,1,6
44126,1,2369,2423,-54,0,123,0,6
44127,2,2402,2406,-4,4,45,0,13
44128,1,2531,2354,177,0,190,0,6
44129,1,2485,2394,91,0,4,0,6
44130,1,2422,2272,150,0,108,1,6
44131,2,2305,2450,-145,0,301,0,6
44132,1,2415,2327,88,0,300,0,8
44133,2,2432,2301,131,0,101,0,6
44134,2,2382,2436,-54,0,101,1,6
44135,2,2388,2485,-97,0,311,0,6
44136,1,2473,2335,138,0,112,0,6
44137,1,2461,2390,71,0,280,0,6
44138,2,2343,2438,-95,0,343,0,6
44139,2,2297,2506,-209,0,43,0,6
44140,1,2583,2545,38,0,200,0,6
44141,2,2430,2245,185,0,211,1,8
44142,1,2411,2586,-175,0,4,1,6
44143,1,2501,2474,27,0,7,0,6
44144,1,2350,2451,-101,0,102,0,6
44145,2,2521,2372,149,0,45,0,6
44146,2,2446,2490,-44,0,190,0,6
44147,2,2641,2626,15,0,150,0,6
44148,1,2438,2397,41,0,454,1,6
44149,3,2474,2432,42,0,357,0,8
44150,1,2514,2401,113,0,0,0,6
44151,1,2397,2425,-28,0,150,0,6
44152,3,2428,2486,-58,0,331,0,6
44153,2,2366,2457,-91,0,1,0,6
44154,2,2573,2617,-44,0,113,1,6
44156,1,2555,2483,72,0,13,0,6
44157,2,2441,2317,124,0,140,1,6
44158,1,2275,2451,-176,0,490,1,6
44159,1,2482,2491,-9,0,1,0,6
44160,2,2416,2376,40,0,83,0,6
44161,2,2471,2455,16,0,300,0,6
44163,1,2456,2411,45,0,28,1,6
44164,2,2648,2563,85,0,45,0,6
44165,2,2391,2407,-16,0,202,0,6
44166,1,2508,2424,84,0,40,0,6
44167,2,2295,2513,-218,0,309,0,6
44168,2,2555,2477,78,0,289,1,6
44169,1,2437,2276,161,4,113,0,13
44170,3,2462,2331,131,0,347,0,6
44172,1,2442,2414,28,0,80,0,6
44173,1,2412,2380,32,0,13,1,6
44174,2,2275,2466,-191,0,205,0,6
44175,2,2304,2439,-135,0,45,0,6
44176,1,2465,2297,168,0,242,0,6
44177,2,2646,2658,-12,0,40,0,6
44178,2,2490,2622,-132,0,143,0,6
44179,2,2397,2518,-121,0,102,0,6
44180,2,2297,2404,-107,0,8,0,6
44181,2,2408,2286,122,0,152,0,6
44182,2,2322,2505,-183,0,30,0,6
44183,1,2497,2435,62,0,46,0,6
44184,3,2351,2540,-189,0,293,0,6
44185,2,2501,2272,229,0,40,0,6
44186,1,2419,2343,76,0,100,0,6
44187,2,2491,2421,70,0,445,1,6
44188,2,2426,2462,-36,0,106,0,6
44189,2,2479,2501,-22,0,102,1,6
44190,2,2504,2553,-49,0,270,0,6
44191,3,2461,2361,100,0,138,0,6
44192,1,2410,2354,56,0,330,0,6
44193,2,2401,2524,-123,0,123,0,6
44194,1,2412,2459,-47,0,127,1,6
44195,2,2423,2360,63,0,151,0,6
44196,1,2641,2669,-28,0,246,0,6
44197,1,2408,2502,-94,0,410,0,6
44198,2,2601,2458,143,0,395,0,6
44199,2,2558,2234,324,0,210,1,6
44200,3,2315,2506,-191,0,6,0,6
44201,1,2491,2269,222,0,4,0,6
44202,2,2506,2447,59,0,7,0,6
44203,1,2264,2418,-154,0,244,1,6
44204,2,2382,2436,-54,0,50,1,6
44205,2,2332,2444,-112,0,27,0,6
44206,1,2649,2596,53,0,300,0,6
44207,1,2402,2264,138,0,246,0,6
44209,1,2425,2319,106,0,330,0,6
44210,2,2469,2639,-170,0,0,0,6
44211,1,2547,2595,-48,0,31,0,6
44212,2,2350,2421,-71,0,37,0,6
44213,1,2622,2484,138,0,122,0,6
44214,2,2366,2496,-130,0,300,0,6
44215,2,2487,2372,115,0,455,0,8
44216,1,2383,2426,-43,0,150,0,6
44217,1,2533,2521,12,0,110,0,6
44218,1,2565,2647,-82,0,123,0,6
44219,2,2577,2485,92,0,278,1,6
44220,3,2485,2488,-3,0,130,0,6
44221,3,2327,2505,-178,0,104,0,6
44222,1,2294,2484,-190,0,335,0,6
44223,3,2559,2429,130,0,373,0,6
44224,1,2385,2435,-50,0,250,0,6
44225,1,2419,2412,7,0,4,0,6
44226,2,2422,2283,139,0,263,0,6
44227,2,2487,2641,-154,0,193,1,6
44228,2,2330,2460,-130,0,153,0,6
44229,1,2418,2385,33,0,46,1,6
44230,3,2412,2355,57,0,106,0,6
44231,2,2302,2406,-104,0,305,1,6
44232,1,2502,2257,245,0,5,0,6
44233,1,2663,2647,16,0,492,1,6
44234,2,2534,2501,33,0,58,0,6
44235,1,2412,2306,106,0,200,0,6
44236,2,2364,2516,-152,0,101,0,6
44237,2,2548,2469,79,0,105,1,6
44238,2,2244,2443,-199,0,106,0,6
44239,2,2458,2439,19,0,102,0,6
44240,1,2293,2423,-130,0,202,0,6
44241,1,2430,2405,25,0,244,0,6
44242,2,2416,2417,-1,0,100,0,6
44243,1,2626,2527,99,0,250,1,6
44244,1,2526,2485,41,0,302,0,6
44245,1,2487,2507,-20,0,45,1,6
44246,2,2294,2418,-124,0,14,1,6
44247,2,2516,2473,43,0,441,1,6
44248,2,2363,2460,-97,0,1,0,6
44249,1,2441,2381,60,0,130,0,6
44250,1,2539,2484,55,0,256,0,6
44251,3,2286,2415,-129,0,6,0,6
44252,2,2281,2410,-129,0,200,0,6
44253,1,2423,2492,-69,0,14,0,6
44254,1,2453,2418,35,0,247,0,6
44255,2,2548,2499,49,0,244,0,6
44256,1,2466,2594,-128,0,123,1,6
44257,1,2515,2327,188,0,40,0,6
44258,1,2433,2347,86,0,201,1,6
44259,1,2448,2442,6,0,328,0,6
44260,1,2464,2387,77,0,43,0,6
44261,1,2475,2351,124,0,133,1,6
44262,2,2329,2520,-191,0,101,0,6
44263,1,2509,2378,131,0,315,0,6
44264,1,2375,2499,-124,0,115,1,6
44266,1,2640,2576,64,0,301,0,6
44267,2,2406,2425,-19,0,333,0,6
44268,1,2558,2539,19,0,228,0,6
44269,1,2426,2345,81,0,151,1,6
44271,2,2399,2430,-31,0,122,1,6
44272,2,2360,2402,-42,0,31,0,6
44273,2,2421,2312,109,0,313,1,6
44274,1,2598,2642,-44,0,107,0,6
44275,1,2411,2380,31,0,101,0,6
44276,1,2413,2458,-45,0,127,0,6
44277,2,2645,2570,75,0,107,0,6
44278,2,2492,2413,79,0,216,0,6
44279,1,2446,2378,68,0,466,0,6
44280,3,2545,2591,-46,0,218,0,6
44281,2,2359,2484,-125,0,1,0,6
44282,2,2508,2536,-28,0,448,0,6
44283,2,2243,2401,-158,0,432,0,6
44284,1,2400,2306,94,0,87,1,6
44285,2,2446,2557,-111,0,200,0,6
44286,2,2414,2380,34,0,305,0,6
44287,3,2480,2454,26,0,102,0,6
44288,1,2473,2441,32,0,40,0,6
44289,2,2436,2446,-10,0,301,0,6
44290,1,2410,2431,-21,0,200,0,6
44291,1,2446,2452,-6,0,43,0,6
44292,2,2480,2544,-64,0,321,0,6
44293,2,2416,2298,118,0,112,0,6
44294,2,2443,2415,28,0,45,0,6
44295,1,2250,2443,-193,0,17,1,6
44296,2,2476,2551,-75,0,242,1,6
44297,2,2381,2425,-44,0,101,0,6
44298,2,2479,2346,133,0,0,0,6
44299,1,2409,2281,128,0,484,0,6
44300,1,2452,2419,33,0,247,0,6
44301,3,2501,2531,-30,0,49,0,6
44302,1,2523,2494,29,0,310,0,6
44303,1,2523,2282,241,0,40,0,6
44304,1,2511,2388,123,0,365,0,6
44305,2,2375,2411,-36,0,247,0,6
44306,1,2495,2260,235,0,5,0,6
44307,1,2488,2256,232,0,58,1,6
44308,1,2422,2553,-131,0,119,0,6
44309,2,2326,2407,-81,0,100,1,6
44310,2,2386,2517,-131,0,242,0,6
44311,2,2480,2509,-29,0,112,0,6
44312,1,2409,2340,69,0,112,1,6
44313,2,2421,2393,28,0,304,0,6
44314,1,2586,2494,92,0,395,0,6
44315,2,2407,2355,52,0,143,1,6
44316,2,2408,2239,169,0,21,1,6
44317,1,2474,2430,44,0,411,0,6
44318,2,2200,2485,-285,0,112,0,6
44319,1,2436,2288,148,0,244,0,6
44320,1,2569,2564,5,0,270,1,6
44321,2,2375,2430,-55,0,4,0,6
44322,2,2533,2492,41,0,115,0,6
44323,2,2561,2483,78,0,455,1,6
44324,2,2577,2638,-61,0,195,0,6
44325,1,2475,2383,92,0,201,0,6
44327,2,2325,2549,-224,0,4,0,6
44328,2,2430,2435,-5,0,302,0,6
44329,1,2481,2485,-4,0,244,0,6
44330,2,2636,2605,31,0,463,0,6
44331,1,2488,2355,133,0,106,0,6
44332,1,2554,2378,176,0,302,0,6
44333,2,2366,2479,-113,0,256,1,6
44334,2,2436,2478,-42,0,267,0,6
44335,2,2445,2513,-68,0,442,0,6
44336,1,2414,2457,-43,0,127,0,6
44337,1,2403,2362,41,0,455,0,6
44338,2,2343,2437,-94,0,49,0,6
44339,1,2435,2445,-10,0,107,0,6
44340,1,2437,2334,103,0,46,0,6
44341,1,2602,2304,298,0,207,0,6
44342,1,2400,2438,-38,0,226,0,6
44343,1,2288,2414,-126,0,244,0,6
44344,2,2608,2632,-24,0,315,0,6
44345,1,2445,2451,-6,0,102,1,6
44346,2,2345,2525,-180,0,10,0,6
44347,1,2452,2431,21,0,130,0,6
44348,2,2541,2503,38,0,34,0,6
44349,2,2339,2404,-65,0,7,1,6
44350,1,2450,2421,29,0,247,0,6
44351,3,2507,2414,93,0,119,0,6
44352,2,2434,2480,-46,0,302,0,6
44353,2,2412,2442,-30,0,45,0,6
44354,1,2433,2347,86,0,415,0,6
44355,2,2421,2392,29,0,350,0,6
44356,2,2272,2401,-129,0,0,0,6
44357,2,2396,2490,-94,0,8,0,6
44358,2,2325,2471,-146,0,46,0,6
44359,1,2412,2265,147,0,141,1,6
44360,1,2417,2370,47,0,102,0,6
44361,1,2418,2339,79,0,31,0,6
44362,2,2501,2376,125,0,344,0,6
44363,2,2529,2530,-1,0,484,1,6
44364,2,2488,2590,-102,0,45,0,6
44365,2,2374,2450,-76,0,4,1,6
44366,2,2597,2412,185,4,312,0,13
44367,1,2471,2489,-18,0,256,1,6
44368,1,2470,2306,164,0,0,1,6
44369,1,2498,2475,23,0,260,0,6
44370,1,2422,2332,90,0,151,0,6
44371,1,2509,2535,-26,0,46,0,6
44372,1,2611,2630,-19,0,106,0,6
44373,2,2643,2573,70,0,125,0,6
44374,2,2469,2482,-13,0,128,1,6
44375,2,2384,2454,-70,0,105,0,6
44376,1,2487,2299,188,0,125,0,6
44377,2,2304,2439,-135,0,123,1,6
44378,1,2351,2492,-141,0,1,0,6
44379,2,2523,2275,248,0,4,0,6
44380,1,2436,2325,111,0,202,0,6
44381,1,2563,2225,338,0,306,0,6
44382,2,2480,2443,37,0,103,0,6
44383,1,2487,2541,-54,0,244,1,6
44384,2,2415,2363,52,0,305,0,6
44385,3,2425,2479,-54,0,4,0,6
44386,3,2499,2204,295,0,8,0,6
44387,2,2248,2400,-152,0,302,0,6
44388,2,2361,2406,-45,0,427,0,6
44389,1,2385,2416,-31,0,151,0,6
44390,1,2476,2316,160,0,42,0,8
44391,2,2267,2605,-338,0,457,0,6
44392,2,2425,2505,-80,0,40,1,6
44393,1,2415,2294,121,0,47,0,6
44394,1,2495,2391,104,0,483,0,6
44395,2,2378,2441,-63,0,122,1,6
44396,2,2384,2484,-100,0,300,0,6
44397,1,2594,2410,184,0,84,0,6
44398,1,2553,2314,239,0,120,1,6
44399,1,2431,2287,144,0,15,0,6
44400,1,2523,2361,162,0,121,0,6
44401,1,2426,2381,45,0,46,0,6
44402,1,2483,2362,121,0,45,0,6
44403,1,2504,2391,113,0,15,0,8
44404,2,2434,2315,119,0,107,0,6
44405,1,2506,2558,-52,0,304,1,6
44406,2,2416,2456,-40,0,127,1,6
44407,2,2234,2401,-167,0,241,0,6
44408,1,2484,2359,125,0,106,0,6
44409,2,2442,2339,103,0,200,1,6
44410,2,2613,2578,35,0,4,1,6
44411,1,2606,2434,172,0,311,0,6
44412,2,2364,2437,-73,0,110,1,6
44413,1,2449,2422,27,0,226,1,6
44414,3,2515,2544,-29,0,96,0,6
44415,1,2475,2453,22,0,182,0,6
44416,2,2603,2542,61,0,0,0,6
44417,2,2407,2264,143,0,45,1,6
44418,1,2528,2306,222,0,310,0,6
44419,2,2437,2494,-57,0,389,1,6
44420,1,2525,2259,266,0,113,0,6
44421,2,2490,2415,75,0,200,0,6
44422,2,2341,2527,-186,0,101,0,6
44423,3,2579,2636,-57,0,100,0,6
44424,2,2223,2564,-341,0,200,0,6
44425,1,2409,2504,-95,0,400,0,6
44426,2,2446,2452,-6,0,43,0,6
44427,1,2518,2429,89,0,420,0,6
44428,1,2459,2358,101,0,311,0,6
44429,1,2416,2303,113,0,112,1,6
44430,1,2441,2514,-73,0,46,0,6
44431,2,2305,2480,-175,0,57,0,6
44432,2,2471,2374,97,0,80,1,6
44433,2,2404,2256,148,0,8,0,6
44434,2,2485,2482,3,0,11,0,6
44435,1,2529,2515,14,0,34,1,6
44436,2,2376,2477,-101,0,300,0,6
44437,1,2403,2244,159,0,9,0,6
44438,1,2415,2309,106,0,103,0,6
44439,1,2406,2420,-14,0,49,0,6
44440,2,2624,2617,7,0,48,0,6
44441,3,2357,2494,-137,0,45,0,6
44442,2,2311,2429,-118,0,48,0,6
44443,2,2256,2495,-239,0,45,0,6
44444,1,2474,2523,-49,0,20,1,6
44445,3,2703,2490,213,0,142,0,6
44446,2,2469,2535,-66,0,211,0,6
44447,1,2298,2427,-129,0,113,0,6
44448,2,2431,2431,0,0,461,0,6
44449,1,2488,2324,164,0,455,1,6
44450,2,2431,2483,-52,0,295,0,6
44451,2,2450,2473,-23,0,246,1,6
44452,3,2339,2443,-104,0,343,0,6
44453,2,2325,2483,-158,0,106,0,6
44455,1,2488,2571,-83,0,1,1,6
44456,2,2215,2428,-213,0,453,0,6
44457,1,2497,2267,230,0,7,0,6
44458,1,2440,2500,-60,0,441,0,6
44459,1,2478,2426,52,0,46,1,6
44460,1,2418,2356,62,0,310,1,6
44461,2,2530,2410,120,0,121,1,6
44462,2,2402,2383,19,0,122,0,6
44463,1,2510,2421,89,0,123,0,6
44464,2,2229,2555,-326,0,43,0,6
44465,2,2556,2596,-40,0,100,0,6
44466,3,2448,2480,-32,0,103,0,6
44467,2,2481,2338,143,0,125,0,6
44468,1,2574,2534,40,0,33,1,6
44469,3,2487,2597,-110,0,380,0,6
44470,2,2440,2409,31,0,344,0,6
44471,2,2352,2426,-74,0,46,0,6
44472,2,2315,2409,-94,0,289,0,6
44473,2,2299,2446,-147,0,4,0,6
44474,2,2356,2488,-132,0,1,0,6
44475,1,2566,2222,344,0,21,0,6
44476,1,2461,2411,50,0,247,0,6
44477,1,2286,2425,-139,0,100,0,6
44478,2,2416,2454,-38,0,241,1,6
44479,2,2437,2531,-94,0,302,0,6
44480,3,2468,2459,9,0,190,0,6
44481,1,2549,2540,9,0,200,1,6
44482,2,2370,2433,-63,0,250,1,6
44483,3,2334,2419,-85,0,389,0,6
44484,1,2286,2507,-221,0,102,0,6
44485,2,2340,2401,-61,0,112,1,6
44486,2,2307,2450,-143,0,4,0,6
44487,3,2557,2394,163,0,120,0,6
44488,2,2463,2496,-33,0,220,1,6
44489,1,2623,2618,5,0,106,1,6
44490,3,2416,2487,-71,0,40,0,6
44491,2,2496,2490,6,0,327,1,6
44492,2,2401,2413,-12,0,130,0,6
44493,2,2354,2620,-266,0,153,0,6
44494,1,2486,2420,66,0,200,0,6
44495,1,2635,2580,55,0,123,0,6
44496,2,2440,2348,92,0,118,0,6
44497,2,2310,2522,-212,4,112,0,8
44498,1,2463,2418,45,0,476,0,6
44499,2,2272,2434,-162,0,45,0,6
44500,1,2611,2536,75,0,466,0,6
44501,1,2500,2315,185,0,313,0,6
44502,2,2335,2483,-148,0,133,1,6
44503,2,2381,2463,-82,0,224,0,6
44504,1,2433,2299,134,0,302,0,6
44505,2,2412,2479,-67,0,302,0,6
44506,2,2443,2294,149,0,140,1,6
44507,1,2406,2466,-60,0,127,1,6
44508,2,2439,2374,65,0,213,1,6
44509,3,2415,2326,89,0,7,0,6
44510,1,2314,2491,-177,0,112,0,6
44511,2,2388,2510,-122,0,45,0,6
44512,1,2458,2516,-58,0,121,1,6
44513,1,2373,2481,-108,0,225,0,6
44514,2,2270,2433,-163,0,45,0,6
44515,3,2252,2439,-187,4,140,0,13
44516,2,2388,2498,-110,0,277,1,6
44517,1,2441,2370,71,0,120,1,6
44518,2,2423,2333,90,0,240,1,6
44519,3,2418,2335,83,0,46,0,6
44520,3,2491,2434,57,0,302,0,6
44521,1,2493,2700,-207,0,193,0,6
44522,1,2542,2396,146,0,113,0,6
44523,2,2400,2268,132,0,8,1,6
44524,2,2474,2340,134,0,207,1,6
44525,2,2329,2402,-73,0,40,0,8
44526,1,2431,2211,220,0,101,1,6
44527,1,2596,2489,107,0,462,0,6
44528,2,2444,2551,-107,0,107,1,6
44529,1,2492,2352,140,0,106,0,6
44530,2,2496,2483,13,0,1,0,6
44531,2,2396,2503,-107,0,102,0,6
44532,3,2312,2554,-242,0,201,0,6
44533,2,2385,2422,-37,0,41,0,6
44534,1,2407,2290,117,0,21,0,6
44535,2,2417,2514,-97,0,40,0,6
44536,2,2351,2428,-77,0,122,0,6
44537,1,2468,2522,-54,0,101,0,6
44538,2,2576,2640,-64,0,245,0,6
44539,2,2480,2448,32,0,107,0,6
44540,1,2514,2384,130,0,302,1,6
44541,2,2348,2515,-167,0,311,1,6
44542,2,2544,2523,21,0,30,0,6
44543,2,2499,2415,84,0,201,0,6
44544,3,2459,2468,-9,0,305,0,6
44545,1,2564,2440,124,0,317,0,6
44546,2,2412,2220,192,0,119,0,6
44547,2,2224,2507,-283,0,46,0,6
44548,1,2346,2419,-73,0,363,0,6
44549,1,2303,2434,-131,0,4,0,6
44550,1,2454,2359,95,0,1,1,6
44551,2,2356,2485,-129,0,40,0,6
44552,1,2502,2513,-11,0,260,0,6
44553,1,2459,2417,42,0,7,0,6
44554,2,2483,2318,165,0,80,0,6
44555,1,2494,2374,120,0,201,0,6
44556,1,2622,2555,67,0,190,1,6
44557,2,2413,2447,-34,0,122,0,6
44558,2,2286,2411,-125,0,0,0,6
44559,2,2423,2536,-113,0,133,0,6
44560,1,2437,2531,-94,0,177,0,6
44561,3,2393,2437,-44,0,0,0,6
44562,1,2438,2347,91,0,320,1,6
44563,1,2435,2490,-55,0,337,1,6
44564,2,2412,2459,-47,0,462,0,6
44565,1,2485,2600,-115,0,172,0,6
44566,2,2295,2422,-127,0,326,0,6
44567,2,2500,2464,36,0,107,0,6
44568,3,2341,2516,-175,0,337,0,6
44569,2,2437,2468,-31,0,28,1,6
44570,1,2492,2408,84,0,344,0,6
44571,1,2484,2490,-6,0,315,0,6
44572,1,2664,2489,175,0,140,1,6
44573,1,2379,2427,-48,0,106,1,6
44574,2,2488,2426,62,0,440,0,6
44575,2,2645,2571,74,0,460,0,6
44576,1,2442,2406,36,0,3,0,6
44577,1,2638,2603,35,0,306,0,6
44578,1,2691,2502,189,0,133,0,6
44580,3,2366,2446,-80,0,424,0,6
44581,2,2274,2452,-178,0,120,0,6
44582,2,2597,2732,-135,0,88,0,6
44583,2,2365,2474,-109,0,406,0,6
44584,3,2468,2459,9,0,190,0,6
44585,1,2527,2516,11,0,101,0,6
44586,1,2414,2237,177,0,0,0,8
44587,2,2361,2412,-51,0,338,0,6
44588,1,2351,2475,-124,0,241,0,6
44589,2,2349,2495,-146,0,1,1,6
44590,2,2207,2434,-227,0,453,0,6
44591,3,2444,2615,-171,0,106,0,6
44592,1,2458,2427,31,0,1,0,6
44593,2,2380,2466,-86,0,477,0,6
44594,1,2496,2376,120,0,118,0,6
44595,2,2290,2440,-150,0,8,0,6
44596,2,2428,2353,75,0,153,0,6
44597,2,2489,2475,14,0,311,0,6
44598,1,2525,2484,41,0,311,0,6
44599,1,2478,2465,13,0,193,0,6
44600,3,2360,2490,-130,0,317,0,6
44601,2,2267,2439,-172,4,202,0,13
44602,2,2380,2517,-137,0,45,0,6
44603,2,2273,2410,-137,0,6,0,6
44604,3,2401,2509,-108,0,15,0,6
44605,2,2593,2662,-69,0,429,0,6
44606,2,2417,2529,-112,0,196,0,6
44607,1,2464,2407,57,0,115,1,6
44608,2,2481,2477,4,0,113,0,6
44609,2,2507,2508,-1,0,112,0,6
44611,3,2521,2330,191,0,302,0,6
44612,1,2492,2470,22,0,278,0,6
44613,1,2444,2271,173,0,100,0,6
44614,1,2550,2627,-77,0,0,1,6
44615,1,2402,2286,116,0,132,0,6
44616,2,2437,2496,-59,0,468,0,6
44617,1,2403,2425,-22,0,40,1,6
44619,2,2425,2359,66,0,122,0,6
44620,2,2598,2643,-45,0,300,0,6
44621,1,2469,2328,141,0,337,0,6
44622,2,2517,2393,124,0,101,0,6
44623,2,2578,2473,105,0,253,1,6
44624,2,2343,2442,-99,0,102,0,6
44625,1,2273,2431,-158,0,133,0,6
44626,2,2434,2408,26,0,102,0,6
44627,1,2402,2328,74,0,154,0,6
44628,1,2468,2372,96,0,45,1,6
44629,2,2513,2492,21,0,385,1,6
44630,1,2618,2342,276,0,209,0,8
44631,2,2325,2435,-110,4,46,0,13
44632,2,2301,2528,-227,0,131,1,6
44633,2,2510,2532,-22,0,256,0,6
44634,2,2227,2553,-326,0,43,0,6
44636,1,2555,2640,-85,0,122,0,6
44637,1,2508,2340,168,0,5,0,6
44638,2,2220,2403,-183,0,4,1,6
44639,1,2436,2203,233,0,101,1,6
44640,1,2486,2513,-27,0,110,0,6
44641,2,2405,2201,204,0,200,0,6
44642,1,2483,2370,113,0,110,0,6
44643,1,2360,2447,-87,0,432,1,6
44644,2,2501,2612,-111,0,106,1,6
44645,2,2499,2694,-195,0,292,1,6
44646,2,2452,2447,5,0,440,0,6
44647,1,2437,2249,188,0,277,0,8
44648,2,2422,2313,109,0,112,0,6
44649,2,2211,2464,-253,0,106,1,6
44650,2,2256,2422,-166,0,4,0,8
44651,1,2483,2389,94,0,31,0,6
44652,2,2481,2509,-28,0,4,1,6
44653,2,2363,2400,-37,0,103,0,6
44654,1,2216,2400,-184,0,122,1,6
44655,2,2479,2475,4,0,1,0,6
44656,1,2335,2438,-103,0,40,1,6
44657,3,2330,2405,-75,0,150,0,6
44658,1,2538,2505,33,0,101,0,6
44659,2,2421,2472,-51,0,101,0,6
44660,1,2499,2345,154,0,106,0,6
44661,1,2529,2533,-4,0,203,1,6
44662,3,2370,2428,-58,0,153,0,6
44663,2,2421,2370,51,0,110,0,6
44664,1,2801,2648,153,0,190,0,6
44665,2,2537,2468,69,0,83,0,6
44666,1,2427,2374,53,0,140,0,6
44667,3,2468,2367,101,0,267,0,6
44668,2,2593,2603,-10,0,45,1,6
44669,2,2412,2402,10,0,245,0,6
44670,3,2421,2442,-21,4,200,0,13
44671,1,2469,2423,46,0,133,0,6
44672,2,2260,2415,-155,0,136,0,6
44673,1,2446,2356,90,0,42,0,6
44674,2,2230,2541,-311,0,35,0,6
44675,1,2272,2415,-143,0,200,0,6
44676,1,2472,2386,86,0,84,0,6
44677,2,2465,2498,-33,0,256,0,6
44678,1,2401,2371,30,0,110,0,6
44679,2,2446,2419,27,0,454,0,6
44680,1,2404,2377,27,0,45,0,6
44681,1,2417,2320,97,0,447,0,6
44682,2,2473,2509,-36,0,1,0,6
44683,1,2321,2446,-125,0,40,0,6
44684,2,2401,2401,0,0,0,0,6
44685,1,2578,2589,-11,0,405,1,6
44686,2,2348,2479,-131,0,43,1,6
44687,1,2667,2633,34,0,106,0,6
44688,2,2378,2487,-109,0,45,0,6
44689,2,2369,2432,-63,0,264,0,6
44690,2,2234,2512,-278,0,303,0,6
44691,2,2456,2368,88,0,334,0,6
44692,2,2324,2503,-179,0,256,0,6
44693,1,2620,2481,139,0,245,0,6
44694,2,2407,2364,43,0,45,0,6
44695,2,2616,2557,59,0,4,1,6
44696,1,2554,2406,148,0,120,0,6
44697,3,2488,2554,-66,0,49,0,6
44698,2,2385,2419,-34,0,57,0,6
44699,2,2227,2484,-257,0,112,0,8
44700,2,2419,2477,-58,0,307,1,6
44701,2,2333,2416,-83,0,106,0,6
44702,1,2431,2392,39,0,106,0,6
44703,1,2452,2409,43,0,312,0,6
44704,1,2400,2263,137,4,203,0,13
44705,2,2483,2420,63,0,122,1,6
44706,1,2532,2500,32,0,103,0,6
44707,1,2475,2585,-110,0,178,0,6
44708,1,2360,2412,-52,0,375,0,6
44709,2,2674,2474,200,0,15,0,6
44710,1,2425,2356,69,0,202,0,6
44711,2,2382,2460,-78,0,269,0,6
44712,2,2316,2421,-105,0,311,1,6
44713,3,2342,2502,-160,0,1,0,6
44714,1,2492,2440,52,0,46,0,6
44715,1,2507,2467,40,0,106,0,6
44716,2,2418,2444,-26,0,46,0,6
44717,2,2500,2543,-43,0,256,0,6
44718,1,2407,2310,97,0,112,0,6
44719,1,2354,2440,-86,0,5,0,6
44720,1,2616,2474,142,0,463,0,6
44721,3,2294,2450,-156,0,190,0,6
44722,1,2515,2476,39,0,4,1,6
44723,1,2477,2281,196,0,392,0,6
44724,2,2263,2466,-203,0,40,1,6
44725,3,2369,2466,-97,0,305,0,6
44726,1,2425,2430,-5,0,40,0,6
44727,1,2533,2384,149,0,418,0,6
44728,2,2437,2366,71,0,415,1,6
44729,1,2514,2403,111,0,8,0,6
44730,2,2330,2515,-185,0,120,0,6
44731,1,2621,2337,284,0,154,0,8
44732,1,2487,2271,216,0,405,1,8
44733,2,2285,2413,-128,0,113,0,6
44734,2,2530,2562,-32,0,45,0,6
44735,1,2441,2575,-134,4,45,0,13
44736,3,2579,2393,186,0,245,0,6
44737,1,2408,2407,1,0,398,0,6
44738,2,2524,2535,-11,0,302,0,6
44739,1,2697,2497,200,0,260,0,6
44740,1,2395,2468,-73,0,0,0,6
44741,3,2452,2388,64,0,158,0,6
44742,1,2403,2409,-6,0,14,0,6
44743,2,2477,2475,2,0,105,0,6
44744,2,2356,2485,-129,0,247,0,6
44745,3,2608,2623,-15,0,45,0,6
44746,2,2628,2645,-17,0,331,0,6
44747,2,2407,2395,12,0,40,1,6
44748,2,2282,2449,-167,0,4,0,6
44749,1,2443,2477,-34,0,3,0,8
44750,1,2391,2512,-121,0,112,1,6
44751,2,2498,2406,92,0,338,0,6
44752,1,2457,2464,-7,0,253,0,6
44753,1,2493,2377,116,0,101,0,6
44754,1,2531,2257,274,0,122,0,6
44755,2,2470,2298,172,0,459,0,6
44756,1,2435,2497,-62,0,454,1,6
44757,2,2350,2518,-168,0,104,1,6
44758,2,2438,2538,-100,0,40,1,6
44759,2,2419,2417,2,0,37,0,6
44760,3,2420,2404,16,0,210,0,6
44761,2,2491,2599,-108,0,277,0,6
44762,2,2399,2558,-159,0,200,0,6
44763,2,2374,2489,-115,0,41,0,6
44764,1,2564,2610,-46,0,0,0,6
44765,1,2384,2506,-122,0,463,0,6
44766,2,2583,2553,30,0,50,1,6
44767,2,2365,2432,-67,0,184,0,6
44768,2,2581,2699,-118,0,344,0,6
44769,1,2449,2414,35,0,13,1,6
44770,2,2483,2665,-182,0,4,1,6
44771,1,2424,2312,112,0,48,1,6
44772,1,2309,2403,-94,0,43,0,6
44773,2,2272,2415,-143,0,6,0,6
44774,1,2430,2380,50,0,123,0,6
44775,2,2495,2471,24,0,127,1,6
44776,2,2254,2425,-171,0,200,0,6
44777,2,2409,2263,146,0,15,1,6
44778,1,2537,2565,-28,0,424,0,6
44779,1,2548,2495,53,0,101,0,6
44780,3,2576,2529,47,0,42,0,6
44781,1,2483,2488,-5,0,245,0,6
44782,2,2500,2344,156,0,106,1,6
44783,2,2448,2493,-45,0,115,0,6
44784,2,2313,2461,-148,0,52,1,6
44785,1,2440,2481,-41,0,440,1,6
44786,2,2471,2520,-49,0,4,0,6
44787,1,2402,2459,-57,0,8,0,6
44788,2,2396,2577,-181,0,153,0,6
44789,1,2548,2525,23,0,200,0,6
44790,1,2469,2347,122,0,1,1,6
44791,3,2521,2413,108,0,4,0,6
44792,2,2438,2374,64,0,85,0,6
44793,1,2405,2326,79,0,0,1,6
44794,2,2507,2370,137,0,315,0,6
44795,1,2651,2623,28,0,45,0,6
44796,2,2401,2414,-13,0,112,0,6
44797,2,2422,2258,164,0,101,0,8
44798,3,2414,2299,115,0,112,0,6
44799,1,2519,2226,293,0,302,0,6
44800,1,2541,2412,129,0,242,0,6
44801,2,2445,2278,167,0,120,0,6
44802,2,2373,2516,-143,0,260,0,6
44803,2,2413,2603,-190,0,50,1,6
44804,2,2518,2498,20,0,103,0,6
44805,1,2567,2623,-56,0,15,0,6
44806,1,2373,2522,-149,0,115,1,6
44807,1,2580,2393,187,0,223,0,6
44808,1,2458,2463,-5,0,42,0,6
44809,2,2486,2342,144,0,345,0,6
44810,3,2288,2471,-183,0,197,0,8
44811,1,2417,2320,97,0,260,1,6
44812,2,2314,2408,-94,0,40,1,6
44813,2,2371,2465,-94,0,301,1,6
44814,3,2703,2577,126,0,172,0,6
44815,1,2352,2451,-99,0,1,0,6
44816,2,2428,2269,159,0,267,0,6
44817,2,2401,2401,0,0,0,0,6
44818,1,2547,2571,-24,0,460,1,6
44819,1,2436,2380,56,0,275,0,6
44820,1,2405,2499,-94,0,49,1,6
44821,2,2418,2381,37,0,4,1,6
44822,3,2444,2613,-169,0,40,0,6
44823,1,2401,2268,133,0,312,0,6
44824,2,2312,2447,-135,0,311,1,6
44825,1,2617,2656,-39,0,322,1,6
44826,2,2465,2483,-18,0,1,0,6
44827,2,2377,2458,-81,0,100,0,6
44828,1,2490,2442,48,0,43,0,6
44829,2,2435,2487,-52,0,17,0,6
44830,2,2526,2428,98,0,151,0,6
44831,2,2434,2603,-169,0,331,0,6
44832,1,2483,2419,64,0,2,0,6
44833,1,2520,2553,-33,0,300,0,6
44834,1,2539,2420,119,0,410,0,6
44835,1,2668,2480,188,0,0,0,6
44836,1,2428,2287,141,0,0,1,6
44837,2,2519,2537,-18,0,409,1,6
44838,1,2672,2560,112,0,152,0,6
44839,3,2392,2601,-209,0,320,0,6
44840,2,2477,2489,-12,0,132,0,6
44841,2,2525,2466,59,0,100,0,6
44842,2,2401,2409,-8,0,13,0,6
44843,2,2559,2544,15,0,107,0,6
44844,2,2365,2406,-41,0,176,0,6
44845,2,2404,2401,3,0,311,0,6
44846,1,2420,2396,24,0,46,0,6
44847,2,2283,2444,-161,0,106,0,6
44848,1,2350,2409,-59,0,0,0,6
44849,2,2267,2443,-176,0,130,0,8
44850,2,2390,2487,-97,0,210,0,6
44851,2,2498,2378,120,0,311,0,6
44852,2,2495,2437,58,0,46,0,6
44853,2,2415,2360,55,0,106,1,6
44854,2,2409,2545,-136,0,301,0,6
44855,1,2485,2271,214,2,269,0,23
44856,2,2270,2435,-165,0,40,1,6
44857,1,2609,2577,32,0,28,0,6
44858,1,2506,2472,34,0,301,1,6
44859,1,2490,2310,180,0,255,1,6
44860,1,2490,2279,211,0,81,1,6
44861,2,2583,2530,53,0,125,0,6
44862,2,2335,2512,-177,0,46,0,6
44863,1,2286,2410,-124,0,45,1,6
44864,1,2457,2367,90,0,205,0,6
44865,1,2464,2420,44,0,143,0,6
44866,1,2447,2374,73,0,57,0,6
44867,2,2606,2645,-39,0,9,0,6
44868,2,2407,2396,11,0,40,1,6
44869,2,2255,2461,-206,0,205,0,6
44870,2,2414,2495,-81,0,123,1,6
44871,2,2473,2518,-45,0,4,0,6
44872,2,2556,2417,139,0,303,0,6
44873,1,2469,2366,103,0,267,0,6
44874,2,2617,2521,96,0,200,0,6
44875,2,2494,2471,23,0,127,0,6
44876,3,2442,2384,58,4,201,0,13
44877,2,2579,2701,-122,0,344,0,6
44878,2,2307,2468,-161,0,100,0,8
44879,2,2496,2469,27,0,248,1,6
44880,2,2492,2430,62,0,106,0,6
44881,2,2544,2611,-67,0,110,0,6
44882,1,2565,2516,49,0,241,1,6
44883,2,2310,2431,-121,0,343,0,6
44884,3,2578,2553,25,0,112,0,6
44885,2,2491,2413,78,0,106,1,6
44886,1,2469,2307,162,0,248,0,8
44887,1,2412,2465,-53,0,46,1,6
44888,1,2650,2624,26,0,45,0,6
44889,1,2547,2526,21,0,207,0,6
44890,1,2388,2472,-84,0,1,0,6
44891,1,2515,2477,38,0,241,0,6
44892,2,2431,2303,128,0,0,1,6
44893,1,2283,2454,-171,0,4,1,6
44894,2,2671,2573,98,0,79,1,6
44895,2,2421,2499,-78,0,310,0,6
44896,1,2390,2425,-35,0,112,0,6
44897,1,2309,2420,-111,0,463,0,6
44898,2,2562,2489,73,0,140,1,6
44899,2,2515,2598,-83,0,20,0,6
44900,2,2290,2543,-253,0,115,0,6
44901,2,2328,2490,-162,0,41,0,6
44902,2,2571,2615,-44,0,41,0,6
44903,1,2386,2492,-106,0,300,0,6
44904,2,2575,2395,180,0,331,0,6
44905,1,2624,2370,254,0,57,0,8
44906,3,2548,2405,143,0,133,0,6
44907,1,2705,2462,243,0,132,1,6
44908,1,2557,2289,268,4,332,1,13
44909,2,2443,2435,8,0,200,1,6
44910,3,2452,2431,21,0,41,0,6
44911,1,2334,2401,-67,0,216,0,6
44912,1,2276,2404,-128,0,13,0,6
44913,3,2450,2392,58,0,200,0,6
44914,2,2408,2492,-84,0,107,0,6
44915,3,2519,2388,131,0,105,0,6
44916,1,2400,2312,88,0,112,0,6
44917,3,2550,2553,-3,0,13,0,6
44918,2,2399,2436,-37,0,173,0,6
44919,2,2367,2429,-62,0,1,0,6
44920,2,2523,2468,55,0,40,0,6
44921,1,2532,2527,5,0,46,0,6
44922,1,2493,2386,107,0,245,0,6
44923,2,2488,2353,135,0,241,0,6
44924,2,2462,2480,-18,0,36,1,6
44925,1,2411,2312,99,0,40,0,8
44926,1,2477,2465,12,0,241,0,6
44927,3,2395,2403,-8,0,1,0,6
44928,1,2448,2264,184,0,44,0,8
44929,1,2618,2655,-37,0,311,0,6
44930,1,2402,2401,1,0,0,0,6
44931,2,2307,2485,-178,0,103,0,6
44932,2,2494,2379,115,0,455,0,6
44933,2,2284,2437,-153,0,0,0,6
44934,2,2601,2570,31,0,4,0,6
44935,1,2656,2499,157,0,190,0,6
44936,1,2521,2552,-31,0,300,0,6
44937,1,2615,2537,78,0,135,1,6
44938,3,2476,2404,72,0,256,0,6
44939,2,2534,2481,53,0,301,0,6
44940,1,2420,2429,-9,0,5,0,6
44941,2,2485,2367,118,0,331,0,6
44942,2,2433,2440,-7,0,101,0,6
44943,2,2570,2664,-94,0,0,0,6
44944,2,2489,2620,-131,0,107,0,6
44945,3,2566,2554,12,0,310,0,6
44946,1,2649,2625,24,0,202,0,6
44947,2,2437,2419,18,0,200,1,6
44948,2,2226,2429,-203,0,117,0,6
44949,2,2362,2424,-62,0,1,0,6
44950,3,2445,2520,-75,0,121,0,6
44951,2,2419,2534,-115,0,40,0,6
44952,1,2542,2367,175,0,315,0,6
44953,1,2484,2483,1,0,127,1,6
44954,1,2459,2352,107,0,40,0,6
44955,2,2668,2566,102,0,4,0,6
44956,1,2400,2397,3,0,45,0,6
44957,1,2496,2415,81,0,304,1,6
44958,1,2538,2443,95,0,28,0,6
44959,1,2407,2546,-139,0,301,1,6
44960,1,2425,2540,-115,0,122,0,6
44961,2,2489,2393,96,0,101,0,6
44962,2,2339,2437,-98,0,121,0,6
44963,1,2441,2243,198,4,45,0,13
44964,1,2238,2490,-252,0,112,0,8
44965,2,2460,2537,-77,0,404,0,6
44966,1,2475,2517,-42,0,5,0,6
44967,2,2264,2403,-139,0,302,0,6
44968,2,2449,2274,175,0,102,1,6
44969,2,2324,2472,-148,0,107,1,8
44970,2,2637,2708,-71,0,190,1,6
44971,1,2446,2393,53,0,202,1,6
44972,1,2546,2417,129,0,129,1,6
44973,2,2442,2318,124,0,192,0,6
44974,1,2487,2456,31,0,62,1,6
44975,1,2447,2527,-80,0,306,0,6
44976,2,2395,2428,-33,0,1,0,6
44977,2,2485,2480,5,0,347,0,6
44978,2,2540,2624,-84,0,107,0,6
44979,2,2361,2497,-136,0,302,1,6
44980,2,2528,2464,64,0,122,0,6
44981,1,2497,2486,11,0,110,1,6
44982,2,2429,2451,-22,0,190,0,6
44983,2,2396,2413,-17,0,46,0,6
44984,2,2532,2386,146,0,386,0,6
44985,1,2504,2353,151,0,27,0,6
44986,1,2454,2359,95,0,108,1,6
44987,1,2542,2382,160,0,36,1,6
44988,2,2439,2431,8,0,262,0,6
44989,2,2431,2357,74,0,40,0,6
44990,1,2620,2654,-34,0,331,0,6
44991,1,2553,2550,3,0,105,0,6
44992,2,2423,2485,-62,0,133,0,6
44993,1,2441,2394,47,0,409,0,6
44994,1,2405,2336,69,0,158,0,6
44995,1,2321,2475,-154,0,301,0,6
44996,2,2352,2402,-50,0,49,0,6
44997,1,2437,2418,19,0,136,0,6
44998,2,2456,2477,-21,0,453,0,6
44999,2,2342,2463,-121,0,241,0,6
45000,1,2486,2480,6,0,253,0,6
45001,1,2620,2442,178,0,190,0,6
45002,2,2603,2524,79,0,202,0,6
45003,1,2394,2554,-160,0,128,0,6
45004,1,2519,2447,72,0,260,1,6
45005,1,2366,2406,-40,0,113,0,6
45006,3,2390,2431,-41,0,41,0,6
45007,1,2554,2577,-23,0,44,0,6
45008,1,2661,2501,160,0,15,1,6
45009,1,2510,2481,29,0,4,0,6
45010,2,2391,2406,-15,0,112,0,6
45011,3,2327,2410,-83,0,300,0,6
45012,1,2477,2425,52,0,210,0,6
45013,2,2457,2424,33,0,302,0,6
45014,2,2466,2357,109,0,112,0,6
45015,1,2454,2287,167,0,50,1,6
45016,2,2548,2490,58,0,101,1,6
45017,1,2482,2359,123,0,46,1,6
45018,1,2261,2453,-192,0,120,0,8
45019,1,2417,2306,111,0,106,0,6
45020,1,2400,2286,114,0,244,0,6
45021,2,2380,2481,-101,0,102,0,6
45022,1,2304,2451,-147,0,176,1,6
45023,1,2433,2493,-60,0,8,0,6
45024,2,2437,2375,62,0,142,1,6
45025,1,2712,2595,117,0,113,0,6
45026,1,2628,2534,94,0,13,0,6
45027,3,2467,2388,79,0,45,0,6
45028,1,2451,2248,203,0,107,0,6
45029,2,2481,2323,158,0,453,0,8
45030,1,2496,2399,97,0,8,1,6
45031,1,2520,2461,59,0,0,0,6
45032,1,2418,2360,58,0,141,0,6
45033,2,2475,2364,111,0,15,0,6
45034,2,2531,2358,173,0,52,0,6
45035,1,2651,2596,55,0,241,0,6
45036,1,2507,2428,79,0,80,0,6
45037,2,2439,2623,-184,0,112,0,6
45038,2,2417,2571,-154,0,102,0,6
45039,1,2413,2364,49,0,106,0,6
45040,1,2300,2415,-115,0,201,1,8
45041,2,2419,2404,15,0,42,0,6
45042,1,2481,2410,71,0,334,0,6
45043,3,2560,2574,-14,0,46,0,6
45044,2,2474,2492,-18,0,131,0,6
45045,2,2400,2331,69,0,4,0,6
45046,2,2372,2545,-173,0,134,0,6
45047,1,2406,2257,149,0,104,0,6
45048,1,2392,2418,-26,0,426,0,6
45049,1,2379,2490,-111,0,130,1,6
45050,1,2420,2482,-62,0,49,1,6
45051,1,2557,2453,104,0,35,0,6
45052,1,2476,2516,-40,0,4,1,6
45053,1,2409,2376,33,0,40,0,6
45054,2,2446,2660,-214,0,341,0,6
45055,1,2398,2412,-14,0,466,0,6
45056,3,2560,2426,134,0,106,0,6
45057,1,2497,2469,28,0,152,0,6
45058,2,2547,2365,182,0,112,0,6
45059,1,2546,2375,171,0,122,0,6
45060,1,2442,2424,18,0,245,1,6
45061,1,2486,2474,12,0,102,0,6
45062,1,2359,2418,-59,0,1,0,6
45063,2,2427,2523,-96,0,218,1,6
45064,1,2471,2246,225,0,5,0,6
45065,1,2628,2301,327,0,107,0,8
45066,2,2282,2520,-238,0,101,0,6
45067,1,2452,2459,-7,0,44,0,6
45068,2,2497,2525,-28,0,241,0,6
45069,1,2470,2209,261,0,80,0,6
45070,1,2450,2341,109,0,241,0,6
45071,3,2441,2296,145,0,409,0,6
45072,3,2406,2236,170,0,123,0,6
45073,2,2390,2421,-31,0,305,0,6
45074,1,2525,2716,-191,0,300,0,6
45075,1,2672,2485,187,0,115,0,6
45076,2,2355,2486,-131,0,485,1,6
45077,2,2414,2528,-114,0,100,0,6
45078,1,2423,2290,133,0,120,0,6
45079,1,2591,2402,189,0,34,0,6
45080,2,2255,2433,-178,0,1,1,6
45081,1,2497,2486,11,0,269,0,6
45082,3,2523,2544,-21,0,405,0,6
45083,2,2284,2424,-140,0,454,0,6
45084,1,2440,2448,-8,0,5,0,6
45085,1,2466,2312,154,0,45,0,6
45086,1,2389,2443,-54,0,312,0,6
45087,2,2522,2282,240,0,152,0,6
45088,1,2436,2285,151,0,120,0,6
45089,1,2390,2411,-21,0,306,0,6
45090,2,2372,2468,-96,0,46,0,6
45091,1,2309,2430,-121,0,152,1,6
45092,2,2355,2454,-99,0,219,0,6
45093,1,2656,2524,132,0,43,0,6
45094,1,2359,2512,-153,0,415,0,6
45095,1,2366,2472,-106,0,1,0,6
45096,2,2413,2316,97,0,42,1,6
45097,1,2573,2538,35,0,228,1,6
45098,2,2371,2414,-43,0,7,1,6
45099,1,2412,2255,157,0,133,1,6
45100,1,2574,2413,161,0,30,0,6
45101,2,2393,2477,-84,0,4,0,6
45102,1,2559,2420,139,0,7,0,6
45103,2,2338,2404,-66,0,143,1,6
45104,2,2440,2549,-109,0,128,0,6
45105,2,2406,2309,97,0,300,0,6
45106,3,2395,2500,-105,0,45,0,6
45107,2,2389,2401,-12,0,10,0,6
45108,1,2473,2631,-158,0,459,0,8
45109,1,2410,2449,-39,0,106,0,6
45110,1,2496,2445,51,0,110,0,6
45111,1,2386,2538,-152,0,45,0,6
45112,2,2476,2427,49,0,210,0,6
45113,2,2480,2511,-31,0,398,0,6
45114,2,2509,2482,27,0,106,1,6
45115,1,2381,2557,-176,0,40,0,6
45116,1,2423,2275,148,0,177,1,6
45117,1,2373,2453,-80,0,46,0,6
45118,1,2446,2410,36,0,1,1,6
45119,1,2456,2463,-7,0,427,0,6
45120,2,2482,2491,-9,0,409,0,6
45121,1,2520,2660,-140,0,8,0,6
45122,2,2291,2468,-177,0,302,0,6
45123,2,2210,2419,-209,0,101,0,6
45124,1,2419,2372,47,0,62,0,6
45125,2,2251,2406,-155,4,40,0,13
45126,3,2576,2560,16,0,101,0,6
45127,2,2410,2303,107,0,200,0,6
45128,2,2431,2427,4,0,80,1,6
45129,1,2451,2469,-18,0,107,0,6
45130,2,2534,2410,124,0,40,0,6
45131,1,2594,2492,102,0,1,0,6
45132,2,2291,2513,-222,0,308,1,6
45133,1,2458,2454,4,0,484,0,6
45134,1,2337,2428,-91,0,152,0,6
45135,2,2280,2402,-122,0,4,0,6
45136,2,2578,2488,90,0,45,0,6
45137,2,2490,2351,139,0,180,0,6
45138,1,2444,2386,58,0,380,0,6
45139,2,2708,2528,180,0,138,0,6
45140,1,2421,2351,70,0,123,0,6
45141,2,2443,2446,-3,0,25,0,6
45142,1,2591,2523,68,0,202,1,6
45143,1,2446,2297,149,0,101,0,6
45144,1,2458,2548,-90,0,120,1,6
45145,1,2364,2477,-113,0,4,1,6
45146,2,2364,2497,-133,0,2,0,6
45147,1,2380,2498,-118,0,43,1,6
45148,2,2549,2390,159,0,300,1,6
45149,1,2663,2416,247,0,141,0,6
45151,2,2472,2368,104,0,15,1,6
45152,1,2352,2415,-63,0,426,1,6
45153,1,2439,2289,150,0,102,1,6
45154,2,2408,2374,34,0,302,0,8
45155,2,2652,2528,124,0,141,0,6
45156,3,2489,2518,-29,0,200,0,6
45157,1,2247,2436,-189,0,117,1,6
45158,1,2334,2465,-131,0,118,0,6
45159,1,2475,2325,150,0,403,0,6
45160,2,2443,2416,27,0,121,0,6
45161,1,2370,2406,-36,0,103,1,6
45162,2,2516,2422,94,0,17,0,6
45163,2,2543,2598,-55,0,45,0,6
45164,2,2416,2562,-146,0,414,0,6
45165,2,2601,2579,22,0,33,0,6
45166,2,2478,2336,142,0,140,1,6
45167,2,2450,2276,174,0,112,0,6
45168,3,2334,2481,-147,0,436,0,8
45169,1,2648,2675,-27,0,325,0,6
45170,1,2433,2469,-36,0,48,1,6
45171,1,2436,2374,62,0,106,1,6
45172,1,2463,2457,6,0,44,0,6
45173,1,2419,2366,53,0,278,0,6
45174,3,2498,2397,101,0,4,0,6
45175,2,2553,2403,150,0,107,1,6
45176,2,2464,2394,70,0,70,0,6
45177,1,2523,2528,-5,0,311,0,6
45178,1,2449,2276,173,0,20,1,8
45179,1,2448,2418,30,0,40,1,6
45180,1,2489,2503,-14,0,4,1,6
45181,2,2329,2424,-95,0,230,0,6
45182,2,2346,2425,-79,0,180,0,6
45183,2,2505,2452,53,0,128,0,6
45184,1,2282,2427,-145,0,120,0,6
45185,2,2333,2482,-149,0,236,1,6
45186,2,2452,2469,-17,0,54,0,6
45187,2,2536,2699,-163,0,180,1,6
45188,2,2326,2437,-111,0,100,0,6
45189,1,2561,2586,-25,0,4,1,6
45190,1,2504,2410,94,0,40,0,6
45191,1,2495,2571,-76,0,118,1,6
45192,2,2325,2462,-137,0,201,1,6
45193,1,2516,2289,227,0,110,1,6
45194,2,2428,2399,29,0,345,1,6
45195,1,2502,2339,163,0,241,1,6
45196,1,2408,2303,105,0,106,0,6
45197,2,2544,2509,35,0,113,0,8
45198,2,2433,2501,-68,0,120,0,6
45199,1,2491,2388,103,0,112,0,6
45200,1,2436,2376,60,0,207,0,6
45201,1,2458,2332,126,0,30,0,6
45202,1,2519,2452,67,0,41,0,6
45203,1,2500,2344,156,0,240,0,6
45204,2,2311,2417,-106,0,277,0,6
45205,1,2431,2210,221,0,6,0,6
45206,2,2387,2401,-14,0,4,0,6
45207,2,2603,2541,62,0,13,0,6
45208,2,2541,2469,72,0,41,0,6
45209,1,2622,2374,248,0,409,1,8
45210,2,2299,2410,-111,4,112,0,13
45211,1,2421,2430,-9,0,431,1,6
45212,2,2518,2465,53,0,241,0,6
45213,1,2430,2342,88,0,123,0,6
45214,1,2490,2360,130,0,200,0,6
45215,2,2405,2452,-47,0,113,1,6
45216,2,2480,2509,-29,0,331,1,6
45217,2,2569,2561,8,0,101,0,6
45218,2,2375,2422,-47,0,302,0,6
45219,2,2457,2408,49,0,151,1,6
45220,2,2382,2425,-43,0,241,0,6
45221,1,2595,2534,61,0,46,0,6
45222,1,2506,2442,64,0,400,0,6
45223,1,2415,2342,73,0,163,0,6
45224,1,2441,2281,160,0,1,0,6
45225,1,2411,2285,126,0,110,0,6
45226,1,2463,2440,23,0,210,0,6
45227,1,2457,2359,98,0,300,0,6
45228,1,2586,2669,-83,0,123,0,6
45229,2,2401,2351,50,0,44,0,6
45230,1,2359,2417,-58,0,70,0,6
45231,1,2436,2454,-18,0,256,0,6
45232,2,2369,2441,-72,0,1,0,6
45233,2,2229,2403,-174,0,46,0,6
45234,2,2392,2411,-19,0,241,0,6
45235,2,2384,2495,-111,0,321,0,6
45236,2,2475,2446,29,0,45,0,6
45237,2,2377,2444,-67,0,122,0,6
45239,1,2419,2461,-42,0,200,0,6
45240,2,2385,2428,-43,0,304,0,6
45241,1,2530,2522,8,0,130,0,6
45242,1,2531,2401,130,0,302,0,6
45243,3,2479,2369,110,0,453,0,8
45244,1,2422,2353,69,0,112,0,6
45245,1,2580,2497,83,0,295,0,6
45246,2,2498,2396,102,0,201,0,6
45247,2,2337,2434,-97,0,190,1,6
45248,1,2433,2447,-14,0,218,0,6
45249,2,2286,2518,-232,0,101,0,6
45250,2,2703,2533,170,0,138,0,6
45251,1,2486,2330,156,0,45,1,6
45252,1,2564,2441,123,0,175,1,6
45253,2,2364,2445,-81,0,1,0,6
45254,1,2457,2449,8,0,255,0,6
45255,2,2502,2534,-32,0,300,1,6
45256,2,2337,2419,-82,0,143,0,6
45257,2,2420,2383,37,0,466,0,6
45258,1,2329,2422,-93,0,315,0,6
45259,2,2567,2534,33,0,411,1,6
45260,1,2422,2405,17,0,310,0,6
45261,2,2207,2433,-226,0,45,0,6
45262,2,2398,2466,-68,0,215,0,6
45263,1,2378,2414,-36,0,202,1,6
45264,1,2260,2452,-192,0,388,1,8
45265,1,2476,2437,39,0,400,0,6
45266,2,2352,2511,-159,0,41,0,6
45267,2,2530,2547,-17,0,200,0,6
45268,2,2385,2440,-55,0,37,0,6
45269,2,2357,2493,-136,0,3,0,6
45270,1,2428,2430,-2,0,110,0,6
45271,2,2505,2665,-160,0,224,0,6
45272,1,2351,2413,-62,0,0,0,6
45273,2,2233,2409,-176,0,404,0,6
45274,3,2432,2426,6,0,256,0,6
45275,2,2449,2372,77,0,112,1,6
45276,2,2481,2536,-55,0,31,0,6
45277,2,2521,2284,237,0,152,0,6
45278,1,2497,2424,73,0,5,1,6
45279,1,2416,2387,29,0,200,0,6
45280,2,2563,2600,-37,0,269,0,6
45281,2,2662,2719,-57,0,142,0,6
45282,2,2406,2370,36,0,0,0,6
45283,2,2472,2459,13,0,120,1,6
45284,1,2455,2404,51,0,415,1,6
45285,2,2517,2596,-79,0,409,0,6
45286,2,2503,2333,170,0,207,0,6
45287,1,2424,2427,-3,0,111,0,6
45288,2,2333,2508,-175,0,249,0,6
45289,2,2434,2468,-34,0,49,0,6
45290,2,2524,2584,-60,0,140,0,6
45291,1,2381,2415,-34,0,283,1,6
45292,2,2380,2406,-26,0,310,1,6
45293,1,2493,2432,61,0,331,0,6
45294,1,2451,2281,170,0,110,0,6
45295,1,2426,2272,154,0,172,0,6
45296,2,2475,2366,109,0,426,0,6
45297,3,2425,2341,84,0,107,0,6
45298,2,2304,2538,-234,0,202,1,8
45299,1,2546,2515,31,0,101,1,6
45300,1,2499,2349,150,0,112,0,6
45301,1,2436,2204,232,0,250,0,6
45302,1,2367,2453,-86,0,4,0,6
45303,2,2398,2488,-90,0,45,1,6
45304,2,2323,2469,-146,0,107,0,6
45305,2,2613,2596,17,0,44,0,6
45306,1,2415,2384,31,0,112,0,6
45307,1,2382,2448,-66,0,365,0,6
45308,1,2489,2694,-205,0,180,1,6
45309,1,2626,2371,255,0,206,1,8
45310,2,2400,2405,-5,0,211,0,6
45311,2,2553,2543,10,0,300,0,6
45312,1,2525,2450,75,0,45,1,6
45313,1,2416,2402,14,0,210,1,8
45314,1,2439,2333,106,0,123,1,6
45315,1,2424,2360,64,0,106,0,6
45316,1,2455,2441,14,0,241,0,6
45317,1,2289,2439,-150,0,302,0,6
45318,1,2359,2412,-53,0,404,1,6
45319,3,2509,2497,12,0,20,0,6
45320,1,2454,2491,-37,0,110,0,6
45321,1,2422,2305,117,0,110,0,6
45322,3,2467,2306,161,0,0,0,6
45323,1,2402,2436,-34,0,6,1,6
45324,2,2497,2384,113,0,122,0,6
45325,2,2438,2567,-129,0,110,1,6
45326,2,2306,2415,-109,0,274,0,6
45327,1,2471,2463,8,0,66,0,6
45328,1,2430,2365,65,0,300,0,6
45329,2,2293,2512,-219,0,101,1,6
45330,2,2541,2495,46,0,100,0,6
45331,1,2428,2371,57,0,45,0,6
45332,1,2502,2393,109,0,60,0,6
45333,1,2549,2605,-56,0,256,0,6
45334,2,2658,2558,100,0,101,0,6
45335,1,2326,2477,-151,0,110,0,6
45336,1,2607,2615,-8,0,410,0,6
45337,1,2411,2292,119,0,300,0,6
45338,1,2394,2460,-66,0,216,1,6
45339,1,2422,2430,-8,0,414,0,6
45340,2,2430,2476,-46,0,200,0,6
45341,3,2457,2355,102,0,150,0,6
45342,3,2415,2566,-151,0,1,0,6
45343,2,2442,2433,9,0,113,0,6
45344,1,2403,2472,-69,0,241,0,6
45345,2,2253,2407,-154,0,120,0,6
45346,1,2346,2502,-156,0,57,1,6
45347,1,2547,2373,174,0,302,0,6
45348,1,2509,2561,-52,0,311,0,6
45349,2,2311,2434,-123,0,330,0,6
45350,1,2483,2427,56,0,331,0,6
45351,1,2498,2551,-53,0,354,0,6
45352,2,2417,2424,-7,0,1,0,6
45353,1,2365,2451,-86,0,453,1,6
45354,2,2464,2601,-137,0,112,1,6
45355,1,2419,2289,130,0,69,0,6
45356,1,2436,2294,142,0,10,0,6
45357,1,2394,2444,-50,0,302,0,6
45358,1,2668,2502,166,0,442,0,6
45359,2,2439,2387,52,0,40,0,6
45360,1,2474,2424,50,0,187,0,6
45361,1,2497,2330,167,0,103,0,6
45362,1,2416,2288,128,0,1,0,6
45363,1,2445,2274,171,0,211,0,6
45364,2,2723,2638,85,0,190,0,6
45365,1,2412,2409,3,0,9,0,6
45366,2,2571,2516,55,0,103,0,6
45367,1,2502,2535,-33,0,123,0,6
45368,1,2411,2250,161,0,309,0,6
45369,1,2686,2498,188,0,265,0,6
45370,2,2429,2530,-101,0,100,0,6
45371,1,2598,2465,133,0,2,0,6
45372,1,2481,2382,99,0,53,1,6
45373,1,2444,2302,142,0,30,1,8
45374,2,2436,2422,14,0,14,0,6
45375,3,2377,2445,-68,0,305,0,6
45376,1,2555,2650,-95,0,7,0,6
45377,2,2389,2506,-117,0,246,1,6
45378,1,2406,2355,51,0,106,0,6
45379,2,2401,2440,-39,0,43,0,6
45380,1,2446,2304,142,0,125,0,6
45381,1,2606,2585,21,0,398,1,6
45382,2,2514,2291,223,0,110,0,6
45383,1,2397,2490,-93,0,104,0,6
45384,1,2457,2240,217,0,8,0,6
45385,1,2465,2348,117,0,300,0,6
45387,2,2410,2534,-124,0,241,0,6
45388,2,2370,2550,-180,0,40,0,6
45389,2,2267,2424,-157,0,46,0,6
45390,2,2430,2495,-65,0,327,0,6
45391,2,2523,2613,-90,0,130,0,6
45392,2,2419,2321,98,0,1,0,6
45393,2,2479,2628,-149,0,406,0,8
45394,3,2545,2504,41,0,248,0,6
45395,2,2379,2453,-74,0,201,0,6
45396,2,2410,2464,-54,0,405,0,6
45397,1,2364,2469,-105,0,110,0,6
45398,1,2455,2334,121,0,206,1,6
45399,1,2428,2404,24,0,103,1,6
45400,2,2442,2370,72,0,409,0,6
45401,2,2430,2449,-19,0,14,0,6
45402,3,2338,2409,-71,0,255,0,6
45403,1,2540,2451,89,0,335,0,6
45404,2,2424,2321,103,0,109,1,6
45405,2,2366,2438,-72,0,113,0,6
45406,2,2495,2479,16,0,127,0,6
45407,1,2554,2446,108,0,244,0,6
45408,3,2589,2723,-134,0,115,0,6
45409,2,2394,2444,-50,4,135,0,13
45410,1,2425,2354,71,0,114,0,6
45411,2,2716,2609,107,0,106,1,6
45412,1,2500,2394,106,0,8,0,6
45413,1,2538,2406,132,0,0,0,6
45414,1,2461,2327,134,0,404,0,6
45415,1,2287,2423,-136,0,20,0,6
45416,3,2361,2403,-42,0,409,0,6
45417,1,2300,2505,-205,0,145,0,6
45418,3,2645,2528,117,0,411,0,6
45419,2,2455,2360,95,0,122,0,6
45420,2,2246,2414,-168,0,120,0,6
45421,2,2529,2508,21,0,154,0,6
45422,1,2541,2419,122,0,150,0,6
45423,1,2602,2635,-33,0,122,1,6
45424,1,2440,2435,5,0,241,0,6
45425,1,2442,2591,-149,0,101,0,6
45426,1,2495,2689,-194,0,190,1,6
45427,2,2350,2411,-61,0,1,0,6
45428,1,2430,2431,-1,0,210,0,6
45429,1,2349,2458,-109,0,310,0,6
45430,2,2510,2385,125,0,270,0,6
45431,1,2541,2643,-102,0,301,0,6
45432,1,2444,2465,-21,0,115,0,6
45433,1,2378,2428,-50,0,305,0,6
45434,2,2390,2553,-163,0,100,0,6
45435,2,2329,2486,-157,0,217,0,6
45436,1,2469,2324,145,0,300,0,6
45437,1,2371,2401,-30,0,7,0,6
45438,1,2563,2417,146,0,113,0,6
45439,3,2505,2544,-39,0,354,0,6
45440,2,2370,2481,-111,4,41,0,13
45441,1,2417,2404,13,0,9,1,6
45442,2,2483,2612,-129,0,256,0,6
45443,1,2430,2410,20,0,100,1,6
45444,2,2579,2519,60,0,0,0,6
45445,1,2371,2454,-83,0,305,1,6
45446,2,2485,2424,61,0,217,1,6
45447,1,2401,2330,71,0,143,0,6
45448,3,2556,2528,28,2,483,0,24
45449,2,2617,2593,24,0,464,0,6
45450,2,2615,2479,136,0,58,0,6
45451,1,2404,2238,166,0,106,0,6
45452,1,2598,2562,36,0,101,1,6
45453,1,2255,2405,-150,0,114,1,6
45454,1,2261,2420,-159,0,39,0,6
45455,2,2237,2460,-223,0,46,0,6
45456,1,2535,2448,87,0,45,0,6
45457,1,2406,2471,-65,0,15,1,6
45458,1,2487,2608,-121,0,121,1,6
45459,2,2393,2502,-109,0,40,0,6
45460,1,2434,2336,98,0,244,0,6
45461,2,2371,2401,-30,0,453,0,6
45462,2,2443,2375,68,0,200,1,6
45463,2,2265,2402,-137,0,112,1,8
45464,2,2445,2446,-1,0,110,0,6
45465,1,2425,2545,-120,0,102,0,6
45466,1,2367,2415,-48,0,59,1,6
45467,1,2415,2286,129,0,263,1,8
45468,1,2250,2415,-165,0,1,0,6
45469,3,2473,2544,-71,0,300,0,6
45470,2,2320,2456,-136,0,45,0,6
45471,1,2497,2309,188,0,110,1,6
45472,2,2567,2505,62,0,27,1,6
45473,1,2382,2567,-185,0,411,0,6
45474,1,2326,2405,-79,0,180,1,6
45475,1,2286,2447,-161,0,302,0,8
45476,2,2260,2419,-159,0,322,0,8
45477,1,2557,2386,171,0,45,0,6
45478,1,2398,2436,-38,0,11,1,6
45479,1,2636,2709,-73,0,190,0,6
45480,1,2526,2573,-47,0,46,0,6
45481,2,2721,2591,130,0,127,0,6
45482,2,2404,2343,61,0,113,0,6
45483,1,2271,2459,-188,0,41,1,6
45484,3,2629,2643,-14,0,4,0,6
45485,2,2450,2480,-30,0,56,1,6
45486,1,2253,2456,-203,0,15,0,6
45487,1,2408,2335,73,0,1,0,6
45488,2,2444,2391,53,0,122,0,6
45489,2,2539,2514,25,0,394,0,6
45490,1,2413,2259,154,0,315,0,6
45491,2,2415,2346,69,0,40,1,6
45492,2,2378,2435,-57,0,176,0,6
45493,1,2680,2504,176,0,253,0,6
45494,2,2459,2450,9,0,410,1,6
45495,2,2572,2589,-17,0,335,0,6
45496,1,2544,2506,38,0,248,0,6
45497,1,2506,2389,117,0,8,0,6
45498,2,2383,2560,-177,0,100,0,6
45499,2,2511,2450,61,0,245,0,6
45500,1,2277,2444,-167,0,405,0,6
45501,1,2510,2383,127,0,202,0,6
45502,2,2317,2489,-172,0,45,0,6
45503,1,2566,2532,34,0,0,0,6
45504,2,2271,2438,-167,0,268,0,6
45505,1,2407,2478,-71,0,0,0,6
45506,1,2447,2277,170,0,133,0,6
45507,2,2339,2419,-80,0,113,0,6
45508,3,2403,2435,-32,0,0,0,6
45509,2,2469,2436,33,0,20,0,6
45510,2,2536,2611,-75,0,5,0,6
45511,1,2450,2293,157,2,131,0,23
45512,1,2537,2526,11,0,101,0,6
45513,2,2431,2423,8,0,4,0,6
45514,1,2495,2549,-54,0,263,0,6
45515,2,2399,2413,-14,0,299,0,6
45516,1,2465,2433,32,0,34,0,6
45517,1,2563,2380,183,0,16,0,6
45518,3,2475,2352,123,0,8,0,8
45519,2,2406,2254,152,0,141,0,6
45520,2,2464,2543,-79,0,243,0,6
45521,1,2402,2330,72,0,190,0,6
45522,1,2439,2474,-35,0,4,0,6
45523,1,2608,2557,51,0,112,1,6
45524,1,2453,2436,17,0,4,0,6
45525,2,2429,2386,43,0,45,1,6
45526,1,2407,2533,-126,0,308,0,6
45527,1,2427,2281,146,0,45,1,6
45528,3,2520,2374,146,0,193,0,6
45529,2,2306,2500,-194,0,100,1,6
45530,2,2501,2549,-48,0,447,1,6
45531,2,2432,2542,-110,0,244,0,6
45532,1,2397,2481,-84,0,212,0,6
45533,1,2450,2346,104,0,106,1,6
45534,2,2552,2501,51,0,101,0,6
45535,1,2402,2437,-35,0,335,0,6
45536,1,2599,2643,-44,0,190,1,6
45537,1,2411,2237,174,0,455,1,8
45538,1,2391,2404,-13,0,492,0,6
45539,2,2417,2362,55,0,463,0,6
45540,3,2462,2235,227,0,0,0,6
45541,2,2264,2429,-165,0,128,0,6
45542,3,2430,2459,-29,0,1,0,6
45543,1,2486,2548,-62,0,242,0,6
45544,1,2383,2446,-63,0,46,0,6
45545,2,2443,2468,-25,0,107,0,6
45546,1,2643,2629,14,0,418,1,6
45547,1,2332,2498,-166,0,130,0,6
45548,1,2492,2445,47,0,312,0,6
45549,1,2702,2683,19,0,190,1,6
45550,2,2485,2353,132,0,135,0,6
45551,2,2441,2350,91,0,184,1,6
45552,2,2447,2320,127,0,140,1,6
45553,3,2456,2425,31,0,203,0,6
45554,2,2453,2437,16,0,398,1,6
45555,2,2471,2414,57,0,217,1,6
45556,1,2333,2437,-104,0,105,0,6
45557,1,2409,2259,150,0,101,0,6
45558,2,2456,2510,-54,0,190,0,6
45559,1,2434,2383,51,0,107,1,6
45560,2,2427,2418,9,0,2,0,6
45561,2,2541,2445,96,0,45,0,6
45562,1,2571,2530,41,0,0,0,6
45563,2,2439,2321,118,0,30,0,8
45564,3,2424,2373,51,0,148,0,6
45565,1,2423,2257,166,0,0,0,8
45566,1,2427,2311,116,0,11,0,6
45567,2,2526,2393,133,0,310,1,6
45568,1,2378,2414,-36,0,271,1,6
45569,1,2459,2291,168,0,243,1,6
45570,1,2546,2404,142,0,301,0,6
45571,2,2343,2474,-131,0,4,0,6
45572,2,2558,2391,167,0,5,0,6
45573,2,2368,2446,-78,0,51,1,6
45574,2,2412,2440,-28,0,1,0,6
45575,2,2411,2350,61,0,404,1,6
45576,1,2531,2505,26,0,40,0,6
45577,1,2447,2262,185,0,115,0,6
45578,3,2433,2411,22,0,190,0,6
45579,2,2372,2405,-33,0,25,1,6
45580,2,2428,2528,-100,0,244,0,6
45581,2,2376,2518,-142,0,405,0,6
45582,3,2670,2552,118,0,300,0,6
45583,1,2554,2496,58,0,203,0,6
45584,1,2368,2401,-33,0,103,1,6
45585,2,2342,2454,-112,0,120,1,6
45586,1,2613,2428,185,0,226,0,6
45587,1,2429,2340,89,0,313,0,6
45588,2,2377,2439,-62,0,107,1,6
45589,1,2436,2437,-1,0,40,0,6
45590,2,2415,2473,-58,0,4,0,6
45591,1,2431,2303,128,0,112,1,6
45592,2,2314,2416,-102,0,100,0,6
45593,1,2342,2409,-67,0,454,0,6
45594,1,2636,2508,128,0,101,1,6
45595,2,2431,2341,90,0,41,0,6
45596,1,2448,2250,198,4,107,0,13
45597,2,2503,2357,146,0,0,1,6
45598,1,2480,2482,-2,0,307,0,6
45599,1,2440,2424,16,0,491,0,6
45600,1,2490,2497,-7,0,15,0,6
45601,3,2410,2389,21,0,45,0,6
45602,2,2624,2648,-24,0,195,0,6
45603,1,2459,2431,28,0,304,0,6
45604,1,2434,2285,149,0,39,0,6
45605,2,2325,2404,-79,0,218,0,6
45606,2,2432,2264,168,0,42,0,6
45607,2,2274,2442,-168,0,8,0,6
45608,1,2427,2331,96,0,110,1,6
45609,1,2491,2559,-68,0,247,0,6
45611,2,2411,2404,7,0,100,0,6
45612,1,2434,2499,-65,0,206,1,6
45613,1,2473,2349,124,0,140,0,8
45614,2,2390,2447,-57,0,488,0,6
45615,1,2374,2423,-49,0,241,0,6
45616,2,2426,2456,-30,0,102,1,6
45617,2,2420,2465,-45,0,462,0,6
45618,1,2412,2397,15,0,157,1,6
45619,1,2492,2405,87,0,223,0,6
45620,1,2501,2512,-11,0,112,0,6
45621,1,2360,2540,-180,0,1,0,6
45622,2,2534,2452,82,0,45,0,6
45623,1,2326,2404,-78,0,136,0,6
45624,1,2592,2204,388,0,113,0,6
45625,2,2430,2462,-32,0,380,0,6
45626,1,2415,2293,122,0,240,0,6
45627,3,2259,2450,-191,0,49,0,6
45628,2,2474,2616,-142,0,132,0,6
45629,2,2478,2385,93,0,255,0,6
45630,1,2425,2542,-117,0,211,0,6
45631,2,2390,2440,-50,0,112,1,6
45632,2,2434,2446,-12,0,31,0,6
45633,3,2478,2432,46,0,300,0,6
45634,1,2531,2369,162,0,40,0,6
45635,1,2412,2441,-29,0,302,1,6
45636,2,2541,2522,19,0,46,0,6
45637,3,2654,2618,36,0,123,0,6
45638,3,2427,2323,104,0,343,0,6
45639,2,2378,2518,-140,0,302,0,6
45640,2,2253,2426,-173,0,43,0,8
45641,2,2444,2373,71,0,490,1,6
45642,1,2458,2435,23,0,130,0,6
45643,1,2512,2512,0,0,123,0,6
45644,1,2446,2332,114,0,380,0,6
45645,1,2419,2352,67,0,4,0,6
45646,2,2451,2369,82,0,399,0,6
45647,2,2404,2296,108,0,67,1,6
45648,1,2428,2367,61,0,40,0,6
45649,1,2459,2536,-77,0,130,1,6
45650,1,2606,2708,-102,0,46,1,6
45651,1,2319,2410,-91,0,302,0,6
45652,2,2302,2407,-105,0,46,0,6
45653,1,2476,2424,52,0,43,1,6
45654,3,2470,2415,55,0,109,0,6
45655,2,2275,2495,-220,0,11,0,6
45656,1,2407,2269,138,0,1,0,6
45657,3,2552,2498,54,0,115,0,6
45658,1,2507,2504,3,0,45,0,6
45659,1,2550,2445,105,0,373,0,6
45660,1,2535,2533,2,0,101,0,6
45661,1,2491,2399,92,0,440,1,6
45662,1,2410,2267,143,0,45,1,6
45663,1,2408,2290,118,0,10,0,6
45664,1,2579,2576,3,0,194,0,6
45665,3,2352,2432,-80,0,380,0,8
45666,1,2327,2432,-105,0,302,0,6
45667,1,2555,2432,123,0,153,0,6
45668,1,2577,2461,116,0,123,0,6
45669,1,2421,2418,3,0,200,0,6
45670,2,2461,2493,-32,0,206,0,6
45671,2,2271,2441,-170,0,331,0,6
45672,2,2362,2433,-71,0,313,0,6
45673,2,2324,2462,-138,0,107,0,6
45674,1,2452,2496,-44,0,409,1,6
45675,1,2619,2653,-34,0,45,0,6
45676,2,2488,2370,118,0,343,0,6
45677,1,2386,2433,-47,0,145,0,6
45678,1,2477,2458,19,0,300,0,6
45679,1,2374,2423,-49,0,175,0,6
45680,1,2424,2293,131,0,9,0,6
45681,1,2528,2530,-2,0,102,0,6
45682,2,2478,2620,-142,0,130,0,6
45683,3,2416,2411,5,0,40,0,6
45684,1,2366,2534,-168,0,1,0,6
45685,1,2467,2423,44,0,122,0,6
45686,1,2554,2515,39,0,411,0,6
45687,1,2430,2374,56,0,112,0,6
45688,1,2392,2446,-54,0,151,0,6
45689,1,2540,2464,76,0,125,1,6
45690,2,2402,2426,-24,0,218,0,6
45691,1,2335,2464,-129,4,147,0,13
45692,2,2401,2497,-96,0,101,0,6
45693,1,2488,2471,17,0,206,1,6
45694,1,2505,2502,3,0,153,0,6
45695,2,2497,2299,198,0,110,0,6
45696,2,2521,2466,55,0,45,1,6
45697,2,2325,2478,-153,0,212,0,6
45698,2,2447,2499,-52,0,203,0,6
45699,2,2332,2450,-118,0,200,1,6
45700,1,2513,2518,-5,0,300,1,6
45701,2,2507,2616,-109,0,40,0,6
45702,1,2447,2262,185,0,115,0,6
45703,1,2534,2444,90,0,336,0,6
45704,2,2437,2483,-46,0,4,0,6
45705,2,2477,2304,173,0,131,1,8
45706,1,2508,2412,96,0,25,0,6
45707,2,2403,2326,77,0,300,0,6
45708,1,2413,2480,-67,0,300,0,6
45709,1,2392,2427,-35,0,140,0,6
45710,2,2416,2469,-53,0,45,1,6
45711,1,2469,2380,89,0,210,1,6
45712,1,2667,2481,186,0,260,1,6
45713,1,2448,2302,146,0,0,0,6
45715,1,2571,2585,-14,0,123,0,6
45716,2,2498,2456,42,0,103,0,6
45717,2,2241,2413,-172,0,111,0,6
45718,1,2496,2380,116,0,331,1,6
45719,1,2526,2419,107,0,331,1,6
45720,2,2259,2450,-191,0,15,0,6
45721,1,2620,2503,117,0,300,0,6
45722,2,2284,2402,-118,0,118,0,6
45723,2,2360,2469,-109,0,5,0,6
45724,3,2379,2434,-55,0,50,0,6
45725,1,2341,2496,-155,0,58,0,6
45726,3,2235,2413,-178,0,122,0,6
45727,1,2438,2358,80,0,40,0,6
45728,1,2531,2550,-19,0,241,0,6
45729,1,2647,2466,181,0,69,0,6
45730,1,2429,2309,120,0,0,1,8
45731,3,2427,2401,26,0,292,0,6
45732,2,2393,2581,-188,0,176,0,6
45733,1,2412,2374,38,0,106,0,6
45734,1,2465,2497,-32,0,413,1,6
45735,2,2521,2533,-12,0,15,0,6
45736,1,2431,2459,-28,0,4,0,6
45737,1,2417,2380,37,0,45,0,6
45738,2,2542,2515,27,0,101,1,6
45739,1,2488,2406,82,0,45,1,6
45740,2,2379,2554,-175,0,5,0,6
45741,2,2474,2461,13,0,107,1,6
45742,1,2472,2321,151,0,225,1,6
45743,1,2417,2472,-55,0,455,1,6
45744,1,2418,2365,53,0,133,0,6
45745,2,2462,2420,42,0,211,0,6
45746,2,2559,2504,55,0,405,1,6
45747,1,2441,2388,53,0,57,0,6
45748,1,2408,2442,-34,0,70,0,6
45749,1,2466,2390,76,0,100,0,6
45750,2,2365,2459,-94,0,359,0,6
45751,2,2308,2489,-181,0,10,1,6
45752,1,2492,2439,53,0,106,0,6
45753,2,2397,2411,-14,0,217,0,6
45754,2,2266,2411,-145,0,100,0,6
45755,1,2462,2297,165,0,112,0,6
45756,2,2623,2613,10,0,223,0,6
45757,1,2408,2345,63,0,0,0,6
45758,1,2463,2650,-187,0,190,0,6
45759,3,2551,2519,32,0,115,0,6
45760,1,2454,2381,73,0,415,0,6
45761,3,2305,2414,-109,0,33,0,6
45762,2,2328,2440,-112,0,277,1,6
45763,2,2468,2380,88,0,380,0,6
45764,1,2539,2512,27,0,102,0,6
45765,2,2400,2312,88,0,106,0,6
45766,2,2544,2499,45,0,0,0,6
45767,2,2345,2455,-110,0,120,0,6
45768,3,2464,2361,103,0,112,0,6
45769,1,2436,2411,25,0,147,0,6
45770,1,2474,2411,63,0,109,0,6
45771,2,2452,2298,154,0,0,0,6
45772,1,2557,2527,30,0,160,0,6
45773,2,2369,2413,-44,0,1,0,6
45774,2,2415,2530,-115,0,112,0,6
45776,2,2419,2452,-33,0,210,0,6
45777,2,2487,2382,105,0,53,0,6
45778,1,2387,2500,-113,0,65,0,6
45779,1,2453,2256,197,0,115,1,6
45780,1,2376,2539,-163,0,40,1,6
45781,2,2378,2468,-90,0,10,0,6
45782,1,2468,2217,251,0,0,1,6
45783,1,2413,2283,130,0,80,1,6
45784,1,2584,2390,194,0,123,0,6
45785,2,2402,2423,-21,0,190,1,6
45786,1,2577,2644,-67,0,125,0,6
45787,2,2288,2473,-185,0,474,0,6
45788,1,2402,2387,15,0,334,0,6
45789,2,2458,2510,-52,0,405,1,6
45790,1,2521,2346,175,0,45,0,6
45791,2,2455,2476,-21,0,107,0,6
45792,1,2466,2425,41,0,122,0,6
45793,1,2340,2505,-165,0,122,0,6
45794,1,2466,2472,-6,0,112,1,6
45795,2,2353,2459,-106,0,201,0,6
45796,2,2470,2468,2,0,101,0,6
45797,1,2536,2642,-106,0,190,0,6
45798,1,2407,2492,-85,0,306,0,6
45799,1,2357,2469,-112,0,107,0,8
45800,1,2433,2497,-64,0,202,0,6
45801,2,2374,2441,-67,0,131,0,6
45802,1,2485,2414,71,0,5,0,6
45803,2,2519,2550,-31,0,300,0,6
45804,2,2462,2298,164,0,45,1,6
45805,2,2414,2268,146,0,57,1,6
45806,2,2246,2400,-154,0,470,1,8
45807,2,2423,2313,110,0,440,1,8
45808,2,2451,2458,-7,0,200,0,6
45809,1,2638,2553,85,0,345,1,6
45810,1,2444,2386,58,0,100,0,6
45811,1,2471,2538,-67,0,224,0,6
45812,1,2632,2654,-22,0,10,0,6
45813,1,2392,2438,-46,0,200,0,6
45814,2,2420,2258,162,4,339,0,13
45815,1,2505,2534,-29,0,302,0,6
45816,1,2464,2314,150,0,415,0,6
45817,2,2445,2589,-144,0,110,0,6
45818,2,2419,2471,-52,0,455,0,6
45819,1,2414,2262,152,0,1,0,6
45820,1,2538,2460,78,0,301,0,6
45821,2,2522,2578,-56,0,101,1,6
45822,2,2307,2490,-183,0,6,0,6
45823,2,2396,2524,-128,0,0,0,6
45824,1,2435,2464,-29,0,109,0,6
45825,2,2411,2492,-81,0,107,1,6
45826,1,2364,2527,-163,0,1,0,6
45827,1,2446,2398,48,0,341,1,6
45828,2,2479,2336,143,0,41,0,6
45829,2,2315,2467,-152,0,344,0,6
45830,1,2411,2271,140,0,40,0,6
45831,1,2464,2390,74,0,411,0,6
45832,2,2446,2370,76,0,112,0,6
45833,2,2634,2543,91,0,45,0,6
45834,2,2308,2433,-125,0,326,0,8
45835,1,2349,2407,-58,0,5,0,6
45836,2,2362,2544,-182,0,301,1,6
45837,2,2401,2416,-15,0,41,1,6
45838,2,2366,2531,-165,0,192,0,6
45839,2,2450,2384,66,0,211,0,6
45840,1,2481,2396,85,0,226,0,6
45841,1,2648,2478,170,0,45,0,6
45842,2,2311,2464,-153,0,211,0,6
45843,2,2449,2474,-25,0,151,0,6
45844,1,2402,2340,62,0,5,0,6
45845,1,2275,2422,-147,0,405,0,8
45846,1,2528,2453,75,0,41,0,6
45847,2,2515,2531,-16,0,306,1,6
45848,2,2499,2638,-139,0,194,0,6
45849,1,2476,2413,63,0,122,1,6
45850,1,2466,2556,-90,0,6,0,6
45851,1,2295,2444,-149,0,3,0,6
45852,2,2413,2392,21,0,306,1,6
45853,1,2519,2505,14,0,102,0,6
45854,1,2420,2431,-11,0,106,0,6
45855,1,2514,2584,-70,0,45,0,6
45856,1,2490,2381,109,0,100,0,6
45857,2,2372,2438,-66,0,1,0,6
45858,1,2253,2428,-175,0,196,0,6
45859,3,2362,2441,-79,0,54,0,6
45860,1,2481,2423,58,0,4,0,6
45861,2,2420,2593,-173,0,106,0,6
45862,1,2440,2302,138,0,1,0,6
45863,1,2493,2409,84,0,201,0,6
45864,1,2293,2454,-161,0,45,1,6
45865,1,2481,2299,182,0,122,0,6
45866,1,2441,2307,134,0,128,0,6
45867,1,2468,2340,128,0,113,0,8
45868,1,2280,2406,-126,0,301,1,6
45869,1,2417,2343,74,0,295,0,6
45870,1,2642,2597,45,0,101,0,6
45871,3,2494,2498,-4,0,101,0,6
45872,1,2343,2456,-113,0,448,0,6
45873,1,2489,2297,192,0,0,0,6
45874,1,2476,2329,147,0,244,0,6
45875,1,2405,2471,-66,0,57,0,6
45876,1,2439,2407,32,0,56,0,6
45877,2,2392,2437,-45,0,214,0,6
45878,2,2468,2486,-18,0,129,0,6
45879,2,2449,2403,46,2,310,0,23
45880,2,2362,2517,-155,0,453,0,6
45881,1,2468,2356,112,0,40,0,6
45882,1,2549,2474,75,0,115,0,6
45883,1,2385,2528,-143,0,311,0,6
45884,1,2418,2267,151,0,469,0,6
45885,1,2439,2431,8,0,190,0,6
45886,2,2403,2441,-38,0,40,0,6
45887,2,2419,2495,-76,0,141,0,6
45888,1,2379,2401,-22,0,300,0,6
45889,1,2443,2368,75,0,106,0,6
45890,1,2497,2370,127,0,45,0,6
45891,1,2437,2304,133,0,0,0,8
45892,1,2408,2247,161,0,337,0,6
45893,3,2391,2443,-52,0,40,0,6
45894,2,2376,2436,-60,0,409,0,6
45895,2,2377,2407,-30,0,302,0,6
45896,1,2401,2408,-7,0,1,0,6
45897,1,2494,2313,181,0,107,1,6
45898,1,2448,2422,26,0,404,0,6
45899,3,2612,2548,64,0,343,0,6
45900,1,2534,2359,175,0,470,1,6
45901,1,2404,2324,80,0,226,0,8
45902,1,2368,2443,-75,0,255,0,6
45903,2,2479,2352,127,0,125,1,6
45904,1,2425,2288,137,0,85,0,6
45905,2,2445,2426,19,0,45,0,6
45906,1,2294,2409,-115,4,101,0,13
45907,2,2547,2448,99,0,125,1,6
45908,1,2448,2521,-73,0,189,0,6
45909,1,2536,2594,-58,0,301,1,6
45910,2,2323,2418,-95,0,90,0,6
45911,1,2520,2510,10,0,45,1,6
45912,2,2444,2324,120,2,18,0,23
45913,2,2577,2579,-2,0,0,0,6
45914,2,2393,2492,-99,0,4,0,6
45915,3,2467,2342,125,0,412,0,6
45916,1,2642,2647,-5,0,311,1,6
45917,2,2497,2525,-28,0,0,0,6
45918,1,2239,2411,-172,0,201,0,6
45919,2,2403,2391,12,0,101,0,6
45920,1,2420,2296,124,0,110,0,6
45921,3,2311,2497,-186,0,301,0,6
45922,2,2532,2521,11,0,302,0,6
45923,1,2440,2339,101,0,110,0,6
45924,2,2426,2445,-19,0,112,0,6
45925,1,2395,2451,-56,0,58,0,6
45926,1,2442,2447,-5,0,43,1,6
45927,2,2387,2484,-97,0,210,1,6
45928,2,2460,2398,62,0,295,0,6
45929,2,2432,2472,-40,0,130,1,6
45930,2,2422,2557,-135,0,45,1,6
45931,1,2437,2353,84,0,112,0,6
45932,1,2530,2489,41,0,46,0,6
45933,2,2364,2451,-87,0,7,0,6
45934,2,2491,2462,29,0,212,0,6
45935,2,2464,2412,52,0,4,0,6
45936,2,2363,2448,-85,0,1,0,6
45937,3,2469,2553,-84,0,6,0,6
45938,3,2407,2336,71,0,374,0,6
45939,2,2438,2364,74,0,115,0,6
45940,1,2402,2385,17,0,21,1,6
45941,3,2395,2443,-48,0,106,0,6
45942,2,2496,2392,104,0,300,0,6
45943,2,2457,2352,105,0,40,0,6
45944,1,2408,2271,137,0,58,0,6
45945,1,2514,2455,59,0,118,0,6
45946,2,2454,2489,-35,0,321,0,6
45947,1,2307,2429,-122,0,45,0,6
45948,2,2407,2400,7,0,302,0,6
45949,2,2397,2444,-47,0,135,0,6
45950,1,2482,2535,-53,0,0,0,6
45951,2,2475,2527,-52,0,110,0,6
45952,2,2340,2412,-72,0,453,0,6
45953,1,2452,2359,93,0,106,0,6
45954,2,2541,2521,20,0,101,0,6
45955,3,2331,2411,-80,0,40,0,6
45956,2,2221,2423,-202,0,250,0,6
45957,1,2598,2571,27,0,190,0,6
45958,2,2440,2414,26,0,487,0,6
45959,1,2348,2497,-149,0,19,0,6
45960,1,2587,2597,-10,0,37,0,6
45961,1,2543,2471,72,0,0,1,6
45962,1,2555,2537,18,0,122,1,6
45963,3,2465,2394,71,0,33,0,6
45964,2,2412,2402,10,0,221,1,6
45965,2,2406,2462,-56,0,302,0,6
45966,1,2539,2526,13,0,321,1,6
45967,1,2422,2289,133,0,40,0,6
45968,2,2507,2408,99,0,45,1,8
45969,1,2470,2365,105,0,140,0,6
45970,1,2504,2495,9,0,306,0,6
45971,2,2483,2422,61,0,10,0,6
45972,2,2457,2524,-67,0,428,0,6
45973,2,2292,2410,-118,0,406,1,6
45974,2,2477,2396,81,0,130,1,6
45975,1,2301,2440,-139,0,40,0,8
45976,1,2270,2424,-154,0,123,0,6
45977,2,2441,2279,162,0,300,0,6
45978,1,2566,2615,-49,0,0,1,6
45979,2,2552,2470,82,0,248,0,6
45980,1,2452,2403,49,0,409,1,6
45981,1,2469,2494,-25,0,255,0,6
45982,1,2404,2374,30,0,311,0,8
45983,2,2380,2493,-113,0,240,0,6
45984,2,2488,2543,-55,0,211,1,6
45985,1,2299,2407,-108,0,244,0,8
45986,2,2383,2402,-19,0,104,1,6
45987,1,2426,2423,3,0,134,0,6
45988,1,2256,2426,-170,0,113,1,6
45989,2,2360,2449,-89,0,4,0,6
45990,2,2366,2419,-53,0,108,0,6
45991,1,2455,2457,-2,0,58,0,6
45992,2,2366,2414,-48,4,483,0,13
45993,1,2464,2340,124,0,4,1,6
45994,1,2416,2397,19,0,105,0,6
45995,3,2593,2450,143,0,37,0,6
45996,2,2455,2418,37,0,46,1,6
45998,2,2428,2367,61,0,351,1,6
45999,3,2529,2532,-3,0,47,0,6
46000,2,2355,2457,-102,0,1,0,6
46001,2,2519,2491,28,0,104,0,6
46002,2,2494,2529,-35,0,259,0,6
46003,2,2442,2449,-7,0,107,1,6
46004,2,2396,2425,-29,0,113,1,6
46005,3,2435,2402,33,0,201,0,6
46006,2,2268,2434,-166,0,190,0,6
46007,1,2572,2528,44,0,380,1,6
46008,1,2287,2451,-164,0,40,0,6
46009,1,2561,2397,164,0,4,0,6
46010,1,2356,2419,-63,0,4,1,6
46011,1,2489,2453,36,0,123,0,6
46012,2,2423,2378,45,0,491,0,6
46013,2,2201,2436,-235,0,22,0,6
46014,1,2467,2321,146,0,270,0,6
46015,1,2471,2401,70,0,200,0,6
46016,3,2548,2668,-120,0,0,0,6
46017,1,2401,2264,137,4,46,0,13
46018,1,2408,2318,90,0,1,0,6
46019,1,2489,2406,83,0,121,1,6
46020,1,2510,2512,-2,0,347,0,6
46021,1,2433,2280,153,0,45,0,8
46022,3,2452,2450,2,0,352,0,6
46023,1,2545,2470,75,0,246,0,6
46024,1,2360,2520,-160,0,300,0,6
46025,1,2546,2576,-30,0,428,0,6
46026,1,2371,2432,-61,0,353,0,6
46027,1,2416,2371,45,0,178,0,6
46028,2,2531,2548,-17,0,41,0,6
46029,1,2533,2483,50,0,4,0,6
46030,1,2444,2371,73,0,40,1,6
46031,2,2298,2443,-145,0,118,1,6
46032,1,2351,2433,-82,0,245,0,6
46033,2,2367,2458,-91,0,8,0,6
46034,1,2470,2550,-80,0,267,0,6
46035,1,2377,2401,-24,0,395,0,6
46036,1,2429,2380,49,0,107,0,6
46037,3,2410,2315,95,0,120,0,6
46038,1,2417,2407,10,0,104,1,6
46039,1,2461,2377,84,0,310,0,6
46040,1,2476,2328,148,0,206,1,6
46041,1,2499,2335,164,0,122,0,6
46043,2,2452,2389,63,0,131,0,6
46044,2,2500,2591,-91,0,45,0,6
46045,2,2470,2466,4,0,46,1,6
46046,2,2402,2434,-32,0,13,0,6
46047,2,2506,2516,-10,0,405,0,6
46048,2,2355,2417,-62,0,466,0,6
46049,1,2461,2351,110,0,106,0,6
46050,2,2534,2396,138,0,201,0,6
46051,3,2479,2441,38,0,141,0,6
46052,1,2625,2592,33,0,45,0,6
46053,1,2336,2431,-95,0,107,0,6
46054,1,2454,2439,15,0,403,1,6
46055,1,2512,2541,-29,0,45,0,6
46056,2,2322,2421,-99,0,122,0,6
46057,2,2489,2369,120,0,200,0,6
46058,3,2406,2306,100,0,374,0,6
46059,3,2666,2573,93,0,30,0,6
46060,1,2436,2408,28,0,45,0,6
46061,1,2523,2412,111,0,101,0,6
46062,2,2314,2420,-106,0,106,0,6
46063,3,2417,2321,96,0,133,0,6
46064,3,2648,2577,71,0,1,0,6
46065,1,2403,2448,-45,0,454,0,6
46066,2,2398,2416,-18,0,15,0,6
46067,2,2498,2373,125,0,0,0,6
46068,3,2421,2271,150,0,302,0,6
46069,2,2513,2494,19,0,13,0,6
46070,2,2416,2421,-5,0,44,0,8
46071,2,2494,2535,-41,0,200,0,6
46072,2,2402,2526,-124,0,302,1,6
46073,2,2553,2521,32,0,301,0,6
46074,1,2384,2554,-170,0,278,0,6
46075,2,2376,2482,-106,0,301,0,6
46076,2,2420,2325,95,0,106,0,6
46077,1,2426,2321,105,0,255,0,6
46078,1,2478,2539,-61,0,112,0,6
46079,3,2595,2617,-22,0,343,0,6
46080,1,2543,2494,49,0,103,0,6
46081,3,2378,2466,-88,0,424,0,6
46082,1,2438,2494,-56,0,302,1,6
46083,2,2450,2452,-2,0,31,0,6
46084,1,2422,2569,-147,0,62,0,6
46085,2,2394,2564,-170,0,406,0,6
46086,2,2224,2436,-212,0,100,0,8
46087,2,2413,2489,-76,0,0,0,6
46088,1,2446,2351,95,0,152,0,6
46089,2,2579,2647,-68,0,310,0,6
46090,1,2396,2446,-50,0,37,0,6
46091,1,2347,2465,-118,0,45,1,6
46092,3,2389,2434,-45,0,125,0,6
46093,1,2485,2488,-3,0,255,0,6
46094,2,2431,2423,8,0,106,0,6
46095,1,2419,2402,17,0,15,0,6
46096,3,2489,2316,173,0,201,0,6
46097,1,2500,2540,-40,0,469,0,6
46098,3,2423,2343,80,0,110,0,6
46099,3,2518,2667,-149,0,80,0,6
46100,1,2381,2490,-109,0,200,0,6
46101,1,2424,2260,164,0,190,0,6
46102,1,2515,2358,157,0,130,1,6
46103,2,2425,2464,-39,0,103,1,6
46104,2,2316,2480,-164,0,453,0,6
46105,1,2439,2292,147,0,0,0,8
46107,1,2434,2393,41,0,125,0,6
46108,2,2482,2491,-9,0,203,0,6
46109,2,2574,2526,48,0,0,0,6
46110,1,2418,2442,-24,0,403,0,6
46111,2,2562,2430,132,0,107,0,6
46112,2,2404,2560,-156,0,305,1,6
46113,2,2347,2401,-54,0,33,0,6
46114,2,2478,2664,-186,0,200,0,6
46116,1,2429,2598,-169,0,214,1,6
46117,2,2406,2413,-7,0,109,1,6
46118,3,2366,2441,-75,0,48,0,6
46119,2,2257,2428,-171,0,103,1,6
46120,2,2308,2427,-119,4,115,0,13
46121,1,2404,2375,29,0,133,0,6
46122,2,2496,2476,20,0,255,0,6
46123,2,2530,2507,23,0,331,0,6
46124,2,2388,2426,-38,0,260,0,6
46125,3,2476,2547,-71,0,60,0,6
46126,3,2475,2354,121,0,145,0,8
46127,2,2488,2548,-60,0,267,0,6
46128,1,2313,2422,-109,0,330,0,6
46129,1,2528,2430,98,0,331,0,6
46130,1,2422,2324,98,0,102,0,6
46131,2,2483,2326,157,0,10,0,6
46132,2,2414,2268,146,0,41,0,6
46133,1,2465,2474,-9,0,483,1,6
46134,2,2303,2414,-111,0,45,0,8
46135,1,2652,2574,78,0,394,0,6
46136,1,2596,2466,130,0,16,0,6
46137,2,2486,2372,114,0,200,0,6
46138,2,2516,2335,181,0,413,0,8
46139,1,2450,2457,-7,0,151,0,6
46140,3,2408,2376,32,0,334,0,6
46141,1,2493,2397,96,0,70,0,6
46142,2,2405,2342,63,0,34,1,6
46143,1,2575,2445,130,0,346,0,6
46144,2,2388,2408,-20,0,263,1,6
46145,1,2438,2410,28,0,344,0,8
46146,1,2405,2246,159,0,115,0,6
46147,1,2444,2278,166,0,45,0,6
46148,2,2440,2497,-57,0,240,0,6
46149,2,2366,2463,-97,0,110,0,6
46150,1,2422,2408,14,0,101,0,6
46151,2,2436,2425,11,0,39,0,6
46152,2,2381,2422,-41,0,207,1,6
46153,3,2404,2309,95,0,374,0,6
46154,1,2380,2478,-98,0,300,0,6
46155,2,2452,2354,98,0,138,0,6
46156,2,2570,2656,-86,0,41,0,6
46157,2,2227,2414,-187,4,102,0,13
46158,2,2277,2433,-156,0,184,0,6
46159,2,2464,2356,108,0,41,0,6
46160,1,2665,2486,179,0,112,0,6
46161,1,2425,2383,42,0,45,0,6
46162,1,2488,2353,135,0,201,0,6
46163,3,2401,2287,114,0,28,0,6
46164,2,2568,2518,50,0,0,0,6
46165,2,2266,2420,-154,0,46,0,6
46166,3,2395,2442,-47,0,4,0,8
46167,1,2554,2382,172,0,170,0,6
46168,2,2406,2264,142,4,424,0,13
46169,1,2456,2379,77,0,152,0,6
46170,2,2409,2444,-35,0,25,0,6
46171,1,2552,2482,70,0,100,0,6
46172,3,2401,2521,-120,0,101,0,6
46173,2,2589,2437,152,0,41,0,6
46174,2,2471,2387,84,0,200,0,6
46175,3,2447,2459,-12,0,110,0,6
46176,1,2431,2335,96,0,106,0,6
46177,1,2492,2401,91,0,211,0,6
46178,1,2435,2351,84,0,45,0,6
46179,3,2423,2338,85,0,312,0,6
46180,2,2394,2464,-70,0,300,0,6
46181,2,2482,2490,-8,0,203,0,6
46182,2,2546,2647,-101,0,301,0,6
46183,2,2280,2426,-146,0,123,0,6
46184,1,2661,2565,96,0,395,0,6
46185,2,2467,2426,41,0,14,1,6
46186,2,2524,2532,-8,0,46,0,6
46187,2,2513,2599,-86,0,345,0,6
46188,2,2335,2444,-109,0,112,0,6
46189,1,2441,2469,-28,0,409,0,6
46190,2,2362,2525,-163,0,1,0,6
46191,2,2500,2441,59,0,112,0,8
46192,2,2325,2461,-136,0,484,0,6
46193,2,2431,2430,1,0,15,0,6
46194,1,2557,2483,74,0,101,0,6
46195,1,2400,2404,-4,0,260,0,6
46196,2,2415,2337,78,0,40,0,6
46197,1,2408,2283,125,0,192,0,6
46198,1,2393,2468,-75,0,453,1,6
46199,2,2445,2581,-136,0,123,0,6
46200,1,2312,2475,-163,0,152,0,6
46201,2,2457,2383,74,0,290,0,6
46202,2,2269,2413,-144,0,245,0,6
46203,2,2459,2322,137,0,242,0,6
46204,2,2378,2498,-120,0,7,0,6
46205,1,2654,2542,112,0,203,0,6
46206,2,2349,2412,-63,0,208,0,6
46207,1,2359,2436,-77,0,122,1,6
46208,1,2420,2273,147,0,201,0,6
46209,1,2519,2561,-42,0,45,0,6
46210,2,2430,2435,-5,0,300,1,6
46211,1,2496,2477,19,0,255,0,6
46212,1,2406,2403,3,0,415,0,6
46213,1,2405,2351,54,0,335,1,6
46214,3,2356,2472,-116,0,190,0,8
46215,3,2561,2665,-104,0,310,0,6
46216,1,2476,2486,-10,0,15,0,6
46217,2,2340,2422,-82,0,302,0,6
46218,1,2668,2518,150,0,311,0,6
46220,1,2528,2359,169,0,106,1,6
46221,1,2585,2442,143,0,122,0,6
46222,1,2233,2450,-217,4,110,0,8
46223,1,2538,2661,-123,0,10,0,6
46224,1,2423,2399,24,0,154,1,6
46225,1,2496,2457,39,0,122,0,6
46226,1,2448,2436,12,0,12,0,6
46227,1,2403,2405,-2,0,14,0,6
46228,1,2458,2428,30,0,453,0,6
46229,2,2397,2412,-15,0,305,0,6
46230,3,2448,2306,142,0,102,0,6
46231,1,2495,2373,122,0,106,1,6
46232,2,2403,2479,-76,0,107,0,6
46233,1,2469,2390,79,0,200,0,6
46235,1,2427,2391,36,0,103,0,6
46236,2,2421,2222,199,4,122,0,13
46237,1,2432,2461,-29,0,106,0,6
46238,2,2533,2509,24,0,141,0,6
46239,2,2350,2507,-157,0,115,1,8
46240,2,2478,2463,15,0,103,0,6
46241,1,2402,2428,-26,0,220,0,6
46242,1,2464,2322,142,0,212,0,6
46243,2,2277,2417,-140,0,263,1,6
46244,1,2450,2307,143,0,119,0,6
46245,1,2341,2406,-65,0,2,0,6
46246,2,2451,2390,61,0,0,0,6
46247,3,2525,2412,113,0,43,0,6
46248,1,2760,2555,205,0,60,0,6
46249,2,2385,2473,-88,0,301,0,6
46250,1,2503,2414,89,0,483,0,6
46251,2,2438,2588,-150,0,301,0,6
46252,3,2455,2439,16,0,14,0,6
46253,2,2471,2372,99,0,300,0,6
46254,2,2339,2501,-162,0,251,0,6
46255,1,2461,2447,14,0,132,0,6
46256,1,2532,2488,44,0,34,0,6
46257,1,2430,2267,163,0,140,0,6
46258,2,2286,2454,-168,0,40,0,6
46259,2,2344,2402,-58,0,16,0,6
46260,2,2419,2443,-24,0,170,1,6
46261,2,2427,2362,65,0,464,1,6
46262,1,2563,2515,48,0,432,0,6
46263,2,2272,2409,-137,0,35,0,6
46264,2,2299,2410,-111,0,143,0,6
46265,1,2502,2346,156,0,115,0,6
46266,2,2395,2452,-57,0,46,1,6
46267,1,2272,2418,-146,0,325,0,6
46268,1,2429,2391,38,0,200,1,6
46269,2,2648,2545,103,0,0,0,6
46270,3,2469,2358,111,0,248,0,8
46271,1,2448,2413,35,0,0,0,8
46272,1,2672,2483,189,0,103,0,6
46273,2,2403,2464,-61,0,10,0,6
46274,2,2355,2454,-99,0,1,0,6
46275,2,2469,2468,1,0,335,1,6
46276,2,2480,2473,7,0,484,1,6
46277,1,2426,2538,-112,0,5,0,6
46278,2,2361,2417,-56,0,248,0,6
46279,1,2399,2429,-30,0,46,1,6
46280,1,2592,2435,157,0,101,0,6
46281,1,2627,2445,182,0,421,0,6
46282,2,2510,2433,77,0,302,0,6
46283,2,2626,2568,58,0,448,0,6
46284,2,2513,2678,-165,0,122,0,6
46285,2,2393,2480,-87,0,241,0,6
46286,2,2534,2560,-26,0,132,0,6
46287,1,2318,2468,-150,0,468,0,6
46288,1,2471,2430,41,0,140,0,6
46289,1,2420,2327,93,0,394,1,6
46290,2,2366,2424,-58,0,107,0,6
46291,2,2439,2455,-16,0,112,0,6
46292,3,2447,2441,6,0,331,0,6
46293,2,2324,2417,-93,0,115,1,6
46294,1,2346,2524,-178,0,300,0,6
46295,1,2515,2531,-16,0,473,1,6
46296,1,2458,2351,107,0,106,0,6
46297,2,2423,2527,-104,0,380,1,6
46298,2,2414,2444,-30,0,415,1,6
46299,1,2552,2553,-1,0,0,0,6
46300,1,2397,2457,-60,0,112,0,6
46301,2,2460,2433,27,0,246,0,6
46302,1,2410,2268,142,0,107,1,6
46303,2,2478,2381,97,0,200,0,6
46304,2,2468,2467,1,0,453,0,6
46305,1,2498,2328,170,0,45,1,6
46306,1,2407,2330,77,0,213,0,6
46307,1,2440,2454,-14,0,112,1,6
46308,1,2484,2339,145,0,0,0,6
46309,3,2528,2442,86,0,50,0,6
46310,3,2417,2457,-40,4,45,0,13
46311,2,2414,2336,78,0,100,0,6
46312,2,2403,2326,77,0,411,1,6
46313,2,2442,2630,-188,0,154,1,6
46314,2,2413,2448,-35,0,20,1,6
46315,1,2417,2404,13,0,43,1,6
46316,1,2409,2385,24,0,0,0,6
46317,1,2681,2531,150,0,167,0,6
46318,1,2451,2477,-26,0,6,0,6
46319,1,2480,2503,-23,0,9,0,6
46320,3,2440,2390,50,0,112,0,6
46321,1,2566,2675,-109,0,247,1,6
46322,2,2453,2348,105,0,0,0,8
46323,2,2510,2346,164,0,319,1,8
46324,1,2386,2435,-49,0,304,1,6
46325,3,2310,2447,-137,0,310,0,6
46326,2,2555,2463,92,0,302,0,6
46327,2,2478,2474,4,0,0,0,6
46328,3,2515,2460,55,0,45,0,6
46329,1,2423,2406,17,0,110,0,6
46330,3,2441,2400,41,0,200,0,6
46331,2,2347,2462,-115,0,42,0,6
46332,2,2575,2547,28,0,333,0,6
46333,2,2351,2508,-157,0,394,0,6
46334,2,2425,2425,0,0,15,0,6
46335,2,2527,2685,-158,0,347,1,6
46336,2,2388,2470,-82,0,302,0,6
46337,1,2457,2389,68,0,43,0,6
46338,2,2440,2361,79,0,13,1,6
46339,2,2547,2531,16,0,49,0,6
46340,2,2257,2407,-150,0,112,0,8
46341,2,2330,2419,-89,0,41,0,6
46342,2,2465,2450,15,0,45,1,6
46343,1,2422,2365,57,0,453,0,6
46344,3,2273,2413,-140,0,332,0,6
46345,1,2422,2334,88,0,140,0,6
46346,3,2605,2521,84,0,132,0,6
46347,2,2388,2446,-58,0,229,1,6
46348,1,2281,2407,-126,0,102,0,6
46349,2,2409,2423,-14,0,331,1,6
46350,1,2457,2380,77,0,6,0,6
46351,2,2471,2668,-197,0,115,0,6
46352,2,2338,2414,-76,0,120,0,6
46353,3,2417,2255,162,4,5,0,8
46354,2,2412,2343,69,0,100,1,6
46355,2,2463,2448,15,0,410,0,6
46356,2,2400,2428,-28,0,453,0,6
46357,2,2415,2361,54,0,0,1,6
46358,2,2403,2347,56,0,14,0,6
46359,1,2427,2278,149,0,40,0,6
46360,2,2431,2527,-96,0,414,0,6
46361,2,2453,2488,-35,0,100,0,6
46362,1,2549,2554,-5,0,334,0,6
46363,1,2497,2430,67,0,302,0,6
46364,1,2667,2573,94,0,154,0,6
46365,1,2336,2439,-103,0,21,0,6
46366,1,2466,2343,123,0,106,0,6
46367,1,2487,2473,14,0,107,1,6
46368,1,2323,2473,-150,0,198,0,6
46369,1,2475,2384,91,0,200,0,6
46370,1,2461,2419,42,0,151,1,6
46371,2,2514,2505,9,0,45,0,6
46372,3,2556,2466,90,0,194,0,8
46373,2,2229,2467,-238,0,45,0,6
46374,2,2400,2429,-29,0,107,0,6
46375,2,2396,2439,-43,0,310,1,6
46376,1,2405,2313,92,0,353,0,8
46377,1,2428,2393,35,0,200,0,6
46378,1,2408,2422,-14,0,15,0,6
46379,1,2451,2367,84,0,145,0,6
46380,2,2423,2365,58,0,373,0,6
46381,2,2537,2604,-67,0,145,0,6
46382,2,2416,2298,118,0,131,0,6
46383,2,2433,2307,126,0,10,1,6
46384,2,2432,2343,89,0,152,0,6
46385,1,2371,2442,-71,0,106,0,6
46386,2,2461,2304,157,0,1,0,6
46387,3,2548,2688,-140,0,312,0,6
46388,1,2540,2564,-24,0,205,0,6
46389,2,2419,2401,18,0,365,1,6
46390,2,2311,2406,-95,4,43,0,8
46391,2,2380,2479,-99,0,300,0,6
46392,1,2461,2457,4,0,41,1,6
46393,2,2411,2334,77,0,132,0,6
46394,2,2247,2446,-199,0,100,0,8
46395,1,2538,2454,84,0,4,0,6
46396,3,2393,2432,-39,0,207,0,6
46397,2,2456,2398,58,0,207,0,6
46398,2,2401,2459,-58,0,330,1,6
46399,1,2468,2389,79,0,138,0,6
46400,1,2395,2403,-8,0,43,0,6
46401,2,2428,2502,-74,0,112,1,6
46402,1,2350,2425,-75,0,21,0,6
46404,2,2278,2435,-157,0,485,0,6
46405,1,2343,2434,-91,0,13,0,6
46406,1,2604,2527,77,0,242,1,6
46407,2,2465,2405,60,0,102,0,6
46408,2,2569,2672,-103,0,123,1,6
46409,2,2470,2509,-39,0,101,0,6
46410,1,2550,2403,147,0,43,1,6
46411,3,2686,2531,155,0,169,0,6
46412,1,2313,2416,-103,0,396,0,8
46413,1,2388,2433,-45,0,304,0,6
46414,2,2467,2476,-9,0,115,1,6
46415,2,2511,2494,17,0,104,1,6
46416,1,2340,2470,-130,0,1,1,6
46417,2,2326,2466,-140,0,335,0,6
46418,1,2485,2453,32,0,100,0,6
46419,1,2416,2369,47,0,211,0,6
46420,1,2512,2426,86,0,335,0,6
46421,2,2414,2466,-52,0,484,0,6
46422,2,2483,2376,107,0,200,0,6
46423,2,2427,2546,-119,0,40,0,6
46424,1,2408,2390,18,0,0,0,6
46425,1,2284,2455,-171,0,268,0,6
46426,2,2695,2524,171,0,111,1,6
46427,2,2543,2514,29,0,7,1,6
46428,2,2445,2527,-82,0,302,0,6
46429,3,2318,2419,-101,2,202,0,23
46430,2,2384,2425,-41,0,247,0,6
46431,1,2407,2413,-6,0,8,0,6
46432,2,2309,2409,-100,0,306,0,8
46433,2,2427,2404,23,0,248,0,6
46434,1,2405,2428,-23,0,113,0,6
46435,2,2608,2558,50,0,34,1,6
46436,1,2451,2465,-14,0,306,1,6
46437,2,2424,2299,125,0,127,0,6
46438,2,2565,2571,-6,0,140,0,6
46439,2,2266,2555,-289,0,278,0,6
46440,2,2412,2355,57,0,100,0,6
46441,1,2448,2401,47,0,112,1,6
46442,1,2506,2458,48,0,48,0,6
46443,1,2380,2469,-89,0,4,0,6
46444,1,2418,2357,61,0,200,0,6
46445,2,2464,2490,-26,0,45,1,6
46446,2,2471,2409,62,0,151,1,6
46447,1,2416,2448,-32,0,191,0,6
46448,1,2550,2423,127,0,45,0,6
46449,1,2426,2379,47,0,405,0,6
46450,2,2434,2395,39,0,80,0,6
46451,2,2449,2283,166,0,469,0,8
46452,2,2676,2565,111,0,461,1,6
46453,1,2384,2467,-83,0,46,0,6
46454,2,2478,2523,-45,0,300,0,6
46455,1,2439,2361,78,0,456,1,6
46456,1,2447,2301,146,0,112,0,6
46457,1,2683,2608,75,0,131,0,6
46458,2,2482,2462,20,0,10,0,6
46459,1,2494,2383,111,0,1,1,6
46460,1,2527,2472,55,0,490,0,6
46461,1,2459,2306,153,0,57,0,6
46462,1,2383,2476,-93,0,300,0,6
46463,3,2410,2305,105,0,119,0,6
46464,2,2407,2413,-6,0,474,0,6
46465,2,2427,2394,33,0,200,1,6
46466,2,2462,2348,114,0,106,0,6
46467,2,2259,2421,-162,0,8,1,6
46468,1,2381,2525,-144,0,123,1,6
46469,3,2529,2522,7,0,20,0,6
46470,2,2442,2436,6,0,34,0,6
46471,2,2403,2405,-2,0,32,1,6
46472,2,2357,2422,-65,0,41,0,6
46473,2,2402,2467,-65,0,151,0,6
46474,1,2441,2411,30,0,207,0,6
46475,3,2442,2536,-94,0,400,0,6
46476,2,2376,2440,-64,0,2,0,6
46478,1,2255,2435,-180,0,224,0,6
46479,2,2353,2423,-70,0,21,0,6
46480,2,2422,2304,118,0,200,1,6
46481,2,2462,2473,-11,0,101,0,6
46482,1,2479,2364,115,0,211,1,6
46483,3,2469,2391,78,0,200,0,6
46484,2,2565,2511,54,0,111,0,6
46485,1,2518,2413,105,0,40,0,6
46486,2,2297,2450,-153,0,405,0,6
46487,2,2428,2348,80,0,152,0,6
46488,1,2531,2456,75,0,380,1,6
46489,1,2361,2448,-87,0,190,0,6
46490,1,2414,2353,61,0,7,0,6
46491,2,2453,2442,11,0,242,0,6
46492,1,2558,2264,294,0,133,0,6
46493,1,2326,2436,-110,0,57,0,6
46494,1,2278,2453,-175,0,195,0,6
46495,2,2396,2460,-64,0,330,0,6
46496,1,2528,2419,109,0,45,0,6
46497,2,2553,2495,58,0,113,0,6
46498,1,2534,2459,75,0,330,0,6
46499,2,2457,2550,-93,0,302,0,6
46500,3,2474,2204,270,4,45,0,8
46501,2,2572,2668,-96,0,253,1,6
46502,1,2604,2688,-84,0,244,0,6
46503,1,2522,2539,-17,0,483,0,6
46504,2,2416,2468,-52,0,487,0,6
46505,1,2414,2305,109,0,220,0,8
46506,2,2424,2532,-108,0,4,0,6
46507,2,2498,2365,133,0,0,0,6
46508,2,2431,2472,-41,0,147,0,6
46509,2,2460,2277,183,0,110,0,6
46510,3,2474,2409,65,0,333,0,6
46511,2,2406,2446,-40,0,100,1,6
46512,1,2439,2283,156,0,302,0,6
46513,2,2355,2421,-66,0,17,0,6
46514,2,2342,2411,-69,0,103,0,6
46515,1,2518,2532,-14,0,292,1,6
46516,1,2577,2558,19,0,442,0,6
46517,1,2327,2448,-121,0,300,0,6
46518,2,2465,2391,74,0,335,0,6
46519,1,2445,2383,62,0,37,0,6
46520,1,2421,2356,65,0,200,1,6
46521,1,2456,2323,133,4,29,0,16
46522,2,2427,2323,104,0,112,0,6
46523,3,2262,2561,-299,0,278,0,6
46524,1,2450,2445,5,0,190,0,6
46525,2,2355,2535,-180,0,152,0,6
46526,1,2532,2535,-3,0,258,1,6
46527,2,2249,2431,-182,0,49,0,6
46528,2,2442,2355,87,0,40,0,6
46529,1,2681,2611,70,0,101,1,6
46530,1,2518,2311,207,0,48,0,6
46531,1,2501,2457,44,0,40,0,6
46532,2,2532,2479,53,0,307,0,6
46533,1,2254,2441,-187,0,101,0,8
46534,1,2428,2322,106,0,242,1,6
46535,1,2313,2473,-160,0,250,1,6
46536,1,2429,2420,9,0,45,0,6
46537,1,2596,2443,153,0,120,0,6
46538,1,2536,2360,176,0,4,0,6
46539,1,2448,2447,1,0,120,0,6
46540,2,2261,2409,-148,4,100,0,8
46541,2,2532,2454,78,0,300,0,6
46542,1,2319,2453,-134,0,41,0,6
46543,2,2359,2483,-124,0,258,0,6
46544,1,2410,2406,4,0,176,0,6
46545,2,2502,2547,-45,0,245,0,6
46547,2,2392,2468,-76,0,302,0,6
46548,2,2439,2554,-115,0,246,0,6
46549,1,2431,2420,11,0,28,0,6
46550,2,2425,2351,74,0,1,0,6
46551,1,2533,2528,5,0,302,0,6
46552,3,2475,2415,60,0,62,0,6
46553,2,2264,2434,-170,0,106,1,6
46554,1,2473,2411,62,0,171,0,6
46555,1,2673,2568,105,0,487,1,6
46556,1,2415,2383,32,0,132,0,6
46557,2,2451,2391,60,0,302,1,6
46558,2,2402,2409,-7,0,40,1,6
46559,2,2472,2501,-29,0,101,0,6
46560,2,2263,2414,-151,0,339,1,6
46561,1,2553,2538,15,0,125,0,6
46562,1,2451,2490,-39,0,100,0,6
46563,1,2401,2439,-38,0,123,0,6
46564,1,2392,2456,-64,0,46,0,6
46565,1,2472,2387,85,0,200,0,6
46566,2,2398,2538,-140,0,354,0,6
46567,2,2381,2522,-141,0,0,0,6
46568,2,2374,2511,-137,0,38,1,6
46569,1,2362,2435,-73,0,1,0,6
46570,1,2523,2539,-16,0,302,1,6
46571,1,2255,2410,-155,0,153,1,6
46572,2,2526,2524,2,0,487,0,6
46573,1,2402,2426,-24,0,315,1,6
46574,2,2606,2686,-80,0,215,0,6
46575,2,2458,2389,69,0,487,0,6
46576,1,2442,2454,-12,0,242,0,6
46577,2,2406,2478,-72,0,487,1,6
46578,2,2452,2432,20,0,257,0,6
46579,1,2555,2266,289,0,490,0,6
46580,2,2357,2435,-78,0,134,1,6
46581,2,2487,2355,132,0,211,0,6
46582,2,2558,2529,29,0,0,0,6
46583,1,2441,2319,122,0,131,0,6
46584,2,2558,2537,21,0,101,0,6
46585,1,2416,2308,108,0,106,0,6
46586,2,2301,2418,-117,0,454,0,8
46587,1,2485,2525,-40,0,45,0,6
46588,2,2449,2399,50,0,40,0,6
46589,1,2465,2445,20,0,107,0,6
46590,2,2461,2318,143,0,243,0,6
46591,2,2215,2403,-188,0,10,0,6
46592,2,2552,2497,55,0,45,0,6
46593,1,2525,2369,156,0,40,0,6
46594,2,2400,2539,-139,0,250,0,6
46595,2,2278,2401,-123,4,250,1,13
46596,1,2421,2378,43,0,212,0,6
46597,2,2396,2451,-55,0,123,1,6
46598,2,2442,2533,-91,0,168,0,6
46599,2,2373,2405,-32,0,3,0,6
46600,2,2417,2265,152,0,131,0,6
46601,2,2383,2477,-94,0,300,1,6
46602,1,2454,2416,38,0,45,1,6
46603,2,2293,2438,-145,0,84,0,6
46604,1,2470,2347,123,0,49,1,6
46605,1,2690,2602,88,0,164,0,6
46606,1,2433,2408,25,0,0,1,6
46607,1,2416,2428,-12,0,301,0,6
46608,3,2273,2452,-179,0,28,0,6
46609,1,2506,2440,66,0,5,0,6
46610,1,2701,2601,100,0,106,0,6
46611,2,2419,2458,-39,0,200,0,6
46612,2,2564,2677,-113,0,162,1,6
46613,3,2428,2462,-34,0,45,0,6
46614,1,2519,2492,27,0,101,0,6
46615,2,2535,2552,-17,0,7,1,6
46616,2,2440,2334,106,0,404,0,6
46617,1,2542,2398,144,0,346,0,6
46618,3,2304,2438,-134,0,7,0,6
46619,1,2520,2471,49,0,354,0,6
46620,2,2453,2446,7,0,206,0,6
46621,3,2506,2466,40,0,120,0,6
46622,1,2448,2395,53,0,110,1,6
46623,2,2347,2426,-79,0,8,1,6
46624,1,2448,2313,135,0,205,0,6
46625,1,2529,2533,-4,0,107,0,6
46626,3,2427,2367,60,0,122,0,6
46627,1,2626,2602,24,0,140,1,6
46628,1,2411,2427,-16,0,303,0,6
46629,2,2364,2479,-115,0,258,1,6
46630,3,2432,2320,112,0,301,0,8
46631,1,2396,2421,-25,0,4,0,6
46632,2,2264,2557,-293,0,277,0,6
46633,1,2504,2545,-41,0,245,0,6
46634,1,2438,2359,79,0,250,1,6
46635,2,2533,2529,4,0,302,0,6
46636,2,2544,2529,15,0,242,0,6
46638,1,2482,2541,-59,0,247,0,6
46639,1,2422,2422,0,0,338,0,6
46640,1,2366,2404,-38,0,1,0,6
46641,2,2409,2402,7,0,37,0,6
46642,2,2543,2396,147,0,332,1,6
46643,1,2443,2293,150,0,22,0,6
46644,1,2435,2511,-76,0,311,1,6
46645,1,2289,2418,-129,0,27,0,6
46646,2,2326,2474,-148,0,415,0,6
46647,2,2598,2695,-97,0,154,1,6
46648,2,2439,2449,-10,0,234,1,6
46649,1,2330,2426,-96,0,45,1,6
46650,3,2394,2546,-152,0,302,0,6
46651,1,2515,2396,119,0,57,1,6
46652,3,2417,2451,-34,0,48,0,6
46653,1,2487,2524,-37,0,45,1,6
46654,1,2402,2438,-36,0,100,0,6
46655,1,2470,2436,34,0,332,0,6
46656,1,2481,2379,102,0,200,0,6
46657,1,2289,2445,-156,0,111,0,6
46658,2,2467,2506,-39,0,10,0,6
46659,2,2411,2507,-96,0,398,0,6
46660,2,2307,2447,-140,0,4,0,6
46661,2,2330,2413,-83,0,107,1,6
46662,1,2456,2433,23,0,487,1,6
46663,1,2422,2297,125,0,40,0,8
46664,2,2539,2510,29,0,45,1,6
46665,1,2530,2560,-30,0,4,0,6
46666,2,2413,2393,20,0,373,0,6
46667,2,2333,2453,-120,0,1,0,6
46668,1,2526,2349,177,0,52,0,6
46669,2,2438,2390,48,0,335,1,6
46670,2,2376,2466,-90,0,245,1,6
46671,2,2451,2303,148,0,106,0,6
46672,1,2445,2341,104,0,106,1,6
46673,3,2525,2681,-156,0,357,0,6
46674,2,2511,2407,104,0,34,0,6
46675,2,2382,2529,-147,0,210,0,6
46676,1,2528,2452,76,0,4,0,6
46677,2,2429,2354,75,0,359,1,6
46678,1,2560,2262,298,0,211,0,6
46679,2,2416,2428,-12,0,16,1,6
46680,1,2406,2212,194,0,45,0,6
46681,1,2478,2372,106,0,106,1,6
46682,2,2480,2597,-117,0,381,1,6
46683,1,2558,2631,-73,0,0,1,6
46684,1,2379,2471,-92,0,133,1,6
46685,1,2532,2489,43,0,121,0,6
46686,2,2242,2430,-188,0,0,0,8
46687,2,2407,2414,-7,0,351,0,6
46688,1,2543,2360,183,0,4,0,6
46689,1,2421,2504,-83,0,310,0,6
46690,3,2699,2594,105,0,101,0,6
46691,2,2323,2442,-119,0,487,0,6
46692,2,2404,2434,-30,0,135,1,6
46693,2,2455,2323,132,0,135,0,6
46694,2,2403,2431,-28,0,207,0,6
46695,1,2421,2253,168,4,144,0,8
46696,2,2431,2354,77,0,1,0,6
46697,1,2367,2419,-52,0,15,0,6
46698,2,2317,2477,-160,0,300,1,6
46699,2,2457,2391,66,0,200,0,6
46700,1,2532,2409,123,0,1,1,6
46701,1,2447,2343,104,0,197,1,6
46702,2,2368,2426,-58,0,270,0,6
46703,1,2401,2236,165,0,143,1,8
46704,2,2432,2381,51,0,120,0,6
46705,2,2531,2475,56,0,125,0,6
46706,2,2261,2563,-302,0,277,1,6
46707,2,2375,2485,-110,0,300,0,6
46708,2,2518,2493,25,0,246,0,6
46709,1,2587,2600,-13,0,112,0,6
46710,2,2362,2443,-81,0,337,0,6
46711,2,2517,2533,-16,0,113,0,6
46712,2,2511,2462,49,0,120,0,6
46713,2,2427,2327,100,0,40,0,6
46714,1,2470,2363,107,0,40,0,6
46715,1,2412,2357,55,0,133,1,6
46716,2,2484,2539,-55,0,0,1,6
46717,1,2316,2431,-115,0,490,0,6
46718,2,2433,2471,-38,0,0,0,8
46719,1,2678,2528,150,0,302,0,6
46720,2,2396,2461,-65,0,338,1,6
46721,2,2596,2565,31,0,34,0,6
46722,1,2519,2429,90,0,18,1,6
46723,2,2294,2425,-131,0,0,0,8
46724,1,2410,2443,-33,0,46,0,6
46725,2,2601,2624,-23,0,341,0,6
46726,1,2398,2476,-78,0,202,1,6
46727,1,2434,2546,-112,0,302,0,6
46728,2,2460,2368,92,0,106,1,6
46729,2,2497,2529,-32,0,369,0,6
46730,3,2410,2310,100,0,131,0,6
46731,1,2504,2512,-8,0,426,1,6
46732,3,2357,2535,-178,0,250,0,6
46733,1,2331,2447,-116,0,278,0,6
46734,2,2451,2446,5,0,466,0,6
46735,2,2399,2449,-50,0,40,0,6
46736,1,2442,2535,-93,0,242,0,6
46737,2,2595,2697,-102,0,154,1,6
46738,1,2474,2319,155,0,327,0,6
46739,1,2420,2402,18,0,57,1,6
46740,1,2429,2290,139,0,0,0,8
46741,2,2202,2422,-220,0,304,0,6
46742,1,2651,2417,234,0,123,0,6
46743,1,2333,2451,-118,0,132,0,6
46744,2,2361,2439,-78,0,130,0,6
46745,2,2437,2228,209,0,339,1,6
46746,2,2405,2447,-42,0,255,1,6
46747,1,2489,2371,118,0,200,0,6
46748,1,2482,2524,-42,0,100,1,6
46749,1,2349,2420,-71,0,110,0,6
46750,2,2469,2504,-35,0,10,0,6
46751,2,2499,2512,-13,0,45,0,6
46752,1,2557,2535,22,0,300,0,6
46753,3,2534,2492,42,0,311,0,6
46754,2,2538,2511,27,0,337,0,6
46755,1,2392,2530,-138,0,45,1,6
46756,1,2317,2441,-124,0,8,1,6
46757,3,2372,2417,-45,0,46,0,6
46758,2,2418,2307,111,0,485,0,6
46759,2,2437,2535,-98,0,109,0,6
46760,2,2436,2397,39,0,295,0,6
46761,1,2536,2392,144,0,8,0,6
46762,2,2428,2287,141,0,0,0,8
46763,1,2312,2477,-165,0,107,1,8
46764,2,2404,2590,-186,0,112,0,6
46765,2,2428,2387,41,0,43,0,6
46766,2,2524,2682,-158,0,341,0,6
46767,3,2532,2359,173,0,200,0,6
46768,2,2439,2339,100,0,131,0,6
46769,2,2324,2427,-103,0,20,0,6
46770,1,2671,2595,76,0,145,0,6
46771,1,2443,2364,79,0,190,0,6
46772,3,2376,2452,-76,0,1,0,6
46773,1,2293,2450,-157,0,307,0,6
46774,2,2469,2654,-185,0,484,1,6
46775,1,2447,2523,-76,0,107,1,6
46776,1,2446,2353,93,0,119,0,6
46777,3,2527,2701,-174,0,300,0,6
46778,2,2506,2450,56,0,5,0,6
46779,1,2539,2532,7,0,4,0,6
46780,2,2367,2493,-126,0,300,0,6
46781,3,2591,2534,57,0,106,0,6
46782,2,2510,2450,60,0,56,0,6
46783,2,2492,2479,13,0,5,1,6
46784,1,2405,2466,-61,0,125,1,6
46785,1,2444,2370,74,0,132,0,6
46786,1,2411,2404,7,0,485,0,6
46787,1,2295,2420,-125,0,100,0,8
46788,1,2452,2400,52,0,207,1,6
46789,2,2413,2346,67,0,311,0,6
46790,2,2396,2425,-29,0,454,0,6
46791,2,2478,2356,122,0,108,0,6
46792,1,2445,2357,88,0,46,1,6
46793,1,2517,2532,-15,0,245,1,6
46794,2,2473,2335,138,0,339,1,6
46795,1,2532,2395,137,0,310,0,6
46796,1,2203,2469,-266,0,45,1,6
46797,1,2379,2448,-69,0,50,0,6
46798,1,2388,2539,-151,0,40,0,6
46799,1,2424,2329,95,0,49,1,6
46800,1,2416,2306,110,0,113,0,6
46801,1,2408,2424,-16,0,241,0,6
46802,2,2456,2372,84,0,100,0,6
46803,1,2448,2276,172,0,107,0,6
46804,1,2286,2433,-147,0,40,1,8
46805,2,2529,2631,-102,0,4,0,6
46806,1,2518,2499,19,0,310,0,6
46807,2,2388,2473,-85,0,207,0,5
46808,2,2363,2464,-101,0,5,0,6
46809,1,2433,2521,-88,0,301,0,6
46810,3,2593,2401,192,0,120,0,6
46811,3,2425,2663,-238,0,310,0,6
46812,1,2462,2338,124,0,315,0,8
46813,1,2488,2325,163,0,106,0,6
46814,2,2346,2432,-86,0,278,0,6
46815,1,2442,2374,68,4,200,0,13
46816,1,2591,2685,-94,0,342,1,6
46817,1,2537,2362,175,0,84,0,6
46818,1,2451,2377,74,0,40,0,6
46819,2,2431,2448,-17,0,80,0,6
46820,2,2434,2449,-15,0,338,0,6
46821,1,2497,2363,134,0,200,0,6
46822,2,2540,2544,-4,0,20,0,6
46823,1,2699,2630,69,0,101,0,6
46824,2,2413,2249,164,0,101,0,8
46825,2,2246,2432,-186,4,111,0,8
46826,2,2431,2391,40,0,178,0,6
46827,2,2460,2523,-63,0,405,0,6
46828,1,2377,2429,-52,0,302,0,6
46829,2,2485,2486,-1,0,0,1,6
46830,1,2535,2590,-55,0,400,0,6
46831,1,2657,2640,17,0,123,0,6
46832,2,2463,2466,-3,0,207,1,6
46833,2,2395,2457,-62,0,123,1,6
46834,2,2462,2530,-68,0,223,0,6
46835,1,2380,2470,-90,0,46,0,6
46836,2,2373,2449,-76,0,300,0,6
46837,1,2635,2675,-40,0,88,0,6
46838,2,2526,2524,2,0,113,0,6
46839,2,2360,2500,-140,0,300,0,6
46840,2,2451,2412,39,0,205,0,6
46841,1,2364,2406,-42,0,41,0,6
46842,2,2459,2391,68,0,310,0,6
46843,1,2408,2338,70,0,8,0,8
46844,2,2292,2455,-163,0,113,0,6
46845,2,2395,2420,-25,0,442,0,6
46846,2,2421,2350,71,0,487,0,6
46847,1,2372,2456,-84,0,0,1,6
46848,1,2437,2342,95,0,131,0,6
46849,2,2525,2514,11,0,345,1,6
46850,1,2407,2474,-67,0,4,0,6
46851,2,2366,2404,-38,0,150,0,6
46852,1,2454,2440,14,0,107,0,6
46853,1,2397,2405,-8,0,40,1,6
46854,1,2359,2451,-92,0,122,0,6
46855,2,2322,2491,-169,0,5,0,6
46856,3,2455,2428,27,0,102,0,6
46857,1,2468,2293,175,0,140,1,8
46858,2,2441,2292,149,0,1,0,6
46859,1,2435,2426,9,0,222,0,6
46860,1,2554,2478,76,0,394,1,6
46861,2,2389,2455,-66,0,130,0,6
46862,2,2635,2703,-68,0,190,1,6
46863,2,2550,2534,16,0,333,0,6
46864,1,2456,2598,-142,0,301,0,6
46865,1,2499,2429,70,0,57,0,6
46866,1,2516,2662,-146,0,27,1,6
46867,2,2528,2417,111,0,448,1,6
46868,2,2213,2401,-188,0,304,0,8
46869,2,2398,2424,-26,0,454,0,6
46870,1,2409,2283,126,0,148,1,6
46871,2,2478,2395,83,0,0,0,5
46872,2,2504,2356,148,0,200,0,6
46873,1,2405,2262,143,4,315,0,13
46874,2,2362,2414,-52,0,242,1,6
46875,1,2678,2492,186,0,311,0,6
46876,1,2462,2390,72,0,211,0,6
46877,1,2584,2541,43,0,106,1,6
46878,2,2495,2479,16,0,127,0,6
46879,2,2401,2296,105,0,40,1,6
46880,1,2335,2422,-87,4,240,0,13
46881,2,2448,2535,-87,0,4,0,6
46882,2,2349,2417,-68,0,10,1,6
46883,1,2540,2544,-4,0,15,0,6
46884,2,2276,2414,-138,0,45,0,6
46885,3,2463,2466,-3,0,302,0,6
46886,2,2418,2517,-99,0,45,1,6
46887,2,2426,2472,-46,0,242,0,6
46888,1,2299,2442,-143,0,111,0,6
46889,1,2468,2359,109,0,15,0,6
46890,2,2458,2561,-103,0,101,0,6
46891,1,2398,2453,-55,0,310,1,6
46892,1,2370,2444,-74,0,244,0,6
46893,1,2669,2625,44,0,101,0,6
46894,1,2453,2375,78,0,79,0,6
46895,2,2376,2503,-127,0,152,0,6
46896,3,2403,2336,67,0,28,0,6
46897,2,2424,2457,-33,0,404,0,6
46898,2,2363,2400,-37,0,330,0,6
46899,1,2520,2520,0,0,331,0,6
46900,1,2466,2294,172,0,200,0,8
46901,1,2420,2425,-5,0,405,1,6
46902,1,2338,2441,-103,0,278,1,6
46903,1,2449,2380,69,0,40,0,6
46904,3,2400,2421,-21,0,404,0,6
46905,1,2444,2366,78,0,207,1,6
46906,3,2546,2641,-95,0,14,0,6
46907,1,2514,2526,-12,0,6,1,6
46908,2,2364,2496,-132,0,300,0,6
46909,2,2386,2467,-81,0,250,0,6
46910,3,2459,2434,25,0,109,0,6
46911,2,2590,2588,2,0,306,1,6
46912,2,2459,2382,77,0,196,0,6
46913,3,2296,2463,-167,0,404,0,6
46914,1,2466,2630,-164,0,324,0,6
46915,3,2426,2355,71,0,4,0,6
46916,1,2418,2524,-106,0,125,0,6
46917,1,2392,2438,-46,0,485,0,6
46918,1,2681,2708,-27,0,345,1,6
46919,1,2539,2464,75,0,45,0,6
46920,2,2428,2443,-15,0,331,0,6
46921,3,2489,2459,30,0,5,0,6
46922,3,2435,2422,13,0,301,0,6
46923,1,2439,2521,-82,0,167,0,6
46924,1,2540,2397,143,0,106,0,6
46925,1,2459,2474,-15,0,311,1,6
46926,1,2280,2413,-133,0,27,1,6
46927,1,2375,2433,-58,0,1,0,6
46928,2,2255,2402,-147,0,31,1,6
46929,1,2471,2418,53,0,248,1,6
46931,1,2413,2350,63,4,255,0,13
46932,1,2322,2421,-99,0,4,1,6
46933,2,2582,2651,-69,0,107,0,6
46934,1,2536,2589,-53,0,400,0,6
46935,2,2358,2419,-61,0,57,0,6
46936,1,2503,2344,159,0,311,1,6
46937,1,2422,2359,63,0,14,0,6
46938,2,2449,2377,72,0,133,0,6
46939,2,2450,2422,28,0,194,0,6
46940,2,2355,2472,-117,0,48,0,6
46941,2,2449,2463,-14,0,100,0,6
46942,1,2472,2291,181,0,200,0,8
46943,1,2426,2349,77,0,337,1,6
46944,3,2402,2400,2,0,10,0,6
46945,2,2431,2357,74,0,190,0,6
46946,2,2362,2448,-86,0,120,0,6
46947,2,2507,2453,54,0,483,0,6
46948,1,2453,2399,54,0,122,0,6
46949,2,2514,2446,68,0,310,1,6
46950,2,2620,2640,-20,0,133,0,6
46951,3,2352,2420,-68,0,426,0,6
46952,1,2544,2548,-4,0,332,0,6
46953,1,2361,2460,-99,0,0,1,6
46954,3,2405,2539,-134,0,45,0,6
46955,1,2389,2544,-155,0,242,0,6
46956,1,2477,2337,140,0,41,0,6
46957,1,2419,2440,-21,0,13,0,6
46958,1,2520,2520,0,0,95,0,6
46959,2,2460,2585,-125,0,301,0,6
46960,1,2485,2594,-109,0,300,0,6
46961,2,2517,2452,65,0,21,0,6
46962,1,2582,2543,39,0,106,0,6
46963,2,2406,2457,-51,0,338,0,6
46964,3,2419,2400,19,0,103,0,6
46965,1,2459,2382,77,0,106,0,6
46966,2,2489,2489,0,0,8,1,6
46967,1,2702,2687,15,0,265,0,6
46968,1,2413,2253,160,0,4,0,6
46969,1,2434,2345,89,0,132,0,6
46970,1,2476,2349,127,0,101,0,6
46971,1,2372,2465,-93,0,226,0,6
46972,1,2468,2425,43,0,48,0,6
46973,1,2317,2444,-127,0,96,0,6
46974,1,2405,2378,27,0,6,0,6
46975,2,2485,2414,71,0,103,0,6
46976,2,2656,2497,159,0,300,0,6
46977,2,2453,2357,96,0,181,1,6
46978,3,2394,2458,-64,0,485,0,6
46979,1,2424,2353,71,0,311,0,6
46980,1,2377,2444,-67,0,121,0,6
46981,1,2426,2261,165,0,7,0,6
46982,2,2468,2443,25,0,224,0,6
46983,1,2587,2521,66,0,156,0,6
46984,2,2388,2510,-122,0,0,0,6
46985,2,2459,2378,81,0,234,0,6
46986,2,2341,2419,-78,4,240,0,13
46987,2,2460,2501,-41,0,190,1,6
46988,2,2341,2438,-97,0,278,0,6
46989,2,2429,2402,27,0,487,0,6
46990,2,2400,2377,23,0,43,0,6
46991,2,2645,2559,86,0,56,0,6
46992,2,2352,2464,-112,0,145,0,6
46993,2,2536,2542,-6,0,300,0,6
46994,2,2483,2397,86,0,46,1,6
46995,2,2294,2435,-141,0,310,0,6
46996,1,2442,2240,202,4,100,1,8
46997,2,2458,2431,27,0,400,0,6
46998,2,2317,2405,-88,0,200,0,6
46999,1,2588,2480,108,0,331,0,6
47000,2,2296,2425,-129,4,51,0,13
47001,1,2426,2324,102,0,10,0,6
47002,1,2507,2587,-80,0,333,0,6
47003,1,2476,2453,23,0,254,1,6
47004,3,2397,2422,-25,0,122,0,6
47005,1,2592,2453,139,0,35,0,6
47006,3,2442,2337,105,0,135,0,6
47007,2,2274,2409,-135,4,274,0,13
47008,1,2514,2526,-12,0,302,0,6
47009,1,2537,2407,130,0,214,0,6
47010,3,2416,2385,31,0,8,0,6
47013,3,2481,2388,93,0,484,0,6
47014,1,2473,2473,0,0,46,1,6
47015,1,2539,2456,83,0,100,1,6
47016,1,2420,2384,36,0,148,0,6
47017,1,2479,2514,-35,0,157,1,6
47018,2,2250,2416,-166,0,153,0,6
47019,1,2388,2424,-36,0,277,0,6
47020,2,2251,2416,-165,0,40,0,6
47021,1,2483,2552,-69,0,46,0,6
47022,2,2374,2422,-48,0,231,0,6
47023,2,2383,2507,-124,0,1,0,6
47024,2,2293,2423,-130,0,454,1,6
47025,2,2368,2438,-70,0,22,0,6
47026,1,2318,2471,-153,0,201,0,5
47027,1,2468,2409,59,0,167,0,6
47028,3,2475,2462,13,0,190,0,6
47029,1,2430,2436,-6,0,4,0,6
47030,1,2494,2490,4,0,250,0,6
47031,2,2450,2545,-95,0,108,0,6
47032,1,2548,2530,18,0,310,0,6
47033,1,2580,2514,66,0,244,0,6
47034,2,2365,2445,-80,0,130,0,6
47035,1,2648,2452,196,0,90,0,6
47036,3,2418,2299,119,0,205,0,6
47037,2,2320,2430,-110,0,4,0,6
47038,1,2323,2429,-106,0,4,0,6
47039,2,2319,2475,-156,0,41,0,8
47040,2,2568,2489,79,0,5,0,6
47041,1,2386,2412,-26,0,156,1,6
47042,2,2261,2439,-178,0,112,0,6
47043,1,2457,2395,62,0,122,0,6
47044,1,2505,2596,-91,0,133,0,6
47045,1,2638,2512,126,0,85,0,6
47046,1,2411,2345,66,0,110,1,6
47047,1,2463,2338,125,0,7,0,5
47048,2,2451,2320,131,0,330,0,6
47049,1,2476,2364,112,0,48,1,6
47050,2,2523,2486,37,0,103,0,6
47051,1,2328,2421,-93,0,120,0,6
47052,1,2479,2455,24,0,332,0,6
47053,1,2520,2520,0,0,331,1,6
47054,1,2418,2302,116,0,4,0,6
47055,1,2448,2481,-33,0,337,0,6
47056,2,2437,2492,-55,0,386,0,6
47057,2,2391,2462,-71,0,40,1,6
47058,1,2642,2479,163,0,337,0,6
47059,1,2511,2379,132,0,106,0,6
47061,2,2508,2508,0,0,40,0,6
47062,2,2426,2485,-59,0,127,0,6
47063,2,2452,2544,-92,0,45,1,6
47064,2,2449,2430,19,0,205,1,6
47065,2,2329,2467,-138,0,112,0,5
47066,1,2452,2229,223,0,4,0,6
47067,1,2484,2436,48,0,5,0,6
47068,1,2412,2476,-64,0,310,1,6
47069,2,2553,2645,-92,0,14,0,6
47070,1,2419,2346,73,0,185,1,6
47071,2,2434,2316,118,0,10,0,6
47072,2,2509,2585,-76,0,341,0,6
47073,1,2421,2426,-5,0,453,0,6
47074,1,2419,2278,141,0,353,1,6
47075,1,2441,2554,-113,0,190,0,6
47076,2,2550,2445,105,0,278,0,6
47077,1,2450,2360,90,0,100,1,6
47078,1,2589,2444,145,0,28,0,6
47079,2,2404,2416,-12,0,21,1,6
47080,1,2475,2502,-27,0,103,1,6
47081,1,2462,2368,94,0,310,1,6
47082,3,2422,2398,24,0,120,0,6
47083,2,2514,2516,-2,0,123,0,6
47084,3,2450,2459,-9,0,250,0,6
47085,2,2512,2762,-250,0,193,0,6
47086,2,2542,2531,11,0,103,0,6
47087,2,2341,2423,-82,0,20,1,6
47088,2,2475,2453,22,0,245,0,6
47089,1,2273,2425,-152,0,487,0,8
47090,1,2496,2561,-65,0,103,0,6
47091,2,2420,2489,-69,0,267,0,6
47092,1,2440,2431,9,0,49,0,6
47093,1,2421,2368,53,0,492,1,6
47094,2,2346,2421,-75,0,302,1,6
47095,2,2360,2480,-120,0,34,0,6
47096,1,2490,2427,63,0,103,0,6
47097,1,2592,2500,92,0,22,0,6
47098,2,2514,2526,-12,0,331,1,6
47099,3,2359,2505,-146,0,264,0,6
47100,2,2328,2467,-139,0,427,0,6
47101,1,2467,2386,81,0,57,0,6
47102,2,2683,2707,-24,0,345,0,6
47103,2,2227,2455,-228,0,106,0,6
47104,2,2514,2549,-35,0,302,0,6
47105,3,2536,2650,-114,0,278,0,6
47106,3,2476,2609,-133,0,335,0,6
47107,2,2443,2450,-7,0,144,0,6
47108,1,2508,2537,-29,0,111,0,6
47109,1,2437,2318,119,0,106,0,6
47110,2,2450,2416,34,0,404,1,6
47111,1,2430,2330,100,0,180,1,6
47112,2,2454,2422,32,0,110,1,6
47113,2,2414,2335,79,0,4,0,6
47114,1,2324,2431,-107,0,8,1,6
47115,3,2494,2436,58,0,7,0,6
47116,1,2360,2481,-121,0,337,0,6
47117,2,2496,2384,112,0,469,1,6
47118,1,2546,2422,124,0,241,0,6
47119,2,2457,2225,232,0,1,0,6
47120,2,2456,2484,-28,0,210,0,6
47121,2,2500,2438,62,0,130,0,6
47122,2,2459,2469,-10,0,131,0,6
47123,2,2422,2494,-72,0,454,0,6
47124,1,2249,2419,-170,0,229,0,6
47125,2,2277,2432,-155,0,248,1,6
47126,2,2234,2451,-217,4,100,0,8
47127,3,2404,2502,-98,0,264,0,6
47128,2,2319,2496,-177,0,265,1,6
47129,2,2418,2550,-132,0,151,0,6
47130,2,2420,2597,-177,0,15,0,6
47131,1,2440,2317,123,0,302,0,6
47132,1,2531,2509,22,0,354,0,6
47133,2,2467,2446,21,0,414,0,6
47134,1,2607,2254,353,0,101,0,6
47135,2,2426,2372,54,0,218,0,6
47136,2,2277,2423,-146,0,242,1,6
47137,1,2382,2471,-89,0,40,0,6
47138,1,2712,2677,35,0,162,0,6
47139,1,2353,2522,-169,0,150,1,6
47140,1,2398,2421,-23,0,110,0,6
47141,1,2648,2510,138,0,344,0,6
47142,2,2359,2538,-179,0,108,0,6
47143,1,2554,2509,45,0,14,0,6
47144,1,2474,2367,107,0,0,0,6
47145,3,2468,2559,-91,0,249,0,8
47146,1,2411,2388,23,0,1,0,6
47147,1,2765,2514,251,0,10,0,6
47148,1,2389,2499,-110,0,267,0,6
47149,2,2493,2437,56,0,7,0,6
47150,2,2423,2331,92,0,88,0,6
47151,2,2489,2499,-10,0,469,1,6
47152,1,2554,2592,-38,0,7,0,6
47153,1,2448,2402,46,0,107,1,6
47154,1,2454,2445,9,0,130,0,6
47155,1,2471,2419,52,0,16,0,6
47156,3,2554,2414,140,0,101,0,6
47158,1,2490,2341,149,0,300,0,6
47159,2,2410,2258,152,0,41,0,6
47160,1,2389,2417,-28,0,380,1,6
47161,1,2395,2422,-27,0,437,0,6
47162,1,2400,2434,-34,0,200,0,6
47163,1,2405,2429,-24,4,240,0,13
47164,1,2417,2298,119,0,306,1,8
47165,2,2470,2362,108,0,246,0,5
47166,2,2334,2464,-130,0,263,0,6
47167,1,2304,2402,-98,0,466,0,6
47168,3,2452,2406,46,0,62,0,6
47169,2,2512,2652,-140,0,40,0,6
47170,1,2409,2338,71,0,15,0,6
47171,2,2672,2717,-45,0,31,0,6
47172,2,2260,2444,-184,0,110,1,6
47173,2,2480,2353,127,0,474,0,6
47174,2,2478,2399,79,0,100,0,6
47175,2,2559,2767,-208,0,20,0,6
47176,2,2489,2356,133,0,217,0,6
47177,1,2491,2483,8,0,242,0,6
47178,1,2338,2416,-78,0,5,1,6
47179,1,2546,2490,56,0,0,0,6
47180,2,2586,2560,26,0,103,0,6
47181,2,2444,2487,-43,0,11,0,6
47182,2,2338,2493,-155,0,40,0,6
47183,1,2416,2483,-67,0,140,1,6
47184,2,2439,2364,75,0,103,0,6
47185,2,2268,2402,-134,0,221,0,6
47186,1,2468,2331,137,0,284,1,6
47187,2,2436,2459,-23,0,331,0,6
47188,1,2503,2426,77,0,320,0,6
47189,1,2545,2509,36,0,111,0,6
47190,2,2655,2453,202,0,49,0,6
47191,2,2360,2418,-58,0,8,1,6
47192,2,2383,2417,-34,0,100,0,6
47193,3,2517,2461,56,0,123,0,6
47194,2,2411,2395,16,0,138,1,6
47195,2,2477,2471,6,0,337,0,6
47196,1,2554,2474,80,0,130,0,6
47197,1,2492,2439,53,0,7,0,6
47198,2,2401,2267,134,0,43,1,6
47199,2,2497,2478,19,0,112,0,6
47200,2,2722,2667,55,0,274,0,6
47201,2,2386,2451,-65,0,409,0,6
47202,2,2559,2556,3,0,201,0,6
47203,2,2371,2414,-43,0,104,1,6
47204,1,2416,2432,-16,0,4,0,6
47205,1,2406,2360,46,0,0,0,6
47206,3,2409,2345,64,0,88,0,6
47207,2,2496,2334,162,0,302,1,6
47208,2,2425,2412,13,4,335,0,13
47209,2,2412,2541,-129,0,107,0,6
47210,1,2508,2328,180,0,477,0,6
47211,1,2770,2576,194,0,25,1,6
47212,2,2470,2559,-89,0,132,0,6
47213,2,2326,2423,-97,0,0,0,6
47214,2,2674,2716,-42,0,487,0,6
47215,1,2477,2471,6,0,256,1,6
47216,2,2368,2476,-108,0,102,0,6
47217,2,2327,2472,-145,0,263,0,6
47218,1,2465,2430,35,0,277,1,6
47219,1,2383,2481,-98,0,245,1,6
47220,2,2504,2647,-143,0,46,0,6
47221,1,2402,2325,77,0,140,1,6
47222,1,2484,2491,-7,0,6,0,6
47223,2,2352,2405,-53,0,30,0,6
47224,1,2459,2229,230,4,125,0,8
47225,2,2423,2396,27,0,41,0,6
47226,2,2362,2411,-49,0,40,0,6
47227,2,2288,2434,-146,0,3,0,6
47228,2,2430,2497,-67,0,315,0,6
47229,3,2461,2388,73,0,487,0,6
47230,2,2419,2250,169,0,20,0,6
47231,2,2346,2408,-62,0,8,0,6
47232,2,2563,2445,118,0,106,1,6
47233,2,2428,2480,-52,0,105,0,6
47234,1,2422,2412,10,4,215,1,13
47235,2,2567,2580,-13,0,7,0,6
47236,2,2562,2674,-112,0,10,0,6
47237,2,2475,2324,151,0,336,0,6
47238,1,2545,2438,107,0,278,1,6
47239,2,2394,2421,-27,0,101,0,8
47240,1,2721,2669,52,0,194,0,6
47241,1,2300,2443,-143,0,4,0,6
47242,1,2422,2292,130,0,194,0,6
47243,2,2407,2425,-18,0,278,1,6
47244,1,2408,2328,80,0,84,0,6
47245,1,2498,2407,91,0,112,0,6
47246,3,2586,2558,28,0,208,0,6
47247,2,2235,2404,-169,0,100,0,6
47249,1,2650,2500,150,0,141,1,6
47250,1,2485,2490,-5,0,112,0,6
47251,3,2434,2470,-36,0,295,0,6
47252,1,2485,2302,183,0,436,0,6
47253,1,2511,2416,95,0,41,0,6
47254,2,2423,2375,48,0,241,0,6
47255,2,2304,2405,-101,0,331,0,6
47256,2,2410,2347,63,0,4,1,6
47257,2,2412,2359,53,0,200,0,6
47258,2,2360,2488,-128,0,210,1,6
47259,2,2592,2772,-180,0,156,0,6
47260,2,2407,2375,32,0,100,0,6
47261,2,2474,2425,49,0,258,0,6
47262,1,2259,2410,-151,0,487,0,6
47263,2,2413,2332,81,0,40,0,6
47264,2,2239,2467,-228,4,4,0,8
47265,1,2274,2413,-139,0,260,1,6
47266,2,2271,2425,-154,0,57,0,6
47267,1,2664,2726,-62,0,48,0,6
47268,3,2456,2556,-100,0,374,0,6
47269,2,2371,2460,-89,0,2,0,6
47270,1,2469,2332,137,0,269,0,6
47271,2,2412,2515,-103,0,0,0,6
47272,1,2413,2302,111,0,4,0,8
47273,2,2392,2462,-70,0,16,0,6
47274,1,2382,2416,-34,0,107,0,6
47275,1,2434,2357,77,0,11,0,6
47276,2,2607,2615,-8,0,101,0,6
47277,2,2559,2586,-27,0,20,0,6
47278,2,2549,2503,46,0,156,0,6
47279,2,2484,2491,-7,0,6,0,6
47280,1,2430,2401,29,0,404,0,6
47281,2,2435,2402,33,0,338,0,6
47282,2,2426,2388,38,0,107,1,8
47283,2,2469,2435,34,0,151,0,6
47284,1,2480,2367,113,0,256,0,6
47285,2,2488,2388,100,0,306,1,6
47286,2,2509,2654,-145,0,133,0,6
47287,1,2356,2402,-46,0,102,0,6
47288,1,2465,2393,72,0,310,1,6
47289,1,2438,2422,16,0,13,0,6
47290,2,2585,2561,24,0,103,0,6
47291,1,2417,2300,117,0,454,0,6
47292,1,2348,2428,-80,0,218,0,6
47293,1,2409,2239,170,0,330,0,6
47294,2,2410,2388,22,0,130,0,6
47295,2,2425,2277,148,0,152,1,6
47296,1,2432,2468,-36,0,485,0,6
47297,1,2403,2401,2,0,14,1,6
47298,2,2330,2429,-99,0,190,0,6
47299,2,2467,2589,-122,0,225,0,6
47300,1,2339,2406,-67,0,15,0,6
47301,3,2446,2233,213,0,114,0,8
47302,2,2591,2554,37,0,333,0,6
47303,1,2621,2601,20,0,153,0,6
47304,1,2554,2458,96,0,106,0,6
47305,1,2719,2671,48,0,279,0,6
47306,1,2678,2776,-98,0,156,0,6
47307,1,2417,2245,172,0,4,0,6
47308,3,2363,2484,-121,0,3,0,6
47309,1,2497,2328,169,0,244,0,6
47310,2,2441,2463,-22,0,143,0,6
47311,2,2408,2479,-71,0,0,1,6
47312,3,2402,2408,-6,0,120,0,6
47313,2,2392,2404,-12,0,143,0,6
47314,2,2497,2519,-22,0,377,0,6
47315,2,2381,2421,-40,0,8,0,6
47316,2,2436,2563,-127,0,306,0,6
47317,3,2488,2363,125,0,84,0,6
47318,1,2433,2481,-48,0,4,1,6
47319,1,2332,2405,-73,0,48,0,6
47320,2,2487,2506,-19,0,150,1,6
47321,1,2453,2558,-105,0,4,0,6
47322,2,2400,2420,-20,0,145,1,6
47323,1,2657,2469,188,0,338,0,6
47324,3,2362,2409,-47,0,242,0,6
47325,2,2596,2626,-30,0,101,0,6
47326,1,2516,2461,55,0,265,0,6
47327,1,2560,2585,-25,0,20,0,6
47328,1,2463,2469,-6,0,203,1,6
47329,1,2666,2724,-58,0,487,1,6
47330,1,2468,2436,32,0,151,1,6
47331,2,2491,2500,-9,0,302,0,6
47332,2,2315,2413,-98,0,100,0,6
47333,1,2768,2660,108,0,404,0,6
47334,1,2482,2365,117,0,211,1,6
47335,2,2355,2507,-152,0,112,0,6
47336,2,2265,2417,-152,0,16,0,6
47337,2,2221,2417,-196,0,242,0,6
47338,1,2466,2521,-55,0,335,0,6
47339,1,2408,2284,124,0,8,1,6
47340,2,2398,2494,-96,0,211,0,6
47341,2,2454,2420,34,0,463,1,8
47342,1,2579,2566,13,0,218,0,6
47343,1,2486,2432,54,0,345,0,6
47344,1,2551,2462,89,0,106,0,6
47345,2,2257,2440,-183,0,125,0,6
47346,3,2377,2475,-98,0,461,0,6
47347,1,2631,2590,41,0,153,0,6
47348,1,2426,2339,87,0,314,0,6
47349,2,2465,2319,146,0,380,0,6
47350,1,2506,2686,-180,0,112,1,6
47351,2,2286,2404,-118,0,4,0,6
47352,1,2420,2301,119,0,110,0,6
47353,2,2341,2404,-63,0,15,1,6
47355,1,2702,2382,320,0,244,0,6
47356,1,2377,2401,-24,0,110,0,6
47357,1,2469,2545,-76,0,190,0,6
47358,3,2298,2463,-165,0,120,0,6
47359,2,2718,2673,45,0,295,0,6
47360,1,2679,2350,329,0,20,0,6
47362,2,2561,2585,-24,0,20,0,6
47363,1,2431,2401,30,0,177,0,6
47364,1,2443,2474,-31,0,4,0,6
47365,2,2361,2486,-125,0,2,0,6
47366,1,2471,2256,215,0,43,0,6
47367,2,2408,2349,59,0,106,0,6
47368,1,2457,2555,-98,0,373,0,6
47369,2,2335,2457,-122,0,46,0,6
47370,1,2656,2514,142,0,156,0,6
47371,2,2293,2422,-129,0,241,0,6
47372,1,2456,2320,136,0,258,1,6
47373,2,2346,2412,-66,0,242,1,6
47374,2,2427,2430,-3,0,57,0,6
47375,1,2473,2320,153,0,28,0,6
47376,2,2253,2420,-167,0,225,0,6
47377,1,2344,2403,-59,0,122,0,6
47378,1,2473,2486,-13,0,331,1,6
47379,2,2677,2772,-95,0,156,1,6
47380,1,2590,2555,35,0,215,0,6
47381,2,2490,2476,14,0,210,0,6
47382,1,2407,2291,116,0,0,0,6
47383,3,2409,2336,73,0,458,0,6
47384,2,2660,2515,145,0,121,0,6
47385,2,2511,2490,21,0,245,0,6
47386,1,2396,2436,-40,0,61,0,6
47387,1,2449,2444,5,0,6,1,6
47388,2,2455,2538,-83,0,110,0,6
47389,2,2503,2367,136,0,200,0,6
47390,1,2454,2357,97,0,85,1,6
47391,1,2301,2482,-181,0,255,1,6
47392,2,2567,2679,-112,0,301,1,6
47393,2,2384,2496,-112,0,400,0,6
47394,1,2505,2421,84,0,241,1,6
47395,1,2550,2595,-45,0,20,0,6
47396,2,2548,2466,82,0,106,1,6
47397,2,2426,2436,-10,0,113,1,8
47398,1,2680,2225,455,0,484,0,6
47399,1,2436,2422,14,0,314,0,6
47400,3,2430,2461,-31,0,194,0,6
47401,2,2411,2402,9,0,0,1,6
47402,1,2536,2214,322,0,108,0,6
47403,2,2316,2460,-144,0,265,0,6
47404,2,2317,2426,-109,0,241,0,6
47405,2,2357,2524,-167,0,106,0,6
47406,2,2476,2460,16,0,60,0,6
47407,2,2355,2401,-46,0,123,1,6
47408,2,2375,2496,-121,0,200,0,6
47409,2,2423,2402,21,0,172,1,6
47410,1,2480,2479,1,0,305,0,6
47411,3,2416,2430,-14,0,490,0,6
47412,1,2673,2726,-53,0,289,1,6
47413,1,2589,2557,32,0,215,0,6
47414,1,2392,2442,-50,0,135,1,6
47415,2,2337,2408,-71,0,15,0,6
47416,1,2400,2430,-30,0,6,0,6
47417,1,2777,2652,125,0,335,0,6
47418,3,2438,2455,-17,0,27,0,6
47419,1,2410,2300,110,0,112,0,6
47420,1,2500,2509,-9,0,152,1,6
47421,1,2523,2563,-40,0,241,0,6
47422,2,2443,2237,206,0,113,0,8
47423,1,2473,2380,93,0,115,1,6
47424,3,2683,2648,35,0,404,0,6
47425,1,2705,2225,480,0,201,0,6
47426,2,2284,2681,-397,0,4,0,6
47427,1,2464,2313,151,0,258,1,6
47428,2,2474,2541,-67,0,455,0,6
47429,3,2416,2441,-25,0,57,0,6
47430,1,2499,2371,128,0,121,1,6
47431,2,2402,2309,93,0,302,0,6
47432,1,2466,2301,165,0,110,0,6
47433,2,2471,2381,90,0,10,1,6
47434,1,2408,2406,2,0,40,0,6
47435,1,2473,2486,-13,0,331,1,6
47436,1,2402,2462,-60,0,145,0,6
47437,1,2430,2489,-59,0,113,0,6
47438,2,2412,2333,79,0,40,0,6
47439,2,2527,2451,76,0,0,0,6
47440,1,2556,2430,126,0,0,0,6
47441,1,2443,2364,79,0,13,0,6
47442,1,2517,2346,171,0,151,0,6
47443,1,2780,2683,97,0,335,0,6
47444,2,2346,2417,-71,0,242,0,6
47445,2,2649,2506,143,0,245,0,6
47446,2,2351,2438,-87,0,255,0,6
47447,1,2454,2503,-49,0,6,0,6
47448,1,2682,2226,456,0,31,1,6
47449,1,2679,2632,47,0,316,1,6
47450,1,2319,2478,-159,0,8,1,6
47451,1,2482,2437,45,0,453,0,6
47452,1,2546,2469,77,0,106,0,6
47453,2,2441,2520,-79,0,106,0,6
47454,2,2310,2467,-157,0,265,0,6
47455,2,2367,2503,-136,0,101,0,6
47456,1,2400,2414,-14,0,0,0,6
47457,3,2470,2476,-6,0,140,0,6
47458,2,2367,2463,-96,0,125,1,6
47459,2,2340,2405,-65,0,374,0,6
47460,2,2480,2479,1,0,305,0,6
47461,1,2706,2359,347,0,53,0,6
47462,1,2569,2458,111,0,45,0,6
47463,2,2386,2475,-89,0,309,0,6
47464,1,2464,2550,-86,0,461,1,6
47465,3,2422,2346,76,0,200,0,6
47466,1,2240,2473,-233,0,264,0,6
47467,1,2426,2560,-134,0,263,0,6
47468,1,2443,2346,97,0,30,0,6
47469,2,2400,2390,10,0,120,0,6
47470,2,2497,2461,36,0,153,0,6
47471,1,2514,2363,151,0,240,1,6
47472,1,2454,2641,-187,0,131,0,6
47473,1,2471,2306,165,0,202,1,6
47474,2,2487,2573,-86,0,405,1,6
47475,2,2470,2581,-111,0,107,1,6
47476,2,2525,2684,-159,0,0,0,6
47477,1,2538,2201,337,0,49,0,6
47478,2,2408,2406,2,0,40,0,6
47479,1,2600,2437,163,0,10,1,6
47480,2,2321,2447,-126,0,310,0,6
47481,1,2384,2468,-84,0,103,0,6
47482,1,2485,2223,262,0,1,1,6
47483,1,2409,2520,-111,0,45,0,6
47484,1,2296,2410,-114,0,300,1,6
47485,2,2434,2543,-109,0,109,1,6
47486,2,2484,2552,-68,0,241,0,6
47487,1,2493,2417,76,0,0,0,6
47488,2,2490,2485,5,0,190,1,6
47489,1,2467,2392,75,0,4,0,6
47490,2,2543,2472,71,0,106,1,6
47491,1,2479,2322,157,0,311,0,6
47492,1,2683,2280,403,0,110,0,6
47493,1,2557,2632,-75,0,301,0,6
47494,1,2480,2371,109,0,190,0,6
47495,2,2708,2273,435,0,48,0,6
47496,1,2335,2458,-123,0,302,0,6
47498,2,2360,2517,-157,0,1,0,6
47499,2,2303,2474,-171,0,0,0,6
47500,1,2427,2461,-34,0,4,1,6
47501,2,2400,2434,-34,0,0,0,6
47502,2,2377,2400,-23,0,0,0,6
47503,1,2585,2466,119,0,455,0,6
47504,1,2412,2472,-60,0,57,0,6
47505,1,2636,2625,11,0,247,0,6
47506,2,2412,2402,10,0,121,0,6
47507,3,2393,2509,-116,0,218,0,6
47508,1,2403,2202,201,0,0,0,6
47509,2,2366,2521,-155,0,108,1,6
47510,1,2687,2603,84,0,398,1,6
47511,2,2476,2387,89,0,335,1,6
47512,3,2482,2391,91,0,13,0,6
47513,1,2344,2484,-140,0,454,0,6
47514,2,2507,2462,45,0,49,0,6
47515,1,2403,2304,99,0,41,1,6
47516,1,2461,2547,-86,0,469,0,6
47517,2,2409,2430,-21,0,123,0,6
47518,1,2476,2352,124,0,190,0,6
47519,2,2440,2485,-45,0,103,0,6
47520,2,2480,2536,-56,0,461,0,6
47521,1,2451,2421,30,0,480,0,8
47522,1,2491,2395,96,0,40,0,6
47523,1,2521,2357,164,0,240,0,6
47524,1,2203,2406,-203,0,117,0,6
47525,1,2477,2300,177,0,200,0,6
47526,1,2627,2589,38,0,439,0,6
47527,2,2396,2462,-66,0,190,0,6
47528,1,2405,2349,56,0,302,1,6
47529,2,2250,2465,-215,0,101,0,6
47530,3,2396,2459,-63,0,121,0,6
47531,2,2408,2406,2,0,106,1,6
47532,2,2454,2620,-166,0,335,0,6
47533,1,2540,2465,75,0,190,0,6
47534,2,2394,2433,-39,0,101,0,6
47535,1,2390,2495,-105,0,0,0,6
47536,1,2525,2599,-74,0,5,0,6
47537,2,2468,2362,106,0,330,1,6
47538,2,2354,2524,-170,0,1,0,6
47539,1,2424,2435,-11,0,15,0,6
47540,1,2490,2342,148,0,277,0,6
47541,2,2299,2407,-108,0,43,0,6
47542,2,2297,2480,-183,0,265,0,6
47543,2,2284,2697,-413,0,203,0,6
47544,1,2691,2481,210,0,302,0,6
47545,2,2415,2465,-50,0,43,0,8
47546,2,2469,2541,-72,0,170,0,6
47547,1,2395,2480,-85,0,453,0,6
47548,2,2287,2489,-202,0,144,0,6
47549,1,2451,2466,-15,0,468,0,6
47550,1,2411,2295,116,0,41,0,6
47551,1,2436,2488,-52,0,196,0,6
47552,2,2578,2680,-102,0,80,0,6
47553,2,2410,2398,12,0,106,0,6
47554,1,2698,2228,470,0,106,0,6
47555,3,2483,2294,189,0,258,0,6
47556,1,2464,2532,-68,0,106,0,6
47557,2,2389,2546,-157,0,175,0,6
47558,1,2481,2442,39,0,492,0,6
47559,2,2397,2419,-22,4,1,0,13
47560,1,2333,2458,-125,0,16,0,6
47561,1,2638,2500,138,0,35,0,6
47562,1,2684,2375,309,0,400,1,6
47563,2,2478,2694,-216,0,20,1,6
47564,1,2412,2403,9,0,0,1,6
47565,3,2592,2433,159,0,345,0,6
47566,2,2461,2428,33,0,4,0,6
47567,1,2544,2493,51,0,133,0,6
47568,1,2699,2276,423,0,101,0,6
47569,2,2321,2417,-96,0,5,0,8
47570,2,2389,2493,-104,0,44,0,6
47571,2,2464,2404,60,0,4,0,6
47572,2,2255,2404,-149,0,115,0,6
47573,2,2632,2549,83,0,54,0,6
47574,2,2473,2370,103,0,242,0,6
47575,2,2360,2402,-42,0,300,0,6
47576,3,2437,2487,-50,0,196,0,6
47577,2,2489,2455,34,0,46,0,6
47578,1,2477,2411,66,0,107,0,8
47579,1,2525,2435,90,0,0,0,6
47580,1,2411,2297,114,0,269,0,6
47581,1,2405,2457,-52,0,112,0,6
47582,1,2642,2471,171,0,469,0,6
47583,3,2292,2415,-123,0,40,0,6
47584,2,2461,2389,72,0,133,0,6
47585,2,2590,2574,16,0,18,0,6
47586,1,2497,2383,114,0,1,0,6
47587,2,2307,2476,-169,0,145,0,6
47588,2,2256,2408,-152,0,43,0,6
47589,2,2450,2340,110,0,127,0,6
47590,2,2397,2408,-11,0,41,0,6
47591,2,2416,2406,10,0,45,0,6
47592,1,2466,2430,36,0,15,0,6
47593,2,2290,2457,-167,0,123,0,6
47594,1,2567,2353,214,0,7,1,6
47595,1,2402,2391,11,0,190,0,6
47596,1,2461,2431,30,0,5,0,6
47597,2,2529,2609,-80,0,0,0,6
47598,1,2293,2415,-122,0,260,0,6
47599,1,2556,2454,102,0,130,0,6
47600,1,2486,2438,48,0,381,1,6
47601,1,2501,2266,235,0,138,0,6
47602,1,2436,2584,-148,0,140,1,6
47603,2,2580,2645,-65,0,80,0,6
47604,1,2397,2480,-83,0,487,0,6
47605,2,2234,2700,-466,0,25,0,6
47606,2,2401,2411,-10,0,114,0,6
47607,2,2413,2293,120,0,41,1,6
47608,1,2451,2363,88,0,41,0,6
47609,2,2479,2425,54,0,457,1,6
47610,1,2471,2303,168,0,337,1,6
47611,1,2413,2355,58,0,461,1,6
47612,2,2324,2443,-119,0,1,0,6
47613,1,2417,2255,162,0,0,0,6
47614,1,2411,2392,19,0,301,1,6
47615,2,2406,2488,-82,0,152,0,8
47616,2,2313,2466,-153,0,106,0,6
47617,2,2425,2439,-14,0,200,0,6
47618,1,2468,2518,-50,0,101,0,6
47619,2,2697,2525,172,0,108,1,6
47620,1,2415,2309,106,0,112,0,6
47621,2,2474,2421,53,0,100,0,6
47622,1,2460,2298,162,0,453,0,6
47623,1,2408,2301,107,0,201,0,6
47624,2,2257,2503,-246,0,4,0,6
47625,1,2341,2438,-97,0,46,1,6
47626,2,2625,2575,50,0,337,0,6
47627,1,2350,2412,-62,0,61,0,6
47628,1,2450,2561,-111,0,175,0,6
47629,2,2417,2491,-74,0,153,1,6
47630,2,2268,2468,-200,0,40,0,6
47631,1,2623,2433,190,0,387,0,6
47632,1,2455,2576,-121,0,16,1,6
47633,3,2422,2473,-51,0,463,0,6
47634,2,2408,2418,-10,0,0,0,6
47635,2,2565,2483,82,0,404,0,6
47636,2,2410,2570,-160,0,45,1,6
47637,2,2405,2290,115,0,410,0,6
47638,3,2463,2368,95,0,311,0,6
47639,1,2463,2389,74,0,455,1,6
47640,1,2470,2474,-4,0,4,0,6
47641,1,2399,2404,-5,0,49,1,6
47642,1,2510,2417,93,0,132,0,6
47643,2,2297,2412,-115,0,102,0,6
47644,2,2386,2425,-39,0,61,0,6
47645,2,2471,2224,247,0,4,0,6
47646,2,2711,2529,182,0,133,0,6
47647,3,2420,2429,-9,0,210,0,6
47648,2,2444,2408,36,0,4,0,6
47649,1,2498,2402,96,0,40,0,8
47650,2,2344,2401,-57,0,132,0,6
47651,1,2463,2424,39,0,4,0,6
47652,1,2582,2688,-106,0,340,0,6
47653,1,2495,2533,-38,0,40,0,6
47654,1,2457,2476,-19,0,33,0,6
47655,1,2431,2287,144,0,310,0,6
47656,1,2681,2589,92,0,398,0,6
47657,2,2376,2462,-86,0,106,0,6
47658,2,2345,2401,-56,0,143,1,8
47659,2,2472,2432,40,0,10,0,6
47660,1,2497,2309,188,0,304,0,6
47661,1,2260,2424,-164,4,113,0,13
47662,1,2430,2386,44,0,1,0,6
47663,1,2568,2475,93,0,225,0,6
47664,3,2381,2463,-82,0,463,0,6
47665,1,2443,2347,96,0,0,1,6
47666,2,2203,2702,-499,0,201,0,6
47667,2,2449,2353,96,0,9,0,6
47668,1,2703,2515,188,0,101,1,6
47669,2,2412,2373,39,0,6,0,6
47670,1,2483,2316,167,0,46,0,6
47671,2,2284,2435,-151,0,245,0,6
47672,3,2491,2288,203,0,6,0,6
47673,1,2405,2357,48,0,212,1,6
47674,2,2420,2438,-18,0,200,1,6
47675,1,2343,2416,-73,0,40,0,6
47676,2,2348,2463,-115,0,419,0,5
47677,1,2495,2235,260,0,469,0,6
47678,1,2466,2376,90,0,39,0,6
47679,2,2685,2572,113,0,414,1,6
47680,1,2424,2326,98,0,210,1,6
47681,1,2573,2407,166,0,4,0,6
47682,1,2430,2652,-222,0,281,1,6
47683,1,2470,2469,1,0,4,0,6
47684,2,2419,2463,-44,0,453,0,6
47685,1,2462,2383,79,0,57,0,6
47686,3,2501,2298,203,0,40,0,6
47687,2,2527,2355,172,0,0,1,6
47688,1,2435,2403,32,0,255,1,6
47689,1,2422,2406,16,0,4,0,6
47690,1,2467,2344,123,0,245,0,5
47691,2,2375,2409,-34,0,257,0,6
47692,1,2471,2512,-41,0,101,0,6
47693,1,2706,2585,121,0,133,0,6
47694,1,2475,2463,12,0,1,0,6
47695,2,2414,2301,113,0,41,1,6
47696,1,2438,2280,158,0,310,0,6
47697,1,2308,2427,-119,0,41,0,6
47698,2,2242,2460,-218,0,267,0,6
47699,1,2404,2577,-173,0,45,1,6
47700,1,2414,2303,111,0,107,1,6
47701,3,2567,2415,152,0,109,0,6
47702,2,2288,2447,-159,0,152,0,6
47703,2,2214,2488,-274,0,201,1,6
47704,2,2467,2439,28,0,45,0,6
47705,2,2308,2410,-102,0,120,0,6
47706,2,2232,2401,-169,0,49,0,6
47707,2,2481,2466,15,0,4,0,6
47708,2,2341,2406,-65,0,143,0,8
47709,2,2457,2378,79,0,4,0,6
47710,2,2371,2510,-139,0,5,1,6
47711,1,2498,2281,217,0,55,0,6
47712,1,2450,2405,45,0,315,1,6
47713,2,2581,2710,-129,0,312,0,6
47714,1,2340,2471,-131,0,43,0,5
47715,2,2230,2704,-474,0,25,0,6
47716,2,2445,2678,-233,0,265,0,6
47717,1,2504,2441,63,0,211,0,6
47718,1,2498,2473,25,0,49,1,6
47719,1,2519,2380,139,0,0,1,6
47720,1,2397,2416,-19,0,101,0,6
47721,1,2416,2353,63,0,115,0,6
47722,2,2345,2420,-75,0,100,0,6
47723,1,2559,2313,246,0,46,0,6
47724,2,2473,2406,67,0,112,0,6
47725,1,2461,2212,249,0,95,0,6
47726,1,2438,2417,21,0,15,0,6
47727,1,2447,2269,178,4,110,0,13
47728,2,2418,2451,-33,0,123,0,6
47729,1,2385,2475,-90,0,484,0,6
47730,2,2436,2351,85,0,103,0,6
47731,1,2404,2402,2,0,110,1,6
47732,1,2713,2578,135,0,133,0,6
47733,2,2514,2372,142,0,303,0,6
47734,1,2505,2240,265,0,312,0,6
47735,1,2510,2468,42,0,110,0,6
47736,1,2680,2443,237,0,492,0,6
47737,2,2405,2392,13,0,389,0,6
47738,2,2377,2468,-91,0,112,1,6
47739,1,2456,2522,-66,0,106,1,6
47740,1,2411,2276,135,0,245,0,8
47741,2,2404,2253,151,0,101,0,6
47742,3,2412,2413,-1,0,114,0,6
47743,1,2373,2413,-40,0,40,0,6
47744,2,2340,2462,-122,0,140,0,6
47745,2,2463,2348,115,0,357,0,5
47746,1,2456,2506,-50,0,374,0,6
47747,2,2405,2340,65,0,150,1,6
47748,1,2409,2228,181,4,303,0,13
47749,2,2406,2502,-96,0,1,0,6
47750,2,2353,2705,-352,0,201,0,6
47751,2,2684,2717,-33,0,190,1,6
47752,3,2562,2494,68,0,408,0,6
47753,3,2366,2568,-202,0,416,0,6
47754,3,2410,2444,-34,0,125,0,6
47755,2,2441,2683,-242,0,337,1,6
47756,1,2397,2463,-66,0,46,0,6
47757,1,2414,2307,107,0,122,0,6
47758,3,2398,2441,-43,0,57,0,6
47759,1,2499,2432,67,0,108,0,6
47760,1,2472,2467,5,0,459,0,6
47761,1,2412,2473,-61,0,200,0,6
47762,2,2413,2380,33,0,400,1,6
47763,2,2254,2407,-153,0,40,0,6
47764,1,2293,2463,-170,0,0,0,6
47765,1,2462,2308,154,0,4,0,6
47766,1,2307,2448,-141,0,40,0,6
47767,1,2419,2412,7,0,102,0,6
47768,3,2238,2536,-298,0,448,0,6
47769,2,2362,2428,-66,0,310,0,6
47770,1,2456,2404,52,0,110,1,6
47771,3,2202,2447,-245,0,41,0,8
47772,1,2749,2679,70,0,110,0,6
47773,2,2574,2722,-148,0,122,0,6
47774,2,2440,2389,51,0,31,0,6
47775,2,2305,2447,-142,0,6,0,6
47776,1,2410,2399,11,0,176,0,6
47777,1,2496,2377,119,0,14,0,6
47778,2,2290,2410,-120,0,130,0,6
47779,2,2505,2507,-2,0,46,0,6
47780,1,2441,2335,106,0,46,0,6
47781,2,2396,2434,-38,0,102,0,6
47782,1,2685,2438,247,0,375,1,6
47783,2,2351,2447,-96,0,300,0,6
47784,3,2413,2305,108,0,122,0,6
47785,2,2454,2466,-12,0,1,0,6
47786,1,2247,2433,-186,0,468,0,6
47787,2,2527,2500,27,0,110,1,6
47788,2,2238,2407,-169,0,41,0,6
47789,1,2466,2419,47,0,1,0,6
47790,2,2414,2341,73,0,49,0,6
47791,2,2403,2228,175,0,484,1,6
47792,2,2303,2451,-148,0,40,1,6
47793,1,2407,2424,-17,0,45,0,6
47794,2,2373,2561,-188,0,4,0,6
47795,1,2726,2571,155,0,241,0,6
47796,2,2500,2266,234,0,152,1,6
47797,2,2414,2471,-57,0,200,0,6
47798,2,2674,2754,-80,0,112,0,6
47799,2,2394,2416,-22,0,40,0,6
47800,2,2410,2461,-51,0,44,0,6
47801,2,2471,2327,144,0,311,0,6
47802,3,2439,2391,48,0,31,0,6
47803,1,2484,2241,243,0,117,0,6
47804,1,2399,2445,-46,0,409,1,6
47805,1,2451,2347,104,0,10,0,6
47806,1,2404,2500,-96,0,1,0,6
47807,2,2436,2687,-251,0,6,0,6
47808,2,2438,2407,31,0,43,0,6
47809,2,2316,2414,-98,0,119,0,6
47810,3,2427,2391,36,0,410,0,6
47811,3,2507,2478,29,0,46,0,6
47812,1,2424,2263,161,0,42,0,6
47813,1,2382,2409,-27,0,463,0,6
47814,2,2567,2729,-162,0,196,0,6
47815,2,2565,2413,152,0,4,1,6
47816,1,2670,2619,51,0,112,1,6
47817,1,2373,2460,-87,0,5,1,6
47818,2,2690,2758,-68,0,404,0,6
47819,2,2564,2490,74,0,404,0,6
47820,3,2273,2407,-134,4,300,0,13
47821,1,2418,2357,61,0,103,0,6
47822,2,2466,2550,-84,0,5,0,6
47823,1,2405,2395,10,0,398,0,6
47824,1,2421,2388,33,0,172,0,6
47825,1,2421,2463,-42,0,135,0,6
47826,1,2415,2283,132,0,469,1,6
47827,2,2288,2418,-130,0,134,0,6
47828,1,2443,2207,236,0,46,0,8
47829,2,2403,2365,38,0,153,0,6
47830,2,2323,2415,-92,0,45,0,8
47831,2,2296,2414,-118,0,84,1,6
47832,3,2303,2459,-156,0,485,0,6
47833,3,2364,2411,-47,0,110,0,6
47834,2,2433,2439,-6,0,9,1,6
47835,1,2492,2275,217,0,46,0,6
47836,3,2391,2427,-36,0,356,0,6
47837,2,2405,2402,3,0,405,1,6
47838,1,2457,2507,-50,0,374,1,6
47839,2,2202,2570,-368,0,300,0,6
47840,1,2373,2422,-49,0,138,0,6
47841,2,2383,2426,-43,0,40,1,6
47842,2,2462,2428,34,0,7,0,6
47843,1,2732,2614,118,0,113,1,6
47844,1,2372,2452,-80,0,265,1,6
47845,2,2685,2564,121,0,400,0,6
47846,3,2412,2495,-83,0,1,0,6
47847,2,2411,2357,54,4,36,0,10
47848,2,2204,2446,-242,0,310,0,8
47849,1,2459,2478,-19,0,200,0,6
47850,2,2310,2432,-122,0,114,0,6
47851,1,2718,2763,-45,0,398,0,6
47852,1,2417,2319,98,0,46,0,6
47853,1,2410,2364,46,0,40,0,6
47854,1,2427,2426,1,0,17,0,6
47855,1,2445,2338,107,0,344,1,6
47856,1,2389,2456,-67,0,46,0,6
47857,1,2381,2419,-38,0,300,1,6
47858,2,2365,2557,-192,0,103,1,6
47859,2,2409,2400,9,0,110,0,6
47860,1,2298,2464,-166,0,315,0,6
47861,1,2499,2336,163,0,41,0,6
47862,2,2472,2378,94,0,49,1,6
47863,2,2382,2415,-33,0,453,1,6
47864,2,2363,2428,-65,0,278,0,6
47865,2,2445,2473,-28,0,242,0,6
47866,1,2422,2351,71,0,106,0,6
47867,1,2449,2436,13,0,343,1,6
47868,1,2757,2726,31,0,474,0,6
47869,2,2448,2201,247,0,48,0,8
47870,1,2451,2358,93,0,6,0,6
47871,2,2359,2415,-56,0,41,0,6
47872,1,2432,2359,73,0,201,0,6
47873,2,2554,2678,-124,0,335,1,6
47874,2,2270,2463,-193,0,143,1,6
47875,2,2503,2477,26,0,461,0,6
47876,2,2402,2309,93,0,4,0,6
47877,1,2657,2450,207,0,301,0,6
47878,3,2411,2398,13,0,146,0,6
47879,2,2413,2389,24,0,1,0,6
47880,2,2689,2736,-47,0,184,0,6
47881,1,2456,2406,50,0,400,1,6
47882,1,2440,2380,60,0,264,1,6
47884,2,2386,2426,-40,0,310,0,6
47885,2,2427,2478,-51,0,236,1,6
47886,2,2355,2436,-81,0,260,0,6
47887,2,2720,2762,-42,0,302,0,6
47888,1,2290,2454,-164,0,44,0,6
47889,1,2430,2316,114,0,41,0,6
47890,1,2442,2334,108,0,100,0,6
47891,1,2465,2392,73,0,43,0,6
47892,1,2447,2406,41,0,141,0,6
47893,3,2741,2684,57,0,265,0,6
47894,1,2438,2483,-45,0,15,0,6
47895,2,2460,2385,75,0,453,0,6
47896,1,2446,2443,3,0,130,1,6
47897,2,2381,2431,-50,0,487,1,6
47898,1,2417,2219,198,0,49,0,6
47899,1,2241,2446,-205,0,46,0,6
47900,1,2448,2244,204,0,337,0,6
47901,1,2462,2255,207,0,152,1,6
47902,1,2266,2473,-207,0,102,1,6
47904,2,2244,2449,-205,0,190,0,6
47905,1,2485,2325,160,0,102,1,6
47906,1,2476,2270,206,0,10,0,6
47907,2,2270,2519,-249,0,106,0,6
47908,1,2282,2493,-211,0,16,1,6
47909,1,2498,2282,216,0,1,0,6
47910,2,2278,2480,-202,0,302,1,6
47911,2,2301,2575,-274,0,112,0,6
47912,1,2703,2307,396,0,154,1,6
47913,1,2541,2294,247,0,15,0,6
47914,1,2401,2416,-15,0,409,1,6
47915,1,2375,2445,-70,0,264,0,6
47916,2,2441,2351,90,0,201,0,6
47917,2,2483,2458,25,0,331,0,6
47918,2,2353,2691,-338,0,120,0,6
47919,1,2449,2297,152,0,410,0,6
47920,2,2453,2329,124,0,1,0,6
47921,3,2405,2283,122,4,41,0,13
47922,1,2685,2551,134,0,130,0,6
47923,2,2234,2471,-237,0,0,0,6
47924,1,2767,2714,53,0,306,0,6
47925,2,2446,2299,147,0,30,0,6
47926,2,2396,2419,-23,0,5,0,6
47927,1,2518,2470,48,0,110,1,6
47928,2,2269,2438,-169,0,100,1,6
47930,1,2354,2400,-46,0,45,0,6
47931,2,2256,2452,-196,0,129,0,6
47932,1,2510,2473,37,0,306,0,6
47933,2,2708,2772,-64,0,121,1,6
47934,1,2681,2740,-59,0,487,1,6
47935,1,2438,2382,56,0,58,1,6
47936,1,2436,2454,-18,0,4,0,6
47937,1,2376,2452,-76,0,426,0,6
47938,1,2437,2452,-15,0,45,0,6
47939,3,2410,2407,3,0,300,0,6
47940,2,2350,2432,-82,0,300,0,6
47941,1,2402,2289,113,0,258,0,6
47942,1,2548,2550,-2,0,45,0,6
47943,3,2464,2442,22,0,43,0,6
47944,2,2497,2448,49,0,106,1,6
47945,3,2213,2439,-226,0,110,0,8
47946,1,2415,2391,24,0,242,0,6
47947,1,2425,2300,125,0,108,0,6
47948,1,2440,2315,125,0,311,1,6
47949,1,2484,2275,209,0,5,0,6
47950,1,2469,2306,163,0,198,0,6
47951,3,2521,2450,71,0,4,0,6
47952,1,2452,2501,-49,0,200,1,6
47953,3,2483,2479,4,0,315,0,6
47954,2,2378,2465,-87,0,5,0,6
47955,3,2398,2420,-22,0,200,0,6
47956,3,2488,2250,238,0,106,0,6
47957,1,2577,2543,34,0,246,0,6
47958,1,2467,2317,150,0,218,1,6
47959,2,2275,2663,-388,0,47,0,6
47960,1,2405,2428,-23,0,46,1,6
47961,1,2777,2703,74,0,463,1,6
47962,2,2454,2516,-62,0,302,0,6
47963,2,2377,2443,-66,0,264,1,6
47964,3,2401,2272,129,0,101,0,6
47965,1,2295,2400,-105,0,337,0,6
47966,1,2316,2402,-86,0,406,0,6
47967,1,2734,2688,46,0,265,1,6
47968,2,2476,2565,-89,0,102,0,6
47969,2,2443,2408,35,0,302,0,6
47970,2,2404,2383,21,0,45,0,6
47971,1,2444,2296,148,0,45,1,6
47972,1,2407,2410,-3,0,46,0,6
47973,2,2336,2464,-128,0,40,0,6
47974,1,2237,2469,-232,0,278,0,6
47975,2,2450,2554,-104,0,90,0,6
47976,2,2522,2545,-23,0,414,0,6
47977,2,2266,2444,-178,0,333,1,6
47978,1,2281,2437,-156,0,100,0,6
47979,2,2267,2415,-148,0,10,0,6
47980,1,2665,2413,252,0,40,1,6
47981,1,2558,2446,112,0,113,0,6
47982,1,2285,2487,-202,0,45,1,6
47983,2,2201,2466,-265,0,414,0,6
47984,1,2493,2376,117,0,53,0,6
47985,1,2538,2363,175,0,15,0,6
47986,2,2479,2472,7,0,36,1,6
47987,2,2283,2485,-202,0,101,1,6
47988,2,2451,2483,-32,0,406,0,6
47989,1,2469,2459,10,0,127,0,6
47990,2,2253,2520,-267,0,49,1,6
47991,1,2704,2217,487,0,4,0,6
47992,2,2383,2582,-199,0,111,0,6
47993,1,2379,2521,-142,0,210,0,6
47994,1,2427,2332,95,0,347,1,6
47995,3,2683,2739,-56,0,404,0,6
47996,2,2295,2422,-127,0,56,0,6
47997,1,2393,2435,-42,0,10,0,6
47998,2,2448,2373,75,0,264,0,6
47999,2,2309,2499,-190,0,41,0,6
48000,1,2404,2447,-43,0,45,0,6
48001,1,2354,2447,-93,0,133,0,6
48002,2,2429,2343,86,0,305,0,6
48003,2,2415,2389,26,0,57,0,6
48004,1,2411,2404,7,0,106,1,6
48005,2,2468,2387,81,0,45,0,6
48006,3,2569,2601,-32,0,419,0,6
48007,2,2411,2389,22,0,45,0,6
48008,1,2418,2375,43,0,46,0,6
48009,1,2437,2442,-5,0,135,0,6
48010,2,2344,2692,-348,0,200,1,6
48011,3,2320,2431,-111,0,40,0,6
48012,2,2738,2684,54,0,354,0,6
48013,2,2321,2668,-347,0,311,1,6
48014,2,2426,2562,-136,0,4,1,6
48015,3,2436,2217,219,0,49,0,8
48016,1,2440,2361,79,0,45,0,6
48017,1,2478,2246,232,0,4,1,6
48018,1,2446,2294,152,0,455,1,6
48019,2,2223,2442,-219,0,45,0,6
48020,1,2468,2207,261,0,152,0,6
48021,2,2262,2473,-211,0,202,1,6
48023,1,2454,2371,83,0,190,0,6
48024,1,2522,2488,34,0,7,0,6
48025,2,2404,2478,-74,0,147,0,6
48026,1,2489,2422,67,0,335,0,6
48027,3,2364,2475,-111,0,45,0,6
48028,3,2585,2705,-120,0,140,0,6
48029,1,2380,2441,-61,0,264,0,6
48030,2,2318,2409,-91,0,40,1,6
48031,1,2560,2399,161,0,13,0,6
48032,1,2417,2395,22,0,48,1,6
48033,1,2550,2444,106,0,331,1,6
48034,1,2436,2313,123,0,409,0,6
48035,1,2422,2295,127,0,46,0,6
48036,1,2370,2423,-53,0,352,0,6
48037,1,2395,2405,-10,0,132,1,6
48038,1,2358,2400,-42,0,473,0,6
48039,1,2412,2262,150,0,190,0,6
48040,1,2317,2468,-151,0,201,0,6
48041,2,2455,2279,176,0,337,0,6
48042,1,2691,2731,-40,0,487,1,6
48043,1,2447,2388,59,0,302,1,6
48044,1,2434,2387,47,0,58,0,6
48045,2,2399,2417,-18,0,463,0,6
48046,1,2434,2394,40,0,184,1,6
48047,1,2396,2563,-167,0,226,0,6
48048,1,2415,2400,15,0,146,0,6
48049,1,2671,2346,325,0,210,0,6
48050,2,2608,2601,7,0,398,1,6
48051,1,2423,2322,101,0,4,0,6
48052,2,2242,2406,-164,0,315,0,6
48053,1,2461,2411,50,0,300,0,6
48054,1,2356,2444,-88,0,133,0,6
48055,1,2565,2425,140,0,41,0,6
48056,2,2443,2350,93,0,187,0,6
48057,2,2440,2402,38,0,4,0,6
48058,1,2390,2417,-27,0,346,1,6
48059,1,2329,2480,-151,0,240,0,6
48060,3,2373,2449,-76,0,229,0,6
48061,2,2482,2465,17,0,101,1,6
48062,2,2292,2444,-152,0,110,0,6
48063,2,2470,2450,20,0,260,1,6
48064,2,2476,2311,165,0,18,0,6
48065,1,2417,2308,109,0,337,1,6
48066,2,2537,2399,138,0,36,0,6
48067,1,2703,2366,337,0,4,0,6
48068,2,2483,2493,-10,0,113,1,6
48069,3,2473,2587,-114,0,112,0,6
48070,1,2499,2383,116,0,1,0,6
48071,2,2458,2528,-70,0,105,0,6
48072,1,2421,2292,129,0,45,0,6
48073,2,2325,2427,-102,0,120,0,6
48074,2,2440,2466,-26,0,200,1,6
48075,2,2406,2554,-148,0,45,0,6
48076,2,2271,2422,-151,0,112,0,6
48077,1,2468,2324,144,0,10,1,6
48078,2,2382,2439,-57,0,264,1,6
48079,2,2532,2694,-162,0,300,1,6
48080,1,2555,2404,151,0,152,0,6
48081,1,2606,2601,5,0,337,0,6
48082,1,2452,2439,13,0,302,0,6
48083,1,2437,2364,73,0,395,0,6
48084,2,2697,2569,128,0,90,1,6
48085,1,2673,2365,308,0,300,0,6
48086,2,2393,2400,-7,0,40,0,6
48087,2,2357,2436,-79,0,246,0,6
48088,1,2389,2433,-44,0,315,0,6
48089,1,2431,2288,143,0,9,0,6
48090,2,2404,2402,2,0,112,0,6
48091,1,2413,2390,23,0,311,1,6
48092,2,2396,2457,-61,0,310,1,6
48093,1,2425,2429,-4,0,302,0,6
48094,1,2262,2428,-166,0,214,0,8
48095,1,2349,2676,-327,0,106,0,6
48096,2,2364,2423,-59,0,211,0,6
48097,1,2444,2377,67,0,50,0,6
48098,2,2253,2450,-197,0,128,1,6
48099,2,2401,2559,-158,0,226,0,6
48100,1,2398,2433,-35,0,310,0,6
48101,2,2530,2249,281,0,343,0,6
48102,2,2304,2467,-163,0,322,1,6
48103,2,2375,2477,-102,0,101,0,6
48104,2,2358,2464,-106,0,102,0,6
48105,2,2447,2279,168,0,106,1,6
48106,1,2456,2503,-47,0,81,0,6
48107,1,2407,2365,42,0,118,0,6
48108,2,2324,2453,-129,0,301,1,6
48109,2,2323,2477,-154,0,46,0,6
48110,1,2471,2421,50,0,18,0,6
48111,3,2499,2585,-86,0,405,0,6
48112,1,2532,2704,-172,0,5,1,6
48113,2,2448,2475,-27,0,15,0,6
48114,2,2471,2431,40,0,43,0,6
48115,3,2359,2442,-83,0,133,0,6
48116,1,2484,2409,75,0,100,0,6
48117,1,2595,2612,-17,0,45,0,6
48118,1,2291,2429,-138,0,40,0,6
48119,1,2388,2427,-39,0,300,0,6
48120,2,2405,2231,174,0,0,0,6
48121,2,2434,2489,-55,0,15,1,6
48122,2,2255,2404,-149,0,100,1,6
48123,2,2529,2562,-33,0,45,1,6
48124,2,2427,2262,165,0,190,0,6
48125,1,2421,2254,167,0,403,1,6
48126,2,2401,2377,24,0,100,0,6
48127,1,2400,2322,78,0,112,0,6
48128,1,2404,2394,10,0,414,0,6
48129,1,2405,2391,14,0,45,0,6
48130,1,2381,2400,-19,0,100,0,6
48131,2,2461,2602,-141,0,405,0,6
48132,2,2408,2359,49,0,45,0,6
48133,2,2404,2338,66,0,400,1,6
48134,1,2434,2426,8,0,110,0,6
48135,2,2395,2660,-265,0,311,0,6
48136,2,2453,2281,172,0,197,0,6
48137,1,2437,2272,165,0,4,0,6
48138,1,2372,2449,-77,0,264,1,6
48139,1,2697,2329,368,0,40,0,6
48140,3,2322,2448,-126,0,354,0,6
48141,1,2441,2361,80,0,45,0,6
48142,2,2423,2439,-16,0,310,0,6
48143,1,2408,2322,86,0,0,0,6
48144,3,2387,2434,-47,0,102,0,6
48145,2,2202,2472,-270,0,48,0,6
48146,1,2471,2259,212,0,34,0,6
48147,2,2287,2443,-156,0,123,1,6
48148,1,2481,2320,161,0,122,0,6
48149,2,2416,2439,-23,0,61,1,6
48150,1,2496,2468,28,0,1,0,6
48151,3,2500,2325,175,0,337,0,6
48152,1,2288,2457,-169,0,57,0,6
48153,3,2583,2476,107,0,101,0,6
48154,3,2696,2412,284,0,5,0,6
48155,2,2481,2462,19,0,224,1,6
48156,1,2480,2541,-61,0,105,0,6
48157,2,2421,2430,-9,0,4,0,6
48158,1,2494,2435,59,0,190,1,6
48159,2,2273,2441,-168,0,132,1,6
48160,2,2292,2410,-118,0,131,0,6
48161,2,2389,2424,-35,0,300,0,6
48162,2,2402,2232,170,0,41,0,6
48163,1,2269,2418,-149,0,257,0,8
48164,2,2356,2445,-89,0,133,1,6
48165,1,2400,2413,-13,0,0,1,6
48166,2,2428,2451,-23,0,110,0,8
48167,1,2386,2446,-60,0,353,0,6
48168,2,2264,2412,-148,0,292,0,6
48169,2,2410,2472,-62,0,415,0,6
48170,1,2370,2418,-48,0,216,1,6
48171,1,2435,2491,-56,0,302,0,6
48172,2,2442,2379,63,0,300,1,6
48173,1,2415,2417,-2,0,15,0,6
48174,1,2445,2440,5,0,250,1,6
48175,1,2312,2434,-122,0,103,0,6
48176,2,2429,2388,41,0,13,0,6
48177,1,2444,2264,180,0,48,0,6
48178,2,2390,2414,-24,0,138,0,6
48179,1,2404,2499,-95,0,123,0,6
48180,1,2521,2411,110,0,15,0,6
48181,2,2449,2484,-35,0,101,0,6
48182,2,2366,2475,-109,0,46,0,6
48183,2,2463,2282,181,0,106,0,6
48184,2,2446,2582,-136,0,45,0,6
48185,1,2473,2296,177,0,18,0,6
48186,1,2416,2502,-86,0,210,0,6
48187,1,2478,2347,131,0,320,1,6
48188,3,2468,2487,-19,0,456,0,6
48189,1,2534,2498,36,0,8,0,6
48190,3,2328,2692,-364,0,122,0,6
48191,2,2426,2412,14,0,41,0,6
48192,2,2447,2288,159,0,43,0,6
48193,1,2456,2441,15,0,128,0,8
48194,2,2419,2690,-271,0,9,0,6
48195,2,2364,2442,-78,0,102,0,6
48196,1,2393,2423,-30,0,43,0,6
48197,1,2394,2419,-25,0,121,0,6
48198,1,2449,2352,97,0,45,1,6
48199,1,2407,2406,1,0,40,0,6
48200,2,2412,2385,27,0,331,0,6
48201,2,2386,2435,-49,0,264,1,6
48202,3,2456,2310,146,0,241,0,5
48203,2,2332,2698,-366,0,244,1,6
48204,1,2384,2439,-55,0,100,0,6
48205,1,2401,2413,-12,0,0,1,6
48206,2,2410,2415,-5,0,202,0,6
48207,1,2692,2411,281,0,453,0,6
48208,1,2413,2309,104,0,57,0,6
48209,2,2477,2360,117,0,84,1,6
48210,1,2417,2399,18,0,4,1,6
48211,1,2454,2525,-71,0,245,0,6
48212,1,2479,2343,136,0,22,0,6
48213,2,2303,2446,-143,0,292,1,6
48214,2,2219,2475,-256,0,382,0,6
48215,1,2489,2493,-4,0,115,0,6
48216,2,2290,2442,-152,0,302,0,6
48217,2,2289,2494,-205,0,123,0,6
48218,1,2688,2476,212,0,176,0,6
48219,1,2585,2332,253,0,248,0,6
48220,3,2487,2423,64,0,152,0,6
48221,2,2469,2539,-70,0,491,0,6
48222,2,2481,2394,87,0,16,1,6
48223,1,2245,2428,-183,0,113,0,6
48224,3,2295,2443,-148,0,190,0,6
48225,1,2348,2454,-106,0,136,1,6
48226,2,2384,2545,-161,0,133,0,6
48227,2,2400,2406,-6,0,201,0,6
48228,1,2440,2381,59,0,220,1,6
48229,1,2379,2433,-54,0,110,0,6
48230,2,2410,2694,-284,0,404,0,6
48231,1,2418,2447,-29,0,0,1,6
48232,2,2432,2409,23,0,0,0,6
48233,2,2407,2407,0,0,40,0,6
48234,1,2462,2432,30,0,140,0,8
48235,2,2417,2266,151,0,414,0,6
48236,1,2421,2390,31,0,4,0,6
48237,1,2484,2405,79,0,4,0,6
48238,2,2388,2411,-23,0,7,0,6
48239,1,2326,2422,-96,0,126,0,6
48240,1,2696,2408,288,0,108,0,6
48241,1,2441,2298,143,0,131,0,6
48242,3,2346,2426,-80,0,130,0,6
48243,2,2533,2414,119,0,273,0,8
48244,3,2377,2445,-68,0,250,0,6
48245,3,2215,2401,-186,0,200,0,6
48246,1,2426,2429,-3,0,302,0,6
48247,2,2238,2408,-170,0,212,1,6
48248,3,2446,2217,229,0,156,0,6
48249,1,2367,2474,-107,0,322,0,6
48250,2,2487,2477,10,0,385,0,6
48251,1,2330,2474,-144,0,122,0,6
48252,2,2450,2691,-241,0,190,0,6
48253,2,2497,2446,51,0,1,0,6
48254,1,2424,2495,-71,0,101,0,6
48255,2,2401,2464,-63,0,14,0,6
48256,2,2483,2486,-3,0,487,1,6
48257,3,2544,2588,-44,0,5,0,6
48258,2,2412,2401,11,0,0,1,6
48259,2,2415,2394,21,0,4,0,6
48260,2,2391,2409,-18,0,40,0,6
48261,2,2395,2400,-5,0,334,0,6
48262,2,2299,2461,-162,0,300,1,6
48263,1,2425,2415,10,0,200,1,6
48264,2,2400,2402,-2,0,300,0,6
48265,1,2426,2329,97,0,4,0,6
48266,2,2372,2549,-177,0,113,0,6
48267,1,2399,2409,-10,0,122,0,6
48268,1,2294,2444,-150,0,180,1,6
48269,1,2417,2317,100,0,153,0,6
48270,2,2406,2697,-291,0,404,0,6
48271,2,2384,2419,-35,0,150,0,6
48272,2,2453,2598,-145,0,130,0,5
48273,2,2432,2358,74,0,302,0,6
48274,1,2548,2489,59,0,101,1,6
48275,1,2699,2404,295,0,487,0,6
48276,3,2469,2485,-16,0,310,0,6
48277,1,2525,2295,230,0,190,0,8
48278,1,2444,2378,66,0,310,0,6
48279,1,2430,2421,9,0,4,0,6
48280,1,2415,2407,8,0,347,0,6
48281,2,2437,2468,-31,0,115,1,8
48282,2,2425,2425,0,0,112,1,6
48283,1,2407,2407,0,0,40,0,6
48284,3,2379,2405,-26,0,211,0,6
48285,1,2403,2249,154,0,458,1,6
48286,3,2428,2423,5,0,302,0,8
48287,1,2406,2380,26,0,100,1,6
48288,2,2294,2431,-137,0,122,0,6
48289,1,2410,2400,10,0,157,1,6
48290,2,2307,2436,-129,0,201,0,6
48291,2,2466,2436,30,0,46,0,6
48292,1,2430,2273,157,0,250,0,6
48293,1,2373,2449,-76,0,100,0,6
48294,1,2552,2523,29,0,109,0,6
48295,2,2554,2525,29,0,127,0,6
48296,1,2402,2342,60,0,106,0,6
48297,1,2401,2413,-12,0,0,0,6
48298,2,2334,2421,-87,0,10,1,6
48299,1,2398,2484,-86,0,40,1,6
48300,2,2420,2314,106,0,344,0,6
48301,1,2434,2383,51,0,46,0,6
48302,3,2490,2341,149,0,106,0,6
48303,1,2440,2269,171,0,4,1,6
48304,1,2580,2417,163,0,39,0,6
48305,1,2462,2380,82,0,302,0,6
48306,1,2405,2228,177,0,102,0,6
48307,3,2431,2419,12,0,302,0,6
48308,1,2442,2263,179,0,1,0,6
48309,2,2423,2528,-105,0,146,0,8
48310,1,2293,2428,-135,0,406,1,8
48311,1,2417,2407,10,0,0,0,6
48312,2,2338,2407,-69,0,1,0,6
48313,2,2442,2380,62,0,43,0,6
48314,2,2407,2407,0,0,321,0,6
48315,1,2415,2469,-54,0,142,1,6
48316,3,2531,2546,-15,0,334,0,6
48317,2,2494,2413,81,0,33,0,6
48318,1,2425,2367,58,0,84,1,6
48319,2,2433,2583,-150,0,120,0,6
48320,3,2401,2460,-59,0,311,0,6
48321,2,2269,2415,-146,0,454,0,8
48322,1,2491,2439,52,0,130,0,6
48323,1,2441,2445,-4,0,405,0,6
48325,2,2477,2351,126,0,56,1,6
48326,1,2370,2487,-117,0,46,0,6
48327,1,2429,2451,-22,0,1,0,6
48328,2,2420,2411,9,0,310,0,6
48329,1,2402,2333,69,0,135,0,6
48330,3,2603,2458,145,0,40,0,6
48331,1,2479,2466,13,0,311,0,6
48332,2,2433,2532,-99,0,220,0,8
48333,1,2587,2414,173,0,39,1,6
48334,2,2419,2431,-12,0,112,0,6
48335,1,2434,2375,59,0,456,0,6
48336,2,2417,2496,-79,0,265,0,6
48337,1,2387,2435,-48,0,264,1,6
48338,2,2461,2305,156,0,46,0,6
48339,1,2413,2401,12,0,0,0,6
48340,1,2485,2330,155,0,327,1,6
48341,1,2465,2363,102,0,40,0,6
48342,2,2430,2422,8,0,53,1,6
48343,1,2440,2328,112,0,240,0,6
48344,1,2446,2402,44,0,310,0,6
48345,3,2406,2391,15,0,343,0,6
48346,2,2415,2311,104,0,122,0,6
48347,1,2419,2274,145,0,338,0,8
48348,1,2474,2301,173,0,150,0,8
48349,2,2444,2375,69,0,1,0,6
48350,1,2430,2453,-23,0,110,0,6
48351,1,2445,2314,131,0,400,0,6
48352,2,2413,2375,38,0,261,1,6
48353,3,2536,2419,117,0,341,0,8
48354,1,2331,2443,-112,0,0,0,6
48355,1,2501,2470,31,0,112,1,6
48356,2,2439,2452,-13,0,211,0,6
48357,2,2436,2414,22,0,302,0,6
48358,1,2448,2287,161,0,394,1,6
48359,1,2441,2287,154,0,45,0,6
48360,1,2590,2507,83,0,456,0,6
48361,3,2396,2418,-22,0,40,0,6
48362,2,2429,2394,35,0,310,0,6
48363,3,2359,2488,-129,0,319,0,6
48364,1,2406,2301,105,0,160,0,6
48365,2,2401,2359,42,0,211,0,6
48366,3,2461,2601,-140,0,301,0,6
48367,2,2401,2447,-46,0,311,0,6
48368,1,2416,2242,174,0,151,0,8
48369,2,2298,2534,-236,0,375,0,8
48370,1,2420,2433,-13,0,218,1,6
48371,2,2428,2391,37,0,245,1,6
48372,1,2406,2318,88,0,156,0,6
48373,1,2469,2436,33,0,47,1,6
48374,1,2574,2635,-61,0,46,0,6
48375,2,2308,2412,-104,4,150,1,13
48376,1,2420,2430,-10,0,258,0,6
48377,2,2368,2400,-32,0,100,1,6
48378,1,2382,2434,-52,0,112,0,6
48379,2,2447,2594,-147,0,1,0,6
48380,2,2430,2423,7,0,220,0,8
48381,1,2464,2284,180,0,484,1,6
48382,2,2396,2435,-39,0,90,0,6
48383,1,2349,2452,-103,0,1,0,6
48384,1,2365,2405,-40,0,100,0,6
48385,2,2382,2427,-45,0,107,1,6
48386,2,2418,2396,22,0,0,0,6
48387,1,2401,2406,-5,0,240,0,6
48388,2,2429,2239,190,0,190,0,8
48389,1,2452,2422,30,0,57,0,6
48390,1,2628,2580,48,0,208,0,6
48391,1,2445,2296,149,0,108,0,6
48392,1,2424,2426,-2,0,319,0,6
48393,1,2440,2474,-34,0,4,0,6
48394,1,2599,2463,136,0,4,1,6
48395,1,2537,2421,116,0,341,0,8
48396,1,2468,2412,56,0,335,0,6
48397,1,2432,2386,46,0,302,1,6
48398,1,2279,2410,-131,0,47,0,6
48399,1,2473,2295,178,0,107,0,8
48400,1,2417,2457,-40,0,200,1,6
48401,1,2558,2431,127,0,331,1,6
48402,2,2427,2428,-1,0,371,0,6
48403,2,2377,2402,-25,0,113,0,6
48404,2,2421,2541,-120,0,152,1,8
48405,1,2316,2402,-86,0,122,1,6
48406,2,2317,2437,-120,0,100,0,6
48407,1,2461,2273,188,0,123,1,6
48408,1,2410,2368,42,0,347,0,6
48409,1,2310,2486,-176,0,7,0,6
48410,1,2408,2386,22,0,354,0,6
48411,3,2418,2476,-58,0,110,0,8
48412,1,2408,2371,37,0,335,0,6
48413,2,2420,2430,-10,0,112,1,6
48414,2,2411,2598,-187,0,38,0,6
48415,2,2441,2468,-27,0,118,0,6
48416,1,2532,2398,134,0,46,1,6
48417,2,2385,2402,-17,0,115,1,6
48418,2,2382,2451,-69,0,16,0,6
48419,2,2459,2423,36,0,46,0,6
48420,1,2544,2429,115,0,16,0,8
48421,2,2423,2464,-41,0,265,0,6
48422,2,2393,2404,-11,0,106,1,6
48423,1,2402,2309,93,0,140,0,8
48424,2,2436,2413,23,0,110,0,6
48425,1,2484,2408,76,0,112,0,6
48426,1,2601,2611,-10,0,4,0,6
48427,3,2473,2366,107,0,302,0,6
48428,2,2327,2413,-86,0,343,0,6
48429,3,2275,2455,-180,0,388,0,6
48430,1,2436,2415,21,0,310,0,6
48431,2,2347,2512,-165,0,1,0,6
48432,1,2428,2334,94,4,43,0,13
48433,1,2424,2376,48,0,5,0,6
48434,2,2469,2457,12,0,214,0,6
48435,3,2475,2299,176,0,48,0,8
48436,1,2429,2203,226,0,4,0,6
48437,2,2418,2535,-117,0,190,0,6
48438,1,2277,2430,-153,0,106,0,6
48439,1,2429,2403,26,0,157,0,6
48440,3,2409,2441,-32,0,0,0,6
48441,2,2419,2401,18,0,40,0,6
48442,1,2570,2512,58,0,48,1,6
48443,1,2421,2472,-51,0,110,0,6
48444,2,2418,2322,96,0,45,0,6
48445,2,2409,2314,95,0,141,0,6
48446,2,2624,2607,17,0,150,0,6
48447,1,2399,2404,-5,0,78,0,6
48448,1,2425,2420,5,0,107,0,8
48449,1,2472,2548,-76,0,150,0,8
48450,2,2464,2486,-22,0,101,0,6
48451,1,2416,2414,2,0,0,0,6
48452,2,2422,2311,111,0,48,0,6
48453,2,2407,2413,-6,0,113,0,6
48454,1,2602,2285,317,0,102,0,6
48455,2,2381,2560,-179,0,4,0,6
48456,1,2539,2353,186,0,335,0,6
48457,2,2440,2410,30,0,108,0,6
48459,2,2381,2463,-82,0,141,1,6
48460,2,2408,2400,8,0,200,0,6
48461,2,2377,2414,-37,0,101,0,6
48462,1,2613,2574,39,0,8,0,6
48463,1,2330,2410,-80,0,330,1,6
48464,1,2253,2403,-150,0,110,1,8
48465,1,2407,2419,-12,0,351,1,6
48466,1,2437,2402,35,0,190,1,6
48467,3,2427,2458,-31,0,226,0,6
48468,1,2465,2396,69,0,347,0,6
48469,1,2408,2421,-13,0,0,0,6
48470,2,2284,2604,-320,0,40,0,6
48471,2,2448,2296,152,0,46,0,6
48472,1,2586,2472,114,0,118,0,6
48473,2,2306,2425,-119,0,302,0,8
48474,2,2565,2397,168,0,190,0,6
48475,2,2245,2509,-264,0,10,0,6
48476,3,2542,2405,137,0,48,0,6
48477,1,2418,2406,12,4,200,0,13
48478,1,2303,2420,-117,0,310,0,6
48479,1,2406,2586,-180,0,45,0,6
48480,2,2532,2458,74,0,267,0,6
48481,2,2467,2377,90,0,28,1,6
48482,1,2429,2237,192,0,128,0,8
48483,1,2403,2362,41,0,46,0,6
48484,2,2475,2618,-143,0,45,0,6
48485,1,2428,2569,-141,0,105,0,6
48486,1,2407,2295,112,0,462,0,6
48487,1,2415,2414,1,0,0,0,6
48488,1,2606,2282,324,0,484,0,6
48489,2,2416,2421,-5,0,101,0,8
48490,2,2384,2467,-83,0,245,1,6
48491,1,2413,2575,-162,0,40,0,6
48492,1,2397,2447,-50,0,141,0,6
48493,2,2274,2440,-166,0,310,0,6
48494,2,2391,2582,-191,0,156,0,6
48495,1,2272,2417,-145,0,106,0,6
48496,2,2468,2421,47,0,315,0,6
48497,2,2553,2342,211,0,163,0,6
48498,2,2443,2484,-41,0,48,1,6
48499,2,2470,2590,-120,0,455,0,6
48500,1,2279,2402,-123,0,120,0,6
48501,1,2412,2323,89,0,130,1,6
48502,2,2397,2427,-30,0,455,0,6
48503,2,2435,2404,31,0,124,1,6
48504,2,2434,2300,134,0,241,0,6
48505,1,2425,2301,124,4,112,0,13
48506,1,2566,2421,145,0,113,1,6
48507,1,2359,2436,-77,0,394,1,6
48508,2,2384,2460,-76,0,191,0,6
48509,3,2345,2401,-56,0,133,0,6
48510,2,2409,2421,-12,0,0,0,6
48511,1,2504,2359,145,0,46,1,6
48512,2,2389,2506,-117,0,195,0,6
48513,1,2411,2366,45,0,13,0,6
48514,2,2281,2608,-327,0,331,0,6
48516,1,2465,2320,145,0,0,0,6
48517,2,2380,2414,-34,0,103,0,6
48518,2,2351,2540,-189,0,41,0,6
48519,2,2298,2427,-129,0,123,0,6
48520,1,2432,2391,41,0,101,1,6
48521,2,2362,2402,-40,4,302,0,13
48522,2,2426,2385,41,0,150,0,6
48523,2,2510,2462,48,0,326,0,6
48524,2,2594,2468,126,0,0,0,6
48525,3,2400,2346,54,0,43,0,6
48526,1,2416,2373,43,0,147,0,6
48527,1,2481,2428,53,0,411,1,6
48528,2,2357,2578,-221,0,486,1,6
48529,3,2403,2412,-9,0,106,0,6
48530,2,2403,2429,-26,0,40,0,6
48531,2,2297,2416,-119,0,113,0,6
48532,2,2465,2380,85,0,123,0,6
48533,1,2418,2570,-152,0,339,0,6
48534,1,2472,2335,137,0,132,1,6
48535,2,2410,2424,-14,0,112,1,6
48536,2,2280,2401,-121,4,209,0,13
48537,2,2362,2454,-92,0,125,1,6
48538,2,2417,2468,-51,0,45,0,6
48539,1,2402,2300,102,0,140,0,6
48540,2,2345,2503,-158,0,1,1,6
48541,1,2391,2420,-29,0,211,1,6
48542,1,2465,2429,36,0,440,0,6
48543,2,2419,2515,-96,0,380,0,6
48544,2,2327,2415,-88,0,315,1,6
48545,1,2397,2438,-41,0,9,0,6
48546,2,2545,2348,197,0,46,0,6
48547,1,2313,2431,-118,0,1,1,6
48549,1,2514,2332,182,0,190,0,6
48550,2,2325,2422,-97,0,130,0,6
48551,1,2622,2587,35,0,4,0,6
48552,2,2411,2403,8,0,0,0,6
48553,2,2486,2413,73,0,300,1,6
48554,1,2370,2520,-150,0,103,1,6
48555,2,2227,2404,-177,0,135,0,6
48556,3,2265,2422,-157,0,105,0,8
48557,1,2432,2311,121,0,302,1,6
48558,1,2408,2311,97,4,101,0,13
48559,2,2562,2517,45,0,138,0,6
48560,2,2434,2404,30,0,317,1,6
48561,1,2582,2627,-45,0,5,1,6
48562,1,2409,2339,70,0,30,0,6
48563,1,2420,2426,-6,0,335,1,6
48564,1,2306,2413,-107,0,36,1,6
48565,1,2580,2516,64,0,226,1,6
48566,2,2424,2311,113,0,298,1,6
48567,2,2437,2473,-36,0,245,0,6
48568,1,2407,2310,97,0,405,1,6
48569,2,2324,2414,-90,0,241,1,6
48570,1,2458,2357,101,0,153,1,6
48571,1,2423,2540,-117,0,120,0,6
48572,1,2409,2406,3,0,190,0,6
48573,2,2435,2342,93,0,106,0,6
48574,2,2478,2341,137,0,110,0,6
48575,1,2411,2296,115,0,1,1,6
48576,1,2423,2321,102,0,4,0,6
48577,2,2315,2479,-164,0,20,0,6
48578,1,2572,2507,65,0,380,0,6
48579,2,2405,2393,12,4,176,0,13
48580,1,2420,2295,125,0,84,0,6
48581,1,2327,2470,-143,0,45,1,6
48582,2,2457,2506,-49,0,190,0,6
48583,1,2556,2530,26,0,113,1,6
48584,1,2523,2348,175,0,163,0,6
48585,1,2420,2426,-6,0,387,0,6
48586,1,2436,2261,175,0,241,1,6
48587,2,2620,2588,32,0,4,1,6
48588,2,2382,2533,-151,0,41,0,6
48589,3,2437,2415,22,0,112,0,6
48590,2,2420,2426,-6,0,335,0,6
48591,1,2406,2315,91,0,36,0,6
48592,3,2411,2424,-13,0,311,0,6
48593,1,2503,2527,-24,0,46,0,6
48594,1,2421,2403,18,0,301,0,6
48595,1,2319,2416,-97,0,190,1,6
48596,1,2482,2418,64,0,40,0,6
48597,1,2352,2428,-76,0,133,0,6
48598,2,2471,2349,122,0,106,0,6
48599,1,2593,2577,16,0,140,0,6
48600,1,2401,2397,4,0,0,0,6
48601,1,2510,2606,-96,0,200,0,6
48602,1,2432,2489,-57,0,4,0,6
48603,2,2268,2415,-147,0,302,0,6
48604,3,2413,2412,1,0,107,0,6
48605,1,2462,2585,-123,0,181,0,6
48606,2,2351,2511,-160,0,17,1,6
48607,2,2382,2509,-127,0,249,1,6
48608,2,2521,2524,-3,0,106,0,6
48609,2,2415,2437,-22,0,190,0,6
48610,2,2397,2427,-30,0,242,0,6
48611,1,2452,2431,21,0,47,1,6
48612,2,2439,2561,-122,0,302,0,6
48613,1,2537,2379,158,0,133,0,6
48614,1,2439,2421,18,0,6,0,6
48615,2,2310,2410,-100,0,36,1,6
48616,2,2432,2463,-31,0,246,0,6
48617,1,2409,2485,-76,0,101,0,6
48618,1,2594,2473,121,0,146,0,6
48619,2,2357,2462,-105,0,1,0,6
48620,1,2418,2498,-80,0,141,0,6
48621,1,2415,2445,-30,0,132,0,6
48622,1,2614,2599,15,0,8,0,6
48623,1,2328,2408,-80,0,113,0,6
48624,2,2270,2405,-135,4,453,0,8
48625,2,2440,2410,30,0,474,0,6
48626,2,2295,2411,-116,0,43,1,6
48627,2,2571,2598,-27,0,80,1,6
48628,2,2416,2313,103,0,162,0,6
48629,2,2407,2343,64,0,0,0,6
48630,1,2412,2435,-23,0,11,1,6
48631,2,2515,2530,-15,0,40,0,6
48632,3,2536,2565,-29,0,278,0,6
48633,2,2432,2392,40,0,311,1,6
48634,1,2348,2413,-65,0,34,0,6
48635,1,2403,2287,116,0,101,0,6
48636,1,2292,2458,-166,0,343,0,6
48637,1,2414,2305,109,0,36,0,6
48638,3,2425,2381,44,0,191,0,6
48639,2,2422,2483,-61,0,200,0,6
48640,1,2468,2321,147,0,107,0,6
48641,2,2467,2598,-131,0,194,1,6
48642,1,2409,2267,142,4,453,1,8
48643,2,2593,2527,66,0,43,0,6
48644,2,2450,2427,23,0,346,0,6
48645,1,2318,2450,-132,0,45,0,5
48646,1,2407,2353,54,0,40,0,6
48647,1,2359,2513,-154,0,392,0,6
48648,1,2343,2409,-66,0,18,1,6
48649,2,2414,2289,125,0,45,0,6
48650,1,2487,2417,70,0,40,1,6
48651,2,2509,2566,-57,0,335,0,6
48652,1,2466,2385,81,0,335,0,6
48653,1,2604,2544,60,0,3,1,6
48654,2,2282,2434,-152,0,123,0,6
48655,2,2471,2416,55,0,460,0,6
48656,2,2279,2418,-139,0,205,0,6
48657,1,2564,2566,-2,0,105,1,6
48658,2,2577,2643,-66,0,118,0,6
48659,1,2368,2429,-61,0,113,1,6
48660,2,2245,2404,-159,0,110,0,6
48661,3,2407,2355,52,0,150,0,6
48662,1,2471,2439,32,0,310,0,6
48663,1,2398,2426,-28,0,103,0,6
48664,2,2571,2505,66,0,463,0,6
48665,1,2402,2461,-59,0,53,1,6
48666,2,2295,2472,-177,0,418,0,6
48667,1,2438,2348,90,0,40,1,6
48668,2,2320,2412,-92,0,300,0,6
48669,2,2318,2404,-86,0,49,0,6
48670,2,2505,2602,-97,0,46,0,6
48671,2,2331,2421,-90,0,13,0,8
48672,1,2445,2280,165,2,244,0,23
48673,1,2346,2413,-67,0,45,0,6
48674,2,2424,2443,-19,0,141,1,6
48675,2,2433,2534,-101,0,201,0,6
48676,2,2422,2275,147,0,335,1,6
48677,2,2464,2586,-122,0,455,0,6
48678,2,2412,2492,-80,0,151,0,6
48679,2,2314,2402,-88,0,140,0,6
48680,2,2511,2564,-53,0,122,0,6
48681,2,2356,2406,-50,0,13,0,6
48682,3,2417,2221,196,0,404,0,6
48683,2,2302,2402,-100,0,150,0,6
48684,2,2278,2419,-141,0,4,0,6
48685,2,2209,2485,-276,0,45,0,6
48686,2,2293,2472,-179,0,300,0,6
48687,2,2423,2417,6,0,112,0,6
48688,1,2475,2330,145,0,123,1,6
48689,1,2606,2590,16,0,0,1,6
48690,3,2315,2460,-145,0,45,0,6
48691,3,2326,2422,-96,0,110,0,6
48692,1,2560,2609,-49,0,10,0,6
48693,1,2463,2476,-13,0,405,1,6
48694,2,2341,2407,-66,0,114,0,6
48695,1,2686,2432,254,0,128,0,6
48696,1,2538,2429,109,0,300,1,6
48697,2,2298,2442,-144,0,131,0,6
48698,2,2400,2570,-170,0,327,0,6
48699,1,2406,2305,101,0,110,0,6
48700,2,2448,2551,-103,0,40,0,6
48701,1,2497,2408,89,0,107,0,6
48702,2,2409,2483,-74,0,310,0,6
48703,1,2373,2449,-76,0,309,0,6
48704,2,2344,2419,-75,0,1,1,6
48705,1,2411,2351,60,0,150,0,6
48706,1,2283,2414,-131,0,221,1,6
48707,1,2421,2315,106,0,43,0,6
48708,1,2397,2414,-17,0,0,0,6
48709,2,2423,2417,6,0,45,1,6
48710,2,2368,2589,-221,0,4,1,6
48711,1,2289,2411,-122,0,111,1,6
48712,3,2585,2573,12,0,140,0,6
48713,3,2458,2500,-42,0,335,0,6
48714,2,2421,2410,11,0,142,1,6
48715,2,2602,2567,35,0,7,0,6
48716,1,2411,2378,33,0,110,1,6
48717,1,2501,2336,165,0,46,0,6
48718,2,2287,2419,-132,0,45,0,6
48719,1,2487,2476,11,0,302,0,6
48720,2,2207,2491,-284,0,40,1,6
48721,2,2219,2528,-309,0,111,0,6
48722,1,2425,2344,81,0,106,1,8
48723,2,2430,2689,-259,0,121,0,6
48724,2,2425,2318,107,0,46,0,6
48725,2,2346,2416,-70,0,11,1,6
48726,2,2478,2398,80,0,46,0,6
48727,2,2585,2489,96,0,40,0,6
48728,1,2425,2542,-117,0,201,1,6
48729,2,2373,2446,-73,0,142,0,6
48730,1,2620,2444,176,0,4,0,6
48731,2,2394,2488,-94,0,15,0,6
48732,1,2311,2404,-93,0,454,0,6
48733,2,2406,2343,63,0,249,1,6
48734,1,2292,2435,-143,0,245,1,6
48735,2,2573,2424,149,0,190,0,6
48736,1,2423,2417,6,0,112,0,6
48737,2,2469,2427,42,0,46,0,6
48738,2,2203,2402,-199,0,302,0,6
48739,1,2339,2501,-162,0,1,1,6
48740,1,2470,2359,111,0,466,0,6
48741,1,2299,2416,-117,4,353,0,13
48742,2,2288,2459,-171,0,102,0,6
48743,2,2365,2418,-53,0,311,1,6
48744,1,2478,2235,243,0,0,0,6
48745,1,2499,2471,28,0,40,0,6
48746,1,2573,2596,-23,0,10,0,6
48747,1,2504,2612,-108,0,337,1,6
48748,1,2411,2429,-18,0,313,0,6
48749,3,2416,2405,11,0,407,0,6
48750,2,2466,2504,-38,0,192,0,6
48751,1,2416,2415,1,0,28,0,6
48752,1,2420,2341,79,0,128,0,6
48753,2,2419,2384,35,0,120,0,6
48754,1,2373,2416,-43,0,150,0,6
48755,1,2496,2325,171,0,130,1,6
48756,1,2535,2433,102,0,0,0,6
48757,2,2439,2282,157,0,260,0,6
48758,2,2492,2397,95,0,455,0,6
48759,2,2429,2539,-110,0,216,1,6
48760,2,2384,2493,-109,0,106,0,6
48761,2,2417,2217,200,0,4,0,6
48762,2,2284,2529,-245,0,15,1,6
48763,2,2423,2492,-69,0,484,1,6
48764,1,2591,2440,151,0,15,0,6
48765,2,2332,2403,-71,0,45,0,6
48766,2,2400,2248,152,0,109,0,6
48767,2,2350,2404,-54,0,49,1,6
48768,3,2432,2565,-133,0,253,0,6
48769,2,2318,2440,-122,0,469,0,6
48770,2,2437,2309,128,4,115,0,13
48771,2,2437,2595,-158,0,45,0,6
48772,1,2404,2405,-1,0,331,0,6
48774,2,2438,2493,-55,0,96,0,6
48775,2,2590,2579,11,0,7,1,6
48776,1,2423,2375,48,0,46,1,6
48777,3,2573,2584,-11,0,226,0,6
48778,1,2461,2360,101,0,0,0,6
48779,1,2410,2422,-12,0,338,0,6
48780,2,2453,2509,-56,0,202,1,6
48781,1,2423,2417,6,0,121,0,6
48782,1,2408,2511,-103,0,45,1,6
48783,2,2404,2485,-81,0,110,0,6
48784,2,2302,2409,-107,0,46,1,6
48785,2,2305,2431,-126,0,152,0,6
48786,1,2405,2416,-11,0,45,1,6
48787,2,2406,2314,92,0,241,0,6
48788,1,2337,2425,-88,0,200,1,6
48789,1,2475,2428,47,0,106,0,6
48790,1,2523,2370,153,0,331,1,6
48791,1,2513,2348,165,0,4,0,6
48792,1,2489,2400,89,0,40,0,6
48793,1,2604,2499,105,0,0,1,6
48794,1,2598,2434,164,0,15,0,6
48795,1,2498,2431,67,0,344,0,6
48796,2,2400,2410,-10,0,373,0,6
48797,2,2543,2425,118,0,45,0,6
48798,2,2412,2429,-17,0,43,1,6
48799,2,2201,2588,-387,4,4,1,13
48800,2,2368,2400,-32,0,241,0,6
48801,1,2408,2201,207,0,112,0,6
48802,1,2497,2282,215,0,110,0,6
48803,2,2352,2471,-119,0,245,0,6
48804,3,2532,2497,35,0,15,0,6
48805,1,2237,2423,-186,0,415,0,6
48806,1,2514,2563,-49,0,301,1,6
48807,1,2494,2390,104,0,321,0,6
48808,2,2395,2444,-49,0,102,0,6
48809,1,2445,2340,105,0,106,0,6
48810,3,2343,2430,-87,0,315,0,8
48811,2,2450,2384,66,0,58,0,6
48812,2,2431,2580,-149,0,301,1,6
48813,3,2425,2502,-77,0,4,0,6
48814,1,2392,2428,-36,0,115,0,6
48815,1,2449,2321,128,0,4,0,6
48816,2,2367,2498,-131,0,110,0,6
48817,2,2435,2386,49,0,299,0,6
48818,1,2317,2484,-167,0,45,0,6
48819,2,2504,2601,-97,0,46,0,6
48820,1,2410,2411,-1,0,4,1,6
48821,2,2413,2379,34,0,135,1,6
48822,1,2418,2344,74,0,107,0,6
48823,1,2423,2298,125,0,0,0,6
48824,2,2495,2432,63,0,257,0,6
48825,2,2516,2435,81,0,302,1,6
48826,2,2434,2418,16,0,153,0,6
48827,1,2480,2608,-128,0,190,1,6
48828,2,2334,2408,-74,0,35,0,6
48829,1,2434,2406,28,0,112,1,6
48830,2,2443,2339,104,0,426,0,6
48831,1,2391,2492,-101,0,6,0,6
48832,3,2457,2326,131,0,225,0,6
48833,2,2322,2427,-105,0,106,0,6
48834,1,2336,2450,-114,0,100,0,6
48835,2,2429,2500,-71,0,107,0,6
48836,2,2501,2534,-33,0,44,1,6
48837,2,2393,2450,-57,0,394,0,6
48838,1,2514,2258,256,0,0,0,6
48839,2,2354,2421,-67,0,4,0,6
48840,1,2557,2398,159,0,154,0,6
48841,2,2352,2410,-58,0,4,0,6
48842,1,2531,2287,244,0,302,1,6
48843,1,2498,2282,216,0,455,0,6
48844,1,2475,2245,230,0,409,0,6
48845,1,2416,2573,-157,0,490,0,6
48846,3,2340,2422,-82,0,224,0,6
48847,1,2584,2427,157,0,100,1,6
48848,2,2475,2415,60,0,455,1,6
48849,2,2427,2500,-73,0,373,0,6
48850,1,2535,2606,-71,0,45,0,6
48851,2,2453,2521,-68,0,14,1,6
48852,2,2405,2233,172,0,311,0,6
48853,1,2436,2349,87,0,385,0,6
48854,1,2406,2416,-10,0,106,1,6
48855,1,2439,2488,-49,0,106,1,6
48856,3,2424,2424,0,0,400,0,6
48857,1,2505,2345,160,0,106,0,6
48858,2,2316,2472,-156,0,245,0,6
48859,1,2421,2341,80,0,130,0,6
48860,2,2669,2531,138,0,122,0,6
48861,2,2473,2407,66,0,335,1,6
48862,2,2431,2415,16,0,8,1,6
48863,2,2277,2426,-149,4,16,1,13
48864,1,2428,2469,-41,0,102,1,8
48865,2,2585,2501,84,0,454,1,6
48866,3,2433,2488,-55,0,4,0,6
48867,2,2328,2455,-127,0,106,0,6
48868,2,2505,2442,63,0,41,1,6
48869,2,2313,2440,-127,0,248,0,6
48870,1,2477,2542,-65,0,201,0,6
48871,1,2496,2316,180,0,307,1,6
48872,2,2297,2434,-137,0,190,1,6
48873,1,2422,2476,-54,0,303,0,6
48874,2,2289,2421,-132,0,136,0,6
48875,1,2341,2448,-107,0,1,1,6
48876,1,2490,2291,199,0,111,0,6
48877,1,2477,2534,-57,0,115,0,6
48878,2,2414,2408,6,0,490,1,6
48879,1,2353,2500,-147,0,244,0,6
48880,1,2539,2527,12,0,302,0,6
48881,1,2469,2428,41,0,127,1,6
48882,1,2412,2317,95,0,265,1,6
48883,2,2307,2400,-93,0,302,0,6
48884,1,2455,2287,168,0,20,0,6
48885,1,2227,2405,-178,0,241,1,6
48886,2,2489,2623,-134,0,463,1,6
48887,1,2415,2398,17,0,485,0,6
48888,2,2459,2324,135,0,225,1,6
48889,1,2394,2424,-30,0,302,0,6
48890,2,2439,2424,15,0,190,0,6
48891,2,2401,2217,184,0,40,1,6
48892,1,2482,2410,72,0,107,0,6
48893,1,2504,2509,-5,0,211,0,6
48894,1,2446,2471,-25,0,201,1,6
48895,2,2403,2336,67,0,304,0,6
48896,1,2318,2421,-103,0,57,0,6
48897,1,2467,2332,135,0,335,0,6
48898,1,2486,2353,133,0,123,1,6
48899,2,2536,2449,87,0,46,1,6
48900,1,2267,2444,-177,0,121,0,6
48901,2,2357,2499,-142,0,40,0,6
48902,2,2382,2560,-178,0,20,0,6
48903,1,2521,2484,37,0,310,0,6
48904,2,2458,2545,-87,0,30,1,6
48905,2,2438,2508,-70,0,102,1,6
48906,2,2423,2474,-51,0,303,0,6
48907,2,2566,2627,-61,0,454,0,6
48908,1,2401,2250,151,0,331,0,8
48909,2,2405,2433,-28,0,453,0,6
48910,1,2448,2371,77,0,100,1,6
48911,1,2493,2291,202,0,125,0,6
48912,2,2492,2251,241,0,4,0,6
48913,2,2527,2361,166,0,15,0,6
48914,3,2408,2484,-76,0,8,0,6
48915,2,2498,2376,122,0,40,0,6
48916,2,2452,2530,-78,0,195,0,6
48917,1,2464,2310,154,0,112,0,6
48918,1,2503,2339,164,0,45,0,6
48919,1,2439,2363,76,0,41,0,6
48920,2,2306,2468,-162,0,48,0,6
48921,1,2414,2325,89,0,32,1,6
48922,2,2479,2458,21,0,278,1,6
48923,2,2418,2349,69,0,106,0,6
48924,1,2463,2435,28,0,473,1,8
48925,2,2425,2612,-187,0,10,0,6
48926,2,2339,2470,-131,0,13,0,6
48927,1,2506,2351,155,0,45,0,6
48928,1,2293,2436,-143,0,48,0,6
48929,3,2376,2592,-216,4,242,0,13
48930,3,2534,2448,86,0,256,0,6
48931,1,2312,2417,-105,0,58,0,6
48932,1,2282,2463,-181,0,203,0,6
48933,1,2557,2487,70,0,106,0,6
48934,2,2284,2472,-188,0,0,1,6
48935,3,2239,2473,-234,0,269,0,6
48936,3,2303,2444,-141,0,46,0,6
48937,1,2411,2380,31,0,101,0,6
48938,2,2369,2509,-140,0,96,0,6
48939,2,2403,2434,-31,0,311,0,6
48940,2,2356,2479,-123,0,0,0,6
48941,1,2317,2404,-87,0,301,1,6
48942,1,2513,2433,80,0,150,1,6
48943,1,2465,2439,26,0,5,0,6
48944,1,2631,2400,231,0,460,0,6
48945,2,2383,2491,-108,0,247,0,6
48946,1,2470,2242,228,0,103,0,6
48947,2,2384,2532,-148,0,201,0,6
48948,1,2418,2300,118,0,320,0,6
48949,2,2312,2452,-140,0,150,0,6
48950,2,2352,2482,-130,0,1,0,6
48951,1,2386,2474,-88,0,140,1,6
48952,1,2411,2241,170,0,57,0,6
48953,1,2483,2351,132,0,5,1,6
48954,2,2370,2417,-47,0,107,1,6
48955,1,2483,2496,-13,0,40,0,6
48956,1,2483,2349,134,0,101,1,6
48957,1,2562,2562,0,0,331,0,6
48958,2,2449,2533,-84,0,195,0,6
48959,3,2464,2484,-20,0,67,0,6
48960,1,2404,2427,-23,0,101,1,6
48961,1,2321,2416,-95,0,344,0,6
48962,2,2249,2406,-157,0,485,0,6
48963,1,2434,2470,-36,0,101,0,6
48964,2,2563,2531,32,0,265,0,6
48965,1,2400,2297,103,0,107,1,6
48966,3,2422,2513,-91,0,40,0,6
48967,1,2486,2348,138,0,106,1,6
48968,1,2429,2442,-13,0,49,0,6
48969,3,2398,2495,-97,0,380,0,6
48970,1,2366,2407,-41,0,101,0,6
48971,2,2239,2472,-233,0,252,0,6
48972,2,2429,2457,-28,0,200,0,6
48973,2,2513,2556,-43,0,355,0,6
48974,2,2534,2536,-2,0,302,0,6
48975,1,2385,2524,-139,0,43,0,8
48976,2,2634,2666,-32,0,4,0,6
48977,2,2435,2398,37,0,106,1,6
48978,1,2464,2508,-44,0,107,0,6
48979,1,2583,2213,370,4,200,0,13
48980,2,2409,2422,-13,0,143,0,6
48981,2,2430,2440,-10,0,343,1,6
48982,2,2409,2380,29,0,107,0,6
48983,2,2391,2464,-73,0,453,0,6
48984,2,2543,2411,132,0,107,0,6
48985,2,2404,2424,-20,0,181,1,6
48986,2,2425,2328,97,0,125,0,6
48987,1,2456,2473,-17,0,121,0,6
48988,1,2483,2399,84,0,45,0,6
48989,1,2463,2423,40,0,311,1,6
48990,1,2421,2275,146,0,107,0,6
48991,2,2295,2403,-108,0,180,0,6
48992,1,2387,2436,-49,0,49,1,6
48993,2,2537,2557,-20,0,338,1,6
48994,1,2400,2372,28,0,247,0,6
48995,1,2475,2361,114,0,211,0,6
48996,1,2502,2445,57,0,300,0,6
48997,1,2514,2384,130,0,302,1,6
48998,1,2424,2265,159,0,4,0,6
48999,2,2414,2489,-75,0,50,0,6
49000,1,2490,2365,125,0,200,0,6
49001,1,2475,2237,238,0,190,0,6
49002,2,2279,2404,-125,0,4,0,6
49003,1,2471,2315,156,0,302,0,6
49004,2,2512,2424,88,0,102,0,6
49005,2,2345,2489,-144,0,1,0,6
49006,2,2462,2561,-99,0,225,0,6
49007,1,2440,2418,22,0,106,0,6
49008,1,2467,2493,-26,0,48,0,6
49009,1,2549,2498,51,0,300,0,6
49010,1,2541,2393,148,0,4,0,6
49011,1,2535,2411,124,0,4,0,6
49012,1,2671,2629,42,0,176,0,6
49013,2,2516,2579,-63,0,140,0,8
49014,2,2469,2442,27,0,405,0,6
49015,2,2429,2425,4,0,131,1,6
49016,3,2407,2367,40,0,104,0,6
49017,3,2493,2341,152,0,106,0,6
49018,1,2401,2278,123,0,15,0,8
49019,2,2312,2474,-162,0,200,1,6
49020,1,2400,2411,-11,0,49,0,6
49021,2,2331,2545,-214,0,1,0,6
49022,1,2504,2335,169,0,40,1,6
49023,1,2433,2286,147,0,244,0,6
49024,1,2424,2480,-56,0,458,0,6
49025,1,2441,2373,68,0,4,1,6
49026,1,2565,2458,107,0,128,0,6
49027,2,2408,2431,-23,0,103,1,6
49028,2,2418,2468,-50,0,200,0,6
49029,1,2661,2567,94,0,110,0,6
49030,1,2394,2430,-36,0,277,0,6
49031,2,2407,2539,-132,0,150,0,6
49032,1,2491,2319,172,0,49,1,6
49033,2,2227,2404,-177,0,109,0,6
49034,3,2529,2445,84,0,303,0,6
49035,1,2427,2404,23,0,28,0,6
49036,1,2488,2328,160,0,343,0,6
49037,3,2430,2393,37,0,115,0,6
49038,2,2449,2463,-14,0,0,0,6
49039,2,2487,2398,89,0,313,0,6
49040,1,2261,2401,-140,0,146,0,6
49041,1,2485,2238,247,0,112,0,6
49042,2,2327,2491,-164,0,45,0,6
49043,1,2454,2569,-115,0,225,1,6
49044,2,2240,2493,-253,0,106,0,6
49045,1,2361,2410,-49,0,150,1,6
49046,2,2262,2517,-255,0,310,1,6
49047,3,2488,2424,64,0,457,0,6
49048,1,2493,2351,142,0,487,0,6
49049,2,2563,2532,31,0,7,0,6
49050,2,2554,2440,114,0,300,0,6
49051,2,2404,2405,-1,0,307,0,6
49052,3,2547,2504,43,0,15,0,6
49053,1,2264,2487,-223,0,246,0,6
49054,2,2389,2440,-51,0,220,1,6
49055,3,2352,2423,-71,0,300,0,6
49056,1,2624,2677,-53,0,122,0,6
49057,1,2277,2431,-154,0,10,0,6
49058,1,2539,2507,32,0,490,0,6
49059,2,2355,2407,-52,0,345,0,6
49060,1,2332,2508,-176,0,40,1,6
49061,2,2563,2665,-102,0,320,1,6
49062,2,2344,2491,-147,0,0,0,6
49063,3,2436,2309,127,0,61,0,6
49064,1,2393,2543,-150,0,190,0,6
49065,2,2283,2407,-124,0,150,1,6
49066,2,2405,2480,-75,0,384,0,6
49067,1,2406,2450,-44,0,132,1,6
49068,1,2446,2402,44,0,455,0,6
49069,1,2468,2413,55,0,304,1,6
49070,1,2478,2308,170,0,311,1,6
49071,1,2494,2494,0,0,453,0,6
49072,3,2492,2337,155,0,150,0,6
49073,2,2447,2547,-100,0,210,0,6
49074,2,2502,2448,54,0,45,0,6
49075,1,2505,2324,181,0,130,0,6
49076,3,2398,2433,-35,0,143,0,6
49077,1,2535,2401,134,0,45,0,6
49078,2,2362,2544,-182,0,110,0,6
49079,1,2562,2461,101,0,128,0,6
49080,3,2394,2526,-132,0,311,0,6
49081,2,2538,2556,-18,0,22,1,6
49082,2,2411,2352,59,0,128,0,6
49083,2,2479,2325,154,0,226,0,6
49084,1,2670,2630,40,0,152,0,6
49085,1,2398,2484,-86,4,149,0,13
49086,3,2285,2421,-136,0,16,0,6
49087,1,2565,2430,135,0,227,0,6
49088,2,2423,2399,24,0,461,1,6
49089,1,2411,2485,-74,0,249,0,6
49090,1,2327,2405,-78,0,40,0,6
49091,1,2329,2406,-77,0,115,0,6
49092,2,2434,2408,26,0,453,0,6
49093,1,2495,2400,95,0,45,1,6
49094,1,2443,2353,90,0,380,1,6
49095,1,2499,2353,146,0,343,0,6
49096,1,2457,2566,-109,0,202,0,6
49097,1,2489,2319,170,0,240,0,6
49098,1,2484,2551,-67,0,10,0,6
49099,2,2443,2435,8,0,210,0,6
49100,2,2404,2584,-180,0,46,0,8
49101,2,2409,2473,-64,0,200,1,6
49102,2,2440,2625,-185,0,150,0,6
49103,1,2341,2486,-145,0,336,0,6
49104,2,2474,2508,-34,0,343,0,6
49105,1,2291,2436,-145,0,31,0,6
49106,2,2301,2429,-128,4,324,0,13
49107,1,2424,2538,-114,0,301,0,6
49108,2,2454,2503,-49,0,213,1,6
49109,1,2452,2416,36,0,416,0,6
49110,2,2513,2469,44,0,330,0,6
49111,2,2348,2492,-144,0,466,0,6
49112,1,2395,2475,-80,0,211,0,6
49113,1,2418,2428,-10,0,102,0,6
49114,1,2396,2401,-5,0,49,0,6
49115,3,2229,2461,-232,0,142,0,8
49116,2,2435,2412,23,0,245,0,6
49117,1,2327,2411,-84,0,5,0,6
49118,1,2402,2367,35,0,134,0,6
49119,2,2416,2246,170,0,269,1,6
49120,2,2400,2320,80,0,124,0,6
49121,1,2465,2519,-54,0,121,0,6
49122,2,2427,2260,167,0,100,0,6
49123,2,2389,2409,-20,0,102,1,6
49124,2,2316,2405,-89,0,300,0,6
49125,1,2478,2404,74,0,150,0,6
49126,1,2676,2630,46,0,46,0,6
49127,1,2391,2499,-108,0,10,0,6
49128,2,2396,2477,-81,0,195,0,6
49129,1,2427,2303,124,0,123,0,6
49130,1,2466,2587,-121,4,49,0,13
49131,2,2401,2424,-23,0,300,0,6
49132,1,2562,2533,29,0,113,1,6
49133,2,2492,2402,90,0,53,0,6
49134,2,2441,2437,4,0,48,0,6
49135,2,2478,2349,129,0,40,0,6
49136,1,2495,2538,-43,0,40,0,6
49137,1,2258,2411,-153,0,257,0,8
49138,1,2468,2402,66,0,184,0,6
49139,2,2395,2569,-174,0,140,0,6
49140,1,2436,2547,-111,0,200,0,6
49141,1,2429,2340,89,0,40,0,6
49142,2,2508,2449,59,0,310,0,6
49143,2,2452,2383,69,0,310,0,6
49144,1,2397,2473,-76,0,211,1,6
49145,1,2411,2457,-46,0,415,0,6
49146,2,2239,2407,-168,0,196,0,6
49147,1,2420,2287,133,0,317,0,6
49148,1,2681,2559,122,0,46,1,6
49149,2,2432,2399,33,0,33,0,6
49150,1,2559,2476,83,0,130,0,6
49151,2,2410,2492,-82,0,241,1,6
49152,2,2408,2393,15,0,145,1,6
49153,3,2431,2429,2,0,123,0,6
49154,1,2512,2330,182,0,241,0,6
49155,1,2443,2435,8,0,210,1,6
49156,1,2409,2418,-9,0,292,0,6
49157,1,2415,2400,15,0,463,0,6
49158,1,2400,2483,-83,0,257,1,6
49159,1,2443,2397,46,0,277,1,6
49160,2,2269,2419,-150,0,255,0,6
49161,2,2414,2485,-71,0,15,0,6
49162,3,2544,2392,152,0,455,0,6
49163,2,2321,2429,-108,0,134,0,6
49165,1,2336,2433,-97,0,1,1,6
49166,2,2319,2445,-126,0,268,1,6
49167,2,2426,2421,5,0,46,0,6
49168,1,2531,2471,60,0,54,0,6
49169,1,2404,2298,106,0,0,1,6
49170,2,2411,2241,170,0,484,0,8
49171,2,2404,2424,-20,0,217,0,6
49172,2,2303,2401,-98,0,122,0,6
49173,2,2496,2314,182,0,45,0,6
49174,1,2394,2420,-26,0,200,0,6
49175,2,2412,2406,6,0,190,1,6
49176,1,2354,2415,-61,0,461,0,6
49177,1,2369,2490,-121,0,0,0,6
49178,2,2471,2563,-92,0,302,0,6
49179,2,2466,2390,76,0,256,1,6
49180,3,2448,2301,147,0,315,0,6
49181,1,2367,2414,-47,0,484,0,6
49182,1,2481,2399,82,0,310,0,6
49183,1,2430,2313,117,0,58,0,6
49184,2,2401,2260,141,0,110,0,6
49185,2,2555,2685,-130,0,426,0,6
49186,2,2477,2324,153,4,110,0,13
49187,1,2422,2265,157,0,100,1,6
49188,1,2515,2334,181,0,34,0,6
49189,2,2420,2402,18,0,108,0,6
49190,1,2429,2466,-37,0,127,0,6
49191,2,2472,2524,-52,0,101,0,6
49192,2,2464,2375,89,0,308,0,6
49193,2,2476,2407,69,0,184,0,6
49194,2,2527,2426,101,0,337,0,6
49195,3,2435,2472,-37,0,302,0,6
49196,1,2451,2405,46,0,320,1,6
49197,2,2572,2380,192,0,125,0,6
49198,2,2350,2408,-58,0,2,0,6
49199,1,2258,2414,-156,0,312,0,6
49200,1,2689,2552,137,0,46,0,6
49201,2,2488,2430,58,0,300,0,6
49202,1,2566,2406,160,4,207,0,13
49203,2,2301,2406,-105,0,1,0,6
49204,2,2433,2448,-15,0,110,0,6
49205,2,2267,2420,-153,0,7,1,8
49206,2,2296,2410,-114,0,130,1,6
49207,1,2426,2467,-41,0,330,0,6
49208,3,2434,2481,-47,0,107,0,6
49209,1,2492,2436,56,0,200,0,6
49210,2,2482,2336,146,0,352,0,6
49211,2,2382,2476,-94,0,193,1,6
49212,1,2536,2353,183,0,4,0,6
49213,2,2427,2343,84,0,40,0,6
49214,2,2333,2443,-110,0,4,0,6
49215,1,2385,2473,-88,0,28,1,6
49216,1,2449,2317,132,0,111,0,6
49217,2,2242,2402,-160,0,123,0,8
49218,2,2420,2361,59,0,211,0,6
49219,3,2412,2303,109,0,130,0,6
49220,1,2408,2407,1,0,292,0,6
49221,2,2416,2459,-43,0,202,0,6
49222,2,2350,2486,-136,0,1,1,6
49223,2,2318,2457,-139,0,301,0,6
49224,3,2461,2433,28,0,453,0,6
49225,2,2262,2425,-163,0,255,0,6
49226,2,2406,2340,66,0,302,0,6
49227,1,2414,2469,-55,0,112,0,6
49228,2,2408,2425,-17,0,331,0,6
49229,1,2481,2388,93,0,45,0,6
49230,2,2408,2452,-44,0,0,1,6
49231,2,2357,2434,-77,0,4,1,6
49232,1,2410,2297,113,0,40,0,6
49233,2,2413,2435,-22,0,4,1,6
49234,1,2539,2539,0,0,302,1,6
49235,2,2309,2474,-165,0,48,0,6
49236,1,2408,2310,98,0,207,0,6
49237,2,2503,2516,-13,0,10,0,6
49238,1,2432,2400,32,0,302,0,6
49239,2,2400,2456,-56,0,288,0,6
49240,1,2496,2403,93,0,110,0,6
49241,2,2433,2520,-87,0,13,1,6
49242,1,2460,2314,146,0,302,0,6
49243,2,2478,2347,131,0,302,0,6
49244,2,2407,2379,28,0,487,1,6
49245,2,2321,2447,-126,0,332,0,6
49246,2,2467,2588,-121,0,202,0,6
49247,2,2301,2413,-112,4,65,0,13
49248,1,2367,2413,-46,0,255,0,6
49249,1,2451,2464,-13,0,101,0,6
49250,1,2399,2501,-102,0,150,0,6
49251,2,2406,2336,70,0,109,0,6
49252,2,2477,2378,99,0,311,0,6
49253,2,2424,2313,111,0,134,1,8
49254,3,2401,2409,-8,0,211,0,6
49255,3,2333,2414,-81,0,344,0,6
49256,1,2480,2424,56,0,15,0,6
49257,2,2252,2410,-158,0,45,1,6
49258,2,2387,2485,-98,0,10,0,6
49259,2,2431,2387,44,0,113,0,6
49260,1,2402,2373,29,0,84,0,6
49261,2,2414,2347,67,0,10,1,6
49262,2,2297,2457,-160,0,4,1,6
49263,2,2366,2514,-148,0,41,1,6
49264,1,2407,2374,33,0,211,0,6
49265,2,2548,2567,-19,0,62,0,6
49266,1,2441,2408,33,0,245,0,6
49267,2,2369,2412,-43,0,255,0,6
49268,1,2521,2463,58,0,0,1,6
49269,3,2592,2578,14,0,265,0,6
49270,1,2461,2396,65,0,320,0,6
49271,3,2489,2320,169,0,426,0,6
49272,1,2429,2392,37,0,464,0,6
49273,1,2437,2460,-23,0,302,1,6
49274,3,2469,2353,116,4,240,0,13
49275,2,2429,2259,170,0,100,1,6
49276,1,2488,2628,-140,0,16,0,6
49277,1,2448,2399,49,0,115,1,6
49278,1,2385,2413,-28,0,152,0,6
49279,2,2404,2310,94,0,133,1,6
49280,2,2457,2524,-67,0,311,0,6
49281,1,2489,2343,146,0,45,0,6
49282,1,2426,2314,112,0,46,0,6
49283,2,2292,2412,-120,0,220,1,6
49284,2,2498,2401,97,0,341,0,6
49285,3,2409,2418,-9,0,49,0,6
49286,2,2393,2493,-100,0,241,0,6
49287,1,2413,2425,-12,0,202,0,6
49289,1,2337,2427,-90,0,40,1,6
49290,2,2306,2416,-110,0,228,0,6
49291,2,2299,2469,-170,0,1,0,6
49292,2,2407,2363,44,0,10,1,6
49293,1,2460,2516,-56,0,55,1,6
49294,1,2417,2364,53,0,380,0,6
49295,2,2403,2446,-43,0,10,1,6
49296,1,2354,2408,-54,0,0,0,6
49297,2,2420,2242,178,0,58,0,6
49298,3,2519,2487,32,0,153,0,6
49299,2,2405,2526,-121,0,106,1,6
49300,3,2485,2429,56,0,20,0,6
49301,1,2610,2561,49,0,8,0,6
49302,1,2403,2450,-47,4,178,1,13
49303,2,2578,2591,-13,0,10,0,6
49304,2,2353,2408,-55,0,301,0,6
49305,2,2252,2416,-164,0,210,0,8
49306,1,2418,2358,60,0,43,1,6
49307,2,2407,2317,90,0,112,0,6
49308,1,2359,2422,-63,0,255,0,6
49309,2,2404,2433,-29,4,324,0,13
49310,2,2409,2419,-10,0,400,0,6
49311,1,2419,2395,24,0,114,0,6
49312,3,2443,2431,12,0,302,0,6
49313,1,2529,2453,76,0,331,1,6
49314,1,2416,2366,50,0,200,0,6
49315,2,2487,2473,14,0,140,0,6
49316,1,2400,2394,6,0,352,0,6
49317,1,2400,2215,185,0,135,0,6
49318,1,2533,2509,24,0,113,0,6
49319,2,2267,2420,-153,0,255,0,6
49320,3,2328,2467,-139,4,381,0,13
49321,3,2420,2302,118,0,292,0,6
49322,3,2472,2391,81,0,127,0,6
49323,3,2387,2434,-47,0,11,0,6
49324,2,2509,2467,42,0,463,1,6
49325,1,2406,2401,5,0,202,0,6
49326,2,2518,2616,-98,0,100,0,6
49327,1,2487,2360,127,0,40,0,6
49328,1,2597,2451,146,0,57,0,6
49329,2,2424,2392,32,0,104,0,6
49330,3,2413,2481,-68,0,345,0,6
49331,1,2425,2497,-72,0,241,0,6
49332,1,2401,2404,-3,0,58,0,6
49333,3,2530,2479,51,0,0,0,6
49334,2,2431,2423,8,0,455,0,6
49335,2,2345,2520,-175,0,5,0,6
49336,1,2431,2538,-107,0,33,0,6
49337,2,2403,2443,-40,0,210,0,6
49338,1,2621,2514,107,0,7,0,6
49339,1,2342,2406,-64,0,131,1,6
49340,2,2430,2484,-54,0,151,0,6
49341,1,2441,2264,177,4,229,1,13
49342,1,2494,2330,164,0,258,0,6
49343,2,2584,2567,17,0,7,0,6
49344,2,2470,2601,-131,0,80,0,6
49345,1,2422,2388,34,0,330,0,6
49346,1,2398,2418,-20,0,200,0,6
49347,1,2258,2432,-174,0,195,0,8
49348,2,2447,2490,-43,0,241,1,6
49349,2,2395,2519,-124,0,46,0,6
49350,1,2616,2374,242,0,190,0,6
49351,1,2301,2432,-131,0,45,1,6
49352,2,2403,2213,190,0,100,0,8
49353,1,2516,2330,186,0,0,1,6
49354,2,2533,2545,-12,0,44,0,6
49355,3,2427,2522,-95,0,484,0,6
49356,1,2510,2626,-116,0,300,1,6
49357,1,2473,2503,-30,0,241,0,6
49358,2,2401,2392,9,0,106,0,6
49359,2,2357,2491,-134,0,0,0,6
49360,2,2587,2402,185,0,50,0,8
49361,1,2475,2407,68,0,45,0,6
49362,1,2431,2439,-8,0,43,1,6
49363,2,2454,2427,27,0,344,0,6
49364,1,2429,2424,5,0,46,0,6
49365,1,2527,2401,126,0,5,0,6
49366,1,2412,2404,8,0,45,1,6
49367,2,2304,2418,-114,0,228,1,6
49369,2,2531,2447,84,0,132,0,6
49370,1,2463,2438,25,4,140,0,13
49371,2,2424,2264,160,0,100,0,6
49372,2,2574,2398,176,0,201,0,6
49373,2,2497,2479,18,0,148,0,6
49374,2,2457,2534,-77,0,360,0,6
49375,1,2327,2497,-170,0,106,1,6
49376,1,2529,2414,115,0,0,0,6
49377,3,2573,2578,-5,0,101,0,6
49378,1,2521,2339,182,0,38,0,6
49379,3,2399,2411,-12,0,415,0,6
49380,3,2551,2527,24,0,337,0,6
49381,2,2602,2604,-2,0,209,0,6
49382,1,2434,2300,134,0,301,0,6
49383,1,2495,2353,142,0,336,0,6
49384,2,2523,2496,27,0,315,0,6
49385,2,2412,2487,-75,0,4,0,6
49386,2,2336,2417,-81,4,46,0,13
49387,1,2579,2297,282,0,40,1,8
49388,2,2495,2442,53,0,45,1,6
49389,1,2480,2466,14,0,242,0,6
49390,2,2438,2391,47,0,211,0,6
49391,2,2278,2424,-146,0,151,0,6
49392,1,2433,2448,-15,0,132,0,6
49393,1,2501,2309,192,0,400,0,6
49394,2,2617,2518,99,0,0,0,6
49395,1,2350,2498,-148,0,1,1,6
49396,2,2491,2363,128,0,54,0,6
49397,1,2474,2341,133,0,453,0,6
49398,1,2408,2462,-54,0,140,0,6
49399,1,2402,2484,-82,0,338,0,6
49400,2,2397,2531,-134,0,429,0,6
49401,2,2489,2425,64,0,123,0,6
49402,1,2401,2360,41,0,111,0,6
49403,2,2373,2437,-64,0,12,1,6
49404,1,2417,2435,-18,0,16,0,6
49405,2,2528,2550,-22,0,44,0,6
49406,1,2414,2357,57,0,150,0,6
49407,3,2524,2422,102,0,474,0,6
49408,2,2399,2418,-19,0,127,1,6
49409,2,2610,2533,77,0,40,0,6
49410,2,2486,2491,-5,0,45,0,6
49411,2,2402,2399,3,0,133,0,6
49412,2,2471,2472,-1,0,301,1,6
49413,1,2415,2469,-54,0,300,0,6
49414,1,2389,2407,-18,0,212,0,6
49415,2,2517,2573,-56,0,20,0,6
49416,1,2274,2401,-127,0,332,0,6
49417,3,2406,2431,-25,0,311,0,6
49418,2,2489,2314,175,0,130,1,6
49419,2,2398,2405,-7,0,48,0,6
49420,2,2353,2566,-213,0,487,1,6
49421,1,2439,2351,88,0,45,0,6
49422,1,2465,2287,178,4,131,0,13
49424,2,2371,2435,-64,0,9,1,6
49425,1,2264,2424,-160,0,190,0,8
49426,1,2461,2389,72,0,108,0,6
49427,1,2489,2344,145,0,45,0,6
49428,1,2448,2445,3,0,302,0,6
49429,2,2306,2439,-133,0,45,0,6
49430,1,2496,2480,16,0,122,0,6
49431,2,2538,2453,85,0,327,0,6
49432,2,2401,2256,145,0,400,0,6
49433,1,2378,2484,-106,0,86,0,6
49434,1,2368,2403,-35,0,202,0,6
49435,2,2465,2358,107,0,40,0,6
49436,1,2449,2409,40,0,107,0,6
49437,1,2428,2444,-16,0,310,1,6
49438,1,2621,2522,99,0,7,0,6
49439,2,2475,2502,-27,0,265,0,6
49440,2,2441,2369,72,0,242,0,6
49441,1,2302,2423,-121,0,202,0,6
49442,2,2439,2415,24,0,304,0,8
49443,1,2352,2423,-71,0,90,1,6
49444,2,2431,2483,-52,0,301,0,6
49445,1,2407,2405,2,0,43,1,6
49446,3,2417,2477,-60,0,190,0,6
49447,1,2462,2422,40,0,327,0,6
49448,2,2411,2481,-70,0,40,0,6
49449,2,2350,2468,-118,0,474,0,8
49450,1,2355,2406,-51,0,320,0,6
49451,2,2462,2443,19,0,115,0,6
49452,1,2512,2414,98,0,15,0,6
49453,1,2477,2470,7,0,150,0,6
49454,1,2341,2458,-117,0,380,0,6
49455,1,2411,2352,59,0,302,1,6
49456,2,2577,2516,61,0,22,1,6
49457,1,2450,2392,58,0,337,0,6
49458,3,2402,2419,-17,0,202,0,6
49459,2,2365,2427,-62,0,0,0,6
49460,2,2510,2568,-58,0,10,0,6
49461,2,2429,2442,-13,0,302,0,6
49462,1,2406,2581,-175,0,352,0,8
49463,1,2404,2400,4,0,453,0,6
49464,2,2401,2393,8,0,104,0,6
49465,2,2458,2454,4,0,45,0,6
49466,3,2387,2421,-34,0,49,0,6
49467,2,2435,2261,174,0,134,0,6
49468,1,2416,2426,-10,0,43,1,6
49469,3,2618,2465,153,0,290,0,6
49470,2,2417,2467,-50,0,301,0,6
49471,1,2460,2421,39,0,15,0,6
49472,2,2518,2504,14,0,311,0,6
49473,1,2488,2464,24,0,470,0,6
49474,2,2507,2469,38,0,247,1,6
49475,2,2379,2403,-24,0,101,1,8
49476,1,2374,2422,-48,0,5,0,6
49477,2,2416,2359,57,0,102,0,6
49478,2,2399,2451,-52,0,385,1,6
49479,2,2476,2396,80,0,311,1,6
49480,1,2374,2482,-108,0,151,0,6
49481,2,2449,2382,67,0,388,0,6
49482,1,2432,2300,132,0,264,0,6
49483,2,2416,2257,159,0,51,0,8
49484,2,2464,2413,51,0,442,0,6
49485,1,2405,2531,-126,0,244,1,6
49486,1,2437,2498,-61,0,45,0,6
49487,2,2463,2483,-20,0,331,0,6
49488,2,2416,2465,-49,0,103,0,6
49489,1,2435,2360,75,0,40,0,6
49490,3,2400,2362,38,0,152,0,6
49491,2,2458,2573,-115,0,121,0,6
49492,2,2325,2449,-124,0,5,0,6
49493,1,2344,2402,-58,0,414,0,6
49494,3,2460,2512,-52,0,190,0,6
49495,1,2578,2500,78,0,113,0,6
49496,1,2457,2442,15,0,8,0,6
49497,1,2510,2419,91,0,404,0,6
49498,1,2310,2408,-98,0,150,0,8
49499,1,2420,2388,32,0,400,0,6
49500,2,2464,2394,70,0,200,0,6
49501,1,2354,2419,-65,0,380,1,6
49502,2,2294,2416,-122,0,122,0,6
49503,3,2472,2412,60,0,327,0,6
49504,2,2470,2418,52,0,395,0,6
49505,2,2393,2411,-18,0,8,1,6
49506,2,2501,2410,91,0,331,0,6
49507,2,2309,2456,-147,0,15,0,6
49508,1,2455,2434,21,0,58,0,6
49509,2,2391,2458,-67,0,405,0,6
49510,2,2403,2366,37,0,302,0,6
49511,1,2343,2458,-115,0,314,1,6
49512,2,2475,2410,65,0,30,1,6
49513,1,2489,2511,-22,0,127,1,6
49514,2,2436,2469,-33,0,103,1,6
49515,1,2420,2356,64,0,106,0,6
49516,3,2318,2474,-156,0,45,0,6
49517,1,2502,2407,95,0,46,0,6
49518,2,2402,2387,15,0,100,0,6
49519,1,2415,2431,-16,0,40,0,6
49520,1,2468,2404,64,0,52,0,6
49521,1,2416,2375,41,0,218,0,6
49522,1,2383,2506,-123,0,245,0,6
49523,2,2461,2464,-3,0,106,0,6
49524,1,2422,2392,30,0,335,0,6
49525,1,2572,2417,155,0,344,0,8
49526,1,2524,2413,111,0,310,0,6
49527,2,2462,2383,79,0,34,0,6
49528,1,2351,2425,-74,0,0,0,6
49529,1,2459,2436,23,0,108,0,6
49530,2,2336,2443,-107,0,15,0,6
49531,2,2412,2360,52,0,333,1,6
49532,2,2340,2462,-122,0,448,0,6
49533,2,2417,2419,-2,0,107,0,6
49534,1,2400,2364,36,0,67,0,6
49535,1,2367,2421,-54,0,15,0,6
49536,2,2420,2290,130,0,10,1,6
49537,2,2393,2506,-113,0,49,0,6
49538,3,2402,2247,155,0,40,0,6
49539,1,2471,2455,16,0,38,0,6
49540,1,2501,2559,-58,0,354,0,6
49541,2,2288,2401,-113,0,336,0,8
49542,1,2505,2386,119,0,4,0,6
49543,1,2410,2431,-21,0,190,0,6
49544,2,2450,2495,-45,0,345,0,6
49545,2,2386,2437,-51,0,302,0,6
49546,1,2504,2409,95,0,204,0,6
49547,1,2528,2463,65,0,345,1,6
49548,1,2442,2439,3,0,454,0,6
49549,1,2401,2372,29,0,307,0,6
49550,2,2421,2411,10,0,40,0,6
49551,2,2405,2336,69,0,380,0,6
49552,2,2492,2416,76,0,45,0,6
49553,2,2625,2531,94,0,121,1,6
49554,1,2425,2391,34,0,113,1,6
49555,1,2415,2284,131,0,101,0,6
49556,2,2377,2447,-70,0,15,0,6
49557,1,2404,2357,47,0,111,0,6
49558,1,2332,2510,-178,0,0,0,6
49559,1,2468,2360,108,0,106,0,6
49560,1,2416,2466,-50,0,414,1,6
49561,1,2390,2418,-28,0,43,0,6
49562,2,2431,2442,-11,0,200,0,6
49563,2,2372,2407,-35,0,469,0,6
49564,1,2551,2508,43,0,10,0,6
49565,2,2362,2401,-39,0,190,1,6
49566,2,2415,2427,-12,0,120,0,6
49567,1,2367,2445,-78,0,330,0,6
49568,2,2388,2406,-18,0,40,0,8
49569,2,2358,2406,-48,0,0,0,6
49570,1,2442,2398,44,0,302,1,6
49571,2,2475,2478,-3,0,474,1,6
49572,2,2500,2450,50,0,202,0,6
49573,2,2616,2566,50,0,325,1,6
49574,2,2414,2473,-59,0,247,0,6
49575,2,2464,2433,31,0,48,0,6
49576,1,2509,2347,162,0,310,0,6
49577,1,2416,2353,63,0,484,0,6
49578,2,2353,2448,-95,0,0,0,6
49579,1,2420,2357,63,0,335,0,6
49580,1,2405,2343,62,0,58,0,8
49581,2,2500,2489,11,0,106,0,6
49582,2,2263,2405,-142,4,133,0,13
49583,2,2402,2426,-24,0,0,1,6
49584,2,2514,2485,29,0,1,0,6
49585,1,2419,2338,81,0,127,0,6
49586,1,2454,2507,-53,0,107,1,6
49587,1,2492,2389,103,0,40,1,6
49588,2,2386,2400,-14,0,112,1,6
49589,2,2459,2532,-73,0,335,0,6
49590,2,2583,2490,93,0,113,0,6
49591,1,2401,2340,61,0,4,0,6
49592,1,2281,2502,-221,0,102,1,6
49593,1,2468,2389,79,0,242,0,6
49594,3,2430,2448,-18,0,117,0,6
49595,1,2542,2510,32,0,4,0,6
49596,2,2296,2447,-151,0,300,0,6
49597,2,2451,2290,161,0,111,0,6
49598,1,2455,2398,57,0,10,0,6
49599,2,2412,2367,45,0,190,0,6
49600,1,2409,2409,0,0,101,0,6
49601,1,2390,2425,-35,0,21,0,6
49602,1,2423,2409,14,0,150,0,8
49603,2,2451,2448,3,0,331,0,6
49604,1,2426,2396,30,0,354,0,6
49605,2,2406,2349,57,0,110,1,6
49606,2,2438,2485,-47,0,303,1,6
49607,2,2314,2452,-138,0,111,1,6
49608,1,2433,2410,23,0,58,0,6
49609,1,2439,2448,-9,0,341,0,6
49610,1,2374,2466,-92,0,333,0,6
49611,2,2495,2457,38,0,202,1,6
49612,3,2458,2493,-35,0,331,0,6
49613,1,2374,2405,-31,0,70,1,6
49614,1,2477,2460,17,0,44,0,6
49615,2,2539,2609,-70,0,5,0,6
49616,1,2513,2349,164,0,337,0,6
49617,1,2557,2447,110,0,345,1,6
49618,1,2443,2423,20,0,123,0,6
49619,1,2304,2596,-292,4,301,0,8
49620,2,2245,2417,-172,0,40,0,8
49621,1,2471,2460,11,0,7,0,6
49622,1,2409,2297,112,0,241,0,6
49623,2,2495,2492,3,0,107,0,6
49624,2,2284,2431,-147,0,107,0,6
49625,1,2434,2350,84,0,255,1,6
49626,2,2384,2496,-112,0,4,0,6
49627,2,2385,2439,-54,0,302,1,6
49628,2,2356,2473,-117,0,1,1,6
49629,1,2547,2431,116,0,4,0,6
49630,2,2376,2406,-30,0,1,0,6
49631,2,2405,2439,-34,0,45,0,6
49632,2,2461,2594,-133,0,0,0,6
49633,1,2493,2328,165,0,487,1,6
49634,2,2499,2415,84,0,107,0,6
49635,3,2537,2454,83,0,453,0,6
49636,1,2614,2581,33,0,345,0,6
49637,2,2391,2400,-9,0,304,0,6
49638,2,2321,2434,-113,0,310,0,6
49639,2,2454,2382,72,0,200,0,6
49640,1,2436,2294,142,0,315,0,6
49641,2,2491,2498,-7,0,5,0,6
49642,2,2369,2469,-100,0,1,0,6
49643,1,2444,2403,41,0,341,0,6
49644,1,2456,2459,-3,0,388,1,6
49645,2,2451,2493,-42,0,13,0,6
49646,1,2404,2354,50,0,58,1,8
49647,1,2463,2488,-25,0,132,0,6
49648,1,2427,2414,13,0,200,1,6
49649,2,2381,2476,-95,0,400,1,6
49650,1,2443,2397,46,0,455,0,6
49651,3,2505,2561,-56,0,28,0,6
49652,1,2551,2382,169,0,7,1,6
49653,1,2401,2392,9,0,303,1,6
49654,3,2398,2449,-51,0,302,0,6
49655,3,2415,2355,60,0,263,0,6
49656,1,2404,2359,45,0,45,1,6
49657,2,2598,2457,141,0,123,1,6
49658,2,2352,2516,-164,0,1,1,6
49659,2,2438,2346,92,0,10,1,6
49660,1,2445,2372,73,0,302,0,6
49661,1,2496,2589,-93,0,253,0,6
49662,2,2325,2438,-113,0,315,0,6
49663,2,2234,2458,-224,4,211,0,13
49664,2,2280,2442,-162,0,386,1,6
49665,1,2402,2344,58,0,338,0,6
49666,2,2498,2473,25,0,265,0,6
49667,2,2376,2448,-72,0,0,0,6
49668,2,2405,2386,19,0,206,0,6
49669,2,2442,2392,50,0,389,0,6
49670,2,2482,2469,13,0,202,0,6
49671,2,2485,2446,39,0,106,1,6
49672,2,2350,2453,-103,0,0,0,6
49674,2,2461,2529,-68,0,106,0,6
49675,1,2481,2377,104,0,70,0,6
49676,2,2361,2423,-62,0,106,0,6
49677,2,2449,2399,50,0,244,0,6
49678,1,2401,2554,-153,0,7,0,6
49679,1,2347,2409,-62,0,398,1,6
49680,1,2365,2413,-48,0,331,1,6
49681,2,2372,2492,-120,0,0,0,6
49682,1,2518,2438,80,0,0,0,6
49683,3,2406,2443,-37,0,20,0,8
49684,2,2453,2466,-13,0,46,0,6
49685,1,2409,2369,40,0,346,0,8
49686,1,2432,2327,105,0,20,0,6
49687,1,2409,2465,-56,4,251,0,0
49688,1,2495,2373,122,0,104,0,6
49689,1,2406,2442,-36,0,4,0,6
49690,1,2664,2465,199,0,6,0,6
49691,2,2472,2595,-123,0,202,1,6
49692,1,2387,2485,-98,0,128,0,6
49693,1,2503,2581,-78,0,255,0,6
49694,2,2349,2423,-74,0,100,1,8
49695,2,2353,2431,-78,0,0,0,6
49696,1,2442,2288,154,0,315,0,6
49697,1,2428,2366,62,0,46,1,6
49698,1,2482,2368,114,0,352,1,6
49699,1,2457,2492,-35,0,311,0,6
49700,3,2455,2536,-81,0,80,0,6
49701,1,2312,2414,-102,0,158,1,6
49702,2,2608,2655,-47,0,460,0,6
49703,1,2503,2436,67,0,302,0,6
49704,3,2399,2448,-49,0,173,0,6
49705,1,2541,2437,104,0,312,0,6
49706,1,2406,2392,14,0,1,0,6
49707,1,2524,2341,183,0,153,0,6
49708,1,2405,2379,26,0,115,1,6
49709,2,2348,2546,-198,0,7,0,6
49710,2,2475,2476,-1,0,110,1,6
49711,2,2533,2477,56,0,108,0,6
49712,1,2452,2312,140,0,4,1,6
49713,2,2246,2414,-168,0,123,0,8
49714,2,2412,2576,-164,0,4,0,6
49715,2,2374,2457,-83,0,57,1,6
49716,1,2533,2406,127,0,22,1,6
49717,1,2660,2603,57,0,200,0,6
49718,2,2472,2431,41,0,309,1,6
49719,1,2436,2349,87,0,106,0,6
49720,2,2407,2376,31,0,110,0,6
49721,2,2448,2508,-60,0,49,0,6
49722,2,2499,2305,194,0,112,0,6
49723,1,2574,2511,63,0,194,0,6
49724,2,2463,2667,-204,0,121,0,6
49725,2,2370,2445,-75,0,302,0,6
49726,3,2424,2369,55,0,122,0,6
49727,1,2549,2525,24,0,0,0,6
49728,2,2372,2503,-131,0,4,0,6
49729,1,2422,2275,147,4,122,1,13
49730,1,2599,2632,-33,0,241,0,6
49731,1,2565,2381,184,0,15,1,6
49732,1,2454,2467,-13,0,345,0,6
49734,2,2386,2426,-40,0,305,0,6
49735,2,2313,2406,-93,0,301,0,6
49736,1,2407,2372,35,0,140,0,6
49737,2,2506,2579,-73,0,130,0,6
49738,2,2415,2368,47,0,49,0,6
49739,1,2485,2527,-42,0,8,0,6
49740,2,2345,2440,-95,0,1,0,6
49742,1,2565,2460,105,0,128,0,6
49743,2,2422,2507,-85,0,40,0,6
49744,1,2534,2457,77,0,332,1,6
49745,1,2351,2404,-53,0,207,0,6
49746,1,2598,2665,-67,0,460,0,6
49747,2,2249,2409,-160,0,51,0,6
49748,1,2491,2411,80,0,202,0,6
49749,2,2388,2417,-29,0,357,0,8
49750,1,2468,2410,58,0,211,0,6
49751,3,2383,2487,-104,0,258,0,6
49752,1,2450,2281,169,0,338,0,6
49753,2,2482,2470,12,0,202,0,6
49754,1,2425,2362,63,0,205,0,6
49755,2,2373,2416,-43,0,454,0,6
49756,2,2362,2456,-94,0,112,0,6
49757,1,2436,2545,-109,0,16,0,6
49758,1,2537,2471,66,0,457,0,6
49759,1,2440,2266,174,0,103,0,6
49760,3,2437,2387,50,0,404,0,6
49761,2,2380,2461,-81,0,219,0,6
49762,3,2429,2423,6,0,261,0,6
49763,1,2411,2370,41,0,30,0,6
49764,1,2432,2261,171,0,40,1,8
49765,2,2444,2340,104,0,10,1,6
49766,1,2625,2520,105,0,15,0,6
49767,1,2473,2454,19,0,302,0,6
49768,2,2605,2542,63,0,40,1,6
49769,1,2658,2605,53,0,113,0,6
49770,2,2456,2569,-113,0,111,0,6
49771,1,2423,2382,41,0,374,0,8
49772,2,2511,2360,151,0,46,0,6
49773,2,2299,2431,-132,0,234,0,6
49774,2,2629,2467,162,0,17,0,6
49775,2,2418,2466,-48,0,306,1,6
49776,2,2392,2485,-93,0,4,0,6
49777,1,2584,2501,83,0,332,0,6
49778,1,2381,2482,-101,0,302,1,6
49779,1,2437,2495,-58,0,485,1,6
49780,2,2365,2449,-84,0,250,1,6
49781,3,2405,2378,27,0,193,0,6
49782,1,2416,2304,112,0,20,1,6
49783,1,2237,2409,-172,0,289,0,6
49784,1,2405,2203,202,0,202,0,8
49785,1,2365,2428,-63,0,50,0,6
49786,1,2513,2473,40,0,102,1,6
49787,1,2600,2663,-63,0,4,0,6
49788,2,2453,2292,161,0,47,1,6
49789,2,2367,2412,-45,0,112,0,6
49790,3,2533,2621,-88,0,49,0,6
49791,1,2418,2219,199,0,138,0,6
49792,1,2357,2423,-66,0,1,0,6
49793,1,2449,2430,19,0,411,0,6
49794,1,2573,2452,121,0,128,0,6
49795,1,2242,2407,-165,0,40,0,8
49796,1,2421,2327,94,0,312,0,6
49797,1,2452,2539,-87,0,347,1,6
49798,1,2459,2216,243,4,311,0,0
49799,2,2433,2444,-11,0,200,0,6
49800,1,2656,2607,49,0,200,0,6
49801,1,2503,2476,27,0,211,0,6
49802,2,2629,2660,-31,0,130,1,6
49803,3,2368,2460,-92,0,12,0,6
49804,2,2435,2295,140,0,240,0,6
49805,1,2375,2412,-37,0,101,0,6
49806,1,2421,2348,73,0,106,0,6
49807,1,2479,2342,137,0,440,0,6
49808,2,2418,2490,-72,0,253,0,6
49809,1,2427,2362,65,0,71,0,6
49810,2,2475,2642,-167,0,224,0,6
49811,1,2471,2479,-8,0,103,1,6
49812,1,2466,2413,53,0,329,0,6
49813,2,2343,2426,-83,0,1,0,6
49814,2,2372,2435,-63,0,88,1,6
49815,2,2338,2437,-99,0,100,0,8
49816,1,2543,2535,8,0,300,0,6
49818,2,2417,2412,5,0,247,0,6
49819,1,2619,2445,174,0,311,0,6
49820,1,2443,2361,82,0,345,1,6
49821,1,2424,2364,60,0,205,1,6
49822,1,2406,2400,6,0,300,0,6
49823,2,2459,2541,-82,0,4,0,6
49824,1,2497,2469,28,0,110,1,6
49825,2,2602,2661,-59,0,134,0,6
49826,2,2428,2256,172,0,337,1,8
49827,2,2416,2385,31,0,302,0,6
49828,1,2405,2238,167,0,244,1,6
49829,1,2516,2518,-2,0,112,0,6
49830,1,2427,2454,-27,0,200,0,6
49831,2,2506,2508,-2,0,214,1,6
49832,1,2427,2389,38,0,200,0,6
49833,2,2335,2411,-76,0,310,0,6
49834,1,2329,2418,-89,0,35,1,6
49835,1,2444,2384,60,0,122,0,6
49836,2,2338,2436,-98,0,4,0,6
49837,2,2312,2430,-118,0,318,0,6
49838,1,2470,2500,-30,0,241,0,6
49839,2,2454,2404,50,0,64,0,6
49840,2,2425,2286,139,4,140,0,13
49841,2,2532,2459,73,0,404,1,6
49842,1,2645,2576,69,0,339,0,6
49843,2,2432,2408,24,0,4,0,6
49844,2,2339,2438,-99,0,1,1,6
49845,1,2473,2345,128,0,302,0,6
49846,1,2477,2364,113,0,490,0,6
49848,1,2454,2347,107,0,49,1,6
49849,2,2359,2418,-59,0,1,0,6
49850,2,2410,2367,43,0,45,0,6
49851,2,2472,2502,-30,0,107,1,6
49852,1,2666,2598,68,0,106,0,6
49853,1,2434,2375,59,0,45,1,6
49854,1,2403,2380,23,4,8,0,13
49855,3,2359,2448,-89,0,102,0,6
49856,2,2374,2403,-29,0,122,0,6
49858,1,2494,2477,17,0,45,0,6
49859,3,2410,2334,76,0,106,0,6
49860,1,2401,2273,128,0,412,0,6
49861,2,2581,2665,-84,0,466,0,6
49862,1,2357,2401,-44,0,50,0,6
49863,1,2445,2290,155,0,454,0,8
49864,2,2471,2449,22,0,337,0,6
49865,1,2514,2433,81,0,3,0,6
49866,1,2480,2512,-32,0,112,0,6
49867,1,2391,2432,-41,0,270,0,6
49868,2,2426,2477,-51,0,102,0,6
49869,2,2360,2417,-57,0,39,0,6
49870,2,2414,2434,-20,0,4,0,6
49871,2,2449,2455,-6,0,122,0,6
49872,2,2416,2335,81,0,410,0,6
49873,1,2426,2398,28,0,133,0,6
49874,1,2571,2486,85,0,240,0,6
49875,1,2421,2341,80,0,37,0,6
49876,1,2434,2354,80,0,211,0,6
49877,2,2408,2468,-60,0,122,0,6
49878,2,2374,2429,-55,0,411,0,6
49879,1,2423,2344,79,0,107,0,6
49880,2,2403,2503,-100,0,45,0,6
49881,2,2379,2565,-186,0,118,0,6
49882,3,2311,2439,-128,0,300,0,6
49883,1,2409,2293,116,0,405,0,6
49884,1,2431,2316,115,0,140,1,6
49885,1,2335,2481,-146,0,107,0,6
49886,2,2458,2409,49,0,112,0,6
49887,2,2477,2421,56,0,203,0,6
49888,2,2343,2437,-94,0,172,0,6
49889,2,2411,2337,74,0,4,0,6
49890,2,2335,2459,-124,0,1,0,6
49891,1,2551,2448,103,0,41,0,6
49892,2,2336,2420,-84,0,190,0,8
49893,2,2365,2409,-44,0,43,1,6
49894,2,2471,2499,-28,0,106,1,6
49895,1,2460,2443,17,0,311,1,6
49896,2,2506,2577,-71,0,484,1,6
49897,2,2370,2481,-111,0,240,1,6
49898,1,2432,2446,-14,0,50,1,6
49899,1,2508,2529,-21,0,302,0,6
49900,2,2466,2525,-59,0,347,1,6
49901,2,2479,2353,126,0,4,0,6
49902,2,2205,2402,-197,0,487,0,6
49903,2,2395,2423,-28,0,211,0,6
49904,2,2520,2503,17,0,130,0,6
49905,1,2308,2484,-176,0,0,0,8
49906,2,2448,2439,9,0,47,1,6
49907,2,2451,2204,247,0,45,1,6
49908,2,2428,2334,94,0,455,0,6
49909,1,2366,2424,-58,0,463,0,6
49910,2,2429,2518,-89,0,40,0,6
49911,1,2568,2376,192,0,45,0,6
49912,2,2431,2439,-8,0,43,1,6
49914,1,2427,2470,-43,0,5,1,6
49915,1,2323,2413,-90,0,151,0,6
49916,2,2411,2502,-91,0,106,0,6
49917,1,2421,2369,52,0,307,1,6
49918,2,2393,2411,-18,0,332,0,6
49919,1,2437,2343,94,0,217,0,6
49920,1,2451,2329,122,0,311,0,8
49921,2,2435,2471,-36,0,127,1,6
49922,3,2313,2481,-168,0,40,0,6
49923,1,2358,2441,-83,0,33,0,6
49924,2,2440,2299,141,0,36,0,6
49925,3,2447,2352,95,0,40,0,6
49926,1,2399,2416,-17,0,111,1,6
49927,2,2523,2571,-48,0,43,0,6
49928,2,2405,2350,55,0,32,0,6
49929,2,2507,2548,-41,0,13,0,6
49930,2,2340,2438,-98,0,455,0,6
49931,2,2204,2400,-196,0,461,0,8
49932,1,2444,2555,-111,0,121,1,6
49933,1,2414,2331,83,0,4,1,6
49934,1,2521,2438,83,0,302,1,6
49935,1,2485,2466,19,0,192,1,6
49936,1,2406,2331,75,0,57,0,6
49937,1,2423,2400,23,0,207,0,6
49938,3,2422,2351,71,0,40,0,6
49939,1,2375,2493,-118,0,453,0,6
49940,2,2376,2473,-97,0,190,0,6
49941,1,2576,2518,58,0,300,1,6
49942,1,2344,2404,-60,0,10,0,6
49943,2,2502,2700,-198,0,108,0,6
49944,1,2441,2369,72,0,302,0,6
49945,2,2581,2514,67,0,28,0,6
49946,3,2453,2457,-4,0,255,0,6
49947,3,2474,2461,13,0,10,0,6
49948,1,2483,2511,-28,0,113,0,6
49949,3,2515,2533,-18,0,315,0,6
49950,2,2419,2442,-23,0,360,1,6
49951,2,2452,2448,4,0,27,1,6
49952,2,2635,2698,-63,0,28,0,6
49953,3,2541,2581,-40,0,20,0,6
49954,1,2518,2319,199,0,111,0,6
49955,2,2411,2415,-4,0,43,0,6
49956,3,2514,2217,297,4,194,0,18
49957,3,2445,2442,3,0,300,0,6
49958,1,2333,2523,-190,0,214,0,6
49959,1,2381,2457,-76,0,100,1,8
49960,1,2365,2428,-63,0,127,0,6
49962,1,2498,2481,17,0,1,1,6
49963,1,2404,2204,200,0,246,1,6
49964,2,2434,2441,-7,0,138,1,6
49965,2,2405,2527,-122,0,268,0,6
49966,2,2214,2483,-269,0,101,0,6
49967,1,2654,2514,140,0,456,0,6
49968,1,2569,2429,140,0,248,0,6
49969,1,2530,2462,68,0,453,0,6
49970,1,2594,2573,21,0,255,0,6
49971,1,2502,2403,99,0,11,0,6
49972,2,2424,2319,105,0,320,0,8
49973,1,2368,2506,-138,0,311,0,6
49974,1,2354,2440,-86,0,48,0,6
49975,2,2454,2358,96,0,133,0,6
49976,2,2488,2232,256,0,112,0,6
49977,2,2426,2430,-4,0,302,0,6
49978,2,2521,2476,45,0,105,1,6
49979,1,2434,2575,-141,0,7,0,6
49980,1,2416,2364,52,0,102,0,6
49981,1,2429,2426,3,0,142,0,6
49982,3,2434,2525,-91,0,110,0,6
49983,2,2531,2401,130,0,103,1,6
49984,2,2341,2464,-123,0,198,0,6
49985,1,2463,2343,120,0,206,0,6
49986,1,2339,2442,-103,0,40,0,6
49987,2,2418,2324,94,0,403,0,6
49988,2,2327,2410,-83,0,1,0,6
49989,2,2327,2475,-148,0,300,0,6
49990,1,2442,2336,106,0,434,0,6
49991,2,2462,2365,97,0,5,0,6
49992,2,2403,2702,-299,0,411,0,6
49993,2,2521,2429,92,0,40,0,6
49994,1,2366,2499,-133,0,477,0,6
49995,1,2467,2294,173,0,4,1,6
49996,1,2697,2402,295,0,134,0,6
49997,3,2514,2581,-67,0,43,0,6
49998,1,2299,2421,-122,0,247,0,6
49999,1,2441,2413,28,0,200,1,8
50000,1,2551,2507,44,0,278,1,6
50001,1,2548,2399,149,0,311,0,6
50002,1,2359,2421,-62,0,426,0,6
50003,1,2445,2344,101,0,389,0,6
50004,3,2464,2445,19,0,0,0,6
50005,1,2447,2300,147,0,16,0,6
50006,2,2471,2413,58,0,153,1,6
50007,2,2447,2334,113,0,130,1,6
50008,1,2429,2344,85,0,10,0,6
50009,1,2477,2372,105,0,13,0,6
50010,2,2403,2337,66,0,190,0,8
50011,2,2361,2411,-50,0,43,1,6
50012,2,2563,2440,123,0,226,0,6
50013,3,2365,2470,-105,0,301,0,6
50014,2,2455,2384,71,0,125,0,6
50015,1,2454,2394,60,0,190,0,6
50016,2,2420,2331,89,0,331,0,6
50017,3,2658,2600,58,0,332,0,6
50018,1,2283,2420,-137,0,123,1,6
50019,2,2322,2436,-114,0,1,0,6
50020,1,2415,2356,59,0,409,1,6
50021,3,2457,2535,-78,0,310,0,6
50023,1,2273,2510,-237,0,117,0,6
50024,2,2210,2447,-237,0,11,0,6
50025,1,2468,2434,34,0,107,1,6
50026,1,2486,2309,177,0,131,0,6
50027,2,2568,2552,16,0,103,0,6
50028,1,2542,2389,153,0,178,0,6
50029,2,2421,2671,-250,0,253,0,6
50030,3,2524,2435,89,0,36,0,6
50031,1,2578,2515,63,0,2,0,6
50032,2,2326,2433,-107,0,152,0,6
50033,2,2291,2455,-164,0,107,1,6
50034,2,2319,2510,-191,0,110,0,6
50035,2,2314,2483,-169,0,300,1,6
50036,1,2704,2402,302,0,14,1,6
50037,2,2498,2508,-10,0,6,0,6
50038,1,2538,2376,162,0,64,0,6
50039,2,2424,2346,78,0,201,0,6
50040,1,2461,2399,62,0,103,0,6
50041,1,2367,2466,-99,0,182,0,6
50042,2,2409,2523,-114,0,268,1,6
50043,1,2420,2204,216,0,110,0,6
50044,1,2471,2202,269,0,228,1,6
50045,2,2209,2474,-265,0,45,0,6
50046,1,2479,2205,274,0,140,0,6
50047,1,2496,2222,274,0,374,1,6
50048,1,2223,2510,-287,0,338,0,6
50049,1,2516,2226,290,0,124,0,6
50050,2,2216,2484,-268,0,46,0,6
50051,1,2487,2214,273,0,130,0,6
50052,2,2238,2521,-283,0,125,0,6
50053,1,2523,2243,280,0,0,0,6
50054,2,2246,2523,-277,0,46,0,6
50055,2,2248,2543,-295,0,43,0,6
50056,1,2552,2247,305,0,404,0,6
50057,1,2598,2251,347,0,61,0,6
50058,1,2561,2249,312,0,11,0,6
50059,2,2251,2586,-335,0,61,0,6
50060,2,2252,2589,-337,0,125,0,6
50061,2,2261,2610,-349,0,270,1,6
50062,1,2646,2256,390,0,315,0,6
50063,2,2269,2670,-401,0,125,0,6
50064,1,2425,2442,-17,0,101,0,6
50065,2,2296,2440,-144,0,334,0,6
50066,3,2384,2490,-106,0,409,0,6
50067,2,2387,2459,-72,0,207,1,6
50068,2,2297,2490,-193,0,45,1,6
50070,2,2434,2340,94,4,136,0,13
50071,2,2478,2464,14,0,67,0,6
50072,2,2385,2546,-161,0,123,0,6
50073,1,2403,2312,91,0,302,0,6
50074,1,2391,2414,-23,0,297,0,6
50075,2,2502,2509,-7,0,28,0,6
50076,3,2442,2292,150,0,265,0,6
50077,1,2249,2413,-164,0,380,1,6
50078,2,2558,2507,51,0,311,0,6
50079,1,2492,2296,196,0,240,0,6
50080,1,2468,2451,17,0,360,0,6
50081,1,2446,2338,108,0,300,0,6
50082,2,2366,2416,-50,0,310,1,6
50083,2,2464,2389,75,0,153,0,6
50084,1,2562,2552,10,0,302,0,6
50085,2,2297,2439,-142,0,311,0,6
50086,1,2408,2417,-9,0,197,0,8
50087,2,2420,2491,-71,0,107,0,6
50088,1,2437,2458,-21,0,181,0,6
50089,1,2458,2576,-118,0,46,1,8
50090,1,2450,2235,215,0,224,0,6
50091,2,2305,2452,-147,4,46,0,13
50092,2,2437,2369,68,0,112,0,6
50093,2,2436,2472,-36,0,110,1,6
50094,2,2235,2400,-165,0,0,1,6
50095,3,2480,2461,19,0,152,0,6
50096,3,2298,2431,-133,0,302,0,6
50097,1,2601,2555,46,0,107,0,6
50098,1,2575,2522,53,0,28,0,6
50099,1,2348,2407,-59,0,110,0,6
50100,2,2400,2706,-306,0,411,0,6
50101,1,2514,2332,182,0,122,1,6
50102,1,2370,2429,-59,0,107,1,6
50103,1,2353,2551,-198,0,300,0,6
50104,1,2513,2577,-64,0,46,0,6
50105,2,2231,2661,-430,0,39,0,6
50106,1,2527,2510,17,0,153,1,6
50107,1,2446,2419,27,0,436,0,6
50108,1,2368,2481,-113,0,192,0,6
50109,2,2450,2394,56,0,300,0,6
50110,2,2415,2249,166,0,34,0,8
50111,2,2384,2449,-65,0,222,0,6
50112,1,2443,2374,69,0,181,0,6
50113,1,2461,2520,-59,0,302,0,6
50114,1,2487,2293,194,0,113,1,6
50116,2,2350,2504,-154,0,203,0,6
50117,1,2405,2402,3,0,200,1,6
50118,2,2444,2347,97,0,140,1,6
50119,2,2299,2440,-141,0,300,1,6
50121,2,2355,2585,-230,0,302,1,6
50122,2,2200,2423,-223,0,40,1,6
50123,1,2470,2556,-86,0,0,0,6
50124,2,2319,2401,-82,0,135,1,6
50125,1,2452,2321,131,0,105,0,6
50126,2,2368,2703,-335,0,126,0,6
50127,2,2388,2496,-108,0,45,0,6
50128,1,2641,2650,-9,0,5,0,6
50129,2,2326,2401,-75,0,176,0,6
50130,1,2409,2551,-142,0,403,0,6
50131,2,2414,2567,-153,0,226,0,6
50132,1,2408,2496,-88,0,107,1,6
50133,1,2452,2615,-163,0,81,0,6
50134,2,2507,2583,-76,0,84,0,6
50135,2,2333,2415,-82,0,130,0,6
50136,2,2320,2443,-123,0,0,0,6
50137,2,2452,2519,-67,0,153,0,6
50138,2,2405,2360,45,0,335,0,6
50139,1,2421,2291,130,0,9,1,6
50140,2,2477,2431,46,0,314,0,6
50141,1,2436,2361,75,0,335,0,6
50142,1,2465,2336,129,0,31,0,6
50143,2,2400,2359,41,0,326,1,6
50144,1,2410,2358,52,0,302,1,6
50145,2,2405,2349,56,0,45,0,6
50146,1,2663,2387,276,0,373,0,6
50147,2,2314,2497,-183,0,140,0,6
50148,1,2447,2494,-47,0,101,0,6
50149,3,2411,2251,160,0,241,0,6
50150,1,2468,2268,200,0,125,0,6
50151,3,2587,2309,278,0,327,0,6
50152,2,2284,2468,-184,0,468,1,6
50153,2,2405,2355,50,0,125,0,6
50154,2,2415,2421,-6,0,348,0,6
50155,2,2464,2481,-17,0,1,0,6
50156,2,2443,2499,-56,0,373,1,6
50157,2,2486,2518,-32,0,31,0,6
50158,2,2476,2461,15,0,454,0,6
50159,2,2468,2489,-21,0,394,0,6
50160,2,2546,2498,48,0,265,1,6
50161,2,2523,2563,-40,0,337,0,6
50162,1,2612,2525,87,0,315,0,6
50163,1,2591,2233,358,0,315,0,6
50164,2,2525,2647,-122,0,406,0,6
50165,2,2384,2554,-170,0,113,0,6
50166,1,2540,2397,143,0,154,0,6
50167,1,2518,2472,46,0,34,0,6
50168,1,2429,2300,129,0,109,1,6
50169,1,2418,2340,78,4,130,0,13
50170,1,2362,2517,-155,0,40,0,6
50171,1,2611,2208,403,0,110,0,6
50172,3,2473,2456,17,0,25,0,6
50173,3,2480,2376,104,0,151,0,6
50174,1,2322,2401,-79,0,110,0,6
50175,1,2582,2567,15,0,302,0,6
50176,2,2408,2438,-30,0,4,0,6
50177,2,2369,2448,-79,0,310,1,6
50178,2,2414,2250,164,0,101,0,6
50179,2,2454,2394,60,0,406,0,6
50180,2,2403,2704,-301,0,123,0,6
50181,1,2520,2367,153,0,48,1,6
50182,1,2493,2294,199,0,113,0,6
50183,1,2493,2342,151,0,241,0,6
50184,1,2456,2500,-44,0,113,0,6
50185,1,2573,2587,-14,0,16,0,6
50186,2,2381,2523,-142,0,9,0,6
50187,1,2447,2314,133,0,29,0,6
50188,2,2644,2647,-3,0,331,0,6
50189,1,2441,2329,112,0,46,0,6
50190,3,2420,2411,9,0,104,0,6
50191,1,2447,2316,131,0,10,0,6
50192,1,2587,2353,234,0,129,1,6
50193,2,2443,2450,-7,0,242,1,6
50194,1,2466,2549,-83,0,341,1,6
50195,1,2500,2368,132,0,11,1,6
50196,2,2222,2489,-267,0,122,1,6
50197,1,2562,2580,-18,0,106,0,6
50198,1,2477,2338,139,0,0,0,6
50199,1,2543,2468,75,0,56,1,6
50200,2,2422,2417,5,0,53,1,6
50201,1,2458,2403,55,0,110,1,6
50202,2,2505,2590,-85,0,121,0,6
50203,2,2509,2370,139,0,315,0,6
50204,2,2455,2425,30,0,120,1,6
50205,1,2416,2358,58,0,245,1,6
50206,1,2524,2366,158,0,344,0,6
50207,1,2519,2385,134,0,380,1,6
50208,1,2483,2343,140,0,335,0,8
50209,1,2279,2405,-126,0,123,1,6
50210,3,2481,2445,36,0,141,0,6
50211,2,2334,2544,-210,0,406,0,6
50212,1,2364,2429,-65,0,46,1,6
50213,1,2405,2227,178,0,248,0,6
50214,2,2330,2502,-172,0,113,0,6
50215,1,2415,2332,83,0,46,0,6
50216,1,2336,2443,-107,0,310,0,6
50217,1,2407,2362,45,0,464,0,6
50218,1,2490,2255,235,0,16,0,6
50219,1,2514,2367,147,0,45,0,6
50220,2,2312,2451,-139,0,150,0,6
50221,2,2706,2667,39,0,122,0,6
50222,1,2444,2454,-10,0,0,0,6
50223,1,2336,2460,-124,0,140,0,6
50224,1,2376,2454,-78,0,100,0,6
50225,3,2407,2365,42,0,48,0,6
50226,3,2526,2377,149,0,46,0,6
50227,1,2488,2248,240,0,106,1,6
50228,1,2388,2403,-15,0,455,0,6
50229,3,2569,2384,185,0,106,0,8
50230,1,2494,2237,257,0,1,0,6
50231,2,2463,2300,163,0,107,1,6
50232,1,2456,2436,20,0,101,0,6
50233,2,2473,2401,72,0,345,0,6
50234,2,2445,2479,-34,0,406,0,6
50235,1,2334,2469,-135,0,310,0,6
50236,1,2429,2389,40,0,200,0,6
50237,1,2542,2475,67,0,122,0,6
50238,1,2291,2419,-128,0,300,0,6
50239,1,2311,2492,-181,0,106,1,8
50240,1,2403,2306,97,0,302,1,6
50241,2,2455,2309,146,0,20,1,6
50242,2,2307,2496,-189,0,4,0,6
50243,1,2596,2568,28,0,46,0,6
50244,1,2315,2514,-199,0,233,0,6
50245,1,2334,2422,-88,4,5,0,13
50246,2,2378,2501,-123,0,45,1,6
50247,2,2384,2432,-48,0,41,0,6
50248,3,2574,2548,26,0,30,0,6
50249,2,2469,2672,-203,0,280,0,6
50250,1,2557,2316,241,0,57,1,6
50251,1,2475,2427,48,0,226,0,6
50252,1,2652,2600,52,0,302,1,6
50253,3,2471,2616,-145,0,8,0,6
50254,1,2523,2362,161,0,124,0,6
50255,2,2568,2504,64,0,27,0,6
50256,1,2504,2473,31,0,331,0,6
50257,2,2495,2592,-97,0,125,1,6
50258,1,2579,2250,329,0,404,0,6
50259,1,2270,2500,-230,0,247,0,6
50260,1,2396,2462,-66,0,4,0,6
50261,2,2251,2521,-270,0,338,0,6
50262,2,2476,2399,77,0,150,0,6
50263,3,2245,2410,-165,0,302,0,6
50264,1,2425,2438,-13,0,122,0,6
50265,2,2321,2536,-215,0,1,0,6
50266,2,2255,2481,-226,0,4,1,6
50267,1,2685,2583,102,0,30,0,6
50268,2,2423,2568,-145,0,6,0,6
50269,2,2240,2451,-211,0,45,1,6
50270,1,2291,2495,-204,0,40,0,6
50271,2,2404,2360,44,0,135,0,6
50272,1,2382,2523,-141,0,414,0,6
50273,1,2431,2394,37,0,373,0,6
50274,2,2309,2492,-183,0,122,0,6
50275,1,2436,2344,92,0,202,0,6
50276,1,2547,2332,215,0,302,0,6
50277,2,2419,2518,-99,0,40,0,6
50278,1,2571,2370,201,0,373,1,6
50279,1,2405,2342,63,0,300,0,6
50280,1,2230,2401,-171,0,16,0,6
50281,3,2427,2493,-66,0,4,0,6
50282,1,2496,2409,87,0,1,0,6
50283,1,2388,2524,-136,0,115,0,6
50284,2,2318,2504,-186,0,241,0,8
50285,3,2365,2406,-41,0,31,0,6
50286,1,2474,2304,170,0,30,1,6
50287,2,2275,2414,-139,0,143,1,6
50288,1,2448,2451,-3,0,203,0,6
50289,1,2522,2540,-18,0,46,0,6
50290,1,2367,2420,-53,0,15,0,6
50291,1,2408,2383,25,0,200,0,6
50292,2,2262,2466,-204,0,101,0,6
50293,2,2252,2463,-211,0,113,0,6
50294,2,2336,2410,-74,0,148,0,6
50295,2,2209,2411,-202,0,6,1,6
50296,1,2469,2495,-26,0,345,0,6
50297,1,2430,2461,-31,0,300,0,6
50298,1,2517,2547,-30,0,302,0,6
50299,2,2495,2367,128,0,466,0,6
50300,2,2349,2556,-207,0,486,0,6
50301,1,2437,2490,-53,0,112,0,6
50302,2,2384,2434,-50,0,405,0,6
50303,1,2466,2419,47,0,241,0,6
50304,1,2261,2464,-203,0,103,0,6
50305,1,2440,2337,103,0,104,0,6
50306,2,2272,2412,-140,0,414,0,6
50307,2,2317,2447,-130,0,170,0,6
50308,1,2461,2382,79,0,15,1,6
50309,1,2358,2480,-122,0,456,0,6
50310,2,2505,2358,147,0,40,0,6
50311,1,2679,2244,435,0,373,0,6
50312,2,2700,2455,245,0,197,0,6
50313,1,2603,2555,48,0,302,0,6
50314,3,2309,2491,-182,0,4,0,6
50315,3,2284,2566,-282,0,300,0,8
50316,2,2339,2428,-89,0,5,1,6
50317,2,2515,2390,125,0,385,0,6
50318,1,2407,2379,28,0,302,0,6
50319,1,2437,2343,94,0,34,0,6
50320,1,2453,2344,109,0,466,0,6
50321,1,2573,2548,25,0,414,0,6
50322,2,2383,2499,-116,0,4,0,6
50323,2,2424,2385,39,0,87,1,6
50324,2,2405,2366,39,0,15,0,6
50325,2,2259,2481,-222,0,122,0,6
50326,2,2421,2482,-61,0,83,0,6
50327,2,2534,2528,6,0,120,0,6
50328,1,2495,2324,171,0,101,0,6
50329,1,2439,2374,65,0,200,0,6
50330,2,2450,2313,137,0,20,1,6
50331,1,2405,2267,138,0,8,0,6
50332,1,2454,2500,-46,0,311,0,6
50333,1,2333,2444,-111,0,222,1,6
50334,1,2351,2450,-99,0,320,0,6
50335,2,2368,2414,-46,0,0,1,6
50336,2,2415,2449,-34,0,45,0,6
50337,2,2476,2455,21,0,332,0,6
50338,2,2490,2398,92,0,206,0,6
50339,2,2551,2379,172,0,4,1,6
50340,2,2540,2523,17,0,267,0,6
50341,2,2563,2606,-43,0,335,0,6
50342,3,2414,2411,3,0,48,0,6
50343,2,2415,2441,-26,0,4,0,6
50344,1,2516,2413,103,0,300,1,6
50345,1,2484,2311,173,0,120,0,6
50346,2,2236,2561,-325,0,9,0,6
50347,1,2540,2453,87,0,153,0,6
50348,1,2595,2431,164,0,337,0,6
50349,2,2312,2473,-161,0,376,0,6
50350,3,2614,2511,103,0,378,0,6
50351,1,2340,2526,-186,0,107,0,6
50352,1,2384,2691,-307,0,117,0,6
50353,2,2365,2488,-123,0,203,0,6
50354,1,2511,2657,-146,0,6,0,6
50355,2,2675,2361,314,0,337,0,6
50356,1,2596,2480,116,0,58,0,6
50357,2,2410,2559,-149,0,45,1,6
50358,2,2297,2514,-217,0,6,0,6
50359,2,2262,2469,-207,0,331,0,6
50360,1,2409,2214,195,0,128,0,6
50361,1,2579,2358,221,0,46,0,6
50362,2,2282,2465,-183,0,466,0,6
50363,1,2406,2404,2,0,269,0,6
50364,2,2483,2580,-97,0,123,0,6
50365,1,2422,2266,156,0,15,1,6
50366,1,2523,2495,28,0,331,1,6
50367,2,2472,2522,-50,0,102,0,6
50368,1,2519,2397,122,0,49,0,6
50369,1,2487,2300,187,0,110,0,6
50370,3,2478,2471,7,0,46,0,6
50371,1,2466,2321,145,0,46,0,6
50372,1,2547,2434,113,0,13,1,6
50373,1,2534,2528,6,0,200,1,6
50374,1,2317,2416,-99,0,320,0,6
50375,1,2471,2254,217,0,52,0,8
50376,1,2432,2271,161,0,123,0,6
50377,1,2472,2213,259,0,112,0,6
50378,1,2398,2507,-109,0,414,0,6
50379,2,2420,2436,-16,0,127,0,6
50381,1,2386,2465,-79,0,300,0,6
50382,1,2515,2410,105,0,45,0,6
50383,2,2529,2535,-6,0,242,0,6
50384,2,2409,2298,111,0,1,0,6
50385,1,2342,2499,-157,0,413,0,6
50386,2,2263,2433,-170,0,255,1,6
50387,2,2373,2412,-39,0,304,0,6
50388,2,2477,2345,132,0,10,0,6
50389,2,2543,2459,84,0,311,1,6
50390,2,2419,2579,-160,0,41,0,6
50391,1,2439,2444,-5,0,151,0,6
50392,1,2674,2603,71,0,242,0,6
50393,2,2365,2474,-109,0,487,1,6
50394,1,2419,2448,-29,0,13,0,6
50395,1,2436,2367,69,0,458,0,6
50396,2,2455,2271,184,0,132,0,6
50397,1,2446,2535,-89,0,278,1,6
50398,2,2343,2461,-118,0,242,1,6
50399,2,2373,2438,-65,0,4,0,6
50400,1,2571,2550,21,0,101,0,6
50401,1,2524,2470,54,0,46,0,6
50402,1,2507,2494,13,0,302,0,6
50403,1,2464,2409,55,0,135,0,6
50404,2,2460,2691,-231,0,49,0,6
50405,2,2308,2491,-183,0,0,0,6
50406,2,2437,2515,-78,0,45,0,6
50407,1,2485,2509,-24,0,101,0,6
50408,2,2437,2466,-29,0,230,0,6
50409,3,2289,2414,-125,0,310,0,6
50410,1,2411,2428,-17,0,107,0,6
50411,1,2437,2355,82,0,426,0,6
50412,2,2441,2607,-166,0,153,0,6
50413,2,2387,2541,-154,0,41,0,6
50414,2,2382,2426,-44,0,145,0,6
50415,1,2368,2433,-65,0,101,0,6
50416,1,2461,2205,256,4,311,0,0
50417,2,2224,2498,-274,0,36,1,6
50418,2,2227,2401,-174,0,45,1,6
50419,3,2471,2478,-7,0,110,0,6
50420,3,2558,2426,132,0,123,0,6
50421,2,2430,2399,31,0,0,0,6
50422,1,2297,2490,-193,0,45,0,6
50423,2,2409,2334,75,0,45,1,6
50424,1,2499,2405,94,0,15,0,6
50425,2,2579,2558,21,0,250,0,6
50426,2,2374,2521,-147,0,315,1,6
50427,2,2522,2370,152,0,215,0,6
50428,3,2504,2485,19,0,45,0,6
50429,3,2286,2417,-131,0,112,0,6
50430,1,2401,2249,152,0,40,0,6
50431,1,2562,2216,346,0,22,0,8
50432,3,2499,2305,194,0,120,0,6
50433,1,2540,2551,-11,0,3,0,6
50434,1,2436,2368,68,0,15,1,6
50435,2,2668,2529,139,0,6,0,6
50436,1,2541,2464,77,0,187,1,6
50437,1,2250,2478,-228,0,108,1,8
50438,1,2506,2287,219,0,106,0,8
50439,1,2508,2225,283,0,15,0,6
50440,1,2693,2261,432,0,101,0,6
50441,1,2598,2678,-80,0,445,0,6
50442,2,2416,2536,-120,0,200,1,6
50443,1,2465,2443,22,0,120,0,6
50444,2,2417,2300,117,4,220,0,8
50445,1,2681,2469,212,0,4,0,6
50446,2,2451,2469,-18,0,313,0,6
50447,1,2354,2469,-115,0,477,0,6
50448,1,2401,2504,-103,0,440,0,6
50449,1,2203,2471,-268,0,4,0,6
50450,1,2532,2290,242,0,190,1,6
50451,1,2610,2545,65,0,315,0,6
50452,3,2472,2211,261,0,130,0,6
50453,1,2320,2449,-129,0,1,0,6
50454,1,2678,2341,337,0,11,0,6
50455,3,2485,2255,230,0,123,0,6
50456,2,2393,2412,-19,0,487,1,6
50457,2,2259,2582,-323,0,125,0,6
50458,2,2585,2412,173,0,332,0,6
50459,2,2402,2665,-263,0,45,1,6
50460,2,2380,2523,-143,0,394,0,6
50461,1,2527,2219,308,0,0,0,6
50462,1,2469,2392,77,0,215,1,6
50463,2,2476,2328,148,0,211,0,6
50464,1,2361,2528,-167,0,247,0,6
50465,2,2319,2405,-86,0,454,0,6
50466,3,2563,2519,44,0,456,0,6
50467,1,2563,2360,203,0,28,0,6
50468,2,2476,2649,-173,0,4,0,6
50469,2,2518,2546,-28,0,126,0,6
50470,1,2512,2394,118,0,307,0,6
50471,1,2378,2612,-234,0,15,0,6
50472,2,2492,2600,-108,0,278,0,6
50473,2,2250,2433,-183,0,354,0,6
50474,2,2243,2479,-236,0,112,1,6
50475,3,2437,2471,-34,0,248,0,6
50477,1,2446,2346,100,0,56,1,8
50478,3,2406,2394,12,0,110,0,6
50479,2,2417,2454,-37,0,200,1,6
50480,2,2412,2380,32,0,40,0,6
50481,1,2378,2432,-54,0,242,0,6
50482,2,2329,2504,-175,0,55,1,6
50483,1,2465,2482,-17,0,466,0,6
50484,2,2404,2315,89,0,7,0,6
50485,2,2469,2686,-217,0,125,0,6
50486,1,2256,2426,-170,0,207,0,6
50487,3,2200,2480,-280,0,30,0,8
50488,2,2471,2593,-122,0,110,0,6
50489,1,2402,2459,-57,0,130,0,6
50490,1,2545,2384,161,0,302,0,6
50491,3,2432,2577,-145,0,301,0,6
50492,1,2431,2390,41,0,211,0,6
50493,1,2564,2573,-9,0,44,1,6
50494,1,2424,2350,74,0,0,0,6
50495,2,2338,2420,-82,0,224,1,6
50496,1,2290,2404,-114,0,301,1,6
50497,2,2615,2660,-45,0,100,1,6
50498,3,2285,2509,-224,0,300,0,8
50499,2,2485,2537,-52,0,432,1,6
50500,1,2410,2514,-104,0,22,0,6
50501,1,2345,2417,-72,0,133,0,6
50502,1,2481,2306,175,0,110,0,6
50503,1,2440,2422,18,0,115,0,6
50504,1,2485,2283,202,0,113,0,6
50505,3,2415,2517,-102,0,46,0,6
50506,1,2597,2546,51,0,4,0,6
50507,1,2436,2222,214,0,227,0,6
50508,2,2422,2467,-45,0,205,0,6
50509,2,2500,2360,140,0,341,0,6
50510,2,2364,2441,-77,0,49,1,6
50511,2,2460,2546,-86,0,338,0,6
50512,1,2279,2447,-168,0,211,0,6
50513,2,2540,2545,-5,0,311,0,6
50514,2,2411,2694,-283,0,123,0,6
50515,1,2370,2475,-105,0,57,0,6
50516,2,2575,2507,68,0,101,0,6
50517,1,2466,2352,114,0,4,0,6
50518,1,2470,2438,32,0,47,0,6
50519,1,2691,2404,287,0,4,0,6
50520,1,2524,2386,138,0,302,1,6
50521,1,2459,2466,-7,0,123,0,6
50522,1,2374,2476,-102,0,456,0,6
50523,1,2378,2541,-163,0,40,0,6
50524,1,2486,2361,125,0,404,0,6
50525,2,2402,2326,76,0,300,0,6
50526,2,2425,2385,40,0,122,1,6
50527,1,2425,2409,16,0,117,1,6
50528,2,2496,2408,88,0,113,0,6
50529,1,2492,2260,232,0,10,0,6
50530,2,2541,2683,-142,0,43,0,6
50531,1,2460,2455,5,0,151,1,6
50532,2,2301,2406,-105,0,11,0,6
50533,2,2550,2365,185,0,14,0,6
50534,1,2503,2462,41,0,123,0,6
50535,2,2475,2490,-15,0,302,0,6
50536,1,2442,2434,8,0,101,1,6
50537,2,2436,2257,179,0,113,1,6
50538,1,2428,2269,159,0,4,0,6
50539,1,2507,2326,181,0,300,0,6
50540,1,2388,2417,-29,0,112,1,6
50541,2,2381,2549,-168,0,41,0,6
50542,1,2475,2515,-40,0,200,0,6
50543,2,2433,2338,95,0,163,0,6
50544,2,2657,2525,132,0,315,0,6
50545,1,2696,2515,181,0,112,0,6
50546,1,2253,2409,-156,0,212,0,6
50547,1,2394,2406,-12,0,5,0,6
50548,2,2535,2507,28,0,212,0,6
50549,1,2417,2362,55,0,61,0,6
50550,2,2551,2385,166,0,4,0,6
50551,1,2534,2417,117,0,31,0,6
50552,1,2428,2388,40,0,0,0,6
50553,3,2239,2421,-182,0,300,0,6
50554,2,2346,2445,-99,0,306,0,6
50555,2,2416,2489,-73,0,58,0,6
50556,1,2439,2288,151,0,49,0,6
50557,1,2610,2480,130,0,343,0,6
50558,1,2512,2494,18,0,46,0,6
50559,1,2488,2249,239,0,100,0,6
50560,1,2410,2294,116,0,302,0,6
50561,2,2400,2384,16,0,203,1,6
50562,1,2303,2484,-181,0,43,0,6
50563,2,2301,2425,-124,0,144,0,6
50564,2,2357,2425,-68,0,405,1,6
50565,2,2577,2394,183,0,113,1,6
50566,1,2550,2482,68,0,330,0,6
50567,2,2378,2442,-64,0,411,0,6
50568,2,2463,2296,167,0,330,0,6
50569,2,2445,2359,86,0,202,1,6
50570,2,2424,2556,-132,0,491,0,6
50571,3,2509,2453,56,0,57,0,6
50572,1,2408,2270,138,0,1,0,6
50573,1,2543,2322,221,0,4,0,6
50574,1,2261,2469,-208,0,246,0,6
50575,2,2211,2482,-271,0,40,0,6
50576,1,2494,2415,79,0,203,0,6
50577,1,2458,2518,-60,0,315,0,6
50578,1,2445,2273,172,0,1,0,6
50579,1,2310,2576,-266,0,106,0,6
50580,3,2520,2278,242,0,31,0,6
50581,1,2481,2400,81,0,106,1,6
50582,1,2387,2400,-13,0,50,0,6
50583,2,2418,2680,-262,0,211,0,6
50584,2,2603,2248,355,0,113,0,6
50585,2,2225,2468,-243,0,244,0,6
50586,1,2239,2473,-234,0,384,1,6
50587,1,2667,2387,280,0,484,0,6
50588,2,2341,2583,-242,0,134,0,6
50589,1,2527,2365,162,0,337,0,6
50590,1,2337,2566,-229,0,402,0,6
50591,1,2599,2369,230,0,34,0,6
50592,2,2412,2475,-63,0,45,1,6
50593,1,2652,2420,232,0,337,0,6
50594,2,2520,2517,3,0,7,1,6
50595,1,2554,2562,-8,0,113,0,6
50596,3,2604,2355,249,0,337,0,6
50597,1,2445,2541,-96,0,46,0,6
50598,2,2367,2508,-141,0,40,0,6
50599,2,2614,2610,4,0,453,0,6
50600,2,2259,2409,-150,0,241,0,6
50601,1,2448,2398,50,0,200,1,6
50603,2,2496,2374,122,0,1,0,6
50604,2,2425,2316,109,0,122,0,6
50605,1,2364,2419,-55,0,484,0,6
50606,2,2517,2465,52,0,302,0,6
50607,3,2699,2694,5,0,160,0,6
50608,2,2512,2489,23,0,4,0,6
50609,1,2271,2461,-190,0,122,0,6
50610,2,2476,2312,164,0,8,0,6
50611,2,2412,2470,-58,0,100,0,6
50612,1,2538,2483,55,0,394,0,6
50613,1,2540,2477,63,0,130,0,6
50614,1,2383,2446,-63,0,211,1,6
50615,2,2254,2402,-148,0,4,0,6
50616,1,2342,2441,-99,0,315,0,6
50617,1,2307,2401,-94,0,374,0,6
50618,2,2396,2431,-35,0,341,0,6
50619,1,2336,2433,-97,0,200,0,6
50620,2,2377,2448,-71,0,307,0,6
50621,3,2428,2538,-110,0,190,0,6
50622,1,2528,2390,138,0,300,0,6
50623,1,2469,2461,8,0,133,0,6
50624,1,2476,2241,235,0,45,0,8
50625,2,2414,2401,13,0,83,0,6
50626,1,2471,2513,-42,0,313,0,6
50627,2,2337,2409,-72,0,48,0,6
50628,1,2464,2280,184,0,10,0,6
50629,1,2452,2323,129,0,128,0,6
50630,2,2325,2457,-132,0,125,1,6
50631,2,2540,2512,28,0,48,0,6
50632,1,2430,2352,78,0,108,1,6
50633,2,2410,2311,99,0,106,1,6
50634,1,2401,2474,-73,0,102,0,6
50635,1,2494,2411,83,0,190,0,6
50636,2,2393,2468,-75,0,1,0,6
50637,1,2238,2402,-164,0,120,0,6
50638,1,2320,2468,-148,0,45,0,6
50639,2,2366,2545,-179,0,49,0,6
50640,2,2284,2442,-158,0,145,0,6
50641,3,2611,2608,3,0,150,0,6
50642,1,2356,2403,-47,0,332,0,6
50643,1,2454,2545,-91,0,341,0,6
50644,1,2452,2408,44,0,111,0,6
50645,1,2348,2403,-55,4,182,0,13
50647,2,2225,2506,-281,0,111,0,6
50648,1,2583,2430,153,0,201,0,6
50649,1,2412,2371,41,0,122,1,6
50650,1,2460,2319,141,0,10,0,6
50651,1,2501,2429,72,0,101,0,6
50652,2,2426,2338,88,0,0,1,6
50653,2,2454,2407,47,0,49,1,6
50654,1,2450,2389,61,0,100,0,6
50656,2,2448,2467,-19,0,101,1,6
50657,2,2438,2412,26,0,45,0,6
50658,1,2270,2434,-164,0,43,0,6
50659,1,2400,2465,-65,0,210,1,6
50660,2,2445,2467,-22,0,103,0,6
50661,1,2408,2250,158,0,123,0,6
50662,1,2600,2624,-24,0,49,0,6
50663,2,2548,2536,12,0,15,0,6
50664,1,2334,2430,-96,0,312,0,6
50665,1,2382,2426,-44,0,121,0,8
50666,1,2290,2420,-130,0,16,0,6
50667,2,2363,2457,-94,0,302,1,6
50668,1,2458,2417,41,0,46,0,6
50669,2,2414,2332,82,0,252,0,6
50670,1,2490,2380,110,0,311,0,6
50671,2,2407,2498,-91,0,414,0,6
50672,1,2488,2511,-23,0,1,0,6
50673,2,2472,2699,-227,0,10,1,6
50674,2,2343,2602,-259,0,53,1,6
50675,2,2382,2694,-312,0,43,0,6
50676,1,2606,2540,66,0,303,0,6
50677,2,2434,2478,-44,0,414,0,6
50678,1,2418,2542,-124,0,46,0,6
50679,1,2384,2456,-72,0,4,1,6
50680,1,2318,2403,-85,0,1,0,6
50681,2,2291,2403,-112,0,112,0,6
50682,2,2538,2462,76,0,122,1,6
50683,1,2416,2262,154,0,135,0,6
50684,2,2360,2517,-157,0,45,0,6
50685,2,2319,2498,-179,0,440,1,6
50686,2,2465,2270,195,0,130,0,6
50687,1,2484,2309,175,0,215,0,6
50688,3,2418,2468,-50,0,101,0,6
50689,1,2430,2220,210,0,256,0,6
50690,1,2412,2378,34,0,118,0,6
50691,1,2514,2438,76,0,123,1,6
50692,3,2470,2465,5,0,201,0,6
50693,2,2337,2454,-117,0,490,0,6
50694,2,2557,2486,71,0,18,0,6
50695,2,2514,2683,-169,0,6,0,6
50696,2,2273,2404,-131,0,112,0,6
50697,1,2367,2406,-39,0,247,0,6
50698,2,2586,2556,30,0,339,0,6
50699,1,2489,2562,-73,0,153,0,6
50700,2,2481,2602,-121,0,280,0,6
50701,1,2654,2346,308,0,47,1,6
50702,2,2358,2669,-311,0,245,0,6
50703,1,2530,2530,0,0,0,1,6
50704,1,2523,2601,-78,0,34,1,6
50706,1,2473,2382,91,0,112,0,6
50707,2,2406,2531,-125,0,115,0,6
50708,3,2435,2431,4,0,105,0,6
50709,1,2445,2281,164,0,130,0,6
50710,2,2411,2357,54,0,80,0,6
50711,1,2477,2472,5,0,31,0,6
50712,2,2534,2608,-74,0,312,1,6
50713,1,2424,2432,-8,0,300,0,6
50714,1,2466,2514,-48,0,4,0,6
50715,1,2491,2393,98,0,414,1,6
50716,2,2326,2506,-180,0,1,0,6
50717,1,2425,2386,39,0,311,0,6
50718,2,2460,2328,132,0,8,0,6
50719,1,2508,2336,172,0,7,0,6
50720,1,2407,2278,129,0,331,0,6
50721,1,2407,2249,158,0,112,0,6
50722,2,2402,2213,189,0,131,1,6
50723,1,2542,2515,27,0,338,0,6
50724,2,2542,2463,79,0,56,0,6
50725,2,2390,2467,-77,0,40,0,8
50726,2,2423,2387,36,0,264,0,6
50727,1,2448,2263,185,0,40,1,6
50728,2,2472,2514,-42,0,190,0,6
50729,2,2417,2388,29,0,202,0,6
50730,3,2334,2413,-79,0,140,0,6
50731,1,2387,2419,-32,0,40,1,6
50732,3,2373,2407,-34,0,49,0,6
50733,2,2618,2611,7,0,130,0,6
50734,2,2361,2414,-53,0,225,1,6
50735,1,2505,2273,232,0,302,0,6
50736,2,2315,2464,-149,0,48,1,6
50737,2,2384,2610,-226,0,1,0,6
50738,1,2535,2472,63,0,302,0,6
50739,1,2453,2494,-41,0,140,0,6
50740,1,2702,2497,205,0,4,0,6
50741,2,2402,2470,-68,0,311,0,6
50742,1,2278,2449,-171,0,113,0,6
50743,1,2483,2401,82,0,52,0,6
50744,1,2403,2549,-146,0,492,0,6
50745,2,2466,2462,4,0,100,0,6
50746,1,2409,2394,15,0,11,1,6
50747,2,2431,2416,15,0,128,0,6
50748,1,2427,2458,-31,0,202,0,6
50749,1,2404,2341,63,0,247,1,6
50750,1,2531,2613,-82,0,33,0,6
50751,2,2345,2431,-86,0,136,0,6
50752,3,2274,2413,-139,0,414,0,8
50753,1,2469,2531,-62,0,341,1,6
50754,2,2381,2548,-167,0,302,0,6
50755,2,2245,2410,-165,0,10,0,6
50756,1,2324,2435,-111,0,120,0,6
50757,2,2421,2449,-28,0,394,1,6
50758,1,2697,2411,286,0,4,1,6
50759,2,2334,2405,-71,0,120,0,6
50760,2,2248,2413,-165,0,253,0,6
50761,1,2509,2323,186,0,106,1,6
50762,1,2483,2404,79,0,410,0,6
50763,2,2536,2664,-128,0,60,0,6
50764,2,2378,2401,-23,0,51,0,6
50765,1,2336,2452,-116,0,45,0,6
50766,1,2470,2371,99,0,210,0,6
50767,1,2327,2402,-75,0,369,0,8
50768,2,2276,2456,-180,0,88,1,6
50769,3,2613,2530,83,0,404,0,6
50770,2,2264,2540,-276,0,6,1,6
50771,3,2467,2441,26,0,34,0,6
50772,2,2605,2295,310,0,140,0,6
50773,1,2406,2409,-3,0,241,0,6
50774,3,2499,2406,93,0,6,0,6
50775,3,2467,2511,-44,0,11,0,6
50776,3,2397,2441,-44,0,4,0,6
50777,1,2477,2359,118,0,106,0,6
50778,1,2378,2411,-33,0,4,0,6
50779,2,2438,2551,-113,0,15,0,6
50780,1,2493,2334,159,0,13,1,6
50781,2,2395,2408,-13,0,176,0,6
50782,1,2464,2297,167,0,49,0,6
50783,1,2449,2297,152,0,27,1,6
50784,2,2407,2410,-3,0,40,0,6
50785,2,2629,2467,162,0,0,0,6
50786,2,2295,2431,-136,0,131,0,8
50787,2,2444,2344,100,0,0,0,6
50788,1,2494,2338,156,0,302,0,6
50789,1,2262,2507,-245,0,225,0,6
50790,2,2507,2533,-26,0,220,0,6
50791,1,2468,2317,151,0,101,0,6
50792,3,2270,2510,-240,0,113,0,6
50793,2,2352,2472,-120,0,40,0,8
50794,2,2419,2422,-3,0,6,0,6
50795,1,2461,2521,-60,0,405,1,6
50796,2,2427,2332,95,0,260,0,6
50797,1,2606,2612,-6,0,45,0,6
50798,1,2409,2327,82,0,483,0,6
50799,1,2408,2442,-34,0,102,0,6
50800,1,2541,2649,-108,0,180,0,6
50801,1,2405,2341,64,0,122,0,6
50802,2,2406,2373,33,0,192,0,6
50803,1,2520,2419,101,0,483,0,6
50804,2,2465,2294,171,0,65,0,6
50805,1,2249,2580,-331,0,134,0,6
50806,3,2467,2470,-3,0,57,0,6
50807,2,2502,2511,-9,0,265,0,6
50808,2,2279,2418,-139,0,14,0,6
50809,1,2464,2476,-12,0,1,1,6
50810,1,2553,2433,120,0,113,0,6
50811,3,2563,2357,206,0,52,0,6
50812,2,2344,2519,-175,0,404,1,6
50813,1,2524,2460,64,0,302,0,6
50814,1,2687,2373,314,0,35,0,6
50815,1,2493,2387,106,0,107,0,6
50816,1,2594,2399,195,0,307,0,6
50817,1,2671,2536,135,0,306,0,6
50818,2,2531,2656,-125,0,415,0,6
50819,2,2606,2496,110,0,415,0,6
50820,2,2298,2506,-208,0,311,0,6
50821,3,2433,2247,186,0,4,0,6
50822,2,2262,2705,-443,0,487,1,6
50823,2,2416,2250,166,0,41,0,6
50824,2,2401,2524,-123,0,332,0,6
50825,3,2606,2434,172,0,307,0,6
50826,1,2494,2474,20,0,210,0,6
50827,2,2620,2498,122,0,4,0,6
50828,2,2423,2404,19,0,241,1,6
50829,3,2320,2412,-92,0,1,0,6
50830,2,2459,2555,-96,0,45,0,6
50831,2,2488,2417,71,0,0,0,6
50832,2,2443,2459,-16,0,228,0,6
50834,2,2513,2530,-17,4,9,0,13
50835,2,2309,2454,-145,0,246,0,6
50836,2,2402,2393,9,0,46,0,6
50837,1,2282,2428,-146,0,100,1,6
50838,2,2522,2612,-90,0,152,0,6
50839,1,2420,2413,7,0,297,0,6
50840,2,2347,2452,-105,0,102,0,6
50841,2,2468,2648,-180,0,200,0,6
50842,2,2353,2410,-57,0,319,0,6
50843,2,2320,2496,-176,0,48,0,6
50844,2,2356,2409,-53,0,200,0,6
50845,2,2326,2481,-155,0,69,1,6
50846,2,2297,2700,-403,0,2,0,6
50847,2,2412,2408,4,0,330,1,6
50848,2,2487,2452,35,0,405,0,6
50849,2,2359,2484,-125,0,4,0,8
50850,2,2351,2437,-86,0,45,0,6
50851,1,2359,2415,-56,0,140,0,6
50852,1,2451,2374,77,0,113,0,6
50853,3,2256,2434,-178,0,244,0,6
50854,3,2531,2518,13,0,40,0,6
50855,1,2443,2493,-50,0,317,0,6
50856,1,2351,2481,-130,0,115,0,6
50857,2,2424,2436,-12,0,22,0,6
50858,2,2542,2465,77,0,46,1,6
50859,1,2415,2353,62,0,40,0,6
50860,2,2476,2549,-73,0,107,0,6
50861,1,2456,2438,18,0,37,1,6
50862,1,2414,2296,118,0,234,1,6
50863,2,2414,2273,141,0,123,1,6
50864,2,2339,2469,-130,0,101,0,6
50865,1,2583,2329,254,0,100,0,8
50866,3,2528,2397,131,0,100,0,6
50867,1,2432,2436,-4,0,46,1,6
50868,3,2498,2361,137,0,64,0,6
50869,1,2469,2286,183,0,15,0,6
50870,2,2379,2400,-21,0,428,0,6
50871,2,2412,2514,-102,0,125,0,6
50872,2,2467,2613,-146,0,41,0,6
50873,1,2499,2351,148,0,101,0,6
50874,2,2321,2478,-157,0,1,0,6
50875,1,2403,2399,4,0,415,1,6
50876,2,2437,2603,-166,0,4,0,6
50877,2,2343,2411,-68,0,70,0,6
50878,1,2413,2441,-28,0,130,1,6
50879,1,2507,2367,140,0,5,0,6
50880,2,2212,2432,-220,0,115,0,6
50881,2,2458,2499,-41,0,41,0,6
50882,1,2410,2418,-8,0,5,0,6
50883,2,2435,2433,2,0,373,0,6
50884,2,2281,2500,-219,0,14,0,6
50885,2,2235,2539,-304,0,330,0,6
50886,1,2412,2335,77,0,13,0,6
50887,1,2612,2565,47,0,300,0,6
50888,1,2321,2414,-93,0,120,0,6
50889,1,2443,2262,181,0,1,0,6
50890,2,2484,2706,-222,0,151,0,6
50891,2,2204,2457,-253,4,120,0,13
50892,2,2459,2365,94,0,107,0,6
50893,2,2451,2518,-67,0,338,0,6
50894,1,2616,2504,112,0,7,0,6
50895,2,2415,2348,67,0,122,0,6
50896,2,2302,2476,-174,0,242,1,8
50897,1,2420,2366,54,0,406,0,6
50898,1,2442,2347,95,0,8,0,6
50899,1,2631,2309,322,0,100,0,7
50900,1,2590,2468,122,0,45,0,6
50901,2,2473,2243,230,0,1,0,6
50902,2,2392,2418,-26,0,322,0,6
50903,2,2319,2403,-84,0,57,0,6
50904,2,2497,2433,64,0,15,0,6
50905,1,2539,2501,38,0,52,0,6
50906,2,2352,2419,-67,0,4,0,6
50907,1,2406,2374,32,0,122,0,6
50908,2,2408,2421,-13,0,479,0,6
50909,2,2361,2449,-88,0,193,1,6
50910,2,2228,2452,-224,0,46,0,6
50911,2,2262,2486,-224,0,101,0,6
50912,1,2512,2345,167,0,106,0,6
50913,2,2406,2407,-1,0,315,0,6
50914,2,2309,2503,-194,0,30,1,6
50915,2,2409,2426,-17,0,300,1,6
50916,1,2523,2519,4,0,218,0,6
50917,1,2431,2379,52,0,4,0,6
50918,2,2355,2408,-53,0,319,0,6
50919,2,2386,2483,-97,0,123,1,6
50920,1,2458,2454,4,0,112,0,6
50921,1,2416,2463,-47,0,46,0,6
50922,1,2650,2616,34,0,41,0,6
50923,3,2473,2318,155,0,21,0,6
50924,1,2418,2318,100,0,231,0,6
50925,3,2399,2526,-127,0,0,0,6
50926,2,2518,2471,47,0,205,0,6
50927,1,2708,2388,320,0,107,0,6
50928,2,2424,2456,-32,0,25,0,6
50929,3,2293,2417,-124,0,49,0,6
50930,1,2444,2253,191,0,40,0,6
50931,2,2543,2553,-10,0,336,0,6
50932,1,2438,2385,53,0,40,0,6
50933,2,2283,2434,-151,0,110,1,6
50934,1,2482,2472,10,0,152,1,6
50935,2,2558,2576,-18,0,337,0,6
50936,2,2606,2434,172,0,307,0,6
50937,1,2429,2418,11,0,4,0,6
50938,1,2416,2338,78,0,118,0,6
50939,2,2425,2326,99,0,105,1,6
50940,1,2668,2531,137,0,106,0,6
50941,2,2344,2429,-85,0,80,0,6
50942,2,2396,2400,-4,0,48,0,6
50943,1,2505,2432,73,0,45,1,6
50944,2,2453,2443,10,0,463,0,6
50945,2,2296,2416,-120,0,288,0,6
50946,1,2544,2233,311,0,176,0,6
50947,2,2413,2350,63,0,380,1,6
50948,2,2472,2710,-238,0,190,0,6
50949,2,2513,2430,83,0,320,1,6
50950,2,2380,2528,-148,0,303,0,6
50951,2,2436,2457,-21,0,4,0,6
50952,1,2455,2535,-80,0,311,0,6
50953,2,2439,2617,-178,0,227,0,6
50954,1,2414,2362,52,0,100,0,6
50955,2,2464,2620,-156,0,331,0,6
50956,1,2662,2295,367,0,4,0,7
50957,1,2489,2452,37,0,151,0,6
50958,2,2200,2516,-316,0,10,1,6
50959,2,2369,2457,-88,0,380,1,6
50960,2,2381,2470,-89,0,101,0,6
50961,2,2412,2453,-41,0,0,0,6
50962,2,2532,2656,-124,0,101,1,6
50963,2,2489,2511,-22,0,117,0,6
50964,1,2685,2284,401,0,0,0,8
50965,3,2570,2655,-85,0,107,0,6
50966,1,2407,2422,-15,0,207,0,6
50967,2,2337,2464,-127,0,123,0,6
50968,3,2496,2544,-48,0,227,0,6
50969,1,2433,2293,140,0,1,0,6
50970,1,2350,2402,-52,4,182,1,13
50971,1,2275,2446,-171,0,113,0,6
50972,2,2259,2497,-238,0,102,1,6
50973,1,2639,2544,95,0,315,0,6
50974,1,2413,2422,-9,0,131,0,6
50975,2,2406,2331,75,0,53,0,6
50976,2,2551,2587,-36,0,311,0,6
50977,2,2442,2598,-156,0,123,0,6
50978,2,2324,2702,-378,0,130,0,6
50979,3,2449,2447,2,0,46,0,6
50980,2,2415,2294,121,0,13,0,6
50981,2,2416,2419,-3,0,80,0,6
50982,2,2275,2702,-427,0,242,0,8
50983,1,2524,2401,123,0,190,0,6
50984,1,2265,2407,-142,0,40,1,6
50985,2,2315,2470,-155,0,56,1,6
50986,2,2712,2506,206,0,131,0,6
50987,2,2366,2508,-142,4,344,0,13
50988,2,2408,2380,28,0,123,1,6
50989,1,2623,2582,41,0,302,0,6
50990,1,2465,2346,119,0,20,1,6
50991,1,2408,2418,-10,0,12,0,6
50992,1,2328,2426,-98,0,15,0,6
50993,2,2420,2334,86,0,46,0,6
50994,1,2717,2267,450,0,0,0,8
50995,1,2512,2460,52,0,45,1,6
50996,2,2414,2314,100,0,106,0,6
50997,2,2406,2334,72,0,18,1,6
50998,3,2231,2548,-317,0,292,0,6
50999,3,2279,2418,-139,0,200,0,6
51000,1,2438,2281,157,0,150,0,6
51001,2,2307,2435,-128,0,0,0,6
51002,1,2399,2463,-64,0,41,1,6
51003,2,2357,2406,-49,0,84,0,6
51004,3,2402,2218,184,0,111,0,6
51005,2,2462,2406,56,0,459,1,6
51006,2,2369,2431,-62,0,40,0,6
51007,1,2466,2358,108,0,104,0,6
51008,2,2367,2487,-120,0,226,0,6
51009,2,2342,2446,-104,0,45,0,6
51010,1,2480,2318,162,0,100,0,8
51011,2,2419,2510,-91,0,110,1,6
51012,2,2260,2729,-469,0,231,0,8
51013,1,2422,2335,87,0,311,0,6
51014,2,2436,2494,-58,0,121,0,6
51015,1,2632,2476,156,0,48,1,6
51016,2,2396,2499,-103,0,455,0,6
51017,2,2355,2416,-61,0,15,0,6
51018,1,2602,2439,163,0,373,0,6
51019,1,2342,2448,-106,0,110,0,6
51020,2,2341,2438,-97,0,101,0,6
51021,2,2428,2528,-100,0,140,0,6
51022,1,2654,2478,176,0,16,1,6
51023,2,2402,2427,-25,0,479,0,6
51024,2,2528,2703,-175,0,48,0,6
51025,3,2475,2465,10,0,36,0,6
51026,2,2349,2462,-113,0,57,1,6
51027,3,2620,2571,49,0,300,0,6
51028,2,2347,2436,-89,0,150,0,6
51029,1,2403,2321,82,0,106,0,6
51030,1,2515,2255,260,0,162,1,6
51031,1,2519,2424,95,0,45,0,6
51032,1,2300,2418,-118,4,346,0,13
51033,1,2707,2470,237,0,153,0,6
51034,2,2384,2525,-141,0,112,0,6
51035,1,2431,2452,-21,0,122,1,6
51036,2,2501,2306,195,0,150,1,8
51037,2,2254,2739,-485,0,243,0,7
51038,2,2457,2413,44,0,200,0,6
51039,1,2348,2419,-71,0,330,1,6
51040,2,2537,2629,-92,0,13,0,6
51041,1,2499,2407,92,0,151,0,6
51042,1,2459,2322,137,4,102,0,13
51043,2,2273,2474,-201,0,324,1,6
51044,3,2366,2412,-46,0,331,0,6
51045,1,2414,2411,3,0,106,0,6
51046,2,2527,2515,12,0,41,0,6
51047,1,2454,2388,66,0,313,0,6
51048,2,2285,2441,-156,0,113,0,6
51049,2,2516,2491,25,0,49,0,6
51050,1,2416,2363,53,0,25,0,6
51051,1,2352,2457,-105,0,180,1,6
51052,1,2400,2248,152,0,0,0,6
51053,1,2543,2497,46,0,490,0,6
51054,2,2419,2308,111,0,80,0,6
51055,3,2641,2524,117,0,174,0,6
51056,2,2419,2572,-153,0,347,0,6
51057,2,2338,2523,-185,0,107,0,6
51058,2,2420,2261,159,0,1,0,6
51059,2,2500,2409,91,0,385,0,6
51060,2,2704,2463,241,0,8,0,6
51061,1,2436,2605,-169,0,1,0,6
51062,2,2456,2636,-180,0,205,0,6
51063,2,2384,2456,-72,0,107,0,6
51064,3,2423,2517,-94,0,100,0,6
51065,2,2340,2400,-60,0,120,1,6
51066,1,2411,2352,59,0,123,0,6
51067,2,2527,2582,-55,0,40,1,6
51068,1,2438,2293,145,0,226,0,6
51069,2,2529,2709,-180,0,46,0,6
51070,3,2382,2468,-86,0,46,0,6
51071,1,2414,2425,-11,0,260,0,6
51072,2,2515,2532,-17,0,123,0,6
51073,1,2317,2403,-86,0,110,0,6
51074,1,2421,2339,82,0,140,0,6
51075,1,2337,2468,-131,0,45,0,6
51076,1,2439,2330,109,0,400,1,6
51077,2,2493,2311,182,0,200,0,6
51078,1,2473,2416,57,0,134,0,6
51079,2,2548,2503,45,0,456,1,6
51080,2,2478,2341,137,0,404,0,6
51081,2,2336,2427,-91,0,46,0,6
51082,1,2526,2252,274,0,45,0,6
51083,1,2445,2400,45,0,458,1,6
51084,1,2572,2665,-93,0,335,0,6
51085,1,2450,2338,112,0,8,0,6
51086,1,2472,2526,-54,0,113,0,6
51087,3,2712,2689,23,0,38,0,6
51088,3,2442,2421,21,0,207,0,6
51089,1,2440,2343,97,0,0,0,6
51090,1,2430,2320,110,0,112,0,6
51091,3,2522,2657,-135,0,4,0,6
51092,1,2475,2512,-37,0,200,0,6
51093,2,2405,2459,-54,0,4,0,6
51094,1,2515,2345,170,0,0,0,6
51095,1,2450,2301,149,0,15,1,6
51096,1,2712,2312,400,0,7,0,6
51097,1,2690,2469,221,0,5,0,6
51098,1,2515,2425,90,0,106,0,6
51099,2,2420,2459,-39,0,297,0,6
51100,1,2432,2651,-219,0,200,0,6
51101,2,2411,2437,-26,0,303,0,6
51102,2,2254,2403,-149,0,211,0,6
51103,3,2477,2383,94,0,16,0,6
51104,1,2467,2350,117,0,100,0,6
51105,1,2382,2403,-21,0,106,0,6
51106,1,2576,2445,131,0,16,0,6
51107,1,2413,2339,74,0,1,0,6
51108,3,2444,2317,127,0,80,0,6
51109,1,2419,2420,-1,0,4,1,6
51110,1,2437,2521,-84,0,88,0,6
51111,1,2397,2411,-14,0,310,0,6
51112,2,2328,2437,-109,0,41,1,8
51113,2,2411,2416,-5,0,154,0,6
51114,2,2375,2468,-93,0,126,0,6
51115,1,2416,2282,134,0,122,0,6
51116,2,2331,2485,-154,0,0,0,8
51117,1,2441,2350,91,0,246,1,6
51118,2,2425,2364,61,0,112,0,6
51119,1,2519,2510,9,0,48,0,6
51120,3,2498,2479,19,0,151,0,6
51121,1,2639,2530,109,0,302,0,6
51122,2,2453,2481,-28,0,201,0,6
51123,2,2403,2522,-119,0,29,0,6
51124,1,2619,2611,8,0,306,0,6
51125,3,2473,2518,-45,0,410,0,6
51126,1,2333,2484,-151,0,230,0,6
51127,2,2401,2509,-108,0,41,0,6
51128,1,2538,2398,140,0,216,0,6
51129,2,2434,2396,38,0,277,0,6
51130,1,2425,2376,49,0,7,0,6
51131,1,2658,2544,114,0,488,0,6
51132,1,2441,2461,-20,0,170,0,6
51133,1,2277,2405,-128,0,123,1,6
51134,1,2339,2444,-105,0,242,0,6
51135,2,2486,2501,-15,0,102,0,6
51136,2,2447,2542,-95,0,40,0,6
51137,2,2285,2435,-150,0,80,0,6
51138,1,2388,2447,-59,0,211,0,6
51139,2,2772,2600,172,0,305,0,6
51140,3,2694,2476,218,0,7,0,6
51141,1,2395,2450,-55,0,0,0,6
51142,2,2556,2655,-99,0,241,0,6
51143,2,2564,2601,-37,0,10,1,6
51144,2,2316,2463,-147,4,45,0,13
51145,1,2420,2400,20,0,122,0,6
51146,2,2383,2425,-42,0,244,1,6
51147,1,2324,2454,-130,0,1,0,6
51148,1,2467,2209,258,0,315,0,6
51149,1,2404,2334,70,0,46,0,6
51150,2,2460,2462,-2,0,132,0,6
51151,2,2391,2535,-144,0,101,0,6
51152,1,2297,2406,-109,0,4,0,6
51153,2,2570,2643,-73,0,344,0,6
51154,1,2492,2548,-56,0,228,1,6
51155,1,2273,2430,-157,0,467,0,6
51156,2,2353,2455,-102,0,5,1,6
51157,3,2421,2546,-125,0,106,0,6
51158,2,2344,2406,-62,0,10,0,6
51159,2,2352,2420,-68,0,1,1,6
51160,1,2514,2432,82,0,202,0,6
51161,2,2405,2447,-42,0,49,0,6
51162,1,2520,2440,80,0,45,0,6
51163,1,2559,2404,155,0,255,0,6
51164,2,2601,2649,-48,0,106,0,6
51165,2,2473,2419,54,0,56,0,6
51166,2,2439,2402,37,0,100,0,6
51167,1,2443,2481,-38,0,31,0,6
51168,1,2507,2524,-17,0,330,0,6
51169,2,2420,2449,-29,0,128,1,6
51170,2,2539,2515,24,0,241,0,6
51171,1,2523,2643,-120,0,28,0,6
51172,1,2294,2414,-120,0,47,0,6
51173,1,2385,2468,-83,0,125,0,6
51174,2,2402,2428,-26,0,147,1,6
51175,1,2590,2425,165,0,224,1,6
51176,1,2418,2421,-3,0,1,0,6
51177,1,2437,2346,91,0,45,0,6
51178,1,2455,2385,70,0,215,0,6
51179,1,2410,2270,140,0,406,1,6
51180,1,2293,2431,-138,0,241,1,6
51181,2,2539,2524,15,0,409,0,6
51182,2,2436,2362,74,0,191,0,6
51183,1,2403,2404,-1,0,316,0,6
51184,1,2440,2371,69,0,45,0,6
51185,1,2330,2400,-70,0,20,1,6
51186,2,2662,2565,97,0,4,0,6
51187,2,2346,2445,-99,0,111,0,6
51188,2,2442,2442,0,0,151,0,6
51189,1,2442,2320,122,0,302,0,8
51190,1,2513,2343,170,0,123,0,6
51191,1,2402,2552,-150,0,8,1,6
51192,2,2394,2413,-19,0,40,0,6
51193,1,2610,2559,51,0,202,0,6
51194,2,2475,2422,53,0,190,0,6
51195,1,2403,2332,71,0,241,0,6
51196,1,2328,2409,-81,0,120,1,6
51197,2,2405,2373,32,0,106,1,6
51198,1,2446,2450,-4,0,10,0,6
51199,2,2365,2481,-116,0,230,1,6
51200,1,2512,2427,85,4,32,0,13
51201,1,2544,2518,26,0,315,1,6
51202,2,2231,2407,-176,0,50,0,6
51203,1,2366,2464,-98,0,40,1,6
51204,1,2445,2327,118,0,300,0,6
51205,2,2425,2518,-93,0,242,0,6
51206,2,2273,2402,-129,0,296,1,6
51207,1,2255,2402,-147,0,226,0,6
51208,1,2410,2340,70,0,41,1,6
51209,3,2425,2539,-114,0,45,0,6
51210,1,2482,2423,59,0,49,0,6
51211,1,2395,2432,-37,0,229,1,6
51212,2,2408,2416,-8,0,129,0,6
51213,1,2521,2635,-114,0,40,0,6
51214,2,2272,2452,-180,0,6,0,6
51215,2,2422,2444,-22,0,101,0,6
51216,2,2561,2550,11,0,107,0,6
51217,1,2459,2323,136,0,270,0,6
51218,2,2511,2356,155,0,200,1,6
51219,3,2655,2564,91,0,14,0,6
51220,2,2455,2251,204,0,266,1,6
51221,3,2609,2764,-155,0,81,0,6
51222,2,2530,2532,-2,0,300,1,6
51223,1,2459,2349,110,0,25,1,6
51224,1,2517,2332,185,0,40,0,6
51225,1,2587,2593,-6,0,28,0,6
51226,1,2429,2257,172,0,130,1,6
51227,1,2436,2433,3,0,144,1,6
51228,2,2249,2418,-169,0,40,0,6
51229,2,2414,2393,21,0,210,1,6
51230,1,2450,2541,-91,0,300,0,6
51231,2,2381,2558,-177,0,27,0,6
51232,2,2572,2655,-83,0,40,0,6
51233,2,2376,2455,-79,0,453,0,6
51234,2,2331,2413,-82,0,101,1,6
51235,2,2422,2246,176,0,0,0,6
51236,1,2411,2449,-38,0,4,0,6
51237,1,2657,2579,78,0,330,0,6
51238,1,2554,2468,86,0,34,0,6
51239,2,2337,2401,-64,0,46,0,6
51240,3,2403,2467,-64,4,50,0,13
51241,1,2550,2487,63,0,18,0,6
51242,1,2348,2420,-72,0,154,0,6
51243,1,2457,2418,39,0,30,0,6
51244,1,2451,2400,51,0,0,0,6
51245,2,2437,2533,-96,0,301,0,6
51246,2,2379,2472,-93,0,83,0,6
51247,1,2421,2422,-1,0,112,0,6
51248,1,2427,2476,-49,0,45,1,6
51249,1,2628,2529,99,0,302,0,6
51250,2,2593,2463,130,0,21,0,6
51251,2,2513,2452,61,0,482,1,6
51252,2,2426,2427,-1,0,176,0,6
51253,3,2587,2555,32,0,125,0,6
51254,2,2309,2411,-102,0,61,1,6
51255,1,2434,2537,-103,4,121,0,13
51256,2,2556,2500,56,0,244,0,6
51257,1,2449,2417,32,0,458,0,6
51258,1,2446,2279,167,0,487,0,8
51259,1,2408,2256,152,0,311,0,6
51260,1,2523,2371,152,0,210,0,6
51261,2,2395,2520,-125,0,4,0,6
51262,1,2329,2456,-127,0,1,0,6
51263,1,2604,2659,-55,0,5,0,6
51264,1,2400,2378,22,0,466,0,6
51265,1,2539,2524,15,0,409,0,6
51266,3,2256,2408,-152,0,128,0,6
51267,2,2335,2443,-108,0,432,0,6
51268,1,2419,2322,97,0,45,0,8
51269,1,2559,2556,3,0,167,1,6
51270,2,2416,2417,-1,0,426,0,6
51271,2,2354,2443,-89,0,123,0,6
51272,2,2464,2559,-95,0,120,1,6
51273,2,2355,2425,-70,0,211,0,6
51274,1,2400,2285,115,0,269,0,8
51275,2,2334,2420,-86,0,110,0,6
51276,1,2343,2509,-166,0,0,0,6
51277,3,2464,2587,-123,0,15,0,6
51278,2,2336,2420,-84,0,7,0,6
51279,1,2284,2418,-134,0,101,0,6
51280,1,2403,2312,91,0,300,0,6
51281,1,2345,2463,-118,0,5,0,6
51282,2,2240,2628,-388,0,388,0,6
51283,1,2708,2700,8,0,9,0,6
51284,1,2575,2662,-87,0,40,0,6
51285,1,2411,2455,-44,0,101,0,6
51286,1,2466,2549,-83,0,41,1,6
51287,2,2429,2433,-4,0,320,0,6
51288,2,2370,2554,-184,0,41,0,6
51289,1,2424,2337,87,0,40,1,6
51290,2,2459,2526,-67,0,88,0,6
51291,2,2353,2405,-52,0,207,0,6
51292,2,2308,2433,-125,0,208,0,6
51293,1,2537,2442,95,0,230,0,6
51294,2,2294,2421,-127,0,4,0,6
51295,1,2371,2433,-62,0,5,1,6
51296,1,2524,2632,-108,0,40,1,6
51297,2,2442,2585,-143,0,106,0,6
51298,3,2473,2353,120,0,209,0,6
51299,1,2534,2457,77,0,335,0,6
51300,1,2594,2269,325,0,202,0,6
51301,2,2513,2523,-10,0,48,0,6
51302,2,2409,2323,86,0,315,0,6
51303,2,2462,2397,65,0,10,0,6
51304,1,2695,2713,-18,0,106,0,6
51305,1,2424,2332,92,0,106,0,6
51306,2,2415,2338,77,0,140,0,6
51307,2,2556,2546,10,0,311,1,6
51308,2,2328,2447,-119,0,212,0,6
51309,1,2423,2376,47,0,7,1,6
51310,1,2652,2611,41,0,0,0,6
51311,2,2531,2392,139,0,202,1,6
51312,2,2384,2455,-71,0,244,0,6
51313,1,2406,2319,87,0,412,0,8
51314,2,2360,2407,-47,0,406,0,6
51315,1,2504,2337,167,0,41,1,6
51316,3,2406,2236,170,0,107,0,6
51317,1,2499,2324,175,0,151,1,6
51318,2,2354,2469,-115,0,40,0,6
51319,2,2550,2562,-12,0,61,1,6
51320,1,2507,2335,172,0,330,0,6
51321,1,2231,2404,-173,0,45,0,8
51322,2,2387,2462,-75,0,190,0,6
51323,1,2565,2577,-12,0,58,0,6
51324,2,2272,2411,-139,0,331,0,6
51325,2,2762,2585,177,0,220,1,6
51326,3,2514,2347,167,0,101,0,6
51327,1,2437,2304,133,0,106,0,6
51328,1,2448,2418,30,0,4,0,6
51329,1,2438,2494,-56,0,250,1,6
51330,1,2345,2408,-63,0,46,0,6
51331,1,2579,2429,150,0,106,0,6
51332,1,2424,2424,0,0,205,0,6
51333,2,2541,2654,-113,0,106,0,6
51334,3,2401,2334,67,0,415,0,6
51335,1,2429,2256,173,0,147,0,6
51336,1,2413,2606,-193,0,11,0,6
51337,3,2707,2701,6,0,9,0,6
51338,1,2624,2542,82,0,107,0,6
51339,1,2416,2341,75,0,140,0,6
51340,2,2294,2423,-129,0,190,0,8
51341,1,2455,2328,127,0,103,0,6
51342,2,2410,2448,-38,0,154,1,6
51343,1,2457,2455,2,0,105,1,6
51344,2,2380,2438,-58,0,106,1,6
51345,1,2459,2426,33,0,33,0,6
51346,1,2422,2471,-49,0,4,1,6
51347,1,2441,2299,142,0,13,0,6
51348,1,2398,2597,-199,0,112,0,6
51349,1,2451,2527,-76,0,300,1,6
51350,3,2206,2446,-240,0,120,0,6
51351,3,2410,2428,-18,0,394,0,6
51352,1,2345,2403,-58,0,40,0,6
51353,2,2488,2449,39,0,241,0,8
51354,2,2468,2400,68,0,110,0,6
51355,2,2328,2449,-121,0,1,1,6
51356,2,2643,2344,299,0,245,0,6
51357,2,2334,2508,-174,0,1,0,6
51358,2,2286,2457,-171,0,10,0,6
51359,2,2413,2454,-41,0,101,0,6
51360,2,2701,2707,-6,0,106,0,6
51361,2,2546,2589,-43,0,106,0,6
51362,2,2589,2466,123,0,4,1,6
51363,3,2445,2401,44,0,132,0,6
51364,1,2247,2421,-174,0,112,0,6
51365,1,2465,2313,152,0,15,0,6
51366,2,2476,2345,131,0,131,0,6
51367,3,2268,2430,-162,0,255,0,6
51368,2,2357,2466,-109,0,40,0,6
51369,1,2538,2511,27,0,233,0,6
51370,1,2425,2249,176,0,462,1,6
51371,2,2487,2583,-96,0,334,1,6
51372,3,2445,2550,-105,0,202,0,6
51373,1,2517,2404,113,4,9,0,13
51374,2,2507,2659,-152,0,40,0,6
51375,2,2296,2445,-149,0,474,0,6
51376,1,2531,2441,90,0,7,0,6
51377,2,2598,2390,208,0,130,0,6
51378,1,2364,2407,-43,0,310,0,6
51379,2,2417,2443,-26,0,106,0,6
51380,1,2713,2695,18,0,311,0,6
51381,2,2465,2351,114,0,205,1,6
51382,2,2406,2414,-8,0,4,0,6
51383,2,2272,2478,-206,0,121,0,6
51384,1,2662,2629,33,0,406,0,6
51385,2,2291,2410,-119,0,322,0,6
51386,1,2539,2459,80,0,453,0,6
51387,2,2374,2461,-87,0,31,0,6
51388,2,2428,2466,-38,0,4,0,6
51389,2,2330,2404,-74,0,1,0,6
51390,2,2413,2585,-172,0,178,0,6
51391,1,2595,2753,-158,0,190,0,6
51393,1,2394,2552,-158,0,194,0,6
51394,2,2432,2589,-157,0,337,1,6
51395,2,2376,2412,-36,0,106,0,6
51396,1,2459,2408,51,0,4,1,6
51397,2,2405,2336,69,0,154,0,6
51399,1,2401,2346,55,0,0,1,6
51400,1,2466,2346,120,0,142,0,6
51401,1,2389,2510,-121,0,315,0,6
51402,1,2371,2428,-57,0,263,0,6
51403,1,2372,2406,-34,0,112,0,6
51404,1,2449,2444,5,0,317,0,6
51405,2,2482,2452,30,0,49,0,6
51406,1,2420,2594,-174,0,5,0,6
51407,3,2448,2292,156,0,302,0,6
51408,2,2250,2451,-201,4,45,0,13
51409,2,2528,2581,-53,0,112,1,6
51410,1,2430,2428,2,0,112,1,6
51411,1,2492,2427,65,0,120,0,8
51412,2,2377,2630,-253,0,49,0,6
51413,1,2394,2423,-29,0,45,0,6
51414,2,2437,2371,66,0,45,0,6
51416,2,2341,2447,-106,0,0,0,6
51417,2,2536,2397,139,0,101,0,6
51418,2,2473,2323,150,0,4,0,6
51419,1,2420,2422,-2,0,242,1,6
51420,1,2400,2316,84,0,145,0,6
51421,2,2389,2412,-23,0,311,1,6
51422,2,2414,2287,127,0,41,0,6
51423,2,2238,2400,-162,0,118,0,6
51424,2,2588,2410,178,0,215,0,6
51425,1,2536,2473,63,0,46,0,6
51426,2,2359,2457,-98,0,150,0,6
51427,1,2430,2359,71,0,300,0,6
51429,1,2690,2667,23,0,106,0,6
51430,2,2346,2400,-54,0,48,0,8
51431,1,2494,2567,-73,0,45,0,6
51432,1,2458,2310,148,0,258,1,6
51433,1,2438,2574,-136,0,101,0,6
51434,1,2423,2378,45,0,311,1,6
51435,3,2347,2406,-59,0,0,0,6
51436,1,2453,2400,53,0,45,0,6
51437,3,2421,2326,95,0,106,0,6
51438,1,2409,2323,86,0,302,0,6
51439,1,2597,2467,130,0,301,0,6
51440,2,2473,2470,3,0,45,0,6
51441,1,2553,2601,-48,0,78,1,6
51442,2,2295,2446,-151,0,310,0,6
51444,2,2343,2437,-94,0,132,0,6
51445,1,2455,2543,-88,0,11,0,6
51446,2,2254,2416,-162,0,41,0,6
51447,2,2566,2385,181,0,5,1,6
51448,1,2623,2532,91,0,330,0,6
51449,1,2295,2406,-111,0,322,0,6
51450,2,2585,2567,18,0,16,0,6
51451,2,2285,2429,-144,0,45,0,6
51452,3,2419,2394,25,0,245,0,8
51453,1,2537,2396,141,0,337,0,6
51454,3,2315,2455,-140,0,107,0,8
51455,2,2326,2502,-176,0,310,0,6
51456,1,2586,2523,63,0,7,0,6
51457,1,2461,2355,106,0,205,1,6
51458,2,2539,2422,117,0,123,0,8
51459,1,2520,2295,225,0,121,0,6
51460,1,2435,2349,86,0,302,0,6
51461,2,2326,2485,-159,0,106,0,6
51462,1,2423,2379,44,0,404,1,6
51463,2,2266,2632,-366,0,409,1,6
51464,1,2528,2446,82,0,8,1,6
51465,1,2400,2277,123,0,54,0,6
51466,1,2417,2375,42,0,485,0,6
51467,2,2484,2436,48,0,80,1,6
51468,2,2552,2568,-16,0,268,0,6
51469,3,2403,2303,100,0,302,0,6
51470,1,2405,2560,-155,0,46,0,6
51471,1,2467,2540,-73,0,242,0,6
51472,1,2355,2435,-80,0,28,0,6
51473,2,2662,2695,-33,0,404,0,6
51474,2,2378,2417,-39,0,426,1,6
51475,1,2472,2555,-83,0,280,0,6
51476,1,2503,2400,103,0,245,0,6
51477,2,2413,2447,-34,0,302,0,6
51478,1,2365,2417,-52,0,40,0,6
51479,1,2580,2464,116,0,228,1,6
51480,1,2431,2317,114,0,40,1,6
51481,2,2405,2541,-136,0,256,0,6
51482,2,2442,2476,-34,0,219,0,6
51483,1,2345,2407,-62,0,45,0,6
51485,1,2378,2420,-42,0,84,0,6
51486,1,2545,2402,143,0,265,0,6
51488,1,2328,2418,-90,0,1,0,6
51489,2,2432,2396,36,0,312,1,6
51490,1,2528,2573,-45,0,302,1,6
51491,1,2616,2403,213,0,290,1,6
51492,2,2507,2467,40,0,112,0,6
51493,2,2362,2408,-46,0,113,0,6
51494,1,2540,2453,87,0,344,1,6
51495,1,2552,2413,139,0,335,0,6
51496,1,2223,2401,-178,4,113,0,13
51497,1,2463,2404,59,0,4,1,6
51498,1,2591,2463,128,0,4,0,6
51499,1,2633,2634,-1,0,22,0,6
51500,1,2594,2518,76,0,335,0,6
51501,1,2310,2412,-102,0,46,0,6
51502,2,2442,2477,-35,0,110,1,6
51503,2,2307,2462,-155,0,322,0,6
51504,3,2548,2487,61,0,280,0,6
51505,3,2351,2466,-115,0,130,0,6
51506,2,2545,2532,13,0,40,0,6
51507,1,2398,2549,-151,0,256,0,6
51508,1,2465,2340,125,0,5,0,6
51509,1,2402,2387,15,0,202,0,6
51510,1,2404,2308,96,0,9,0,6
51511,1,2536,2462,74,0,490,1,6
51512,1,2403,2428,-25,0,10,0,6
51513,1,2442,2478,-36,0,224,0,6
51514,1,2481,2437,44,0,190,0,6
51515,1,2701,2657,44,0,218,1,6
51516,2,2399,2428,-29,0,341,1,6
51517,1,2389,2422,-33,0,66,0,6
51518,2,2225,2402,-177,0,110,1,6
51519,1,2496,2491,5,0,7,1,6
51520,1,2445,2337,108,0,484,1,6
51521,2,2283,2413,-130,0,317,0,6
51522,3,2404,2282,122,0,140,0,8
51523,2,2393,2639,-246,0,106,1,6
51524,1,2594,2501,93,0,373,0,6
51525,1,2432,2486,-54,0,219,1,6
51526,1,2483,2391,92,0,250,0,6
51527,3,2453,2282,171,0,45,0,6
51528,2,2315,2411,-96,0,200,1,6
51529,3,2505,2671,-166,0,395,0,6
51530,2,2422,2413,9,0,90,0,6
51531,3,2514,2510,4,0,270,0,6
51532,2,2460,2335,125,0,40,0,6
51533,1,2411,2361,50,0,115,0,6
51534,1,2410,2556,-146,0,46,0,6
51535,3,2540,2406,134,0,13,0,6
51536,2,2289,2586,-297,0,374,0,6
51537,2,2574,2584,-10,0,176,0,6
51538,2,2501,2462,39,0,300,0,6
51539,1,2489,2389,100,0,253,0,6
51540,2,2273,2447,-174,0,128,0,6
51541,1,2484,2277,207,0,150,0,6
51542,2,2628,2263,365,0,398,1,6
51543,1,2417,2371,46,0,46,0,6
51544,2,2249,2408,-159,0,40,0,6
51545,1,2577,2545,32,0,400,0,6
51546,2,2402,2426,-24,0,337,0,6
51547,2,2566,2534,32,0,107,0,6
51548,1,2448,2446,2,0,302,0,6
51549,1,2496,2599,-103,0,112,1,6
51550,1,2345,2433,-88,0,48,0,6
51551,1,2400,2259,141,0,250,1,6
51552,1,2428,2281,147,0,131,0,6
51553,3,2422,2396,26,0,267,0,6
51554,2,2538,2609,-71,0,380,0,6
51555,2,2374,2444,-70,0,245,0,6
51557,2,2641,2349,292,0,1,0,6
51558,1,2343,2452,-109,0,1,0,6
51559,1,2489,2547,-58,0,280,0,6
51560,2,2293,2437,-144,0,300,0,6
51561,2,2467,2487,-20,0,337,0,6
51562,1,2487,2367,120,0,147,0,6
51563,1,2373,2457,-84,0,33,0,6
51564,1,2548,2512,36,0,50,0,6
51565,3,2402,2445,-43,0,80,0,6
51566,1,2431,2397,34,0,315,0,6
51567,2,2269,2419,-150,0,405,1,6
51568,3,2390,2400,-10,0,331,0,6
51569,3,2508,2539,-31,0,436,0,6
51570,2,2378,2484,-106,0,455,0,6
51571,2,2433,2393,40,0,45,0,6
51572,2,2468,2495,-27,0,101,0,6
51573,1,2416,2339,77,0,84,0,6
51574,1,2405,2312,93,0,46,0,6
51575,3,2589,2568,21,0,228,0,6
51576,1,2471,2416,55,0,306,0,6
51577,1,2540,2541,-1,0,241,0,6
51578,1,2444,2451,-7,0,128,0,6
51579,2,2356,2589,-233,0,45,1,6
51580,2,2502,2582,-80,0,7,0,6
51581,1,2455,2486,-31,0,11,0,6
51582,1,2510,2514,-4,0,335,1,6
51583,2,2404,2403,1,0,106,0,6
51584,2,2408,2538,-130,0,106,0,6
51585,1,2416,2356,60,0,373,1,6
51586,2,2611,2606,5,0,123,1,6
51587,1,2464,2324,140,0,108,0,6
51588,1,2479,2438,41,0,245,0,6
51589,1,2384,2412,-28,0,300,1,6
51590,1,2304,2458,-154,0,461,0,6
51591,3,2541,2619,-78,0,490,0,6
51592,2,2402,2441,-39,0,246,0,6
51593,2,2392,2437,-45,0,337,0,6
51594,1,2448,2508,-60,0,215,0,6
51595,1,2606,2454,152,0,300,1,6
51596,3,2420,2343,77,0,485,0,6
51597,1,2493,2353,140,0,246,0,6
51598,1,2409,2369,40,0,130,0,6
51599,1,2366,2632,-266,0,106,0,6
51600,2,2363,2450,-87,0,7,0,6
51601,1,2540,2502,38,0,280,0,6
51602,3,2594,2359,235,0,45,0,6
51603,2,2415,2591,-176,0,115,0,6
51604,2,2504,2334,170,0,132,0,6
51605,1,2413,2313,100,0,0,0,6
51606,2,2410,2385,25,0,385,0,6
51607,2,2303,2402,-99,0,302,0,8
51608,2,2493,2452,41,0,80,1,6
51609,1,2572,2571,1,0,301,0,6
51610,2,2361,2445,-84,0,11,0,6
51611,2,2350,2497,-147,0,1,1,6
51612,1,2614,2659,-45,0,107,1,6
51613,1,2586,2587,-1,0,113,0,6
51614,1,2500,2463,37,0,300,0,6
51615,2,2317,2410,-93,0,15,0,6
51616,2,2389,2468,-79,0,277,1,6
51618,1,2440,2350,90,0,127,0,6
51619,2,2508,2504,4,0,310,0,6
51620,2,2342,2496,-154,0,308,1,6
51621,1,2464,2304,160,0,47,1,6
51622,3,2281,2618,-337,0,315,0,6
51623,1,2542,2405,137,0,265,0,6
51624,1,2428,2436,-8,0,48,1,6
51625,3,2426,2395,31,0,117,0,6
51626,2,2400,2335,65,0,150,1,8
51627,3,2379,2423,-44,0,127,0,6
51628,1,2413,2308,105,0,258,0,6
51629,1,2538,2364,174,0,404,0,6
51630,1,2401,2329,72,0,50,0,6
51631,1,2496,2203,293,0,107,0,6
51632,2,2206,2510,-304,0,38,1,6
51633,2,2234,2567,-333,0,4,1,6
51634,1,2520,2219,301,0,302,1,6
51635,1,2500,2358,142,0,466,0,8
51636,3,2492,2545,-53,0,280,0,6
51637,3,2451,2417,34,0,400,0,6
51638,1,2412,2351,61,0,150,0,6
51639,2,2566,2489,77,0,101,1,6
51640,3,2404,2357,47,4,101,0,13
51641,1,2455,2626,-171,4,307,0,10
51642,2,2433,2451,-18,4,194,0,10
51643,1,2429,2302,127,0,485,0,6
51644,2,2479,2589,-110,0,150,0,6
51645,2,2418,2384,34,0,107,0,6
51646,2,2508,2516,-8,0,267,0,6
51647,2,2413,2489,-76,0,45,1,5
51648,2,2461,2545,-84,0,195,1,6
51649,1,2450,2284,166,0,100,0,6
51650,2,2314,2563,-249,0,123,0,8
51651,1,2405,2411,-6,0,312,1,6
51652,1,2365,2447,-82,0,211,1,6
51653,2,2391,2404,-13,0,201,0,6
51654,2,2423,2420,3,0,112,0,6
51655,2,2433,2484,-51,0,56,0,6
51656,2,2308,2417,-109,0,200,0,6
51657,2,2397,2422,-25,0,337,0,6
51658,1,2566,2578,-12,0,67,1,6
51659,2,2448,2445,3,0,325,0,6
51660,2,2593,2535,58,0,241,1,6
51661,2,2475,2594,-119,0,113,0,6
51662,2,2373,2414,-41,0,424,1,6
51663,2,2439,2451,-12,0,202,0,6
51664,1,2612,2614,-2,0,295,0,6
51665,3,2432,2283,149,0,123,0,6
51666,1,2513,2503,10,0,46,0,6
51667,1,2582,2598,-16,0,11,1,6
51668,2,2400,2560,-160,0,478,0,6
51669,1,2502,2200,302,0,106,1,5
51670,1,2474,2542,-68,0,436,0,6
51671,2,2449,2361,88,0,46,0,6
51672,1,2301,2407,-106,0,40,1,8
51673,1,2499,2339,160,0,132,0,6
51674,3,2426,2367,59,0,403,0,6
51675,2,2417,2347,70,0,127,0,6
51676,1,2451,2339,112,0,4,0,6
51677,2,2458,2621,-163,0,380,1,6
51678,1,2385,2458,-73,0,277,0,6
51679,1,2489,2428,61,0,132,1,6
51680,1,2472,2324,148,0,314,1,6
51681,1,2302,2417,-115,0,470,0,6
51682,2,2652,2470,182,0,27,0,6
51683,2,2275,2406,-131,0,200,1,6
51684,1,2336,2502,-166,0,2,0,6
51685,1,2479,2227,252,0,143,0,5
51686,3,2409,2239,170,4,305,0,18
51687,1,2522,2503,19,0,140,0,6
51688,1,2507,2552,-45,0,212,1,6
51689,1,2422,2258,164,0,13,0,6
51690,3,2544,2494,50,0,280,0,6
51691,3,2423,2302,121,4,152,0,13
51692,2,2264,2442,-178,0,154,0,6
51693,1,2501,2419,82,0,65,0,6
51694,2,2614,2290,324,0,338,0,6
51695,1,2543,2579,-36,0,106,0,6
51696,1,2496,2559,-63,0,101,0,6
51697,1,2216,2422,-206,4,394,0,10
51698,1,2465,2338,127,4,485,0,10
51699,1,2473,2497,-24,0,3,0,6
51700,1,2362,2449,-87,0,46,1,6
51701,3,2411,2409,2,0,8,0,6
51702,3,2380,2427,-47,0,216,0,6
51703,2,2411,2533,-122,0,107,1,6
51704,1,2542,2455,87,0,490,0,6
51705,2,2550,2426,124,0,42,0,6
51706,1,2453,2382,71,0,260,0,6
51707,1,2440,2372,68,0,410,0,6
51708,1,2565,2218,347,0,118,0,8
51709,2,2421,2304,117,0,0,0,6
51710,2,2281,2467,-186,0,311,0,6
51711,2,2572,2572,0,0,211,0,6
51712,1,2585,2457,128,0,330,0,6
51713,1,2435,2278,157,0,85,0,6
51714,2,2601,2618,-17,0,107,0,6
51715,1,2388,2402,-14,0,453,1,6
51716,2,2451,2442,9,0,111,0,6
51717,1,2415,2316,99,0,21,1,6
51718,2,2418,2299,119,0,140,0,6
51719,3,2457,2518,-61,0,107,0,6
51720,2,2392,2568,-176,0,277,0,6
51721,1,2456,2476,-20,0,302,1,6
51722,1,2604,2360,244,0,207,0,6
51723,1,2419,2368,51,0,394,0,6
51724,2,2491,2430,61,0,306,0,6
51725,3,2586,2426,160,0,121,0,6
51726,1,2494,2344,150,0,132,1,6
51727,1,2434,2401,33,0,14,1,6
51728,1,2502,2535,-33,0,46,1,6
51729,1,2592,2644,-52,0,4,0,6
51730,1,2485,2348,137,0,405,0,6
51731,1,2464,2426,38,0,224,0,6
51732,1,2624,2588,36,0,111,0,6
51733,2,2495,2543,-48,0,282,0,6
51734,1,2424,2289,135,0,311,0,6
51735,2,2368,2442,-74,0,249,0,6
51736,2,2455,2476,-21,0,277,0,6
51737,3,2410,2330,80,0,115,0,6
51738,1,2542,2410,132,0,108,0,6
51739,1,2405,2275,130,4,175,0,10
51740,1,2458,2425,33,0,106,0,6
51741,1,2442,2336,106,4,113,1,13
51742,1,2497,2527,-30,0,267,0,6
51744,1,2503,2277,226,0,253,0,5
51745,1,2552,2503,49,0,101,0,6
51746,1,2578,2566,12,0,67,1,6
51747,2,2424,2494,-70,0,46,0,6
51748,1,2445,2261,184,0,330,0,6
51749,1,2583,2511,72,0,11,0,6
51750,2,2256,2498,-242,0,106,0,6
51751,2,2284,2521,-237,0,115,1,6
51752,1,2569,2237,332,0,118,0,6
51753,1,2629,2623,6,0,190,1,6
51755,1,2384,2426,-42,0,335,0,6
51756,2,2275,2411,-136,0,45,0,6
51757,3,2561,2623,-62,0,102,0,6
51758,1,2424,2381,43,0,49,0,6
51759,2,2404,2522,-118,4,373,0,10
51760,2,2542,2573,-31,0,40,1,6
51761,2,2310,2504,-194,0,301,0,6
51762,1,2377,2457,-80,0,474,0,6
51763,2,2328,2408,-80,0,5,1,6
51764,1,2448,2445,3,0,201,0,6
51765,1,2332,2407,-75,0,128,0,6
51766,2,2403,2369,34,0,344,1,6
51767,1,2446,2484,-38,0,200,0,6
51768,3,2470,2397,73,0,343,0,6
51769,2,2307,2407,-100,0,4,0,6
51770,1,2567,2405,162,0,101,0,8
51771,1,2451,2447,4,0,225,1,6
51772,1,2278,2456,-178,0,385,0,6
51773,2,2364,2455,-91,0,42,0,6
51774,2,2344,2506,-162,0,49,0,5
51775,1,2385,2400,-15,0,50,0,6
51776,2,2446,2517,-71,0,40,0,6
51777,3,2587,2458,129,0,345,0,6
51778,2,2450,2348,102,0,194,1,6
51779,1,2391,2410,-19,4,423,0,13
51780,1,2470,2462,8,0,310,0,6
51781,2,2281,2403,-122,0,132,1,6
51782,1,2637,2506,131,0,101,0,6
51783,2,2420,2546,-126,0,46,0,6
51784,3,2449,2463,-14,0,101,0,6
51785,2,2482,2293,189,0,241,0,5
51786,2,2387,2429,-42,0,211,0,6
51787,2,2448,2406,42,0,470,0,6
51788,2,2547,2506,41,0,310,1,6
51789,2,2265,2415,-150,0,204,1,6
51790,2,2259,2427,-168,0,380,0,6
51791,2,2529,2599,-70,0,326,0,6
51792,2,2416,2333,83,0,404,0,6
51793,2,2537,2550,-13,0,14,0,6
51794,1,2415,2255,160,0,344,0,6
51795,2,2344,2491,-147,0,128,0,6
51796,1,2406,2234,172,0,244,0,8
51797,1,2428,2584,-156,0,177,0,6
51798,1,2440,2374,66,0,369,0,6
51799,2,2396,2425,-29,0,102,0,6
51800,2,2369,2607,-238,0,49,0,6
51801,2,2498,2557,-59,0,112,0,6
51802,1,2555,2561,-6,0,108,1,6
51803,2,2394,2401,-7,0,145,0,6
51804,1,2499,2419,80,0,102,0,6
51805,2,2421,2563,-142,0,122,0,6
51806,2,2304,2422,-118,0,113,1,6
51807,2,2363,2531,-168,0,337,1,6
51808,2,2449,2297,152,0,127,1,6
51809,2,2388,2546,-158,0,302,0,6
51810,2,2431,2263,168,0,394,0,6
51811,3,2399,2469,-70,0,210,0,6
51812,1,2635,2481,154,0,111,0,6
51813,3,2609,2307,302,0,300,0,6
51814,2,2409,2305,104,0,255,0,8
51815,3,2578,2536,42,0,331,0,6
51816,2,2443,2368,75,0,410,1,6
51817,2,2420,2384,36,0,113,0,6
51818,2,2390,2448,-58,0,31,0,6
51819,1,2551,2399,152,4,398,1,10
51820,2,2501,2506,-5,0,152,1,6
51821,2,2413,2384,29,0,48,1,6
51822,2,2503,2524,-21,0,46,0,6
51823,3,2452,2302,150,0,58,0,6
51824,1,2496,2341,155,0,409,0,6
51825,1,2480,2449,31,0,2,0,6
51826,2,2447,2398,49,0,456,1,6
51827,3,2341,2463,-122,0,440,0,6
51828,2,2460,2585,-125,0,113,0,6
51829,2,2455,2441,14,0,45,0,6
51830,1,2434,2522,-88,0,57,1,6
51831,1,2576,2442,134,0,101,0,6
51832,1,2509,2278,231,0,253,0,5
51833,1,2633,2476,157,0,344,1,6
51834,1,2469,2274,195,2,260,0,25
51835,2,2224,2570,-346,0,43,0,8
51836,2,2406,2377,29,0,122,0,6
51837,1,2622,2367,255,0,11,0,6
51838,2,2305,2409,-104,0,115,1,6
51839,2,2382,2595,-213,4,4,0,10
51840,1,2447,2457,-10,0,314,0,6
51841,3,2478,2206,272,0,289,0,6
51842,2,2292,2413,-121,0,249,1,6
51843,2,2449,2638,-189,0,45,1,6
51844,2,2400,2356,44,0,346,0,6
51845,2,2468,2359,109,0,150,1,6
51846,2,2451,2427,24,0,301,0,6
51847,2,2439,2331,108,0,130,0,6
51848,1,2537,2578,-41,0,40,0,6
51849,1,2606,2477,129,0,373,0,6
51850,1,2406,2445,-39,0,42,0,6
51851,2,2241,2402,-161,4,124,0,10
51852,2,2404,2397,7,4,115,0,13
51853,2,2292,2524,-232,0,45,0,6
51854,2,2459,2308,151,0,87,0,6
51855,3,2408,2278,130,0,457,0,6
51856,2,2420,2487,-67,0,131,0,6
51857,2,2375,2436,-61,0,300,0,6
51858,1,2261,2454,-193,0,4,0,8
51859,1,2413,2442,-29,0,45,0,6
51860,1,2398,2418,-20,0,67,0,6
51861,2,2271,2424,-153,0,454,0,6
51862,1,2500,2368,132,0,124,1,6
51863,3,2524,2570,-46,0,46,0,6
51864,1,2338,2432,-94,0,147,1,6
51865,1,2355,2443,-88,0,426,0,6
51866,2,2305,2441,-136,0,80,1,6
51867,3,2438,2580,-142,0,48,0,6
51868,1,2422,2366,56,0,40,0,6
51869,2,2450,2534,-84,0,354,0,6
51870,1,2474,2307,167,0,241,0,5
51871,2,2505,2510,-5,0,300,0,6
51872,2,2319,2426,-107,0,112,0,6
51873,2,2433,2445,-12,0,112,1,6
51874,2,2404,2360,44,0,193,1,6
51875,1,2321,2475,-154,0,110,0,6
51876,1,2453,2290,163,0,119,1,6
51877,1,2589,2456,133,0,320,0,6
51878,2,2210,2476,-266,0,250,0,6
51879,2,2526,2495,31,0,43,0,6
51880,1,2511,2450,61,0,267,0,6
51881,1,2534,2497,37,0,7,0,6
51882,1,2564,2270,294,0,408,0,8
51883,1,2399,2453,-54,4,152,1,10
51884,2,2401,2397,4,0,386,1,6
51885,1,2515,2353,162,0,331,0,6
51886,2,2421,2436,-15,0,408,0,6
51887,2,2294,2407,-113,0,3,0,6
51888,1,2451,2453,-2,0,49,0,6
51889,3,2574,2395,179,4,460,0,10
51890,2,2484,2509,-25,0,48,1,6
51891,2,2450,2540,-90,0,115,0,6
51892,2,2706,2636,70,0,162,0,6
51893,1,2488,2337,151,4,152,1,13
51894,1,2474,2473,1,0,304,1,6
51895,1,2405,2251,154,4,48,0,10
51896,2,2248,2559,-311,4,374,0,10
51897,1,2433,2441,-8,0,153,0,6
51898,1,2571,2555,16,0,466,1,6
51899,2,2524,2445,79,0,36,0,6
51900,3,2319,2415,-96,0,302,0,6
51901,2,2467,2365,102,0,453,0,6
51902,1,2592,2296,296,4,8,0,8
51903,1,2287,2413,-126,0,115,0,6
51904,2,2220,2605,-385,0,21,0,6
51905,2,2412,2322,90,0,311,0,6
51906,1,2414,2428,-14,0,0,0,6
51907,1,2363,2512,-149,0,485,0,5
51908,1,2641,2561,80,0,245,0,6
51909,1,2361,2427,-66,0,388,0,6
51910,2,2444,2438,6,0,42,1,6
51911,1,2263,2448,-185,0,301,1,6
51912,3,2332,2413,-81,0,122,0,6
51913,1,2407,2401,6,0,45,0,6
51914,2,2454,2313,141,0,121,0,6
51915,1,2567,2405,162,0,107,0,6
51916,1,2441,2378,63,0,45,0,6
51917,2,2420,2444,-24,0,300,0,6
51918,3,2569,2366,203,4,84,0,10
51919,2,2330,2571,-241,0,43,0,8
51920,1,2518,2389,129,0,43,0,6
51921,1,2355,2504,-149,0,245,0,5
51922,1,2350,2451,-101,0,2,0,6
51923,2,2577,2440,137,0,101,0,6
51924,1,2298,2442,-144,0,46,0,6
51925,1,2425,2346,79,0,228,0,6
51926,2,2337,2402,-65,4,225,1,13
51927,1,2444,2301,143,0,130,0,6
51928,2,2513,2257,256,4,338,0,13
51929,1,2578,2391,187,0,112,0,8
51930,3,2387,2436,-49,0,150,0,6
51931,2,2538,2646,-108,0,157,0,6
51932,2,2385,2451,-66,0,323,0,6
51933,3,2236,2403,-167,0,101,0,8
51934,1,2452,2593,-141,0,119,0,6
51935,1,2297,2461,-164,0,202,0,6
51936,1,2402,2331,71,4,463,0,13
51937,1,2442,2457,-15,0,115,0,6
51938,1,2368,2554,-186,4,113,0,10
51939,2,2402,2285,117,0,118,0,8
51940,2,2501,2539,-38,0,107,0,6
51941,1,2411,2215,196,4,141,0,10
51942,2,2447,2457,-10,0,314,0,6
51943,2,2482,2566,-84,0,141,0,8
51944,1,2467,2445,22,0,470,0,6
51945,1,2444,2308,136,0,30,0,6
51946,1,2395,2414,-19,0,46,1,6
51947,1,2450,2357,93,0,331,0,6
51948,1,2643,2555,88,0,311,0,6
51949,2,2373,2460,-87,0,4,1,6
51950,1,2517,2479,38,0,11,1,6
51951,1,2413,2236,177,0,381,0,6
51952,1,2699,2611,88,0,111,0,6
51953,1,2520,2226,294,0,210,0,6
51954,2,2280,2405,-125,0,132,0,6
51955,2,2496,2282,214,0,200,0,5
51956,3,2315,2606,-291,0,70,0,6
51957,2,2331,2411,-80,0,464,0,6
51959,1,2532,2221,311,0,247,1,6
51960,1,2420,2420,0,0,0,0,6
51961,1,2402,2390,12,0,110,0,6
51962,1,2440,2434,6,0,190,1,6
51963,1,2511,2227,284,0,110,0,6
51964,3,2452,2522,-70,0,57,0,6
51965,1,2411,2356,55,0,101,0,6
51966,2,2417,2591,-174,4,80,0,10
51967,2,2462,2442,20,0,49,1,6
51968,1,2418,2271,147,0,100,0,6
51969,3,2545,2481,64,0,406,0,6
51970,2,2385,2444,-59,0,127,0,6
51971,1,2414,2395,19,0,457,1,6
51972,1,2435,2438,-3,0,270,0,6
51973,2,2550,2549,1,0,211,0,6
51974,1,2602,2356,246,0,45,0,6
51975,2,2405,2373,32,0,40,0,6
51976,1,2570,2585,-15,0,111,0,6
51977,3,2513,2525,-12,0,300,0,6
51978,2,2295,2504,-209,0,106,0,6
51979,1,2427,2470,-43,0,128,1,6
51980,3,2532,2448,84,0,152,0,6
51981,2,2440,2472,-32,0,227,1,6
51982,1,2405,2363,42,4,101,0,13
51983,2,2259,2417,-158,4,400,0,10
51984,2,2658,2671,-13,0,50,1,6
51985,2,2353,2455,-102,0,3,0,6
51986,2,2413,2276,137,0,55,1,6
51987,1,2430,2323,107,0,48,0,6
51988,2,2303,2447,-144,0,1,0,6
51989,1,2457,2460,-3,0,415,0,6
51990,1,2444,2342,102,0,9,1,6
51991,3,2544,2412,132,0,0,0,6
51992,2,2430,2342,88,0,45,0,8
51993,2,2625,2563,62,0,13,0,6
51994,2,2529,2496,33,0,144,0,6
51995,1,2334,2402,-68,0,315,1,6
51996,1,2311,2405,-94,4,211,0,10
51997,2,2351,2410,-59,0,300,1,6
51998,3,2422,2266,156,4,277,0,13
51999,1,2515,2416,99,0,344,1,6
52000,2,2402,2439,-37,0,483,1,6
52001,2,2395,2426,-31,0,200,0,6
52002,1,2478,2247,231,0,144,0,5
52003,2,2513,2675,-162,0,113,0,6
52004,1,2333,2434,-101,0,110,1,6
52005,1,2495,2228,267,0,40,0,8
52006,1,2415,2416,-1,0,215,0,6
52007,1,2435,2388,47,0,200,1,6
52008,1,2464,2369,95,0,453,1,6
52009,2,2375,2619,-244,0,240,0,6
52010,1,2647,2703,-56,0,313,0,6
52011,1,2382,2408,-26,0,201,0,6
52012,2,2452,2521,-69,0,4,0,6
52013,3,2306,2445,-139,0,301,0,6
52014,1,2361,2408,-47,0,469,0,6
52015,2,2385,2428,-43,0,46,0,6
52016,2,2401,2345,56,0,5,0,6
52017,2,2359,2401,-42,0,112,0,6
52018,2,2515,2522,-7,0,460,1,6
52019,3,2328,2581,-253,0,48,0,8
52020,2,2268,2434,-166,0,45,0,6
52021,1,2448,2423,25,0,337,1,6
52022,1,2452,2622,-170,0,253,0,6
52023,1,2401,2316,85,0,49,0,6
52024,2,2362,2407,-45,4,0,0,10
52025,1,2604,2342,262,4,455,0,10
52026,2,2459,2349,110,0,4,0,6
52027,2,2449,2380,69,0,458,0,6
52028,2,2535,2605,-70,0,112,0,6
52029,2,2341,2405,-64,0,40,0,6
52030,1,2579,2453,126,0,405,1,6
52031,1,2404,2398,6,4,335,0,13
52032,2,2409,2276,133,0,455,0,6
52033,1,2521,2503,18,0,381,0,6
52034,1,2421,2368,53,0,258,0,6
52035,3,2424,2576,-152,0,126,0,6
52036,1,2434,2411,23,0,133,0,6
52037,1,2320,2481,-161,0,455,0,5
52038,2,2382,2423,-41,4,5,0,10
52039,2,2453,2320,133,0,190,0,3
52040,1,2555,2544,11,0,109,0,6
52041,1,2622,2373,249,0,48,0,6
52042,1,2339,2413,-74,0,115,1,6
52043,1,2449,2531,-82,0,288,0,6
52044,2,2515,2403,112,4,84,1,10
52045,1,2570,2368,202,0,225,1,6
52046,1,2455,2463,-8,0,201,0,6
52047,1,2482,2544,-62,0,343,0,6
52048,2,2201,2595,-394,4,253,0,13
52049,1,2599,2499,100,0,307,0,6
52050,2,2432,2434,-2,0,190,1,6
52051,2,2401,2440,-39,0,300,0,6
52052,3,2388,2407,-19,0,45,0,6
52053,1,2270,2432,-162,0,241,0,6
52054,1,2444,2299,145,4,40,0,10
52055,3,2510,2491,19,4,45,0,13
52056,2,2414,2469,-55,0,117,1,6
52057,2,2444,2491,-47,0,106,0,6
52058,2,2605,2219,386,0,125,0,6
52059,1,2354,2448,-94,0,245,1,6
52060,3,2412,2345,67,0,102,0,6
52061,2,2405,2514,-109,0,428,0,6
52062,1,2340,2452,-112,4,122,0,10
52064,2,2410,2341,69,0,455,0,6
52065,1,2402,2510,-108,0,211,0,6
52066,3,2525,2528,-3,0,47,0,6
52067,1,2401,2265,136,0,100,0,6
52068,2,2497,2526,-29,0,267,0,6
52069,1,2384,2447,-63,0,130,0,6
52070,2,2390,2601,-211,0,154,0,8
52071,3,2424,2619,-195,4,152,0,10
52072,2,2447,2654,-207,0,121,0,6
52073,2,2406,2368,38,0,304,1,6
52074,1,2495,2603,-108,0,45,0,6
52075,2,2358,2488,-130,0,245,0,5
52076,1,2433,2443,-10,0,395,1,6
52077,2,2357,2451,-94,0,3,0,6
52078,2,2387,2442,-55,0,127,1,6
52079,1,2287,2401,-114,0,300,1,6
52080,2,2481,2330,151,0,339,0,6
52081,1,2573,2426,147,0,215,0,6
52082,2,2306,2440,-134,0,491,1,6
52083,2,2359,2411,-52,4,302,0,13
52084,1,2453,2283,170,0,302,0,6
52085,1,2405,2355,50,0,414,0,6
52086,2,2596,2503,93,0,101,1,6
52087,1,2440,2291,149,4,46,0,10
52088,1,2519,2583,-64,0,13,0,6
52089,2,2461,2444,17,0,111,1,6
52090,1,2571,2267,304,0,327,0,8
52091,1,2255,2403,-148,0,110,0,6
52092,2,2509,2510,-1,0,112,0,6
52093,1,2351,2426,-75,0,453,0,6
52094,1,2538,2503,35,0,211,0,6
52095,1,2415,2411,4,0,128,0,6
52096,2,2477,2450,27,0,150,1,6
52097,1,2406,2371,35,0,46,0,6
52098,3,2438,2373,65,0,288,0,8
52099,2,2229,2417,-188,4,260,0,13
52100,1,2473,2461,12,0,311,0,6
52101,2,2455,2323,132,0,301,0,6
52102,1,2381,2524,-143,0,1,0,6
52103,2,2395,2613,-218,0,4,0,6
52104,1,2449,2339,110,2,254,0,25
52105,2,2451,2459,-8,0,4,0,6
52106,1,2419,2426,-7,0,251,0,6
52107,2,2440,2496,-56,0,190,1,6
52108,2,2330,2473,-143,0,466,0,6
52109,2,2301,2481,-180,4,110,0,10
52110,2,2422,2242,180,4,127,0,10
52111,3,2603,2360,243,0,304,0,8
52112,1,2284,2401,-117,0,194,1,6
52113,1,2473,2409,64,0,487,1,6
52114,2,2657,2697,-40,0,404,0,6
52115,1,2532,2492,40,0,167,0,6
52116,2,2355,2412,-57,0,110,0,6
52117,2,2423,2577,-154,0,207,0,6
52118,3,2260,2574,-314,0,34,0,8
52119,2,2246,2409,-163,4,115,0,13
52120,3,2402,2401,1,4,247,0,10
52121,3,2609,2282,327,4,37,0,10
52122,1,2429,2209,220,4,141,0,10
52123,1,2537,2489,48,0,406,0,6
52124,3,2318,2473,-155,0,245,0,5
52125,1,2544,2533,11,0,40,0,6
52126,2,2525,2510,15,0,302,1,6
52127,2,2437,2261,176,0,100,1,6
52128,2,2222,2513,-291,0,40,1,6
52129,2,2506,2570,-64,0,110,1,6
52130,2,2524,2293,231,0,20,1,6
52131,2,2427,2448,-21,0,0,1,6
52132,1,2401,2229,172,0,15,0,8
52133,2,2352,2528,-176,0,2,0,6
52134,1,2456,2591,-135,0,382,0,6
52135,1,2447,2382,65,0,215,0,6
52136,1,2406,2374,32,0,17,1,6
52137,1,2576,2551,25,0,345,0,6
52138,2,2455,2479,-24,0,117,0,6
52139,1,2443,2420,23,0,20,1,6
52140,1,2516,2501,15,0,6,0,6
52141,1,2702,2652,50,0,267,1,6
52142,2,2366,2411,-45,0,15,0,6
52143,2,2580,2444,136,0,28,1,6
52144,1,2445,2308,137,0,31,0,6
52145,2,2378,2452,-74,0,4,1,6
52147,1,2458,2313,145,0,45,0,6
52148,2,2498,2395,103,0,114,0,6
52149,2,2349,2446,-97,0,245,0,6
52150,3,2398,2402,-4,4,80,0,10
52151,1,2401,2451,-50,4,250,0,10
52152,1,2418,2264,154,0,250,0,6
52153,1,2424,2573,-149,0,140,0,6
52154,1,2589,2581,8,0,440,0,6
52155,2,2319,2594,-275,0,484,0,6
52156,2,2437,2362,75,0,134,0,6
52157,2,2527,2549,-22,0,331,0,6
52158,2,2544,2534,10,0,109,0,6
52159,1,2474,2331,143,0,106,0,6
52160,1,2473,2464,9,0,394,1,6
52161,3,2379,2455,-76,0,40,0,6
52162,2,2535,2402,133,0,4,1,6
52163,1,2350,2410,-60,0,211,0,6
52164,1,2330,2493,-163,0,459,0,5
52165,1,2516,2454,62,0,136,0,6
52166,2,2495,2432,63,4,460,0,10
52167,3,2410,2433,-23,4,152,0,10
52168,1,2580,2419,161,0,215,0,6
52169,1,2444,2302,142,0,36,0,6
52170,1,2400,2266,134,0,108,0,6
52171,2,2417,2203,214,4,110,0,13
52172,2,2340,2425,-85,0,123,1,6
52173,1,2520,2553,-33,0,211,0,6
52174,3,2300,2402,-102,4,85,0,10
52175,1,2600,2287,313,0,2,0,8
52176,2,2400,2420,-20,0,344,0,6
52177,2,2354,2567,-213,0,301,0,8
52178,1,2328,2478,-150,0,38,1,6
52179,2,2555,2522,33,0,40,0,6
52180,2,2573,2579,-6,0,193,1,6
52181,1,2349,2478,-129,0,3,0,6
52182,1,2596,2608,-12,0,106,0,6
52183,3,2356,2595,-239,4,122,0,10
52184,2,2435,2499,-64,0,112,0,6
52185,2,2207,2475,-268,4,2,0,13
52186,2,2414,2308,106,0,31,1,6
52187,2,2523,2639,-116,0,45,0,6
52188,2,2380,2411,-31,0,343,1,6
52189,1,2487,2526,-39,0,105,1,6
52190,1,2404,2456,-52,0,125,0,6
52191,3,2417,2449,-32,0,136,0,6
52192,1,2484,2456,28,0,374,0,6
52193,2,2547,2679,-132,0,151,0,6
52194,1,2256,2428,-172,0,40,0,6
52195,2,2407,2419,-12,4,88,1,13
52196,1,2458,2448,10,0,135,0,6
52197,1,2521,2521,0,0,101,1,6
52198,2,2403,2405,-2,0,462,0,6
52199,1,2415,2450,-35,0,200,0,6
52200,1,2450,2490,-40,0,212,1,6
52201,2,2504,2430,74,0,40,1,6
52202,2,2707,2653,54,0,278,0,6
52203,2,2456,2594,-138,0,4,1,6
52204,1,2430,2313,117,0,192,1,6
52205,2,2576,2538,38,0,16,0,6
52206,2,2281,2442,-161,0,0,0,6
52207,1,2467,2356,111,0,122,0,6
52208,1,2554,2522,32,0,245,1,6
52209,1,2263,2403,-140,0,150,0,6
52210,2,2452,2528,-76,0,202,0,6
52211,1,2570,2254,316,0,137,0,8
52212,2,2403,2357,46,0,123,0,6
52213,1,2470,2528,-58,0,491,0,6
52214,1,2423,2326,97,0,106,0,6
52215,2,2484,2542,-58,0,85,0,6
52216,1,2565,2391,174,0,116,0,6
52217,2,2299,2448,-149,0,491,0,6
52218,2,2403,2478,-75,0,300,0,6
52219,3,2420,2313,107,0,4,0,6
52220,1,2528,2458,70,0,45,0,6
52221,1,2416,2584,-168,0,101,0,6
52222,2,2397,2410,-13,0,405,0,6
52223,2,2408,2258,150,0,300,0,6
52224,2,2411,2448,-37,0,122,0,6
52225,2,2334,2490,-156,0,405,0,6
52226,2,2421,2510,-89,4,131,0,13
52227,1,2451,2357,94,0,40,0,6
52228,1,2352,2429,-77,0,485,0,6
52229,1,2380,2447,-67,0,309,0,6
52230,1,2575,2515,60,0,216,1,6
52231,2,2354,2502,-148,0,106,0,6
52232,1,2516,2470,46,0,123,1,6
52233,1,2274,2405,-131,0,4,0,6
52234,2,2285,2602,-317,0,40,0,8
52235,1,2239,2400,-161,0,306,0,6
52236,1,2422,2359,63,0,258,0,6
52237,1,2426,2421,5,0,103,1,6
52238,1,2455,2438,17,0,151,0,6
52239,1,2536,2585,-49,0,151,1,6
52240,3,2483,2417,66,0,395,0,6
52241,1,2432,2462,-30,0,302,1,6
52242,2,2683,2543,140,0,399,0,6
52243,2,2454,2605,-151,0,242,1,6
52244,1,2584,2519,65,0,255,0,6
52245,2,2339,2406,-67,0,189,0,6
52246,3,2385,2520,-135,0,108,0,6
52247,3,2471,2276,195,0,200,0,5
52248,3,2493,2330,163,0,311,0,6
52249,1,2492,2310,182,4,113,0,13
52250,3,2547,2479,68,0,50,0,6
52251,1,2544,2570,-26,0,301,1,6
52252,1,2437,2497,-60,0,40,1,6
52253,2,2406,2292,114,0,140,1,6
52254,1,2442,2329,113,0,15,0,6
52255,2,2346,2432,-86,0,455,0,6
52256,2,2369,2434,-65,0,2,1,6
52257,2,2533,2448,85,0,300,1,6
52258,2,2309,2419,-110,0,106,1,6
52259,1,2577,2493,84,0,374,0,6
52260,1,2598,2453,145,0,440,0,6
52261,1,2352,2471,-119,0,40,0,6
52262,2,2376,2568,-192,0,140,1,6
52263,1,2421,2369,52,0,46,0,6
52264,3,2419,2371,48,0,375,0,6
52265,1,2575,2425,150,0,215,1,6
52266,1,2521,2456,65,0,343,1,6
52267,1,2406,2247,159,0,200,0,6
52268,1,2533,2636,-103,0,45,1,6
52269,2,2423,2528,-105,0,302,0,6
52270,3,2395,2502,-107,0,405,0,6
52271,2,2454,2450,4,0,333,1,6
52272,1,2346,2429,-83,0,302,0,6
52273,2,2521,2551,-30,0,45,0,6
52274,2,2416,2456,-40,0,386,0,6
52275,2,2525,2353,172,0,330,0,6
52276,1,2427,2367,60,0,112,1,6
52277,2,2385,2451,-66,0,135,0,6
52278,1,2433,2318,115,0,176,0,6
52279,2,2211,2481,-270,0,45,0,5
52280,3,2468,2590,-122,0,201,0,6
52281,1,2572,2272,300,0,136,1,8
52282,2,2374,2441,-67,0,307,0,6
52283,2,2411,2305,106,0,111,0,6
52284,1,2619,2582,37,0,226,0,6
52285,2,2296,2445,-149,0,119,0,6
52286,1,2333,2491,-158,0,406,1,6
52287,2,2410,2369,41,0,207,0,6
52288,1,2455,2454,1,0,382,0,6
52289,1,2485,2476,9,0,43,0,6
52290,1,2521,2538,-17,0,13,0,6
52291,1,2582,2584,-2,0,405,0,6
52292,1,2618,2592,26,0,190,0,6
52293,3,2434,2434,0,0,4,0,6
52294,1,2408,2396,12,0,202,1,6
52295,1,2322,2476,-154,0,153,0,6
52296,2,2416,2403,13,0,131,1,6
52297,1,2418,2432,-14,0,6,0,6
52298,2,2517,2515,2,0,112,0,6
52299,2,2518,2446,72,0,301,0,6
52300,2,2434,2589,-155,0,385,0,6
52301,1,2201,2455,-254,0,228,0,6
52302,3,2556,2434,122,0,410,0,6
52303,1,2464,2360,104,0,416,0,6
52304,2,2397,2482,-85,0,300,0,6
52305,2,2456,2404,52,0,168,1,6
52306,2,2577,2627,-50,0,270,0,6
52307,1,2514,2456,58,0,45,0,6
52308,1,2568,2387,181,0,4,1,6
52309,1,2603,2284,319,0,123,0,8
52310,1,2436,2342,94,0,130,0,6
52311,2,2461,2424,37,0,40,0,6
52312,2,2526,2557,-31,0,43,0,6
52313,1,2439,2393,46,0,211,0,6
52314,1,2564,2551,13,0,16,1,6
52315,1,2271,2450,-179,0,200,0,6
52316,2,2426,2348,78,0,100,0,6
52317,2,2340,2401,-61,0,5,1,6
52318,2,2602,2567,35,0,347,1,6
52319,2,2609,2700,-91,0,404,1,6
52320,3,2379,2450,-71,0,1,0,6
52321,1,2398,2409,-11,0,460,0,6
52322,2,2403,2263,140,0,10,1,6
52323,1,2629,2540,89,0,96,0,6
52324,1,2553,2555,-2,0,110,0,6
52325,1,2305,2461,-156,0,134,0,6
52326,2,2452,2526,-74,0,246,0,6
52327,1,2431,2217,214,0,398,0,6
52328,1,2414,2588,-174,0,247,0,6
52329,3,2556,2589,-33,0,335,0,6
52330,2,2265,2418,-153,0,347,0,6
52331,2,2236,2419,-183,0,310,0,6
52332,2,2361,2516,-155,0,2,0,6
52333,3,2375,2580,-205,0,119,0,6
52334,2,2510,2505,5,0,106,0,6
52335,2,2818,2658,160,0,388,0,6
52336,1,2449,2465,-16,0,46,0,6
52337,2,2636,2572,64,0,225,1,6
52338,2,2376,2403,-27,0,323,1,6
52339,2,2403,2420,-17,0,246,1,6
52340,1,2470,2419,51,0,241,0,6
52341,2,2457,2318,139,0,190,0,6
52342,2,2483,2678,-195,0,80,0,6
52343,3,2367,2542,-175,0,21,0,6
52344,2,2426,2410,16,0,208,1,6
52345,1,2432,2424,8,0,242,0,6
52346,2,2356,2468,-112,0,40,0,6
52347,2,2398,2422,-24,0,0,0,6
52348,3,2532,2527,5,0,0,0,6
52349,2,2577,2595,-18,0,115,0,6
52350,3,2544,2545,-1,0,37,0,6
52351,1,2478,2498,-20,0,43,1,6
52352,1,2422,2445,-23,0,45,0,6
52353,1,2540,2538,2,0,310,0,6
52354,1,2548,2546,2,0,46,0,6
52355,1,2560,2549,11,0,107,0,6
52356,3,2502,2503,-1,0,0,0,6
52357,2,2504,2524,-20,0,241,1,6
52358,1,2450,2463,-13,0,388,0,6
52359,2,2560,2563,-3,0,65,0,6
52360,1,2533,2534,-1,0,205,0,6
52361,3,2632,2618,14,0,280,0,6
52362,1,2483,2511,-28,0,311,1,6
52363,3,2470,2579,-109,0,228,0,6
52364,1,2428,2435,-7,0,107,0,6
52365,1,2534,2528,6,0,152,0,6
52366,1,2484,2453,31,0,248,0,6
52367,1,2464,2411,53,0,211,0,6
52368,2,2341,2532,-191,0,49,0,6
52369,1,2448,2437,11,0,245,0,6
52370,1,2480,2546,-66,0,315,0,6
52371,1,2254,2593,-339,0,388,0,6
52372,1,2483,2321,162,0,140,0,5
52373,1,2600,2245,355,0,122,0,6
52374,2,2569,2546,23,0,0,0,6
52375,1,2450,2521,-71,0,216,0,6
52376,1,2396,2433,-37,0,415,0,6
52377,2,2212,2491,-279,0,190,0,6
52378,1,2409,2329,80,0,40,0,6
52379,1,2456,2439,17,0,247,0,6
52380,2,2400,2313,87,0,151,0,6
52381,1,2520,2358,162,0,331,1,6
52382,2,2379,2444,-65,0,254,0,6
52383,2,2514,2457,57,0,45,0,6
52384,2,2334,2417,-83,0,118,0,6
52385,1,2430,2402,28,0,200,0,6
52386,2,2325,2572,-247,0,106,1,6
52387,2,2536,2633,-97,0,45,0,6
52388,1,2422,2446,-24,0,302,0,6
52389,1,2549,2559,-10,0,44,0,6
52390,2,2601,2389,212,0,109,0,6
52391,2,2545,2505,40,0,62,0,6
52392,2,2522,2338,184,0,102,1,6
52393,2,2502,2544,-42,0,0,0,6
52394,2,2535,2565,-30,0,0,0,6
52395,1,2528,2378,150,0,5,0,6
52396,1,2578,2436,142,0,112,0,6
52397,2,2410,2569,-159,0,106,1,6
52398,1,2361,2423,-62,0,151,0,8
52399,2,2410,2595,-185,0,265,0,6
52400,1,2529,2362,167,0,3,0,6
52401,3,2456,2384,72,0,270,0,6
52402,1,2571,2388,183,0,125,0,6
52403,2,2293,2484,-191,0,25,0,6
52404,2,2315,2426,-111,4,10,1,13
52405,3,2581,2554,27,0,344,0,6
52406,2,2530,2447,83,0,265,0,6
52407,2,2402,2413,-11,4,310,0,13
52408,2,2464,2474,-10,0,245,0,6
52409,1,2531,2231,300,0,17,0,6
52410,2,2345,2554,-209,0,466,0,6
52411,2,2577,2539,38,0,4,0,6
52412,1,2631,2472,159,0,263,0,6
52413,2,2207,2618,-411,0,190,0,6
52414,1,2499,2267,232,0,101,1,6
52415,2,2409,2371,38,0,200,0,6
52416,1,2472,2307,165,0,218,0,6
52417,1,2618,2317,301,0,210,0,6
52418,2,2464,2539,-75,0,43,0,6
52419,2,2282,2605,-323,0,92,0,8
52420,1,2407,2449,-42,0,245,0,6
52421,1,2497,2290,207,0,0,0,6
52422,1,2552,2487,65,0,300,0,6
52423,2,2243,2563,-320,0,140,0,6
52424,3,2511,2539,-28,0,107,0,6
52425,2,2549,2601,-52,0,20,0,6
52427,2,2371,2432,-61,0,48,0,6
52428,1,2587,2402,185,0,440,0,6
52429,2,2268,2400,-132,0,102,0,6
52430,2,2586,2573,13,0,347,0,6
52431,3,2579,2625,-46,0,270,0,6
52432,2,2377,2472,-95,0,100,0,6
52433,3,2255,2421,-166,0,200,0,6
52434,3,2554,2533,21,0,317,0,6
52435,1,2428,2531,-103,0,106,0,6
52436,3,2439,2392,47,0,412,0,6
52437,2,2295,2449,-154,0,57,0,6
52438,1,2705,2619,86,0,268,0,6
52439,2,2378,2527,-149,0,45,0,6
52440,1,2420,2258,162,0,301,0,6
52441,2,2510,2421,89,0,200,0,6
52442,1,2582,2580,2,0,248,0,6
52443,3,2555,2397,158,0,398,0,6
52444,3,2363,2442,-79,0,203,0,6
52445,1,2392,2489,-97,0,113,0,6
52446,2,2505,2398,107,0,49,0,6
52447,1,2406,2326,80,0,7,1,6
52448,1,2427,2397,30,0,152,0,6
52449,1,2392,2429,-37,0,41,0,6
52450,2,2493,2434,59,0,341,0,6
52451,2,2592,2635,-43,0,167,0,6
52452,2,2395,2438,-43,0,150,0,6
52453,1,2440,2420,20,0,10,0,6
52454,2,2418,2434,-16,0,115,0,6
52455,1,2416,2428,-12,0,300,0,6
52456,1,2533,2533,0,0,4,0,6
52457,1,2237,2427,-190,0,242,0,6
52458,2,2335,2421,-86,0,300,0,6
52459,2,2804,2709,95,0,315,1,6
52460,1,2342,2539,-197,0,0,0,6
52461,1,2357,2574,-217,0,4,1,6
52462,1,2571,2238,333,0,112,1,6
52463,1,2545,2374,171,0,457,0,6
52464,2,2502,2340,162,0,454,0,6
52465,2,2545,2540,5,0,107,1,6
52466,1,2326,2410,-84,0,302,0,8
52467,1,2449,2221,228,0,288,1,6
52468,1,2336,2404,-68,0,354,0,6
52469,1,2489,2439,50,0,248,0,6
52470,1,2437,2341,96,0,101,0,6
52471,3,2367,2405,-38,0,303,0,6
52472,1,2571,2364,207,0,123,0,6
52473,1,2468,2334,134,0,0,0,6
52474,2,2497,2381,116,0,49,1,6
52475,2,2564,2360,204,0,0,1,6
52476,2,2242,2530,-288,0,104,0,6
52477,2,2406,2482,-76,0,117,0,6
52478,1,2405,2408,-3,0,187,0,6
52479,2,2440,2264,176,0,43,0,6
52480,2,2464,2507,-43,0,216,1,6
52481,1,2502,2436,66,0,218,0,6
52482,2,2292,2486,-194,0,0,0,6
52483,2,2264,2587,-323,0,115,0,6
52484,2,2441,2524,-83,0,200,0,6
52485,1,2523,2480,43,0,331,0,6
52486,2,2355,2530,-175,0,2,0,6
52487,1,2399,2493,-94,0,415,0,6
52488,2,2590,2272,318,0,365,0,6
52489,1,2544,2439,105,0,110,0,6
52490,2,2638,2532,106,0,40,0,6
52491,1,2521,2571,-50,0,40,0,6
52492,1,2350,2432,-82,0,46,1,6
52493,1,2459,2486,-27,0,255,0,5
52494,2,2428,2503,-75,0,126,0,6
52495,2,2377,2402,-25,0,323,1,6
52496,1,2549,2269,280,0,49,0,6
52497,1,2527,2371,156,0,2,0,6
52498,1,2533,2539,-6,0,40,0,6
52499,2,2439,2438,1,0,133,0,6
52500,2,2413,2523,-110,0,102,0,6
52501,1,2478,2353,125,0,4,1,6
52502,2,2297,2431,-134,0,315,0,6
52503,3,2403,2245,158,0,16,0,8
52504,1,2539,2487,52,0,406,0,6
52505,2,2397,2407,-10,0,335,0,6
52506,1,2512,2342,170,0,211,0,6
52507,2,2489,2557,-68,0,484,1,6
52508,2,2385,2455,-70,0,246,1,6
52509,1,2402,2411,-9,0,181,0,6
52510,1,2454,2523,-69,0,246,0,6
52511,1,2437,2572,-135,0,404,0,6
52512,3,2433,2461,-28,0,241,0,6
52513,1,2514,2303,211,0,113,0,6
52514,3,2530,2544,-14,0,80,0,6
52515,1,2421,2265,156,0,45,0,6
52516,3,2527,2428,99,0,13,0,6
52517,2,2460,2217,243,0,1,0,6
52518,1,2548,2588,-40,0,140,0,6
52519,3,2435,2409,26,0,313,0,6
52520,1,2577,2276,301,0,130,1,6
52521,1,2511,2512,-1,0,110,0,6
52522,1,2406,2407,-1,0,102,1,6
52523,3,2500,2368,132,0,339,0,6
52524,1,2553,2555,-2,0,110,0,6
52525,2,2252,2449,-197,0,110,0,6
52526,1,2414,2533,-119,0,247,0,6
52527,2,2268,2446,-178,0,113,0,6
52528,3,2325,2414,-89,0,310,0,6
52529,1,2423,2494,-71,0,45,0,6
52530,1,2483,2530,-47,0,80,0,6
52531,2,2400,2557,-157,0,331,1,6
52532,1,2557,2503,54,0,44,1,6
52533,1,2525,2406,119,0,45,0,6
52534,2,2399,2486,-87,0,7,0,6
52535,1,2460,2430,30,0,395,0,6
52536,1,2454,2442,12,0,48,1,6
52537,1,2454,2352,102,0,13,0,6
52538,1,2413,2301,112,0,85,0,6
52539,2,2431,2539,-108,0,300,0,6
52540,1,2588,2532,56,0,301,0,6
52541,1,2533,2444,89,0,131,0,6
52542,2,2620,2506,114,0,200,1,6
52543,2,2509,2584,-75,0,132,1,6
52544,3,2476,2372,104,0,263,0,6
52545,1,2501,2573,-72,0,0,1,6
52546,2,2361,2433,-72,0,225,1,6
52547,2,2555,2437,118,0,404,0,6
52548,2,2283,2495,-212,4,108,0,13
52549,2,2252,2466,-214,0,43,0,5
52550,1,2391,2401,-10,0,36,1,6
52551,1,2402,2553,-151,0,46,0,6
52552,2,2416,2483,-67,0,40,0,8
52553,1,2355,2435,-80,0,106,0,6
52554,2,2561,2528,33,0,40,0,6
52555,1,2515,2471,44,0,263,0,6
52556,2,2487,2530,-43,0,43,0,6
52557,2,2321,2459,-138,0,484,0,6
52558,2,2387,2554,-167,0,101,0,6
52559,2,2620,2581,39,0,200,0,6
52560,1,2339,2437,-98,0,426,0,6
52561,2,2580,2539,41,0,67,0,6
52562,1,2307,2423,-116,0,110,0,6
52563,1,2519,2476,43,0,45,1,6
52564,1,2486,2367,119,0,40,0,6
52565,1,2386,2411,-25,0,456,0,6
52566,2,2340,2551,-211,0,58,0,6
52567,2,2267,2517,-250,0,123,1,6
52568,1,2405,2408,-3,0,187,0,6
52569,2,2579,2407,172,0,474,1,6
52570,2,2238,2425,-187,0,31,0,6
52571,2,2537,2555,-18,0,226,0,6
52572,1,2524,2369,155,0,2,0,6
52573,3,2489,2640,-151,0,301,0,6
52574,3,2535,2345,190,0,40,0,6
52575,2,2242,2402,-160,0,290,0,8
52576,2,2716,2792,-76,0,267,0,6
52577,3,2440,2580,-140,0,151,0,6
52578,1,2433,2354,79,0,110,0,6
52579,2,2444,2373,71,0,311,0,6
52580,2,2539,2630,-91,0,46,0,6
52581,1,2353,2540,-187,0,4,0,6
52582,1,2327,2449,-122,0,7,1,6
52583,1,2289,2435,-146,0,61,0,6
52584,3,2425,2306,119,0,373,0,6
52585,1,2394,2443,-49,0,190,0,6
52586,2,2211,2473,-262,4,40,0,13
52587,1,2507,2424,83,0,200,0,6
52588,1,2585,2628,-43,0,106,0,6
52589,1,2338,2415,-77,0,300,0,6
52590,1,2547,2427,120,0,40,0,6
52591,1,2527,2566,-39,0,0,0,6
52592,2,2607,2560,47,0,211,0,6
52593,1,2543,2397,146,0,43,0,6
52594,2,2444,2593,-149,0,247,0,6
52595,2,2332,2412,-80,0,22,1,6
52596,1,2513,2459,54,0,45,0,6
52597,1,2376,2403,-27,0,278,0,6
52598,1,2361,2515,-154,0,45,0,6
52599,1,2402,2420,-18,0,250,0,6
52600,1,2459,2358,101,0,162,0,6
52601,2,2475,2490,-15,0,110,1,6
52602,3,2545,2530,15,0,330,0,6
52603,1,2402,2411,-9,0,153,0,6
52604,2,2316,2404,-88,0,143,1,6
52605,1,2408,2372,36,0,1,1,6
52606,2,2455,2508,-53,0,109,0,6
52607,1,2458,2378,80,0,20,0,6
52608,1,2459,2381,78,0,270,0,6
52609,1,2490,2427,63,0,110,0,6
52610,1,2588,2575,13,0,112,0,6
52611,1,2530,2302,228,0,5,0,6
52612,2,2435,2517,-82,0,404,0,6
52613,2,2348,2565,-217,0,3,0,6
52614,1,2526,2340,186,0,250,0,6
52615,1,2482,2544,-62,0,85,0,6
52616,2,2535,2519,16,0,5,1,6
52617,2,2431,2555,-124,0,109,0,6
52618,1,2545,2532,13,0,455,0,6
52619,1,2561,2265,296,0,0,0,6
52620,2,2356,2482,-126,0,245,0,5
52621,1,2441,2443,-2,0,224,0,6
52622,1,2545,2442,103,0,373,0,6
52623,2,2514,2551,-37,0,113,1,6
52624,2,2612,2550,62,0,190,0,6
52625,1,2424,2302,122,0,211,0,6
52626,2,2452,2377,75,0,46,1,6
52627,1,2631,2435,196,0,100,1,8
52628,1,2408,2363,45,0,40,1,6
52629,1,2586,2494,92,0,300,0,6
52630,2,2549,2559,-10,0,131,0,6
52632,3,2532,2562,-30,0,43,0,6
52633,2,2348,2486,-138,0,453,0,6
52634,2,2533,2546,-13,0,7,0,6
52635,3,2560,2389,171,0,100,0,6
52636,2,2448,2297,151,0,301,0,6
52637,3,2397,2460,-63,0,228,0,6
52638,3,2259,2431,-172,0,40,0,6
52639,1,2468,2338,130,0,170,0,5
52640,2,2437,2527,-90,0,241,1,6
52641,2,2401,2314,87,0,25,0,8
52642,3,2576,2558,18,0,300,0,6
52643,1,2437,2414,23,0,192,0,6
52644,1,2420,2512,-92,0,123,1,6
52645,1,2564,2382,182,0,49,0,6
52646,2,2428,2393,35,0,15,0,6
52647,2,2567,2363,204,0,1,1,6
52648,2,2365,2601,-236,0,43,0,6
52649,3,2415,2279,136,0,373,0,6
52650,2,2412,2266,146,0,300,0,8
52651,1,2532,2427,105,0,4,0,6
52652,2,2513,2563,-50,0,0,1,6
52653,2,2298,2533,-235,0,200,0,6
52654,2,2562,2450,112,0,200,0,6
52655,1,2592,2574,18,0,133,0,6
52656,1,2405,2408,-3,0,188,0,6
52657,1,2438,2466,-28,0,268,0,6
52658,1,2579,2343,236,0,44,0,6
52659,2,2549,2389,160,0,455,0,6
52660,1,2353,2414,-61,0,203,0,6
52661,2,2287,2597,-310,0,0,0,6
52662,2,2504,2442,62,0,7,0,6
52663,2,2403,2335,68,0,61,0,6
52664,1,2570,2427,143,0,201,0,6
52665,2,2642,2498,144,0,121,0,6
52666,1,2379,2401,-22,0,101,1,6
52667,1,2567,2345,222,0,200,0,6
52668,2,2465,2557,-92,0,80,1,6
52669,1,2466,2605,-139,0,123,0,6
52671,2,2549,2559,-10,0,10,0,6
52672,1,2489,2367,122,0,343,0,6
52673,1,2428,2492,-64,0,300,0,6
52674,1,2441,2335,106,0,13,0,6
52675,2,2461,2434,27,0,201,0,6
52676,1,2400,2527,-127,0,112,0,6
52677,1,2462,2529,-67,0,246,0,6
52678,1,2380,2462,-82,0,415,0,6
52679,1,2412,2276,136,4,107,1,13
52680,1,2615,2570,45,0,110,0,6
52681,2,2533,2593,-60,0,37,0,6
52682,1,2567,2552,15,0,101,0,6
52683,1,2436,2498,-62,0,257,0,6
52684,2,2517,2528,-11,0,45,0,6
52685,3,2401,2363,38,0,373,0,8
52686,1,2337,2409,-72,0,330,0,6
52687,3,2484,2558,-74,0,313,0,6
52688,3,2512,2277,235,0,242,0,6
52689,2,2362,2528,-166,0,102,0,6
52690,3,2422,2460,-38,0,455,0,6
52691,2,2495,2444,51,0,201,0,6
52692,1,2262,2425,-163,0,470,0,6
52693,1,2442,2363,79,0,204,1,6
52694,1,2525,2603,-78,0,104,0,6
52695,1,2360,2529,-169,0,106,1,6
52696,2,2562,2643,-81,0,227,0,6
52697,1,2538,2401,137,0,242,1,6
52698,1,2492,2304,188,0,463,0,6
52699,1,2376,2490,-114,0,212,1,6
52700,1,2565,2544,21,0,119,0,6
52701,1,2536,2346,190,0,307,0,6
52702,1,2387,2558,-171,0,41,0,6
52703,1,2521,2349,172,0,345,0,6
52704,2,2421,2392,29,0,7,0,8
52705,2,2367,2413,-46,0,56,0,6
52706,1,2375,2437,-62,0,57,0,6
52707,1,2519,2411,108,0,394,0,6
52708,2,2422,2408,14,0,45,0,6
52709,2,2642,2671,-29,0,100,0,6
52710,1,2564,2395,169,0,1,0,6
52711,1,2493,2434,59,0,409,0,6
52712,2,2363,2457,-94,0,200,0,6
52713,3,2550,2543,7,0,1,0,6
52714,1,2485,2474,11,0,45,0,6
52715,1,2418,2446,-28,0,40,0,6
52716,2,2478,2454,24,0,409,0,6
52717,1,2316,2419,-103,0,414,0,6
52718,1,2402,2411,-9,0,270,1,6
52719,1,2598,2633,-35,0,125,0,6
52720,1,2486,2346,140,0,112,0,5
52721,3,2506,2345,161,0,40,0,6
52722,2,2295,2579,-284,0,45,1,6
52723,2,2374,2506,-132,0,106,0,6
52724,1,2414,2368,46,0,190,0,6
52725,2,2400,2524,-124,0,267,0,6
52726,1,2236,2445,-209,0,404,1,6
52727,2,2413,2360,53,0,46,0,6
52728,2,2396,2416,-20,4,320,0,13
52729,1,2531,2425,106,0,0,1,6
52730,1,2485,2359,126,0,43,0,6
52731,1,2497,2582,-85,0,10,0,6
52732,1,2483,2449,34,0,114,0,6
52733,2,2326,2440,-114,0,218,1,6
52734,2,2234,2406,-172,0,310,1,8
52735,2,2557,2509,48,0,43,0,6
52736,3,2532,2509,23,0,2,0,6
52737,1,2385,2405,-20,0,110,0,6
52738,2,2372,2473,-101,0,263,1,6
52739,1,2402,2325,77,0,53,0,6
52740,1,2445,2398,47,0,20,0,6
52741,3,2455,2387,68,0,15,0,6
52742,2,2527,2468,59,0,222,0,6
52743,1,2211,2508,-297,0,43,0,6
52744,2,2568,2532,36,0,0,0,6
52745,1,2596,2267,329,0,106,0,6
52746,2,2491,2539,-48,0,301,0,6
52747,1,2459,2442,17,0,80,0,6
52748,2,2322,2576,-254,0,0,0,8
52749,2,2317,2427,-110,0,106,0,6
52750,2,2343,2570,-227,0,3,0,6
52751,1,2387,2403,-16,0,0,1,6
52752,1,2423,2424,-1,0,13,0,6
52753,1,2620,2451,169,0,123,0,6
52754,1,2337,2440,-103,0,141,0,6
52755,1,2386,2419,-33,0,211,0,6
52756,1,2569,2597,-28,0,310,0,6
52757,1,2440,2401,39,0,4,0,6
52758,1,2568,2446,122,0,13,0,6
52759,2,2392,2520,-128,0,109,0,6
52760,2,2537,2489,48,0,406,0,6
52761,1,2491,2443,48,0,196,0,6
52762,1,2377,2413,-36,0,45,0,6
52763,1,2430,2304,126,4,110,0,13
52764,1,2391,2575,-184,0,45,0,6
52765,2,2264,2598,-334,0,8,0,6
52766,2,2550,2498,52,0,108,0,6
52767,1,2344,2536,-192,0,343,0,6
52768,1,2475,2430,45,0,109,0,6
52769,2,2543,2598,-55,0,461,0,6
52770,1,2461,2521,-60,0,213,0,6
52771,1,2598,2402,196,0,248,0,6
52772,1,2475,2414,61,4,0,1,13
52773,1,2419,2417,2,0,210,0,6
52774,3,2423,2450,-27,0,126,0,6
52775,1,2435,2295,140,0,140,0,6
52776,2,2400,2395,5,0,40,0,6
52777,1,2522,2431,91,0,201,0,6
52778,1,2382,2558,-176,0,9,1,6
52779,2,2599,2460,139,0,140,0,6
52780,2,2547,2561,-14,0,80,0,6
52781,2,2573,2562,11,0,123,1,6
52782,1,2538,2371,167,0,104,1,6
52783,3,2437,2462,-25,4,260,0,13
52784,1,2602,2605,-3,0,110,0,6
52785,1,2533,2512,21,0,43,0,6
52786,1,2572,2340,232,0,200,0,6
52787,1,2637,2618,19,0,153,0,6
52788,1,2559,2301,258,0,254,0,6
52789,2,2398,2429,-31,0,305,0,6
52790,2,2464,2382,82,0,106,0,6
52791,1,2605,2531,74,0,225,0,6
52792,1,2509,2368,141,0,150,0,6
52793,1,2520,2627,-107,0,4,0,6
52794,3,2395,2455,-60,0,143,0,6
52795,2,2407,2498,-91,0,405,0,6
52796,3,2529,2623,-94,0,345,0,6
52797,1,2407,2504,-97,0,46,0,6
52798,2,2359,2535,-176,0,102,0,6
52799,2,2421,2230,191,0,40,0,6
52800,2,2469,2416,53,0,201,0,6
52801,1,2411,2347,64,0,414,0,6
52802,1,2538,2570,-32,0,177,0,6
52803,1,2323,2425,-102,0,207,0,6
52804,2,2567,2544,23,0,15,1,6
52805,1,2425,2462,-37,0,45,0,6
52806,3,2541,2480,61,0,43,0,6
52807,2,2269,2486,-217,0,131,0,6
52808,1,2681,2579,102,0,103,0,6
52809,2,2335,2426,-91,0,121,0,6
52810,3,2338,2575,-237,0,3,0,6
52811,3,2353,2446,-93,0,203,0,6
52812,2,2418,2362,56,0,46,0,6
52813,2,2622,2460,162,0,250,0,6
52814,2,2219,2572,-353,0,487,0,6
52815,1,2443,2356,87,0,101,0,6
52816,2,2524,2498,26,0,222,0,6
52817,2,2405,2408,-3,0,101,0,6
52818,2,2444,2523,-79,0,300,1,6
52819,2,2437,2419,18,0,278,0,6
52820,2,2407,2499,-92,0,414,0,6
52821,3,2401,2414,-13,0,121,0,6
52822,1,2539,2540,-1,0,312,0,6
52823,2,2388,2527,-139,0,44,0,6
52824,2,2368,2543,-175,0,303,0,6
52825,2,2272,2481,-209,0,245,0,6
52827,2,2397,2461,-64,0,130,0,6
52828,2,2417,2398,19,0,226,0,6
52829,1,2573,2609,-36,0,46,0,6
52830,1,2603,2218,385,0,43,0,6
52831,2,2527,2240,287,0,225,0,6
52832,2,2434,2298,136,0,15,0,6
52833,3,2530,2561,-31,0,13,0,6
52834,1,2578,2274,304,0,211,0,8
52835,2,2388,2454,-66,0,415,1,6
52836,1,2402,2226,176,0,485,0,8
52837,2,2489,2399,90,0,302,0,6
52838,2,2566,2447,119,0,201,0,6
52840,1,2592,2550,42,0,113,0,6
52841,1,2431,2567,-136,0,301,0,6
52842,1,2484,2568,-84,0,127,1,6
52843,1,2440,2455,-15,0,304,0,6
52844,2,2345,2489,-144,0,245,0,5
52845,2,2564,2545,19,0,110,1,6
52846,2,2495,2361,134,0,380,1,6
52847,2,2571,2507,64,0,43,0,6
52848,1,2437,2317,120,0,147,0,6
52849,1,2619,2412,207,0,206,0,6
52850,3,2513,2439,74,0,108,0,6
52851,1,2455,2491,-36,0,337,0,6
52852,2,2528,2366,162,0,4,1,6
52853,2,2215,2435,-220,0,262,0,6
52854,2,2364,2559,-195,0,45,0,6
52855,2,2406,2464,-58,0,371,0,6
52856,3,2528,2575,-47,0,133,0,6
52857,1,2508,2477,31,0,485,1,6
52858,1,2305,2413,-108,0,229,0,6
52859,1,2391,2475,-84,0,373,1,6
52861,1,2576,2601,-25,0,474,0,6
52862,1,2547,2362,185,0,250,0,6
52863,1,2634,2535,99,0,15,1,6
52865,2,2514,2468,46,0,3,0,6
52866,1,2603,2365,238,0,45,0,6
52867,2,2447,2380,67,0,247,0,6
52868,1,2247,2544,-297,0,57,0,6
52869,1,2546,2579,-33,0,1,0,6
52870,2,2534,2216,318,0,373,0,6
52871,1,2488,2597,-109,0,211,0,6
52872,3,2526,2574,-48,0,133,0,6
52873,2,2455,2566,-111,0,111,0,6
52874,1,2405,2459,-54,0,15,0,6
52875,1,2497,2313,184,0,28,0,6
52876,1,2537,2613,-76,0,151,0,6
52877,2,2366,2414,-48,0,7,0,6
52878,1,2589,2517,72,0,241,0,6
52879,2,2310,2518,-208,0,4,1,6
52880,2,2538,2604,-66,0,0,0,6
52881,2,2505,2496,9,0,0,0,6
52882,1,2531,2250,281,0,4,0,6
52883,2,2401,2337,64,0,123,0,6
52884,2,2256,2404,-148,0,112,1,8
52885,1,2450,2424,26,0,250,0,6
52886,1,2400,2265,135,0,1,0,6
52887,1,2288,2468,-180,0,1,0,5
52888,3,2457,2367,90,0,101,0,6
52889,1,2573,2527,46,0,300,0,6
52890,1,2439,2389,50,0,127,0,6
52891,3,2539,2513,26,0,43,0,6
52892,1,2397,2497,-100,0,15,0,6
52893,3,2348,2453,-105,0,405,0,6
52894,1,2600,2608,-8,0,201,1,6
52895,1,2392,2458,-66,0,130,0,8
52896,1,2571,2341,230,0,13,0,6
52897,2,2349,2606,-257,0,40,0,6
52898,2,2410,2356,54,0,301,0,6
52899,2,2363,2622,-259,0,0,0,6
52900,2,2491,2505,-14,0,187,0,6
52901,3,2541,2266,275,0,106,0,6
52902,2,2485,2546,-61,0,303,0,6
52903,2,2560,2535,25,0,0,0,6
52904,2,2575,2416,159,0,45,0,6
52905,2,2324,2463,-139,0,111,1,6
52906,1,2595,2561,34,0,0,0,6
52907,2,2226,2609,-383,0,48,0,6
52908,2,2440,2374,66,0,45,0,6
52909,1,2550,2520,30,0,106,0,6
52910,1,2534,2512,22,0,0,0,6
52911,1,2423,2411,12,0,435,0,6
52912,1,2430,2355,75,0,120,1,6
52913,1,2510,2269,241,0,140,0,6
52914,2,2232,2518,-286,0,40,0,6
52915,1,2504,2213,291,0,10,0,6
52916,3,2580,2273,307,0,100,0,6
52917,3,2522,2578,-56,0,133,0,6
52918,2,2362,2440,-78,0,45,0,6
52919,1,2513,2260,253,0,2,0,6
52920,2,2562,2550,12,0,102,0,6
52921,2,2387,2561,-174,0,80,0,6
52922,1,2362,2594,-232,0,332,0,6
52923,1,2496,2531,-35,0,83,0,6
52924,1,2419,2437,-18,0,106,0,6
52925,2,2493,2253,240,0,149,0,5
52926,1,2451,2613,-162,0,151,1,6
52927,2,2406,2411,-5,0,100,1,6
52928,2,2521,2352,169,0,101,0,6
52929,1,2556,2499,57,0,107,0,6
52930,1,2502,2485,17,0,0,0,6
52931,2,2556,2553,3,0,302,1,6
52932,1,2573,2511,62,0,1,1,6
52933,1,2452,2452,0,0,301,0,6
52934,2,2412,2314,98,0,31,1,6
52935,1,2455,2469,-14,0,11,1,6
52936,2,2297,2439,-142,0,300,1,6
52937,2,2521,2391,130,0,455,0,6
52938,1,2519,2225,294,0,13,0,6
52939,1,2431,2273,158,0,43,0,6
52940,2,2578,2523,55,0,300,0,6
52941,1,2449,2446,3,0,201,0,6
52942,1,2624,2506,118,0,205,0,6
52943,2,2433,2361,72,0,211,1,6
52944,1,2381,2539,-158,0,102,0,6
52945,2,2490,2404,86,0,315,0,6
52946,2,2409,2520,-111,0,127,0,8
52947,2,2400,2485,-85,0,10,0,6
52948,2,2440,2505,-65,0,158,0,6
52949,1,2554,2347,207,0,0,0,6
52950,2,2464,2561,-97,0,454,0,6
52951,3,2541,2608,-67,0,18,0,6
52952,2,2501,2480,21,0,101,0,6
52953,1,2551,2558,-7,0,175,1,6
52954,2,2406,2399,7,0,45,1,6
52955,2,2228,2514,-286,0,415,0,6
52956,1,2600,2319,281,0,226,0,6
52957,1,2257,2468,-211,0,146,0,6
52958,1,2515,2399,116,0,123,0,6
52959,2,2519,2389,130,0,45,0,6
52960,1,2460,2484,-24,0,255,0,5
52961,2,2339,2574,-235,0,3,0,6
52962,1,2411,2352,59,0,211,1,6
52963,2,2417,2582,-165,0,4,0,6
52964,3,2359,2554,-195,0,341,0,6
52965,1,2215,2403,-188,0,300,0,8
52966,1,2533,2384,149,0,46,0,6
52967,2,2564,2557,7,0,22,1,6
52968,1,2544,2390,154,0,150,1,6
52969,3,2395,2501,-106,0,380,0,6
52970,2,2514,2606,-92,0,45,0,6
52971,1,2389,2628,-239,0,160,0,6
52972,1,2531,2555,-24,0,0,1,6
52973,1,2466,2213,253,0,131,0,5
52974,2,2300,2559,-259,0,487,0,8
52975,2,2539,2489,50,0,4,1,6
52976,2,2384,2447,-63,0,84,0,6
52977,3,2610,2578,32,0,263,0,6
52978,2,2506,2507,-1,0,307,0,6
52979,2,2480,2565,-85,0,228,0,6
52980,1,2585,2459,126,0,200,0,6
52981,1,2240,2404,-164,0,40,0,6
52982,1,2343,2478,-135,0,256,0,5
52983,1,2369,2402,-33,0,42,0,6
52984,1,2416,2273,143,4,107,1,13
52985,1,2487,2439,48,0,50,0,6
52986,1,2580,2221,359,0,107,0,8
52987,3,2515,2403,112,0,31,0,6
52988,2,2570,2557,13,0,43,0,6
52989,1,2578,2368,210,0,47,0,6
52990,2,2445,2438,7,0,247,0,6
52991,1,2609,2427,182,0,107,0,6
52992,1,2425,2431,-6,0,278,0,6
52993,2,2459,2445,14,0,200,0,6
52994,1,2507,2429,78,0,2,0,6
52995,3,2451,2383,68,0,334,0,8
52996,3,2322,2406,-84,0,122,0,6
52997,2,2331,2422,-91,0,0,1,6
52998,2,2500,2542,-42,0,487,1,6
52999,2,2607,2513,94,0,124,0,6
53000,3,2424,2460,-36,0,120,0,6
53001,1,2404,2407,-3,0,8,0,6
53002,1,2307,2402,-95,0,331,0,6
53003,1,2576,2336,240,0,200,0,6
53004,3,2521,2460,61,0,369,0,6
53005,2,2223,2605,-382,0,154,0,6
53006,1,2459,2486,-27,0,57,0,6
53007,2,2537,2519,18,0,241,0,6
53008,2,2289,2541,-252,0,428,0,6
53009,1,2446,2436,10,0,88,1,6
53010,2,2510,2490,20,0,310,0,6
53011,1,2530,2571,-41,0,133,0,6
53012,2,2270,2419,-149,0,140,0,8
53013,1,2272,2400,-128,0,45,0,6
53014,3,2581,2537,44,0,1,0,6
53015,1,2516,2372,144,0,242,0,6
53016,2,2466,2320,146,0,107,1,6
53017,1,2505,2425,80,0,113,0,6
53018,1,2547,2362,185,0,250,0,6
53019,1,2458,2447,11,0,301,0,6
53020,3,2404,2227,177,0,4,0,6
53021,2,2334,2579,-245,0,3,0,6
53022,1,2505,2550,-45,0,107,0,6
53023,2,2550,2558,-8,0,4,0,6
53024,1,2563,2559,4,0,0,0,6
53025,2,2373,2413,-40,0,375,0,6
53026,1,2411,2483,-72,0,96,0,6
53027,1,2316,2470,-154,0,437,0,6
53028,2,2461,2602,-141,0,56,0,6
53029,2,2606,2642,-36,0,1,0,6
53030,1,2416,2398,18,0,45,0,6
53031,1,2400,2401,-1,0,246,0,6
53032,1,2570,2375,195,0,200,0,6
53033,1,2444,2381,63,0,265,0,6
53034,2,2537,2476,61,0,43,0,6
53035,1,2417,2295,122,0,140,0,6
53036,2,2389,2443,-54,0,320,0,6
53037,3,2297,2451,-154,0,101,0,6
53038,1,2317,2520,-203,0,331,0,6
53039,3,2440,2249,191,0,311,0,6
53040,1,2511,2509,2,0,45,0,6
53041,1,2456,2619,-163,0,43,0,6
53042,3,2612,2398,214,0,121,0,6
53043,2,2222,2589,-367,0,302,0,6
53044,2,2423,2638,-215,0,42,1,6
53045,2,2524,2502,22,0,406,1,6
53046,2,2440,2454,-14,0,304,0,6
53047,1,2552,2557,-5,0,45,1,6
53048,1,2312,2603,-291,4,132,1,13
53049,2,2580,2606,-26,0,58,0,6
53050,2,2432,2221,211,0,1,0,6
53051,1,2371,2418,-47,0,22,1,6
53052,2,2531,2495,36,0,114,0,6
53053,2,2547,2525,22,0,85,0,6
53054,2,2339,2532,-193,0,13,1,6
53055,2,2461,2218,243,0,48,0,6
53056,2,2402,2346,56,0,302,0,8
53057,1,2266,2538,-272,0,49,0,6
53058,3,2564,2599,-35,0,11,0,6
53059,2,2466,2545,-79,0,427,0,6
53060,1,2520,2580,-60,0,106,0,6
53061,1,2531,2472,59,0,59,0,6
53062,2,2612,2606,6,0,147,0,6
53063,2,2575,2457,118,0,43,1,6
53064,2,2396,2434,-38,0,0,0,6
53065,1,2510,2452,58,0,40,1,6
53066,2,2287,2511,-224,0,40,1,6
53067,1,2355,2543,-188,0,41,1,6
53068,1,2590,2543,47,0,113,0,6
53069,1,2463,2400,63,0,302,0,6
53070,1,2392,2410,-18,4,141,0,13
53071,3,2504,2421,83,0,112,0,6
53072,3,2531,2553,-22,0,3,0,6
53073,3,2541,2569,-28,0,140,0,6
53074,3,2482,2396,86,0,188,0,6
53075,2,2257,2405,-148,0,112,0,8
53076,1,2581,2332,249,0,331,0,6
53077,2,2496,2424,72,0,2,1,6
53078,2,2512,2528,-16,0,3,1,6
53079,1,2394,2564,-170,0,485,0,6
53080,2,2496,2394,102,0,108,1,6
53081,1,2416,2357,59,0,106,0,6
53082,1,2384,2449,-65,0,122,0,8
53083,2,2431,2532,-101,0,301,1,6
53084,3,2470,2202,268,0,200,0,5
53085,2,2422,2347,75,0,45,0,6
53086,1,2504,2509,-5,0,487,0,6
53087,1,2536,2401,135,0,288,0,6
53088,2,2467,2370,97,0,110,0,6
53089,2,2356,2517,-161,0,264,0,6
53090,3,2266,2506,-240,0,242,0,6
53091,3,2353,2576,-223,0,115,0,6
53092,1,2277,2520,-243,0,487,0,6
53093,2,2324,2468,-144,0,100,0,5
53094,1,2427,2326,101,0,41,0,6
53095,2,2465,2606,-141,0,57,0,6
53096,2,2612,2511,101,0,102,0,6
53097,1,2233,2503,-270,0,12,0,6
53099,2,2441,2421,20,0,133,0,6
53100,2,2315,2464,-149,0,46,0,6
53101,1,2448,2313,135,0,301,0,6
53102,1,2404,2323,81,0,152,0,6
53103,1,2511,2346,165,0,253,0,6
53105,1,2464,2465,-1,0,131,0,6
53106,3,2414,2409,5,0,7,0,6
53107,2,2450,2422,28,0,186,0,6
53108,1,2476,2418,58,0,300,0,6
53109,1,2421,2510,-89,0,101,1,6
53110,2,2565,2536,29,0,300,1,6
53111,2,2340,2564,-224,0,101,0,6
53112,1,2395,2430,-35,0,253,0,6
53113,2,2458,2335,123,0,246,1,6
53114,2,2359,2554,-195,0,305,0,6
53115,3,2414,2377,37,0,277,0,6
53116,2,2319,2410,-91,0,112,0,6
53117,2,2410,2402,8,0,107,0,6
53118,2,2459,2424,35,0,115,1,6
53119,1,2451,2349,102,0,150,0,6
53120,2,2530,2376,154,0,41,1,6
53121,1,2348,2447,-99,0,45,0,6
53122,1,2556,2402,154,0,405,0,6
53123,3,2321,2452,-131,0,9,0,6
53124,3,2567,2610,-43,0,151,0,6
53125,1,2408,2462,-54,0,45,0,6
53126,3,2328,2461,-133,0,388,0,6
53127,1,2589,2520,69,0,4,1,6
53128,2,2341,2500,-159,0,125,1,6
53129,1,2412,2338,74,0,1,0,6
53130,1,2422,2267,155,0,112,1,8
53131,2,2322,2431,-109,0,25,0,6
53132,1,2551,2558,-7,0,157,1,6
53133,2,2416,2414,2,0,344,1,6
53134,1,2609,2246,363,0,211,0,6
53136,1,2494,2395,99,0,53,1,6
53137,1,2496,2492,4,0,25,1,6
53138,1,2546,2507,39,0,301,0,6
53139,1,2539,2563,-24,0,152,0,6
53140,1,2403,2233,170,0,411,0,6
53141,1,2488,2423,65,0,140,1,6
53142,1,2330,2583,-253,0,3,0,6
53143,1,2426,2368,58,0,102,0,6
53144,1,2567,2509,58,0,203,0,6
53145,1,2487,2467,20,0,4,0,6
53146,1,2422,2368,54,0,48,0,6
53147,2,2508,2518,-10,0,85,1,6
53148,1,2447,2317,130,0,4,0,6
53149,3,2424,2489,-65,0,103,0,6
53150,1,2536,2427,109,0,4,0,6
53151,2,2401,2402,-1,0,1,0,6
53152,1,2291,2453,-162,0,100,0,8
53153,1,2533,2421,112,0,300,0,6
53154,1,2430,2305,125,0,130,1,6
53155,2,2421,2514,-93,0,3,0,6
53156,3,2431,2489,-58,0,40,0,6
53157,1,2391,2460,-69,0,102,0,6
53158,1,2421,2308,113,0,211,0,6
53159,1,2481,2506,-25,0,201,0,6
53160,1,2377,2437,-60,0,128,0,6
53161,2,2352,2451,-99,0,84,0,6
53162,3,2436,2380,56,0,400,0,8
53163,1,2454,2515,-61,0,334,0,6
53164,1,2552,2504,48,0,455,0,6
53165,2,2414,2402,12,0,7,0,6
53166,1,2641,2647,-6,0,96,1,6
53167,2,2401,2428,-27,0,122,0,6
53168,2,2278,2417,-139,0,58,0,6
53169,3,2542,2558,-16,0,4,0,6
53170,1,2483,2409,74,0,302,1,6
53171,1,2594,2429,165,0,301,0,6
53172,2,2361,2414,-53,0,304,0,6
53173,1,2439,2249,190,0,310,0,6
53174,2,2460,2435,25,0,107,0,6
53175,1,2435,2318,117,0,106,0,6
53176,1,2459,2560,-101,0,102,0,6
53177,1,2419,2331,88,0,1,0,6
53179,1,2440,2356,84,0,80,0,6
53180,2,2503,2397,106,0,31,0,6
53181,2,2505,2572,-67,0,248,0,6
53182,2,2343,2411,-68,0,51,0,6
53183,3,2310,2408,-98,0,30,0,6
53184,1,2414,2341,73,0,7,0,6
53185,2,2550,2535,15,0,40,0,6
53186,2,2564,2610,-46,0,0,0,6
53187,3,2245,2493,-248,0,6,0,6
53188,2,2500,2487,13,0,3,1,6
53189,3,2503,2323,180,0,45,0,6
53190,1,2429,2450,-21,0,112,0,6
53191,1,2431,2453,-22,0,123,0,6
53192,1,2511,2312,199,4,202,0,13
53193,3,2392,2402,-10,0,6,0,6
53194,3,2324,2469,-145,0,24,0,6
53195,2,2360,2524,-164,0,140,1,6
53196,2,2495,2358,137,0,202,0,6
53197,1,2462,2492,-30,0,105,0,6
53198,3,2454,2514,-60,0,302,0,6
53199,2,2516,2338,178,0,40,0,6
53200,1,2423,2540,-117,0,40,0,6
53201,1,2574,2339,235,0,0,0,6
53202,1,2552,2557,-5,0,45,0,6
53203,2,2333,2527,-194,0,300,1,6
53204,1,2419,2334,85,0,8,0,6
53205,1,2467,2411,56,0,215,1,6
53207,2,2501,2551,-50,0,45,0,6
53208,2,2402,2419,-17,0,7,0,6
53209,2,2314,2487,-173,0,388,0,6
53210,2,2310,2493,-183,0,306,0,6
53211,1,2280,2400,-120,0,245,0,6
53212,3,2488,2432,56,0,206,0,6
53213,2,2326,2502,-176,0,371,0,6
53214,1,2519,2417,102,0,83,0,6
53215,1,2356,2417,-61,0,4,1,6
53216,2,2337,2576,-239,0,3,0,6
53217,1,2424,2396,28,0,463,0,6
53218,1,2416,2249,167,0,300,0,6
53219,1,2537,2500,37,0,45,0,6
53220,2,2453,2357,96,0,150,0,6
53221,3,2264,2425,-161,0,4,0,6
53222,2,2387,2487,-100,0,108,0,6
53223,3,2407,2363,44,0,469,0,6
53224,2,2579,2334,245,0,331,0,6
53225,1,2396,2447,-51,0,0,0,6
53226,1,2364,2537,-173,0,37,0,6
53227,1,2455,2396,59,0,4,0,6
53228,1,2354,2419,-65,0,49,1,6
53229,1,2498,2557,-59,0,8,0,6
53230,1,2401,2270,131,0,421,0,6
53231,1,2433,2258,175,0,42,0,6
53232,2,2278,2444,-166,0,22,0,6
53233,1,2461,2392,69,0,400,1,6
53234,2,2264,2425,-161,0,122,0,8
53235,1,2558,2543,15,0,40,0,6
53236,3,2372,2502,-130,0,226,0,6
53237,1,2507,2287,220,0,100,1,6
53238,1,2511,2242,269,0,225,0,6
53239,2,2508,2444,64,0,257,1,6
53240,2,2403,2461,-58,0,122,0,6
53241,1,2556,2496,60,0,301,0,6
53242,2,2380,2487,-107,0,16,1,6
53243,1,2420,2243,177,0,374,1,6
53244,1,2541,2447,94,0,46,1,6
53245,1,2391,2430,-39,0,302,0,6
53246,1,2435,2383,52,0,240,1,6
53247,2,2434,2545,-111,0,278,0,6
53248,2,2492,2496,-4,0,306,0,6
53249,1,2314,2439,-125,0,20,1,6
53250,1,2493,2494,-1,0,201,0,6
53251,2,2537,2564,-27,0,34,0,6
53252,1,2563,2434,129,0,13,0,6
53253,1,2334,2409,-75,0,11,0,8
53254,1,2253,2456,-203,0,113,0,6
53255,2,2335,2457,-122,0,43,0,6
53256,2,2507,2384,123,0,45,0,6
53257,1,2425,2319,106,0,4,0,6
53258,2,2490,2556,-66,0,380,0,6
53259,2,2465,2399,66,0,14,1,6
53260,1,2570,2474,96,0,464,0,6
53261,2,2542,2402,140,0,300,0,6
53262,1,2486,2468,18,0,4,0,6
53263,2,2425,2440,-15,0,302,1,6
53264,3,2316,2414,-98,0,106,0,6
53265,1,2418,2318,100,0,302,1,6
53266,1,2500,2344,156,0,40,0,6
53267,2,2444,2530,-86,0,354,1,6
53268,2,2441,2454,-13,0,260,0,6
53269,1,2423,2295,128,0,107,1,6
53270,1,2447,2326,121,0,157,0,6
53271,1,2550,2506,44,0,10,0,6
53273,2,2489,2499,-10,0,3,1,6
53274,2,2495,2324,171,0,331,0,6
53275,1,2464,2528,-64,0,373,0,6
53276,2,2406,2464,-58,0,48,0,6
53277,1,2311,2404,-93,4,141,0,13
53278,1,2460,2399,61,0,6,0,6
53279,2,2413,2523,-110,0,216,1,6
53280,3,2621,2647,-26,0,107,0,6
53281,2,2433,2487,-54,0,320,1,6
53282,2,2340,2503,-163,0,2,1,6
53283,1,2524,2446,78,0,57,0,6
53284,2,2253,2444,-191,0,106,0,6
53285,2,2426,2276,150,0,373,0,6
53286,1,2448,2442,6,0,331,0,6
53287,1,2410,2338,72,0,110,1,6
53288,1,2423,2398,25,0,87,1,6
53289,1,2389,2420,-31,0,195,0,6
53290,2,2503,2509,-6,0,40,0,6
53291,2,2341,2419,-78,0,0,1,6
53292,1,2499,2320,179,0,12,0,6
53293,2,2528,2486,42,0,19,1,6
53294,2,2239,2404,-165,0,43,0,6
53295,2,2437,2558,-121,0,123,0,6
53296,3,2373,2436,-63,0,39,0,6
53297,1,2436,2295,141,0,310,0,6
53298,1,2500,2555,-55,0,8,0,6
53299,3,2250,2436,-186,0,100,0,8
53300,1,2341,2501,-160,0,8,0,6
53301,1,2522,2387,135,0,335,0,6
53302,1,2491,2561,-70,0,15,0,6
53303,2,2349,2502,-153,0,131,1,6
53304,1,2463,2536,-73,0,43,1,6
53305,1,2463,2340,123,0,107,0,6
53306,1,2451,2398,53,4,405,0,13
53307,1,2431,2410,21,0,432,0,6
53308,2,2538,2545,-7,0,96,0,6
53309,2,2443,2489,-46,0,100,0,6
53310,2,2344,2434,-90,0,49,0,6
53311,2,2551,2535,16,0,115,0,6
53312,2,2485,2549,-64,0,331,1,6
53313,1,2598,2322,276,0,43,0,6
53314,3,2442,2234,208,0,112,0,8
53315,1,2375,2470,-95,0,45,0,6
53316,1,2392,2500,-108,0,100,0,6
53317,1,2424,2369,55,0,45,1,6
53318,2,2579,2508,71,0,453,0,6
53319,2,2389,2574,-185,0,429,1,6
53320,2,2431,2532,-101,0,301,1,6
53321,1,2400,2314,86,0,107,1,6
53322,1,2516,2469,47,0,100,0,6
53323,2,2396,2416,-20,0,138,0,6
53324,2,2431,2567,-136,0,100,1,6
53325,3,2470,2551,-81,0,96,0,6
53326,2,2361,2459,-98,0,140,0,6
53327,3,2429,2600,-171,0,100,0,6
53328,2,2451,2399,52,0,469,1,6
53329,1,2497,2529,-32,0,83,0,6
53330,2,2504,2483,21,0,202,0,6
53331,2,2273,2443,-170,0,245,0,6
53332,1,2569,2533,36,0,300,1,6
53333,2,2503,2474,29,0,46,0,6
53334,2,2283,2420,-137,0,102,1,6
53335,1,2469,2408,61,0,278,1,6
53336,1,2440,2277,163,0,354,0,6
53337,2,2419,2426,-7,0,80,0,6
53338,1,2235,2436,-201,0,331,1,6
53339,1,2372,2402,-30,0,257,0,8
53340,2,2367,2524,-157,0,334,0,6
53341,2,2419,2444,-25,0,157,1,6
53342,2,2412,2405,7,0,4,0,6
53343,2,2338,2441,-103,0,485,0,6
53344,1,2434,2266,168,0,338,0,8
53345,1,2561,2394,167,0,16,1,6
53346,1,2227,2402,-175,0,315,0,8
53347,3,2527,2409,118,0,45,0,6
53348,2,2244,2513,-269,0,106,0,6
53349,1,2361,2510,-149,0,106,1,6
53350,2,2231,2574,-343,0,45,1,6
53351,2,2407,2461,-54,0,43,0,6
53352,2,2452,2492,-40,0,200,0,6
53353,1,2414,2395,19,0,191,0,6
53354,1,2493,2374,119,0,42,0,6
53355,2,2498,2590,-92,0,300,0,6
53356,1,2415,2322,93,0,119,0,6
53357,1,2317,2502,-185,0,46,0,6
53358,2,2337,2525,-188,0,3,0,6
53359,2,2392,2429,-37,0,141,1,6
53360,2,2366,2470,-104,0,40,1,6
53361,3,2460,2436,24,0,107,0,6
53362,1,2467,2493,-26,0,102,0,6
53363,1,2435,2364,71,0,100,1,6
53364,1,2438,2494,-56,0,100,0,6
53365,1,2507,2350,157,0,40,1,6
53366,2,2578,2391,187,0,101,0,6
53367,1,2505,2433,72,0,110,0,6
53368,2,2550,2545,5,0,45,0,6
53369,1,2529,2470,59,0,127,0,6
53370,2,2276,2437,-161,0,40,0,6
53371,1,2642,2647,-5,0,107,0,6
53372,2,2263,2443,-180,0,132,0,6
53373,1,2463,2405,58,0,14,0,6
53374,2,2444,2349,95,0,463,0,6
53375,1,2263,2421,-158,0,135,0,6
53376,2,2286,2441,-155,0,45,0,6
53377,1,2401,2313,88,0,303,1,6
53378,1,2536,2361,175,0,141,0,6
53379,1,2597,2425,172,0,301,1,6
53380,1,2445,2334,111,0,292,1,6
53381,1,2577,2548,29,0,463,0,6
53382,2,2406,2308,98,0,4,0,6
53383,2,2432,2398,34,4,143,0,13
53384,1,2413,2426,-13,0,302,0,6
53385,1,2432,2497,-65,0,192,1,6
53386,1,2522,2477,45,0,256,0,6
53387,1,2440,2464,-24,0,202,0,6
53388,2,2489,2404,85,0,3,1,6
53389,2,2610,2546,64,0,490,0,6
53390,1,2510,2427,83,0,100,1,6
53391,1,2522,2503,19,0,13,0,6
53392,1,2260,2419,-159,0,302,0,6
53393,1,2357,2411,-54,0,40,0,6
53394,2,2443,2326,117,0,4,1,6
53395,2,2595,2494,101,0,45,0,6
53396,1,2466,2334,132,0,330,0,6
53397,1,2528,2402,126,0,484,0,6
53398,1,2400,2569,-169,0,240,0,6
53399,1,2486,2497,-11,0,44,1,6
53400,1,2495,2424,71,0,50,0,6
53401,2,2447,2237,210,0,310,0,6
53402,1,2473,2291,182,0,153,0,6
53403,1,2402,2342,60,0,84,0,6
53404,2,2204,2556,-352,2,57,0,28
53405,1,2488,2534,-46,0,249,0,6
53406,1,2465,2285,180,0,244,0,6
53407,1,2411,2525,-114,0,216,0,6
53408,1,2311,2468,-157,0,474,0,6
53409,2,2247,2414,-167,0,419,1,6
53410,1,2493,2325,168,0,7,0,6
53411,2,2376,2497,-121,0,101,0,6
53412,2,2202,2443,-241,0,111,0,6
53413,1,2459,2554,-95,0,301,0,6
53414,1,2402,2481,-79,0,385,0,6
53415,1,2570,2427,143,0,4,0,6
53416,1,2493,2376,117,0,130,0,6
53417,1,2474,2440,34,0,331,1,6
53418,2,2597,2471,126,0,106,0,6
53419,3,2581,2539,42,0,2,0,6
53420,2,2429,2389,40,0,43,0,6
53421,2,2327,2409,-82,0,34,0,6
53422,1,2474,2311,163,0,15,0,6
53423,2,2434,2387,47,0,41,0,6
53424,1,2641,2528,113,0,110,1,6
53425,1,2411,2234,177,0,211,1,6
53426,1,2390,2420,-30,0,156,1,6
53427,3,2416,2320,96,0,120,0,6
53428,1,2404,2383,21,0,202,1,6
53429,1,2402,2244,158,0,151,1,8
53430,3,2440,2261,179,0,130,0,6
53431,3,2400,2488,-88,0,23,0,6
53432,1,2440,2445,-5,0,150,0,6
53433,1,2427,2374,53,0,143,0,6
53434,2,2356,2437,-81,0,127,0,6
53435,1,2604,2785,-181,0,381,0,6
53436,1,2551,2373,178,0,132,0,6
53437,1,2588,2429,159,0,45,0,6
53438,3,2453,2391,62,0,151,0,6
53439,3,2582,2501,81,0,442,0,6
53440,1,2440,2328,112,0,409,1,6
53441,1,2420,2382,38,0,107,1,6
53442,2,2322,2496,-174,0,46,0,6
53443,2,2423,2528,-105,0,300,0,6
53444,1,2404,2284,120,0,353,0,6
53445,2,2500,2419,81,0,448,0,6
53446,1,2434,2233,201,0,211,0,6
53447,2,2492,2442,50,0,4,1,6
53448,1,2308,2439,-131,0,278,0,6
53449,2,2449,2278,171,0,5,1,6
53450,3,2331,2470,-139,0,2,0,6
53451,2,2490,2514,-24,0,302,0,6
53452,3,2475,2472,3,0,245,0,6
53453,3,2402,2481,-79,4,112,0,13
53454,1,2412,2296,116,0,41,0,6
53455,2,2498,2528,-30,0,85,0,6
53456,2,2532,2305,227,0,56,1,6
53457,1,2408,2450,-42,0,436,0,6
53458,2,2411,2482,-71,0,205,1,6
53459,2,2426,2450,-24,0,327,0,6
53460,1,2291,2502,-211,0,315,0,6
53461,3,2290,2502,-212,0,106,0,6
53462,1,2575,2242,333,0,130,0,6
53463,2,2390,2468,-78,0,453,0,6
53464,1,2269,2404,-135,0,123,0,6
53465,2,2398,2492,-94,0,414,1,6
53466,1,2518,2418,100,0,45,1,6
53467,2,2491,2493,-2,0,190,1,6
53468,2,2330,2466,-136,0,136,1,6
53469,2,2402,2468,-66,0,249,1,6
53470,2,2450,2297,153,0,107,1,6
53471,3,2448,2602,-154,0,389,0,6
53472,1,2443,2516,-73,0,41,0,6
53474,2,2612,2759,-147,0,61,0,6
53475,2,2379,2477,-98,0,312,0,6
53476,1,2503,2291,212,0,112,0,8
53477,2,2437,2250,187,0,247,0,6
53478,1,2422,2276,146,0,4,0,6
53479,2,2528,2487,41,0,7,1,6
53480,2,2448,2468,-20,0,381,1,6
53481,2,2417,2358,59,0,100,0,6
53482,3,2211,2458,-247,4,113,0,18
53483,1,2257,2416,-159,0,255,0,6
53484,1,2476,2435,41,0,302,0,6
53485,2,2776,2606,170,0,382,0,6
53486,2,2479,2589,-110,0,7,1,6
53487,2,2458,2446,12,0,4,0,6
53488,1,2328,2527,-199,0,120,1,6
53489,2,2535,2645,-110,0,107,0,6
53490,1,2372,2437,-65,0,253,0,6
53491,2,2313,2414,-101,0,343,0,6
53492,1,2422,2314,108,4,201,0,13
53493,2,2394,2427,-33,0,8,0,6
53494,2,2497,2430,67,0,112,0,6
53495,1,2503,2531,-28,0,300,0,6
53496,1,2649,2524,125,0,110,1,6
53497,1,2413,2288,125,0,330,1,6
53498,1,2406,2439,-33,0,190,1,6
53499,2,2442,2387,55,0,241,0,6
53500,1,2490,2221,269,0,46,0,6
53501,2,2358,2446,-88,0,172,1,6
53502,1,2350,2414,-64,0,145,1,6
53503,1,2416,2208,208,0,101,0,6
53504,1,2413,2396,17,0,191,1,6
53505,3,2296,2599,-303,0,100,0,6
53506,2,2513,2398,115,0,112,0,6
53507,1,2425,2591,-166,0,101,0,6
53508,2,2624,2568,56,0,147,0,6
53509,1,2330,2425,-95,0,101,0,6
53510,1,2584,2481,103,0,220,0,6
53511,1,2461,2302,159,0,302,0,8
53512,1,2375,2415,-40,0,440,0,6
53513,2,2280,2452,-172,0,4,0,6
53515,1,2401,2386,15,0,45,0,6
53516,1,2487,2421,66,0,3,0,6
53517,1,2500,2319,181,0,9,0,6
53518,1,2431,2379,52,0,130,1,6
53519,2,2396,2419,-23,0,45,0,6
53520,2,2435,2423,12,0,156,0,6
53521,1,2468,2333,135,0,330,0,6
53522,3,2436,2383,53,0,343,0,6
53523,1,2595,2240,355,0,46,1,6
53524,2,2431,2522,-91,0,216,0,6
53525,2,2382,2427,-45,0,102,0,6
53526,2,2292,2473,-181,0,277,0,6
53527,1,2416,2443,-27,0,380,0,6
53528,1,2496,2346,150,0,244,0,6
53529,2,2308,2408,-100,0,34,0,6
53530,1,2502,2509,-7,0,102,0,6
53531,1,2525,2494,31,0,203,0,6
53532,1,2486,2372,114,0,140,0,6
53533,2,2256,2428,-172,0,120,0,6
53534,1,2497,2498,-1,0,49,0,6
53535,2,2314,2411,-97,0,143,0,6
53536,2,2348,2410,-62,0,300,1,6
53537,3,2375,2439,-64,0,100,0,8
53538,3,2556,2533,23,0,258,0,6
53539,3,2288,2450,-162,0,100,0,6
53540,2,2402,2302,100,0,125,0,8
53541,1,2434,2418,16,0,120,1,6
53542,3,2429,2429,0,0,112,0,6
53543,1,2477,2517,-40,0,33,0,6
53544,1,2457,2508,-51,0,50,0,6
53545,1,2405,2233,172,0,246,0,8
53546,2,2459,2521,-62,0,224,0,6
53547,3,2407,2379,28,0,343,0,6
53548,1,2490,2443,47,0,255,1,6
53549,1,2766,2581,185,0,241,0,6
53550,2,2408,2331,77,0,58,0,6
53551,2,2526,2609,-83,0,45,0,6
53552,1,2427,2382,45,0,127,0,6
53553,2,2422,2452,-30,0,4,0,6
53554,2,2329,2523,-194,0,2,0,6
53555,1,2533,2493,40,0,13,1,6
53556,3,2593,2475,118,0,106,0,6
53557,1,2442,2273,169,0,152,0,6
53558,1,2406,2327,79,0,122,0,6
53559,1,2433,2389,44,0,463,0,6
53560,1,2261,2432,-171,0,254,0,6
53561,1,2751,2545,206,0,7,0,6
53562,1,2476,2653,-177,0,241,0,6
53563,1,2406,2338,68,0,49,0,6
53564,1,2461,2492,-31,0,99,1,6
53565,3,2285,2438,-153,0,125,0,6
53566,1,2452,2479,-27,0,48,0,6
53567,2,2343,2499,-156,0,107,1,6
53568,3,2416,2413,3,0,46,0,6
53569,2,2520,2614,-94,0,302,1,6
53570,2,2323,2450,-127,0,1,0,6
53571,2,2316,2503,-187,0,352,0,6
53572,2,2418,2379,39,0,300,0,6
53573,2,2425,2596,-171,0,380,1,6
53574,1,2516,2433,83,0,15,1,6
53575,2,2446,2522,-76,0,131,0,6
53576,1,2503,2521,-18,0,15,0,6
53577,2,2432,2433,-1,0,3,0,6
53578,2,2277,2407,-130,0,4,1,6
53579,2,2455,2576,-121,0,223,0,6
53580,2,2419,2334,85,0,134,1,6
53581,1,2578,2526,52,0,3,0,6
53582,1,2762,2772,-10,0,373,0,6
53583,2,2340,2489,-149,0,304,0,6
53584,2,2374,2436,-62,0,250,1,6
53585,1,2427,2287,140,0,35,0,6
53586,1,2424,2391,33,0,184,0,6
53587,3,2323,2425,-102,4,122,0,13
53588,2,2406,2315,91,0,312,0,6
53589,2,2219,2516,-297,0,106,0,6
53590,1,2493,2352,141,0,11,0,6
53591,1,2526,2572,-46,0,365,1,6
53592,1,2468,2324,144,0,302,0,8
53593,2,2237,2410,-173,0,110,1,6
53594,1,2323,2430,-107,0,104,0,6
53595,3,2415,2348,67,0,139,0,6
53596,2,2310,2411,-101,0,147,1,6
53597,1,2390,2414,-24,0,300,1,6
53598,1,2407,2276,131,0,315,0,6
53599,2,2613,2531,82,0,463,0,6
53600,2,2369,2448,-79,0,455,0,6
53601,1,2482,2361,121,0,302,1,6
53602,2,2460,2337,123,0,46,1,6
53603,2,2538,2435,103,0,57,1,6
53604,1,2413,2440,-27,0,343,0,6
53605,2,2522,2445,77,0,300,0,6
53606,1,2261,2421,-160,0,242,1,6
53607,3,2458,2433,25,0,10,0,6
53608,2,2438,2371,67,0,335,0,6
53610,2,2455,2506,-51,0,224,0,6
53611,1,2429,2429,0,0,162,1,6
53612,2,2422,2330,92,0,184,0,6
53613,2,2644,2477,167,0,469,1,6
53614,1,2515,2326,189,0,200,0,6
53615,1,2542,2413,129,0,406,0,6
53616,1,2420,2287,133,0,439,0,6
53617,1,2384,2438,-54,0,13,0,6
53618,3,2336,2431,-95,0,200,0,6
53619,1,2422,2293,129,0,59,0,6
53620,1,2496,2337,159,0,145,0,6
53621,1,2495,2463,32,0,120,0,6
53622,2,2442,2486,-44,0,85,1,6
53623,1,2580,2467,113,0,248,0,6
53624,2,2438,2426,12,0,104,1,6
53625,3,2474,2403,71,4,405,0,13
53626,2,2400,2445,-45,0,28,0,6
53627,2,2218,2431,-213,0,100,0,6
53628,1,2452,2364,88,0,45,0,6
53629,3,2394,2515,-121,0,101,0,8
53630,2,2410,2436,-26,0,100,0,6
53631,3,2493,2503,-10,0,120,0,6
53632,2,2521,2583,-62,0,5,1,6
53633,1,2442,2280,162,0,201,0,6
53634,1,2760,2535,225,0,110,0,6
53635,1,2411,2385,26,0,426,0,6
53636,3,2361,2410,-49,0,306,0,6
53637,1,2437,2274,163,0,112,0,6
53638,1,2768,2754,14,0,311,0,6
53639,1,2440,2369,71,0,454,0,6
53641,3,2393,2617,-224,0,5,0,6
53642,1,2463,2584,-121,0,265,0,6
53643,2,2321,2456,-135,0,392,1,6
53644,2,2231,2457,-226,0,0,0,6
53645,1,2403,2254,149,0,0,1,6
53646,1,2414,2403,11,0,253,0,6
53647,1,2423,2554,-131,0,301,0,6
53648,2,2434,2473,-39,0,28,1,6
53649,1,2434,2344,90,0,241,0,6
53650,1,2472,2706,-234,0,40,0,6
53651,3,2419,2271,148,0,15,0,6
53652,3,2421,2532,-111,0,260,0,6
53654,2,2268,2403,-135,0,40,1,6
53655,2,2373,2415,-42,0,148,0,6
53656,2,2459,2299,160,0,48,0,6
53657,1,2610,2434,176,0,315,0,6
53658,3,2317,2400,-83,0,7,0,6
53659,2,2486,2588,-102,0,40,0,6
53660,2,2250,2420,-170,0,380,0,8
53661,2,2211,2421,-210,0,8,0,6
53662,2,2348,2431,-83,0,414,1,6
53663,1,2403,2223,180,0,487,0,8
53664,3,2516,2542,-26,0,48,0,6
53665,1,2366,2475,-109,0,45,0,8
53666,1,2414,2293,121,0,130,1,6
53667,2,2452,2515,-63,0,216,1,6
53668,1,2430,2518,-88,0,300,1,6
53669,2,2395,2546,-151,0,153,0,6
53670,2,2315,2441,-126,0,247,0,6
53671,2,2394,2440,-46,0,300,0,6
53672,1,2323,2451,-128,0,3,0,6
53673,1,2765,2561,204,0,240,0,6
53674,2,2431,2390,41,0,335,1,6
53675,2,2486,2636,-150,0,4,0,6
53676,2,2416,2301,115,0,112,0,6
53677,1,2364,2445,-81,0,253,0,6
53678,2,2416,2556,-140,0,154,0,6
53679,1,2442,2212,230,0,42,0,6
53680,2,2363,2404,-41,0,193,0,6
53681,2,2432,2433,-1,0,3,0,6
53682,2,2434,2425,9,0,198,0,6
53683,2,2429,2398,31,0,0,0,6
53684,2,2262,2404,-142,0,118,0,6
53685,1,2491,2437,54,0,3,0,6
53686,3,2268,2445,-177,0,20,0,6
53687,1,2747,2606,141,0,381,0,6
53688,3,2380,2417,-37,0,258,0,6
53689,1,2449,2468,-19,0,310,0,6
53690,2,2434,2356,78,0,8,0,6
53691,2,2354,2494,-140,0,190,0,6
53692,3,2457,2578,-121,0,45,0,6
53693,2,2336,2404,-68,0,46,1,6
53694,2,2309,2460,-151,0,140,0,6
53695,2,2340,2438,-98,0,346,0,6
53696,1,2425,2531,-106,0,8,0,6
53697,2,2503,2493,10,0,200,1,6
53698,2,2274,2440,-166,0,200,0,6
53699,3,2424,2435,-11,0,112,0,6
53700,2,2272,2411,-139,0,46,0,6
53701,1,2425,2521,-96,0,440,0,6
53702,1,2410,2362,48,0,147,0,6
53703,1,2517,2462,55,0,7,0,6
53704,2,2416,2273,143,0,46,1,6
53705,1,2575,2546,29,0,46,0,6
53706,3,2459,2445,14,0,4,0,6
53707,1,2471,2527,-56,0,337,1,6
53708,2,2282,2402,-120,0,122,0,6
53709,2,2420,2368,52,0,311,0,6
53710,2,2312,2492,-180,0,319,0,6
53711,3,2492,2360,132,0,140,0,6
53712,2,2417,2300,117,0,241,1,6
53714,1,2400,2482,-82,0,101,0,6
53715,3,2457,2455,2,0,335,0,6
53716,2,2438,2427,11,0,104,0,6
53717,1,2406,2265,141,0,46,0,6
53718,1,2549,2440,109,0,4,1,6
53719,1,2522,2405,117,0,4,1,6
53720,2,2374,2442,-68,0,58,1,6
53721,1,2443,2331,112,0,210,0,6
53722,1,2520,2447,73,0,300,0,6
53723,2,2441,2557,-116,0,106,0,6
53724,1,2436,2388,48,0,45,0,6
53725,2,2411,2280,131,0,302,0,6
53726,2,2497,2218,279,0,11,0,6
53727,2,2230,2499,-269,0,40,0,6
53728,1,2423,2372,51,0,277,0,6
53729,2,2496,2481,15,0,3,0,6
53730,1,2640,2482,158,0,41,0,6
53731,3,2294,2450,-156,0,0,0,6
53732,1,2558,2418,140,0,254,0,6
53733,2,2510,2396,114,0,80,1,8
53734,1,2493,2424,69,0,324,0,6
53735,3,2463,2265,198,0,100,0,6
53736,2,2542,2558,-16,0,44,0,6
53737,1,2511,2423,88,0,190,1,6
53738,1,2424,2261,163,4,100,0,13
53739,2,2321,2435,-114,0,242,0,6
53740,2,2460,2373,87,0,40,0,8
53741,2,2421,2446,-25,0,331,0,6
53742,1,2409,2271,138,0,102,1,6
53743,1,2443,2290,153,0,1,0,6
53744,1,2438,2372,66,0,130,0,6
53745,2,2524,2416,108,0,45,0,6
53746,2,2532,2752,-220,0,13,0,6
53747,1,2406,2336,70,0,8,0,8
53748,1,2397,2537,-140,0,190,0,8
53749,1,2419,2425,-6,0,140,0,6
53750,2,2247,2414,-167,0,458,0,8
53751,1,2563,2232,331,0,0,0,6
53752,1,2662,2462,200,0,104,0,6
53753,1,2599,2285,314,0,202,1,6
53754,2,2338,2609,-271,0,49,0,6
53755,2,2574,2251,323,0,46,0,6
53756,2,2426,2404,22,0,112,0,6
53757,2,2442,2428,14,0,441,0,6
53758,2,2383,2412,-29,0,241,0,6
53759,2,2336,2414,-78,0,45,1,6
53760,1,2414,2269,145,0,405,0,6
53761,1,2562,2393,169,0,113,0,6
53762,1,2848,2604,244,0,122,0,6
53763,2,2279,2431,-152,0,43,1,6
53764,2,2264,2478,-214,0,1,0,6
53765,2,2357,2415,-58,0,306,0,6
53766,2,2312,2430,-118,0,476,0,6
53767,1,2561,2437,124,0,35,0,6
53768,2,2390,2565,-175,0,247,0,6
53769,2,2231,2493,-262,0,121,0,6
53770,2,2233,2409,-176,0,144,1,6
53771,2,2344,2413,-69,0,448,1,6
53772,2,2383,2441,-58,0,127,0,6
53773,1,2497,2397,100,0,268,0,6
53774,1,2445,2458,-13,0,47,0,6
53775,2,2541,2438,103,0,100,0,6
53776,2,2443,2312,131,0,250,0,6
53777,1,2451,2304,147,0,0,0,6
53778,1,2516,2583,-67,0,411,0,6
53779,1,2420,2352,68,0,414,0,6
53780,2,2261,2410,-149,0,380,1,6
53781,2,2495,2291,204,0,0,0,6
53782,2,2475,2254,221,0,4,1,6
53783,3,2253,2402,-149,0,453,0,8
53784,1,2405,2258,147,4,385,0,13
53785,2,2433,2433,0,0,3,0,6
53786,1,2406,2301,105,0,96,0,6
53787,1,2375,2414,-39,0,148,1,6
53788,1,2357,2478,-121,0,43,1,6
53789,1,2228,2405,-177,0,231,0,8
53790,2,2403,2393,10,0,19,0,6
53791,1,2754,2770,-16,0,382,0,6
53792,1,2436,2410,26,0,40,0,6
53793,2,2452,2490,-38,0,40,0,6
53794,2,2288,2462,-174,0,107,0,6
53795,1,2487,2501,-14,0,43,0,6
53796,1,2327,2447,-120,0,3,0,6
53797,1,2553,2490,63,0,4,0,6
53798,2,2513,2588,-75,0,6,0,6
53799,1,2400,2526,-126,0,300,0,6
53800,2,2524,2439,85,0,106,0,6
53801,1,2271,2406,-135,0,300,0,8
53802,1,2336,2407,-71,0,41,0,6
53803,2,2479,2643,-164,0,454,0,6
53804,1,2261,2496,-235,0,154,1,6
53805,1,2408,2403,5,0,150,0,6
53806,2,2446,2393,53,0,25,1,6
53807,1,2430,2307,123,0,112,0,6
53808,1,2568,2387,181,0,113,0,6
53809,3,2564,2533,31,0,245,0,6
53810,1,2600,2329,271,0,130,0,6
53811,1,2509,2515,-6,0,301,0,6
53812,2,2410,2436,-26,0,19,0,6
53813,1,2381,2400,-19,0,106,1,6
53814,2,2419,2379,40,0,56,0,6
53815,3,2298,2487,-189,0,112,0,6
53816,2,2283,2533,-250,0,40,0,6
53817,1,2363,2428,-65,0,304,0,6
53818,2,2380,2447,-67,0,45,0,8
53819,3,2397,2447,-50,0,6,0,6
53821,1,2530,2384,146,0,65,1,6
53822,3,2528,2660,-132,0,13,0,6
53823,2,2443,2426,17,0,414,1,6
53824,1,2590,2287,303,0,45,0,6
53825,2,2433,2558,-125,0,113,0,6
53826,2,2435,2424,11,0,163,1,6
53827,1,2441,2378,63,0,40,0,6
53828,2,2565,2446,119,0,34,0,6
53829,2,2383,2404,-21,0,40,1,6
53830,1,2413,2299,114,0,151,1,6
53831,2,2412,2287,125,0,382,1,6
53832,1,2419,2309,110,4,315,0,13
53833,2,2525,2564,-39,0,49,0,6
53834,1,2315,2425,-110,0,257,0,6
53835,2,2509,2485,24,0,101,1,6
53836,2,2419,2685,-266,0,483,0,6
53837,1,2515,2515,0,0,414,0,6
53838,2,2424,2517,-93,0,307,0,6
53839,1,2760,2761,-1,0,211,0,6
53841,1,2451,2379,72,0,302,1,6
53842,2,2292,2403,-111,0,380,0,6
53843,1,2495,2493,2,0,241,1,6
53844,1,2347,2424,-77,0,306,0,6
53845,1,2329,2466,-137,0,101,1,6
53846,1,2435,2262,173,0,311,0,6
53847,2,2573,2571,2,0,46,0,6
53848,2,2413,2366,47,0,40,0,6
53849,1,2448,2397,51,0,374,0,6
53850,1,2446,2343,103,0,300,0,6
53851,3,2442,2427,15,0,244,0,6
53852,1,2501,2206,295,0,20,0,6
53853,2,2245,2542,-297,0,111,1,6
53854,2,2615,2671,-56,0,123,0,6
53855,1,2410,2247,163,0,116,0,6
53856,3,2562,2576,-14,0,303,0,6
53857,1,2419,2336,83,0,218,0,6
53858,2,2419,2661,-242,0,133,0,6
53859,2,2314,2404,-90,0,123,0,6
53860,1,2439,2335,104,0,210,0,6
53861,1,2511,2371,140,0,62,0,6
53862,1,2534,2554,-20,0,107,0,6
53863,1,2417,2334,83,0,100,0,8
53864,1,2291,2591,-300,0,100,0,6
53865,1,2500,2523,-23,0,30,0,6
53866,3,2481,2512,-31,0,41,0,6
53867,3,2407,2381,26,0,9,0,6
53868,2,2239,2527,-288,0,310,0,6
53869,2,2460,2601,-141,0,326,1,6
53870,1,2537,2343,194,0,205,0,6
53871,1,2298,2441,-143,0,5,0,6
53872,1,2465,2332,133,0,227,0,6
53873,1,2544,2365,179,0,40,1,6
53874,2,2281,2453,-172,0,34,0,6
53875,2,2405,2469,-64,4,112,1,13
53877,3,2453,2307,146,0,107,0,6
53878,1,2436,2402,34,0,365,0,6
53879,2,2418,2521,-103,0,207,0,6
53880,1,2530,2520,10,0,211,1,6
53881,2,2510,2521,-11,0,40,0,6
53882,1,2376,2400,-24,0,125,0,6
53883,1,2238,2438,-200,0,15,0,6
53884,1,2658,2531,127,0,112,0,6
53885,3,2220,2469,-249,0,123,0,6
53887,2,2452,2517,-65,0,151,1,6
53888,1,2397,2497,-100,0,300,0,6
53889,1,2401,2385,16,0,202,0,6
53890,2,2434,2370,64,0,210,0,6
53891,2,2534,2563,-29,0,132,0,6
53892,1,2235,2495,-260,0,140,0,6
53893,3,2400,2390,10,0,201,0,8
53894,2,2418,2341,77,0,337,0,6
53895,2,2385,2437,-52,0,265,0,6
53896,2,2509,2685,-176,0,111,0,6
53897,2,2421,2285,136,0,385,0,6
53898,2,2327,2506,-179,0,132,0,6
53899,1,2497,2413,84,0,320,0,6
53900,2,2283,2503,-220,0,200,0,6
53901,2,2417,2354,63,0,414,1,6
53902,2,2517,2565,-48,0,411,1,6
53903,1,2223,2581,-358,0,133,0,6
53904,1,2689,2417,272,0,123,0,6
53905,2,2562,2495,67,0,4,1,6
53906,1,2450,2380,70,0,81,1,6
53908,1,2577,2429,148,0,109,0,6
53909,1,2331,2443,-112,0,3,0,6
53910,3,2417,2417,0,0,454,0,6
53911,2,2310,2442,-132,0,476,0,6
53912,1,2755,2770,-15,0,61,0,6
53913,1,2399,2514,-115,0,46,0,6
53914,1,2333,2410,-77,0,100,0,6
53915,3,2430,2364,66,0,245,0,6
53916,2,2407,2245,162,0,41,0,6
53917,2,2373,2503,-130,0,127,0,6
53918,1,2408,2355,53,0,118,1,6
53919,1,2516,2420,96,0,453,0,6
53920,1,2663,2416,247,0,190,0,6
53921,1,2499,2278,221,0,101,0,6
53922,2,2576,2562,14,0,103,0,6
53923,2,2295,2456,-161,0,142,0,6
53924,1,2435,2453,-18,0,101,0,6
53925,2,2401,2382,19,0,200,0,6
53926,1,2587,2501,86,0,110,0,6
53927,2,2435,2509,-74,0,13,0,6
53928,2,2381,2464,-83,0,130,1,6
53929,1,2436,2339,97,0,210,0,6
53930,2,2427,2368,59,0,2,0,6
53931,1,2423,2455,-32,0,141,1,6
53933,1,2488,2555,-67,0,220,1,6
53934,3,2313,2407,-94,0,43,0,6
53935,2,2450,2502,-52,0,456,0,6
53936,1,2470,2456,14,0,151,0,8
53937,1,2442,2380,62,0,150,0,6
53938,1,2381,2407,-26,0,218,1,6
53939,2,2490,2491,-1,0,106,0,6
53940,2,2432,2414,18,0,150,1,6
53941,2,2304,2422,-118,0,4,1,6
53942,1,2394,2456,-62,0,344,0,6
53943,2,2371,2438,-67,0,40,1,6
53944,1,2478,2275,203,0,140,0,6
53945,1,2391,2400,-9,0,255,0,8
53946,2,2525,2662,-137,0,84,0,6
53947,2,2568,2471,97,0,150,1,6
53948,1,2481,2441,40,0,331,0,6
53949,2,2527,2498,29,0,381,0,6
53950,3,2571,2377,194,0,41,0,6
53951,1,2276,2427,-151,0,178,0,6
53952,1,2414,2404,10,0,100,0,6
53953,2,2525,2540,-15,0,45,0,6
53954,1,2604,2216,388,0,110,1,6
53955,2,2403,2292,111,0,45,0,6
53956,1,2459,2334,125,0,40,0,6
53957,2,2314,2455,-141,0,40,1,6
53958,1,2548,2547,1,0,211,0,6
53959,1,2433,2362,71,0,133,1,6
53960,2,2760,2761,-1,0,211,0,6
53961,2,2527,2504,23,0,331,0,6
53962,2,2423,2366,57,0,15,0,6
53963,2,2324,2446,-122,0,480,1,8
53964,1,2417,2211,206,0,130,1,6
53965,2,2248,2450,-202,0,198,1,6
53966,1,2567,2298,269,0,57,0,6
53967,1,2676,2514,162,0,107,0,6
53968,1,2507,2523,-16,0,70,0,6
53969,2,2610,2520,90,0,265,0,6
53970,1,2605,2534,71,0,156,0,6
53971,3,2551,2531,20,0,302,0,6
53972,1,2516,2601,-85,0,4,0,6
53973,3,2563,2543,20,0,136,0,6
53974,1,2573,2495,78,0,188,0,6
53975,1,2435,2568,-133,0,192,0,6
53976,1,2495,2567,-72,0,487,0,6
53977,1,2476,2376,100,0,100,0,8
53978,2,2505,2416,89,0,222,1,6
53979,2,2511,2593,-82,0,300,0,6
53980,2,2341,2520,-179,0,241,1,6
53981,3,2514,2666,-152,0,49,0,6
53982,2,2415,2693,-278,0,311,0,6
53983,1,2401,2361,40,0,4,0,6
53984,2,2318,2413,-95,0,380,0,6
53985,2,2502,2532,-30,0,448,0,6
53986,2,2358,2487,-129,0,441,0,6
53987,1,2295,2445,-150,0,200,1,6
53988,2,2408,2419,-11,0,56,1,6
53989,1,2447,2421,26,0,102,0,6
53990,2,2298,2403,-105,0,100,1,6
53991,1,2665,2520,145,0,311,0,6
53992,1,2509,2497,12,0,308,0,6
53993,2,2414,2666,-252,0,133,0,6
53994,2,2407,2218,189,0,121,0,6
53995,1,2435,2224,211,0,335,0,6
53996,1,2426,2580,-154,0,240,0,6
53997,2,2356,2414,-58,0,131,0,6
53998,1,2478,2572,-94,0,411,0,6
53999,2,2533,2419,114,0,81,0,6
54000,1,2421,2262,159,0,110,0,6
54001,3,2361,2411,-50,0,40,0,6
54002,2,2443,2499,-56,0,6,0,6
54003,3,2416,2310,106,0,250,0,6
54004,2,2554,2555,-1,0,211,0,6
54005,1,2417,2266,151,0,374,0,6
54006,1,2410,2326,84,0,5,0,8
54007,2,2407,2568,-161,0,46,0,6
54008,1,2402,2232,170,0,202,0,6
54009,1,2465,2280,185,0,204,0,6
54010,1,2529,2225,304,0,400,0,6
54011,1,2255,2421,-166,0,9,0,8
54012,2,2328,2452,-124,0,45,0,6
54013,2,2429,2310,119,0,107,1,6
54014,1,2519,2324,195,0,300,0,6
54015,2,2445,2523,-78,0,301,0,6
54016,3,2335,2491,-156,0,230,0,6
54017,2,2448,2350,98,0,112,0,6
54018,3,2509,2438,71,0,483,0,6
54019,1,2419,2492,-73,0,290,1,6
54020,2,2332,2413,-81,0,45,1,6
54021,1,2397,2424,-27,0,57,0,6
54022,2,2447,2411,36,0,4,0,6
54023,2,2349,2438,-89,0,45,0,6
54024,1,2451,2291,160,0,15,0,6
54025,1,2516,2463,53,0,300,0,6
54026,1,2440,2297,143,0,241,0,6
54027,1,2301,2443,-142,0,106,1,6
54028,2,2375,2451,-76,0,106,0,6
54029,1,2366,2491,-125,4,113,0,13
54030,1,2486,2333,153,0,80,1,6
54031,1,2429,2376,53,0,162,0,6
54032,2,2546,2543,3,0,211,0,6
54033,1,2443,2401,42,0,311,0,6
54034,2,2546,2520,26,0,216,0,6
54035,1,2450,2272,178,0,41,0,6
54036,1,2414,2404,10,0,250,1,6
54037,2,2401,2349,52,0,4,0,6
54038,2,2417,2441,-24,0,386,1,6
54039,1,2405,2315,90,0,110,0,6
54040,2,2455,2494,-39,0,45,0,6
54041,1,2426,2331,95,0,122,0,6
54042,1,2537,2497,40,0,405,0,6
54043,1,2696,2413,283,0,121,1,6
54044,2,2433,2561,-128,0,485,0,6
54045,1,2668,2411,257,0,151,0,6
54046,1,2461,2311,150,0,107,0,6
54047,3,2767,2750,17,0,380,0,6
54048,2,2331,2452,-121,0,2,0,6
54049,2,2536,2517,19,0,3,0,6
54050,3,2430,2521,-91,0,28,0,6
54051,1,2401,2315,86,0,113,1,8
54052,2,2441,2418,23,0,132,0,6
54053,3,2688,2648,40,0,101,0,6
54054,2,2508,2271,237,0,463,0,6
54055,1,2439,2379,60,0,455,0,6
54056,2,2417,2299,118,0,380,1,6
54057,2,2491,2515,-24,0,131,0,6
54058,1,2407,2338,69,0,331,0,6
54059,2,2258,2426,-168,0,0,0,6
54060,1,2851,2607,244,0,122,0,6
54061,1,2437,2234,203,0,277,0,6
54062,1,2230,2402,-172,0,49,0,6
54063,3,2406,2308,98,0,4,0,6
54064,1,2222,2405,-183,0,112,0,6
54066,1,2455,2399,56,0,46,1,6
54067,3,2425,2456,-31,0,312,0,6
54068,2,2455,2427,28,4,88,0,13
54069,1,2612,2280,332,0,121,0,6
54070,1,2560,2452,108,0,0,0,6
54071,1,2302,2437,-135,0,211,0,6
54072,1,2510,2565,-55,0,301,1,6
54073,3,2263,2408,-145,0,4,0,6
54074,2,2370,2420,-50,0,311,1,6
54075,2,2342,2669,-327,0,111,1,6
54076,1,2459,2335,124,0,114,0,6
54077,2,2410,2362,48,0,122,1,6
54078,2,2403,2404,-1,0,338,0,6
54079,1,2427,2363,64,0,112,0,6
54080,3,2571,2486,85,0,40,0,6
54081,2,2526,2572,-46,0,51,0,6
54082,1,2231,2400,-169,0,245,1,8
54083,1,2405,2339,66,0,455,0,6
54084,2,2562,2257,305,0,115,0,6
54085,2,2424,2314,110,0,122,0,6
54086,1,2401,2259,142,0,0,1,6
54087,2,2439,2394,45,0,4,0,6
54088,1,2550,2448,102,0,40,0,6
54089,3,2560,2224,336,0,49,0,6
54090,2,2553,2512,41,0,101,1,6
54091,1,2488,2220,268,0,335,1,6
54092,2,2411,2300,111,0,127,1,6
54093,2,2532,2406,126,0,474,0,6
54094,1,2239,2562,-323,0,53,0,6
54095,2,2344,2497,-153,0,131,0,6
54096,2,2279,2577,-298,0,284,0,6
54097,1,2263,2538,-275,0,123,0,6
54098,2,2606,2679,-73,0,123,0,6
54099,1,2426,2440,-14,0,1,0,6
54100,1,2497,2610,-113,0,46,0,6
54101,1,2420,2398,22,0,373,0,6
54102,2,2527,2399,128,0,320,0,6
54103,2,2340,2520,-180,0,45,0,6
54104,1,2431,2288,143,0,176,0,6
54105,2,2381,2502,-121,0,45,0,6
54106,1,2493,2491,2,0,200,0,6
54107,3,2365,2523,-158,0,45,0,6
54108,1,2510,2298,212,0,278,0,6
54109,1,2561,2248,313,0,335,0,6
54110,1,2517,2354,163,0,200,0,6
54111,1,2491,2348,143,0,43,0,6
54112,1,2417,2330,87,0,211,0,6
54113,2,2357,2404,-47,0,375,1,6
54114,3,2368,2418,-50,0,38,0,6
54115,1,2540,2561,-21,0,15,0,6
54116,1,2417,2371,46,0,103,1,6
54117,1,2565,2434,131,0,107,0,6
54118,2,2409,2670,-261,0,133,1,6
54119,1,2503,2327,176,0,210,0,6
54120,2,2417,2302,115,0,103,0,6
54121,1,2492,2542,-50,0,344,0,6
54122,2,2279,2402,-123,0,190,0,6
54123,1,2453,2321,132,0,46,0,6
54124,3,2359,2402,-43,0,15,0,6
54125,2,2381,2454,-73,0,195,0,6
54126,2,2431,2232,199,0,45,0,6
54127,2,2482,2523,-41,0,210,1,6
54128,2,2392,2464,-72,0,150,0,6
54129,2,2407,2426,-19,0,150,0,6
54130,2,2526,2539,-13,0,45,1,6
54131,2,2430,2335,95,0,211,0,6
54132,3,2442,2254,188,0,243,0,6
54133,1,2507,2527,-20,0,1,0,6
54134,1,2497,2324,173,0,153,0,6
54135,2,2371,2450,-79,0,133,0,6
54136,2,2282,2438,-156,0,101,1,6
54137,1,2372,2480,-108,0,45,0,8
54138,1,2854,2355,499,0,456,0,6
54139,1,2353,2449,-96,0,140,0,6
54140,1,2472,2429,43,0,125,0,6
54141,1,2472,2373,99,0,100,0,6
54142,1,2280,2552,-272,0,120,0,6
54143,1,2266,2499,-233,0,4,0,6
54144,2,2418,2265,153,0,62,1,8
54145,1,2503,2441,62,0,100,0,6
54146,2,2411,2420,-9,0,20,0,6
54147,2,2298,2457,-159,0,491,0,6
54148,1,2402,2370,32,0,211,0,8
54149,1,2383,2423,-40,4,40,0,13
54150,2,2751,2767,-16,0,211,0,6
54151,3,2229,2538,-309,0,302,0,6
54152,1,2444,2251,193,0,490,0,6
54153,1,2304,2417,-113,0,13,0,6
54154,3,2425,2555,-130,0,13,0,6
54155,1,2412,2333,79,0,253,0,6
54156,2,2565,2245,320,0,0,0,6
54157,3,2448,2396,52,0,314,0,6
54158,3,2346,2416,-70,0,341,0,6
54159,1,2310,2410,-100,0,16,1,6
54160,1,2453,2330,123,0,302,0,8
54161,1,2430,2569,-139,0,123,1,6
54162,1,2406,2327,79,0,302,0,6
54163,2,2455,2546,-91,0,211,0,6
54164,1,2486,2507,-21,0,200,0,6
54165,1,2429,2577,-148,0,22,0,6
54166,1,2412,2291,121,0,469,0,6
54167,1,2520,2431,89,0,337,0,6
54168,2,2597,2547,50,0,255,1,6
54169,2,2401,2426,-25,0,337,0,6
54170,2,2404,2232,172,0,142,0,6
54171,1,2409,2322,87,0,334,1,6
54172,1,2444,2409,35,0,311,0,6
54173,2,2447,2554,-107,0,1,0,6
54174,2,2268,2456,-188,0,464,0,6
54175,2,2550,2451,99,0,30,0,6
54176,2,2387,2505,-118,0,20,0,6
54177,2,2218,2854,-636,0,388,1,6
54178,1,2408,2312,96,0,122,0,6
54179,1,2352,2405,-53,0,116,0,8
54180,2,2411,2378,33,0,302,1,6
54181,2,2425,2407,18,0,15,0,6
54182,1,2417,2477,-60,0,455,0,6
54183,2,2487,2570,-83,0,8,0,6
54184,1,2556,2233,323,0,48,0,6
54185,1,2407,2521,-114,0,154,0,6
54186,2,2424,2325,99,0,483,0,6
54187,1,2255,2406,-151,0,10,1,6
54188,2,2439,2495,-56,0,123,0,6
54189,2,2339,2432,-93,0,200,0,6
54190,1,2542,2358,184,0,113,0,6
54191,1,2259,2490,-231,0,4,0,6
54192,3,2403,2486,-83,0,277,0,6
54193,1,2301,2429,-128,0,263,0,8
54194,2,2270,2402,-132,0,295,1,6
54195,2,2340,2444,-104,0,0,1,6
54196,2,2528,2531,-3,0,83,0,6
54197,2,2255,2533,-278,0,454,0,6
54198,2,2288,2409,-121,0,45,1,6
54199,2,2672,2407,265,0,151,0,6
54200,1,2431,2438,-7,0,49,1,6
54201,2,2536,2626,-90,0,400,0,6
54202,1,2455,2367,88,0,455,0,6
54203,1,2615,2443,172,0,103,0,6
54204,1,2558,2328,230,0,1,0,6
54205,2,2360,2446,-86,0,120,0,6
54206,2,2403,2360,43,0,106,0,6
54207,2,2407,2319,88,0,140,0,6
54208,1,2569,2498,71,0,121,0,6
54209,2,2401,2360,41,0,483,0,6
54210,2,2277,2428,-151,0,263,0,6
54211,2,2545,2521,24,0,200,0,6
54212,3,2412,2300,112,0,455,0,6
54213,1,2330,2432,-102,0,4,0,6
54214,1,2427,2500,-73,0,15,1,6
54215,1,2684,2498,186,0,148,0,6
54216,2,2407,2376,31,0,110,0,6
54217,2,2372,2504,-132,0,4,0,6
54218,1,2506,2479,27,0,335,0,6
54219,1,2321,2401,-80,0,123,1,6
54220,2,2377,2528,-151,0,330,0,6
54221,1,2420,2520,-100,0,107,0,6
54222,2,2393,2602,-209,0,301,1,6
54223,1,2602,2562,40,0,190,0,6
54224,1,2217,2491,-274,0,140,0,6
54225,2,2513,2337,176,0,102,1,6
54226,2,2388,2611,-223,0,382,1,6
54227,1,2482,2504,-22,0,102,0,6
54228,1,2551,2367,184,0,200,1,6
54229,1,2414,2228,186,0,131,0,6
54230,2,2314,2435,-121,0,380,0,6
54231,1,2579,2275,304,0,282,0,6
54232,2,2521,2545,-24,0,5,0,6
54233,1,2525,2212,313,0,411,0,6
54234,1,2565,2236,329,0,481,0,6
54235,1,2358,2426,-68,0,138,0,6
54236,2,2349,2455,-106,0,198,0,6
54237,2,2483,2469,14,0,113,0,6
54238,1,2410,2312,98,0,5,0,6
54239,2,2289,2464,-175,0,13,0,6
54240,2,2257,2664,-407,0,43,0,6
54241,1,2315,2460,-145,0,103,0,6
54242,3,2401,2490,-89,0,25,0,6
54243,1,2521,2544,-23,0,80,0,6
54244,1,2446,2415,31,0,102,0,8
54245,1,2439,2299,140,0,143,0,6
54246,1,2436,2508,-72,0,301,0,6
54247,2,2406,2532,-126,0,46,0,6
54248,1,2421,2401,20,0,37,0,6
54249,3,2276,2408,-132,0,452,0,8
54250,2,2307,2455,-148,0,133,0,6
54251,1,2231,2400,-169,0,330,0,6
54252,2,2557,2449,108,0,40,0,6
54253,3,2404,2253,151,0,300,0,6
54254,2,2523,2404,119,0,463,0,6
54255,1,2426,2547,-121,0,255,0,6
54256,3,2362,2416,-54,0,123,0,6
54257,3,2375,2513,-138,0,428,0,6
54258,1,2494,2574,-80,0,51,0,6
54259,1,2341,2414,-73,0,119,0,6
54260,2,2256,2603,-347,0,43,0,6
54261,1,2500,2422,78,0,269,0,6
54262,1,2339,2472,-133,0,132,0,8
54263,3,2543,2492,51,0,20,0,6
54264,2,2422,2343,79,0,200,0,6
54265,1,2427,2524,-97,0,11,0,6
54266,3,2459,2310,149,0,45,0,6
54267,2,2417,2434,-17,0,7,1,6
54268,1,2414,2500,-86,0,90,1,6
54269,2,2310,2485,-175,0,301,1,6
54270,2,2311,2525,-214,0,150,0,8
54271,2,2263,2423,-160,0,107,0,6
54272,2,2240,2561,-321,0,43,0,6
54273,2,2537,2274,263,0,2,0,6
54274,2,2522,2534,-12,0,307,0,6
54275,2,2454,2501,-47,0,200,0,6
54276,1,2459,2377,82,0,15,0,6
54277,1,2478,2326,152,0,201,0,6
54278,2,2287,2419,-132,0,100,0,6
54279,2,2413,2373,40,0,112,0,6
54280,1,2429,2276,153,0,253,0,6
54281,1,2454,2561,-107,0,4,0,6
54282,2,2417,2663,-246,0,133,0,6
54283,3,2433,2241,192,0,100,0,6
54284,2,2509,2497,12,0,246,0,6
54285,2,2342,2416,-74,0,211,0,6
54286,1,2574,2483,91,0,45,0,6
54287,1,2451,2280,171,0,311,0,6
54288,2,2272,2435,-163,0,277,0,6
54289,1,2855,2338,517,0,245,0,6
54290,2,2511,2517,-6,0,0,0,6
54291,2,2485,2259,226,0,115,0,6
54292,2,2385,2407,-22,0,48,0,6
54293,2,2405,2404,1,0,150,0,6
54294,1,2567,2501,66,0,215,0,6
54295,2,2456,2525,-69,0,150,0,6
54296,1,2406,2266,140,0,143,0,6
54297,1,2488,2352,136,0,315,0,6
54298,1,2471,2412,59,0,248,0,6
54299,2,2212,2407,-195,0,392,0,8
54300,2,2539,2274,265,0,40,0,6
54301,3,2443,2284,159,0,132,0,6
54302,2,2314,2479,-165,0,0,0,6
54303,1,2413,2437,-24,0,45,0,6
54304,1,2440,2352,88,0,345,0,6
54305,1,2448,2336,112,0,102,1,6
54306,2,2340,2773,-433,0,200,0,6
54307,2,2459,2298,161,0,61,0,8
54308,3,2409,2312,97,0,201,0,6
54309,3,2527,2539,-12,0,45,0,6
54310,1,2553,2458,95,0,130,0,6
54311,1,2321,2468,-147,0,84,0,6
54312,2,2256,2556,-300,0,48,0,6
54313,1,2517,2319,198,0,337,0,6
54314,1,2535,2558,-23,0,43,0,6
54315,1,2418,2402,16,0,112,0,6
54316,2,2303,2432,-129,0,255,0,6
54317,1,2415,2247,168,0,4,0,6
54318,1,2395,2459,-64,0,133,1,6
54319,2,2495,2362,133,0,455,0,6
54320,1,2444,2348,96,0,405,0,6
54321,1,2431,2394,37,0,106,0,6
54322,2,2410,2415,-5,0,365,0,8
54323,2,2235,2522,-287,0,16,0,6
54324,1,2470,2438,32,0,108,1,6
54325,1,2330,2423,-93,0,344,0,6
54326,1,2235,2414,-179,0,305,0,6
54327,2,2540,2520,20,0,211,0,6
54328,1,2503,2360,143,0,81,0,6
54329,1,2410,2344,66,0,30,0,6
54330,1,2641,2591,50,0,30,0,6
54331,1,2451,2370,81,0,301,0,6
54332,2,2433,2419,14,0,112,0,6
54333,2,2431,2535,-104,0,46,0,6
54334,1,2465,2347,118,0,152,0,8
54335,2,2478,2579,-101,0,8,0,6
54336,1,2260,2400,-140,0,10,0,6
54337,2,2493,2542,-49,0,132,0,6
54338,2,2408,2377,31,0,190,0,6
54339,2,2373,2452,-79,0,200,0,6
54340,1,2455,2374,81,0,202,0,6
54341,1,2554,2393,161,0,371,0,6
54342,2,2444,2563,-119,0,331,1,6
54343,1,2280,2403,-123,0,140,0,6
54344,2,2323,2430,-107,0,170,0,6
54345,2,2200,2423,-223,0,310,0,6
54346,2,2244,2454,-210,0,101,0,6
54347,2,2372,2463,-91,0,195,0,6
54348,2,2449,2472,-23,0,218,1,6
54349,1,2516,2258,258,0,317,0,6
54350,2,2385,2553,-168,0,271,0,6
54351,1,2531,2329,202,0,121,0,6
54352,2,2595,2328,267,0,15,0,6
54353,2,2222,2604,-382,0,13,0,6
54354,2,2419,2530,-111,0,313,0,6
54355,1,2495,2380,115,0,130,0,6
54356,2,2273,2608,-335,0,256,0,6
54357,1,2474,2368,106,0,210,0,6
54358,1,2532,2315,217,0,406,1,6
54359,2,2425,2368,57,0,1,0,6
54360,1,2546,2437,109,0,474,0,6
54361,2,2332,2492,-160,0,200,0,6
54362,3,2413,2554,-141,0,112,0,6
54363,3,2604,2401,203,0,225,0,6
54364,2,2372,2529,-157,0,45,1,6
54365,1,2382,2417,-35,0,250,0,6
54366,1,2581,2425,156,0,123,0,6
54367,2,2439,2338,101,0,270,0,6
54368,1,2508,2434,74,0,110,0,6
54369,1,2550,2567,-17,0,310,0,6
54370,2,2459,2301,158,0,43,0,6
54371,3,2382,2512,-130,0,46,0,6
54373,1,2486,2297,189,0,0,0,6
54374,1,2272,2432,-160,0,4,0,6
54375,2,2254,2476,-222,0,101,0,6
54376,3,2418,2518,-100,0,374,0,6
54377,2,2250,2476,-226,0,57,0,6
54378,2,2331,2488,-157,0,131,0,6
54379,1,2484,2439,45,0,202,0,6
54380,2,2503,2477,26,2,319,0,30
54381,1,2665,2414,251,0,151,1,6
54382,1,2417,2470,-53,0,102,0,6
54383,1,2538,2591,-53,0,6,0,6
54384,2,2279,2413,-134,0,302,0,6
54385,2,2254,2484,-230,0,0,0,6
54386,2,2407,2348,59,0,122,0,6
54387,2,2422,2336,86,0,145,0,8
54388,2,2457,2475,-18,0,45,0,6
54389,2,2496,2572,-76,0,52,0,6
54390,1,2327,2421,-94,0,13,0,6
54391,2,2451,2376,75,0,120,1,6
54392,1,2460,2300,160,0,4,1,6
54393,2,2547,2488,59,0,0,0,6
54394,1,2417,2275,142,0,43,0,6
54395,1,2339,2435,-96,0,80,1,6
54396,2,2410,2390,20,0,269,1,8
54397,2,2530,2530,0,0,46,0,6
54398,1,2421,2338,83,0,56,0,6
54399,1,2419,2233,186,0,123,0,6
54400,1,2488,2316,172,0,310,0,6
54401,1,2606,2346,260,0,105,0,6
54402,1,2412,2241,171,0,225,0,6
54403,1,2457,2379,78,0,335,0,6
54404,2,2466,2401,65,4,120,0,13
54405,2,2454,2329,125,0,302,1,6
54406,1,2774,2519,255,0,311,0,6
54407,2,2309,2422,-113,4,45,1,8
54408,1,2558,2268,290,0,0,0,6
54409,1,2267,2489,-222,0,354,1,6
54410,2,2263,2409,-146,0,118,0,6
54411,1,2404,2316,88,0,327,0,6
54412,1,2389,2501,-112,0,487,0,6
54413,3,2365,2456,-91,0,352,0,6
54414,2,2395,2506,-111,0,4,0,6
54415,1,2332,2452,-120,0,0,0,6
54416,2,2308,2442,-134,0,120,0,6
54417,2,2539,2527,12,0,200,0,6
54418,2,2370,2418,-48,0,120,0,6
54419,2,2313,2492,-179,0,415,1,6
54420,1,2436,2384,52,0,405,0,6
54421,1,2446,2268,178,0,387,1,8
54422,2,2450,2412,38,0,484,0,6
54423,1,2414,2323,91,0,41,0,6
54424,2,2275,2404,-129,0,113,0,6
54425,1,2508,2257,251,0,127,0,6
54426,1,2541,2448,93,0,106,0,6
54427,2,2487,2360,127,0,307,0,6
54428,1,2469,2379,90,0,100,0,8
54429,2,2367,2461,-94,0,6,0,6
54430,2,2425,2427,-2,0,303,0,6
54431,1,2370,2487,-117,0,200,0,6
54432,2,2349,2415,-66,0,409,0,6
54433,1,2584,2541,43,0,190,0,6
54434,1,2425,2359,66,0,13,1,6
54435,1,2434,2442,-8,0,123,0,6
54436,1,2330,2526,-196,0,0,0,6
54437,2,2393,2473,-80,0,454,0,6
54438,2,2495,2541,-46,0,130,0,6
54439,1,2624,2352,272,0,34,0,6
54440,1,2310,2444,-134,0,45,0,6
54441,1,2424,2280,144,0,224,0,6
54442,2,2426,2441,-15,0,343,1,6
54443,1,2251,2479,-228,0,331,0,6
54444,3,2557,2375,182,0,377,0,6
54445,1,2309,2461,-152,0,111,0,6
54446,1,2481,2451,30,0,100,0,6
54447,1,2855,2207,648,0,122,0,6
54448,2,2402,2425,-23,0,113,0,6
54449,1,2533,2533,0,0,45,0,6
54450,2,2523,2505,18,0,387,0,6
54451,1,2487,2231,256,0,45,0,6
54452,1,2255,2415,-160,0,111,0,6
54453,2,2434,2238,196,0,145,0,6
54454,1,2268,2401,-133,0,100,1,6
54455,2,2428,2440,-12,0,208,1,6
54456,2,2552,2586,-34,0,151,0,6
54457,1,2530,2232,298,0,225,0,6
54458,3,2302,2609,-307,0,125,0,6
54459,2,2287,2403,-116,0,0,0,6
54460,2,2288,2414,-126,4,26,1,13
54461,1,2468,2368,100,0,15,0,6
54462,2,2444,2340,104,0,102,0,6
54463,2,2576,2492,84,0,121,0,6
54464,1,2417,2462,-45,4,302,0,13
54465,1,2314,2408,-94,0,330,0,6
54466,3,2369,2445,-76,0,131,0,6
54467,2,2413,2321,92,0,35,1,6
54468,1,2299,2415,-116,0,226,1,6
54469,2,2234,2401,-167,0,248,0,6
54470,1,2412,2270,142,0,302,0,6
54471,2,2412,2667,-255,0,133,1,6
54472,2,2217,2856,-639,0,388,1,6
54473,1,2567,2517,50,0,310,0,6
54474,1,2423,2524,-101,0,167,1,6
54475,3,2375,2473,-98,0,45,0,8
54476,1,2478,2470,8,0,415,1,6
54477,2,2410,2539,-129,0,202,1,6
54478,2,2413,2259,154,0,429,0,6
54479,1,2568,2562,6,0,43,0,6
54480,1,2344,2459,-115,4,15,0,13
54481,1,2510,2328,182,0,122,0,6
54482,3,2297,2404,-107,0,377,0,8
54483,1,2431,2292,139,4,127,1,13
54484,3,2397,2444,-47,0,466,0,6
54485,2,2428,2408,20,0,101,0,6
54486,1,2452,2329,123,0,288,0,8
54487,1,2286,2404,-118,0,300,0,8
54488,1,2459,2368,91,0,41,0,6
54489,2,2301,2585,-284,0,440,0,6
54490,2,2392,2498,-106,0,301,1,6
54491,2,2241,2419,-178,0,143,1,6
54492,2,2223,2603,-380,0,458,0,6
54493,1,2433,2318,115,0,263,1,6
54494,2,2410,2304,106,0,240,1,6
54495,1,2517,2601,-84,0,37,0,6
54496,2,2307,2521,-214,0,110,0,6
54497,1,2557,2386,171,0,112,0,6
54498,1,2404,2469,-65,0,122,0,6
54499,3,2338,2499,-161,0,124,0,6
54501,2,2551,2495,56,0,455,0,6
54502,1,2429,2348,81,0,242,0,6
54503,3,2421,2550,-129,0,267,0,6
54504,3,2609,2432,177,0,154,0,6
54505,1,2255,2534,-279,0,269,0,6
54506,1,2606,2317,289,0,112,0,6
54507,3,2438,2451,-13,0,152,0,6
54508,1,2497,2534,-37,0,248,0,6
54509,2,2294,2534,-240,0,354,1,6
54510,2,2430,2350,80,0,15,0,6
54511,1,2479,2384,95,0,337,1,6
54512,3,2684,2556,128,0,136,0,6
54513,3,2510,2389,121,0,45,0,6
54514,2,2309,2513,-204,0,2,0,6
54515,3,2535,2584,-49,0,49,0,6
54516,3,2492,2436,56,0,376,0,6
54517,3,2312,2422,-110,0,82,0,6
54518,1,2399,2463,-64,0,203,0,6
54519,1,2712,2776,-64,0,211,0,6
54520,2,2296,2422,-126,0,103,0,6
54521,1,2517,2583,-66,0,455,0,6
54522,3,2379,2441,-62,0,58,0,6
54523,3,2352,2454,-102,0,300,0,6
54524,2,2446,2396,50,0,455,0,6
54525,2,2256,2430,-174,0,4,0,6
54526,2,2270,2605,-335,0,112,0,6
54527,2,2415,2401,14,0,45,0,6
54528,2,2464,2285,179,0,4,0,8
54529,1,2479,2277,202,0,0,0,6
54530,1,2409,2418,-9,0,107,0,6
54531,1,2475,2430,45,0,491,0,6
54532,1,2495,2505,-10,0,379,0,6
54533,1,2469,2325,144,0,107,1,6
54534,2,2348,2437,-89,0,0,1,6
54535,1,2484,2301,183,0,106,1,6
54536,1,2424,2262,162,0,124,0,6
54537,2,2262,2572,-310,0,330,0,6
54538,1,2446,2386,60,0,313,0,6
54539,3,2512,2420,92,0,43,0,6
54540,1,2584,2545,39,0,105,1,6
54541,1,2433,2420,13,0,112,0,6
54542,1,2486,2466,20,0,125,0,6
54543,2,2404,2314,90,0,242,1,6
54544,1,2407,2291,116,0,123,0,6
54545,2,2382,2568,-186,0,1,1,8
54546,1,2416,2438,-22,0,278,0,6
54547,2,2325,2513,-188,0,111,0,6
54548,1,2449,2304,145,0,44,0,6
54549,3,2350,2626,-276,0,330,0,6
54550,1,2444,2387,57,0,300,0,6
54551,1,2535,2511,24,0,106,0,6
54552,2,2548,2479,69,0,211,0,6
54553,1,2466,2537,-71,0,126,0,6
54554,1,2423,2589,-166,0,132,0,6
54555,2,2546,2490,56,0,302,0,6
54556,2,2426,2365,61,0,245,0,6
54557,1,2539,2246,293,0,43,0,6
54558,2,2592,2570,22,0,265,1,6
54559,2,2280,2536,-256,0,100,0,6
54560,2,2267,2405,-138,0,109,0,6
54561,2,2511,2517,-6,0,255,0,6
54562,3,2433,2377,56,0,8,0,6
54563,2,2301,2493,-192,0,106,0,6
54564,2,2453,2305,148,0,56,0,6
54565,2,2499,2569,-70,0,52,1,6
54566,2,2415,2482,-67,0,4,0,6
54567,2,2411,2481,-70,0,4,0,6
54568,1,2400,2240,160,0,0,0,6
54569,1,2515,2517,-2,0,103,0,6
54570,2,2446,2362,84,0,241,0,6
54571,1,2258,2471,-213,0,331,0,6
54572,1,2470,2393,77,0,434,0,6
54573,1,2453,2371,82,0,312,0,6
54574,2,2337,2516,-179,0,306,0,6
54575,1,2506,2358,148,0,315,0,6
54576,1,2541,2260,281,0,40,0,6
54577,1,2574,2451,123,0,107,0,6
54578,2,2295,2475,-180,0,0,0,6
54579,3,2304,2424,-120,0,202,0,6
54580,1,2670,2410,260,0,151,0,6
54581,2,2465,2446,19,0,40,1,6
54582,2,2408,2431,-23,0,250,0,6
54583,2,2323,2464,-141,0,365,0,6
54584,1,2401,2321,80,0,201,0,6
54585,2,2381,2446,-65,0,357,0,6
54586,2,2769,2574,195,0,61,0,6
54587,3,2418,2371,47,0,4,0,6
54588,2,2300,2426,-126,4,30,1,13
54589,1,2667,2268,399,0,122,0,6
54590,1,2456,2380,76,0,4,0,6
54591,2,2415,2221,194,0,210,0,6
54592,1,2444,2404,40,4,120,0,11
54593,1,2452,2350,102,0,260,0,8
54594,1,2551,2517,34,0,491,0,6
54595,2,2543,2406,137,0,45,0,6
54596,2,2444,2398,46,0,40,0,6
54597,3,2362,2455,-93,0,222,0,6
54598,2,2230,2428,-198,0,41,0,6
54599,2,2338,2416,-78,0,117,0,6
54600,1,2420,2409,11,0,205,0,6
54601,2,2262,2451,-189,0,196,0,8
54602,1,2348,2440,-92,0,133,0,6
54603,1,2402,2352,50,0,211,0,8
54604,1,2265,2453,-188,0,110,0,6
54606,2,2467,2458,9,0,43,0,6
54607,1,2414,2439,-25,0,41,0,6
54608,1,2428,2351,77,0,130,0,6
54609,1,2406,2338,68,0,114,0,6
54610,1,2511,2538,-27,0,0,0,6
54611,2,2581,2486,95,0,297,0,6
54612,2,2322,2432,-110,0,131,1,6
54613,2,2364,2472,-108,0,122,0,6
54614,2,2456,2543,-87,0,307,0,6
54615,2,2460,2478,-18,0,10,1,6
54616,1,2441,2343,98,0,102,0,6
54617,1,2470,2343,127,0,241,0,6
54618,1,2446,2267,179,0,4,0,6
54619,3,2255,2407,-152,0,4,0,6
54620,1,2363,2411,-48,0,120,0,6
54621,3,2496,2539,-43,0,200,0,6
54622,2,2295,2452,-157,4,42,1,13
54623,1,2509,2285,224,0,337,0,6
54624,2,2342,2489,-147,0,320,0,6
54625,1,2552,2207,345,0,30,0,6
54626,1,2398,2403,-5,0,258,0,6
54627,1,2587,2336,251,0,45,0,6
54628,1,2343,2545,-202,0,131,0,6
54629,1,2484,2380,104,0,426,0,6
54630,2,2525,2307,218,0,484,1,6
54631,1,2422,2252,170,0,1,0,6
54632,2,2514,2312,202,0,113,0,6
54633,2,2201,2423,-222,0,6,1,6
54634,1,2502,2437,65,0,45,1,6
54635,3,2518,2340,178,0,337,0,6
54636,1,2497,2441,56,0,150,0,6
54637,3,2527,2524,3,0,404,0,6
54638,3,2380,2607,-227,0,302,0,6
54639,2,2451,2423,28,0,330,0,6
54640,2,2373,2560,-187,0,272,1,6
54641,2,2311,2607,-296,0,6,0,6
54642,2,2434,2410,24,0,262,1,6
54643,1,2433,2306,127,0,112,0,6
54644,2,2501,2265,236,0,115,0,6
54645,2,2536,2682,-146,0,187,0,6
54646,1,2480,2479,1,0,4,0,6
54647,1,2558,2335,223,0,40,0,6
54648,1,2516,2351,165,0,302,0,6
54649,2,2357,2536,-179,0,101,0,6
54650,1,2583,2483,100,0,112,0,6
54651,1,2283,2420,-137,0,300,0,6
54652,1,2394,2530,-136,0,487,0,6
54653,1,2576,2586,-10,0,151,0,6
54654,2,2279,2400,-121,0,45,1,8
54655,1,2321,2404,-83,0,31,0,6
54656,2,2439,2298,141,0,102,0,6
54657,2,2622,2354,268,0,123,1,6
54658,1,2408,2672,-264,0,133,0,6
54659,1,2409,2264,145,0,409,1,6
54660,2,2322,2487,-165,0,0,0,6
54661,3,2447,2424,23,0,40,0,6
54662,1,2314,2404,-90,0,118,0,6
54663,2,2322,2464,-142,0,101,1,6
54664,1,2488,2461,27,0,102,0,6
54665,2,2347,2432,-85,0,45,1,6
54666,1,2410,2235,175,0,106,0,6
54667,2,2492,2574,-82,0,240,0,6
54668,3,2512,2668,-156,0,49,0,6
54669,3,2334,2463,-129,0,313,0,6
54670,2,2451,2298,153,0,45,0,6
54671,2,2376,2437,-61,0,40,0,6
54672,1,2272,2404,-132,0,123,0,6
54673,3,2291,2432,-141,0,0,0,6
54674,2,2298,2478,-180,0,321,0,6
54675,2,2420,2337,83,0,334,0,6
54676,1,2529,2523,6,0,101,1,6
54677,3,2338,2471,-133,0,123,0,8
54678,3,2621,2514,107,0,210,0,6
54679,1,2410,2436,-26,0,1,1,6
54680,1,2437,2320,117,0,140,0,6
54681,2,2388,2404,-16,0,148,0,6
54682,1,2533,2459,74,0,4,1,6
54683,3,2407,2494,-87,0,13,0,6
54684,2,2426,2574,-148,0,207,0,6
54685,2,2433,2420,13,0,5,1,6
54686,2,2403,2433,-30,0,45,0,6
54687,1,2402,2283,119,0,106,0,6
54688,3,2719,2761,-42,0,211,0,6
54689,2,2414,2535,-121,0,13,0,6
54690,1,2455,2460,-5,0,20,0,6
54691,2,2422,2346,76,0,110,0,6
54692,1,2400,2410,-10,0,336,0,6
54693,1,2523,2491,32,0,345,1,6
54694,1,2424,2470,-46,0,45,0,6
54695,1,2490,2299,191,0,106,0,6
54696,2,2350,2571,-221,0,143,0,8
54697,1,2449,2313,136,0,45,1,6
54698,1,2412,2374,38,0,45,0,6
54699,1,2432,2261,171,0,21,0,6
54700,2,2436,2395,41,0,17,1,6
54702,2,2339,2446,-107,0,0,0,6
54703,1,2266,2455,-189,0,45,0,8
54704,1,2508,2503,5,4,337,0,8
54705,2,2444,2340,104,0,453,0,6
54706,2,2539,2517,22,0,440,0,6
54707,1,2474,2431,43,0,440,0,6
54708,1,2662,2417,245,0,151,1,6
54709,1,2405,2378,27,0,15,0,6
54710,1,2318,2415,-97,0,476,0,6
54711,1,2476,2360,116,0,15,0,6
54712,1,2412,2495,-83,0,49,1,6
54713,1,2444,2418,26,0,49,0,6
54714,2,2333,2475,-142,0,202,0,6
54715,3,2376,2497,-121,0,117,0,6
54716,2,2402,2403,-1,0,38,0,6
54717,2,2461,2321,140,0,15,1,6
54718,1,2394,2451,-57,4,112,0,11
54719,1,2437,2343,94,0,4,1,6
54720,1,2540,2520,20,0,301,1,6
54721,1,2481,2511,-30,0,100,0,6
54722,2,2312,2445,-133,0,408,0,6
54723,1,2430,2305,125,0,4,0,6
54724,2,2405,2344,61,0,131,0,6
54725,1,2577,2474,103,0,190,0,6
54726,1,2578,2487,91,0,122,1,6
54727,1,2334,2423,-89,0,21,0,6
54728,2,2260,2412,-152,0,46,0,6
54729,2,2454,2494,-40,0,46,0,6
54730,1,2538,2481,57,0,5,0,6
54731,2,2302,2490,-188,0,123,0,6
54732,2,2370,2589,-219,0,6,0,6
54733,2,2332,2419,-87,0,0,0,6
54734,1,2603,2382,221,0,218,0,6
54735,2,2316,2516,-200,0,7,1,6
54736,2,2348,2425,-77,0,56,0,6
54737,1,2425,2263,162,0,15,0,6
54738,1,2604,2524,80,0,0,0,6
54739,2,2235,2527,-292,0,17,0,6
54740,2,2430,2501,-71,0,122,0,6
54741,2,2563,2549,14,0,288,0,6
54742,3,2416,2479,-63,0,110,0,6
54743,2,2274,2561,-287,0,120,0,6
54744,2,2609,2587,22,0,278,1,6
54746,2,2348,2486,-138,0,374,0,6
54747,1,2509,2437,72,0,110,0,6
54748,2,2685,2509,176,0,204,1,6
54749,2,2227,2428,-201,0,108,0,6
54750,1,2361,2404,-43,0,11,0,6
54751,1,2461,2334,127,0,100,0,6
54752,1,2410,2382,28,0,302,0,6
54753,1,2404,2364,40,0,405,0,6
54754,2,2430,2406,24,0,176,0,6
54755,2,2336,2485,-149,0,411,0,6
54756,2,2539,2410,129,0,40,0,6
54757,1,2427,2416,11,0,4,0,6
54758,2,2316,2441,-125,0,16,0,6
54759,2,2523,2537,-14,0,301,0,6
54760,1,2407,2286,121,0,6,0,6
54762,1,2409,2398,11,0,96,0,6
54763,1,2452,2431,21,0,4,0,6
54764,2,2760,2719,41,0,440,1,6
54765,2,2613,2364,249,0,46,0,6
54766,2,2426,2427,-1,0,41,1,6
54767,1,2568,2320,248,0,41,0,6
54768,1,2455,2284,171,4,120,0,13
54769,2,2263,2417,-154,0,103,1,6
54770,2,2432,2353,79,4,301,0,13
54771,2,2354,2405,-51,0,484,0,6
54772,1,2648,2602,46,0,112,0,6
54773,1,2209,2411,-202,0,48,1,6
54774,1,2280,2451,-171,0,45,0,6
54775,3,2453,2323,130,0,300,0,6
54777,2,2347,2542,-195,0,100,0,6
54778,2,2254,2457,-203,0,121,1,8
54779,1,2443,2408,35,4,10,0,11
54780,1,2430,2449,-19,0,132,0,6
54781,2,2349,2403,-54,0,108,0,6
54782,1,2413,2315,98,0,13,0,6
54783,2,2375,2454,-79,0,332,1,6
54784,2,2425,2483,-58,0,295,0,6
54785,1,2499,2530,-31,0,337,0,6
54786,2,2279,2448,-169,0,13,0,6
54787,2,2495,2378,117,0,259,0,6
54788,1,2286,2419,-133,0,302,0,6
54789,1,2493,2264,229,0,134,0,6
54790,2,2432,2411,21,0,15,0,6
54791,2,2301,2412,-111,0,302,0,6
54792,2,2478,2427,51,0,491,0,6
54793,1,2573,2247,326,0,337,0,8
54794,2,2465,2453,12,0,172,0,6
54795,2,2414,2305,109,4,45,0,13
54796,2,2470,2515,-45,0,149,0,6
54797,2,2416,2382,34,0,222,0,6
54798,2,2424,2494,-70,0,140,0,6
54799,1,2486,2501,-15,0,426,0,6
54800,1,2394,2478,-84,0,241,1,8
54801,1,2388,2426,-38,0,46,0,6
54802,1,2416,2257,159,0,1,1,6
54804,2,2583,2518,65,0,80,0,6
54805,1,2545,2369,176,0,211,1,6
54806,2,2310,2489,-179,0,57,0,6
54807,2,2412,2436,-24,0,5,0,6
54808,1,2445,2312,133,0,200,0,6
54809,1,2651,2545,106,0,45,0,6
54810,1,2463,2342,121,0,127,0,6
54811,2,2280,2442,-162,0,463,1,6
54812,1,2472,2410,62,0,112,0,6
54813,1,2590,2329,261,0,150,0,6
54814,2,2581,2572,9,0,129,0,6
54815,1,2404,2414,-10,4,301,0,13
54816,2,2393,2545,-152,0,40,0,6
54817,2,2377,2415,-38,0,148,0,6
54818,1,2458,2295,163,0,45,1,6
54819,1,2452,2276,176,0,46,1,6
54820,1,2327,2409,-82,0,268,0,6
54821,2,2414,2597,-183,0,9,0,6
54822,2,2446,2305,141,0,111,0,6
54823,2,2327,2425,-98,0,131,0,6
54824,1,2418,2531,-113,0,200,0,6
54825,2,2241,2434,-193,0,111,1,6
54826,2,2488,2435,53,0,278,0,6
54827,1,2511,2235,276,0,190,0,6
54828,1,2402,2459,-57,0,330,0,6
54830,1,2459,2302,157,0,153,0,6
54831,1,2331,2451,-120,0,306,0,6
54832,2,2492,2507,-15,0,46,0,6
54833,1,2524,2436,88,0,133,1,6
54834,1,2554,2367,187,0,18,1,6
54835,1,2517,2344,173,0,354,1,6
54836,1,2478,2429,49,0,113,0,6
54837,2,2230,2557,-327,0,461,0,6
54838,1,2431,2360,71,0,142,0,6
54839,2,2494,2328,166,0,118,0,6
54840,2,2433,2272,161,0,115,0,6
54841,2,2424,2606,-182,0,302,0,6
54842,1,2592,2475,117,0,45,0,6
54843,1,2508,2346,162,0,45,1,6
54844,2,2531,2300,231,0,326,0,6
54845,2,2495,2417,78,0,326,0,6
54847,1,2202,2603,-401,0,49,0,6
54848,2,2609,2344,265,0,0,0,6
54849,3,2519,2594,-75,0,455,0,6
54850,1,2563,2514,49,0,411,0,6
54851,2,2555,2541,14,0,307,0,6
54852,1,2489,2521,-32,0,40,0,6
54853,3,2325,2451,-126,0,380,0,6
54854,1,2463,2506,-43,0,0,0,6
54855,2,2373,2604,-231,0,453,0,6
54856,1,2496,2297,199,0,123,0,6
54857,2,2389,2592,-203,0,45,0,6
54858,1,2549,2475,74,0,8,0,6
54859,1,2355,2467,-112,0,310,0,6
54860,2,2644,2754,-110,0,13,0,6
54861,1,2523,2426,97,0,45,0,6
54862,2,2505,2377,128,0,226,0,6
54863,1,2488,2432,56,0,184,1,6
54864,1,2480,2348,132,0,241,0,6
54865,1,2458,2371,87,0,115,0,6
54866,1,2512,2363,149,0,144,0,6
54867,2,2415,2419,-4,0,3,0,6
54868,2,2386,2488,-102,0,117,1,6
54869,1,2354,2409,-55,0,1,0,6
54870,1,2413,2353,60,0,7,0,8
54871,2,2344,2499,-155,0,46,0,6
54872,1,2465,2330,135,0,163,0,6
54873,3,2421,2528,-107,0,200,0,6
54874,3,2553,2713,-160,0,4,0,6
54875,1,2412,2397,15,0,344,0,6
54876,2,2512,2385,127,0,140,0,6
54877,1,2398,2486,-88,0,22,0,6
54878,1,2442,2351,91,0,17,1,6
54879,1,2549,2576,-27,0,101,0,6
54880,2,2408,2358,50,0,41,0,6
54881,2,2492,2484,8,0,45,0,6
54882,2,2392,2418,-26,0,165,0,6
54883,1,2481,2410,71,0,0,0,6
54884,1,2403,2236,167,0,4,0,6
54885,1,2600,2525,75,0,57,0,6
54886,1,2312,2492,-180,0,159,0,6
54887,1,2400,2483,-83,0,341,0,6
54888,3,2380,2457,-77,0,129,0,8
54889,2,2433,2445,-12,0,15,1,6
54890,1,2403,2346,57,0,131,1,6
54891,2,2471,2655,-184,0,110,0,6
54892,2,2313,2438,-125,0,27,1,6
54893,2,2429,2450,-21,0,80,1,6
54894,2,2388,2506,-118,0,101,0,6
54895,2,2349,2400,-51,0,302,0,8
54896,1,2541,2580,-39,0,123,0,6
54897,2,2312,2462,-150,0,484,0,6
54898,2,2376,2469,-93,0,45,0,6
54899,1,2640,2558,82,0,13,0,6
54900,1,2499,2469,30,0,100,0,6
54901,1,2415,2449,-34,0,15,0,6
54902,1,2477,2432,45,0,122,1,6
54903,1,2412,2421,-9,0,380,0,6
54904,2,2455,2404,51,0,6,0,6
54905,1,2332,2431,-99,0,12,1,6
54906,1,2528,2546,-18,0,143,0,6
54907,2,2332,2499,-167,0,470,0,6
54908,1,2410,2386,24,0,101,0,6
54909,1,2405,2392,13,0,113,0,6
54910,2,2483,2442,41,0,331,0,6
54911,1,2479,2489,-10,0,380,0,6
54912,1,2407,2403,4,0,80,0,6
54913,2,2466,2360,106,0,10,1,6
54914,1,2355,2407,-52,0,484,0,6
54915,1,2446,2406,40,0,122,0,6
54916,2,2270,2575,-305,0,45,0,8
54917,2,2424,2425,-1,0,200,0,6
54918,1,2758,2505,253,0,338,0,6
54919,2,2490,2487,3,0,140,0,6
54920,2,2319,2490,-171,0,45,0,6
54921,2,2400,2296,104,0,107,0,6
54922,1,2538,2263,275,0,31,0,6
54923,1,2421,2424,-3,0,315,1,6
54924,2,2383,2512,-129,0,112,1,6
54925,2,2424,2313,111,0,13,1,6
54926,1,2436,2381,55,0,218,0,6
54927,2,2520,2238,282,0,406,0,6
54928,1,2263,2599,-336,0,135,0,6
54929,1,2280,2483,-203,0,113,0,6
54930,2,2363,2549,-186,0,477,1,6
54931,1,2558,2429,129,0,141,0,6
54932,1,2609,2213,396,0,101,0,6
54933,3,2309,2596,-287,0,132,0,6
54934,1,2509,2512,-3,0,374,0,6
54935,2,2513,2520,-7,0,122,0,6
54936,2,2424,2336,88,0,110,0,6
54937,2,2508,2520,-12,0,128,0,6
54938,2,2551,2568,-17,0,302,0,6
54939,2,2592,2495,97,0,112,0,6
54940,1,2384,2497,-113,0,9,1,6
54941,2,2471,2233,238,0,127,1,8
54942,2,2391,2552,-161,0,300,1,6
54943,2,2250,2406,-156,0,43,1,6
54944,3,2502,2340,162,0,142,0,6
54945,2,2485,2644,-159,0,0,0,6
54946,1,2357,2493,-136,0,300,0,6
54947,1,2526,2423,103,0,201,0,6
54948,2,2461,2343,118,0,6,1,6
54949,2,2492,2382,110,0,259,0,6
54950,3,2233,2532,-299,0,426,0,6
54951,1,2459,2316,143,0,205,0,6
54952,1,2335,2501,-166,0,331,0,8
54953,2,2402,2404,-2,0,337,0,6
54954,2,2526,2338,188,0,453,0,6
54955,1,2402,2253,149,0,247,0,6
54956,1,2486,2444,42,0,315,0,6
54957,3,2414,2604,-190,0,83,0,6
54958,1,2411,2249,162,0,401,0,6
54959,1,2492,2484,8,0,45,0,6
54960,2,2318,2418,-100,0,103,1,6
54961,2,2520,2688,-168,0,0,0,6
54962,3,2417,2516,-99,0,46,0,6
54963,1,2417,2337,80,0,112,0,6
54964,1,2422,2378,44,0,265,0,6
54965,2,2445,2267,178,4,201,1,13
54966,1,2442,2309,133,0,101,0,6
54967,2,2349,2468,-119,0,41,1,6
54968,1,2496,2215,281,4,46,0,8
54969,1,2463,2407,56,0,170,0,6
54970,3,2531,2548,-17,0,57,0,6
54971,1,2415,2418,-3,0,45,1,6
54972,2,2331,2413,-82,0,120,0,6
54973,2,2324,2502,-178,0,107,0,6
54974,2,2381,2415,-34,0,45,1,6
54975,1,2428,2318,110,0,120,0,6
54976,2,2291,2413,-122,0,380,0,6
54977,2,2345,2473,-128,0,411,0,6
54978,3,2281,2459,-178,4,0,0,13
54979,1,2401,2277,124,0,373,0,6
54980,1,2451,2208,243,0,112,0,6
54981,2,2386,2411,-25,0,45,0,6
54982,2,2455,2424,31,0,131,0,6
54983,2,2335,2427,-92,0,21,0,6
54984,2,2464,2505,-41,0,0,0,6
54985,1,2648,2461,187,0,469,0,6
54986,2,2406,2482,-76,0,100,0,6
54987,2,2389,2484,-95,0,300,0,6
54988,2,2422,2380,42,0,14,0,6
54989,2,2390,2413,-23,0,201,0,6
54990,1,2503,2334,169,0,121,1,6
54991,3,2372,2415,-43,0,268,0,6
54992,1,2534,2449,85,0,246,1,6
54993,2,2760,2666,94,0,464,0,6
54994,2,2341,2408,-67,0,112,0,6
54995,1,2414,2368,46,0,40,0,6
54996,1,2483,2340,143,0,107,0,6
54997,1,2485,2424,61,0,302,1,6
54998,1,2420,2323,97,0,7,0,8
54999,1,2312,2400,-88,4,8,0,13
55000,2,2510,2459,51,0,260,1,6
55001,2,2419,2530,-111,0,40,1,6
55002,2,2492,2518,-26,0,46,1,6
55003,1,2254,2432,-178,0,140,0,6
55004,2,2343,2500,-157,0,43,1,6
55005,2,2290,2536,-246,0,122,0,6
55006,1,2528,2427,101,0,344,0,6
55007,1,2405,2229,176,0,56,0,8
55008,1,2604,2438,166,0,4,1,6
55009,2,2420,2438,-18,0,13,1,6
55010,2,2556,2574,-18,0,133,1,6
55011,1,2442,2276,166,0,28,1,6
55012,3,2489,2385,104,0,259,0,6
55013,1,2506,2302,204,0,277,0,6
55014,1,2409,2432,-23,0,156,1,6
55015,2,2485,2532,-47,0,106,1,6
55016,2,2301,2427,-126,4,25,0,13
55017,1,2401,2367,34,0,40,0,6
55018,3,2477,2319,158,0,41,0,6
55019,2,2517,2651,-134,0,107,0,6
55020,1,2439,2458,-19,0,45,1,6
55021,1,2477,2300,177,0,172,0,6
55022,2,2250,2533,-283,0,153,0,8
55023,1,2405,2453,-48,0,462,0,6
55024,2,2355,2511,-156,0,345,0,6
55025,1,2509,2463,46,0,32,0,6
55026,2,2602,2504,98,0,202,0,6
55027,3,2417,2245,172,0,106,0,6
55028,2,2490,2501,-11,0,226,0,6
55029,2,2424,2308,116,0,12,0,6
55030,1,2327,2410,-83,0,247,0,6
55031,1,2416,2381,35,0,113,0,6
55032,1,2401,2281,120,0,7,0,6
55033,2,2263,2508,-245,0,140,0,6
55034,3,2308,2487,-179,0,100,0,6
55035,1,2654,2726,-72,0,28,0,6
55036,3,2419,2401,18,0,52,0,6
55037,2,2432,2265,167,0,112,0,6
55038,2,2412,2421,-9,0,432,0,6
55039,1,2420,2376,44,0,6,0,6
55040,1,2696,2514,182,0,6,0,6
55041,1,2449,2363,86,0,106,1,6
55042,2,2487,2531,-44,0,241,0,6
55043,2,2304,2430,-126,0,125,0,6
55044,1,2673,2753,-80,0,218,0,6
55045,3,2363,2462,-99,0,41,0,8
55046,1,2456,2408,48,4,200,0,13
55047,2,2402,2351,51,0,222,0,6
55048,2,2310,2411,-101,0,134,0,6
55049,2,2534,2415,119,0,45,1,6
55050,2,2540,2613,-73,0,112,0,6
55051,2,2419,2476,-57,0,132,0,6
55052,2,2327,2428,-101,0,213,1,6
55053,1,2379,2408,-29,0,330,0,8
55054,2,2327,2490,-163,0,10,1,6
55055,2,2444,2539,-95,0,277,0,6
55056,1,2221,2457,-236,0,129,0,8
55057,1,2443,2271,172,0,4,0,8
55058,2,2409,2378,31,0,454,1,6
55059,1,2538,2287,251,0,45,0,6
55060,2,2487,2503,-16,0,303,0,6
55061,1,2405,2379,26,0,369,0,6
55062,1,2206,2499,-293,4,112,0,8
55063,2,2401,2277,124,0,243,1,6
55064,2,2514,2361,153,0,41,0,6
55065,2,2308,2423,-115,0,143,0,6
55066,1,2503,2340,163,0,101,0,6
55067,2,2480,2538,-58,0,132,1,6
55068,2,2435,2440,-5,0,119,0,6
55069,1,2387,2487,-100,0,117,0,6
55070,2,2409,2549,-140,0,338,0,6
55071,2,2243,2415,-172,0,121,1,6
55072,1,2580,2518,62,0,349,1,6
55073,1,2427,2407,20,0,45,0,6
55074,2,2402,2419,-17,0,148,0,6
55075,1,2421,2362,59,0,25,0,6
55076,1,2457,2325,132,0,101,0,8
55077,2,2532,2661,-129,0,41,0,6
55078,2,2426,2480,-54,0,406,0,6
55079,2,2419,2415,4,0,150,0,6
55080,1,2699,2719,-20,0,6,0,6
55081,1,2448,2453,-5,0,36,0,6
55082,2,2490,2314,176,0,70,0,6
55083,1,2413,2337,76,0,131,0,6
55084,2,2390,2425,-35,0,177,0,6
55085,1,2371,2415,-44,0,100,1,6
55086,1,2421,2242,179,0,278,0,6
55087,3,2445,2481,-36,0,45,0,6
55088,2,2240,2411,-171,0,190,0,6
55089,1,2420,2376,44,0,106,1,6
55090,1,2299,2419,-120,0,3,0,6
55091,1,2480,2394,86,0,259,0,6
55092,1,2484,2419,65,0,0,1,6
55093,1,2404,2310,94,0,101,0,6
55094,2,2543,2440,103,0,244,0,6
55095,1,2423,2532,-109,0,278,1,6
55096,2,2359,2427,-68,0,1,0,6
55097,1,2507,2484,23,0,108,1,6
55098,1,2373,2445,-72,0,354,1,6
55099,2,2506,2511,-5,0,50,1,6
55100,2,2358,2475,-117,0,160,0,6
55101,1,2441,2274,167,0,134,1,6
55102,1,2554,2482,72,0,148,0,6
55103,1,2453,2405,48,0,224,1,6
55104,2,2474,2680,-206,0,7,0,6
55105,3,2508,2473,35,0,302,0,6
55106,2,2493,2482,11,0,302,1,6
55107,2,2423,2527,-104,0,4,0,6
55108,3,2500,2404,96,0,5,0,6
55109,2,2511,2618,-107,0,310,0,6
55110,1,2536,2369,167,0,427,0,6
55111,1,2546,2665,-119,0,41,0,6
55112,1,2434,2352,82,0,40,0,6
55113,1,2419,2270,149,0,309,0,6
55114,1,2471,2404,67,0,106,1,6
55115,3,2296,2446,-150,0,125,0,8
55116,2,2492,2324,168,0,302,1,8
55117,1,2485,2334,151,0,113,1,6
55118,1,2401,2396,5,0,265,0,6
55119,1,2446,2430,16,0,46,0,6
55120,3,2403,2240,163,0,304,0,6
55121,2,2384,2481,-97,0,130,0,6
55122,1,2285,2541,-256,0,122,0,6
55123,1,2423,2363,60,0,10,0,6
55124,2,2350,2426,-76,0,142,0,6
55125,1,2316,2422,-106,0,46,0,6
55126,1,2354,2400,-46,0,228,1,6
55127,1,2513,2542,-29,0,8,0,6
55128,2,2445,2475,-30,0,300,0,6
55129,1,2529,2585,-56,0,58,0,6
55130,2,2401,2432,-31,0,380,0,6
55131,2,2414,2323,91,0,7,1,6
55132,2,2421,2437,-16,0,241,0,6
55133,1,2460,2320,140,0,105,1,8
55134,1,2531,2419,112,0,40,0,6
55135,3,2418,2328,90,0,4,0,6
55136,1,2431,2553,-122,0,7,0,6
55137,2,2250,2418,-168,0,242,0,6
55138,3,2464,2385,79,0,46,0,6
55139,2,2402,2231,171,0,45,1,8
55140,2,2477,2657,-180,0,241,0,6
55141,1,2341,2401,-60,0,40,0,6
55142,2,2536,2519,17,0,300,0,6
55143,2,2408,2303,105,0,132,0,6
55144,2,2448,2536,-88,0,260,1,6
55145,2,2559,2507,52,0,168,0,6
55146,1,2390,2484,-94,0,101,0,6
55147,2,2432,2368,64,0,205,0,6
55148,1,2330,2490,-160,0,130,0,6
55149,2,2354,2480,-126,0,1,1,6
55150,1,2424,2349,75,0,135,0,6
55151,3,2507,2415,92,0,302,0,6
55152,2,2442,2539,-97,0,7,0,6
55153,1,2474,2365,109,0,122,0,6
55154,1,2415,2363,52,0,100,1,6
55155,1,2415,2535,-120,0,0,0,6
55156,1,2372,2490,-118,0,41,0,6
55157,2,2373,2428,-55,0,163,0,6
55158,2,2300,2404,-104,0,301,1,6
55159,1,2443,2400,43,0,246,0,6
55160,3,2335,2419,-84,0,22,0,6
55161,1,2531,2295,236,0,218,0,6
55162,1,2424,2451,-27,0,118,0,6
55163,2,2380,2444,-64,0,277,1,6
55164,2,2361,2478,-117,0,90,0,6
55165,1,2512,2501,11,0,302,0,6
55166,1,2331,2475,-144,0,300,1,6
55167,1,2438,2243,195,0,200,0,6
55168,2,2488,2488,0,0,46,1,6
55169,1,2607,2653,-46,0,96,1,6
55170,2,2399,2466,-67,0,14,0,6
55171,1,2525,2430,95,0,344,0,6
55172,1,2437,2396,41,0,45,0,6
55173,2,2402,2266,136,4,244,1,13
55174,2,2317,2483,-166,0,4,0,6
55175,1,2320,2401,-81,0,4,0,6
55176,1,2334,2431,-97,0,140,1,6
55177,1,2337,2407,-70,0,90,0,6
55178,1,2478,2313,165,0,61,0,6
55179,1,2332,2417,-85,0,189,0,8
55180,3,2546,2438,108,0,487,0,6
55181,2,2438,2319,119,0,14,0,6
55182,1,2425,2336,89,0,112,0,6
55183,2,2622,2472,150,0,41,0,6
55184,1,2439,2342,97,0,300,0,6
55185,1,2401,2320,81,0,132,0,6
55186,2,2317,2479,-162,0,133,0,6
55187,2,2318,2479,-161,0,6,0,6
55188,2,2395,2417,-22,0,102,0,6
55189,1,2474,2506,-32,0,105,1,6
55190,2,2360,2448,-88,0,115,0,6
55191,1,2527,2423,104,0,300,0,6
55192,1,2477,2397,80,0,259,0,6
55193,1,2485,2324,161,0,305,0,6
55194,2,2540,2541,-1,0,120,0,6
55195,2,2309,2417,-108,0,122,0,6
55196,3,2560,2358,202,0,145,0,6
55197,1,2329,2518,-189,0,404,0,8
55198,2,2292,2534,-242,0,122,1,6
55199,2,2268,2400,-132,0,48,0,6
55200,1,2339,2498,-159,0,152,1,6
55201,1,2260,2407,-147,0,477,1,6
55202,2,2311,2402,-91,0,405,0,6
55203,3,2319,2438,-119,0,200,0,6
55204,2,2457,2294,163,4,120,0,13
55205,2,2443,2552,-109,0,414,0,6
55206,1,2311,2429,-118,0,156,1,6
55207,1,2459,2471,-12,0,128,1,6
55208,1,2345,2406,-61,0,45,0,6
55209,1,2484,2350,134,0,106,0,6
55210,2,2393,2482,-89,0,300,1,6
55211,2,2495,2518,-23,0,415,1,6
55212,2,2315,2405,-90,0,100,0,6
55213,1,2520,2359,161,0,40,1,6
55214,1,2455,2320,135,0,40,0,6
55215,2,2229,2445,-216,4,1,0,13
55216,1,2514,2420,94,0,481,0,6
55217,1,2404,2264,140,0,100,0,6
55218,2,2494,2356,138,0,133,0,6
55219,1,2391,2442,-51,0,380,0,6
55220,1,2540,2381,159,0,106,0,6
55221,1,2449,2375,74,0,56,0,6
55222,2,2358,2488,-130,0,56,0,6
55223,2,2445,2430,15,0,305,0,6
55224,2,2222,2440,-218,0,108,0,6
55225,1,2486,2324,162,0,484,0,6
55226,2,2468,2314,154,0,300,1,6
55227,2,2544,2390,154,0,58,0,6
55228,2,2349,2502,-153,0,5,0,6
55229,1,2454,2452,2,0,441,0,6
55230,1,2464,2318,146,0,200,0,8
55231,1,2418,2397,21,0,0,0,6
55232,2,2401,2422,-21,0,278,0,6
55233,2,2614,2541,73,0,4,0,6
55234,2,2236,2401,-165,0,245,0,6
55235,3,2357,2482,-125,0,302,0,6
55236,1,2403,2297,106,0,127,0,6
55237,3,2556,2464,92,0,242,0,6
55238,2,2309,2439,-130,0,40,0,6
55239,2,2311,2458,-147,0,0,0,6
55240,2,2531,2500,31,0,45,0,6
55241,2,2317,2423,-106,0,46,0,6
55242,2,2544,2481,63,0,386,0,6
55243,2,2416,2418,-2,0,15,0,6
55244,1,2430,2351,79,0,140,0,6
55245,2,2340,2520,-180,0,40,0,6
55246,2,2307,2486,-179,0,120,0,6
55247,1,2301,2406,-105,0,420,1,8
55248,2,2317,2443,-126,0,16,1,6
55250,3,2237,2485,-248,0,288,0,6
55251,1,2364,2408,-44,0,46,1,6
55252,3,2482,2529,-47,0,312,0,6
55253,1,2443,2236,207,0,200,0,6
55254,1,2426,2279,147,0,120,0,6
55255,1,2421,2256,165,0,106,1,6
55256,1,2436,2398,38,0,45,0,6
55257,3,2548,2607,-59,0,326,0,6
55258,3,2476,2411,65,0,440,0,6
55259,2,2261,2407,-146,0,45,0,6
55260,2,2436,2319,117,0,0,0,6
55261,1,2408,2277,131,0,110,0,6
55262,2,2355,2410,-55,0,45,0,6
55263,2,2424,2523,-99,0,10,0,6
55264,1,2377,2543,-166,0,327,0,6
55265,2,2446,2268,178,0,112,0,6
55266,1,2320,2510,-190,0,101,0,8
55267,2,2430,2443,-13,0,10,0,6
55268,1,2480,2317,163,0,400,0,6
55269,2,2347,2488,-141,0,1,1,6
55270,1,2486,2389,97,0,259,0,6
55271,2,2436,2410,26,0,100,1,6
55272,1,2462,2378,84,0,10,0,6
55273,1,2426,2413,13,0,107,0,6
55274,1,2465,2310,155,0,315,0,6
55275,1,2582,2480,102,0,106,0,6
55276,1,2428,2283,145,0,466,0,6
55277,2,2520,2506,14,0,483,0,6
55278,1,2371,2454,-83,0,133,1,6
55279,1,2547,2396,151,0,228,0,6
55280,3,2327,2445,-118,0,213,0,6
55281,2,2487,2537,-50,0,211,0,6
55282,2,2647,2614,33,0,112,0,6
55283,2,2415,2555,-140,0,255,1,6
55284,1,2467,2309,158,0,492,0,6
55285,2,2524,2490,34,0,302,0,6
55286,1,2518,2430,88,0,404,1,6
55287,1,2482,2385,97,0,46,0,6
55288,1,2489,2313,176,0,100,0,6
55289,3,2528,2345,183,0,40,0,6
55290,2,2492,2460,32,0,215,1,6
55291,1,2442,2372,70,0,133,0,5
55292,1,2322,2408,-86,0,4,1,6
55293,3,2223,2554,-331,4,4,0,13
55294,2,2477,2420,57,0,339,0,6
55295,2,2384,2490,-106,0,113,1,6
55296,1,2595,2325,270,0,45,1,6
55297,2,2274,2411,-137,0,317,0,6
55298,2,2310,2496,-186,0,40,0,6
55299,3,2482,2240,242,0,190,0,6
55300,2,2337,2492,-155,0,45,0,6
55301,1,2490,2460,30,0,8,0,6
55302,1,2691,2594,97,0,101,0,6
55303,2,2452,2287,165,0,331,0,6
55304,1,2443,2330,113,0,385,0,6
55305,2,2421,2458,-37,0,485,0,6
55306,2,2350,2408,-58,0,106,0,6
55307,1,2468,2227,241,0,336,1,6
55308,3,2397,2425,-28,0,4,0,6
55309,1,2437,2434,3,0,140,0,6
55310,1,2319,2437,-118,0,45,1,6
55311,1,2476,2586,-110,0,7,0,6
55312,2,2367,2407,-40,0,310,1,6
55313,1,2408,2432,-24,0,250,0,6
55314,2,2393,2441,-48,0,432,0,6
55315,1,2447,2379,68,0,300,0,6
55316,1,2332,2424,-92,0,183,0,6
55317,1,2554,2361,193,0,190,0,6
55318,2,2523,2513,10,0,41,1,6
55319,2,2358,2422,-64,0,435,0,6
55320,2,2373,2415,-42,0,45,0,6
55321,1,2364,2466,-102,0,112,0,6
55322,1,2405,2535,-130,0,256,1,6
55323,1,2496,2606,-110,0,324,0,6
55325,1,2326,2431,-105,0,30,0,6
55326,1,2549,2386,163,0,40,0,6
55327,1,2512,2468,44,0,190,0,6
55328,3,2514,2525,-11,0,43,0,6
55329,2,2428,2411,17,0,52,0,6
55330,2,2454,2334,120,0,18,0,6
55331,1,2379,2470,-91,0,288,0,6
55332,1,2452,2581,-129,0,113,0,6
55333,1,2446,2388,58,0,45,1,6
55334,1,2492,2343,149,0,106,0,6
55335,1,2401,2427,-26,0,255,0,6
55336,1,2410,2482,-72,0,131,1,6
55337,2,2542,2483,59,0,380,1,6
55338,2,2430,2525,-95,0,101,0,6
55339,1,2300,2470,-170,0,200,0,6
55340,1,2429,2346,83,0,152,1,6
55341,2,2416,2392,24,0,312,1,6
55342,1,2447,2378,69,0,1,0,6
55343,2,2309,2463,-154,0,15,1,6
55344,1,2415,2270,145,0,122,0,6
55345,2,2266,2444,-178,0,4,0,6
55346,1,2459,2411,48,0,176,0,6
55347,1,2485,2472,13,0,9,0,6
55348,2,2314,2402,-88,0,113,0,6
55349,1,2348,2559,-211,0,8,1,6
55350,1,2504,2528,-24,0,233,0,6
55351,2,2450,2448,2,0,41,1,6
55352,1,2431,2417,14,0,202,0,6
55353,1,2409,2401,8,0,311,1,6
55354,1,2541,2495,46,0,45,0,6
55355,2,2435,2436,-1,0,101,0,6
55356,1,2401,2401,0,0,200,0,6
55357,2,2418,2419,-1,0,101,0,6
55358,1,2494,2380,114,0,259,0,6
55359,2,2314,2466,-152,0,300,0,6
55360,1,2407,2425,-18,0,197,0,6
55361,1,2632,2522,110,0,151,1,6
55362,2,2419,2399,20,0,373,0,7
55363,2,2553,2402,151,0,3,0,6
55364,2,2321,2419,-98,0,132,1,6
55365,1,2401,2234,167,0,13,1,6
55366,2,2320,2752,-432,0,302,0,6
55367,2,2355,2501,-146,0,302,0,8
55368,1,2579,2483,96,0,106,0,6
55369,1,2323,2597,-274,0,337,1,6
55370,1,2447,2495,-48,0,190,1,6
55371,1,2340,2495,-155,0,1,0,6
55372,1,2333,2443,-110,0,205,0,8
55373,1,2355,2447,-92,0,253,1,6
55374,2,2443,2425,18,0,337,0,6
55375,3,2496,2486,10,0,132,0,6
55376,3,2346,2499,-153,0,130,0,6
55377,1,2406,2310,96,0,101,0,6
55378,2,2309,2413,-104,0,124,0,6
55379,1,2447,2362,85,0,301,1,6
55380,2,2453,2339,114,0,0,0,6
55381,2,2598,2517,81,0,5,1,6
55382,1,2451,2326,125,0,122,0,6
55383,1,2414,2271,143,0,311,0,8
55384,1,2345,2451,-106,0,45,0,6
55385,1,2504,2526,-22,0,344,1,6
55386,1,2469,2405,64,0,52,1,6
55387,2,2249,2419,-170,0,4,0,6
55388,3,2359,2560,-201,0,330,0,6
55389,1,2420,2292,128,0,14,0,6
55390,1,2462,2227,235,0,335,0,6
55391,2,2404,2316,88,0,216,1,6
55392,2,2417,2422,-5,0,247,0,6
55394,1,2400,2451,-51,0,118,0,6
55395,1,2405,2344,61,0,485,0,7
55396,3,2584,2206,378,0,41,0,6
55397,1,2505,2267,238,0,120,0,6
55398,1,2573,2568,5,0,442,0,6
55399,2,2426,2455,-29,0,121,0,6
55400,1,2525,2514,11,0,45,0,6
55401,2,2421,2550,-129,0,10,0,6
55402,2,2491,2330,161,0,13,0,6
55403,1,2263,2466,-203,0,302,0,6
55404,3,2380,2427,-47,0,200,0,6
55405,3,2466,2497,-31,0,129,0,6
55406,1,2374,2446,-72,0,40,0,6
55407,1,2479,2583,-104,0,7,0,6
55408,1,2407,2326,81,0,112,0,6
55409,2,2489,2536,-47,0,440,0,6
55410,2,2364,2529,-165,0,302,1,6
55411,1,2426,2463,-37,0,297,0,6
55412,2,2215,2412,-197,0,120,1,6
55413,2,2425,2753,-328,0,302,0,6
55414,1,2530,2340,190,0,301,0,6
55415,1,2281,2412,-131,0,106,0,6
55416,2,2305,2410,-105,0,0,1,6
55417,2,2433,2386,47,0,302,1,6
55418,2,2430,2318,112,4,260,0,13
55419,1,2389,2455,-66,0,277,0,6
55420,1,2342,2433,-91,0,142,0,6
55421,1,2528,2426,102,0,344,1,6
55422,2,2410,2413,-3,0,111,1,6
55423,2,2578,2545,33,0,40,0,6
55424,2,2489,2321,168,0,120,0,6
55425,2,2546,2330,216,0,106,0,6
55426,1,2457,2510,-53,0,27,0,6
55427,2,2349,2425,-76,0,15,1,6
55428,2,2398,2424,-26,0,142,1,6
55429,2,2295,2422,-127,0,302,0,6
55430,1,2426,2231,195,0,441,1,6
55431,1,2442,2407,35,0,48,0,6
55432,2,2202,2429,-227,0,14,0,6
55433,2,2529,2534,-5,0,40,0,6
55434,1,2404,2348,56,0,127,0,6
55435,1,2413,2416,-3,0,45,0,6
55436,1,2463,2385,78,0,455,1,6
55437,2,2503,2438,65,0,474,0,6
55438,2,2212,2415,-203,0,13,0,6
55439,2,2549,2502,47,0,141,0,6
55440,3,2392,2476,-84,0,380,0,6
55441,1,2452,2331,121,0,45,0,6
55442,1,2285,2417,-132,0,106,0,6
55443,1,2518,2475,43,0,330,0,6
55444,2,2205,2580,-375,0,129,0,6
55445,1,2505,2348,157,0,490,0,8
55446,1,2410,2413,-3,0,45,0,6
55447,1,2563,2579,-16,0,429,0,6
55448,2,2357,2454,-97,0,8,0,6
55449,2,2444,2402,42,0,45,0,6
55450,2,2565,2543,22,0,245,0,6
55451,1,2336,2419,-83,0,304,0,6
55452,2,2217,2423,-206,0,101,0,6
55453,1,2330,2440,-110,0,221,1,6
55454,1,2554,2362,192,0,141,0,6
55455,2,2322,2496,-174,0,50,0,6
55456,2,2486,2518,-32,0,255,0,6
55457,2,2524,2443,81,0,100,1,6
55458,2,2368,2466,-98,0,45,0,6
55459,2,2339,2469,-130,0,25,0,6
55460,2,2210,2418,-208,0,404,1,6
55461,2,2495,2356,139,0,106,1,6
55462,3,2509,2523,-14,0,53,0,6
55463,1,2461,2539,-78,0,40,0,6
55464,1,2531,2538,-7,0,300,1,6
55465,1,2312,2426,-114,0,325,0,6
55466,1,2417,2233,184,0,9,0,6
55467,1,2439,2345,94,0,13,0,6
55468,2,2520,2510,10,0,14,0,6
55469,1,2427,2252,175,0,490,1,6
55470,1,2541,2484,57,0,380,0,6
55471,2,2532,2548,-16,0,45,0,6
55472,2,2576,2487,89,0,106,0,6
55473,3,2341,2420,-79,0,0,0,6
55474,3,2457,2201,256,0,305,0,6
55475,1,2510,2249,261,0,41,0,6
55476,2,2316,2537,-221,0,0,0,6
55477,1,2754,2211,543,0,107,0,6
55479,1,2551,2596,-45,0,230,0,6
55480,2,2467,2457,10,0,250,0,6
55481,2,2247,2438,-191,0,114,0,6
55482,2,2418,2379,39,0,312,1,8
55483,1,2458,2353,105,0,106,0,6
55484,1,2437,2347,90,0,405,0,6
55485,1,2303,2415,-112,0,147,1,6
55486,1,2581,2368,213,0,315,0,6
55487,1,2381,2456,-75,0,133,0,6
55488,1,2523,2572,-49,0,43,0,6
55489,1,2483,2451,32,0,483,0,6
55490,1,2399,2429,-30,0,140,0,6
55491,2,2201,2480,-279,0,143,0,6
55492,1,2363,2431,-68,0,258,0,6
55493,2,2410,2554,-144,0,9,0,6
55494,1,2426,2292,134,0,101,0,6
55495,2,2429,2332,97,0,120,0,6
55496,3,2470,2393,77,0,228,0,6
55497,2,2409,2416,-7,0,311,0,6
55498,1,2317,2402,-85,0,136,1,6
55499,2,2277,2447,-170,0,48,0,6
55500,1,2504,2238,266,0,232,0,6
55501,1,2320,2424,-104,0,140,0,6
55502,1,2532,2481,51,0,43,0,6
55503,2,2343,2468,-125,0,1,0,6
55504,2,2573,2569,4,0,405,1,6
55505,3,2349,2462,-113,0,8,0,6
55506,2,2431,2305,126,0,266,1,6
55507,2,2326,2423,-97,4,140,0,13
55508,1,2467,2225,242,0,335,0,6
55509,2,2497,2396,101,0,253,0,6
55510,2,2344,2508,-164,0,101,1,8
55511,1,2364,2401,-37,0,40,0,6
55512,3,2325,2433,-108,0,121,0,6
55513,3,2500,2669,-169,0,326,0,6
55514,1,2450,2411,39,0,45,0,6
55515,1,2207,2400,-193,0,43,0,7
55516,1,2426,2298,128,0,302,0,6
55517,2,2338,2584,-246,0,215,1,6
55518,1,2755,2254,501,0,134,0,6
55519,2,2422,2532,-110,0,112,0,6
55520,1,2402,2308,94,0,345,0,6
55521,2,2407,2278,129,0,209,0,6
55522,2,2432,2338,94,0,140,0,6
55523,3,2549,2401,148,0,101,0,6
55524,2,2318,2535,-217,0,40,1,6
55525,1,2412,2409,3,0,150,0,6
55526,1,2539,2234,305,0,300,0,6
55527,1,2482,2391,91,0,301,1,6
55528,3,2359,2560,-201,0,293,0,6
55529,1,2400,2289,111,0,243,1,6
55530,2,2344,2424,-80,0,108,0,6
55531,1,2441,2253,188,0,314,0,6
55532,1,2445,2238,207,0,454,1,6
55533,1,2402,2368,34,0,191,0,6
55534,1,2533,2558,-25,0,122,0,6
55535,1,2449,2388,61,0,40,0,6
55536,1,2400,2271,129,4,57,0,13
55537,2,2517,2453,64,0,103,1,6
55538,3,2474,2453,21,0,426,0,6
55539,3,2469,2280,189,0,101,0,6
55540,2,2319,2418,-99,0,20,0,6
55541,2,2426,2369,57,0,40,1,6
55542,1,2420,2333,87,0,80,0,6
55543,2,2577,2635,-58,0,247,1,6
55544,3,2527,2514,13,0,330,0,6
55545,2,2389,2532,-143,0,12,0,6
55546,1,2431,2226,205,0,405,0,6
55547,1,2461,2537,-76,0,202,0,6
55548,2,2404,2440,-36,0,114,0,6
55549,3,2239,2513,-274,0,337,0,6
55550,1,2419,2450,-31,0,9,0,6
55551,2,2332,2454,-122,0,45,0,6
55552,1,2450,2557,-107,0,45,0,6
55553,2,2523,2439,84,0,45,0,6
55554,1,2311,2521,-210,0,211,0,6
55555,1,2375,2494,-119,0,463,1,6
55556,1,2454,2454,0,0,300,1,6
55557,1,2501,2396,105,0,107,1,6
55558,1,2404,2248,156,0,176,0,6
55559,1,2375,2455,-80,0,15,1,6
55561,2,2470,2230,240,0,311,1,6
55562,1,2329,2410,-81,0,28,1,6
55563,2,2406,2539,-133,0,247,0,6
55564,1,2565,2529,36,0,414,0,6
55565,1,2434,2246,188,0,178,0,6
55566,2,2413,2271,142,0,48,0,6
55567,3,2235,2755,-520,0,300,0,6
55568,2,2284,2402,-118,0,227,0,6
55569,1,2506,2428,78,0,337,1,6
55570,1,2403,2228,175,0,127,0,6
55571,1,2537,2422,115,0,7,0,6
55572,2,2552,2509,43,0,140,0,6
55573,1,2446,2334,112,0,151,0,6
55574,2,2499,2404,95,0,101,0,6
55575,1,2463,2547,-84,0,339,0,6
55576,2,2553,2494,59,0,484,1,6
55577,2,2407,2422,-15,0,143,1,6
55578,1,2406,2311,95,0,131,0,6
55579,3,2389,2459,-70,0,253,0,3
55580,2,2331,2448,-117,0,128,0,6
55581,3,2472,2317,155,0,327,0,6
55582,1,2288,2429,-141,0,302,1,6
55583,1,2531,2523,8,0,45,0,6
55584,1,2245,2448,-203,0,31,0,6
55585,2,2271,2541,-270,0,112,0,6
55586,1,2647,2539,108,0,302,0,6
55587,1,2470,2339,131,0,127,0,6
55588,3,2433,2383,50,0,459,0,6
55589,1,2575,2567,8,0,426,1,6
55590,2,2363,2407,-44,0,409,1,6
55591,2,2530,2636,-106,0,45,0,6
55592,3,2407,2302,105,0,140,0,6
55593,1,2428,2453,-25,0,41,0,6
55594,1,2446,2339,107,0,1,0,6
55595,2,2394,2454,-60,0,172,0,6
55596,3,2590,2516,74,0,107,0,6
55597,2,2373,2487,-114,0,102,1,6
55598,1,2554,2362,192,0,250,0,6
55599,3,2335,2453,-118,0,40,0,6
55600,1,2496,2351,145,0,41,0,6
55601,2,2298,2424,-126,0,139,0,7
55602,1,2425,2292,133,0,311,0,6
55603,3,2369,2444,-75,0,386,0,6
55604,2,2205,2424,-219,0,205,0,6
55605,2,2328,2455,-127,0,353,0,6
55606,2,2430,2291,139,0,337,0,6
55607,1,2250,2406,-156,0,113,0,6
55608,1,2418,2331,87,0,140,0,6
55609,2,2420,2333,87,0,80,0,6
55610,2,2308,2442,-134,0,200,0,6
55611,1,2345,2425,-80,0,244,0,6
55612,2,2334,2460,-126,0,125,1,6
55613,1,2457,2385,72,0,310,0,6
55614,1,2495,2535,-40,0,46,0,6
55615,2,2535,2527,8,0,101,1,6
55616,2,2336,2419,-83,0,1,0,6
55617,2,2382,2474,-92,0,245,0,6
55618,1,2558,2564,-6,0,45,0,6
55619,2,2506,2308,198,0,40,0,6
55620,1,2586,2426,160,0,81,0,6
55621,1,2444,2245,199,0,302,0,6
55622,1,2487,2336,151,0,120,0,6
55623,2,2453,2514,-61,0,225,1,6
55624,2,2390,2543,-153,0,288,0,6
55625,2,2445,2396,49,0,230,0,6
55626,1,2412,2295,117,0,477,0,8
55627,1,2418,2510,-92,0,45,0,6
55628,1,2369,2460,-91,0,228,0,6
55629,1,2438,2228,210,4,375,0,10
55630,2,2279,2410,-131,0,48,1,6
55631,1,2404,2406,-2,0,196,1,6
55632,2,2370,2443,-73,0,45,0,6
55633,2,2480,2316,164,0,219,0,6
55634,2,2424,2277,147,0,21,0,6
55635,1,2536,2418,118,0,404,0,6
55636,2,2353,2424,-71,0,147,0,6
55637,1,2511,2341,170,0,490,0,8
55638,2,2468,2500,-32,0,254,1,6
55639,1,2411,2395,16,0,45,0,6
55640,2,2639,2492,147,0,5,0,6
55641,1,2652,2681,-29,0,483,0,6
55642,2,2505,2450,55,0,110,1,6
55643,1,2398,2439,-41,0,123,0,6
55644,1,2750,2369,381,0,190,1,6
55645,1,2400,2408,-8,0,325,0,6
55646,2,2345,2487,-142,0,120,1,6
55647,2,2448,2545,-97,0,300,0,6
55648,1,2432,2315,117,0,20,0,6
55649,1,2442,2338,104,0,301,0,6
55650,1,2492,2384,108,0,315,0,6
55651,1,2507,2242,265,0,120,1,6
55652,2,2249,2543,-294,0,115,0,6
55653,1,2374,2400,-26,0,176,1,6
55654,1,2537,2518,19,0,45,0,6
55655,1,2423,2423,0,0,354,0,6
55656,2,2418,2352,66,0,140,0,6
55657,2,2452,2383,69,0,48,0,6
55658,1,2424,2331,93,0,106,0,6
55659,2,2450,2399,51,4,130,0,13
55660,2,2511,2370,141,0,40,1,6
55661,3,2447,2436,11,0,130,0,6
55662,3,2305,2469,-164,0,9,0,6
55663,2,2366,2403,-37,0,106,0,6
55664,2,2517,2589,-72,0,300,0,6
55665,1,2443,2459,-16,0,300,0,6
55666,1,2299,2402,-103,0,45,1,6
55667,1,2331,2500,-169,0,414,0,6
55668,3,2428,2232,196,0,46,0,7
55669,1,2476,2283,193,0,85,0,6
55670,3,2359,2560,-201,0,288,0,6
55671,2,2421,2296,125,0,101,1,6
55672,1,2580,2641,-61,0,428,0,6
55673,1,2410,2259,151,0,1,1,6
55674,2,2235,2446,-211,0,113,0,6
55675,1,2426,2210,216,0,269,0,6
55676,1,2447,2428,19,0,301,1,6
55677,1,2417,2422,-5,0,300,1,6
55678,3,2458,2390,68,0,285,0,3
55679,2,2311,2429,-118,0,14,1,6
55680,1,2404,2336,68,0,108,0,6
55681,2,2462,2343,119,0,320,0,6
55682,1,2403,2392,11,0,100,1,6
55683,1,2347,2589,-242,0,203,1,6
55684,1,2478,2330,148,0,343,0,6
55685,1,2422,2348,74,0,4,0,6
55686,1,2402,2229,173,0,128,1,6
55687,1,2546,2384,162,0,114,1,6
55688,1,2445,2459,-14,0,311,0,6
55689,2,2386,2416,-30,0,270,0,6
55690,2,2461,2235,226,0,311,1,6
55691,1,2549,2550,-1,0,112,0,6
55692,2,2519,2448,71,0,8,1,6
55693,1,2466,2284,182,0,40,0,6
55694,1,2434,2283,151,4,110,0,13
55695,1,2316,2447,-131,0,107,0,6
55696,2,2529,2513,16,0,156,1,6
55697,3,2533,2543,-10,0,50,0,6
55698,2,2404,2422,-18,0,112,1,6
55699,1,2545,2234,311,0,314,0,6
55700,2,2299,2490,-191,0,4,0,6
55701,2,2511,2458,53,0,100,0,6
55702,3,2444,2366,78,0,40,0,6
55703,1,2463,2316,147,0,300,0,6
55704,1,2403,2337,66,0,140,0,6
55705,3,2391,2457,-66,0,250,0,3
55706,1,2327,2454,-127,0,1,0,6
55707,2,2317,2494,-177,0,43,0,6
55708,1,2490,2474,16,0,156,0,6
55709,2,2503,2587,-84,0,200,0,6
55710,2,2416,2425,-9,0,300,0,6
55711,1,2484,2454,30,0,409,0,6
55712,1,2299,2446,-147,0,300,0,6
55713,1,2562,2406,156,0,107,0,6
55714,1,2491,2305,186,0,201,0,6
55715,2,2429,2306,123,0,202,0,6
55716,2,2387,2453,-66,0,9,0,6
55717,1,2500,2451,49,0,34,1,6
55718,1,2471,2232,239,0,41,0,6
55719,2,2281,2448,-167,0,320,1,6
55720,2,2359,2412,-53,0,469,0,6
55721,3,2265,2439,-174,0,16,0,6
55722,2,2313,2453,-140,0,101,0,6
55723,2,2276,2407,-131,0,302,0,6
55724,2,2414,2449,-35,0,15,1,6
55725,3,2395,2401,-6,0,152,0,6
55727,1,2505,2417,88,0,200,0,6
55728,2,2507,2463,44,0,130,0,6
55729,2,2382,2511,-129,0,6,0,6
55730,3,2402,2474,-72,0,301,0,6
55731,1,2593,2512,81,0,107,0,6
55732,1,2390,2421,-31,0,140,0,6
55733,1,2437,2279,158,0,335,0,6
55734,1,2467,2390,77,0,488,0,6
55735,3,2341,2450,-109,0,100,0,6
55736,1,2405,2413,-8,0,28,0,6
55737,1,2751,2547,204,0,112,0,6
55738,1,2554,2362,192,0,190,0,6
55739,1,2408,2262,146,0,210,0,6
55740,2,2456,2378,78,0,241,0,6
55741,1,2326,2498,-172,0,49,0,6
55742,2,2411,2363,48,0,130,1,6
55743,1,2505,2390,115,0,205,0,6
55744,2,2325,2433,-108,0,45,0,6
55745,2,2416,2354,62,0,140,1,6
55746,1,2631,2565,66,0,441,0,6
55747,2,2508,2378,130,0,40,1,6
55748,2,2598,2503,95,0,105,1,6
55749,3,2428,2310,118,0,440,0,6
55750,1,2334,2427,-93,0,374,0,6
55751,1,2533,2445,88,0,454,0,6
55752,2,2354,2416,-62,0,278,0,6
55753,1,2542,2428,114,0,45,0,6
55754,2,2544,2502,42,0,154,0,6
55755,1,2414,2292,122,0,122,0,6
55756,1,2427,2395,32,0,337,1,6
55757,1,2324,2443,-119,0,123,0,6
55758,1,2404,2367,37,0,13,0,6
55759,2,2431,2563,-132,0,300,0,6
55760,1,2304,2416,-112,0,7,1,8
55761,1,2354,2436,-82,0,109,0,6
55762,1,2423,2517,-94,0,46,0,6
55763,2,2452,2378,74,0,302,0,6
55764,1,2346,2414,-68,0,151,0,6
55765,2,2423,2556,-133,0,300,0,6
55766,1,2380,2446,-66,0,113,0,6
55767,3,2223,2425,-202,0,42,0,7
55768,1,2404,2411,-7,0,477,0,6
55769,1,2435,2429,6,0,300,0,6
55770,2,2248,2411,-163,0,107,0,6
55771,1,2452,2497,-45,0,43,0,6
55772,2,2315,2499,-184,0,466,1,6
55773,2,2248,2408,-160,0,101,0,6
55774,2,2392,2407,-15,0,247,0,6
55775,1,2332,2486,-154,0,108,0,6
55776,1,2439,2324,115,0,250,1,6
55777,1,2276,2492,-216,0,245,0,6
55778,2,2338,2514,-176,0,101,0,8
55779,2,2592,2572,20,0,463,0,6
55780,1,2386,2401,-15,0,13,0,6
55781,1,2433,2311,122,0,474,0,6
55782,3,2203,2405,-202,0,302,0,6
55783,1,2421,2411,10,0,101,0,6
55784,2,2402,2439,-37,0,70,0,6
55785,1,2434,2262,172,0,50,0,6
55786,1,2549,2564,-15,0,101,0,6
55787,1,2420,2337,83,0,9,0,6
55788,2,2457,2206,251,0,40,0,6
55789,1,2512,2482,30,0,108,0,6
55790,2,2424,2368,56,0,42,0,6
55791,1,2429,2321,108,0,154,0,6
55792,3,2506,2471,35,0,122,0,6
55793,2,2455,2441,14,0,140,1,6
55794,1,2544,2430,114,0,45,1,6
55795,1,2494,2246,248,0,120,0,6
55796,1,2505,2331,174,0,106,0,6
55797,1,2437,2490,-53,0,388,1,6
55798,3,2353,2458,-105,0,302,0,6
55799,2,2318,2421,-103,0,30,0,6
55800,2,2314,2754,-440,0,107,0,6
55801,1,2386,2509,-123,0,1,0,6
55802,2,2286,2422,-136,0,241,1,6
55803,2,2289,2418,-129,0,380,0,6
55804,3,2440,2414,26,0,201,0,6
55805,2,2247,2408,-161,0,280,0,6
55806,3,2456,2392,64,0,330,0,3
55807,1,2580,2445,135,0,490,1,6
55808,2,2390,2419,-29,0,335,1,6
55809,1,2447,2335,112,0,5,0,6
55810,1,2343,2482,-139,0,40,1,6
55811,3,2396,2409,-13,0,234,0,6
55812,1,2454,2335,119,0,40,0,6
55813,2,2280,2426,-146,0,8,0,6
55814,2,2307,2402,-95,0,7,0,6
55815,1,2725,2560,165,0,113,0,6
55816,2,2415,2321,94,0,102,0,6
55817,2,2489,2366,123,0,392,0,6
55818,1,2403,2588,-185,0,40,0,6
55819,1,2402,2363,39,0,100,0,6
55820,1,2478,2341,137,0,142,0,6
55821,1,2362,2404,-42,0,128,0,6
55822,2,2477,2517,-40,0,347,1,6
55823,1,2361,2410,-49,0,5,0,6
55824,2,2579,2586,-7,0,200,0,6
55825,1,2549,2528,21,0,132,0,6
55826,1,2476,2469,7,0,1,0,6
55827,3,2306,2409,-103,0,260,0,6
55828,2,2373,2555,-182,0,242,0,6
55829,1,2510,2449,61,0,109,0,6
55830,1,2424,2346,78,0,225,0,6
55831,2,2335,2400,-65,0,158,1,6
55832,2,2215,2422,-207,0,386,0,7
55833,3,2385,2401,-16,0,108,0,6
55834,2,2380,2494,-114,0,394,1,6
55835,2,2230,2442,-212,0,253,0,6
55836,2,2386,2413,-27,0,45,1,6
55837,1,2435,2247,188,0,133,0,6
55838,1,2538,2590,-52,0,156,0,6
55839,3,2489,2499,-10,0,7,0,6
55840,2,2432,2236,196,0,40,0,6
55841,2,2427,2395,32,0,106,0,6
55842,1,2575,2499,76,0,250,1,6
55843,1,2451,2203,248,4,335,0,13
55844,2,2424,2496,-72,0,31,0,6
55845,3,2244,2458,-214,0,374,0,6
55846,2,2427,2487,-60,0,45,0,6
55847,2,2395,2499,-104,0,6,0,6
55848,2,2620,2591,29,0,202,1,6
55849,1,2755,2448,307,0,101,0,6
55850,1,2505,2334,171,0,122,1,6
55851,2,2419,2454,-35,0,140,0,6
55852,2,2405,2320,85,0,45,0,6
55853,2,2505,2393,112,0,200,1,6
55854,2,2298,2426,-128,0,123,0,6
55855,2,2276,2548,-272,0,112,0,6
55856,1,2421,2469,-48,0,27,1,6
55857,1,2561,2214,347,0,65,0,6
55858,2,2402,2313,89,0,265,0,6
55859,1,2428,2331,97,0,106,0,6
55860,2,2370,2558,-188,0,113,0,6
55861,1,2464,2424,40,0,202,1,6
55862,2,2273,2491,-218,0,0,1,6
55863,1,2450,2303,147,0,110,0,6
55864,2,2341,2505,-164,0,46,0,6
55865,1,2483,2317,166,0,21,0,6
55866,2,2292,2447,-155,0,301,0,6
55867,1,2309,2421,-112,0,102,0,6
55868,2,2557,2396,161,0,11,0,6
55869,1,2409,2239,170,0,455,0,6
55870,1,2444,2408,36,0,335,0,6
55871,2,2484,2503,-19,0,122,1,6
55872,1,2478,2311,167,0,28,1,6
55873,1,2417,2420,-3,0,202,1,6
55874,2,2403,2728,-325,0,12,0,6
55875,2,2403,2242,161,0,310,1,6
55876,1,2414,2368,46,0,153,0,6
55877,1,2426,2209,217,0,106,0,6
55878,2,2329,2439,-110,0,13,0,6
55879,3,2369,2517,-148,0,102,0,6
55880,1,2372,2425,-53,0,387,0,7
55881,1,2456,2341,115,0,45,0,6
55882,1,2451,2401,50,0,48,0,6
55883,2,2444,2397,47,0,190,0,6
55884,1,2444,2400,44,0,61,0,6
55885,3,2341,2455,-114,0,0,0,6
55886,1,2442,2247,195,0,40,0,6
55887,1,2395,2584,-189,0,48,0,6
55888,1,2410,2495,-85,0,113,0,6
55889,1,2406,2328,78,0,102,0,6
55890,1,2468,2361,107,0,101,1,6
55891,2,2337,2482,-145,0,49,0,6
55892,2,2213,2562,-349,0,4,0,6
55893,1,2430,2233,197,0,335,0,6
55894,1,2414,2238,176,0,115,0,6
55895,2,2401,2501,-100,0,1,0,6
55896,2,2666,2483,183,0,15,0,6
55897,2,2498,2444,54,0,120,0,6
55898,1,2408,2445,-37,0,111,0,6
55899,2,2359,2445,-86,0,0,1,6
55900,1,2407,2201,206,0,15,0,6
55901,3,2430,2365,65,0,46,0,6
55902,2,2562,2584,-22,0,101,0,6
55903,2,2544,2515,29,0,103,0,6
55904,2,2437,2352,85,4,111,0,13
55905,1,2522,2476,46,0,7,0,6
55906,3,2393,2455,-62,0,190,0,3
55907,2,2321,2437,-116,0,253,0,6
55908,1,2412,2361,51,0,13,1,6
55909,2,2402,2385,17,0,100,0,6
55910,2,2229,2424,-195,0,13,0,6
55911,1,2307,2412,-105,0,463,1,6
55912,2,2448,2482,-34,0,310,0,6
55913,3,2322,2400,-78,0,125,0,6
55914,2,2401,2420,-19,0,102,0,6
55915,2,2422,2453,-31,0,300,0,6
55916,3,2539,2549,-10,0,113,0,6
55917,2,2385,2404,-19,0,463,0,6
55918,1,2494,2279,215,0,223,0,6
55919,1,2404,2299,105,0,35,0,6
55920,2,2567,2398,169,0,101,1,6
55921,3,2263,2408,-145,0,268,0,8
55922,1,2561,2381,180,0,226,0,6
55923,1,2501,2757,-256,0,109,0,6
55924,2,2446,2358,88,0,40,1,6
55925,1,2404,2385,19,4,57,0,13
55926,2,2386,2400,-14,0,171,0,6
55927,1,2430,2281,149,0,4,0,6
55929,1,2460,2386,74,0,45,1,6
55930,2,2443,2315,128,0,380,0,6
55931,2,2410,2481,-71,0,380,0,6
55932,2,2493,2433,60,0,112,0,6
55933,1,2597,2580,17,0,474,1,6
55934,2,2332,2489,-157,0,0,0,6
55935,2,2363,2418,-55,0,6,1,6
55936,2,2331,2503,-172,0,117,1,6
55937,2,2343,2550,-207,0,302,0,6
55938,2,2231,2564,-333,0,170,1,6
55939,2,2272,2432,-160,0,302,1,6
55940,3,2436,2327,109,0,106,0,6
55941,2,2377,2448,-71,0,106,0,6
55942,1,2505,2348,157,0,15,0,6
55943,1,2450,2322,128,0,45,0,6
55944,2,2321,2467,-146,0,101,0,6
55945,1,2489,2338,151,0,123,0,8
55946,1,2501,2383,118,0,148,0,6
55947,1,2580,2550,30,0,101,0,6
55948,1,2352,2400,-48,0,345,0,6
55949,1,2419,2327,92,0,106,0,6
55950,2,2487,2443,44,0,411,0,6
55951,1,2419,2380,39,0,300,1,6
55952,1,2730,2589,141,0,101,1,6
55953,2,2306,2538,-232,0,41,0,6
55954,1,2428,2375,53,0,130,0,6
55955,2,2345,2451,-106,0,140,0,8
55956,1,2498,2429,69,0,81,0,6
55957,2,2254,2404,-150,0,4,1,8
55958,1,2486,2334,152,0,101,0,6
55959,1,2527,2488,39,0,5,0,6
55960,2,2417,2418,-1,0,234,0,6
55961,1,2403,2324,79,0,147,0,6
55962,2,2397,2538,-141,0,1,0,6
55963,1,2402,2280,122,0,42,1,6
55964,1,2521,2478,43,0,108,0,6
55965,1,2482,2491,-9,0,27,1,6
55966,1,2521,2383,138,0,483,0,6
55967,2,2439,2485,-46,0,253,0,6
55968,2,2400,2248,152,0,140,0,6
55969,2,2338,2445,-107,0,15,0,6
55970,2,2453,2575,-122,0,45,0,6
55971,2,2458,2304,154,0,106,0,6
55972,1,2564,2417,147,0,113,0,6
55973,1,2462,2312,150,0,58,0,6
55974,2,2301,2428,-127,0,400,0,6
55975,2,2349,2414,-65,0,133,0,6
55976,2,2449,2403,46,0,43,1,6
55977,2,2427,2355,72,0,40,0,6
55978,2,2233,2410,-177,0,28,0,6
55979,2,2454,2306,148,0,106,0,6
55980,1,2408,2384,24,0,113,0,6
55981,2,2365,2429,-64,0,300,0,6
55982,1,2425,2366,59,0,14,1,6
55983,2,2439,2395,44,0,300,1,6
55984,3,2657,2483,174,0,15,0,6
55985,2,2404,2438,-34,0,404,1,6
55986,2,2438,2378,60,0,246,0,6
55987,1,2748,2315,433,0,106,0,6
55988,2,2523,2472,51,0,380,1,6
55989,2,2546,2539,7,0,351,0,6
55990,2,2238,2450,-212,0,202,0,6
55991,1,2549,2430,119,0,464,1,6
55992,3,2453,2384,69,0,300,0,6
55993,2,2324,2414,-90,0,43,0,6
55994,2,2408,2351,57,0,17,0,6
55995,1,2574,2603,-29,0,205,0,6
55996,2,2432,2271,161,0,483,1,6
55997,1,2249,2420,-171,0,48,0,7
55998,2,2343,2434,-91,0,49,0,6
55999,3,2356,2417,-61,0,414,0,6
56000,2,2331,2458,-127,0,48,1,6
56001,1,2506,2328,178,0,300,0,6
56002,1,2467,2330,137,0,131,1,8
56003,2,2329,2485,-156,0,1,0,6
56004,1,2540,2236,304,0,14,0,6
56005,1,2553,2323,230,0,45,0,6
56006,1,2565,2308,257,0,414,0,6
56007,1,2425,2304,121,0,112,0,6
56008,1,2423,2411,12,0,386,1,6
56009,1,2453,2465,-12,0,302,0,6
56010,1,2569,2537,32,0,115,0,6
56011,1,2492,2344,148,0,101,0,8
56012,1,2539,2524,15,0,140,0,6
56013,1,2374,2432,-58,0,100,0,6
56014,3,2299,2408,-109,0,280,0,6
56015,1,2394,2423,-29,0,51,1,6
56016,1,2529,2420,109,0,202,0,6
56017,1,2410,2242,168,0,4,0,6
56018,2,2460,2476,-16,0,125,0,6
56019,1,2381,2508,-127,0,190,0,6
56020,1,2456,2323,133,0,48,0,6
56021,2,2406,2443,-37,0,102,0,6
56022,3,2277,2410,-133,0,448,0,6
56023,2,2229,2433,-204,0,218,1,6
56024,2,2483,2419,64,0,125,0,6
56025,2,2491,2435,56,0,112,0,6
56026,1,2514,2372,142,0,15,0,6
56027,2,2386,2446,-60,0,409,0,6
56028,2,2586,2734,-148,0,154,1,6
56029,2,2547,2486,61,0,234,0,6
56030,2,2453,2265,188,0,345,0,6
56031,1,2423,2425,-2,0,200,0,6
56032,2,2375,2446,-71,0,54,0,6
56033,3,2597,2585,12,0,310,0,6
56034,1,2479,2526,-47,0,105,0,6
56035,2,2362,2449,-87,0,0,1,6
56036,2,2236,2420,-184,0,101,0,6
56037,1,2579,2280,299,0,385,1,6
56038,1,2491,2311,180,2,202,0,24
56040,1,2545,2636,-91,0,127,0,6
56041,1,2495,2405,90,0,255,0,6
56042,1,2527,2393,134,0,211,0,6
56043,3,2492,2466,26,0,373,0,6
56044,1,2347,2542,-195,0,111,0,6
56045,1,2567,2344,223,0,41,0,6
56046,2,2377,2432,-55,0,101,0,6
56047,1,2402,2306,96,0,202,0,6
56048,1,2591,2414,177,0,8,0,6
56049,1,2414,2568,-154,0,243,1,6
56050,1,2407,2354,53,4,130,0,13
56051,1,2434,2297,137,0,106,1,6
56052,3,2454,2394,60,0,250,0,3
56053,1,2414,2480,-66,0,143,0,6
56054,2,2338,2474,-136,0,344,0,6
56055,2,2485,2235,250,0,120,0,6
56056,1,2490,2325,165,0,40,0,6
56057,1,2439,2231,208,0,101,0,6
56058,1,2469,2305,164,0,202,0,8
56059,2,2432,2266,166,0,146,0,6
56060,2,2506,2555,-49,0,301,0,6
56061,1,2450,2554,-104,0,184,0,6
56062,2,2501,2655,-154,0,455,0,6
56063,1,2414,2213,201,0,456,1,6
56064,2,2361,2748,-387,0,108,0,6
56065,2,2228,2430,-202,0,103,0,6
56066,2,2215,2441,-226,0,315,0,6
56067,3,2499,2385,114,0,46,0,6
56068,3,2385,2407,-22,0,157,0,6
56069,1,2447,2366,81,0,106,0,6
56070,2,2443,2398,45,0,190,1,6
56071,2,2424,2406,18,0,0,1,6
56072,2,2481,2454,27,0,211,0,6
56073,1,2532,2553,-21,0,426,0,6
56074,2,2518,2368,150,0,45,1,6
56075,3,2368,2421,-53,0,110,0,6
56076,1,2459,2385,74,0,300,0,6
56077,2,2439,2459,-20,0,45,0,6
56078,2,2382,2401,-19,0,9,0,6
56079,2,2219,2539,-320,0,123,0,6
56080,1,2227,2401,-174,0,100,0,6
56081,2,2316,2496,-180,0,242,0,8
56082,1,2438,2399,39,0,341,0,6
56083,1,2452,2444,8,0,1,0,6
56084,1,2414,2299,115,0,85,1,6
56085,3,2217,2429,-212,0,110,0,6
56086,2,2424,2503,-79,0,200,0,6
56087,1,2384,2426,-42,0,190,1,6
56088,1,2443,2213,230,0,302,0,6
56089,1,2419,2375,44,0,300,0,6
56090,2,2358,2428,-70,0,130,0,6
56091,1,2579,2324,255,0,1,1,6
56092,1,2397,2464,-67,0,140,0,6
56093,1,2445,2327,118,0,53,1,6
56094,2,2411,2375,36,0,135,0,7
56095,2,2451,2320,131,0,45,0,6
56096,1,2466,2463,3,0,40,1,6
56097,2,2533,2550,-17,0,101,0,6
56098,1,2437,2342,95,0,43,1,6
56099,1,2406,2406,0,0,200,0,6
56100,2,2346,2423,-77,0,302,1,6
56101,2,2433,2332,101,0,14,0,6
56102,1,2364,2400,-36,0,345,0,6
56103,1,2501,2411,90,0,302,0,6
56104,1,2322,2478,-156,0,1,1,6
56105,2,2441,2357,84,0,122,0,6
56106,2,2390,2595,-205,0,1,0,6
56107,1,2444,2420,24,0,45,1,6
56108,1,2417,2226,191,0,142,0,6
56109,1,2381,2436,-55,0,200,0,6
56110,1,2274,2476,-202,0,302,1,6
56111,3,2585,2597,-12,0,205,0,6
56112,2,2449,2271,178,0,277,0,6
56113,1,2628,2552,76,0,330,0,6
56114,1,2426,2332,94,0,106,1,6
56115,1,2352,2471,-119,0,107,1,8
56116,2,2407,2238,169,0,132,0,8
56117,2,2249,2404,-155,0,46,0,6
56118,1,2443,2440,3,0,310,0,6
56119,2,2381,2424,-43,0,463,0,6
56120,1,2454,2285,169,0,314,1,6
56121,2,2501,2360,141,0,225,0,6
56122,2,2560,2750,-190,0,300,0,6
56123,1,2500,2217,283,0,120,0,6
56124,2,2506,2485,21,0,140,0,6
56125,1,2487,2334,153,0,192,0,6
56126,1,2582,2675,-93,0,154,0,6
56127,1,2443,2418,25,0,30,0,6
56128,1,2363,2430,-67,4,196,1,13
56129,2,2233,2405,-172,0,106,1,7
56130,1,2437,2581,-144,0,49,0,6
56131,1,2560,2483,77,0,267,0,6
56132,1,2364,2443,-79,0,426,0,6
56133,1,2341,2422,-81,0,16,0,6
56134,1,2301,2466,-165,0,83,0,6
56135,1,2569,2367,202,0,160,0,6
56137,2,2403,2406,-3,0,15,0,6
56138,1,2426,2426,0,0,117,0,6
56139,2,2456,2448,8,0,301,1,6
56140,2,2713,2625,88,0,8,0,6
56141,1,2436,2433,3,0,130,0,6
56142,2,2522,2540,-18,0,34,0,6
56143,2,2428,2429,-1,0,335,0,6
56144,1,2500,2501,-1,0,100,0,6
56145,1,2420,2418,2,0,45,0,6
56146,1,2401,2402,-1,0,140,1,6
56147,2,2479,2476,3,0,305,0,6
56148,2,2618,2616,2,0,14,0,6
56149,1,2587,2614,-27,0,40,1,6
56150,2,2422,2422,0,0,106,0,6
56151,2,2417,2418,-1,0,476,1,6
56152,1,2414,2417,-3,0,108,0,6
56153,1,2408,2411,-3,0,202,0,6
56154,2,2552,2545,7,0,131,0,6
56155,1,2493,2497,-4,0,13,0,6
56156,2,2400,2400,0,0,311,0,6
56157,1,2505,2506,-1,0,45,0,6
56158,1,2432,2433,-1,0,190,0,6
56159,2,2450,2493,-43,0,5,0,6
56160,2,2433,2597,-164,0,113,0,6
56161,2,2547,2362,185,0,455,0,6
56162,1,2531,2387,144,0,245,1,6
56163,1,2658,2497,161,0,484,0,6
56164,2,2532,2570,-38,0,170,0,6
56165,2,2405,2385,20,0,412,1,6
56166,1,2462,2503,-41,0,344,0,6
56167,2,2414,2412,2,0,16,1,6
56168,2,2438,2460,-22,0,0,0,6
56169,1,2379,2417,-38,0,320,1,6
56170,3,2395,2453,-58,0,250,0,3
56171,1,2462,2284,178,0,30,1,6
56172,1,2464,2442,22,0,176,0,6
56173,1,2340,2451,-111,0,0,0,6
56174,2,2465,2434,31,0,303,0,6
56175,2,2434,2409,25,0,131,0,6
56176,1,2319,2410,-91,4,11,0,13
56177,1,2464,2301,163,0,40,0,6
56178,3,2466,2446,20,0,380,0,6
56179,1,2499,2338,161,0,123,0,8
56180,2,2381,2425,-44,0,455,0,6
56181,1,2334,2442,-108,0,335,0,6
56182,2,2547,2425,122,0,13,0,6
56183,1,2302,2502,-200,0,150,0,6
56184,2,2424,2489,-65,0,106,0,6
56185,2,2418,2393,25,0,0,0,6
56186,2,2328,2490,-162,0,0,1,6
56187,1,2612,2370,242,0,200,1,6
56188,2,2223,2426,-203,0,45,0,6
56189,1,2347,2412,-65,0,301,1,6
56190,1,2401,2369,32,0,112,0,6
56191,2,2279,2479,-200,0,414,1,6
56192,2,2433,2411,22,0,150,0,6
56193,1,2495,2241,254,0,10,0,6
56194,1,2456,2331,125,0,337,0,8
56195,2,2333,2443,-110,0,54,0,6
56196,1,2329,2447,-118,0,40,1,6
56197,1,2573,2425,148,0,385,0,6
56198,1,2434,2259,175,0,45,0,6
56199,2,2446,2445,1,0,49,1,6
56200,1,2387,2418,-31,0,101,0,6
56201,3,2627,2575,52,0,171,0,6
56202,1,2449,2266,183,0,15,0,6
56203,2,2444,2309,135,0,7,0,6
56204,1,2491,2547,-56,0,112,0,6
56205,2,2478,2564,-86,0,247,0,6
56206,1,2406,2420,-14,0,300,0,6
56207,2,2380,2449,-69,0,132,0,6
56208,2,2451,2633,-182,0,400,0,6
56210,2,2453,2282,171,0,300,0,6
56211,2,2404,2449,-45,0,130,0,6
56212,1,2428,2414,14,0,101,1,6
56213,1,2385,2414,-29,0,0,1,6
56214,1,2457,2510,-53,0,90,1,6
56215,1,2402,2354,48,0,106,1,6
56216,2,2505,2516,-11,0,31,0,6
56217,2,2364,2442,-78,0,194,1,6
56218,1,2402,2407,-5,0,45,0,6
56219,1,2393,2457,-64,0,485,0,6
56220,1,2467,2311,156,0,16,0,6
56221,2,2507,2468,39,0,146,0,6
56222,2,2549,2596,-47,0,201,0,6
56223,3,2368,2457,-89,0,113,0,6
56224,2,2282,2433,-151,0,202,1,6
56225,1,2228,2420,-192,0,101,0,6
56226,1,2416,2284,132,0,4,1,6
56227,2,2470,2467,3,0,300,0,6
56228,2,2494,2661,-167,0,5,0,6
56229,1,2436,2371,65,0,150,0,6
56230,2,2416,2427,-11,4,140,1,13
56231,1,2498,2430,68,0,45,0,6
56232,1,2467,2414,53,0,16,1,6
56233,2,2246,2753,-507,0,41,1,6
56234,2,2428,2557,-129,0,302,0,6
56235,2,2205,2425,-220,0,102,0,6
56236,2,2365,2430,-65,0,145,0,6
56237,1,2486,2228,258,0,330,1,6
56238,2,2280,2500,-220,0,488,0,6
56239,2,2457,2329,128,0,211,0,6
56240,2,2523,2465,58,0,302,0,6
56241,1,2500,2474,26,0,45,0,6
56242,1,2330,2446,-116,0,1,0,6
56243,1,2408,2304,104,0,202,1,6
56244,2,2406,2494,-88,0,202,0,6
56245,1,2457,2312,145,0,140,0,6
56246,2,2429,2432,-3,0,45,0,6
56247,1,2414,2345,69,0,100,0,6
56248,2,2416,2496,-80,0,100,0,6
56249,2,2413,2539,-126,0,45,0,6
56250,2,2624,2632,-8,0,46,1,6
56251,2,2546,2612,-66,0,177,0,6
56252,2,2668,2585,83,0,310,0,6
56253,1,2407,2371,36,0,211,0,6
56254,1,2498,2311,187,0,466,1,6
56255,2,2306,2494,-188,0,43,1,6
56256,1,2414,2420,-6,0,432,0,6
56257,1,2334,2464,-130,0,107,0,8
56258,1,2408,2340,68,0,46,0,7
56259,1,2424,2241,183,0,143,1,6
56260,2,2433,2467,-34,0,112,0,6
56261,2,2359,2458,-99,0,306,1,6
56263,1,2472,2445,27,0,49,0,6
56264,2,2369,2643,-274,0,16,0,6
56265,1,2407,2302,105,4,200,0,13
56266,2,2246,2413,-167,0,45,0,6
56267,1,2401,2444,-43,0,200,0,6
56268,2,2511,2276,235,0,45,0,6
56269,3,2345,2408,-63,0,20,0,6
56270,2,2498,2503,-5,0,152,0,6
56271,2,2314,2428,-114,0,461,0,6
56272,2,2401,2397,4,0,4,0,6
56273,3,2347,2504,-157,0,4,0,6
56274,1,2455,2256,199,0,45,1,6
56275,1,2437,2369,68,0,305,0,6
56276,2,2416,2412,4,0,106,0,6
56277,1,2401,2369,32,0,380,0,6
56278,1,2401,2377,24,0,40,0,6
56279,2,2497,2541,-44,0,302,1,6
56280,3,2420,2310,110,0,210,0,6
56281,3,2396,2452,-56,0,28,0,3
56282,2,2419,2329,90,0,130,1,6
56283,1,2412,2304,108,4,240,1,13
56284,2,2464,2417,47,0,484,0,6
56285,1,2427,2399,28,0,140,1,6
56286,2,2505,2232,273,0,11,0,6
56287,1,2345,2467,-122,0,16,0,6
56288,1,2706,2280,426,0,107,0,6
56289,1,2216,2406,-190,0,102,0,6
56290,2,2309,2508,-199,0,115,0,6
56291,3,2473,2384,89,0,96,0,6
56292,3,2364,2447,-83,0,140,0,6
56293,2,2405,2577,-172,0,190,1,6
56294,1,2667,2354,313,0,106,0,6
56295,2,2425,2492,-67,0,123,1,6
56296,2,2439,2494,-55,0,403,0,6
56297,1,2636,2448,188,0,57,0,6
56298,1,2302,2423,-121,0,4,0,6
56299,1,2408,2288,120,0,5,0,8
56300,1,2526,2307,219,0,43,1,6
56301,1,2233,2471,-238,0,106,0,6
56302,1,2547,2357,190,0,337,0,6
56303,1,2414,2396,18,0,123,0,6
56304,2,2412,2387,25,0,100,1,6
56305,1,2422,2236,186,0,4,0,6
56306,2,2284,2484,-200,0,15,0,6
56307,1,2454,2428,26,0,300,1,6
56308,1,2443,2276,167,0,3,0,6
56309,2,2302,2576,-274,0,123,0,6
56310,1,2437,2411,26,0,123,0,6
56311,1,2501,2407,94,0,120,0,6
56312,2,2367,2534,-167,0,327,0,6
56313,1,2497,2454,43,0,134,1,6
56314,1,2437,2270,167,0,152,0,6
56315,1,2441,2351,90,0,250,0,6
56316,1,2573,2465,108,0,201,0,6
56317,1,2455,2447,8,0,301,0,6
56318,2,2439,2410,29,0,101,1,6
56319,1,2413,2552,-139,0,49,0,6
56320,1,2725,2569,156,0,242,1,6
56321,1,2543,2368,175,0,1,0,6
56322,2,2387,2402,-15,0,114,0,6
56323,1,2390,2498,-108,0,31,0,6
56324,2,2603,2339,264,0,44,0,6
56325,2,2401,2412,-11,4,129,0,13
56326,2,2421,2406,15,0,133,0,6
56327,2,2522,2517,5,0,107,0,6
56328,1,2398,2443,-45,0,15,0,6
56329,1,2440,2277,163,0,118,0,6
56330,1,2753,2561,192,0,112,0,6
56331,1,2437,2424,13,0,101,0,6
56332,1,2435,2409,26,0,111,1,6
56333,2,2390,2420,-30,0,485,1,6
56334,1,2419,2499,-80,0,4,0,6
56335,2,2203,2504,-301,0,16,1,6
56336,2,2438,2330,108,0,302,0,6
56337,2,2365,2412,-47,0,255,1,6
56338,1,2300,2442,-142,0,10,1,6
56339,1,2274,2421,-147,0,0,1,6
56340,2,2436,2416,20,0,198,0,6
56341,2,2401,2627,-226,0,180,0,6
56342,2,2432,2500,-68,0,122,0,6
56343,3,2434,2376,58,0,311,0,6
56344,1,2398,2441,-43,0,389,1,6
56345,2,2337,2436,-99,0,121,0,6
56346,2,2499,2493,6,0,298,0,6
56347,2,2307,2510,-203,0,40,0,6
56348,2,2352,2685,-333,0,470,0,6
56349,1,2402,2338,64,0,0,1,6
56350,1,2327,2407,-80,0,101,0,6
56351,2,2403,2230,173,0,109,0,6
56352,2,2284,2421,-137,0,117,0,6
56353,1,2451,2395,56,0,310,1,6
56354,1,2661,2538,123,0,320,0,6
56355,3,2440,2387,53,0,9,0,6
56356,1,2290,2502,-212,0,115,1,6
56357,2,2415,2310,105,0,247,0,6
56358,1,2395,2499,-104,0,0,0,6
56359,2,2333,2491,-158,0,300,0,6
56360,3,2511,2593,-82,0,4,0,6
56361,1,2419,2255,164,0,107,0,6
56362,1,2375,2471,-96,0,122,0,6
56363,1,2424,2364,60,0,4,0,6
56364,2,2407,2273,134,0,143,1,6
56365,1,2462,2308,154,0,200,0,6
56366,2,2420,2542,-122,0,300,0,6
56367,1,2593,2556,37,0,101,0,6
56368,2,2416,2472,-56,0,122,0,6
56369,3,2474,2322,152,0,34,0,6
56370,2,2629,2638,-9,0,31,0,6
56371,1,2558,2425,133,0,45,0,6
56372,2,2321,2756,-435,0,6,0,6
56373,2,2392,2406,-14,0,331,0,6
56374,2,2457,2399,58,0,142,0,6
56375,2,2394,2470,-76,0,110,0,6
56376,2,2337,2404,-67,0,466,1,6
56377,2,2475,2410,65,0,40,0,6
56378,2,2385,2492,-107,0,1,0,6
56379,1,2546,2455,91,0,253,1,6
56380,2,2451,2359,92,0,15,0,6
56381,1,2482,2428,54,0,112,0,6
56382,2,2284,2529,-245,0,455,0,6
56383,2,2262,2430,-168,0,302,0,6
56384,2,2221,2413,-192,0,300,1,6
56385,2,2252,2458,-206,0,45,1,6
56386,1,2493,2459,34,0,133,0,6
56387,3,2571,2577,-6,0,335,0,6
56388,1,2545,2381,164,0,461,0,6
56389,1,2474,2252,222,0,80,0,6
56390,1,2609,2216,393,0,306,0,6
56391,2,2423,2444,-21,0,302,0,6
56392,2,2205,2405,-200,0,5,0,6
56393,2,2461,2470,-9,0,244,0,6
56394,1,2461,2340,121,0,253,1,6
56395,2,2383,2504,-121,0,426,1,6
56396,1,2436,2542,-106,0,84,0,6
56397,1,2404,2413,-9,0,13,0,6
56398,1,2446,2394,52,0,300,1,6
56399,1,2417,2262,155,0,313,0,6
56400,3,2456,2340,116,0,101,0,8
56401,1,2516,2546,-30,0,15,0,6
56402,1,2458,2423,35,0,484,0,6
56403,2,2207,2580,-373,0,201,1,6
56404,1,2402,2289,113,0,101,0,6
56405,2,2237,2415,-178,0,4,0,6
56406,2,2365,2439,-74,0,461,0,6
56407,1,2441,2241,200,0,310,0,6
56408,2,2360,2471,-111,0,403,0,6
56409,3,2506,2433,73,0,15,0,6
56410,2,2465,2310,155,0,429,1,6
56411,2,2366,2410,-44,0,110,1,6
56412,2,2512,2516,-4,0,46,1,6
56413,2,2496,2520,-24,0,302,1,6
56414,2,2336,2432,-96,0,331,1,6
56415,1,2700,2402,298,0,150,0,6
56416,2,2491,2350,141,0,80,1,6
56417,3,2270,2422,-152,0,110,0,6
56418,1,2466,2371,95,0,41,0,6
56419,1,2417,2422,-5,0,300,0,6
56420,2,2216,2431,-215,0,310,1,6
56421,1,2404,2251,153,0,118,0,8
56422,2,2334,2406,-72,0,52,0,6
56423,3,2394,2596,-202,0,123,0,6
56424,1,2565,2729,-164,0,241,0,6
56425,1,2617,2634,-17,0,226,0,6
56426,1,2496,2421,75,0,15,0,6
56427,1,2592,2491,101,0,106,0,6
56428,2,2259,2579,-320,0,310,1,6
56429,1,2234,2433,-199,0,248,0,6
56430,1,2445,2271,174,0,4,1,6
56431,1,2370,2439,-69,0,142,0,6
56432,2,2421,2434,-13,0,302,0,6
56433,2,2562,2442,120,0,426,0,6
56434,1,2418,2381,37,0,46,1,6
56435,2,2381,2466,-85,0,1,0,6
56436,2,2429,2259,170,0,140,0,6
56437,1,2292,2432,-140,0,28,0,6
56438,3,2338,2402,-64,0,4,0,6
56439,1,2402,2207,195,0,112,0,6
56440,3,2422,2459,-37,0,34,0,6
56441,1,2400,2320,80,0,1,1,6
56442,2,2364,2516,-152,0,111,0,6
56443,1,2644,2738,-94,0,345,1,6
56444,2,2202,2481,-279,0,17,0,6
56445,1,2259,2623,-364,0,45,0,6
56446,2,2619,2411,208,0,304,0,6
56447,3,2476,2482,-6,0,123,0,6
56448,1,2400,2308,92,0,4,0,6
56449,2,2448,2277,171,0,300,0,6
56450,3,2451,2397,54,0,288,0,3
56451,1,2382,2406,-24,0,330,0,6
56452,2,2420,2551,-131,0,45,0,6
56453,2,2383,2450,-67,0,132,0,6
56455,1,2555,2440,115,0,130,0,6
56456,1,2404,2421,-17,0,300,0,6
56457,1,2228,2417,-189,0,246,1,6
56458,2,2433,2317,116,0,400,0,6
56459,2,2238,2501,-263,0,121,0,6
56460,1,2424,2323,101,0,148,1,6
56461,2,2281,2425,-144,0,348,1,6
56462,2,2359,2429,-70,0,473,1,6
56463,3,2377,2534,-157,0,260,0,6
56464,3,2406,2243,163,4,130,0,13
56465,1,2533,2379,154,0,122,0,6
56466,2,2500,2449,51,0,120,0,6
56467,2,2311,2406,-95,0,128,0,6
56468,1,2464,2299,165,0,46,0,6
56469,2,2404,2471,-67,0,40,0,6
56470,2,2306,2515,-209,0,310,0,6
56471,1,2531,2593,-62,0,215,1,6
56472,2,2261,2407,-146,0,491,0,6
56473,1,2413,2415,-2,0,9,0,6
56474,2,2416,2444,-28,0,123,0,6
56475,2,2250,2402,-152,0,250,1,6
56476,1,2551,2665,-114,0,154,0,6
56477,2,2457,2446,11,0,6,0,6
56478,2,2314,2400,-86,0,46,1,6
56479,1,2416,2372,44,0,45,0,6
56480,1,2491,2408,83,0,48,0,6
56481,1,2242,2434,-192,0,45,0,6
56482,1,2708,2504,204,0,460,0,6
56483,1,2546,2473,73,0,103,0,6
56484,2,2424,2424,0,4,80,0,13
56485,1,2534,2216,318,0,205,0,6
56486,1,2555,2397,158,0,7,0,6
56487,1,2347,2461,-114,0,48,0,6
56488,2,2592,2477,115,0,398,1,6
56489,3,2492,2464,28,0,200,0,6
56490,3,2540,2487,53,0,40,0,6
56491,2,2454,2498,-44,0,300,0,6
56492,1,2581,2321,260,0,335,0,6
56493,1,2757,2450,307,0,218,0,6
56494,2,2571,2598,-27,0,310,0,6
56495,2,2248,2407,-159,0,190,0,8
56496,1,2420,2269,151,0,112,0,6
56497,2,2401,2247,154,0,0,0,6
56499,2,2263,2513,-250,0,4,0,6
56500,1,2451,2362,89,0,106,0,6
56501,2,2333,2418,-85,0,1,0,6
56502,2,2461,2554,-93,0,300,1,6
56503,1,2321,2467,-146,0,302,0,6
56504,1,2410,2306,104,0,205,0,6
56505,1,2731,2362,369,0,101,0,6
56506,1,2385,2541,-156,0,112,0,6
56507,1,2503,2449,54,0,133,0,6
56508,1,2289,2451,-162,0,123,0,6
56509,1,2202,2421,-219,0,154,0,6
56510,1,2440,2209,231,0,46,1,6
56511,3,2416,2369,47,0,315,0,6
56512,3,2417,2463,-46,0,203,0,6
56513,1,2414,2504,-90,0,13,0,6
56514,2,2455,2407,48,0,142,0,6
56515,2,2439,2361,78,0,13,0,6
56516,2,2304,2416,-112,0,320,1,6
56517,1,2392,2483,-91,0,1,0,6
56518,1,2639,2523,116,0,441,0,6
56519,1,2503,2362,141,0,197,0,6
56520,1,2477,2478,-1,0,335,1,6
56521,1,2453,2236,217,0,455,0,6
56522,2,2272,2537,-265,0,42,1,6
56523,1,2467,2457,10,0,43,1,6
56524,1,2327,2425,-98,0,46,0,6
56525,2,2411,2257,154,0,140,0,6
56526,3,2273,2402,-129,0,101,0,6
56527,2,2525,2491,34,0,302,0,6
56528,1,2720,2574,146,0,277,1,6
56529,2,2412,2393,19,0,4,0,6
56530,2,2407,2410,-3,0,315,1,6
56531,2,2605,2602,3,0,13,1,6
56532,1,2414,2322,92,0,464,0,6
56533,2,2270,2415,-145,0,115,0,6
56534,1,2406,2333,73,0,43,0,6
56535,2,2359,2482,-123,0,101,1,6
56536,2,2257,2423,-166,0,456,1,6
56537,3,2404,2436,-32,0,300,0,6
56538,1,2614,2416,198,0,5,0,6
56539,2,2425,2314,111,0,140,0,6
56540,3,2281,2495,-214,0,101,0,6
56541,1,2419,2386,33,0,129,0,6
56542,1,2328,2471,-143,0,45,0,6
56543,2,2449,2334,115,0,263,0,6
56544,2,2411,2423,-12,0,123,0,6
56545,1,2459,2315,144,0,45,1,6
56546,2,2412,2370,42,0,127,0,6
56547,1,2440,2331,109,0,107,0,6
56548,2,2248,2454,-206,0,44,0,8
56549,2,2247,2419,-172,0,101,0,6
56550,1,2273,2424,-151,0,483,0,6
56551,2,2464,2343,121,0,150,1,6
56552,2,2353,2428,-75,0,201,0,6
56553,2,2319,2558,-239,0,112,0,6
56554,1,2612,2261,351,0,43,0,6
56555,2,2242,2416,-174,0,4,0,7
56556,1,2586,2241,345,0,83,0,6
56557,3,2495,2538,-43,0,202,0,6
56558,2,2406,2246,160,0,104,0,6
56559,1,2498,2357,141,0,46,0,6
56560,2,2597,2539,58,0,211,0,6
56561,1,2581,2411,170,0,335,0,6
56562,2,2266,2457,-191,0,48,1,6
56563,1,2424,2294,130,0,106,1,6
56564,3,2391,2486,-95,0,404,0,6
56565,1,2508,2382,126,0,411,1,6
56566,2,2376,2447,-71,0,140,1,6
56567,2,2444,2314,130,0,300,0,6
56568,3,2317,2487,-170,0,244,0,6
56569,2,2259,2426,-167,0,426,0,6
56570,1,2461,2442,19,0,53,0,6
56571,1,2549,2732,-183,0,310,1,6
56572,2,2366,2583,-217,0,203,0,6
56573,2,2330,2436,-106,0,130,1,6
56574,1,2379,2497,-118,0,56,1,6
56575,2,2341,2446,-105,0,45,0,6
56576,3,2398,2450,-52,0,332,0,3
56577,2,2314,2453,-139,4,135,1,13
56578,1,2459,2237,222,0,101,1,6
56579,2,2497,2442,55,0,28,0,6
56580,2,2296,2485,-189,0,8,0,6
56581,1,2477,2399,78,0,314,0,6
56582,1,2410,2239,171,0,247,1,6
56583,2,2409,2321,88,0,34,1,6
56584,2,2410,2759,-349,0,147,0,6
56585,2,2263,2614,-351,0,48,0,6
56586,2,2259,2415,-156,0,4,0,6
56587,2,2218,2507,-289,0,72,1,6
56588,2,2463,2405,58,0,43,0,6
56589,3,2266,2403,-137,0,491,0,6
56590,2,2275,2415,-140,0,103,0,6
56591,1,2400,2448,-48,0,40,1,6
56592,2,2432,2587,-155,0,200,0,6
56593,3,2559,2561,-2,0,101,0,6
56594,1,2433,2421,12,0,216,0,6
56595,1,2405,2247,158,0,150,1,6
56596,2,2423,2329,94,0,225,1,6
56597,2,2251,2617,-366,0,120,0,6
56598,2,2411,2414,-3,0,338,0,6
56599,2,2412,2486,-74,0,120,0,6
56600,2,2476,2248,228,0,225,0,6
56601,2,2442,2400,42,0,40,0,6
56602,2,2404,2362,42,0,151,1,6
56603,1,2519,2611,-92,0,301,1,6
56604,2,2357,2468,-111,0,102,0,6
56605,1,2498,2413,85,0,45,1,6
56606,2,2407,2449,-42,0,46,0,6
56607,3,2355,2433,-78,4,326,0,13
56608,2,2317,2406,-89,0,1,0,6
56609,2,2399,2585,-186,0,0,0,6
56610,2,2615,2516,99,0,409,1,6
56611,1,2425,2412,13,0,123,0,6
56612,2,2374,2559,-185,0,317,0,6
56613,2,2223,2457,-234,0,113,0,6
56614,1,2536,2283,253,2,202,1,24
56615,1,2550,2565,-15,0,132,0,6
56616,1,2360,2456,-96,0,123,0,6
56617,2,2307,2502,-195,0,201,1,6
56618,2,2385,2531,-146,0,304,0,6
56619,2,2300,2412,-112,0,150,0,6
56621,2,2533,2460,73,0,405,0,6
56622,1,2411,2245,166,0,101,1,8
56623,2,2423,2433,-10,0,302,0,6
56624,2,2446,2298,148,0,463,0,6
56625,2,2546,2589,-43,0,17,0,6
56626,2,2462,2389,73,0,484,1,6
56627,1,2401,2313,88,0,250,0,8
56628,3,2417,2418,-1,0,133,0,6
56629,2,2407,2557,-150,0,45,0,6
56630,1,2492,2485,7,0,45,0,6
56631,1,2724,2284,440,0,113,0,6
56632,2,2398,2584,-186,0,123,0,6
56633,1,2395,2483,-88,0,10,0,6
56634,1,2561,2306,255,0,7,0,6
56635,2,2464,2491,-27,0,45,0,6
56636,1,2384,2450,-66,0,454,0,6
56637,1,2540,2370,170,0,272,0,6
56638,1,2333,2426,-93,0,490,0,6
56639,2,2418,2522,-104,0,401,1,6
56640,1,2455,2432,23,0,127,0,6
56641,2,2278,2430,-152,0,487,0,6
56642,2,2488,2264,224,0,115,0,6
56643,1,2711,2307,404,0,200,0,6
56644,2,2476,2377,99,0,85,1,6
56645,3,2315,2405,-90,0,300,0,6
56646,1,2361,2419,-58,0,107,0,6
56647,1,2420,2281,139,0,453,0,6
56648,2,2476,2354,122,0,200,1,6
56649,1,2448,2315,133,0,40,1,6
56650,1,2487,2622,-135,0,7,0,6
56651,2,2538,2595,-57,0,335,0,6
56652,1,2437,2541,-104,0,106,0,6
56653,3,2498,2478,20,0,45,0,6
56654,2,2395,2422,-27,0,49,0,6
56655,1,2431,2302,129,0,485,0,6
56656,1,2429,2220,209,0,122,0,6
56657,2,2570,2724,-154,0,157,1,6
56658,1,2410,2418,-8,0,136,0,6
56659,1,2587,2295,292,0,65,0,6
56660,1,2586,2297,289,0,336,0,6
56661,1,2462,2287,175,0,120,0,6
56662,2,2415,2448,-33,0,45,1,6
56664,2,2464,2491,-27,0,139,0,6
56665,2,2428,2335,93,0,104,0,6
56666,2,2264,2445,-181,0,45,0,6
56667,2,2401,2599,-198,0,414,1,6
56668,3,2446,2356,90,0,213,0,6
56669,1,2406,2281,125,0,1,1,6
56670,2,2416,2436,-20,0,302,0,6
56671,3,2400,2400,0,0,334,0,6
56672,2,2418,2561,-143,0,134,0,6
56673,2,2457,2564,-107,0,118,0,6
56674,1,2537,2618,-81,0,15,0,6
56675,1,2304,2496,-192,0,301,0,6
56676,1,2354,2419,-65,0,338,0,6
56677,1,2483,2462,21,0,35,1,6
56678,1,2485,2382,103,0,205,0,6
56679,1,2322,2427,-105,0,103,0,6
56680,2,2435,2226,209,0,49,0,6
56681,2,2371,2409,-38,0,307,0,6
56682,3,2449,2399,50,0,250,0,3
56683,1,2244,2479,-235,0,121,0,6
56684,2,2460,2368,92,0,45,0,6
56685,2,2543,2402,141,0,154,0,6
56686,1,2535,2319,216,0,101,0,6
56687,1,2440,2335,105,0,123,0,6
56688,2,2435,2367,68,0,123,0,6
56689,1,2372,2467,-95,0,45,0,6
56690,2,2417,2434,-17,0,40,0,6
56691,1,2449,2321,128,0,466,0,6
56692,1,2437,2326,111,0,300,0,6
56693,2,2561,2502,59,0,200,0,6
56694,2,2608,2719,-111,0,1,0,6
56695,3,2294,2430,-136,0,423,0,6
56696,1,2420,2276,144,0,302,0,7
56697,2,2512,2332,180,0,40,1,6
56698,2,2335,2448,-113,0,70,1,6
56699,1,2442,2562,-120,0,113,0,6
56700,3,2401,2413,-12,0,455,0,6
56701,2,2257,2407,-150,0,102,0,6
56702,2,2490,2413,77,0,302,1,6
56703,2,2418,2281,137,0,210,0,6
56704,1,2486,2276,210,0,241,0,6
56705,2,2480,2497,-17,0,302,0,6
56706,1,2336,2416,-80,0,1,0,6
56707,2,2490,2415,75,0,200,1,6
56708,2,2444,2268,176,0,123,0,6
56709,1,2601,2533,68,0,301,0,6
56710,1,2417,2360,57,0,5,0,6
56711,2,2412,2441,-29,0,14,0,6
56712,2,2415,2244,171,0,131,0,6
56713,2,2410,2402,8,0,15,1,6
56714,1,2564,2324,240,0,310,0,6
56715,2,2438,2387,51,0,31,0,6
56716,1,2433,2545,-112,0,17,1,6
56717,2,2250,2401,-151,0,140,0,6
56718,1,2407,2304,103,0,242,0,6
56719,1,2553,2213,340,4,292,0,13
56720,2,2293,2405,-112,0,40,0,6
56721,2,2589,2712,-123,0,474,0,6
56722,1,2420,2306,114,0,125,1,6
56723,2,2281,2588,-307,0,142,0,6
56724,1,2601,2526,75,0,102,0,6
56725,2,2244,2409,-165,0,250,0,6
56726,1,2459,2398,61,0,45,1,6
56727,2,2426,2400,26,0,269,0,6
56728,1,2559,2556,3,0,300,1,6
56729,2,2320,2412,-92,0,45,0,6
56730,1,2205,2591,-386,0,405,0,6
56731,1,2474,2529,-55,0,460,0,6
56732,1,2383,2400,-17,0,34,0,6
56733,1,2534,2421,113,0,45,1,6
56734,2,2290,2457,-167,0,210,0,6
56735,1,2614,2489,125,0,263,1,6
56736,2,2444,2390,54,0,300,0,6
56737,2,2412,2249,163,0,310,0,6
56738,3,2503,2278,225,0,45,0,6
56739,1,2606,2475,131,0,305,0,6
56740,1,2327,2453,-126,0,5,0,6
56741,1,2361,2515,-154,0,331,0,6
56742,1,2367,2423,-56,0,255,1,6
56743,2,2378,2462,-84,0,54,0,6
56744,2,2539,2437,102,0,122,0,6
56746,2,2420,2523,-103,0,402,0,6
56747,2,2431,2275,156,0,123,1,6
56748,2,2405,2330,75,0,45,0,6
56749,1,2416,2280,136,0,242,0,6
56750,2,2325,2407,-82,0,40,0,6
56751,3,2304,2419,-115,0,5,0,6
56752,1,2436,2417,19,0,249,1,6
56753,2,2326,2418,-92,0,130,1,6
56754,2,2495,2561,-66,0,4,0,6
56755,2,2404,2455,-51,0,200,0,6
56756,2,2465,2431,34,0,218,0,6
56757,2,2313,2503,-190,0,300,1,6
56758,2,2487,2290,197,0,227,1,6
56759,3,2453,2518,-65,0,4,0,6
56761,2,2526,2549,-23,0,101,1,6
56762,1,2447,2346,101,0,46,0,6
56763,1,2443,2339,104,0,45,0,6
56764,1,2544,2301,243,0,215,1,6
56765,1,2440,2608,-168,0,190,0,6
56766,2,2612,2429,183,0,4,0,6
56767,2,2430,2418,12,4,279,0,13
56768,1,2311,2725,-414,0,344,0,6
56769,1,2414,2292,122,0,102,0,6
56770,1,2588,2410,178,0,40,1,6
56771,1,2396,2433,-37,0,140,0,6
56772,2,2506,2521,-15,0,102,0,6
56773,2,2393,2476,-83,0,485,0,6
56774,2,2471,2368,103,0,40,0,6
56775,1,2470,2453,17,0,125,1,6
56776,1,2568,2610,-42,0,4,0,6
56777,2,2506,2266,240,0,253,0,6
56778,2,2406,2535,-129,0,380,0,6
56779,2,2413,2390,23,0,4,0,6
56780,2,2723,2604,119,0,13,0,6
56781,2,2252,2409,-157,0,483,0,6
56782,3,2361,2406,-45,0,95,0,6
56783,1,2439,2426,13,0,426,0,6
56784,1,2402,2227,175,0,4,0,6
56785,1,2301,2449,-148,0,218,1,6
56786,1,2554,2367,187,0,45,0,6
56787,1,2460,2420,40,0,140,0,6
56788,2,2298,2430,-132,0,426,0,6
56789,2,2428,2269,159,0,301,0,6
56790,2,2406,2410,-4,0,113,0,6
56791,2,2466,2384,82,0,80,1,6
56792,2,2413,2411,2,0,103,0,6
56793,2,2317,2538,-221,0,7,0,6
56794,1,2473,2450,23,0,41,0,6
56795,1,2363,2453,-90,0,201,1,6
56796,2,2500,2398,102,0,45,0,6
56797,2,2468,2339,129,0,4,1,6
56798,1,2412,2240,172,0,150,0,6
56799,1,2410,2404,6,0,309,0,6
56800,3,2404,2364,40,0,135,0,6
56801,3,2527,2251,276,0,4,0,6
56802,2,2272,2416,-144,0,45,0,6
56803,1,2421,2316,105,0,202,0,6
56804,2,2349,2454,-105,0,110,0,6
56805,2,2381,2419,-38,0,305,0,6
56806,2,2461,2484,-23,0,28,0,6
56807,2,2322,2459,-137,0,143,0,6
56808,1,2412,2324,88,0,80,0,6
56809,2,2546,2438,108,0,45,0,6
56810,2,2248,2427,-179,0,256,0,6
56811,1,2643,2529,114,0,434,0,6
56812,1,2457,2350,107,0,300,0,6
56813,1,2581,2200,381,0,477,1,6
56814,1,2567,2216,351,0,38,0,6
56815,2,2389,2445,-56,0,106,0,6
56816,3,2409,2343,66,0,106,0,6
56817,1,2447,2383,64,0,210,0,6
56818,1,2612,2280,332,0,50,0,6
56819,1,2477,2424,53,0,202,0,6
56820,2,2322,2441,-119,0,130,0,6
56821,3,2400,2449,-49,0,250,0,3
56822,2,2241,2414,-173,0,373,0,8
56823,2,2410,2405,5,0,475,0,6
56824,1,2417,2218,199,0,258,0,6
56825,2,2378,2602,-224,0,208,0,6
56826,2,2254,2506,-252,0,102,0,6
56827,2,2524,2574,-50,0,4,0,6
56828,2,2330,2539,-209,0,47,0,6
56829,1,2420,2483,-63,0,301,1,6
56830,2,2445,2500,-55,0,300,0,6
56831,1,2401,2345,56,0,300,0,6
56832,3,2366,2400,-34,0,258,0,6
56833,1,2385,2414,-29,0,484,0,6
56834,1,2446,2412,34,0,22,1,6
56835,2,2464,2451,13,0,300,0,6
56836,1,2546,2316,230,0,338,0,6
56837,1,2618,2527,91,0,104,0,6
56838,1,2455,2313,142,0,108,0,6
56839,1,2716,2449,267,0,128,0,6
56840,1,2415,2441,-26,0,190,0,6
56841,1,2497,2459,38,0,34,0,6
56842,2,2416,2537,-121,0,45,1,6
56843,1,2417,2460,-43,0,200,1,6
56844,3,2603,2477,126,0,374,0,6
56845,1,2585,2448,137,0,317,0,6
56846,1,2605,2590,15,0,46,0,6
56847,2,2538,2504,34,0,428,0,6
56848,3,2380,2404,-24,4,256,0,13
56850,3,2522,2341,181,0,40,0,6
56851,1,2506,2369,137,0,313,0,6
56852,2,2406,2376,30,0,40,0,6
56853,2,2413,2492,-79,0,311,0,6
56854,2,2557,2375,182,0,80,0,6
56855,1,2485,2420,65,0,122,0,6
56856,1,2423,2425,-2,0,123,0,6
56857,2,2469,2312,157,0,200,0,6
56858,2,2559,2567,-8,0,6,0,6
56859,3,2422,2412,10,0,302,0,6
56860,2,2334,2481,-147,0,300,0,6
56861,1,2405,2418,-13,0,306,1,6
56862,1,2411,2288,123,0,103,0,6
56863,1,2438,2441,-3,0,331,0,6
56864,2,2302,2431,-129,0,224,0,6
56865,2,2300,2411,-111,0,320,1,6
56866,1,2400,2402,-2,0,455,0,6
56867,2,2402,2539,-137,0,278,0,6
56868,2,2407,2568,-161,0,49,0,6
56870,2,2332,2495,-163,0,184,0,6
56871,2,2308,2407,-99,0,101,0,6
56872,1,2417,2760,-343,0,13,0,6
56873,2,2284,2400,-116,0,333,1,6
56874,2,2343,2406,-63,0,277,0,8
56875,1,2716,2299,417,0,113,0,6
56876,1,2508,2419,89,0,45,0,6
56877,1,2469,2353,116,0,172,0,6
56878,2,2433,2365,68,0,313,1,6
56879,2,2457,2249,208,0,45,0,6
56880,1,2426,2250,176,0,339,0,6
56881,2,2362,2481,-119,0,49,0,6
56882,1,2389,2459,-70,0,426,0,6
56883,3,2450,2275,175,0,10,0,6
56884,2,2233,2547,-314,0,130,0,6
56885,1,2408,2365,43,0,245,1,6
56886,2,2442,2591,-149,0,200,1,6
56887,2,2371,2407,-36,0,40,0,6
56888,2,2430,2475,-45,0,409,0,6
56889,2,2447,2613,-166,0,106,0,6
56890,1,2380,2497,-117,0,101,0,6
56891,2,2447,2718,-271,0,150,0,6
56892,1,2531,2359,172,0,300,0,6
56893,2,2408,2398,10,0,308,1,6
56894,1,2420,2331,89,0,118,0,6
56895,2,2582,2540,42,0,429,0,6
56896,3,2391,2501,-110,0,1,0,6
56897,1,2417,2277,140,0,16,0,6
56898,2,2459,2404,55,0,303,0,6
56899,3,2525,2622,-97,0,320,0,6
56900,2,2372,2407,-35,0,152,0,6
56901,2,2236,2412,-176,0,107,0,6
56902,1,2413,2416,-3,0,101,0,6
56903,2,2420,2216,204,0,123,1,6
56904,1,2408,2344,64,0,106,0,6
56905,2,2458,2345,113,0,4,0,6
56906,1,2573,2490,83,0,106,0,6
56907,2,2579,2612,-33,0,14,0,6
56908,2,2222,2429,-207,0,2,0,6
56909,1,2320,2419,-99,0,255,0,6
56910,2,2219,2519,-300,0,463,1,6
56911,2,2465,2446,19,0,373,1,6
56912,2,2400,2343,57,0,140,0,6
56913,1,2505,2441,64,0,140,0,6
56914,3,2523,2715,-192,0,0,0,6
56915,2,2237,2415,-178,0,5,1,6
56916,2,2435,2422,13,0,483,0,6
56917,2,2227,2424,-197,0,4,0,7
56918,1,2508,2549,-41,0,2,0,6
56919,2,2418,2456,-38,0,102,0,6
56920,1,2463,2308,155,0,200,0,6
56921,1,2461,2376,85,0,41,0,6
56922,1,2401,2510,-109,0,180,0,6
56923,1,2415,2342,73,0,43,0,6
56924,2,2383,2409,-26,0,20,0,6
56925,2,2264,2512,-248,0,46,0,6
56926,2,2476,2427,49,0,302,1,6
56927,2,2377,2428,-51,0,211,0,6
56928,2,2240,2412,-172,0,101,0,6
56929,2,2400,2223,177,0,0,0,6
56930,1,2571,2202,369,0,18,0,6
56931,2,2366,2510,-144,0,331,0,6
56932,1,2454,2369,85,0,200,0,6
56933,2,2353,2472,-119,0,15,0,6
56934,1,2499,2415,84,0,12,0,6
56935,2,2283,2425,-142,0,302,0,6
56936,1,2458,2353,105,0,131,0,6
56937,2,2445,2452,-7,0,45,0,6
56938,2,2436,2410,26,0,300,0,6
56939,2,2313,2510,-197,0,300,1,6
56940,1,2619,2262,357,0,49,0,6
56941,1,2424,2574,-150,0,131,0,6
56942,1,2411,2231,180,0,45,0,6
56943,1,2452,2419,33,0,107,0,6
56944,1,2415,2490,-75,0,466,1,6
56945,2,2353,2717,-364,0,36,0,6
56946,1,2526,2347,179,0,4,0,6
56947,1,2548,2322,226,0,345,0,6
56948,1,2484,2472,12,0,138,1,6
56949,1,2415,2274,141,0,42,1,6
56950,1,2750,2371,379,0,1,0,6
56951,1,2520,2396,124,0,57,1,6
56952,1,2538,2502,36,0,4,0,6
56953,2,2542,2515,27,0,40,0,6
56954,1,2454,2379,75,0,484,0,6
56955,2,2445,2573,-128,0,42,0,6
56956,1,2489,2391,98,0,45,0,6
56957,2,2462,2269,193,0,4,1,6
56958,2,2232,2589,-357,0,1,0,6
56959,2,2534,2551,-17,0,112,0,6
56960,2,2412,2427,-15,0,1,0,6
56962,1,2424,2412,12,0,112,1,6
56963,1,2388,2520,-132,0,394,1,6
56964,1,2301,2443,-142,0,46,0,6
56965,1,2585,2392,193,0,409,0,6
56966,2,2601,2620,-19,0,335,0,6
56967,1,2490,2248,242,0,101,0,8
56968,1,2412,2404,8,0,247,1,6
56969,1,2422,2347,75,0,4,0,6
56970,2,2549,2411,138,0,300,0,6
56971,1,2412,2234,178,0,277,1,6
56972,3,2602,2303,299,0,373,0,6
56973,3,2608,2515,93,0,432,0,6
56974,1,2445,2343,102,0,331,0,6
56975,3,2541,2396,145,0,200,0,6
56976,3,2311,2517,-206,0,40,0,6
56977,2,2385,2533,-148,0,300,0,6
56978,2,2261,2429,-168,0,4,0,6
56979,1,2511,2535,-24,0,113,0,6
56980,1,2674,2611,63,0,110,0,6
56981,1,2405,2321,84,4,46,0,13
56982,3,2448,2400,48,0,288,0,3
56983,2,2387,2458,-71,0,311,0,6
56984,1,2589,2399,190,0,3,0,6
56985,3,2576,2419,157,0,16,0,6
56986,2,2333,2403,-70,0,144,0,6
56987,2,2338,2441,-103,0,211,0,6
56988,2,2340,2412,-72,0,1,0,6
56989,1,2320,2551,-231,0,122,1,6
56990,1,2356,2427,-71,0,305,0,6
56991,3,2485,2430,55,0,140,0,6
56992,1,2293,2417,-124,0,335,0,6
56993,1,2274,2463,-189,0,335,0,6
56994,1,2617,2320,297,0,310,0,6
56995,1,2548,2290,258,0,0,0,6
56996,2,2262,2442,-180,0,132,0,6
56997,1,2461,2413,48,0,466,0,6
56998,1,2496,2621,-125,0,324,0,6
56999,2,2296,2481,-185,0,45,0,6
57000,1,2577,2526,51,0,113,1,6
57001,2,2521,2536,-15,0,2,1,6
57002,1,2408,2244,164,0,414,0,6
57003,2,2383,2413,-30,0,6,1,6
57004,2,2338,2594,-256,0,327,0,6
57005,2,2438,2248,190,0,260,1,6
57006,1,2435,2328,107,0,123,0,6
57007,1,2259,2424,-165,4,80,0,13
57008,2,2566,2352,214,0,455,0,6
57009,1,2414,2494,-80,0,310,0,6
57010,1,2718,2432,286,0,216,0,6
57011,2,2481,2398,83,0,244,1,6
57012,2,2521,2627,-106,0,305,0,6
57013,2,2375,2504,-129,0,44,1,6
57014,1,2547,2565,-18,0,4,0,6
57015,2,2352,2402,-50,0,200,1,6
57016,2,2314,2476,-162,0,122,0,6
57017,1,2427,2234,193,0,302,0,7
57018,1,2419,2347,72,4,102,0,11
57019,2,2404,2377,27,0,201,0,6
57020,1,2507,2454,53,0,440,0,6
57021,2,2280,2445,-165,0,201,0,6
57022,1,2595,2445,150,0,333,1,6
57023,2,2415,2467,-52,0,142,0,6
57024,1,2482,2326,156,0,11,1,6
57025,1,2712,2526,186,0,9,0,6
57026,2,2333,2484,-151,0,278,0,6
57027,1,2449,2315,134,0,108,1,6
57028,2,2486,2597,-111,0,4,0,6
57029,1,2421,2297,124,0,372,0,6
57030,1,2497,2393,104,0,211,0,6
57031,1,2433,2324,109,0,15,0,6
57032,2,2407,2210,197,0,1,1,6
57033,2,2281,2429,-148,0,120,0,6
57034,1,2458,2439,19,0,303,0,6
57035,1,2409,2356,53,0,122,1,6
57036,2,2224,2447,-223,0,190,1,6
57037,2,2517,2528,-11,0,113,0,6
57038,2,2264,2428,-164,0,140,1,6
57039,2,2433,2376,57,0,53,0,6
57040,2,2433,2453,-20,0,102,0,6
57041,2,2361,2574,-213,0,36,0,6
57042,1,2403,2517,-114,0,228,0,6
57043,1,2631,2557,74,0,49,0,6
57044,1,2401,2291,110,0,45,0,6
57045,1,2409,2352,57,0,112,0,6
57046,2,2422,2287,135,0,20,1,6
57047,1,2483,2356,127,0,41,1,6
57048,3,2458,2414,44,0,44,0,6
57049,1,2445,2281,164,0,198,1,6
57050,1,2577,2231,346,0,310,0,6
57051,2,2434,2470,-36,0,301,0,6
57052,1,2283,2411,-128,0,27,0,6
57053,2,2268,2406,-138,0,207,0,6
57054,2,2375,2420,-45,0,320,0,6
57055,1,2461,2334,127,0,4,1,6
57057,1,2414,2424,-10,4,210,0,13
57058,1,2516,2393,123,0,101,0,6
57059,2,2457,2594,-137,0,304,0,6
57060,2,2310,2519,-209,0,303,1,6
57061,2,2529,2557,-28,0,101,0,6
57062,2,2428,2305,123,0,241,1,6
57063,2,2447,2437,10,0,305,0,6
57064,1,2414,2441,-27,0,255,1,6
57065,1,2350,2429,-79,0,205,0,8
57066,3,2392,2427,-35,0,409,0,6
57067,3,2395,2449,-54,0,5,0,6
57068,3,2590,2424,166,0,380,0,6
57069,1,2264,2404,-140,0,46,0,6
57070,1,2267,2410,-143,0,123,0,6
57071,3,2331,2436,-105,0,34,0,6
57072,2,2392,2523,-131,0,485,0,6
57073,1,2370,2418,-48,0,300,0,6
57074,1,2751,2541,210,0,112,0,6
57075,1,2419,2270,149,0,31,0,6
57076,2,2327,2421,-94,0,301,0,6
57077,2,2487,2388,99,0,45,0,6
57078,2,2512,2466,46,0,302,0,6
57079,1,2407,2418,-11,0,300,1,6
57080,2,2389,2599,-210,0,174,0,6
57081,3,2442,2588,-146,0,143,0,6
57082,1,2550,2599,-49,0,199,0,6
57083,2,2307,2411,-104,0,409,0,6
57084,2,2404,2285,119,0,80,0,8
57085,1,2432,2396,36,0,7,1,6
57086,2,2501,2363,138,0,13,0,6
57087,1,2433,2420,13,0,255,1,6
57088,1,2596,2415,181,0,307,0,6
57089,1,2400,2223,177,0,142,0,8
57090,1,2449,2559,-110,0,27,0,6
57091,1,2406,2577,-171,0,0,0,6
57092,1,2457,2483,-26,0,15,0,6
57093,2,2309,2410,-101,0,40,0,6
57095,1,2431,2252,179,0,45,0,6
57096,2,2403,2205,198,0,258,1,6
57097,2,2442,2209,233,0,202,0,6
57098,1,2451,2355,96,0,133,0,6
57099,2,2426,2345,81,0,380,1,6
57100,2,2366,2624,-258,0,401,0,6
57101,1,2480,2399,81,0,212,0,6
57102,1,2613,2607,6,0,107,0,6
57103,1,2516,2504,12,0,432,0,6
57104,2,2396,2579,-183,0,216,0,6
57105,1,2542,2329,213,0,101,0,6
57106,1,2429,2251,178,0,40,0,6
57107,2,2417,2335,82,0,100,1,6
57108,1,2754,2430,324,0,218,1,6
57109,1,2538,2243,295,0,40,0,6
57110,2,2396,2429,-33,0,153,0,6
57111,2,2415,2512,-97,0,83,1,6
57112,2,2515,2795,-280,0,2,1,6
57113,2,2592,2381,211,0,428,0,6
57114,1,2389,2557,-168,0,41,0,6
57115,1,2666,2349,317,0,6,0,6
57116,1,2636,2720,-84,0,304,0,6
57117,2,2430,2275,155,0,200,0,6
57118,2,2553,2520,33,0,8,0,6
57119,2,2443,2414,29,0,399,0,6
57120,2,2342,2449,-107,0,41,0,6
57121,1,2601,2482,119,0,456,0,6
57122,2,2522,2582,-60,0,0,0,6
57123,3,2346,2457,-111,0,338,0,6
57124,1,2412,2361,51,0,40,1,6
57125,1,2440,2211,229,0,0,0,6
57126,3,2418,2418,0,0,277,0,6
57127,1,2385,2407,-22,0,40,0,6
57128,2,2434,2464,-30,0,53,0,6
57129,2,2523,2715,-192,0,0,0,6
57130,2,2419,2347,72,0,369,0,6
57131,2,2471,2334,137,0,120,0,6
57132,2,2201,2461,-260,0,225,0,6
57133,1,2534,2425,109,0,10,1,6
57134,1,2421,2305,116,0,4,0,6
57135,1,2458,2414,44,0,80,0,6
57136,1,2372,2447,-75,0,419,1,5
57137,1,2343,2421,-78,0,131,0,6
57138,2,2443,2600,-157,0,13,0,6
57139,1,2412,2441,-29,0,101,0,6
57140,1,2449,2512,-63,0,405,0,6
57141,1,2475,2429,46,0,302,0,6
57142,1,2619,2523,96,0,142,0,6
57143,2,2431,2398,33,0,131,0,6
57144,2,2527,2389,138,0,176,0,6
57145,1,2432,2251,181,0,46,0,6
57146,2,2412,2422,-10,0,343,0,6
57147,1,2302,2426,-124,0,131,1,6
57148,1,2367,2425,-58,0,129,1,6
57149,2,2506,2389,117,0,80,0,6
57150,1,2326,2544,-218,0,245,0,6
57151,2,2414,2326,88,0,211,0,6
57152,2,2473,2456,17,0,40,1,6
57153,2,2379,2440,-61,0,229,0,6
57154,2,2421,2420,1,0,107,0,6
57155,2,2434,2264,170,0,247,1,6
57156,1,2605,2601,4,0,405,0,6
57157,2,2425,2364,61,0,101,1,6
57158,2,2565,2559,6,0,4,0,6
57159,2,2343,2446,-103,0,13,0,6
57160,1,2718,2520,198,0,9,1,6
57161,1,2426,2371,55,0,412,0,6
57162,1,2513,2587,-74,0,221,0,6
57163,1,2498,2320,178,0,43,0,6
57164,1,2459,2379,80,0,40,1,6
57165,1,2486,2442,44,0,143,0,6
57166,1,2327,2408,-81,0,110,0,6
57167,1,2412,2488,-76,0,247,0,6
57168,2,2349,2487,-138,0,10,0,6
57169,3,2357,2453,-96,0,371,0,6
57170,2,2375,2540,-165,0,113,0,6
57171,2,2331,2410,-79,0,16,0,8
57172,1,2484,2413,71,0,304,0,6
57173,1,2373,2432,-59,0,110,1,6
57174,1,2517,2560,-43,0,0,0,6
57175,2,2394,2410,-16,0,312,0,6
57176,2,2472,2434,38,0,157,0,6
57177,2,2241,2432,-191,0,106,0,7
57178,1,2424,2480,-56,0,301,1,6
57179,2,2469,2429,40,0,45,0,6
57180,2,2409,2485,-76,0,3,0,6
57181,2,2309,2463,-154,0,6,0,6
57182,1,2272,2434,-162,0,54,0,6
57183,1,2660,2477,183,0,28,0,6
57185,2,2435,2440,-5,0,40,0,6
57186,3,2603,2756,-153,0,484,0,6
57187,1,2401,2418,-17,0,130,0,6
57188,1,2418,2411,7,0,33,0,6
57189,1,2401,2354,47,0,380,0,6
57190,1,2402,2343,59,0,313,0,8
57191,1,2526,2257,269,0,300,0,6
57192,1,2426,2440,-14,0,101,0,6
57193,1,2372,2415,-43,0,6,0,6
57194,2,2596,2610,-14,0,301,0,6
57195,2,2342,2410,-68,0,1,0,6
57196,1,2514,2522,-8,0,2,0,6
57197,2,2248,2493,-245,0,229,0,8
57198,1,2488,2348,140,0,30,0,6
57199,1,2451,2519,-68,0,224,0,6
57200,2,2333,2465,-132,0,376,0,6
57201,2,2334,2415,-81,0,45,0,6
57202,1,2501,2397,104,0,453,1,6
57203,1,2249,2400,-151,4,7,0,13
57204,2,2293,2429,-136,0,365,0,8
57205,2,2317,2407,-90,0,0,0,6
57206,1,2692,2709,-17,0,302,0,6
57207,2,2522,2524,-2,0,21,0,6
57208,1,2591,2587,4,0,459,0,6
57209,3,2650,2647,3,0,267,0,6
57210,2,2677,2677,0,0,133,0,6
57211,1,2640,2640,0,0,50,0,6
57212,2,2671,2660,11,0,45,0,6
57213,1,2632,2628,4,0,46,0,6
57214,3,2642,2644,-2,0,335,0,6
57215,1,2604,2595,9,0,300,0,6
57216,2,2799,2775,24,0,147,0,6
57217,1,2609,2606,3,0,123,0,6
57218,1,2605,2605,0,0,0,0,6
57219,2,2676,2674,2,0,335,0,6
57220,2,2774,2742,32,0,103,0,6
57221,1,2716,2718,-2,0,7,0,6
57222,2,2564,2561,3,0,106,1,6
57223,2,2632,2634,-2,0,151,1,6
57225,3,2690,2685,5,0,43,0,6
57226,2,2627,2624,3,0,48,0,6
57227,1,2719,2720,-1,0,288,0,6
57230,1,2532,2534,-2,0,57,0,6
57231,2,2725,2728,-3,0,144,1,6
57233,1,2465,2468,-3,0,120,0,6
57234,1,2472,2472,0,0,341,0,6
57235,1,2518,2515,3,0,455,0,6
57236,1,2578,2577,1,0,123,1,6
57237,1,2536,2536,0,0,414,0,6
57238,1,2541,2539,2,0,151,1,6
57239,1,2651,2653,-2,0,11,0,6
57240,2,2488,2489,-1,0,11,0,6
57241,1,2472,2472,0,0,8,1,6
57242,1,2487,2486,1,0,248,0,6
57243,2,2473,2477,-4,0,341,0,6
57244,1,2509,2505,4,0,461,1,6
57245,1,2551,2549,2,0,219,0,6
57246,3,2546,2548,-2,0,39,0,6
57247,2,2519,2521,-2,0,226,0,6
57248,2,2584,2584,0,0,7,0,6
57249,2,2573,2573,0,0,466,1,6
57251,1,2606,2606,0,0,49,0,6
57252,1,2565,2569,-4,0,338,0,6
57253,1,2525,2526,-1,0,122,0,6
57254,1,2494,2491,3,0,190,0,6
57255,1,2443,2441,2,0,300,1,6
57256,2,2491,2491,0,0,302,0,6
57257,1,2579,2579,0,0,190,0,6
57260,2,2436,2438,-2,0,244,0,6
57261,3,2432,2432,0,0,1,0,6
57262,2,2426,2424,2,0,464,0,6
57263,1,2418,2417,1,0,310,0,6
57264,1,2454,2454,0,0,432,1,6
57265,2,2470,2471,-1,0,150,0,6
57266,2,2479,2479,0,0,46,0,6
57267,2,2410,2411,-1,0,454,0,6
57269,3,2424,2424,0,0,40,0,6
57270,2,2455,2455,0,0,331,0,6
57271,2,2499,2499,0,0,112,0,6
57272,2,2451,2449,2,0,4,1,6
57273,2,2434,2434,0,0,110,0,6
57274,2,2515,2513,2,0,45,0,6
57275,2,2411,2411,0,0,153,0,6
57276,2,2571,2572,-1,0,400,0,6
57277,1,2433,2433,0,0,101,0,6
57278,1,2402,2402,0,0,172,0,6
57279,1,2403,2404,-1,0,15,0,6
57280,2,2400,2399,1,0,49,1,6
57281,2,2431,2431,0,0,453,0,6
57282,1,2459,2460,-1,0,487,0,6
57283,2,2505,2503,2,0,121,0,6
57284,2,2405,2405,0,0,123,0,6
57285,2,2455,2457,-2,0,411,0,6
57286,1,2404,2405,-1,0,330,1,6
57287,2,2440,2441,-1,0,154,1,6
57288,1,2400,2400,0,0,269,0,6
57289,1,2423,2422,1,0,40,0,6
57290,1,2408,2405,3,0,381,0,6
57291,2,2427,2428,-1,0,147,0,6
57292,1,2412,2414,-2,0,40,1,6
57293,3,2439,2439,0,0,201,0,6
57294,1,2656,2655,1,0,302,0,6
57296,1,2462,2464,-2,0,203,0,6
57298,3,2503,2490,13,0,4,0,6
57299,2,2537,2538,-1,0,46,0,6
57300,2,2405,2425,-20,0,57,1,6
57301,1,2478,2423,55,0,129,1,6
57302,2,2673,2614,59,0,242,1,6
57303,3,2408,2394,14,0,103,0,6
57304,1,2600,2592,8,0,123,0,6
57305,2,2452,2476,-24,0,10,1,6
57306,2,2374,2677,-303,0,469,1,6
57307,2,2520,2514,6,0,1,0,6
57308,1,2592,2590,2,0,132,0,6
57309,1,2600,2609,-9,0,305,0,6
57310,1,2540,2505,35,0,190,1,6
57311,1,2518,2520,-2,0,46,0,6
57312,3,2232,2402,-170,0,304,0,6
57313,1,2685,2345,340,0,200,1,6
57314,2,2411,2319,92,4,200,0,13
57315,3,2356,2514,-158,0,395,0,6
57316,1,2403,2400,3,0,131,0,6
57317,2,2438,2417,21,0,101,0,6
57318,1,2366,2431,-65,0,305,0,6
57319,2,2463,2565,-102,0,300,0,6
57320,3,2405,2417,-12,0,48,0,6
57321,2,2381,2416,-35,0,15,0,6
57322,2,2421,2434,-13,0,140,0,6
57323,1,2365,2410,-45,0,46,0,6
57324,2,2499,2477,22,0,101,0,6
57325,1,2544,2548,-4,0,0,1,6
57326,2,2422,2385,37,0,44,0,6
57327,1,2517,2411,106,0,229,1,6
57328,1,2240,2400,-160,0,398,0,8
57329,2,2556,2519,37,0,4,0,6
57330,1,2434,2432,2,0,45,1,6
57331,3,2408,2350,58,0,242,0,6
57332,1,2396,2498,-102,0,15,0,6
57333,2,2403,2451,-48,0,120,0,6
57334,2,2560,2566,-6,0,250,0,6
57335,2,2547,2537,10,0,158,0,6
57336,1,2397,2500,-103,0,1,1,6
57337,1,2449,2303,146,0,228,1,6
57338,1,2544,2391,153,0,464,1,6
57339,2,2334,2401,-67,0,454,0,6
57340,2,2233,2471,-238,0,308,0,6
57341,2,2642,2327,315,0,381,0,6
57342,2,2707,2559,148,0,7,0,6
57343,1,2500,2301,199,0,106,0,6
57344,1,2520,2328,192,0,42,1,6
57345,2,2426,2374,52,0,106,0,6
57346,2,2518,2333,185,0,107,0,6
57347,2,2554,2523,31,0,115,1,6
57348,2,2323,2535,-212,0,199,1,6
57349,2,2242,2441,-199,0,330,0,6
57350,1,2623,2398,225,0,5,0,6
57351,2,2537,2591,-54,0,301,0,6
57352,1,2620,2531,89,0,125,0,6
57353,2,2416,2421,-5,0,469,1,6
57354,1,2384,2685,-301,0,40,0,6
57355,2,2578,2557,21,0,28,0,6
57356,2,2641,2698,-57,0,260,1,6
57357,1,2520,2374,146,0,45,0,6
57358,1,2543,2563,-20,0,25,0,6
57359,1,2424,2491,-67,0,57,0,6
57360,1,2664,2491,173,0,469,1,6
57361,1,2403,2408,-5,0,9,0,6
57362,1,2481,2348,133,0,0,1,6
57363,2,2517,2721,-204,0,107,0,6
57364,1,2435,2395,40,0,107,0,6
57365,2,2495,2483,12,0,130,1,6
57366,3,2296,2670,-374,0,277,0,6
57367,1,2479,2485,-6,0,125,0,6
57368,2,2478,2481,-3,0,40,0,6
57369,1,2512,2690,-178,0,295,1,6
57370,1,2404,2419,-15,0,330,0,6
57371,1,2342,2465,-123,0,60,0,6
57372,2,2489,2405,84,0,301,1,6
57373,2,2319,2401,-82,0,106,0,6
57374,1,2685,2551,134,0,337,1,6
57375,2,2264,2442,-178,0,120,1,6
57376,2,2443,2423,20,0,112,0,6
57377,1,2734,2605,129,0,153,0,6
57378,1,2509,2455,54,0,10,0,6
57379,2,2712,2765,-53,0,47,0,6
57380,1,2267,2402,-135,0,127,0,6
57381,1,2703,2699,4,0,104,0,6
57382,2,2567,2722,-155,0,110,0,6
57383,2,2458,2474,-16,0,46,0,6
57384,1,2473,2430,43,0,302,0,6
57385,1,2495,2389,106,0,211,1,6
57386,1,2505,2456,49,0,440,1,6
57387,2,2421,2466,-45,0,200,1,6
57388,1,2678,2597,81,0,253,0,6
57389,2,2418,2468,-50,0,302,0,6
57390,2,2351,2573,-222,0,301,0,6
57391,1,2533,2526,7,0,131,0,6
57392,2,2582,2558,24,0,147,0,6
57393,2,2575,2645,-70,0,40,0,6
57394,2,2638,2555,83,0,25,1,6
57395,1,2562,2513,49,0,22,0,6
57396,1,2408,2410,-2,0,0,0,6
57397,1,2634,2490,144,0,283,0,6
57398,1,2403,2306,97,0,245,0,6
57399,1,2412,2407,5,0,106,0,6
57400,2,2265,2419,-154,4,250,1,13
57401,2,2435,2463,-28,0,45,0,6
57402,2,2288,2426,-138,0,54,1,6
57403,2,2439,2393,46,0,144,0,6
57404,1,2528,2530,-2,0,5,0,6
57405,2,2601,2557,44,0,151,1,6
57406,1,2454,2474,-20,0,7,1,6
57407,2,2425,2381,44,0,140,0,6
57408,2,2424,2538,-114,0,57,0,6
57409,2,2296,2465,-169,0,111,0,6
57410,1,2714,2295,419,0,264,0,6
57411,2,2554,2533,21,0,373,0,6
57412,1,2725,2542,183,0,146,1,6
57413,3,2221,2424,-203,0,375,0,6
57414,1,2752,2225,527,0,125,0,6
57415,2,2553,2603,-50,0,7,0,6
57416,1,2421,2565,-144,0,338,0,6
57417,2,2497,2539,-42,0,461,0,6
57419,2,2408,2273,135,0,118,0,6
57420,1,2616,2590,26,0,405,0,6
57422,1,2521,2513,8,0,110,0,6
57423,2,2434,2496,-62,0,374,0,6
57424,1,2708,2671,37,0,177,0,6
57425,2,2455,2665,-210,0,245,0,6
57426,1,2563,2337,226,0,380,0,6
57427,3,2596,2383,213,0,140,0,6
57428,3,2319,2417,-98,0,411,0,6
57429,2,2544,2683,-139,0,122,0,6
57430,2,2649,2532,117,0,74,0,6
57431,1,2666,2456,210,0,49,0,6
57432,1,2416,2397,19,0,100,0,6
57433,2,2322,2572,-250,0,102,0,6
57434,2,2437,2411,26,0,213,0,6
57435,2,2265,2630,-365,0,200,0,6
57436,1,2375,2515,-140,0,61,0,6
57437,2,2402,2505,-103,0,45,0,6
57438,2,2388,2414,-26,0,456,0,6
57439,1,2393,2409,-16,0,309,0,6
57440,1,2425,2281,144,0,40,0,6
57441,2,2389,2650,-261,0,255,0,6
57442,2,2519,2516,3,0,113,0,6
57443,1,2772,2472,300,0,45,0,6
57444,3,2427,2231,196,0,410,0,6
57445,1,2444,2429,15,0,57,0,6
57446,2,2581,2535,46,0,122,0,6
57447,1,2465,2500,-35,0,255,1,6
57448,2,2390,2410,-20,0,200,1,6
57449,1,2734,2357,377,0,190,0,6
57450,2,2584,2559,25,0,100,0,6
57452,2,2370,2441,-71,0,112,1,6
57454,2,2450,2707,-257,0,123,0,6
57455,1,2460,2459,1,0,5,0,6
57456,1,2415,2338,77,0,106,0,6
57457,1,2412,2269,143,0,301,0,6
57458,2,2405,2403,2,0,131,0,6
57459,2,2399,2404,-5,0,45,0,6
57460,2,2497,2493,4,0,104,0,6
57461,2,2435,2467,-32,0,438,0,6
57462,1,2443,2447,-4,0,22,0,6
57463,2,2479,2463,16,0,123,0,6
57464,1,2449,2330,119,0,112,0,6
57465,1,2499,2224,275,0,133,0,6
57466,2,2417,2414,3,0,218,1,6
57467,2,2339,2538,-199,0,337,0,6
57468,1,2370,2433,-63,0,122,0,6
57469,1,2783,2515,268,0,211,0,6
57470,2,2481,2393,88,0,143,0,6
57471,3,2726,2487,239,0,14,0,6
57472,2,2485,2478,7,0,45,0,6
57473,2,2321,2792,-471,0,43,0,6
57474,2,2621,2546,75,0,112,0,6
57475,2,2405,2358,47,0,253,0,6
57476,1,2451,2358,93,0,51,0,6
57477,1,2467,2373,94,0,40,0,6
57478,3,2401,2447,-46,0,28,0,3
57479,1,2405,2422,-17,0,121,0,6
57480,2,2484,2600,-116,0,45,0,6
57481,1,2429,2570,-141,0,324,0,6
57482,2,2622,2613,9,0,301,0,6
57483,3,2437,2414,23,0,100,0,6
57484,3,2399,2414,-15,0,247,0,6
57485,1,2564,2489,75,0,132,0,6
57486,1,2629,2254,375,0,150,0,6
57487,3,2374,2523,-149,0,302,0,6
57488,2,2555,2489,66,0,365,0,6
57489,1,2444,2445,-1,0,106,1,6
57490,1,2403,2314,89,0,4,0,6
57491,2,2302,2621,-319,0,405,0,6
57492,3,2411,2439,-28,0,210,0,6
57493,1,2399,2427,-28,0,138,0,6
57494,2,2404,2392,12,0,102,0,6
57495,1,2599,2600,-1,0,487,0,6
57496,2,2583,2576,7,0,5,0,6
57497,2,2416,2344,72,4,111,0,13
57498,1,2399,2416,-17,0,208,0,6
57499,2,2342,2430,-88,0,15,1,6
57500,1,2548,2587,-39,0,455,0,6
57501,1,2574,2482,92,0,15,0,6
57502,1,2625,2514,111,0,15,0,6
57503,2,2395,2582,-187,0,106,0,6
57504,2,2392,2680,-288,0,193,1,6
57505,2,2534,2567,-33,0,4,0,6
57506,2,2417,2373,44,0,113,0,6
57507,2,2417,2440,-23,0,310,0,6
57508,1,2447,2448,-1,0,100,0,6
57509,1,2414,2469,-55,0,400,1,6
57510,2,2590,2585,5,0,302,0,6
57511,1,2607,2547,60,0,121,0,6
57512,1,2525,2533,-8,0,5,0,6
57513,2,2640,2607,33,0,45,0,6
57514,1,2509,2505,4,0,45,0,6
57515,2,2433,2419,14,0,110,1,6
57516,1,2441,2429,12,0,319,1,6
57517,2,2519,2476,43,0,145,1,6
57518,3,2573,2507,66,0,4,0,6
57519,1,2418,2410,8,0,0,0,6
57520,2,2399,2415,-16,0,13,0,6
57521,1,2400,2283,117,0,302,0,8
57522,1,2526,2533,-7,0,3,1,6
57523,1,2602,2345,257,0,108,0,6
57524,1,2666,2292,374,0,394,1,6
57525,2,2465,2659,-194,0,470,0,6
57526,2,2396,2434,-38,0,125,0,6
57527,1,2409,2466,-57,0,200,0,6
57528,3,2647,2486,161,0,434,0,6
57529,2,2288,2738,-450,0,0,0,6
57530,1,2638,2347,291,0,112,0,6
57531,1,2632,2713,-81,0,302,1,6
57532,2,2421,2382,39,0,13,1,6
57533,3,2575,2593,-18,0,332,0,6
57534,2,2405,2349,56,0,113,1,6
57535,2,2441,2399,42,0,130,0,6
57536,2,2243,2687,-444,0,201,1,6
57537,2,2667,2547,120,0,13,0,6
57538,1,2373,2400,-27,0,43,1,6
57539,3,2470,2715,-245,0,335,0,6
57540,1,2453,2541,-88,0,131,0,6
57541,1,2416,2666,-250,0,1,0,6
57542,1,2709,2492,217,0,110,0,6
57543,2,2548,2567,-19,0,9,0,6
57544,2,2546,2624,-78,0,57,0,6
57545,1,2668,2774,-106,0,46,0,6
57546,2,2294,2693,-399,0,120,0,6
57547,3,2470,2535,-65,0,310,0,6
57548,1,2608,2527,81,0,45,0,6
57549,1,2523,2399,124,0,170,0,6
57550,2,2387,2547,-160,0,113,0,6
57551,1,2675,2358,317,0,1,0,6
57552,1,2448,2430,18,0,0,0,6
57553,1,2709,2414,295,0,302,0,6
57554,1,2739,2394,345,0,267,0,6
57555,2,2256,2501,-245,0,101,0,6
57556,3,2501,2399,102,0,207,0,6
57557,2,2486,2407,79,0,211,0,6
57558,1,2565,2688,-123,0,265,0,6
57559,1,2493,2330,163,0,45,0,6
57560,2,2342,2409,-67,0,129,0,6
57561,1,2484,2509,-25,0,394,0,6
57562,1,2530,2547,-17,0,426,1,6
57563,2,2383,2640,-257,0,50,0,6
57564,2,2510,2531,-21,0,474,0,6
57565,1,2507,2292,215,0,42,0,6
57566,2,2542,2557,-15,0,41,0,6
57567,1,2689,2485,204,0,464,0,6
57568,1,2479,2460,19,0,145,0,6
57569,2,2475,2424,51,0,153,0,6
57570,1,2454,2414,40,0,429,0,6
57571,1,2564,2257,307,0,7,1,6
57572,2,2404,2394,10,0,309,0,6
57573,2,2527,2663,-136,0,458,1,6
57574,1,2450,2397,53,0,394,0,6
57575,1,2470,2287,183,0,81,0,6
57576,1,2595,2201,394,0,0,0,6
57577,2,2468,2438,30,0,332,0,6
57578,1,2561,2334,227,0,190,0,6
57579,1,2468,2423,45,0,45,1,6
57580,1,2547,2605,-58,0,20,0,6
57581,2,2479,2485,-6,0,269,0,6
57582,2,2432,2404,28,0,245,0,8
57583,1,2398,2412,-14,0,45,1,6
57584,1,2413,2471,-58,0,203,1,6
57585,2,2538,2320,218,0,302,0,6
57586,1,2514,2502,12,0,301,1,6
57587,2,2365,2403,-38,0,255,0,6
57588,1,2426,2299,127,0,115,0,6
57589,1,2565,2436,129,0,0,0,6
57590,1,2540,2232,308,0,9,0,6
57591,1,2414,2234,180,0,0,0,6
57592,2,2424,2634,-210,0,404,0,6
57593,1,2703,2411,292,0,474,0,6
57594,2,2398,2642,-244,0,112,0,6
57595,1,2416,2397,19,0,123,0,6
57596,1,2553,2429,124,0,190,0,6
57597,2,2321,2454,-133,0,8,0,6
57598,2,2246,2420,-174,0,106,1,6
57599,1,2340,2578,-238,0,21,1,6
57600,2,2283,2406,-123,0,331,1,8
57601,1,2425,2478,-53,0,301,1,6
57602,3,2446,2402,44,0,331,0,3
57603,1,2437,2576,-139,0,301,0,6
57604,2,2401,2287,114,0,113,0,6
57605,1,2412,2565,-153,0,106,0,6
57606,1,2440,2521,-81,0,300,0,6
57607,2,2503,2619,-116,0,341,1,6
57608,2,2369,2577,-208,0,484,0,6
57609,1,2469,2617,-148,0,302,0,6
57610,2,2257,2623,-366,0,41,0,6
57611,1,2681,2375,306,0,302,0,6
57612,2,2687,2629,58,0,113,0,6
57614,2,2490,2650,-160,0,201,0,6
57615,1,2565,2765,-200,0,103,0,6
57616,1,2391,2433,-42,0,242,1,6
57617,2,2400,2728,-328,0,376,0,6
57618,1,2414,2539,-125,0,194,1,6
57619,2,2614,2540,74,0,246,0,6
57620,2,2722,2676,46,0,4,0,6
57621,2,2464,2417,47,0,112,1,6
57622,1,2581,2233,348,0,145,0,6
57623,3,2572,2569,3,0,36,0,6
57624,1,2333,2419,-86,0,1,0,6
57625,2,2585,2621,-36,0,45,1,6
57626,1,2352,2458,-106,0,485,0,6
57627,2,2256,2406,-150,0,0,0,8
57628,1,2468,2430,38,0,45,0,6
57629,1,2446,2400,46,0,142,0,6
57630,1,2421,2265,156,0,459,0,6
57631,2,2474,2331,143,0,107,0,6
57632,1,2412,2454,-42,0,106,0,6
57633,3,2475,2701,-226,0,480,0,6
57634,2,2439,2513,-74,0,459,0,6
57635,2,2421,2429,-8,0,140,0,6
57636,1,2491,2477,14,0,146,0,6
57637,1,2540,2346,194,0,150,0,6
57638,2,2523,2486,37,0,122,0,6
57639,1,2499,2705,-206,0,150,0,6
57640,1,2253,2457,-204,0,190,0,6
57641,2,2475,2629,-154,0,120,0,6
57642,1,2793,2268,525,0,123,0,6
57643,2,2593,2754,-161,0,40,0,6
57644,2,2612,2711,-99,0,45,0,6
57645,3,2424,2393,31,0,7,0,6
57646,1,2429,2385,44,0,45,0,6
57647,1,2496,2312,184,0,45,0,6
57648,2,2363,2526,-163,0,133,0,6
57649,1,2392,2432,-40,0,214,0,6
57650,2,2462,2281,181,0,56,0,6
57651,2,2484,2541,-57,0,338,0,6
57652,1,2521,2453,68,0,152,0,6
57653,2,2444,2250,194,0,307,0,6
57654,2,2418,2566,-148,0,0,1,6
57655,2,2292,2662,-370,0,120,0,6
57656,1,2694,2585,109,0,48,0,6
57657,2,2408,2295,113,0,4,1,6
57658,2,2434,2395,39,0,171,1,6
57659,2,2490,2385,105,0,46,0,6
57660,1,2606,2474,132,0,45,0,6
57661,3,2407,2521,-114,0,414,0,6
57662,2,2292,2593,-301,0,112,0,6
57663,2,2547,2374,173,0,130,0,6
57664,1,2399,2431,-32,0,241,1,6
57665,2,2531,2631,-100,0,463,0,6
57666,2,2478,2380,98,0,242,0,6
57667,1,2564,2252,312,0,365,0,6
57668,1,2419,2409,10,0,14,1,6
57669,1,2578,2554,24,0,5,0,6
57670,2,2485,2640,-155,0,200,1,6
57671,1,2669,2463,206,0,200,0,6
57672,2,2261,2408,-147,0,158,1,6
57673,1,2595,2352,243,0,113,0,6
57674,1,2514,2452,62,0,124,0,6
57675,1,2706,2607,99,0,244,0,6
57676,3,2580,2652,-72,0,337,0,6
57677,2,2496,2228,268,0,130,0,6
57679,2,2410,2406,4,0,44,0,6
57680,2,2405,2375,30,0,206,1,6
57681,1,2407,2353,54,0,330,0,6
57682,1,2509,2232,277,0,0,0,6
57683,1,2475,2458,17,0,190,0,6
57684,2,2605,2736,-131,0,288,1,6
57685,2,2513,2480,33,0,400,0,6
57686,2,2454,2473,-19,0,341,1,6
57687,3,2356,2466,-110,0,263,0,6
57688,2,2489,2365,124,0,426,0,6
57689,2,2325,2572,-247,0,58,0,6
57690,1,2712,2292,420,0,106,0,6
57691,1,2592,2499,93,0,153,0,6
57692,1,2446,2466,-20,0,242,0,6
57693,2,2638,2697,-59,0,49,0,6
57694,2,2348,2705,-357,0,13,0,6
57695,1,2536,2460,76,0,205,0,6
57696,1,2785,2421,364,0,341,0,6
57698,1,2539,2203,336,0,7,0,6
57699,1,2379,2422,-43,0,183,0,6
57700,2,2409,2340,69,0,241,1,6
57701,2,2506,2548,-42,0,115,0,6
57702,1,2564,2440,124,0,245,0,6
57703,1,2644,2369,275,0,404,1,6
57704,3,2494,2396,98,0,106,0,6
57705,2,2498,2688,-190,0,140,0,6
57706,1,2435,2352,83,0,130,0,6
57707,2,2265,2415,-150,0,101,0,6
57708,2,2482,2659,-177,0,107,1,6
57709,2,2445,2281,164,0,436,0,6
57710,2,2311,2422,-111,0,406,0,6
57711,2,2698,2604,94,0,0,0,6
57712,2,2230,2581,-351,0,106,0,6
57713,2,2331,2542,-211,0,46,0,6
57714,1,2445,2304,141,0,130,0,6
57715,2,2268,2453,-185,0,278,0,6
57716,1,2416,2410,6,0,28,0,6
57718,2,2645,2473,172,0,331,0,6
57719,1,2436,2341,95,0,210,0,6
57720,2,2416,2471,-55,0,41,0,6
57721,1,2442,2411,31,0,45,0,6
57722,1,2418,2282,136,0,333,0,6
57723,1,2509,2608,-99,0,211,0,6
57724,2,2447,2484,-37,0,190,0,6
57725,3,2467,2496,-29,0,107,0,6
57726,2,2584,2515,69,0,302,0,6
57727,3,2715,2569,146,0,40,0,6
57728,2,2580,2390,190,0,43,0,6
57729,1,2499,2366,133,0,278,1,6
57730,3,2481,2295,186,0,300,0,6
57731,3,2420,2346,74,0,4,0,6
57732,1,2667,2637,30,0,115,0,6
57733,2,2591,2452,139,0,218,0,6
57734,1,2456,2370,86,0,52,0,6
57735,1,2682,2483,199,0,211,0,6
57736,1,2615,2499,116,0,337,0,6
57737,2,2400,2677,-277,0,106,0,6
57738,1,2509,2387,122,0,1,1,6
57739,2,2754,2487,267,0,100,0,6
57740,3,2413,2425,-12,0,46,0,6
57741,2,2296,2633,-337,0,414,0,6
57742,2,2423,2405,18,0,46,0,6
57743,2,2465,2450,15,0,157,0,6
57744,2,2654,2623,31,0,304,0,6
57746,2,2574,2691,-117,0,151,0,6
57747,2,2410,2314,96,0,113,1,6
57748,2,2512,2390,122,0,170,0,6
57749,1,2511,2358,153,0,0,1,6
57750,2,2470,2610,-140,0,112,0,6
57751,1,2418,2292,126,0,130,1,6
57752,1,2341,2412,-71,0,200,0,6
57753,2,2287,2414,-127,0,140,0,6
57754,1,2414,2479,-65,0,123,0,6
57755,1,2527,2558,-31,0,302,0,6
57756,1,2503,2391,112,0,320,1,6
57757,3,2553,2542,11,0,153,0,6
57758,2,2463,2362,101,0,125,0,6
57759,2,2516,2256,260,0,244,0,6
57760,1,2611,2308,303,0,4,0,6
57761,1,2663,2447,216,0,463,1,6
57762,2,2425,2473,-48,0,413,1,6
57763,2,2426,2490,-64,0,15,0,6
57764,1,2512,2354,158,0,200,0,6
57765,1,2673,2716,-43,0,110,0,6
57766,1,2458,2453,5,0,310,0,6
57767,2,2624,2544,80,0,4,0,6
57768,2,2682,2289,393,0,306,0,6
57769,1,2460,2415,45,0,45,0,6
57770,2,2463,2211,252,0,5,0,6
57771,1,2573,2420,153,0,315,0,6
57772,1,2434,2328,106,0,100,1,6
57773,1,2551,2384,167,0,107,0,6
57774,2,2451,2510,-59,0,202,0,6
57775,2,2392,2436,-44,4,270,1,13
57776,1,2711,2425,286,0,1,0,6
57777,2,2386,2568,-182,0,244,0,6
57778,1,2567,2507,60,0,463,0,6
57779,1,2223,2474,-251,0,335,1,6
57780,1,2536,2425,111,0,40,0,6
57781,1,2492,2554,-62,0,302,1,6
57782,1,2356,2467,-111,0,301,0,6
57783,1,2421,2381,40,0,487,1,6
57784,2,2598,2242,356,0,337,0,6
57785,3,2525,2485,40,0,204,0,6
57786,2,2562,2456,106,0,380,0,6
57787,1,2541,2584,-43,0,105,0,6
57788,2,2455,2398,57,0,5,1,6
57789,3,2706,2510,196,0,405,0,6
57790,2,2656,2533,123,0,310,0,6
57791,2,2432,2642,-210,0,50,0,6
57792,1,2261,2472,-211,0,300,0,6
57793,1,2549,2346,203,0,4,0,6
57794,2,2435,2399,36,0,306,0,6
57795,1,2458,2432,26,0,414,0,6
57796,2,2329,2417,-88,0,40,0,6
57797,2,2382,2644,-262,0,200,0,6
57798,2,2424,2416,8,0,319,0,6
57799,1,2308,2539,-231,0,107,0,6
57800,1,2601,2530,71,0,45,0,6
57801,1,2403,2444,-41,0,141,1,6
57802,3,2412,2392,20,0,4,0,6
57803,2,2583,2794,-211,0,147,0,6
57805,2,2268,2603,-335,0,242,0,6
57806,2,2333,2412,-79,0,315,0,6
57807,1,2386,2560,-174,0,133,0,6
57808,1,2564,2710,-146,0,190,0,6
57809,1,2632,2740,-108,0,130,0,6
57810,1,2471,2517,-46,0,120,0,6
57811,1,2534,2221,313,0,242,0,6
57812,1,2330,2529,-199,0,41,0,6
57813,3,2309,2510,-201,0,267,0,6
57814,1,2422,2317,105,0,5,0,6
57815,2,2406,2252,154,0,200,0,6
57816,3,2494,2419,75,0,140,0,6
57817,1,2730,2347,383,0,288,0,6
57818,1,2541,2398,143,0,5,0,6
57819,1,2482,2262,220,0,150,0,6
57820,2,2597,2374,223,0,131,0,6
57821,2,2361,2446,-85,0,150,0,6
57822,1,2706,2613,93,0,474,0,6
57823,1,2432,2305,127,0,201,0,6
57824,2,2202,2553,-351,0,300,0,6
57825,1,2489,2380,109,0,121,0,6
57826,1,2572,2339,233,0,106,0,6
57827,2,2397,2649,-252,0,250,0,6
57828,1,2523,2501,22,0,5,0,6
57829,1,2645,2492,153,0,446,0,6
57830,3,2380,2438,-58,0,88,0,6
57831,1,2569,2572,-3,0,45,0,6
57832,3,2681,2623,58,0,196,0,6
57833,2,2379,2499,-120,0,46,0,6
57834,1,2465,2309,156,0,415,0,6
57835,1,2636,2570,66,0,9,0,6
57836,2,2611,2683,-72,0,201,0,6
57838,1,2425,2497,-72,0,152,1,6
57839,2,2583,2631,-48,0,5,0,6
57840,2,2710,2479,231,0,7,0,6
57841,3,2703,2548,155,0,448,0,6
57842,2,2494,2259,235,0,4,1,6
57843,1,2477,2479,-2,0,45,0,6
57844,1,2544,2647,-103,0,14,0,6
57845,1,2629,2436,193,0,302,0,6
57846,1,2565,2691,-126,0,50,0,6
57847,1,2229,2597,-368,0,130,0,6
57848,2,2259,2556,-297,0,107,0,6
57849,1,2470,2222,248,0,300,0,6
57850,2,2631,2609,22,0,434,0,6
57851,1,2426,2406,20,0,311,1,6
57852,3,2715,2442,273,0,484,0,6
57853,1,2486,2507,-21,0,106,0,6
57854,1,2680,2673,7,0,133,0,6
57855,2,2404,2460,-56,0,45,0,6
57856,1,2331,2405,-74,0,344,0,6
57857,2,2472,2432,40,0,46,0,6
57858,2,2569,2620,-51,0,132,0,6
57859,1,2382,2411,-29,0,246,0,6
57860,1,2589,2507,82,0,300,1,6
57861,3,2468,2572,-104,0,392,0,6
57862,1,2517,2348,169,0,4,0,6
57863,1,2657,2302,355,0,85,0,6
57864,2,2434,2423,11,0,440,0,6
57865,1,2569,2417,152,0,101,0,6
57866,2,2531,2447,84,0,130,0,6
57867,1,2448,2402,46,0,40,0,6
57868,1,2695,2569,126,0,405,0,6
57869,1,2395,2757,-362,0,211,0,6
57870,1,2349,2519,-170,0,27,0,6
57871,1,2495,2377,118,0,484,0,6
57872,2,2486,2422,64,0,45,0,6
57873,3,2524,2507,17,0,311,0,6
57874,2,2412,2341,71,0,106,0,6
57875,2,2483,2394,89,0,0,0,6
57876,2,2381,2554,-173,0,113,0,6
57877,2,2408,2434,-26,0,106,0,6
57878,2,2311,2422,-111,0,190,0,6
57879,3,2796,2713,83,0,335,0,6
57880,1,2743,2449,294,0,301,0,6
57881,3,2387,2514,-127,0,12,0,6
57882,2,2399,2635,-236,0,112,0,6
57883,2,2605,2580,25,0,246,0,6
57884,1,2404,2294,110,0,313,0,6
57885,2,2236,2425,-189,0,469,0,6
57886,3,2473,2397,76,0,411,0,6
57888,2,2318,2471,-153,0,464,0,6
57889,1,2571,2478,93,0,0,0,6
57890,2,2263,2656,-393,0,192,0,6
57891,1,2635,2483,152,0,140,0,6
57892,2,2419,2262,157,0,45,1,6
57893,2,2420,2291,129,0,106,0,6
57894,1,2691,2426,265,0,138,0,6
57895,2,2363,2422,-59,0,15,1,6
57896,2,2306,2787,-481,0,74,0,6
57897,2,2332,2713,-381,0,106,0,6
57898,1,2299,2456,-157,0,46,0,6
57899,1,2553,2485,68,0,46,0,6
57900,1,2269,2495,-226,0,490,0,6
57901,2,2221,2617,-396,0,0,0,6
57902,2,2410,2258,152,0,331,0,6
57903,2,2549,2540,9,0,4,0,6
57904,2,2404,2428,-24,0,300,0,6
57905,2,2458,2530,-72,0,156,0,6
57906,1,2373,2406,-33,0,143,0,6
57907,2,2496,2577,-81,0,120,0,6
57908,1,2278,2492,-214,0,43,0,6
57909,2,2416,2448,-32,0,100,0,6
57910,1,2419,2701,-282,0,6,0,6
57911,1,2502,2372,130,0,10,1,6
57912,1,2555,2465,90,0,332,0,6
57913,1,2278,2403,-125,0,207,1,6
57914,1,2459,2494,-35,0,434,0,6
57915,3,2645,2672,-27,0,267,0,6
57916,2,2526,2536,-10,0,7,0,6
57917,1,2300,2547,-247,0,0,0,6
57918,1,2679,2347,332,0,50,0,6
57919,1,2352,2648,-296,0,11,0,6
57920,1,2426,2329,97,0,110,0,6
57921,1,2387,2489,-102,0,13,0,6
57922,1,2406,2482,-76,0,484,0,6
57923,3,2326,2425,-99,0,200,0,6
57924,3,2219,2501,-282,0,485,0,6
57925,1,2429,2200,229,0,490,0,6
57926,2,2488,2572,-84,0,40,1,6
57927,2,2463,2606,-143,0,200,0,6
57928,2,2375,2400,-25,0,205,0,6
57929,1,2404,2246,158,0,44,0,8
57930,2,2626,2580,46,0,455,0,6
57931,3,2507,2347,160,0,404,0,6
57932,1,2647,2552,95,0,61,0,6
57933,1,2740,2427,313,0,203,0,6
57934,2,2389,2468,-79,0,15,0,6
57935,1,2664,2383,281,0,10,0,6
57936,2,2322,2452,-130,0,113,0,6
57937,2,2292,2495,-203,0,45,0,6
57938,1,2464,2459,5,0,4,0,6
57939,1,2651,2480,171,0,153,0,6
57940,1,2596,2529,67,0,15,0,6
57941,1,2403,2460,-57,0,301,0,6
57942,1,2638,2380,258,0,156,0,6
57943,1,2588,2448,140,0,385,0,6
57944,3,2253,2600,-347,0,48,0,6
57945,2,2518,2809,-291,0,302,0,6
57946,1,2646,2375,271,0,485,0,6
57947,1,2640,2389,251,0,40,1,6
57948,2,2321,2581,-260,0,485,1,6
57949,2,2267,2588,-321,0,121,0,6
57950,1,2574,2225,349,0,13,0,6
57951,3,2466,2517,-51,0,121,0,6
57952,2,2338,2440,-102,0,70,0,6
57953,1,2337,2458,-121,0,302,0,6
57954,3,2403,2446,-43,0,250,0,3
57955,2,2552,2436,116,0,455,0,6
57956,1,2373,2429,-56,0,245,0,6
57957,2,2565,2499,66,0,152,0,6
57958,2,2520,2607,-87,0,4,0,6
57959,2,2460,2544,-84,0,112,0,6
57960,2,2483,2573,-90,0,325,0,6
57961,3,2733,2672,61,0,258,0,6
57962,2,2522,2583,-61,0,302,0,6
57963,1,2646,2641,5,0,110,0,6
57964,2,2571,2449,122,0,101,0,6
57965,2,2300,2456,-156,0,300,0,6
57966,2,2574,2686,-112,0,442,0,6
57967,2,2554,2690,-136,0,409,0,6
57968,3,2395,2507,-112,0,59,0,6
57970,2,2458,2543,-85,0,36,1,6
57971,1,2543,2379,164,0,130,1,6
57972,2,2381,2545,-164,0,405,0,6
57973,3,2690,2640,50,0,122,0,6
57974,3,2453,2394,59,0,10,0,6
57975,1,2551,2290,261,0,300,0,6
57976,2,2420,2468,-48,0,201,0,6
57977,2,2421,2517,-96,0,120,1,6
57978,2,2515,2540,-25,0,310,0,6
57979,2,2476,2410,66,0,302,0,6
57980,2,2397,2426,-29,0,108,1,8
57981,2,2455,2659,-204,0,117,1,6
57982,3,2632,2731,-99,0,49,0,6
57983,1,2691,2382,309,0,7,0,6
57984,2,2433,2558,-125,0,466,0,6
57985,1,2297,2429,-132,0,207,0,6
57986,2,2524,2402,122,0,36,0,6
57987,2,2385,2428,-43,0,201,0,6
57988,2,2495,2703,-208,0,52,0,6
57989,2,2333,2577,-244,0,352,1,6
57990,1,2529,2385,144,0,335,0,6
57991,2,2200,2434,-234,0,320,1,6
57992,1,2478,2420,58,0,45,0,6
57993,1,2290,2440,-150,0,122,0,6
57994,2,2393,2437,-44,0,106,0,6
57995,2,2381,2403,-22,0,84,0,6
57996,1,2474,2348,126,0,1,0,6
57997,2,2452,2266,186,0,13,0,6
57998,1,2495,2376,119,0,337,0,6
57999,3,2405,2554,-149,0,31,0,6
58000,2,2460,2471,-11,0,205,0,6
58001,2,2205,2532,-327,0,464,0,6
58002,2,2417,2367,50,0,50,0,6
58003,1,2686,2453,233,0,112,0,6
58004,1,2493,2388,105,0,250,1,6
58005,1,2571,2795,-224,0,37,0,6
58006,2,2609,2714,-105,0,300,0,6
58007,3,2393,2422,-29,0,304,0,6
58008,1,2402,2505,-103,0,130,0,6
58009,2,2415,2587,-172,0,130,1,6
58010,2,2503,2625,-122,0,156,0,6
58011,1,2395,2418,-23,0,36,0,6
58012,2,2326,2683,-357,0,45,0,6
58013,1,2420,2411,9,0,100,1,6
58014,1,2480,2339,141,0,190,1,6
58015,1,2615,2577,38,0,43,1,6
58016,1,2347,2413,-66,0,111,0,6
58017,1,2473,2436,37,0,406,0,6
58018,2,2503,2415,88,0,300,0,6
58019,1,2512,2542,-30,0,0,0,6
58020,2,2357,2505,-148,0,337,1,6
58021,1,2586,2305,281,0,253,0,6
58022,1,2651,2307,344,0,43,0,6
58023,1,2788,2429,359,0,9,0,6
58024,2,2207,2574,-367,0,45,0,6
58026,2,2257,2462,-205,0,133,0,6
58027,3,2395,2413,-18,0,140,0,6
58028,2,2398,2445,-47,0,113,0,6
58029,3,2421,2513,-92,0,1,0,6
58030,1,2413,2232,181,0,331,0,6
58031,1,2427,2403,24,0,302,0,6
58032,1,2453,2423,30,0,226,0,6
58033,2,2451,2449,2,0,455,1,6
58034,1,2449,2228,221,0,13,0,6
58035,2,2470,2339,131,0,335,0,6
58036,2,2426,2540,-114,0,57,0,6
58037,2,2482,2327,155,0,176,0,6
58038,2,2598,2520,78,0,142,1,6
58039,2,2441,2296,145,0,302,0,6
58040,2,2428,2482,-54,0,410,0,6
58041,1,2558,2563,-5,0,108,0,6
58042,2,2489,2412,77,0,4,0,6
58043,2,2450,2325,125,0,140,0,6
58044,3,2422,2422,0,0,7,0,6
58045,3,2415,2353,62,0,236,0,8
58046,1,2688,2243,445,0,43,0,6
58047,1,2474,2492,-18,0,100,0,6
58048,3,2462,2397,65,0,405,0,6
58049,1,2499,2405,94,0,43,1,6
58050,1,2472,2601,-129,0,123,0,6
58051,2,2637,2480,157,0,46,0,6
58052,1,2414,2385,29,0,46,0,6
58053,1,2541,2402,139,0,49,1,6
58054,2,2582,2642,-60,0,454,0,6
58055,2,2747,2547,200,0,109,1,6
58056,2,2374,2525,-151,0,132,0,6
58057,1,2396,2572,-176,0,130,1,6
58058,3,2378,2680,-302,0,101,0,6
58059,1,2524,2553,-29,0,4,0,6
58060,2,2711,2576,135,0,40,1,6
58061,2,2609,2573,36,0,4,0,6
58062,1,2485,2399,86,0,246,0,6
58063,1,2437,2361,76,0,20,0,6
58064,2,2683,2363,320,0,315,0,6
58065,2,2415,2483,-68,0,54,1,6
58066,2,2363,2443,-80,0,41,0,6
58067,1,2315,2438,-123,0,123,0,6
58068,2,2510,2479,31,0,101,0,6
58069,2,2522,2408,114,0,45,0,6
58070,2,2376,2576,-200,0,4,0,6
58071,2,2619,2457,162,0,4,0,6
58072,1,2431,2262,169,0,6,0,6
58073,1,2578,2309,269,0,61,0,6
58074,1,2266,2412,-146,0,45,0,6
58075,3,2438,2426,12,0,310,0,6
58077,1,2538,2483,55,0,7,0,6
58078,1,2428,2391,37,0,278,0,6
58079,2,2358,2563,-205,0,405,0,6
58080,1,2663,2201,462,0,313,1,6
58081,2,2402,2472,-70,0,106,0,6
58082,1,2410,2254,156,0,335,1,8
58083,3,2519,2482,37,0,404,0,6
58084,2,2418,2271,147,0,45,0,6
58085,2,2403,2479,-76,0,100,0,6
58086,1,2508,2453,55,0,453,0,6
58087,2,2611,2642,-31,0,209,0,6
58088,2,2510,2603,-93,0,182,0,6
58089,2,2307,2708,-401,0,48,0,6
58090,1,2506,2380,126,0,473,1,6
58091,1,2475,2284,191,0,330,0,6
58092,1,2405,2592,-187,0,142,0,6
58093,3,2385,2508,-123,0,28,0,6
58094,1,2406,2413,-7,0,4,0,6
58095,1,2423,2339,84,0,112,0,6
58096,2,2580,2605,-25,0,447,0,6
58097,1,2666,2648,18,0,303,0,6
58098,1,2446,2473,-27,0,255,0,6
58099,1,2445,2448,-3,0,487,0,6
58100,2,2447,2254,193,0,109,0,6
58101,1,2680,2600,80,0,113,1,6
58102,1,2515,2446,69,0,200,0,6
58103,1,2499,2399,100,0,315,0,6
58104,3,2490,2411,79,0,311,0,6
58105,2,2718,2673,45,0,43,0,6
58106,2,2390,2564,-174,0,125,0,6
58107,1,2480,2210,270,0,50,0,6
58108,2,2693,2559,134,0,4,0,6
58109,3,2412,2223,189,0,354,0,6
58110,1,2477,2516,-39,0,453,1,6
58111,2,2454,2745,-291,0,103,0,6
58112,3,2447,2544,-97,0,148,0,6
58114,1,2260,2466,-206,0,118,0,6
58115,1,2500,2331,169,0,201,0,6
58116,2,2380,2453,-73,0,106,0,6
58117,2,2338,2401,-63,0,4,0,6
58118,1,2551,2431,120,0,202,1,6
58119,2,2487,2344,143,0,122,0,6
58120,1,2438,2465,-27,0,301,1,6
58121,2,2230,2504,-274,0,107,0,6
58122,3,2567,2557,10,0,118,0,6
58123,2,2542,2439,103,0,101,0,6
58124,1,2786,2635,151,0,426,0,6
58125,1,2487,2313,174,0,7,0,6
58126,2,2566,2580,-14,0,125,1,6
58127,2,2300,2432,-132,0,251,0,6
58128,1,2506,2516,-10,0,484,0,6
58129,2,2204,2412,-208,0,13,0,6
58131,3,2590,2700,-110,0,140,0,6
58132,2,2456,2578,-122,0,242,1,6
58133,2,2534,2476,58,0,205,0,6
58134,1,2580,2789,-209,0,4,0,6
58135,1,2384,2461,-77,0,245,0,6
58136,2,2575,2423,152,0,190,0,6
58137,1,2699,2651,48,0,50,0,6
58138,1,2811,2206,605,0,307,0,6
58139,3,2399,2594,-195,0,245,0,6
58140,1,2355,2484,-129,0,28,0,6
58141,1,2350,2559,-209,0,101,0,6
58142,2,2347,2405,-58,0,1,0,6
58143,2,2472,2409,63,0,80,0,6
58144,2,2534,2575,-41,0,140,0,6
58145,1,2607,2518,89,0,4,0,6
58146,2,2425,2471,-46,0,133,0,6
58147,2,2413,2304,109,0,46,1,6
58148,2,2307,2741,-434,0,228,0,6
58149,1,2423,2452,-29,0,211,1,6
58150,1,2638,2392,246,0,41,0,6
58151,1,2410,2380,30,0,301,0,6
58152,2,2419,2395,24,0,217,1,6
58153,1,2484,2369,115,0,129,0,6
58154,1,2467,2542,-75,0,106,0,6
58155,1,2454,2272,182,0,20,0,6
58156,1,2480,2513,-33,0,31,0,6
58157,1,2535,2287,248,0,107,0,6
58158,1,2416,2334,82,0,190,0,6
58159,2,2447,2253,194,0,7,0,6
58160,1,2579,2479,100,0,7,0,6
58161,1,2693,2653,40,0,250,0,6
58162,2,2225,2462,-237,0,50,0,6
58163,2,2632,2639,-7,0,462,0,6
58164,1,2472,2390,82,0,409,0,6
58165,1,2259,2452,-193,0,122,1,6
58166,2,2543,2790,-247,0,147,0,6
58167,1,2424,2311,113,0,140,1,6
58168,2,2620,2459,161,0,102,1,6
58169,2,2348,2588,-240,0,56,0,6
58170,1,2528,2362,166,0,145,0,6
58171,1,2550,2303,247,0,223,0,6
58172,3,2566,2452,114,0,122,0,6
58173,2,2442,2299,143,0,40,1,6
58174,3,2421,2412,9,0,206,0,6
58175,2,2419,2469,-50,0,140,0,6
58176,2,2546,2510,36,0,405,0,6
58177,1,2415,2256,159,0,152,0,8
58178,2,2420,2334,86,0,131,1,6
58179,2,2472,2496,-24,0,10,0,6
58180,2,2500,2541,-41,0,101,0,6
58181,1,2418,2243,175,0,382,0,6
58182,2,2459,2703,-244,0,152,0,6
58183,1,2381,2404,-23,0,48,0,6
58184,1,2450,2533,-83,0,332,0,6
58185,1,2431,2274,157,0,7,0,6
58186,2,2260,2409,-149,0,310,0,6
58187,2,2306,2652,-346,0,200,0,6
58188,3,2405,2427,-22,0,0,0,6
58189,3,2742,2548,194,0,107,0,6
58190,2,2465,2480,-15,0,0,1,6
58191,3,2395,2486,-91,0,101,0,6
58192,2,2334,2434,-100,0,400,1,6
58193,1,2507,2288,219,0,5,0,6
58194,1,2610,2426,184,0,302,0,6
58195,1,2477,2435,42,0,315,0,6
58196,2,2467,2479,-12,0,121,0,6
58197,1,2343,2471,-128,0,300,0,6
58198,1,2679,2689,-10,0,404,0,6
58199,2,2583,2333,250,0,40,0,6
58200,1,2474,2380,94,0,112,0,6
58201,2,2552,2478,74,0,112,0,6
58202,1,2546,2567,-21,0,406,0,6
58203,3,2606,2254,352,0,201,0,6
58204,2,2484,2654,-170,0,15,1,6
58205,2,2647,2641,6,0,46,0,6
58206,1,2595,2422,173,0,203,0,6
58207,2,2535,2396,139,0,302,0,6
58208,3,2546,2455,91,0,200,0,6
58209,1,2433,2318,115,0,455,0,6
58210,2,2258,2461,-203,0,45,0,6
58211,1,2281,2411,-130,0,315,0,6
58212,2,2365,2461,-96,0,138,0,6
58213,2,2406,2432,-26,0,17,0,6
58214,2,2468,2712,-244,0,154,1,6
58215,2,2374,2476,-102,0,122,0,6
58216,2,2425,2492,-67,0,18,1,6
58217,1,2416,2348,68,0,211,0,6
58218,3,2586,2620,-34,0,45,0,6
58219,1,2350,2505,-155,0,5,0,6
58220,1,2439,2513,-74,0,114,0,6
58221,1,2444,2319,125,4,151,1,13
58222,1,2481,2320,161,0,123,0,6
58223,2,2326,2433,-107,0,138,0,6
58224,2,2209,2439,-230,0,15,0,6
58225,1,2812,2550,262,0,123,0,6
58226,2,2591,2591,0,0,106,0,6
58227,1,2710,2517,193,0,112,0,6
58228,2,2251,2531,-280,0,48,0,6
58229,1,2592,2551,41,0,13,0,6
58230,1,2286,2456,-170,0,187,0,6
58231,1,2527,2401,126,0,4,1,6
58232,2,2549,2345,204,0,7,0,6
58233,2,2444,2684,-240,0,25,1,6
58234,2,2443,2504,-61,0,190,0,6
58235,1,2478,2325,153,0,200,0,6
58236,3,2363,2544,-181,0,35,0,6
58237,1,2548,2217,331,0,207,0,6
58238,2,2396,2592,-196,0,246,0,6
58239,1,2779,2483,296,0,46,0,6
58240,2,2590,2352,238,0,197,0,6
58241,1,2694,2588,106,0,278,0,6
58242,1,2486,2268,218,0,345,0,6
58243,1,2457,2304,153,0,310,0,6
58244,2,2392,2547,-155,0,45,0,6
58245,3,2527,2490,37,0,203,0,6
58246,1,2451,2224,227,0,357,0,6
58247,1,2440,2294,146,0,102,0,6
58248,2,2522,2338,184,0,100,0,6
58249,2,2306,2499,-193,0,302,0,6
58250,1,2567,2408,159,0,310,0,6
58251,2,2306,2626,-320,0,113,0,6
58252,1,2200,2629,-429,0,20,0,6
58253,1,2506,2673,-167,0,121,0,6
58254,1,2729,2574,155,0,190,0,6
58255,1,2577,2509,68,0,0,0,6
58256,2,2383,2667,-284,0,247,0,6
58257,1,2610,2649,-39,0,48,0,6
58258,1,2690,2685,5,0,113,0,6
58259,2,2488,2667,-179,0,72,0,6
58260,1,2265,2570,-305,0,400,0,6
58261,2,2386,2421,-35,0,200,0,6
58262,1,2373,2503,-130,0,301,0,6
58263,1,2629,2314,315,0,490,0,6
58264,2,2645,2634,11,0,280,0,6
58265,1,2482,2376,106,0,491,0,6
58266,3,2518,2422,96,0,40,0,6
58267,1,2478,2333,145,0,335,0,6
58268,1,2338,2442,-104,0,45,0,6
58269,2,2408,2246,162,0,302,0,8
58270,1,2386,2434,-48,0,13,1,6
58271,1,2503,2452,51,0,369,0,6
58272,2,2653,2564,89,0,345,0,6
58273,1,2583,2366,217,0,4,0,6
58274,1,2388,2541,-153,0,100,0,6
58275,1,2556,2541,15,0,138,0,6
58276,1,2583,2434,149,0,0,0,6
58277,1,2326,2497,-171,0,45,1,6
58278,1,2792,2703,89,0,335,0,6
58279,1,2437,2313,124,0,45,1,6
58280,1,2580,2264,316,0,49,0,6
58281,2,2384,2662,-278,0,115,0,6
58282,2,2499,2397,102,0,108,1,6
58283,1,2357,2484,-127,0,131,0,6
58284,2,2312,2489,-177,0,152,0,6
58285,1,2412,2335,77,0,119,0,6
58286,2,2427,2453,-26,0,216,0,6
58287,2,2551,2335,216,0,45,0,6
58288,1,2421,2306,115,0,250,0,6
58289,2,2512,2611,-99,0,484,1,6
58290,1,2514,2552,-38,0,0,0,6
58291,1,2747,2689,58,0,301,0,6
58292,1,2510,2490,20,0,373,0,6
58293,3,2329,2423,-94,0,40,0,6
58294,1,2508,2444,64,0,49,1,6
58295,1,2406,2227,179,0,133,0,6
58296,2,2393,2483,-90,0,211,1,6
58297,1,2481,2223,258,0,210,0,6
58298,2,2394,2465,-71,0,7,0,6
58299,2,2301,2450,-149,0,315,1,6
58300,3,2511,2370,141,0,1,0,6
58301,1,2307,2527,-220,0,100,0,6
58302,2,2579,2462,117,0,125,0,6
58303,3,2421,2398,23,0,245,0,6
58304,2,2419,2490,-71,0,3,0,6
58305,1,2484,2372,112,0,330,0,6
58306,1,2488,2411,77,0,303,0,6
58307,2,2385,2528,-143,0,140,0,6
58308,2,2271,2484,-213,0,45,0,6
58309,1,2426,2457,-31,0,306,1,6
58310,1,2556,2316,240,0,59,0,6
58311,1,2709,2416,293,0,1,0,6
58312,3,2602,2704,-102,0,22,0,6
58313,1,2476,2435,41,0,150,0,6
58314,2,2228,2402,-174,0,121,0,6
58315,1,2407,2504,-97,0,241,0,6
58316,1,2646,2259,387,0,201,0,6
58317,1,2591,2407,184,0,330,0,6
58318,1,2526,2437,89,0,25,0,6
58319,1,2344,2418,-74,0,117,1,6
58320,1,2522,2395,127,0,0,0,6
58321,1,2496,2531,-35,0,143,0,6
58322,1,2581,2383,198,0,100,0,6
58323,1,2533,2599,-66,0,5,0,6
58324,1,2591,2538,53,0,131,0,6
58325,1,2414,2448,-34,0,207,0,6
58326,1,2419,2391,28,0,43,0,6
58327,2,2275,2515,-240,0,347,0,6
58328,2,2492,2643,-151,0,194,1,6
58329,1,2269,2583,-314,0,142,0,6
58330,1,2698,2549,149,0,0,0,6
58331,2,2506,2546,-40,0,101,0,6
58332,1,2381,2521,-140,0,300,0,6
58333,1,2646,2597,49,0,106,0,6
58334,2,2485,2479,6,0,415,0,6
58335,1,2388,2673,-285,0,463,0,6
58336,1,2642,2585,57,0,49,0,6
58337,2,2564,2738,-174,0,106,0,6
58338,1,2589,2580,9,0,45,1,6
58339,3,2445,2403,42,0,250,0,3
58340,2,2465,2409,56,0,45,1,6
58341,2,2450,2289,161,0,18,1,6
58342,2,2353,2520,-167,0,45,1,6
58343,1,2618,2670,-52,0,101,0,6
58344,2,2330,2508,-178,0,41,1,6
58345,1,2235,2496,-261,0,385,0,6
58346,1,2397,2415,-18,0,178,0,6
58347,1,2542,2404,138,0,464,0,6
58348,1,2457,2477,-20,0,7,0,6
58349,2,2476,2582,-106,0,45,0,6
58350,2,2342,2584,-242,0,0,0,6
58351,1,2796,2587,209,0,100,0,6
58352,1,2398,2641,-243,0,200,0,6
58353,3,2728,2585,143,0,127,0,6
58354,1,2699,2432,267,0,300,0,6
58355,1,2430,2458,-28,0,218,1,6
58356,2,2648,2386,262,0,426,0,6
58357,2,2558,2699,-141,0,344,0,6
58358,2,2365,2452,-87,0,112,1,6
58359,1,2454,2594,-140,0,4,0,6
58360,3,2458,2505,-47,0,45,0,6
58361,3,2435,2564,-129,0,140,0,6
58362,1,2440,2529,-89,0,0,0,6
58363,2,2422,2237,185,4,49,0,13
58365,3,2245,2495,-250,0,4,0,6
58366,2,2304,2482,-178,0,200,0,6
58367,1,2459,2445,14,0,122,0,6
58368,1,2502,2451,51,0,146,0,6
58369,1,2412,2381,31,0,409,1,6
58370,2,2396,2613,-217,0,201,0,6
58371,2,2314,2411,-97,0,14,0,6
58372,2,2475,2528,-53,0,405,0,6
58373,2,2567,2401,166,0,154,0,6
58374,2,2423,2526,-103,0,241,0,6
58375,1,2551,2437,114,0,121,1,6
58376,3,2582,2739,-157,0,108,0,6
58377,1,2452,2294,158,0,260,1,6
58378,3,2448,2490,-42,0,136,0,6
58379,2,2390,2402,-12,0,106,1,6
58380,1,2455,2225,230,0,158,0,6
58381,2,2327,2723,-396,0,112,0,6
58382,1,2442,2303,139,0,4,1,6
58383,1,2374,2451,-77,0,307,0,6
58384,1,2410,2343,67,0,106,0,6
58385,2,2430,2403,27,0,140,1,6
58386,1,2506,2548,-42,0,410,1,6
58387,2,2378,2557,-179,0,105,0,6
58388,3,2426,2427,-1,0,469,0,6
58389,2,2426,2490,-64,0,411,0,6
58390,2,2685,2781,-96,0,343,0,6
58391,1,2457,2406,51,0,100,1,6
58392,2,2487,2480,7,0,216,0,6
58393,1,2385,2481,-96,0,130,0,6
58394,1,2556,2560,-4,0,140,0,6
58395,1,2312,2617,-305,0,0,0,6
58396,1,2393,2554,-161,0,129,0,6
58397,1,2713,2356,357,0,241,0,6
58398,2,2581,2488,93,0,478,1,6
58399,1,2679,2268,411,0,334,0,6
58400,1,2561,2481,80,0,102,0,6
58401,3,2640,2681,-41,0,225,0,6
58402,2,2408,2476,-68,0,112,0,6
58403,1,2466,2300,166,0,320,0,6
58404,1,2518,2272,246,0,456,0,6
58405,1,2705,2203,502,0,211,0,6
58406,1,2510,2219,291,0,17,0,6
58407,1,2514,2489,25,0,45,0,6
58408,2,2430,2695,-265,0,330,0,6
58409,1,2407,2232,175,0,311,1,6
58410,2,2283,2432,-149,0,466,0,8
58411,1,2640,2463,177,0,305,0,6
58412,1,2460,2381,79,0,0,0,6
58413,1,2639,2586,53,0,106,1,6
58414,1,2665,2272,393,0,48,0,6
58415,1,2619,2461,158,0,46,0,6
58416,1,2433,2244,189,0,48,1,6
58417,2,2221,2455,-234,0,0,0,6
58418,2,2363,2530,-167,0,340,0,6
58419,2,2343,2514,-171,0,101,0,6
58420,1,2460,2211,249,0,134,0,6
58421,2,2400,2343,57,0,200,0,6
58422,1,2485,2418,67,0,120,0,6
58423,2,2413,2340,73,0,241,0,6
58424,3,2441,2233,208,0,123,0,6
58425,2,2273,2483,-210,0,121,0,6
58426,1,2596,2523,73,0,359,1,6
58427,2,2406,2427,-21,0,418,0,6
58428,2,2434,2345,89,0,40,0,6
58429,1,2434,2375,59,0,45,0,6
58430,1,2489,2386,103,0,45,0,6
58431,2,2535,2714,-179,0,106,0,6
58432,1,2664,2403,261,0,16,0,6
58433,2,2571,2562,9,0,108,1,6
58434,3,2714,2645,69,0,302,0,6
58435,2,2425,2815,-390,0,258,0,6
58436,2,2485,2532,-47,0,132,0,6
58437,1,2502,2540,-38,0,115,1,6
58438,1,2464,2359,105,0,464,0,6
58439,3,2405,2304,101,0,217,0,6
58440,2,2292,2525,-233,0,45,0,6
58441,2,2628,2571,57,0,15,0,6
58442,2,2409,2510,-101,0,104,1,6
58443,1,2589,2256,333,0,11,0,6
58444,2,2400,2354,46,0,47,0,6
58445,2,2442,2500,-58,0,132,0,6
58446,2,2309,2414,-105,0,246,0,8
58447,1,2421,2360,61,0,115,0,6
58448,1,2544,2428,116,0,127,0,6
58449,2,2733,2646,87,0,213,0,6
58450,1,2571,2403,168,0,41,1,6
58451,2,2741,2612,129,0,140,0,6
58452,2,2580,2586,-6,0,102,0,6
58453,2,2657,2546,111,0,149,1,6
58454,1,2670,2469,201,0,6,0,6
58455,2,2661,2702,-41,0,470,0,6
58456,2,2357,2437,-80,0,457,0,6
58457,2,2227,2485,-258,0,113,0,6
58458,1,2423,2444,-21,0,195,1,6
58459,1,2422,2277,145,0,300,0,6
58460,1,2497,2446,51,0,201,0,6
58461,2,2435,2345,90,0,210,0,6
58462,2,2358,2513,-155,0,4,0,6
58463,2,2533,2420,113,0,0,0,6
58464,1,2469,2472,-3,0,331,0,6
58465,2,2592,2799,-207,0,440,0,6
58466,2,2584,2598,-14,0,119,1,6
58467,2,2439,2542,-103,0,58,0,6
58468,2,2289,2544,-255,0,409,0,6
58469,2,2222,2750,-528,0,231,0,6
58470,2,2456,2312,144,0,211,0,6
58471,2,2508,2596,-88,0,333,0,6
58472,1,2485,2698,-213,0,5,0,6
58473,1,2573,2437,136,0,345,0,6
58474,1,2516,2439,77,0,49,0,6
58475,1,2616,2508,108,0,8,0,6
58476,2,2584,2651,-67,0,0,0,6
58477,2,2442,2631,-189,0,150,0,6
58478,2,2619,2587,32,0,110,0,6
58479,2,2244,2421,-177,4,150,0,13
58480,2,2474,2412,62,0,106,0,6
58481,1,2513,2339,174,0,250,0,6
58482,3,2410,2562,-152,0,245,0,6
58483,2,2430,2603,-173,0,58,0,6
58484,1,2724,2378,346,0,46,0,6
58485,2,2474,2462,12,0,255,0,6
58486,1,2517,2346,171,0,122,0,6
58487,2,2546,2437,109,0,305,0,6
58488,2,2393,2753,-360,0,103,0,6
58489,1,2438,2297,141,0,326,0,6
58490,3,2701,2389,312,0,40,0,6
58492,1,2683,2513,170,0,112,0,6
58493,1,2562,2335,227,0,122,0,6
58494,1,2435,2285,150,0,119,0,8
58495,3,2404,2444,-40,0,190,0,3
58496,2,2372,2522,-150,0,306,0,6
58497,2,2419,2392,27,0,15,1,6
58498,2,2415,2508,-93,0,211,0,6
58499,3,2421,2395,26,0,1,0,6
58500,1,2544,2419,125,0,302,1,6
58501,1,2687,2490,197,0,48,0,6
58502,2,2356,2448,-92,0,45,0,6
58503,1,2462,2201,261,0,190,1,6
58504,2,2447,2497,-50,0,241,0,6
58505,1,2680,2682,-2,0,267,0,6
58506,1,2616,2640,-24,0,455,0,6
58507,1,2504,2393,111,0,305,0,6
58508,1,2223,2520,-297,0,41,0,6
58509,2,2485,2211,274,0,15,0,6
58510,2,2456,2457,-1,0,123,1,6
58511,1,2531,2458,73,0,100,0,6
58512,1,2533,2546,-13,0,313,0,6
58513,2,2264,2400,-136,0,438,0,6
58514,2,2413,2311,102,0,477,0,8
58515,2,2516,2539,-23,0,310,0,6
58516,1,2436,2352,84,0,100,0,6
58517,2,2338,2486,-148,0,1,0,6
58518,2,2427,2392,35,0,300,0,6
58519,2,2488,2418,70,0,43,0,6
58520,1,2377,2464,-87,0,143,1,6
58521,2,2417,2594,-177,0,250,1,6
58522,1,2345,2410,-65,0,7,0,6
58523,1,2202,2402,-200,0,145,0,6
58524,1,2751,2379,372,0,130,0,6
58525,2,2330,2509,-179,0,106,0,6
58526,1,2349,2515,-166,0,211,0,6
58527,2,2258,2464,-206,0,101,0,6
58528,2,2647,2648,-1,0,50,0,6
58529,1,2713,2706,7,0,300,0,6
58530,2,2488,2555,-67,0,210,0,6
58531,1,2404,2390,14,0,426,0,6
58532,1,2711,2463,248,0,1,0,6
58533,1,2702,2539,163,0,194,0,6
58534,2,2591,2471,120,0,132,0,6
58535,1,2587,2584,3,0,228,0,6
58536,2,2270,2493,-223,0,114,1,6
58537,1,2414,2209,205,0,56,0,6
58538,2,2406,2492,-86,0,413,1,6
58539,1,2485,2375,110,0,484,0,6
58540,1,2308,2435,-127,0,126,0,6
58541,1,2401,2394,7,0,0,0,6
58542,1,2726,2564,162,0,153,0,6
58543,2,2409,2436,-27,0,27,0,6
58544,1,2501,2462,39,0,125,0,6
58545,2,2297,2559,-262,0,76,0,6
58546,2,2444,2507,-63,0,11,0,6
58547,1,2454,2468,-14,0,484,0,6
58548,1,2554,2361,193,0,405,0,6
58549,1,2551,2588,-37,0,127,0,6
58550,1,2502,2289,213,0,122,0,6
58551,1,2446,2210,236,0,487,0,6
58552,1,2400,2364,36,0,40,0,6
58553,2,2412,2492,-80,0,57,0,6
58554,1,2404,2282,122,0,106,1,6
58555,2,2497,2666,-169,0,310,0,6
58556,1,2399,2520,-121,0,10,0,6
58557,1,2638,2279,359,0,466,0,6
58558,1,2574,2504,70,0,44,0,6
58559,3,2291,2439,-148,0,100,0,6
58560,1,2447,2310,137,0,172,0,6
58561,1,2427,2407,20,0,176,0,6
58562,2,2601,2589,12,0,106,0,6
58563,1,2634,2421,213,0,331,1,6
58564,2,2225,2422,-197,0,250,0,6
58565,1,2802,2681,121,0,248,0,6
58566,1,2632,2405,227,0,469,0,6
58567,2,2452,2401,51,0,140,0,6
58568,2,2416,2393,23,0,4,0,6
58569,2,2407,2236,171,0,255,0,6
58570,1,2487,2380,107,0,453,0,6
58571,1,2486,2481,5,0,106,0,6
58572,1,2489,2607,-118,0,61,1,6
58573,1,2546,2446,100,0,461,0,6
58574,1,2413,2343,70,0,148,0,6
58575,2,2266,2438,-172,0,195,0,6
58576,2,2439,2465,-26,0,312,0,6
58577,2,2444,2381,63,0,1,0,6
58578,2,2495,2477,18,0,31,0,6
58579,1,2433,2428,5,0,487,0,6
58580,1,2349,2413,-64,0,335,0,6
58581,2,2515,2432,83,0,5,0,6
58582,2,2202,2458,-256,0,48,1,6
58583,2,2566,2666,-100,0,121,0,6
58584,1,2717,2643,74,0,246,0,6
58585,3,2697,2622,75,0,201,0,6
58586,1,2632,2360,272,0,241,0,6
58587,1,2592,2555,37,0,4,0,6
58588,2,2457,2532,-75,0,373,0,6
58589,1,2575,2427,148,0,112,0,6
58590,2,2451,2276,175,0,246,0,6
58591,3,2477,2279,198,0,121,0,6
58592,1,2347,2443,-96,0,0,1,6
58593,1,2606,2490,116,0,308,0,6
58594,1,2431,2313,118,0,170,0,6
58595,2,2372,2405,-33,0,375,0,6
58596,1,2281,2413,-132,0,115,0,6
58597,1,2545,2594,-49,0,315,0,6
58598,2,2644,2729,-85,0,130,0,6
58599,2,2480,2410,70,0,456,0,6
58600,2,2336,2489,-153,0,122,0,6
58601,1,2444,2417,27,0,410,0,6
58602,3,2291,2404,-113,0,106,0,6
58603,1,2442,2520,-78,0,212,0,6
58604,2,2689,2516,173,0,104,0,6
58605,2,2255,2519,-264,0,112,1,6
58606,3,2646,2494,152,0,47,0,6
58607,1,2737,2468,269,0,263,0,6
58608,2,2581,2585,-4,0,8,0,6
58609,1,2480,2311,169,0,335,0,6
58610,1,2560,2468,92,0,130,0,6
58611,1,2516,2521,-5,0,115,0,6
58612,2,2428,2508,-80,0,190,0,6
58613,1,2434,2455,-21,0,80,0,6
58614,2,2536,2421,115,0,101,0,6
58615,3,2371,2407,-36,0,140,0,6
58616,2,2545,2590,-45,0,61,1,6
58617,1,2520,2516,4,0,211,1,6
58618,1,2577,2393,184,0,310,0,6
58619,2,2423,2621,-198,0,71,1,6
58620,2,2453,2389,64,0,211,0,6
58621,1,2393,2403,-10,0,463,1,6
58622,2,2457,2574,-117,0,13,0,6
58623,2,2495,2622,-127,0,258,0,6
58624,1,2481,2403,78,0,245,1,6
58625,2,2504,2578,-74,0,453,0,6
58627,1,2441,2434,7,0,302,0,6
58628,2,2306,2753,-447,0,240,0,6
58629,1,2270,2562,-292,0,123,1,6
58630,2,2527,2366,161,0,8,0,6
58631,3,2620,2697,-77,0,260,0,6
58632,2,2352,2577,-225,0,48,0,6
58633,1,2492,2248,244,0,107,0,6
58634,2,2311,2428,-117,0,103,1,6
58635,2,2395,2494,-99,0,40,0,6
58636,1,2578,2244,334,0,1,0,6
58637,1,2436,2424,12,0,315,0,6
58638,1,2708,2557,151,0,46,0,6
58639,2,2399,2548,-149,0,101,0,6
58640,1,2224,2405,-181,0,341,0,6
58641,2,2726,2311,415,0,225,1,6
58642,1,2573,2434,139,0,337,0,6
58643,1,2592,2655,-63,0,112,1,6
58644,1,2540,2380,160,0,125,1,6
58645,2,2677,2493,184,0,108,0,6
58646,2,2466,2539,-73,0,45,0,6
58647,2,2475,2580,-105,0,409,0,6
58648,1,2475,2816,-341,0,106,1,6
58649,2,2374,2506,-132,0,411,0,6
58650,1,2426,2289,137,0,353,0,6
58651,1,2250,2417,-167,0,5,1,6
58652,1,2358,2427,-69,0,200,0,6
58653,2,2307,2425,-118,0,88,1,6
58654,3,2656,2806,-150,0,125,0,6
58655,1,2517,2431,86,0,108,0,6
58656,2,2268,2469,-201,0,125,0,6
58657,1,2358,2421,-63,0,369,0,6
58658,1,2512,2466,46,0,307,0,6
58659,1,2517,2355,162,0,188,1,6
58660,2,2533,2221,312,0,16,0,6
58661,1,2401,2634,-233,0,201,0,6
58662,2,2236,2406,-170,0,343,0,6
58663,2,2386,2512,-126,0,106,1,6
58664,1,2445,2360,85,0,220,0,6
58665,2,2442,2593,-151,0,115,0,6
58666,1,2620,2379,241,0,247,0,6
58667,1,2755,2719,36,0,122,1,6
58668,1,2734,2213,521,0,211,0,6
58669,1,2654,2391,263,0,46,0,6
58670,2,2299,2402,-103,0,17,0,6
58671,1,2502,2403,99,0,123,0,6
58672,3,2700,2725,-25,0,288,0,6
58673,1,2487,2208,279,0,140,0,6
58674,1,2439,2425,14,0,45,0,6
58675,3,2444,2405,39,0,288,0,3
58676,2,2344,2401,-57,0,96,1,6
58677,2,2593,2613,-20,0,302,0,6
58678,2,2537,2673,-136,0,130,0,6
58679,1,2486,2278,208,0,120,0,6
58680,2,2510,2255,255,0,0,0,6
58681,1,2480,2295,185,0,250,0,6
58682,1,2466,2467,-1,0,101,0,6
58683,3,2332,2561,-229,0,45,0,6
58684,2,2565,2687,-122,0,122,0,6
58685,2,2326,2635,-309,0,229,0,6
58686,1,2534,2277,257,0,302,0,6
58687,2,2466,2451,15,0,206,0,6
58688,2,2739,2698,41,0,281,0,6
58689,2,2358,2579,-221,0,120,0,6
58690,2,2499,2627,-128,0,484,0,6
58691,2,2362,2547,-185,0,130,0,6
58692,2,2437,2388,49,0,149,0,6
58693,1,2519,2500,19,0,106,0,6
58694,2,2433,2316,117,0,27,1,6
58695,2,2430,2368,62,0,200,0,6
58696,2,2526,2385,141,0,220,0,6
58697,1,2335,2410,-75,0,1,1,6
58698,1,2513,2681,-168,0,6,0,6
58699,1,2404,2481,-77,0,101,1,6
58700,1,2581,2565,16,0,21,0,6
58701,1,2507,2372,135,0,106,0,6
58702,2,2405,2410,-5,0,395,0,6
58703,2,2492,2560,-68,0,210,0,6
58704,1,2465,2348,117,0,492,0,6
58705,2,2600,2557,43,0,43,0,6
58706,1,2425,2599,-174,0,378,1,6
58707,2,2283,2448,-165,0,200,0,6
58708,1,2454,2305,149,0,300,0,6
58709,1,2566,2501,65,0,206,0,6
58710,2,2224,2411,-187,0,454,1,6
58711,1,2754,2569,185,0,42,0,6
58712,2,2463,2535,-72,0,241,0,6
58713,1,2513,2512,1,0,311,1,6
58714,2,2454,2401,53,0,203,0,6
58715,2,2513,2512,1,0,40,0,6
58716,2,2490,2376,114,0,106,0,6
58717,1,2483,2562,-79,0,200,0,6
58718,1,2398,2435,-37,0,45,1,6
58719,2,2490,2346,144,0,40,0,6
58720,2,2416,2399,17,0,426,1,6
58721,1,2329,2473,-144,0,381,1,6
58722,2,2550,2595,-45,0,332,0,6
58723,1,2658,2597,61,0,125,1,6
58724,2,2331,2650,-319,0,335,0,6
58725,1,2406,2417,-11,0,301,0,6
58726,2,2503,2537,-34,0,42,0,6
58727,3,2428,2275,153,0,1,0,6
58728,1,2432,2400,32,0,106,1,6
58729,1,2553,2647,-94,0,115,1,6
58730,1,2408,2445,-37,0,229,0,6
58731,1,2356,2538,-182,0,35,0,6
58732,2,2430,2464,-34,0,46,0,6
58733,2,2575,2448,127,0,1,0,6
58734,2,2356,2450,-94,0,380,0,6
58735,1,2417,2450,-33,0,426,0,6
58736,1,2591,2669,-78,0,132,0,6
58737,2,2595,2803,-208,0,395,0,6
58738,1,2474,2285,189,0,313,0,6
58739,1,2559,2343,216,0,442,0,6
58740,2,2440,2213,227,0,70,0,6
58741,2,2534,2425,109,0,373,1,6
58743,2,2413,2222,191,0,5,1,6
58744,1,2486,2508,-22,0,110,0,6
58745,1,2673,2365,308,0,4,0,6
58746,3,2420,2217,203,0,43,0,6
58747,2,2522,2610,-88,0,131,1,6
58748,2,2498,2366,132,0,58,0,6
58749,2,2230,2473,-243,0,202,0,6
58750,2,2282,2582,-300,0,278,1,6
58751,2,2410,2420,-10,0,332,0,6
58752,2,2402,2524,-122,0,35,0,6
58753,1,2487,2478,9,0,125,1,6
58754,2,2669,2580,89,0,28,1,6
58755,2,2336,2430,-94,0,200,0,6
58756,2,2544,2493,51,0,4,0,6
58757,2,2513,2520,-7,0,200,1,6
58758,3,2462,2681,-219,0,409,0,6
58759,2,2390,2624,-234,0,201,0,6
58760,1,2284,2407,-123,0,40,0,6
58761,2,2442,2372,70,0,335,0,6
58762,2,2456,2446,10,0,484,0,6
58763,2,2440,2460,-20,0,111,0,6
58764,1,2408,2326,82,0,190,0,6
58765,1,2496,2420,76,0,49,0,6
58767,1,2497,2402,95,0,303,0,6
58768,1,2433,2392,41,0,111,0,6
58769,2,2470,2434,36,0,313,1,6
58770,1,2343,2514,-171,4,130,0,13
58771,1,2448,2359,89,0,315,0,6
58772,2,2426,2506,-80,0,436,0,6
58773,2,2696,2687,9,0,269,0,6
58774,1,2690,2713,-23,0,302,0,6
58775,1,2460,2350,110,0,461,0,6
58776,1,2700,2449,251,0,196,0,6
58777,1,2540,2725,-185,0,245,0,6
58778,1,2506,2381,125,0,245,0,6
58779,1,2580,2457,123,0,330,0,6
58780,2,2329,2415,-86,0,143,0,6
58781,1,2500,2705,-205,0,344,0,6
58782,1,2656,2358,298,0,109,0,6
58783,1,2547,2604,-57,0,300,0,6
58784,1,2597,2548,49,0,46,1,6
58785,2,2786,2583,203,0,58,0,6
58786,2,2300,2578,-278,0,244,0,6
58787,1,2471,2257,214,0,406,1,6
58788,2,2459,2307,152,0,203,0,6
58789,1,2539,2508,31,0,6,1,6
58790,1,2439,2508,-69,0,210,1,8
58791,1,2483,2517,-34,0,202,0,6
58792,3,2492,2350,142,0,411,0,6
58793,2,2450,2231,219,0,311,1,6
58794,1,2461,2410,51,0,128,0,6
58795,2,2313,2422,-109,0,107,1,6
58796,3,2344,2426,-82,0,101,0,6
58797,2,2653,2581,72,0,123,0,6
58798,2,2564,2637,-73,0,152,0,6
58799,1,2656,2640,16,0,304,0,6
58800,1,2449,2439,10,0,121,0,6
58801,1,2644,2410,234,0,410,0,6
58802,2,2392,2483,-91,0,244,0,6
58803,2,2243,2555,-312,0,278,0,6
58804,2,2536,2410,126,0,5,1,6
58805,1,2554,2496,58,0,145,0,6
58806,1,2433,2490,-57,0,209,0,6
58807,1,2552,2469,83,0,112,0,6
58808,2,2372,2580,-208,0,156,0,6
58809,1,2625,2222,403,0,210,0,6
58810,1,2459,2423,36,0,200,0,6
58811,1,2513,2356,157,0,41,0,6
58812,2,2315,2404,-89,0,46,1,6
58813,2,2507,2550,-43,0,332,0,6
58814,2,2389,2495,-106,0,101,0,6
58815,1,2496,2220,276,0,123,0,6
58816,2,2402,2267,135,0,200,1,6
58817,1,2443,2203,240,0,152,0,6
58818,1,2347,2414,-67,0,118,0,6
58819,1,2399,2462,-63,0,10,1,6
58820,2,2354,2523,-169,0,395,1,6
58821,1,2414,2347,67,0,83,0,6
58822,2,2714,2696,18,0,302,1,6
58823,1,2442,2351,91,0,8,0,6
58824,2,2286,2447,-161,0,40,0,6
58825,1,2511,2330,181,0,115,0,6
58826,1,2428,2640,-212,0,440,0,6
58827,2,2760,2621,139,0,301,0,6
58828,1,2463,2399,64,0,100,1,6
58829,2,2584,2587,-3,0,125,0,6
58830,1,2651,2378,273,0,153,0,6
58831,1,2292,2430,-138,0,325,0,6
58832,1,2522,2349,173,0,145,0,6
58833,3,2231,2662,-431,0,125,0,6
58834,2,2400,2523,-123,0,305,0,6
58835,2,2561,2440,121,0,286,0,6
58836,1,2559,2471,88,0,196,0,6
58837,2,2588,2526,62,0,45,0,6
58838,1,2407,2365,42,0,201,1,6
58839,3,2375,2441,-66,0,487,0,6
58840,1,2463,2412,51,0,131,0,6
58841,2,2638,2472,166,0,43,1,6
58842,1,2722,2325,397,0,104,0,6
58843,1,2477,2500,-23,0,302,0,6
58844,2,2390,2568,-178,0,106,1,6
58845,2,2418,2449,-31,0,6,0,6
58846,2,2733,2598,135,0,243,0,6
58847,1,2461,2388,73,0,110,0,6
58848,3,2390,2637,-247,0,122,0,6
58849,1,2627,2639,-12,0,462,0,6
58850,2,2264,2491,-227,0,114,1,6
58851,1,2369,2488,-119,0,110,0,6
58852,1,2442,2289,153,0,40,1,6
58853,2,2376,2411,-35,0,7,0,6
58854,2,2412,2391,21,0,40,0,6
58855,2,2322,2578,-256,0,211,0,6
58856,2,2322,2413,-91,0,454,0,6
58857,2,2338,2425,-87,0,241,0,8
58858,2,2272,2426,-154,0,202,1,6
58859,1,2296,2408,-112,0,45,0,6
58860,1,2406,2380,26,0,312,0,8
58861,1,2564,2537,27,0,453,1,6
58862,1,2803,2561,242,0,4,0,6
58863,1,2419,2491,-72,0,191,0,6
58864,2,2444,2518,-74,0,106,1,6
58865,2,2692,2712,-20,0,122,0,6
58866,1,2489,2423,66,0,255,0,6
58867,1,2600,2529,71,0,15,1,6
58868,3,2487,2622,-135,0,148,0,6
58869,1,2600,2497,103,0,190,0,6
58870,2,2542,2545,-3,0,152,0,6
58871,3,2383,2505,-122,0,302,0,6
58872,1,2402,2267,135,0,357,0,6
58873,1,2600,2516,84,0,301,0,6
58874,1,2486,2351,135,0,154,0,6
58875,2,2449,2370,79,0,15,0,6
58876,1,2399,2591,-192,0,244,0,6
58877,1,2717,2454,263,0,218,0,6
58878,1,2427,2253,174,0,150,1,6
58879,1,2277,2477,-200,0,400,0,6
58880,2,2548,2675,-127,0,115,0,6
58881,1,2457,2442,15,0,147,0,6
58882,1,2400,2482,-82,0,5,0,6
58883,1,2550,2521,29,0,302,0,6
58884,2,2324,2593,-269,0,106,0,6
58885,1,2806,2723,83,0,248,0,6
58886,2,2593,2433,160,0,300,0,6
58887,2,2397,2438,-41,0,104,1,6
58888,1,2410,2286,124,0,373,0,6
58889,2,2452,2583,-131,0,189,0,6
58890,2,2200,2459,-259,0,304,0,6
58891,2,2462,2562,-100,0,16,0,6
58892,1,2697,2225,472,0,211,1,6
58893,1,2523,2563,-40,0,225,0,6
58894,2,2347,2412,-65,0,112,0,6
58895,2,2246,2494,-248,0,33,1,6
58896,2,2539,2662,-123,0,41,0,6
58897,2,2368,2494,-126,0,40,0,6
58898,2,2321,2496,-175,0,13,0,6
58899,2,2558,2418,140,0,207,0,6
58900,1,2671,2402,269,0,40,0,6
58901,3,2340,2544,-204,0,140,0,6
58902,1,2401,2521,-120,0,152,1,6
58903,1,2428,2320,108,0,202,0,6
58904,1,2533,2431,102,0,253,0,6
58905,1,2678,2464,214,0,46,0,6
58906,1,2426,2509,-83,0,418,0,6
58907,2,2407,2380,27,0,100,0,6
58908,1,2592,2570,22,0,200,0,6
58909,2,2397,2734,-337,0,200,0,6
58910,2,2494,2733,-239,0,391,0,6
58911,2,2516,2776,-260,0,474,0,6
58912,2,2213,2453,-240,0,0,1,6
58913,2,2416,2482,-66,0,253,1,6
58914,1,2619,2588,31,0,405,0,6
58915,1,2398,2501,-103,0,45,0,6
58916,1,2518,2490,28,0,100,0,6
58917,2,2352,2520,-168,0,199,0,6
58918,1,2657,2695,-38,0,338,0,6
58919,2,2582,2273,309,0,133,0,6
58920,1,2439,2407,32,0,152,0,6
58921,1,2348,2414,-66,0,70,0,6
58922,1,2476,2280,196,0,106,0,6
58923,1,2435,2402,33,0,110,0,6
58924,1,2487,2465,22,0,250,0,6
58925,2,2236,2489,-253,0,110,1,6
58926,3,2635,2735,-100,0,381,0,6
58927,2,2491,2690,-199,0,0,0,6
58928,1,2704,2661,43,0,400,0,6
58929,1,2678,2231,447,0,112,0,6
58930,1,2232,2483,-251,0,338,0,6
58931,2,2354,2415,-61,0,476,0,6
58932,1,2643,2492,151,0,101,0,6
58933,1,2499,2559,-60,0,324,0,6
58934,1,2389,2638,-249,0,4,0,6
58935,2,2259,2511,-252,0,207,0,6
58936,1,2554,2422,132,0,45,0,6
58937,2,2516,2382,134,0,1,0,6
58938,2,2453,2388,65,0,130,1,6
58939,1,2502,2385,117,0,125,0,6
58940,2,2407,2393,14,0,143,0,6
58941,1,2510,2584,-74,0,123,1,6
58942,2,2597,2354,243,0,15,0,6
58943,2,2395,2497,-102,0,194,0,6
58944,1,2315,2451,-136,0,122,0,6
58945,2,2309,2456,-147,0,106,0,6
58946,2,2315,2448,-133,4,131,0,13
58947,2,2314,2498,-184,0,345,1,6
58948,1,2566,2466,100,0,40,0,6
58949,3,2615,2759,-144,0,240,0,6
58950,1,2530,2440,90,0,302,0,6
58951,2,2308,2456,-148,0,256,0,6
58952,1,2325,2578,-253,0,140,0,6
58953,1,2383,2517,-134,0,41,0,6
58954,2,2426,2538,-112,0,7,0,6
58955,2,2522,2378,144,0,90,0,6
58956,2,2425,2440,-15,0,1,0,6
58957,2,2417,2450,-33,0,106,0,6
58958,1,2379,2417,-38,0,201,0,6
58959,2,2279,2400,-121,0,315,0,6
58960,1,2566,2557,9,0,56,0,6
58961,2,2545,2511,34,0,405,0,6
58962,1,2406,2378,28,0,84,0,6
58963,1,2464,2342,122,0,40,0,6
58964,2,2250,2417,-167,0,120,0,8
58965,2,2484,2442,42,0,128,0,6
58966,1,2702,2595,107,0,41,0,6
58967,2,2387,2406,-19,0,200,0,6
58968,1,2445,2217,228,0,260,1,6
58969,2,2397,2489,-92,0,190,0,6
58970,2,2381,2411,-30,0,400,1,6
58971,1,2620,2426,194,0,304,0,6
58972,2,2579,2217,362,0,410,1,6
58973,1,2474,2475,-1,0,45,0,6
58974,1,2708,2322,386,0,46,0,6
58975,2,2514,2382,132,0,456,0,6
58976,1,2441,2703,-262,0,344,0,6
58977,2,2419,2506,-87,0,172,1,6
58978,1,2472,2585,-113,0,200,0,6
58979,1,2375,2511,-136,0,117,0,6
58980,2,2465,2581,-116,0,100,0,6
58981,1,2401,2346,55,0,145,1,6
58982,1,2692,2288,404,0,300,0,6
58983,2,2419,2507,-88,0,57,0,6
58984,2,2377,2448,-71,0,215,1,6
58985,2,2283,2518,-235,0,300,0,6
58986,2,2526,2527,-1,0,8,0,6
58987,2,2418,2396,22,0,107,0,6
58988,3,2493,2592,-99,0,103,0,6
58989,2,2386,2418,-32,0,394,0,6
58990,2,2630,2604,26,0,302,0,6
58991,2,2448,2806,-358,0,106,0,6
58992,1,2433,2553,-120,0,46,0,6
58993,1,2631,2336,295,0,333,0,6
58994,2,2559,2573,-14,0,244,0,6
58995,2,2480,2663,-183,0,190,0,6
58996,1,2455,2493,-38,0,100,1,6
58997,1,2586,2564,22,0,1,0,6
58998,1,2464,2441,23,0,45,1,6
58999,1,2465,2558,-93,0,56,0,6
59000,1,2556,2580,-24,0,200,0,6
59001,1,2516,2320,196,0,45,0,6
59002,2,2327,2492,-165,0,404,0,6
59004,1,2407,2467,-60,0,45,0,6
59005,1,2346,2437,-91,0,102,0,6
59006,3,2447,2571,-124,0,106,0,6
59007,2,2290,2439,-149,0,117,0,6
59008,3,2414,2512,-98,0,45,0,6
59009,2,2277,2400,-123,0,210,0,8
59010,1,2666,2609,57,0,13,0,6
59011,1,2408,2483,-75,0,143,0,6
59012,2,2492,2494,-2,0,4,1,6
59013,1,2473,2362,111,0,61,0,6
59014,2,2555,2453,102,0,375,0,6
59015,2,2355,2406,-51,0,335,0,6
59016,1,2528,2578,-50,0,100,0,6
59017,2,2580,2470,110,0,42,0,6
59018,1,2629,2514,115,0,455,0,6
59019,1,2593,2673,-80,0,310,0,6
59020,2,2455,2529,-74,0,45,1,6
59021,1,2779,2752,27,0,10,0,6
59022,2,2383,2574,-191,0,414,0,6
59023,2,2404,2410,-6,0,300,1,6
59024,1,2278,2446,-168,0,0,0,6
59025,1,2417,2417,0,0,43,0,6
59026,2,2588,2693,-105,0,310,1,6
59027,1,2510,2350,160,0,7,0,6
59028,1,2408,2275,133,0,250,1,6
59029,2,2422,2515,-93,0,28,0,6
59030,1,2426,2381,45,0,156,0,6
59031,1,2411,2662,-251,0,34,1,6
59032,1,2278,2474,-196,0,120,0,6
59033,2,2454,2550,-96,0,33,0,6
59034,1,2381,2664,-283,0,113,0,6
59035,1,2502,2390,112,0,344,0,6
59036,1,2433,2487,-54,0,61,0,6
59037,2,2206,2584,-378,0,1,0,6
59038,2,2363,2413,-50,0,302,0,6
59039,2,2547,2526,21,0,302,0,6
59040,1,2506,2300,206,0,247,0,6
59041,3,2433,2559,-126,0,426,0,6
59042,1,2462,2403,59,0,153,1,6
59043,2,2327,2486,-159,0,242,0,6
59044,2,2444,2323,121,0,107,0,6
59045,2,2440,2464,-24,0,301,0,6
59046,1,2546,2540,6,0,6,1,6
59047,3,2503,2524,-21,0,112,0,6
59048,2,2342,2463,-121,0,89,0,6
59049,1,2583,2624,-41,0,352,0,6
59050,1,2602,2375,227,0,15,0,6
59051,2,2656,2682,-26,0,304,0,6
59052,2,2356,2411,-55,0,7,0,6
59053,1,2404,2444,-40,0,404,0,6
59054,1,2414,2288,126,0,14,0,6
59055,2,2484,2371,113,0,277,1,6
59056,1,2230,2542,-312,0,305,0,6
59057,3,2653,2440,213,0,153,0,6
59058,2,2391,2709,-318,0,45,0,6
59059,1,2279,2507,-228,0,454,0,6
59060,1,2633,2422,211,0,455,0,6
59061,1,2456,2542,-86,0,48,0,6
59062,2,2201,2416,-215,0,15,1,6
59063,1,2283,2446,-163,0,301,0,6
59064,1,2402,2394,8,0,211,1,6
59065,1,2679,2510,169,0,218,0,6
59066,2,2394,2696,-302,0,245,0,6
59067,2,2479,2466,13,0,40,0,6
59068,1,2316,2441,-125,0,0,0,6
59069,2,2364,2405,-41,0,304,0,6
59070,1,2341,2523,-182,0,101,0,6
59071,2,2469,2377,92,0,46,0,6
59072,2,2384,2443,-59,0,300,0,6
59073,2,2588,2607,-19,0,325,0,6
59074,2,2395,2525,-130,0,0,1,6
59075,3,2452,2447,5,0,268,0,6
59076,1,2627,2329,298,0,1,0,6
59077,1,2808,2719,89,0,5,1,6
59078,1,2479,2272,207,0,101,1,6
59079,1,2536,2506,30,0,8,1,6
59080,2,2687,2725,-38,0,302,0,6
59081,1,2462,2646,-184,0,110,0,6
59082,1,2407,2343,64,0,172,0,6
59083,2,2550,2553,-3,0,4,0,6
59084,2,2374,2611,-237,0,150,1,6
59085,1,2663,2646,17,0,404,0,6
59086,1,2276,2419,-143,0,46,0,6
59087,2,2420,2350,70,0,107,1,6
59088,1,2706,2709,-3,0,300,0,6
59089,1,2402,2278,124,0,0,0,6
59090,2,2474,2501,-27,0,113,0,6
59091,2,2572,2462,110,0,394,0,6
59092,2,2591,2633,-42,0,394,0,6
59093,3,2506,2545,-39,0,156,0,6
59094,2,2386,2678,-292,0,112,0,6
59095,1,2551,2537,14,0,122,0,6
59096,1,2320,2633,-313,0,0,0,6
59097,3,2427,2407,20,0,487,0,6
59098,1,2440,2301,139,0,199,0,6
59099,2,2440,2376,64,0,464,0,6
59100,1,2440,2360,80,0,484,0,6
59101,1,2375,2439,-64,0,211,0,6
59102,1,2327,2425,-98,0,123,0,6
59103,1,2689,2451,238,0,127,0,6
59104,1,2494,2698,-204,0,344,0,6
59105,1,2445,2334,111,0,45,1,6
59106,2,2462,2624,-162,0,0,0,6
59107,1,2610,2651,-41,0,200,0,6
59108,1,2461,2262,199,0,331,1,6
59109,2,2509,2384,125,0,307,0,6
59110,2,2224,2570,-346,0,301,0,6
59111,1,2489,2693,-204,0,120,1,6
59112,2,2374,2531,-157,0,40,0,6
59113,1,2436,2228,208,0,438,0,6
59114,2,2280,2401,-121,0,111,0,6
59115,2,2570,2592,-22,0,43,0,6
59116,2,2289,2436,-147,0,320,0,6
59117,1,2556,2529,27,0,302,0,6
59118,2,2442,2375,67,0,337,0,6
59119,1,2305,2422,-117,0,36,1,6
59120,2,2330,2431,-101,0,256,0,6
59121,3,2403,2685,-282,0,40,0,6
59122,2,2514,2445,69,0,4,0,6
59123,1,2478,2414,64,0,335,0,6
59124,1,2609,2412,197,0,18,0,6
59125,2,2591,2755,-164,0,7,0,6
59126,2,2423,2409,14,0,106,0,6
59127,1,2494,2486,8,0,133,0,6
59128,1,2553,2623,-70,0,102,0,6
59129,2,2460,2578,-118,0,43,0,6
59130,1,2633,2440,193,0,7,0,6
59131,1,2513,2497,16,0,40,0,6
59132,1,2524,2419,105,0,101,0,6
59133,1,2648,2617,31,0,211,0,6
59134,3,2418,2335,83,0,4,0,6
59135,3,2363,2439,-76,0,120,0,6
59136,2,2461,2461,0,0,122,0,6
59137,3,2494,2405,89,0,303,0,6
59138,1,2523,2348,175,0,188,0,6
59139,2,2496,2244,252,0,231,0,6
59140,2,2453,2346,107,0,176,0,6
59141,1,2535,2391,144,0,1,0,6
59142,1,2486,2492,-6,0,245,0,6
59143,1,2623,2631,-8,0,131,0,6
59144,2,2290,2451,-161,0,101,0,6
59145,2,2390,2534,-144,0,122,0,6
59146,2,2531,2519,12,0,302,0,6
59147,1,2317,2508,-191,0,106,1,6
59148,1,2736,2269,467,0,218,0,6
59149,1,2719,2785,-66,0,150,0,6
59150,2,2510,2545,-35,0,20,1,6
59151,1,2666,2810,-144,0,123,0,6
59153,1,2476,2289,187,0,45,1,6
59154,1,2415,2513,-98,0,214,1,6
59155,1,2533,2386,147,0,4,0,6
59156,2,2558,2746,-188,0,103,1,6
59157,1,2436,2404,32,0,143,1,6
59158,1,2494,2372,122,0,194,0,6
59159,2,2226,2430,-204,0,231,0,6
59160,2,2297,2432,-135,0,127,0,6
59161,1,2438,2318,120,0,14,0,6
59162,2,2411,2240,171,0,385,0,6
59163,3,2533,2232,301,4,240,0,13
59164,1,2419,2385,34,0,394,0,6
59165,1,2415,2359,56,0,130,0,6
59166,1,2286,2411,-125,0,331,0,8
59167,1,2416,2435,-19,0,260,0,6
59168,1,2733,2458,275,0,101,0,6
59169,2,2456,2235,221,0,343,0,6
59170,1,2557,2302,255,0,331,0,6
59171,2,2638,2351,287,0,127,0,6
59172,2,2333,2519,-186,0,40,1,6
59173,1,2565,2636,-71,0,207,0,6
59174,2,2368,2470,-102,0,133,0,6
59175,1,2627,2597,30,0,454,0,6
59176,1,2281,2513,-232,0,225,0,6
59177,1,2485,2211,274,0,308,1,6
59178,1,2414,2378,36,0,325,1,6
59179,2,2359,2411,-52,0,46,0,6
59180,2,2572,2233,339,0,0,0,6
59181,2,2371,2480,-109,0,302,0,6
59182,1,2666,2390,276,0,40,0,6
59183,2,2377,2425,-48,0,106,0,6
59184,2,2411,2541,-130,0,43,0,6
59185,3,2711,2600,111,0,453,0,6
59186,2,2535,2487,48,0,40,1,6
59187,2,2401,2358,43,0,106,1,6
59188,2,2491,2535,-44,0,247,1,6
59189,1,2496,2532,-36,0,125,0,6
59190,1,2466,2417,49,0,4,0,6
59191,1,2294,2461,-167,0,115,0,6
59192,2,2347,2418,-71,0,140,0,6
59193,2,2342,2693,-351,0,331,0,6
59194,1,2411,2273,138,0,311,0,6
59195,3,2519,2574,-55,0,46,0,6
59196,2,2578,2469,109,0,22,0,6
59197,1,2438,2339,99,0,43,0,6
59198,1,2517,2539,-22,0,310,0,6
59199,1,2680,2542,138,0,373,1,6
59200,1,2395,2419,-24,0,474,1,6
59201,1,2372,2486,-114,0,122,0,6
59202,2,2304,2620,-316,0,46,0,6
59203,1,2446,2353,93,0,100,0,6
59204,2,2501,2449,52,0,313,1,6
59205,2,2533,2401,132,0,36,0,6
59206,2,2430,2337,93,0,456,0,6
59207,1,2500,2520,-20,0,0,0,6
59208,2,2585,2363,222,0,111,0,6
59209,3,2507,2563,-56,0,244,0,6
59210,2,2577,2407,170,0,311,0,6
59211,3,2569,2509,60,0,8,0,6
59212,1,2437,2490,-53,0,150,0,6
59213,1,2331,2515,-184,0,122,0,6
59214,2,2417,2255,162,0,102,0,6
59215,1,2503,2383,120,0,46,1,6
59216,1,2473,2359,114,0,402,0,6
59217,3,2501,2311,190,0,123,0,6
59218,2,2330,2583,-253,0,123,0,6
59219,1,2731,2420,311,0,202,0,6
59220,1,2612,2712,-100,0,260,0,6
59221,2,2446,2498,-52,0,198,0,6
59222,1,2551,2222,329,0,45,0,6
59223,1,2474,2484,-10,0,200,0,6
59224,1,2478,2382,96,0,163,0,6
59225,2,2571,2472,99,0,310,0,6
59226,1,2703,2813,-110,0,48,0,6
59227,2,2452,2605,-153,0,268,0,6
59228,2,2354,2517,-163,0,432,0,6
59229,2,2574,2449,125,0,18,0,6
59230,3,2409,2715,-306,0,45,0,6
59231,1,2512,2228,284,0,121,0,6
59232,1,2447,2364,83,0,190,0,6
59233,1,2624,2681,-57,0,282,0,6
59234,2,2227,2403,-176,0,247,0,6
59235,1,2402,2317,85,0,0,0,6
59236,1,2501,2375,126,0,416,0,8
59237,1,2433,2223,210,0,108,0,6
59238,1,2431,2633,-202,0,405,0,6
59239,2,2214,2429,-215,0,315,0,6
59240,1,2416,2456,-40,0,123,0,6
59241,3,2511,2448,63,0,192,0,6
59242,1,2477,2374,103,0,40,0,6
59243,3,2280,2412,-132,0,45,0,6
59244,1,2582,2653,-71,0,112,0,6
59245,3,2597,2645,-48,0,145,0,6
59246,2,2373,2415,-42,0,320,0,6
59247,2,2612,2565,47,0,108,0,6
59249,1,2521,2381,140,0,57,0,6
59250,1,2558,2431,127,0,202,0,6
59251,3,2300,2629,-329,0,121,0,6
59252,2,2423,2559,-136,0,115,0,6
59253,1,2338,2405,-67,0,1,0,6
59254,1,2650,2671,-21,0,241,0,6
59255,2,2394,2415,-21,4,404,0,13
59256,1,2420,2247,173,0,112,0,8
59257,2,2511,2472,39,0,347,0,6
59258,2,2484,2470,14,0,300,0,6
59259,2,2391,2418,-27,0,0,1,6
59260,1,2554,2441,113,0,176,0,6
59261,2,2435,2367,68,0,15,0,6
59262,2,2450,2382,68,0,466,0,6
59263,2,2735,2692,43,0,131,1,6
59264,1,2521,2423,98,0,200,0,6
59265,1,2449,2476,-27,0,87,0,6
59266,1,2719,2456,263,0,40,0,6
59267,1,2450,2291,159,0,302,0,6
59268,1,2546,2737,-191,0,205,1,6
59269,2,2293,2502,-209,0,245,1,6
59270,1,2450,2393,57,0,242,1,6
59271,2,2529,2614,-85,0,115,0,6
59272,1,2600,2532,68,0,301,0,6
59273,2,2490,2324,166,0,31,1,6
59274,1,2411,2416,-5,0,130,0,6
59275,1,2391,2560,-169,0,145,0,6
59276,1,2629,2480,149,0,200,0,6
59277,2,2460,2417,43,0,315,0,6
59278,1,2698,2506,192,0,46,0,6
59280,1,2802,2592,210,0,57,0,6
59281,1,2420,2415,5,0,4,0,6
59282,3,2633,2674,-41,0,46,0,6
59283,1,2681,2557,124,0,122,0,6
59284,2,2231,2573,-342,0,222,1,6
59285,3,2532,2616,-84,0,148,0,6
59286,1,2544,2630,-86,0,167,0,6
59287,2,2448,2707,-259,0,45,0,6
59288,1,2438,2407,31,0,141,0,6
59289,1,2487,2215,272,0,115,0,6
59290,2,2512,2554,-42,0,101,1,6
59291,1,2307,2438,-131,0,4,0,6
59292,1,2418,2439,-21,0,127,1,8
59293,1,2469,2435,34,0,242,1,6
59294,1,2506,2503,3,0,277,0,6
59295,2,2697,2669,28,0,130,0,6
59296,1,2641,2422,219,0,123,0,6
59297,2,2550,2556,-6,0,302,0,6
59298,1,2498,2505,-7,0,120,1,6
59299,1,2638,2572,66,0,6,0,6
59300,1,2412,2273,139,0,130,0,6
59301,2,2405,2468,-63,0,193,1,6
59302,1,2507,2269,238,0,40,1,6
59303,2,2452,2482,-30,0,411,0,6
59304,2,2507,2444,63,0,15,1,6
59305,1,2350,2482,-132,0,36,0,6
59306,2,2506,2359,147,0,7,0,6
59307,1,2685,2411,274,0,217,0,6
59308,1,2749,2585,164,0,40,1,6
59309,2,2363,2435,-72,0,123,0,6
59310,1,2424,2411,13,0,201,0,6
59311,2,2253,2452,-199,4,133,0,13
59312,3,2438,2371,67,0,61,0,6
59313,1,2442,2399,43,0,118,0,6
59314,1,2429,2416,13,0,300,0,6
59315,3,2313,2414,-101,0,45,0,6
59316,2,2415,2442,-27,0,1,0,6
59317,1,2525,2408,117,0,25,0,6
59318,1,2429,2636,-207,0,398,0,6
59319,2,2502,2587,-85,0,354,0,6
59320,2,2465,2476,-11,0,487,0,6
59321,2,2533,2545,-12,0,343,0,6
59322,2,2388,2650,-262,0,255,0,6
59323,2,2484,2682,-198,0,258,0,6
59324,2,2689,2387,302,0,148,0,6
59325,1,2760,2510,250,0,246,0,6
59326,1,2538,2568,-30,0,456,1,6
59327,1,2547,2276,271,0,300,0,6
59328,3,2409,2506,-97,0,22,0,6
59329,2,2439,2474,-35,0,106,0,6
59330,1,2390,2407,-17,0,200,0,6
59331,2,2433,2420,13,0,330,0,6
59332,1,2345,2527,-182,0,199,0,6
59333,2,2479,2334,145,0,200,0,6
59334,2,2413,2383,30,0,455,1,6
59335,1,2504,2524,-20,0,310,1,6
59336,1,2585,2633,-48,0,310,0,6
59337,1,2615,2329,286,0,484,0,6
59338,2,2342,2528,-186,0,58,1,6
59339,1,2454,2443,11,0,80,0,6
59340,1,2514,2449,65,0,4,0,6
59341,1,2477,2455,22,0,106,0,6
59342,1,2710,2422,288,0,190,0,6
59343,2,2414,2537,-123,0,211,0,6
59344,1,2468,2328,140,0,0,0,6
59345,2,2503,2608,-105,0,253,0,6
59346,1,2417,2258,159,0,4,0,6
59347,1,2566,2570,-4,0,49,0,6
59348,2,2339,2498,-159,0,22,0,6
59349,1,2205,2436,-231,0,128,1,6
59350,2,2463,2551,-88,0,41,0,6
59351,2,2377,2552,-175,0,102,0,6
59352,3,2259,2562,-303,0,245,0,6
59353,1,2419,2476,-57,0,461,0,6
59354,3,2647,2564,83,0,278,0,6
59356,2,2623,2668,-45,0,129,0,6
59357,2,2553,2479,74,0,130,0,6
59358,1,2625,2220,405,0,46,1,6
59359,3,2369,2508,-139,0,204,0,6
59360,1,2620,2584,36,0,190,0,6
59361,1,2562,2304,258,0,0,0,6
59362,2,2704,2732,-28,0,426,0,6
59364,2,2441,2368,73,0,317,0,6
59365,1,2500,2477,23,0,101,0,6
59366,2,2340,2426,-86,0,396,0,6
59367,3,2245,2447,-202,0,457,0,6
59368,1,2525,2209,316,0,45,0,6
59369,1,2500,2368,132,0,1,0,6
59370,2,2470,2685,-215,0,1,0,6
59371,2,2326,2524,-198,0,129,0,6
59372,1,2423,2397,26,0,6,0,6
59373,2,2624,2206,418,0,57,0,6
59374,1,2668,2410,258,0,101,0,6
59375,1,2524,2562,-38,0,120,0,6
59376,2,2382,2416,-34,0,140,0,6
59377,3,2457,2351,106,0,104,0,8
59378,2,2456,2416,40,0,122,1,6
59379,1,2467,2343,124,0,315,0,6
59380,1,2435,2261,174,0,253,0,6
59381,1,2403,2404,-1,0,225,0,6
59382,3,2652,2552,100,0,140,0,6
59383,2,2465,2449,16,0,344,1,6
59384,3,2568,2386,182,0,338,0,6
59385,1,2455,2562,-107,0,196,0,6
59386,1,2422,2538,-116,0,31,0,6
59387,1,2563,2495,68,0,400,1,6
59388,2,2589,2725,-136,0,250,0,6
59389,2,2644,2636,8,0,49,0,6
59390,2,2419,2451,-32,0,190,0,6
59391,2,2571,2711,-140,0,154,0,6
59392,2,2433,2392,41,0,170,0,6
59393,1,2804,2538,266,0,101,0,6
59394,2,2437,2605,-168,0,0,0,6
59395,2,2270,2428,-158,0,45,0,6
59396,2,2777,2684,93,0,13,0,6
59397,1,2436,2283,153,0,184,0,6
59398,2,2300,2422,-122,0,103,1,6
59399,1,2428,2416,12,0,206,0,6
59400,1,2494,2360,134,0,110,0,6
59401,2,2377,2415,-38,0,140,0,6
59402,2,2412,2468,-56,0,57,0,6
59403,2,2275,2489,-214,0,113,0,6
59404,1,2644,2506,138,0,123,0,6
59405,3,2478,2451,27,0,125,0,6
59406,2,2522,2373,149,0,301,0,6
59407,1,2487,2425,62,0,192,0,6
59408,2,2364,2461,-97,0,404,1,6
59409,1,2472,2544,-72,0,101,0,6
59410,1,2409,2371,38,0,100,0,6
59411,2,2598,2805,-207,0,148,0,6
59412,1,2521,2589,-68,0,0,0,6
59413,2,2561,2675,-114,0,130,0,6
59414,1,2419,2351,68,0,107,0,6
59415,1,2402,2380,22,0,4,0,6
59416,2,2375,2521,-146,0,102,1,6
59417,2,2406,2492,-86,0,45,0,6
59418,1,2421,2404,17,0,43,0,6
59419,1,2417,2305,112,0,335,0,6
59420,2,2413,2466,-53,0,84,0,6
59421,1,2476,2358,118,0,112,1,6
59422,2,2325,2691,-366,0,225,0,6
59423,1,2555,2473,82,0,45,0,6
59424,3,2646,2487,159,0,45,0,6
59425,1,2388,2416,-28,0,152,1,6
59426,2,2457,2372,85,0,117,0,6
59427,2,2441,2628,-187,0,190,0,6
59428,1,2447,2300,147,0,123,0,6
59429,1,2430,2327,103,0,45,0,6
59430,2,2410,2709,-299,0,10,0,6
59431,1,2502,2481,21,0,146,0,6
59432,2,2326,2446,-120,0,253,0,6
59433,2,2505,2601,-96,0,0,0,6
59434,1,2400,2272,128,0,265,0,6
59435,2,2364,2425,-61,0,200,0,6
59436,1,2469,2444,25,0,103,0,6
59437,3,2248,2401,-153,0,0,0,6
59438,1,2526,2410,116,0,30,0,6
59439,1,2685,2519,166,0,141,0,6
59440,1,2468,2283,185,0,133,1,6
59441,1,2406,2430,-24,0,41,0,6
59442,2,2407,2397,10,0,352,0,6
59443,2,2480,2544,-64,0,375,0,6
59444,1,2575,2258,317,0,180,0,6
59445,1,2454,2508,-54,0,229,0,6
59446,1,2225,2613,-388,0,405,0,6
59447,2,2401,2482,-81,0,454,0,6
59448,1,2626,2287,339,0,142,0,6
59449,2,2540,2434,106,0,116,0,6
59450,1,2437,2624,-187,0,41,1,6
59451,1,2443,2303,140,0,310,0,6
59452,1,2642,2753,-111,0,4,1,6
59453,1,2582,2638,-56,0,337,0,6
59454,3,2701,2721,-20,0,49,0,6
59455,1,2453,2558,-105,0,112,0,6
59457,1,2423,2304,119,0,331,0,6
59458,1,2679,2492,187,0,106,1,6
59459,1,2486,2504,-18,0,101,0,6
59460,3,2562,2564,-2,0,7,0,6
59461,1,2404,2386,18,0,100,1,6
59462,2,2609,2763,-154,0,206,1,6
59463,1,2407,2217,190,0,27,0,6
59464,3,2507,2477,30,0,406,0,6
59465,2,2528,2609,-81,0,0,0,6
59466,2,2466,2519,-53,0,10,0,6
59467,1,2371,2404,-33,0,244,1,8
59468,1,2527,2478,49,0,400,0,6
59469,2,2323,2453,-130,0,221,0,6
59470,2,2529,2410,119,0,331,0,6
59471,2,2451,2358,93,0,145,1,6
59472,1,2693,2673,20,0,129,0,6
59473,1,2388,2497,-109,0,60,0,6
59474,1,2618,2323,295,0,102,0,6
59476,1,2670,2358,312,0,218,1,6
59477,2,2541,2507,34,0,7,0,6
59478,2,2407,2287,120,0,469,1,6
59479,1,2404,2476,-72,0,145,1,6
59480,1,2418,2263,155,0,309,0,6
59481,2,2244,2423,-179,0,250,0,8
59482,2,2592,2625,-33,0,302,0,6
59483,2,2579,2557,22,0,43,0,6
59484,1,2536,2322,214,0,4,0,6
59485,3,2423,2446,-23,0,250,0,6
59486,2,2687,2620,67,0,194,0,6
59487,2,2306,2407,-101,0,301,0,6
59488,2,2410,2476,-66,0,242,0,6
59489,1,2807,2479,328,0,454,0,6
59490,3,2418,2421,-3,0,125,0,6
59491,1,2710,2375,335,0,1,1,6
59492,1,2432,2454,-22,0,371,0,6
59493,1,2537,2712,-175,0,255,0,6
59494,1,2478,2403,75,0,45,0,6
59495,1,2626,2586,40,0,56,0,6
59496,2,2465,2489,-24,0,397,0,6
59497,2,2345,2482,-137,0,1,1,6
59498,2,2275,2421,-146,0,0,0,6
59499,2,2342,2401,-59,0,406,0,6
59500,3,2642,2617,25,0,13,0,6
59501,1,2567,2595,-28,0,130,0,6
59502,1,2556,2425,131,0,210,0,6
59503,2,2558,2525,33,0,150,1,6
59504,3,2433,2414,19,0,253,0,6
59505,1,2654,2808,-154,0,408,0,6
59506,2,2392,2482,-90,0,112,1,6
59507,2,2206,2449,-243,0,48,0,6
59508,1,2287,2510,-223,0,300,0,6
59509,1,2549,2335,214,0,303,0,6
59510,1,2546,2371,175,0,202,0,6
59511,2,2486,2626,-140,0,50,0,6
59512,1,2688,2527,161,0,241,1,6
59513,2,2457,2459,-2,0,106,0,6
59514,2,2401,2397,4,0,41,0,6
59515,1,2302,2467,-165,0,145,0,6
59516,2,2409,2622,-213,0,404,0,6
59517,1,2369,2481,-112,0,302,0,6
59518,3,2367,2443,-76,0,335,0,6
59519,1,2465,2408,57,0,374,0,6
59521,2,2263,2504,-241,0,106,1,6
59522,2,2332,2420,-88,0,105,1,6
59523,1,2234,2409,-175,0,46,0,6
59524,1,2505,2403,102,0,416,0,8
59525,2,2439,2359,80,0,20,0,6
59526,1,2498,2512,-14,0,133,0,6
59527,2,2506,2565,-59,0,126,0,6
59528,1,2615,2389,226,0,304,0,6
59529,2,2444,2728,-284,0,459,0,6
59530,1,2355,2651,-296,0,302,0,6
59531,1,2502,2539,-37,0,42,0,6
59532,2,2674,2699,-25,0,250,0,6
59533,1,2533,2554,-21,0,130,1,6
59534,1,2574,2504,70,0,190,0,6
59535,2,2319,2449,-130,0,106,0,6
59536,3,2473,2248,225,0,134,0,6
59537,2,2738,2633,105,0,280,0,6
59538,1,2379,2498,-119,0,106,0,6
59539,1,2346,2460,-114,0,10,0,6
59540,1,2554,2421,133,0,122,0,6
59541,1,2482,2647,-165,0,110,0,6
59542,1,2592,2424,168,0,16,0,6
59543,1,2285,2400,-115,0,112,0,6
59544,1,2491,2564,-73,0,100,1,6
59545,1,2427,2342,85,0,300,0,6
59546,2,2489,2333,156,0,202,0,6
59547,1,2565,2560,5,0,101,0,6
59548,1,2533,2523,10,0,405,0,6
59549,1,2430,2315,115,0,111,0,6
59550,2,2444,2507,-63,0,200,1,6
59551,2,2497,2402,95,0,45,1,6
59552,2,2396,2572,-176,0,40,0,6
59553,1,2550,2336,214,0,113,1,6
59554,2,2468,2729,-261,0,40,0,6
59555,2,2463,2560,-97,0,101,1,6
59556,2,2700,2589,111,0,106,0,6
59557,1,2531,2380,151,0,121,0,6
59558,2,2428,2524,-96,0,6,0,6
59559,1,2554,2680,-126,0,196,1,6
59560,1,2266,2467,-201,0,167,0,6
59561,1,2667,2432,235,0,140,0,6
59562,2,2632,2809,-177,0,40,0,6
59563,1,2627,2477,150,0,263,0,6
59564,1,2430,2475,-45,0,301,0,6
59565,2,2483,2496,-13,0,4,0,6
59566,2,2398,2542,-144,0,140,0,6
59567,1,2518,2354,164,0,133,0,6
59568,2,2398,2420,-22,0,40,0,6
59569,3,2489,2371,118,0,484,0,6
59570,2,2394,2408,-14,0,45,0,6
59571,1,2502,2331,171,0,45,1,6
59572,1,2612,2568,44,0,70,0,6
59573,3,2691,2491,200,0,4,0,6
59574,2,2325,2618,-293,0,454,0,6
59575,2,2501,2582,-81,0,147,1,6
59576,1,2627,2405,222,0,343,0,6
59577,2,2714,2698,16,0,46,0,6
59578,2,2441,2639,-198,0,315,1,6
59579,2,2461,2533,-72,0,0,0,6
59580,2,2295,2500,-205,0,404,1,6
59581,2,2451,2431,20,0,142,0,6
59582,2,2437,2296,141,0,459,1,6
59583,1,2406,2455,-49,0,6,0,6
59584,2,2285,2617,-332,0,106,0,6
59585,1,2668,2528,140,0,46,0,6
59586,2,2438,2642,-204,0,429,0,6
59587,1,2481,2499,-18,0,4,0,6
59588,1,2530,2450,80,0,455,0,6
59589,2,2635,2524,111,0,337,1,6
59590,1,2421,2322,99,0,335,1,6
59591,2,2665,2646,19,0,18,0,6
59592,1,2426,2461,-35,0,131,0,6
59593,2,2571,2567,4,0,101,0,6
59594,2,2485,2407,78,0,45,0,6
59595,3,2581,2605,-24,0,123,0,6
59596,1,2514,2475,39,0,110,0,6
59597,1,2453,2549,-96,0,315,0,6
59598,2,2431,2482,-51,0,337,0,6
59599,1,2417,2534,-117,0,211,0,6
59600,1,2490,2490,0,0,101,0,6
59601,2,2643,2522,121,0,300,0,6
59602,2,2566,2414,152,0,84,0,6
59603,2,2366,2502,-136,0,0,0,6
59604,1,2567,2315,252,0,70,0,6
59605,2,2768,2631,137,0,207,0,6
59606,2,2319,2440,-121,0,135,0,6
59607,3,2506,2312,194,4,200,0,13
59608,1,2501,2447,54,0,0,0,6
59609,3,2299,2417,-118,0,255,0,6
59610,2,2510,2527,-17,0,9,1,6
59611,1,2606,2559,47,0,331,0,6
59612,2,2422,2252,170,0,16,0,6
59613,2,2427,2390,37,0,101,0,6
59614,1,2375,2524,-149,0,49,0,6
59615,1,2495,2433,62,0,373,0,6
59616,1,2577,2473,104,0,248,0,6
59617,2,2553,2471,82,0,160,0,6
59618,1,2555,2531,24,0,337,1,6
59619,2,2516,2525,-9,0,130,0,6
59620,2,2589,2711,-122,0,246,0,6
59621,1,2533,2514,19,0,40,0,6
59622,2,2417,2381,36,0,8,0,6
59623,1,2211,2473,-262,0,123,0,6
59624,2,2704,2688,16,0,278,0,6
59625,2,2563,2573,-10,0,207,0,6
59626,1,2546,2573,-27,0,190,0,6
59627,1,2427,2404,23,0,106,0,6
59628,1,2380,2408,-28,0,210,1,6
59629,2,2516,2455,61,0,5,0,6
59630,1,2530,2387,143,0,43,0,6
59631,2,2430,2617,-187,0,241,0,6
59632,1,2353,2501,-148,0,143,0,6
59633,2,2429,2424,5,0,5,1,8
59634,1,2364,2408,-44,0,1,0,6
59635,1,2432,2268,164,0,344,0,6
59636,2,2325,2405,-80,0,49,0,6
59637,2,2464,2730,-266,0,46,0,6
59638,2,2360,2438,-78,0,9,0,6
59639,1,2564,2475,89,0,310,1,6
59640,3,2631,2357,274,0,50,0,6
59641,1,2486,2422,64,0,143,0,6
59642,2,2396,2451,-55,0,466,0,6
59643,3,2491,2562,-71,0,48,0,6
59644,2,2641,2473,168,0,46,0,6
59645,1,2487,2557,-70,0,45,0,6
59646,3,2404,2498,-94,0,101,0,6
59647,1,2451,2397,54,0,8,0,6
59648,2,2300,2466,-166,0,121,0,6
59649,3,2387,2493,-106,0,112,0,6
59650,2,2427,2426,1,0,35,1,6
59651,2,2293,2432,-139,0,300,0,8
59652,2,2472,2480,-8,0,132,1,6
59653,1,2300,2449,-149,0,253,0,6
59654,1,2730,2344,386,0,134,0,6
59655,1,2641,2368,273,0,213,0,6
59656,2,2383,2446,-63,0,131,0,6
59657,1,2448,2442,6,0,487,0,6
59658,2,2421,2682,-261,0,169,0,6
59659,1,2438,2384,54,0,39,1,6
59660,1,2551,2535,16,0,107,0,6
59661,1,2474,2532,-58,0,42,0,6
59662,1,2461,2549,-88,0,132,0,6
59663,2,2509,2581,-72,0,255,0,6
59664,1,2631,2649,-18,0,150,0,6
59665,2,2234,2671,-437,0,20,0,6
59666,1,2459,2365,94,0,109,0,6
59667,2,2745,2605,140,0,213,0,6
59668,1,2418,2535,-117,0,125,0,6
59669,1,2438,2346,92,0,123,0,6
59670,3,2392,2455,-63,0,4,0,8
59671,2,2269,2420,-151,0,45,1,6
59672,2,2518,2507,11,0,409,1,6
59673,2,2429,2477,-48,0,269,0,6
59674,1,2450,2552,-102,0,245,1,6
59675,1,2672,2399,273,0,144,0,6
59676,1,2812,2552,260,0,7,0,6
59677,1,2502,2354,148,0,345,0,6
59678,1,2379,2406,-27,0,487,0,6
59679,2,2452,2531,-79,0,4,0,6
59680,1,2615,2399,216,0,14,0,6
59681,2,2430,2401,29,0,456,1,6
59682,1,2566,2465,101,0,40,0,6
59683,2,2402,2483,-81,0,143,0,6
59684,3,2603,2212,391,0,308,0,6
59685,2,2629,2671,-42,0,304,0,6
59686,2,2421,2577,-156,0,288,0,6
59687,1,2366,2446,-80,0,16,1,6
59688,2,2627,2562,65,0,20,0,6
59689,1,2630,2630,0,0,337,0,6
59690,2,2365,2409,-44,0,190,0,6
59692,1,2696,2297,399,0,300,1,6
59693,1,2527,2496,31,0,4,0,6
59694,1,2484,2652,-168,0,352,0,6
59695,1,2570,2413,157,0,337,0,6
59696,1,2448,2376,72,0,167,0,6
59697,3,2493,2471,22,0,255,0,6
59698,2,2501,2456,45,0,245,0,6
59699,1,2537,2731,-194,0,124,0,6
59700,2,2411,2435,-24,0,5,1,6
59701,1,2639,2688,-49,0,331,0,6
59702,1,2704,2494,210,0,133,0,6
59703,2,2708,2438,270,0,302,0,6
59704,2,2487,2457,30,0,374,0,6
59705,1,2251,2474,-223,0,46,0,6
59706,2,2642,2757,-115,0,240,0,6
59707,1,2387,2444,-57,0,122,0,6
59708,2,2425,2701,-276,0,301,0,6
59709,1,2328,2470,-142,0,4,0,6
59710,1,2427,2241,186,0,100,1,8
59711,2,2607,2570,37,0,353,0,6
59712,1,2389,2431,-42,0,55,0,6
59713,1,2363,2449,-86,0,131,0,6
59714,1,2274,2432,-158,0,8,1,6
59715,2,2501,2319,182,0,216,0,6
59716,1,2443,2393,50,0,172,0,6
59717,2,2335,2617,-282,0,14,1,6
59718,1,2489,2227,262,0,46,0,6
59719,1,2402,2355,47,0,113,1,6
59720,2,2421,2529,-108,0,211,1,6
59721,1,2618,2663,-45,0,113,0,6
59722,2,2587,2595,-8,0,102,1,6
59723,1,2513,2440,73,0,101,0,7
59724,2,2461,2642,-181,0,343,0,6
59725,1,2497,2505,-8,0,115,0,6
59726,1,2542,2550,-8,0,1,0,6
59727,1,2442,2442,0,0,152,0,6
59728,2,2296,2424,-128,0,201,0,6
59729,3,2800,2815,-15,0,335,0,6
59730,1,2290,2425,-135,0,220,0,6
59731,1,2495,2266,229,0,107,0,6
59732,1,2506,2337,169,0,243,0,6
59733,1,2403,2504,-101,0,277,1,6
59734,2,2338,2436,-98,0,45,0,6
59735,1,2563,2503,60,0,1,0,6
59736,1,2500,2494,6,0,0,0,6
59737,1,2469,2380,89,0,207,0,6
59738,2,2303,2618,-315,0,194,0,6
59739,1,2457,2386,71,0,240,0,6
59740,1,2440,2284,156,0,330,1,6
59741,2,2551,2275,276,0,303,0,6
59742,1,2529,2551,-22,0,19,0,6
59743,1,2630,2586,44,0,293,0,6
59744,3,2721,2504,217,0,386,0,6
59745,1,2617,2587,30,0,466,0,6
59746,2,2511,2411,100,0,224,0,6
59747,2,2553,2545,8,0,140,0,6
59748,2,2656,2659,-3,0,241,1,6
59749,2,2485,2341,144,0,138,1,6
59750,2,2267,2579,-312,0,300,1,6
59751,1,2728,2707,21,0,131,0,6
59752,3,2509,2711,-202,0,7,0,6
59753,2,2303,2430,-127,0,40,1,6
59754,1,2452,2257,195,0,218,0,6
59755,2,2313,2519,-206,0,0,0,6
59756,3,2491,2680,-189,0,130,0,6
59757,1,2462,2470,-8,0,302,1,6
59758,1,2553,2636,-83,0,312,1,6
59759,1,2500,2294,206,0,150,0,6
59760,1,2373,2445,-72,0,244,0,6
59761,1,2437,2323,114,0,143,0,6
59762,2,2672,2692,-20,0,195,1,6
59763,1,2621,2255,366,0,4,0,6
59764,2,2432,2388,44,0,111,0,6
59765,2,2478,2546,-68,0,22,0,6
59766,2,2412,2322,90,0,380,0,6
59767,2,2260,2497,-237,0,40,0,6
59768,1,2503,2387,116,0,253,1,6
59769,1,2652,2614,38,0,400,0,6
59770,1,2539,2378,161,0,474,1,6
59771,1,2723,2684,39,0,147,0,6
59772,2,2492,2481,11,0,331,0,6
59773,1,2458,2367,91,0,70,0,6
59774,3,2522,2433,89,0,200,0,6
59775,2,2463,2704,-241,0,0,0,6
59776,1,2561,2418,143,0,7,0,6
59777,1,2506,2395,111,0,1,0,6
59778,2,2546,2668,-122,0,64,0,6
59779,1,2491,2448,43,0,211,0,6
59780,2,2403,2415,-12,0,270,0,6
59781,2,2507,2283,224,0,130,0,6
59782,2,2279,2424,-145,0,132,1,6
59783,3,2468,2571,-103,0,455,0,6
59784,3,2362,2417,-55,0,360,0,6
59785,2,2436,2398,38,0,245,0,8
59786,1,2511,2439,72,0,241,0,6
59787,1,2445,2299,146,0,135,0,6
59788,2,2285,2505,-220,0,310,0,6
59789,2,2418,2429,-11,0,194,0,6
59790,1,2516,2458,58,0,0,0,6
59791,2,2423,2498,-75,0,211,0,6
59792,2,2378,2417,-39,0,0,0,6
59793,3,2304,2438,-134,0,125,0,6
59794,2,2536,2557,-21,0,100,0,6
59795,2,2534,2539,-5,0,302,0,6
59796,1,2656,2389,267,0,106,0,6
59797,1,2491,2624,-133,0,155,0,6
59798,1,2443,2448,-5,0,102,0,6
59799,2,2409,2489,-80,0,45,1,6
59800,2,2410,2425,-15,0,40,0,6
59801,1,2337,2425,-88,0,312,0,6
59802,3,2402,2292,110,0,242,0,6
59803,2,2321,2505,-184,0,140,0,6
59804,2,2564,2460,104,0,45,0,6
59805,2,2611,2624,-13,0,335,0,6
59806,1,2548,2638,-90,0,7,0,6
59807,1,2715,2691,24,0,50,0,6
59808,2,2436,2405,31,0,456,0,6
59809,1,2469,2423,46,0,41,0,6
59810,2,2276,2420,-144,0,302,0,6
59811,2,2596,2646,-50,0,315,0,6
59812,2,2324,2432,-108,0,123,0,6
59813,1,2613,2682,-69,0,331,0,6
59814,2,2548,2297,251,0,204,0,6
59815,1,2558,2453,105,0,437,0,6
59816,1,2492,2459,33,0,485,0,6
59817,2,2381,2581,-200,0,226,1,6
59818,1,2623,2402,221,0,337,1,6
59819,2,2554,2677,-123,0,7,0,6
59820,1,2544,2571,-27,0,40,0,6
59821,2,2392,2442,-50,0,236,0,6
59822,2,2396,2488,-92,0,485,1,6
59823,2,2411,2397,14,0,4,1,6
59824,2,2362,2427,-65,0,0,0,6
59825,2,2378,2731,-353,0,201,0,6
59826,1,2487,2468,19,0,83,1,6
59827,1,2570,2462,108,0,138,1,6
59828,1,2464,2207,257,0,459,0,6
59829,2,2359,2630,-271,0,28,1,6
59830,1,2387,2413,-26,0,337,0,6
59831,2,2507,2413,94,0,331,0,6
59832,1,2558,2480,78,0,255,0,6
59833,2,2260,2694,-434,0,263,0,6
59834,1,2526,2487,39,0,8,0,6
59835,1,2462,2347,115,0,133,0,6
59836,2,2763,2732,31,0,130,0,6
59837,1,2620,2542,78,0,306,0,6
59838,2,2358,2627,-269,0,8,0,6
59839,1,2579,2633,-54,0,101,0,6
59840,2,2396,2643,-247,0,245,0,6
59841,2,2498,2373,125,0,107,1,6
59842,2,2480,2320,160,0,20,0,6
59843,1,2627,2511,116,0,381,0,6
59844,1,2531,2553,-22,0,107,1,6
59845,1,2343,2410,-67,0,211,0,6
59846,1,2631,2419,212,0,125,0,6
59847,3,2456,2555,-99,0,116,0,6
59848,3,2624,2527,97,0,385,0,6
59849,2,2257,2426,-169,0,301,0,6
59850,1,2615,2636,-21,0,20,0,6
59851,1,2503,2405,98,0,129,1,6
59852,1,2551,2378,173,0,45,1,6
59853,1,2496,2391,105,0,233,0,6
59854,1,2503,2396,107,0,490,1,6
59855,2,2397,2509,-112,0,331,1,8
59856,1,2406,2206,200,4,132,1,13
59857,1,2418,2250,168,0,45,0,6
59858,1,2536,2505,31,0,36,0,6
59859,1,2436,2556,-120,0,380,0,6
59860,2,2374,2504,-130,0,46,0,6
59861,1,2532,2574,-42,0,45,0,6
59862,2,2491,2568,-77,0,200,0,6
59863,2,2532,2674,-142,0,4,0,6
59864,1,2658,2317,341,0,150,0,6
59865,1,2470,2397,73,0,149,0,6
59866,1,2545,2428,117,0,201,0,6
59867,1,2530,2409,121,0,115,0,6
59868,1,2551,2637,-86,0,48,0,6
59869,2,2677,2643,34,0,49,0,6
59870,2,2334,2422,-88,0,152,1,6
59871,2,2564,2570,-6,0,414,0,6
59872,1,2524,2505,19,0,110,0,6
59873,1,2489,2492,-3,0,45,0,6
59874,2,2350,2447,-97,0,400,0,6
59875,3,2577,2552,25,0,200,0,6
59876,1,2342,2500,-158,0,122,1,6
59877,1,2447,2318,129,0,330,0,6
59879,2,2456,2250,206,4,140,0,13
59880,1,2436,2276,160,0,46,0,6
59881,1,2486,2461,25,0,211,0,6
59882,1,2703,2568,135,0,46,0,6
59883,1,2418,2512,-94,0,140,0,6
59884,1,2508,2395,113,0,109,1,6
59885,3,2410,2288,122,0,1,0,6
59886,1,2498,2387,111,0,106,0,6
59887,1,2658,2494,164,0,125,0,6
59888,2,2544,2422,122,0,373,0,6
59889,1,2308,2530,-222,0,190,0,6
59890,1,2224,2618,-394,0,106,0,6
59891,1,2562,2474,88,0,0,0,6
59892,1,2708,2492,216,0,13,0,6
59893,1,2581,2311,270,0,102,0,6
59894,3,2601,2522,79,0,1,0,6
59895,2,2431,2457,-26,0,423,0,6
59896,3,2399,2539,-140,0,9,0,6
59897,1,2408,2263,145,0,122,0,6
59898,3,2213,2416,-203,0,6,0,6
59899,2,2551,2473,78,0,160,1,6
59900,3,2707,2800,-93,0,426,0,6
59901,2,2479,2259,220,0,302,0,6
59902,2,2490,2463,27,0,201,0,6
59903,1,2437,2382,55,0,14,0,6
59904,3,2815,2699,116,0,6,0,6
59905,1,2417,2564,-147,0,106,0,6
59906,1,2533,2531,2,0,394,0,6
59907,2,2415,2449,-34,0,242,0,6
59908,2,2260,2453,-193,0,49,0,6
59909,1,2695,2448,247,0,110,0,6
59910,1,2508,2546,-38,0,45,0,6
59911,1,2507,2631,-124,0,110,0,6
59912,1,2551,2502,49,0,490,0,6
59913,2,2609,2657,-48,0,45,0,6
59914,3,2345,2481,-136,0,4,0,6
59915,1,2431,2405,26,0,344,0,6
59916,2,2476,2458,18,0,101,1,6
59917,1,2491,2623,-132,0,255,0,6
59918,2,2379,2420,-41,0,150,1,6
59919,2,2397,2443,-46,0,132,0,6
59920,2,2420,2557,-137,0,101,0,6
59921,1,2645,2662,-17,0,6,0,6
59922,2,2319,2492,-173,0,43,0,6
59923,1,2582,2562,20,0,43,1,6
59924,1,2513,2455,58,0,43,0,6
59925,2,2297,2445,-148,0,40,0,6
59926,1,2462,2327,135,0,490,1,6
59927,1,2254,2510,-256,0,0,0,6
59928,2,2296,2401,-105,0,106,0,6
59929,2,2469,2698,-229,0,50,0,6
59930,2,2391,2494,-103,0,46,0,6
59931,2,2672,2616,56,0,250,0,6
59932,3,2424,2266,158,0,53,0,6
59933,2,2408,2448,-40,0,15,1,6
59934,2,2505,2465,40,0,5,0,6
59935,2,2475,2499,-24,0,115,0,6
59936,1,2626,2542,84,0,305,0,6
59937,1,2545,2667,-122,0,103,0,6
59938,2,2401,2538,-137,0,302,0,6
59939,1,2471,2425,46,0,106,0,6
59940,2,2581,2326,255,0,277,0,6
59941,3,2404,2624,-220,0,455,0,6
59942,2,2242,2416,-174,0,201,0,6
59943,2,2352,2453,-101,0,120,1,6
59944,1,2519,2353,166,0,244,0,6
59945,1,2271,2421,-150,0,140,0,6
59946,3,2483,2370,113,0,45,0,6
59947,1,2453,2494,-41,0,101,0,6
59948,1,2484,2490,-6,0,49,0,6
59949,1,2440,2533,-93,0,80,1,6
59950,1,2629,2236,393,0,46,0,6
59951,2,2461,2498,-37,0,0,0,6
59952,3,2605,2541,64,0,332,0,6
59953,2,2500,2711,-211,0,406,0,6
59954,1,2680,2586,94,0,302,0,6
59955,1,2424,2205,219,0,242,1,6
59956,2,2606,2462,144,0,0,0,6
59958,2,2619,2378,241,0,455,1,6
59959,1,2629,2551,78,0,41,0,6
59960,2,2225,2528,-303,0,58,0,6
59961,2,2318,2405,-87,0,203,0,6
59962,2,2270,2697,-427,0,215,1,6
59963,3,2623,2515,108,0,40,0,6
59964,1,2424,2282,142,0,241,0,6
59965,1,2499,2254,245,0,123,0,6
59966,2,2318,2509,-191,0,107,0,6
59967,3,2440,2334,106,0,13,0,6
59968,1,2512,2514,-2,0,409,0,6
59969,1,2539,2662,-123,0,4,0,6
59970,2,2238,2542,-304,0,113,0,6
59971,2,2282,2455,-173,0,45,0,6
59972,1,2439,2406,33,0,405,0,6
59973,1,2529,2646,-117,0,7,0,6
59974,1,2507,2737,-230,0,103,0,6
59975,2,2431,2392,39,0,50,0,6
59976,2,2383,2717,-334,0,140,0,6
59977,2,2675,2708,-33,0,14,0,6
59978,2,2510,2622,-112,0,337,0,6
59979,1,2424,2373,51,0,455,0,6
59980,3,2799,2620,179,0,143,0,6
59981,1,2466,2289,177,0,4,1,6
59982,1,2345,2543,-198,0,125,0,6
59983,1,2418,2356,62,0,112,0,6
59984,1,2635,2419,216,0,42,0,6
59985,1,2395,2426,-31,0,45,0,6
59986,2,2237,2472,-235,0,9,0,6
59987,1,2352,2424,-72,0,241,0,6
59988,2,2423,2509,-86,0,101,0,6
59989,2,2447,2334,113,0,228,0,6
59990,1,2570,2384,186,0,123,0,6
59991,2,2400,2418,-18,0,1,0,6
59992,2,2701,2635,66,0,242,0,6
59993,2,2211,2403,-192,0,302,0,6
59994,2,2567,2356,211,0,338,0,6
59995,1,2446,2583,-137,0,60,0,6
59996,2,2308,2502,-194,0,301,0,6
59997,2,2452,2504,-52,0,101,0,6
59998,1,2581,2754,-173,0,240,0,6
59999,2,2371,2401,-30,0,176,0,6
60000,1,2632,2539,93,0,327,0,6
60001,1,2411,2498,-87,0,345,0,6
60002,2,2386,2521,-135,0,106,1,6
60003,2,2306,2405,-99,4,105,0,13
60004,2,2419,2370,49,0,28,0,6
60005,1,2496,2470,26,0,292,0,6
60006,1,2349,2477,-128,0,1,1,6
60007,1,2433,2281,152,0,1,0,6
60008,1,2734,2558,176,0,150,0,6
60009,2,2671,2634,37,0,49,0,6
60010,3,2389,2454,-65,0,200,0,6
60011,2,2525,2529,-4,0,7,0,6
60012,2,2449,2398,51,0,100,0,6
60013,2,2301,2562,-261,0,400,0,6
60014,2,2403,2230,173,0,58,0,6
60015,2,2650,2630,20,0,460,1,6
60016,2,2500,2678,-178,0,0,0,6
60017,2,2538,2629,-91,0,112,0,6
60018,2,2388,2573,-185,0,302,0,6
60019,2,2401,2416,-15,0,122,0,6
60020,1,2539,2507,32,0,394,0,6
60021,1,2502,2496,6,0,211,0,6
60022,1,2626,2560,66,0,445,0,6
60023,1,2486,2486,0,0,108,0,6
60024,2,2487,2529,-42,0,4,0,6
60025,1,2413,2386,27,0,45,0,6
60026,2,2411,2600,-189,0,118,1,6
60027,3,2423,2454,-31,0,41,0,8
60028,2,2494,2405,89,0,45,0,6
60029,2,2556,2435,121,0,107,0,6
60030,2,2380,2417,-37,0,5,1,6
60031,2,2634,2813,-179,0,305,0,6
60032,2,2484,2521,-37,0,241,0,6
60033,1,2306,2466,-160,0,123,0,6
60034,1,2488,2500,-12,0,300,1,6
60035,1,2728,2425,303,0,141,0,6
60036,1,2407,2492,-85,0,16,1,6
60037,1,2452,2434,18,0,217,1,6
60038,2,2546,2503,43,0,5,0,6
60039,2,2556,2393,163,0,8,0,6
60040,1,2484,2346,138,0,201,0,6
60041,1,2442,2351,91,0,45,0,6
60042,2,2257,2660,-403,0,40,0,6
60043,1,2739,2701,38,0,122,1,6
60044,1,2374,2455,-81,0,101,0,6
60045,1,2468,2460,8,0,45,0,6
60046,2,2387,2625,-238,0,43,0,6
60047,2,2464,2679,-215,0,444,0,6
60048,2,2436,2443,-7,0,319,1,6
60049,1,2424,2333,91,0,400,0,6
60050,1,2495,2539,-44,0,241,0,6
60051,2,2651,2655,-4,0,485,0,6
60052,1,2428,2498,-70,0,123,1,6
60053,1,2733,2394,339,0,123,0,6
60054,2,2559,2457,102,0,45,1,6
60055,1,2575,2592,-17,0,106,0,6
60056,1,2531,2359,172,0,242,1,6
60057,1,2307,2497,-190,0,205,0,6
60058,2,2458,2497,-39,0,302,1,6
60059,3,2554,2651,-97,0,7,0,6
60060,1,2405,2316,89,0,0,0,6
60061,1,2681,2574,107,0,217,0,6
60062,1,2424,2470,-46,0,211,0,6
60063,2,2391,2491,-100,0,380,0,6
60064,2,2447,2348,99,0,122,1,6
60065,1,2434,2276,158,0,253,1,6
60066,2,2584,2549,35,0,148,0,6
60067,3,2454,2417,37,0,246,0,6
60068,2,2268,2707,-439,0,255,1,6
60069,3,2462,2410,52,0,1,0,6
60070,1,2564,2465,99,0,45,0,6
60071,2,2560,2615,-55,0,300,1,6
60072,2,2381,2553,-172,0,132,0,6
60073,1,2412,2218,194,0,196,0,6
60074,1,2720,2499,221,0,341,0,6
60075,2,2456,2512,-56,0,40,1,6
60076,1,2685,2665,20,0,45,0,6
60077,1,2423,2346,77,0,200,0,6
60078,1,2640,2697,-57,0,45,0,6
60079,1,2633,2493,140,0,0,0,6
60080,2,2432,2436,-4,0,222,0,6
60081,1,2474,2444,30,0,28,0,6
60082,2,2435,2537,-102,0,6,0,6
60083,2,2381,2497,-116,0,265,0,6
60084,2,2492,2350,142,0,138,0,6
60085,1,2523,2205,318,0,1,0,7
60086,3,2455,2576,-121,0,262,0,6
60087,1,2406,2290,116,0,40,0,6
60088,1,2367,2407,-40,0,123,1,6
60089,1,2719,2631,88,0,315,0,6
60090,1,2743,2631,112,0,209,1,6
60091,1,2521,2533,-12,0,8,0,6
60092,2,2349,2555,-206,0,10,0,6
60093,1,2816,2589,227,0,453,0,6
60094,1,2428,2477,-49,0,100,0,6
60095,3,2261,2408,-147,0,40,0,6
60096,1,2430,2311,119,0,122,0,8
60097,1,2448,2510,-62,0,301,0,6
60098,3,2666,2723,-57,0,253,0,6
60099,1,2586,2544,42,0,315,0,6
60100,2,2268,2554,-286,0,45,1,6
60101,2,2454,2587,-133,0,466,0,6
60102,2,2470,2363,107,0,100,0,6
60103,2,2581,2630,-49,0,280,1,6
60104,2,2470,2254,216,0,201,0,6
60105,2,2427,2508,-81,0,267,0,6
60106,2,2466,2567,-101,0,40,0,6
60107,1,2538,2604,-66,0,49,0,6
60108,2,2429,2626,-197,0,115,0,6
60109,2,2542,2502,40,0,331,0,6
60110,1,2701,2557,144,0,101,0,6
60111,1,2623,2496,127,0,130,0,6
60112,2,2372,2422,-50,0,200,0,6
60113,2,2350,2522,-172,0,4,0,6
60114,1,2491,2343,148,0,103,0,6
60115,1,2346,2429,-83,0,14,0,6
60116,2,2381,2470,-89,0,101,0,6
60117,1,2464,2599,-135,0,13,0,6
60118,2,2505,2568,-63,0,106,0,6
60119,2,2557,2282,275,0,25,0,6
60120,2,2283,2420,-137,0,120,1,6
60121,1,2713,2398,315,0,1,0,6
60122,2,2722,2714,8,0,337,0,6
60123,2,2685,2737,-52,0,48,0,6
60124,1,2513,2380,133,0,315,0,6
60125,2,2423,2448,-25,0,101,0,6
60126,1,2458,2730,-272,0,146,0,6
60127,2,2497,2488,9,0,45,0,6
60128,1,2523,2670,-147,0,112,0,6
60129,2,2420,2380,40,0,112,0,6
60130,3,2555,2582,-27,0,302,0,6
60131,2,2509,2536,-27,0,121,0,6
60132,1,2458,2291,167,0,133,0,6
60133,2,2361,2451,-90,0,300,1,6
60134,1,2544,2428,116,0,125,1,6
60135,1,2417,2268,149,0,113,1,6
60136,1,2655,2537,118,0,395,0,6
60137,1,2453,2345,108,0,483,0,6
60138,1,2548,2523,25,0,4,1,6
60139,2,2422,2631,-209,0,301,0,6
60140,2,2396,2492,-96,0,200,1,6
60141,1,2407,2479,-72,0,190,0,6
60142,1,2446,2401,45,0,300,0,6
60143,2,2575,2540,35,0,107,0,6
60144,2,2346,2499,-153,0,241,0,6
60145,2,2509,2662,-153,0,337,0,6
60146,1,2480,2555,-75,0,43,0,6
60147,1,2531,2667,-136,0,190,0,6
60148,2,2457,2419,38,0,45,0,6
60149,2,2526,2439,87,0,45,0,6
60150,1,2501,2372,129,0,1,0,6
60151,2,2527,2448,79,0,253,1,6
60152,1,2406,2324,82,0,1,1,6
60153,1,2264,2507,-243,0,455,0,6
60154,1,2442,2315,127,0,4,0,6
60155,1,2571,2445,126,0,130,1,6
60156,1,2508,2381,127,0,45,0,6
60157,1,2400,2436,-36,0,52,1,6
60158,1,2516,2622,-106,0,112,0,6
60159,1,2659,2645,14,0,303,0,6
60160,3,2662,2691,-29,0,140,0,6
60161,3,2682,2402,280,0,153,0,6
60162,1,2548,2462,86,0,4,0,6
60163,1,2380,2553,-173,0,40,0,6
60164,1,2638,2429,209,0,215,0,6
60165,2,2536,2481,55,0,461,0,6
60166,1,2491,2502,-11,0,240,0,6
60167,1,2514,2401,113,0,111,0,6
60168,2,2413,2354,59,0,302,0,6
60169,2,2482,2534,-52,0,414,0,6
60170,2,2401,2395,6,0,455,0,6
60171,2,2239,2443,-204,0,20,1,6
60172,1,2696,2727,-31,0,45,0,6
60173,2,2382,2466,-84,0,156,0,6
60174,1,2544,2349,195,0,49,0,6
60175,2,2419,2576,-157,0,310,0,6
60176,1,2695,2744,-49,0,133,0,6
60177,3,2504,2536,-32,0,201,0,6
60178,2,2404,2368,36,0,122,0,6
60179,1,2482,2470,12,0,7,0,6
60180,2,2492,2591,-99,0,150,0,6
60181,1,2642,2627,15,0,190,0,6
60182,2,2517,2450,67,0,113,0,6
60183,1,2425,2262,163,0,200,1,6
60184,2,2202,2450,-248,0,218,1,6
60185,3,2425,2384,41,0,335,0,6
60186,3,2306,2492,-186,0,0,0,6
60187,2,2493,2461,32,0,201,0,6
60188,1,2819,2647,172,0,1,0,6
60189,1,2463,2402,61,0,125,0,6
60190,1,2571,2535,36,0,0,1,6
60192,1,2508,2520,-12,0,101,0,6
60193,2,2453,2504,-51,0,115,0,6
60194,1,2587,2691,-104,0,253,1,6
60195,2,2402,2280,122,0,15,1,6
60196,2,2427,2390,37,0,53,0,6
60197,1,2368,2427,-59,0,41,0,6
60198,1,2335,2438,-103,0,45,0,6
60199,1,2464,2502,-38,0,402,0,6
60200,2,2429,2360,69,0,85,1,6
60201,1,2426,2462,-36,0,88,1,6
60202,2,2314,2610,-296,0,131,0,6
60203,1,2576,2419,157,0,355,0,6
60204,1,2650,2640,10,0,6,0,6
60205,1,2665,2555,110,0,53,0,6
60206,2,2627,2646,-19,0,301,1,6
60207,1,2634,2465,169,0,50,1,6
60208,2,2532,2381,151,0,304,1,6
60209,1,2546,2545,1,0,102,0,6
60210,1,2461,2298,163,0,113,0,6
60211,2,2454,2597,-143,0,123,0,6
60212,2,2288,2641,-353,0,301,0,6
60213,2,2411,2641,-230,0,278,0,6
60214,2,2407,2419,-12,0,106,0,6
60215,2,2388,2475,-87,0,204,0,6
60216,2,2698,2209,489,0,300,0,6
60217,3,2412,2487,-75,0,45,0,6
60218,2,2474,2284,190,0,48,0,6
60219,2,2569,2448,121,0,261,0,6
60220,2,2463,2448,15,0,132,0,6
60221,2,2554,2488,66,0,130,0,6
60222,3,2408,2418,-10,0,4,0,6
60223,2,2495,2378,117,0,106,0,6
60224,1,2469,2279,190,0,7,1,6
60225,2,2622,2704,-82,0,190,0,6
60226,2,2339,2473,-134,0,429,0,6
60227,1,2494,2453,41,0,135,1,6
60228,2,2502,2552,-50,0,0,0,6
60229,1,2556,2430,126,0,253,0,6
60230,2,2595,2796,-201,0,449,1,6
60231,1,2569,2494,75,0,101,0,6
60232,1,2459,2299,160,0,288,0,6
60233,2,2283,2435,-152,0,332,0,6
60234,2,2457,2357,100,0,40,0,6
60235,1,2614,2524,90,0,15,0,6
60236,2,2382,2473,-91,0,453,0,6
60237,1,2296,2427,-131,0,40,0,6
60238,2,2373,2430,-57,0,122,1,6
60239,2,2627,2644,-17,0,46,0,6
60240,1,2564,2365,199,0,306,0,6
60241,1,2289,2439,-150,0,300,0,6
60242,1,2533,2431,102,0,151,0,6
60243,1,2418,2377,41,0,193,0,6
60244,2,2472,2393,79,0,337,0,6
60245,1,2448,2502,-54,0,110,1,6
60246,1,2489,2414,75,0,40,0,6
60247,2,2365,2527,-162,0,454,0,6
60248,2,2259,2541,-282,0,46,1,6
60249,1,2474,2500,-26,0,115,0,6
60250,1,2665,2636,29,0,5,1,6
60251,2,2749,2506,243,0,191,0,6
60252,1,2734,2637,97,0,101,0,6
60253,3,2444,2558,-114,0,490,0,6
60254,2,2297,2443,-146,0,45,0,6
60255,2,2259,2447,-188,4,172,0,13
60256,2,2603,2651,-48,0,10,1,6
60257,1,2495,2326,169,0,123,1,6
60258,1,2387,2408,-21,0,311,0,6
60259,2,2342,2428,-86,0,70,1,6
60260,2,2299,2479,-180,0,132,0,6
60261,2,2389,2428,-39,0,6,0,6
60262,1,2446,2451,-5,0,310,0,6
60263,2,2504,2519,-15,0,106,1,6
60264,2,2406,2573,-167,0,464,0,6
60265,2,2486,2504,-18,0,40,0,6
60266,2,2342,2401,-59,0,469,0,6
60267,1,2429,2408,21,0,190,0,6
60268,2,2360,2415,-55,0,8,0,6
60269,1,2544,2446,98,0,40,0,6
60270,1,2457,2643,-186,0,335,0,6
60271,3,2542,2342,200,0,406,0,6
60272,2,2678,2457,221,0,250,0,6
60273,1,2358,2484,-126,0,123,1,6
60274,1,2431,2343,88,0,19,0,6
60275,2,2401,2376,25,0,46,0,6
60276,2,2414,2308,106,0,18,0,6
60277,3,2495,2742,-247,0,106,0,6
60278,2,2720,2423,297,0,143,0,6
60279,3,2426,2565,-139,0,100,0,6
60280,1,2502,2626,-124,0,123,0,6
60281,2,2472,2680,-208,0,9,1,6
60282,2,2410,2360,50,0,110,1,6
60283,2,2422,2623,-201,0,255,0,6
60284,1,2630,2489,141,0,305,0,6
60285,2,2514,2473,41,0,0,0,6
60286,1,2547,2514,33,0,255,0,6
60287,2,2372,2474,-102,0,13,0,6
60288,2,2498,2383,115,0,15,0,6
60289,3,2536,2574,-38,0,245,0,6
60290,2,2454,2394,60,0,249,1,8
60291,1,2361,2441,-80,4,331,0,13
60292,1,2557,2510,47,0,381,0,6
60293,3,2496,2715,-219,0,268,0,6
60294,3,2490,2552,-62,0,108,0,6
60295,1,2469,2555,-86,0,57,0,6
60296,1,2620,2551,69,0,354,0,6
60297,2,2396,2487,-91,0,100,0,6
60298,2,2457,2669,-212,0,418,0,6
60299,1,2721,2574,147,0,300,0,6
60300,3,2400,2487,-87,0,25,0,6
60301,3,2685,2702,-17,0,154,0,6
60302,1,2570,2497,73,0,4,1,6
60303,1,2462,2465,-3,0,100,0,6
60304,1,2548,2476,72,0,0,0,6
60305,3,2398,2424,-26,0,344,0,6
60306,1,2293,2446,-153,0,145,0,6
60307,1,2370,2482,-112,0,141,0,6
60308,1,2400,2385,15,0,404,0,6
60309,1,2439,2455,-16,0,114,0,6
60310,3,2504,2430,74,0,463,0,6
60311,1,2472,2378,94,0,106,1,6
60312,2,2611,2440,171,0,311,0,6
60313,3,2533,2659,-126,0,0,0,6
60314,2,2464,2530,-66,0,153,1,6
60315,2,2555,2461,94,0,286,0,6
60316,2,2539,2576,-37,0,394,0,6
60317,1,2410,2330,80,0,69,0,6
60318,1,2417,2326,91,0,143,0,6
60319,1,2635,2555,80,0,43,0,6
60320,1,2581,2591,-10,0,108,0,6
60321,1,2454,2267,187,0,132,1,6
60322,1,2644,2594,50,0,222,1,6
60323,1,2612,2439,173,0,141,0,6
60325,3,2467,2427,40,0,210,0,6
60326,1,2549,2344,205,0,343,0,6
60327,1,2517,2227,290,0,219,0,6
60328,1,2427,2360,67,0,31,1,6
60329,3,2442,2527,-85,0,130,0,6
60330,1,2631,2487,144,0,13,0,6
60331,1,2542,2437,105,0,405,0,6
60332,2,2295,2451,-156,0,373,0,6
60333,2,2601,2822,-221,0,28,0,6
60334,1,2577,2373,204,0,260,0,6
60335,2,2401,2464,-63,0,192,1,6
60336,1,2452,2634,-182,0,50,0,6
60337,2,2485,2446,39,0,453,0,6
60338,3,2708,2725,-17,0,47,0,6
60339,2,2490,2450,40,0,10,0,6
60340,1,2517,2457,60,0,90,0,6
60341,1,2482,2379,103,0,96,0,6
60342,2,2518,2554,-36,0,6,0,6
60343,2,2480,2397,83,0,315,1,6
60344,1,2492,2407,85,0,201,0,6
60345,2,2316,2507,-191,0,440,0,6
60346,2,2524,2520,4,0,40,0,6
60347,2,2719,2655,64,0,426,0,6
60348,2,2547,2678,-131,0,373,0,6
60349,2,2634,2716,-82,0,335,0,6
60350,3,2265,2575,-310,0,255,0,6
60351,2,2624,2539,85,0,341,0,6
60352,1,2570,2535,35,0,218,0,6
60353,1,2576,2659,-83,0,45,0,6
60354,1,2477,2556,-79,0,130,1,6
60355,2,2402,2505,-103,0,115,0,6
60356,2,2374,2459,-85,0,10,0,6
60357,2,2398,2468,-70,0,224,0,6
60358,1,2445,2392,53,0,123,0,6
60359,1,2418,2283,135,0,404,1,6
60360,2,2483,2729,-246,0,142,0,6
60361,1,2424,2471,-47,0,130,1,6
60362,1,2513,2336,177,0,4,0,6
60363,2,2512,2573,-61,0,45,0,6
60364,2,2273,2413,-140,0,256,0,6
60365,1,2437,2265,172,0,0,0,6
60366,3,2374,2548,-174,0,210,0,6
60367,1,2525,2347,178,0,244,0,6
60368,1,2433,2292,141,0,102,0,6
60370,2,2391,2505,-114,0,380,1,6
60371,2,2462,2379,83,0,101,0,6
60372,1,2637,2562,75,0,445,0,6
60373,2,2431,2448,-17,0,45,0,6
60374,2,2475,2509,-34,0,7,0,6
60375,2,2495,2471,24,0,260,0,6
60376,1,2421,2411,10,0,8,0,6
60377,2,2350,2471,-121,0,212,0,6
60378,1,2386,2738,-352,0,255,1,6
60379,2,2515,2499,16,0,333,0,6
60381,1,2452,2455,-3,0,45,0,6
60382,2,2633,2487,146,0,201,0,6
60383,2,2738,2552,186,0,246,0,6
60384,2,2438,2383,55,0,14,0,6
60385,2,2286,2410,-124,0,0,0,6
60386,2,2478,2477,1,0,45,0,6
60387,1,2494,2368,126,0,123,0,6
60388,1,2481,2737,-256,0,226,0,6
60389,2,2420,2548,-128,0,147,0,6
60390,2,2548,2711,-163,0,300,0,6
60391,2,2468,2432,36,0,345,0,6
60392,3,2455,2457,-2,0,1,0,6
60393,2,2644,2345,299,0,205,0,6
60394,1,2308,2518,-210,0,200,1,6
60395,2,2454,2401,53,0,4,1,6
60396,2,2433,2539,-106,0,228,1,6
60397,3,2580,2337,243,0,206,0,6
60398,2,2453,2522,-69,0,107,0,6
60399,2,2568,2444,124,0,100,0,6
60400,1,2259,2537,-278,0,147,0,6
60401,2,2289,2547,-258,0,112,0,6
60402,1,2443,2384,59,0,133,0,6
60403,2,2526,2531,-5,0,150,1,6
60404,2,2702,2543,159,0,48,0,6
60405,2,2254,2420,-166,0,251,0,6
60406,2,2387,2705,-318,0,4,0,6
60407,1,2445,2367,78,0,35,0,6
60408,2,2236,2423,-187,0,374,0,6
60409,1,2427,2625,-198,0,171,0,6
60410,1,2682,2618,64,0,213,0,6
60411,1,2429,2361,68,0,242,0,6
60412,1,2560,2685,-125,0,152,0,6
60413,1,2239,2475,-236,0,41,0,6
60414,1,2709,2737,-28,0,130,0,6
60415,1,2539,2495,44,0,101,0,6
60416,1,2621,2701,-80,0,131,1,6
60417,2,2250,2512,-262,0,21,0,6
60418,1,2618,2445,173,0,368,0,6
60419,2,2388,2449,-61,0,113,1,6
60420,1,2430,2406,24,0,315,0,6
60421,2,2579,2496,83,0,43,0,6
60422,1,2362,2405,-43,0,0,0,6
60423,2,2575,2621,-46,0,202,0,6
60424,2,2648,2640,8,0,280,1,6
60425,2,2557,2316,241,0,409,0,6
60426,2,2364,2536,-172,0,45,0,6
60427,2,2493,2491,2,0,0,0,6
60428,1,2562,2213,349,0,45,0,6
60429,1,2387,2446,-59,0,122,1,6
60430,1,2416,2551,-135,0,107,0,6
60431,2,2427,2369,58,0,4,0,6
60432,2,2551,2649,-98,0,49,0,6
60433,2,2216,2455,-239,0,375,0,6
60434,1,2403,2434,-31,0,16,0,6
60435,2,2209,2403,-194,0,45,0,6
60436,1,2270,2428,-158,0,40,0,6
60437,2,2339,2435,-96,0,45,0,6
60438,3,2446,2355,91,0,200,0,6
60439,2,2457,2510,-53,0,106,1,6
60440,2,2448,2622,-174,0,46,1,6
60441,2,2514,2307,207,0,58,1,6
60442,2,2630,2490,140,0,43,0,6
60443,1,2543,2395,148,0,242,0,6
60444,2,2589,2575,14,0,147,0,6
60445,1,2721,2649,72,0,302,0,6
60446,2,2213,2402,-189,0,45,0,6
60447,2,2530,2725,-195,0,18,0,6
60448,2,2454,2662,-208,0,288,0,6
60449,2,2381,2479,-98,0,437,0,6
60451,2,2525,2494,31,0,45,0,6
60452,2,2374,2443,-69,0,15,1,6
60453,2,2438,2535,-97,0,110,0,6
60454,2,2466,2395,71,0,129,0,6
60455,2,2630,2662,-32,0,110,0,6
60456,1,2509,2576,-67,0,100,0,6
60457,3,2317,2469,-152,0,141,0,6
60458,2,2322,2518,-196,0,125,0,6
60459,2,2524,2498,26,0,373,1,6
60460,2,2671,2552,119,0,7,0,6
60461,1,2713,2725,-12,0,365,0,6
60462,1,2405,2385,20,0,151,0,6
60463,2,2530,2510,20,0,123,0,6
60464,2,2383,2567,-184,0,278,0,6
60465,1,2421,2455,-34,0,277,0,6
60466,2,2228,2406,-178,0,50,0,6
60467,1,2619,2535,84,0,346,0,6
60468,2,2456,2562,-106,0,0,0,6
60469,1,2490,2551,-61,0,153,1,6
60470,1,2486,2413,73,0,45,1,6
60471,2,2365,2448,-83,0,1,0,6
60472,2,2263,2424,-161,0,320,1,6
60473,1,2514,2466,48,0,308,0,6
60474,2,2288,2466,-178,0,145,0,6
60475,1,2577,2508,69,0,123,0,6
60476,1,2481,2346,135,0,255,0,6
60477,2,2799,2662,137,0,468,0,6
60478,1,2435,2414,21,0,315,1,6
60479,1,2644,2672,-28,0,267,0,6
60480,1,2724,2636,88,0,45,0,6
60481,1,2691,2592,99,0,37,0,6
60482,1,2635,2345,290,0,5,0,6
60483,2,2484,2313,171,0,14,1,6
60484,3,2466,2517,-51,0,386,0,6
60486,2,2454,2708,-254,0,466,0,6
60487,1,2496,2457,39,0,107,0,6
60488,2,2254,2434,-180,0,330,0,8
60490,1,2653,2583,70,0,4,0,6
60491,1,2544,2455,89,0,246,0,6
60492,1,2652,2547,105,0,210,0,6
60493,1,2495,2571,-76,0,292,1,6
60494,1,2557,2498,59,0,45,0,6
60495,2,2469,2642,-173,0,353,0,6
60496,3,2683,2505,178,0,46,0,6
60497,1,2707,2346,361,0,245,0,6
60498,2,2364,2424,-60,0,132,0,6
60499,1,2626,2455,171,0,311,0,6
60500,2,2305,2419,-114,0,432,0,6
60501,1,2472,2385,87,0,45,0,6
60502,2,2333,2472,-139,0,50,0,6
60503,2,2499,2513,-14,0,127,0,6
60504,1,2503,2486,17,0,56,0,6
60505,2,2463,2467,-4,0,128,0,6
60506,2,2406,2473,-67,0,260,0,6
60507,1,2712,2598,114,0,1,0,6
60508,1,2519,2532,-13,0,301,0,6
60509,2,2457,2825,-368,0,200,1,6
60510,2,2459,2393,66,0,153,0,6
60511,2,2317,2553,-236,0,188,0,6
60512,1,2427,2369,58,0,100,0,6
60513,1,2464,2206,258,0,7,0,6
60514,1,2371,2491,-120,0,210,0,6
60515,3,2424,2337,87,0,243,0,6
60516,2,2289,2402,-113,0,302,0,6
60517,1,2402,2270,132,0,110,1,6
60518,2,2483,2297,186,0,6,0,6
60519,2,2367,2510,-143,0,13,0,6
60520,1,2472,2535,-63,0,42,0,6
60521,1,2619,2399,220,0,6,0,6
60522,3,2551,2587,-36,0,0,0,6
60523,2,2509,2429,80,0,141,0,6
60524,1,2425,2234,191,0,300,0,6
60525,2,2543,2694,-151,0,124,0,6
60526,2,2309,2428,-119,0,168,0,6
60527,2,2527,2398,129,0,13,0,6
60528,2,2454,2424,30,0,245,1,6
60529,2,2729,2585,144,0,106,0,6
60530,3,2527,2448,79,0,359,0,6
60531,2,2538,2560,-22,0,101,1,6
60532,1,2453,2360,93,0,106,0,6
60533,2,2374,2479,-105,0,226,0,6
60534,2,2432,2386,46,0,4,0,6
60535,1,2366,2503,-137,0,202,1,6
60536,1,2576,2355,221,0,143,0,6
60537,1,2546,2629,-83,0,246,0,6
60538,2,2493,2496,-3,0,101,0,6
60539,2,2449,2625,-176,0,50,0,6
60540,3,2479,2460,19,0,195,0,6
60541,1,2694,2583,111,0,269,0,6
60542,2,2487,2458,29,0,0,0,6
60543,1,2582,2562,20,0,190,0,6
60544,2,2469,2457,12,0,205,0,6
60545,1,2581,2617,-36,0,245,0,6
60546,2,2431,2546,-115,0,122,0,6
60547,1,2409,2336,73,0,129,0,6
60548,3,2508,2477,31,0,120,0,6
60549,2,2371,2548,-177,0,123,0,6
60550,1,2517,2457,60,0,42,0,6
60551,3,2552,2455,97,0,115,0,6
60552,1,2500,2387,113,0,466,1,6
60553,1,2509,2534,-25,0,211,1,6
60554,2,2450,2370,80,0,490,0,6
60555,1,2326,2519,-193,0,106,1,6
60556,2,2498,2695,-197,0,228,0,6
60557,1,2319,2433,-114,0,124,1,6
60558,1,2588,2622,-34,0,310,0,6
60559,3,2431,2396,35,0,455,0,6
60560,1,2524,2482,42,0,0,0,6
60561,1,2362,2423,-61,0,394,1,6
60562,2,2357,2580,-223,0,17,0,6
60563,2,2535,2621,-86,0,45,0,6
60564,2,2442,2377,65,0,122,1,6
60565,1,2401,2435,-34,0,307,1,6
60566,1,2440,2334,106,0,210,0,6
60567,2,2593,2671,-78,0,463,0,6
60568,2,2205,2436,-231,0,205,0,6
60569,2,2464,2431,33,0,487,0,6
60570,2,2503,2678,-175,0,120,0,6
60571,1,2616,2479,137,0,123,0,6
60572,1,2439,2486,-47,0,455,1,6
60573,1,2521,2435,86,0,302,0,6
60574,1,2613,2483,130,0,405,1,6
60575,2,2472,2567,-95,0,302,0,6
60576,2,2687,2791,-104,0,148,0,6
60577,1,2719,2594,125,0,4,1,6
60578,1,2714,2572,142,0,210,0,6
60579,1,2545,2409,136,0,300,0,6
60580,2,2428,2484,-56,0,204,0,6
60581,1,2476,2462,14,0,8,0,6
60582,2,2344,2528,-184,0,184,0,6
60583,3,2418,2473,-55,0,122,0,6
60584,1,2428,2626,-198,0,40,0,6
60585,3,2414,2416,-2,0,1,0,6
60586,1,2343,2484,-141,0,46,0,6
60587,1,2426,2329,97,0,18,0,6
60588,2,2616,2561,55,0,302,0,6
60589,2,2520,2411,109,0,140,0,6
60590,2,2411,2455,-44,0,190,0,6
60591,1,2536,2637,-101,0,278,0,6
60592,1,2553,2423,130,0,405,0,6
60593,2,2544,2570,-26,0,111,0,6
60594,1,2498,2386,112,0,101,0,6
60595,1,2730,2656,74,0,150,0,6
60596,1,2436,2422,14,0,1,1,6
60597,1,2490,2359,131,0,120,0,6
60598,2,2549,2229,320,0,0,0,6
60599,2,2475,2201,274,0,4,0,6
60600,3,2595,2663,-68,0,331,0,6
60601,2,2408,2267,141,0,10,0,6
60602,1,2380,2549,-169,0,110,0,6
60603,2,2402,2716,-314,0,225,0,6
60604,1,2204,2405,-201,0,45,0,6
60605,1,2546,2456,90,0,113,0,6
60606,2,2543,2560,-17,0,13,0,6
60607,1,2466,2459,7,0,246,0,6
60608,1,2404,2452,-48,0,40,1,6
60609,2,2393,2426,-33,0,40,0,6
60610,1,2540,2623,-83,0,411,0,6
60611,1,2417,2299,118,0,378,1,6
60612,2,2475,2542,-67,0,106,0,6
60613,1,2339,2464,-125,0,57,0,6
60614,1,2671,2234,437,0,43,0,6
60615,2,2502,2516,-14,0,45,0,6
60616,2,2485,2401,84,0,426,0,6
60617,2,2406,2708,-302,0,113,0,6
60618,1,2472,2481,-9,0,302,0,6
60619,1,2464,2488,-24,0,313,0,6
60620,1,2346,2420,-74,0,40,0,6
60621,1,2731,2509,222,0,108,1,6
60622,1,2569,2258,311,0,0,0,6
60623,1,2467,2387,80,0,4,0,6
60624,3,2466,2400,66,0,330,0,6
60625,1,2587,2611,-24,0,291,0,6
60626,2,2716,2650,66,0,112,0,6
60627,2,2507,2826,-319,0,101,0,6
60628,2,2665,2680,-15,0,315,1,6
60629,2,2552,2588,-36,0,4,0,6
60630,2,2452,2518,-66,0,130,0,6
60631,3,2380,2423,-43,0,16,0,6
60632,1,2499,2428,71,0,253,0,6
60633,2,2508,2629,-121,0,255,0,6
60634,1,2443,2452,-9,0,123,0,6
60635,2,2625,2630,-5,0,47,0,6
60636,2,2268,2505,-237,0,143,0,6
60637,1,2316,2445,-129,0,106,1,6
60638,1,2729,2452,277,0,300,0,6
60639,2,2710,2646,64,0,302,1,6
60640,1,2527,2277,250,0,245,0,6
60641,1,2432,2379,53,0,221,0,6
60642,1,2670,2540,130,0,263,1,6
60643,2,2477,2728,-251,0,108,0,6
60644,2,2455,2396,59,0,0,0,6
60645,2,2697,2642,55,0,302,0,6
60646,3,2454,2383,71,0,40,0,6
60647,3,2501,2331,170,0,306,0,6
60648,2,2503,2582,-79,0,45,1,6
60649,3,2284,2401,-117,0,21,0,6
60650,1,2583,2314,269,0,204,0,6
60651,1,2528,2448,80,0,7,0,6
60652,1,2579,2437,142,0,134,1,6
60653,2,2322,2548,-226,0,386,0,6
60654,1,2451,2376,75,0,112,0,6
60655,2,2620,2475,145,0,243,1,6
60656,1,2549,2422,127,0,20,0,6
60657,1,2567,2676,-109,0,255,0,6
60658,1,2618,2588,30,0,40,0,6
60659,3,2609,2698,-89,0,335,0,6
60660,1,2440,2354,86,0,338,1,6
60661,1,2469,2331,138,0,46,0,6
60662,3,2374,2445,-71,0,107,0,6
60663,2,2400,2355,45,0,331,1,8
60664,1,2447,2314,133,0,128,0,8
60665,2,2489,2380,109,0,112,1,6
60666,1,2645,2521,124,0,354,0,6
60667,2,2364,2423,-59,0,200,0,6
60668,2,2327,2611,-284,0,13,0,6
60669,1,2449,2466,-17,0,0,0,6
60670,3,2437,2453,-16,0,101,0,6
60671,1,2667,2495,172,0,457,0,6
60672,2,2399,2430,-31,0,200,0,6
60673,3,2452,2570,-118,0,246,0,6
60674,1,2400,2432,-32,0,201,0,6
60675,1,2699,2587,112,0,45,1,6
60676,1,2557,2403,154,0,45,0,6
60677,1,2477,2508,-31,0,10,0,6
60678,1,2409,2490,-81,0,45,1,6
60679,1,2406,2502,-96,0,464,0,6
60680,1,2515,2395,120,0,1,0,6
60681,2,2467,2519,-52,0,333,0,6
60682,1,2409,2250,159,0,375,0,6
60683,2,2551,2505,46,0,58,0,6
60684,2,2268,2459,-191,0,111,0,6
60685,1,2357,2463,-106,0,5,0,6
60686,1,2452,2270,182,0,41,1,6
60687,1,2222,2428,-206,0,247,0,6
60688,1,2719,2625,94,0,460,0,6
60689,2,2436,2719,-283,0,225,0,6
60690,1,2463,2516,-53,0,112,0,6
60691,1,2406,2270,136,0,4,0,6
60692,1,2275,2440,-165,0,141,0,6
60693,3,2483,2545,-62,0,4,0,6
60694,1,2523,2379,144,0,110,0,6
60695,3,2426,2335,91,0,1,0,6
60696,2,2452,2412,40,0,312,0,6
60697,1,2427,2356,71,0,106,1,6
60698,1,2497,2509,-12,0,265,1,6
60699,2,2232,2416,-184,0,310,0,6
60700,2,2355,2504,-149,0,142,0,6
60701,1,2565,2724,-159,0,240,0,6
60702,2,2591,2617,-26,0,474,0,6
60703,1,2478,2372,106,0,218,0,6
60704,1,2497,2319,178,0,45,0,6
60705,3,2551,2537,14,0,4,0,6
60706,1,2383,2446,-63,0,375,0,6
60707,1,2413,2200,213,0,4,1,6
60708,3,2479,2522,-43,0,427,0,6
60709,1,2431,2518,-87,0,31,0,6
60710,2,2452,2240,212,0,104,0,6
60711,2,2628,2494,134,0,302,0,6
60712,2,2433,2546,-113,0,255,0,6
60713,2,2828,2795,33,0,125,0,6
60714,3,2556,2462,94,0,310,0,6
60715,1,2657,2506,151,0,125,0,6
60716,3,2579,2649,-70,0,373,0,6
60717,1,2651,2593,58,0,200,0,6
60718,1,2401,2525,-124,0,126,0,6
60719,2,2431,2256,175,0,211,0,6
60720,1,2396,2525,-129,0,83,0,6
60721,1,2709,2734,-25,0,253,0,6
60722,1,2476,2510,-34,0,257,0,6
60723,2,2605,2571,34,0,40,0,6
60724,1,2681,2518,163,0,177,0,6
60725,2,2357,2403,-46,0,455,1,6
60726,2,2593,2658,-65,0,170,0,6
60727,2,2718,2500,218,0,1,0,6
60728,2,2683,2547,136,0,112,0,6
60729,2,2449,2526,-77,0,101,0,6
60730,2,2426,2525,-99,0,200,0,6
60731,1,2396,2502,-106,0,373,0,6
60732,1,2662,2660,2,0,7,0,6
60733,1,2507,2575,-68,0,338,0,6
60734,1,2569,2460,109,0,398,0,6
60735,1,2564,2394,170,0,212,0,6
60736,2,2524,2596,-72,0,36,0,6
60737,2,2621,2364,257,0,70,0,6
60738,2,2685,2734,-49,0,46,1,6
60739,2,2717,2538,179,0,141,0,6
60740,1,2326,2406,-80,0,107,0,6
60741,2,2513,2418,95,0,123,0,6
60742,1,2495,2549,-54,0,40,1,6
60743,2,2330,2444,-114,0,0,0,6
60744,1,2511,2359,152,0,100,0,6
60745,1,2553,2470,83,0,101,0,6
60746,2,2428,2479,-51,0,114,0,6
60747,1,2400,2532,-132,0,332,0,6
60748,2,2401,2553,-152,0,10,1,6
60749,2,2275,2445,-170,0,301,1,6
60750,2,2231,2462,-231,0,483,1,6
60751,1,2437,2513,-76,0,4,0,6
60752,2,2359,2478,-119,0,40,0,6
60753,3,2417,2262,155,0,250,0,6
60754,2,2340,2418,-78,0,21,0,6
60755,1,2482,2622,-140,0,123,0,6
60756,1,2566,2560,6,0,4,0,6
60757,1,2392,2406,-14,0,195,0,6
60758,3,2393,2413,-20,0,41,0,6
60759,2,2423,2427,-4,0,211,0,6
60760,2,2454,2481,-27,0,130,1,6
60761,3,2211,2556,-345,0,143,0,6
60762,1,2456,2550,-94,0,405,0,6
60763,2,2670,2623,47,0,13,0,6
60764,1,2419,2434,-15,0,101,0,6
60765,1,2461,2405,56,0,335,0,6
60766,2,2388,2470,-82,0,15,0,6
60767,1,2399,2479,-80,0,132,0,6
60768,1,2370,2472,-102,0,121,0,6
60769,3,2540,2409,131,0,46,0,6
60770,1,2605,2309,296,0,213,0,6
60771,1,2549,2472,77,0,210,0,6
60772,2,2583,2560,23,0,394,0,6
60773,1,2450,2457,-7,0,10,0,6
60774,2,2420,2448,-28,0,45,1,6
60775,2,2267,2439,-172,0,45,0,6
60776,1,2429,2407,22,0,4,0,6
60777,1,2456,2347,109,0,338,1,6
60778,1,2625,2531,94,0,337,0,6
60779,2,2369,2412,-43,0,20,0,6
60780,2,2583,2585,-2,0,100,0,6
60781,1,2528,2455,73,0,320,0,6
60782,2,2622,2575,47,0,107,0,6
60783,2,2434,2731,-297,0,40,0,6
60784,1,2578,2500,78,0,0,0,6
60785,1,2476,2266,210,0,331,0,6
60786,2,2504,2508,-4,0,0,0,6
60787,1,2615,2352,263,0,221,0,6
60788,1,2509,2408,101,0,4,0,6
60789,1,2483,2404,79,0,206,0,6
60790,2,2668,2492,176,0,255,0,6
60791,1,2600,2599,1,0,310,0,6
60792,2,2401,2455,-54,0,250,0,6
60793,1,2460,2520,-60,0,330,0,6
60794,1,2450,2515,-65,0,387,0,6
60795,1,2730,2551,179,0,245,0,6
60796,2,2316,2529,-213,0,301,0,6
60797,1,2576,2524,52,0,45,0,6
60798,1,2435,2369,66,0,122,0,6
60799,2,2507,2566,-59,0,36,1,6
60800,1,2406,2324,82,0,227,0,6
60801,2,2204,2514,-310,0,332,0,7
60802,2,2564,2419,145,0,190,0,6
60803,1,2531,2341,190,0,177,0,6
60804,1,2466,2553,-87,0,56,0,6
60805,2,2401,2467,-66,0,10,0,6
60806,1,2416,2300,116,0,106,0,6
60807,3,2394,2456,-62,0,123,0,6
60808,3,2691,2675,16,0,46,0,6
60809,1,2801,2502,299,0,145,1,6
60810,2,2297,2543,-246,0,424,0,6
60811,1,2617,2444,173,0,133,0,6
60812,2,2365,2437,-72,0,332,0,6
60813,2,2714,2588,126,0,200,0,6
60814,1,2629,2475,154,0,48,0,6
60815,2,2574,2821,-247,0,203,0,6
60816,2,2555,2656,-101,0,5,0,6
60817,3,2475,2502,-27,0,0,0,6
60818,1,2478,2544,-66,0,466,0,6
60819,1,2371,2452,-81,0,301,0,6
60820,2,2414,2384,30,0,1,0,6
60821,1,2432,2443,-11,0,14,0,6
60822,1,2472,2411,61,0,6,0,6
60823,1,2366,2475,-109,0,428,1,6
60824,1,2463,2390,73,4,115,0,18
60825,1,2649,2721,-72,0,260,0,6
60826,2,2408,2468,-60,0,113,1,6
60827,1,2565,2207,358,0,315,0,6
60828,2,2464,2443,21,0,5,0,6
60829,2,2304,2539,-235,0,132,0,6
60830,3,2572,2550,22,0,106,0,6
60831,1,2388,2454,-66,0,278,0,6
60832,1,2517,2495,22,0,303,0,6
60833,1,2426,2482,-56,0,201,0,6
60835,1,2407,2585,-178,0,250,0,6
60836,2,2484,2273,211,0,140,0,6
60837,1,2548,2374,174,0,200,0,6
60838,3,2420,2460,-40,0,394,0,6
60839,2,2663,2661,2,0,7,0,6
60840,1,2423,2612,-189,0,200,1,6
60841,1,2412,2416,-4,0,153,0,6
60842,2,2483,2423,60,0,8,0,6
60843,3,2508,2504,4,0,411,0,6
60844,1,2433,2324,109,0,106,0,6
60845,2,2588,2532,56,0,211,0,6
60846,2,2475,2345,130,0,256,0,6
60847,2,2438,2446,-8,0,457,0,6
60848,2,2265,2537,-272,0,123,0,6
60849,2,2298,2441,-143,0,40,0,6
60850,2,2342,2547,-205,0,6,0,6
60851,2,2527,2629,-102,0,0,0,6
60852,2,2384,2453,-69,0,201,0,6
60853,1,2587,2499,88,0,125,1,6
60854,1,2602,2432,170,0,469,0,6
60855,2,2466,2480,-14,0,40,1,6
60856,1,2639,2490,149,0,15,0,6
60857,1,2390,2619,-229,0,311,0,6
60858,1,2275,2495,-220,0,15,0,6
60859,2,2439,2443,-4,0,7,0,6
60860,1,2438,2381,57,0,37,0,6
60861,3,2647,2558,89,0,332,0,6
60862,2,2521,2668,-147,0,112,1,6
60863,2,2247,2465,-218,0,138,0,6
60864,1,2614,2580,34,0,45,0,6
60865,2,2433,2404,29,0,426,1,6
60866,2,2437,2530,-93,0,148,0,6
60867,1,2471,2388,83,0,211,1,6
60868,1,2413,2246,167,0,45,1,6
60869,2,2236,2448,-212,0,400,0,8
60870,2,2514,2681,-167,0,147,0,6
60871,2,2653,2733,-80,0,47,1,6
60872,2,2432,2457,-25,0,300,0,6
60873,2,2508,2709,-201,0,140,0,6
60874,1,2483,2390,93,0,278,0,6
60875,2,2654,2697,-43,0,338,0,6
60876,2,2313,2408,-95,0,300,0,6
60877,1,2510,2358,152,0,1,1,6
60878,1,2684,2611,73,0,211,0,6
60879,1,2482,2428,54,0,313,0,6
60880,2,2481,2300,181,0,210,1,6
60881,2,2410,2331,79,0,123,0,6
60882,2,2443,2376,67,0,101,1,6
60883,1,2514,2551,-37,0,4,0,6
60884,1,2472,2334,138,0,143,0,6
60885,2,2469,2633,-164,0,278,0,6
60886,1,2568,2536,32,0,103,0,6
60887,1,2577,2406,171,0,443,0,6
60888,2,2501,2571,-70,0,101,0,6
60889,2,2279,2416,-137,0,106,0,6
60890,1,2484,2399,85,0,331,0,6
60891,1,2660,2566,94,0,8,0,6
60892,2,2204,2462,-258,0,4,1,6
60893,2,2592,2547,45,0,0,1,6
60894,1,2824,2659,165,0,6,0,6
60895,1,2307,2437,-130,0,302,1,8
60896,1,2402,2435,-33,0,10,0,6
60897,1,2544,2484,60,0,112,0,6
60898,1,2502,2484,18,0,120,0,6
60899,1,2527,2451,76,0,108,1,6
60900,3,2375,2440,-65,0,385,0,6
60901,1,2408,2418,-10,0,46,0,6
60902,2,2530,2445,85,0,209,1,6
60903,3,2724,2664,60,0,330,0,6
60904,1,2630,2577,53,0,49,0,6
60905,1,2568,2513,55,0,441,0,6
60906,2,2275,2420,-145,0,121,0,6
60907,2,2591,2728,-137,0,474,0,6
60908,2,2388,2455,-67,0,123,0,6
60909,2,2396,2454,-58,0,21,0,6
60910,1,2420,2350,70,0,0,0,6
60911,2,2435,2620,-185,0,28,1,6
60912,2,2472,2502,-30,0,101,0,6
60913,2,2448,2318,130,0,58,1,6
60914,2,2571,2690,-119,0,152,0,6
60915,1,2621,2606,15,0,127,0,6
60916,1,2404,2519,-115,0,106,0,6
60917,3,2551,2593,-42,0,7,0,6
60918,2,2375,2444,-69,0,46,0,6
60919,2,2365,2424,-59,0,18,0,6
60920,1,2307,2451,-144,0,107,1,8
60921,2,2346,2523,-177,0,4,0,6
60922,1,2205,2463,-258,0,40,0,6
60923,1,2702,2681,21,0,129,0,6
60924,2,2619,2715,-96,0,153,0,6
60925,2,2489,2532,-43,0,102,0,6
60926,1,2539,2583,-44,0,111,0,6
60927,2,2575,2649,-74,0,43,1,6
60928,2,2739,2703,36,0,278,1,6
60929,1,2733,2313,420,0,103,0,6
60930,2,2548,2325,223,0,245,1,6
60931,3,2675,2616,59,0,148,0,6
60932,1,2503,2480,23,0,334,0,6
60933,1,2550,2429,121,0,406,1,6
60934,1,2483,2416,67,0,45,0,6
60935,1,2550,2433,117,0,462,0,6
60936,1,2441,2534,-93,0,30,0,6
60937,1,2580,2607,-27,0,245,0,6
60938,1,2581,2646,-65,0,253,0,6
60939,3,2402,2381,21,0,248,0,6
60940,2,2417,2620,-203,0,400,0,6
60941,1,2554,2464,90,0,8,0,6
60942,1,2543,2422,121,0,150,0,6
60943,2,2546,2709,-163,0,300,0,6
60944,2,2509,2582,-73,0,100,0,6
60945,2,2495,2473,22,0,45,0,6
60946,2,2529,2573,-44,0,301,1,6
60947,1,2572,2503,69,0,101,0,6
60948,2,2400,2422,-22,0,43,0,6
60949,1,2425,2394,31,0,110,0,6
60950,1,2714,2520,194,0,57,0,6
60951,3,2513,2442,71,0,6,0,6
60952,2,2479,2384,95,0,335,1,6
60953,1,2501,2544,-43,0,130,1,6
60954,2,2541,2567,-26,0,300,0,6
60955,2,2498,2612,-114,0,111,1,6
60956,1,2546,2284,262,0,132,1,6
60957,1,2391,2408,-17,0,4,0,6
60958,1,2442,2506,-64,0,107,0,6
60959,2,2338,2534,-196,0,343,0,6
60960,1,2400,2393,7,0,211,1,6
60961,1,2543,2398,145,0,190,0,6
60962,1,2520,2351,169,0,40,0,6
60963,2,2356,2471,-115,0,15,0,6
60964,1,2705,2427,278,0,130,0,6
60965,1,2442,2259,183,0,112,1,6
60966,2,2596,2559,37,0,131,1,6
60967,1,2412,2404,8,0,35,1,6
60968,1,2288,2423,-135,0,207,0,6
60969,2,2486,2463,23,0,0,0,6
60970,2,2215,2475,-260,0,300,0,6
60971,2,2473,2460,13,0,300,0,6
60972,1,2454,2308,146,0,424,0,6
60973,2,2468,2383,85,0,145,0,6
60974,3,2352,2460,-108,0,49,0,6
60975,2,2455,2217,238,0,145,0,6
60976,1,2501,2437,64,0,201,0,6
60977,2,2320,2515,-195,0,454,0,6
60978,2,2406,2445,-39,0,45,0,6
60979,1,2572,2580,-8,0,200,0,6
60980,1,2458,2487,-29,0,8,0,6
60981,1,2588,2582,6,0,60,0,6
60982,2,2467,2734,-267,0,4,0,6
60983,1,2732,2635,97,0,201,1,6
60984,2,2360,2458,-98,0,57,0,6
60985,1,2470,2202,268,0,311,0,6
60986,1,2453,2567,-114,0,100,0,6
60987,1,2449,2456,-7,0,15,0,6
60988,2,2539,2403,136,0,400,0,6
60989,1,2508,2474,34,0,211,0,6
60990,1,2480,2548,-68,0,4,1,6
60991,1,2460,2449,11,0,426,0,6
60992,1,2434,2396,38,0,311,1,6
60993,2,2475,2290,185,0,130,1,6
60994,1,2449,2573,-124,0,15,0,6
60995,2,2451,2399,52,0,1,0,6
60997,1,2513,2644,-131,0,14,0,6
60998,3,2501,2339,162,0,404,0,6
60999,1,2532,2413,119,0,45,0,6
61000,3,2551,2703,-152,0,373,0,6
61001,2,2479,2496,-17,0,57,0,6
61002,2,2531,2526,5,0,49,0,6
61003,1,2556,2215,341,0,11,0,6
61004,1,2592,2574,18,0,46,0,6
61005,2,2656,2648,8,0,220,0,6
61006,3,2469,2576,-107,0,43,0,6
61007,1,2489,2432,57,0,338,0,6
61008,1,2666,2827,-161,0,106,0,6
61009,1,2358,2414,-56,0,0,1,6
61010,2,2411,2375,36,0,4,0,6
61011,2,2424,2400,24,0,0,0,6
61012,1,2603,2449,154,0,400,0,6
61013,1,2486,2343,143,0,4,0,6
61014,1,2737,2657,80,0,301,0,6
61015,2,2396,2414,-18,0,116,0,6
61016,1,2634,2523,111,0,40,0,6
61017,1,2501,2450,51,0,415,1,6
61018,1,2587,2717,-130,0,0,0,6
61019,2,2517,2578,-61,0,453,0,6
61020,1,2552,2445,107,0,60,0,6
61021,1,2537,2391,146,0,278,0,6
61022,2,2459,2485,-26,0,128,0,6
61023,1,2505,2414,91,0,120,0,6
61024,1,2575,2434,141,0,61,0,6
61025,3,2515,2470,45,0,142,0,7
61026,1,2606,2674,-68,0,46,0,6
61027,3,2617,2507,110,0,123,0,6
61028,2,2499,2377,122,0,101,0,6
61029,3,2636,2504,132,0,100,0,6
61030,2,2396,2452,-56,0,153,0,6
61031,1,2430,2465,-35,0,245,0,6
61032,1,2454,2477,-23,0,242,0,6
61033,1,2487,2408,79,0,40,1,6
61034,2,2432,2443,-11,0,46,1,6
61035,1,2486,2282,204,0,242,0,6
61036,2,2486,2508,-22,0,123,1,6
61037,1,2457,2373,84,0,100,0,6
61038,2,2429,2360,69,0,0,0,6
61039,2,2654,2707,-53,0,131,0,6
61040,1,2479,2570,-91,0,335,0,6
61041,2,2675,2593,82,0,48,1,6
61042,2,2511,2415,96,0,1,1,6
61044,1,2576,2330,246,0,143,0,6
61045,1,2469,2388,81,0,255,0,6
61046,2,2538,2489,49,0,8,0,6
61047,1,2464,2234,230,0,404,0,6
61048,2,2412,2476,-64,0,278,0,6
61049,1,2551,2371,180,0,110,0,6
61050,2,2499,2577,-78,0,101,0,6
61051,1,2428,2606,-178,0,150,0,6
61052,2,2428,2408,20,0,140,1,6
61053,1,2518,2474,44,0,215,0,6
61054,1,2671,2546,125,0,7,1,6
61055,2,2562,2689,-127,0,310,0,6
61056,2,2610,2317,293,0,106,1,6
61057,2,2305,2410,-105,0,45,1,6
61058,2,2537,2577,-40,0,125,0,6
61059,1,2397,2426,-29,0,8,0,6
61060,2,2282,2404,-122,0,171,1,6
61061,1,2458,2212,246,0,202,0,6
61062,1,2478,2484,-6,0,0,0,6
61063,2,2665,2576,89,0,4,0,6
61064,3,2665,2723,-58,0,125,0,6
61065,1,2517,2399,118,0,106,0,6
61066,1,2417,2343,74,0,9,1,6
61067,2,2411,2488,-77,0,45,0,6
61068,2,2270,2437,-167,0,62,0,6
61069,3,2320,2494,-174,0,40,0,6
61070,2,2490,2624,-134,0,15,0,6
61071,2,2511,2581,-70,0,103,0,6
61072,1,2578,2513,65,0,43,0,6
61073,1,2430,2506,-76,0,193,0,6
61074,2,2418,2521,-103,0,13,1,6
61075,1,2450,2616,-166,0,110,1,6
61076,1,2507,2712,-205,0,120,1,6
61077,2,2496,2568,-72,0,300,0,6
61079,2,2459,2494,-35,0,345,0,6
61080,2,2532,2601,-69,0,48,1,6
61081,1,2694,2531,163,0,48,0,6
61082,1,2455,2296,159,0,15,1,6
61083,1,2502,2583,-81,0,228,0,6
61084,1,2568,2511,57,0,138,0,6
61085,2,2433,2272,161,0,201,0,6
61086,2,2627,2598,29,0,299,0,6
61087,1,2398,2558,-160,0,123,0,6
61088,2,2632,2525,107,0,20,0,6
61089,1,2439,2384,55,0,201,0,6
61090,1,2383,2437,-54,0,241,0,6
61091,1,2456,2460,-4,0,4,0,6
61092,1,2463,2389,74,0,4,0,6
61093,2,2574,2737,-163,0,106,0,6
61094,1,2431,2358,73,0,40,0,6
61095,2,2539,2461,78,0,15,0,6
61096,1,2392,2449,-57,0,305,1,6
61097,1,2470,2271,199,0,61,0,6
61098,2,2712,2465,247,0,1,0,6
61099,1,2355,2558,-203,0,46,0,6
61100,1,2334,2436,-102,0,255,0,6
61101,1,2356,2514,-158,0,58,1,6
61102,2,2356,2676,-320,0,200,0,6
61103,2,2337,2543,-206,0,101,0,6
61104,1,2352,2459,-107,0,20,0,6
61105,1,2554,2467,87,0,111,0,6
61106,1,2402,2336,66,0,191,0,6
61107,1,2200,2405,-205,0,115,0,6
61108,1,2732,2668,64,0,487,0,6
61109,2,2292,2401,-109,0,336,1,6
61110,2,2466,2613,-147,0,300,1,6
61111,1,2639,2615,24,0,333,0,6
61112,1,2623,2481,142,0,138,1,6
61113,1,2414,2445,-31,0,83,1,6
61114,1,2406,2432,-26,0,320,0,6
61115,2,2719,2588,131,0,241,0,6
61116,1,2573,2434,139,0,210,0,6
61117,1,2527,2536,-9,0,5,0,6
61118,1,2623,2466,157,0,46,1,6
61119,2,2412,2446,-34,0,57,0,6
61120,1,2452,2523,-71,0,101,0,6
61121,1,2620,2531,89,0,341,0,6
61122,1,2227,2439,-212,0,110,0,6
61123,1,2537,2335,202,0,132,0,6
61124,3,2396,2480,-84,0,4,0,6
61125,2,2307,2407,-100,0,300,0,6
61126,2,2354,2524,-170,0,40,0,6
61127,2,2369,2477,-108,0,487,0,6
61128,2,2509,2595,-86,0,100,0,6
61129,1,2578,2410,168,0,344,0,6
61130,1,2506,2425,81,0,131,0,6
61131,2,2654,2742,-88,0,47,0,6
61132,2,2615,2698,-83,0,300,1,6
61133,2,2653,2650,3,0,455,0,6
61134,1,2459,2360,99,0,160,0,6
61135,3,2709,2803,-94,0,426,0,6
61136,3,2528,2708,-180,0,302,0,6
61137,1,2573,2509,64,0,100,0,6
61138,1,2475,2508,-33,0,337,0,6
61139,2,2475,2319,156,0,131,0,6
61140,1,2546,2518,28,0,110,0,6
61141,2,2207,2607,-400,0,300,0,6
61142,2,2547,2471,76,0,205,1,6
61143,2,2396,2418,-22,0,123,1,6
61144,1,2480,2493,-13,0,106,0,6
61145,1,2349,2441,-92,0,125,0,6
61146,1,2427,2407,20,0,190,0,6
61147,1,2492,2391,101,0,200,0,6
61148,3,2468,2260,208,0,4,0,6
61149,2,2445,2385,60,0,101,1,6
61150,2,2478,2319,159,0,20,0,6
61151,1,2570,2401,169,0,111,0,6
61152,2,2407,2512,-105,0,14,1,6
61153,1,2802,2734,68,0,45,0,6
61154,2,2490,2335,155,0,4,0,6
61155,1,2546,2456,90,0,300,0,6
61156,2,2443,2468,-25,0,218,0,6
61157,1,2340,2461,-121,0,28,0,6
61158,1,2491,2554,-63,0,45,0,6
61159,2,2710,2736,-26,0,45,0,6
61160,2,2572,2563,9,0,206,0,6
61161,2,2630,2675,-45,0,389,1,6
61162,1,2351,2418,-67,0,106,0,6
61163,2,2700,2711,-11,0,260,1,6
61164,2,2565,2474,91,0,394,1,6
61165,2,2532,2487,45,0,141,0,6
61166,2,2395,2527,-132,0,127,0,6
61167,2,2451,2429,22,0,211,0,6
61168,1,2421,2266,155,0,45,0,6
61169,1,2280,2489,-209,0,113,0,6
61170,1,2580,2656,-76,0,123,0,6
61171,1,2559,2235,324,0,45,0,6
61172,2,2279,2549,-270,0,140,0,6
61173,2,2819,2713,106,0,5,0,6
61174,1,2276,2425,-149,0,200,0,6
61175,2,2431,2393,38,0,140,0,6
61176,1,2511,2531,-20,0,207,0,6
61178,2,2499,2357,142,0,100,1,6
61179,2,2432,2280,152,0,0,0,6
61180,3,2509,2675,-166,0,115,0,6
61181,1,2445,2271,174,0,200,0,6
61182,2,2411,2508,-97,0,101,1,6
61183,1,2394,2454,-60,0,125,0,6
61184,1,2701,2414,287,0,302,1,6
61185,2,2420,2525,-105,0,300,0,6
61186,3,2389,2506,-117,0,211,0,6
61187,1,2459,2394,65,0,110,0,6
61188,1,2387,2447,-60,0,122,0,6
61189,3,2434,2316,118,0,380,0,6
61190,2,2542,2487,55,0,0,0,6
61191,1,2621,2464,157,0,15,0,6
61192,1,2514,2439,75,0,4,0,6
61193,1,2568,2426,142,0,46,0,6
61194,3,2590,2523,67,0,260,0,6
61195,1,2540,2454,86,0,116,1,6
61196,1,2430,2389,41,0,101,0,6
61197,3,2510,2220,290,0,0,0,6
61198,2,2469,2437,32,0,61,0,6
61199,1,2252,2466,-214,0,15,0,6
61200,2,2566,2722,-156,0,246,0,6
61201,2,2533,2513,20,0,123,1,6
61202,3,2467,2579,-112,0,5,0,6
61203,2,2499,2481,18,0,113,0,6
61204,2,2588,2666,-78,0,57,0,6
61205,3,2551,2625,-74,0,111,0,6
61206,2,2519,2638,-119,0,4,0,6
61207,2,2426,2554,-128,0,255,1,6
61208,1,2428,2375,53,4,344,0,13
61209,2,2451,2238,213,0,4,0,8
61210,1,2417,2554,-137,0,120,0,6
61211,3,2486,2511,-25,0,56,0,6
61212,1,2672,2473,199,0,112,0,6
61213,1,2385,2412,-27,0,246,0,6
61214,2,2678,2364,314,0,41,0,6
61215,1,2499,2351,148,0,210,0,6
61216,3,2414,2321,93,0,207,0,6
61217,2,2425,2354,71,0,45,1,6
61218,1,2563,2387,176,0,177,0,6
61219,2,2414,2422,-8,0,2,0,6
61220,2,2289,2473,-184,0,120,0,8
61221,1,2477,2467,10,0,6,0,6
61222,2,2585,2667,-82,0,101,1,6
61223,2,2472,2364,108,0,115,1,6
61224,2,2432,2499,-67,0,153,0,6
61225,1,2656,2650,6,0,302,0,6
61226,1,2467,2279,188,0,43,0,6
61227,1,2617,2668,-51,0,310,0,6
61228,1,2483,2406,77,0,0,1,6
61229,2,2740,2463,277,0,101,0,6
61230,1,2746,2605,141,0,301,0,6
61231,2,2222,2453,-231,0,382,1,6
61232,2,2583,2571,12,0,101,0,6
61233,2,2422,2433,-11,0,233,0,6
61234,2,2504,2373,131,0,1,0,6
61235,2,2402,2550,-148,0,168,0,6
61236,1,2404,2556,-152,0,1,0,6
61237,1,2658,2647,11,0,5,1,6
61238,1,2608,2479,129,0,49,0,6
61239,1,2597,2625,-28,0,406,1,6
61240,2,2492,2407,85,0,45,0,6
61241,1,2462,2342,120,0,40,0,6
61242,1,2531,2369,162,0,110,0,6
61243,2,2429,2430,-1,0,122,0,8
61244,2,2332,2533,-201,0,130,0,6
61245,3,2703,2454,249,0,1,0,6
61246,1,2417,2401,16,0,156,0,6
61247,2,2268,2490,-222,0,301,0,6
61248,3,2473,2737,-264,0,45,0,6
61249,1,2730,2531,199,0,110,0,6
61250,2,2457,2464,-7,0,288,0,6
61251,1,2542,2255,287,0,39,0,6
61252,2,2663,2474,189,0,127,0,6
61253,2,2705,2645,60,0,156,0,6
61254,2,2383,2471,-88,0,13,1,6
61255,3,2615,2599,16,0,100,0,6
61256,2,2530,2376,154,0,127,0,6
61257,1,2409,2470,-61,0,150,1,6
61258,1,2443,2238,205,0,200,0,8
61259,3,2429,2634,-205,0,253,0,6
61260,1,2452,2341,111,0,6,0,6
61261,1,2506,2449,57,0,121,1,6
61262,1,2427,2450,-23,0,48,0,6
61263,3,2662,2505,157,0,46,0,6
61264,2,2416,2550,-134,0,301,0,6
61265,2,2705,2623,82,0,302,0,6
61266,2,2419,2270,149,0,200,0,6
61267,2,2529,2611,-82,0,36,0,6
61268,3,2203,2438,-235,0,315,0,7
61269,3,2414,2422,-8,0,459,0,6
61270,2,2504,2493,11,0,120,0,6
61271,1,2387,2403,-16,0,122,0,6
61272,1,2423,2601,-178,0,144,1,6
61273,2,2420,2561,-141,0,310,0,6
61274,2,2577,2596,-19,0,241,0,6
61275,2,2327,2496,-169,0,201,0,6
61276,3,2578,2498,80,0,101,0,6
61277,1,2487,2553,-66,0,109,0,6
61278,1,2233,2571,-338,0,305,0,6
61279,1,2521,2388,133,0,256,0,6
61280,2,2578,2712,-134,0,101,0,6
61281,1,2445,2346,99,0,40,0,6
61282,2,2492,2323,169,0,300,0,6
61283,1,2435,2450,-15,0,112,0,6
61284,1,2348,2444,-96,0,1,1,6
61285,2,2604,2659,-55,0,312,0,6
61286,1,2436,2293,143,0,80,0,6
61287,3,2670,2587,83,0,255,0,6
61288,2,2379,2421,-42,0,311,0,6
61289,2,2527,2532,-5,0,46,0,6
61290,1,2582,2605,-23,0,380,0,6
61291,1,2412,2421,-9,0,255,0,6
61292,2,2527,2458,69,0,301,1,6
61293,2,2442,2351,91,0,1,1,6
61294,1,2507,2584,-77,0,106,0,6
61295,2,2558,2621,-63,0,162,0,6
61296,2,2397,2496,-99,0,106,0,6
61297,1,2582,2627,-45,0,200,0,6
61298,1,2452,2285,167,0,8,0,6
61299,2,2642,2515,127,0,95,0,6
61300,1,2544,2217,327,0,130,0,6
61301,2,2225,2587,-362,0,192,0,6
61302,1,2499,2516,-17,0,101,0,6
61303,2,2525,2498,27,0,60,1,6
61304,1,2473,2406,67,0,190,0,6
61305,1,2463,2566,-103,0,310,1,6
61306,1,2414,2459,-45,0,337,1,6
61307,3,2608,2363,245,0,405,0,6
61308,1,2365,2525,-160,0,0,0,6
61309,3,2705,2581,124,0,13,0,6
61310,1,2442,2342,100,0,46,0,6
61311,3,2438,2399,39,0,218,0,6
61312,2,2720,2569,151,0,202,0,6
61313,2,2444,2517,-73,0,135,0,6
61314,2,2358,2492,-134,0,244,0,6
61315,3,2649,2812,-163,0,0,0,6
61316,2,2549,2276,273,0,43,0,6
61317,2,2450,2359,91,0,394,0,6
61318,1,2277,2445,-168,0,201,1,6
61319,2,2288,2463,-175,0,45,0,6
61320,2,2356,2457,-101,0,373,1,6
61321,3,2405,2277,128,0,124,0,6
61322,2,2462,2627,-165,0,1,0,6
61323,2,2680,2675,5,0,7,0,6
61324,1,2512,2615,-103,0,4,0,6
61327,1,2551,2364,187,0,200,0,6
61328,2,2227,2470,-243,0,320,0,6
61329,1,2402,2525,-123,0,200,1,6
61330,1,2566,2488,78,0,110,0,6
61331,2,2347,2427,-80,0,123,1,6
61332,2,2333,2540,-207,0,199,0,6
61333,3,2535,2425,110,0,112,0,6
61334,2,2546,2513,33,0,101,0,6
61335,1,2516,2389,127,0,32,1,6
61336,2,2460,2527,-67,0,15,0,6
61337,1,2528,2562,-34,0,7,0,6
61338,2,2554,2519,35,0,0,1,6
61339,1,2519,2626,-107,0,338,0,6
61340,2,2430,2506,-76,0,31,1,6
61341,1,2644,2733,-89,0,302,0,6
61342,1,2391,2576,-185,0,246,0,6
61343,2,2406,2426,-20,0,300,0,6
61344,2,2725,2662,63,0,460,0,6
61345,2,2434,2627,-193,0,50,0,6
61346,3,2461,2347,114,0,177,0,6
61347,1,2424,2302,122,0,462,1,6
61348,1,2430,2506,-76,0,45,0,6
61349,1,2384,2435,-51,0,263,0,6
61350,2,2293,2455,-162,0,106,0,6
61351,1,2486,2467,19,0,4,0,6
61352,1,2577,2412,165,0,206,0,6
61353,1,2385,2488,-103,0,10,1,6
61354,1,2602,2589,13,0,56,1,6
61355,2,2506,2493,13,0,100,0,6
61356,1,2365,2448,-83,0,121,0,6
61357,2,2729,2663,66,0,112,0,6
61358,2,2325,2415,-90,0,300,0,6
61359,2,2630,2669,-39,0,466,0,6
61360,1,2493,2482,11,0,145,0,6
61361,3,2318,2417,-99,0,106,0,6
61362,1,2668,2313,355,0,40,0,6
61363,3,2715,2525,190,0,101,0,6
61364,1,2806,2750,56,0,102,1,6
61365,1,2608,2574,34,0,226,0,6
61366,1,2391,2517,-126,0,46,0,6
61367,2,2343,2486,-143,0,250,0,6
61368,1,2439,2334,105,0,140,0,6
61369,1,2641,2520,121,0,373,1,6
61370,2,2434,2332,102,0,405,1,6
61371,1,2502,2481,21,0,398,0,6
61372,2,2245,2401,-156,0,101,0,6
61373,2,2441,2376,65,0,110,0,6
61374,1,2377,2418,-41,0,311,0,6
61375,1,2509,2290,219,0,311,0,6
61376,1,2546,2703,-157,0,310,1,6
61377,1,2412,2413,-1,0,13,0,6
61378,1,2450,2457,-7,0,41,0,6
61379,2,2544,2699,-155,0,130,1,6
61380,1,2540,2354,186,0,176,0,6
61381,1,2495,2401,94,0,122,1,6
61382,2,2554,2494,60,0,45,0,6
61383,1,2490,2423,67,0,311,0,6
61385,2,2243,2407,-164,0,106,0,6
61386,2,2243,2424,-181,0,28,1,6
61387,1,2444,2441,3,0,205,0,6
61388,1,2621,2552,69,0,46,0,6
61389,2,2695,2698,-3,0,145,1,6
61390,2,2602,2729,-127,0,13,0,6
61391,1,2493,2538,-45,0,405,1,6
61392,3,2652,2571,81,0,70,0,6
61393,2,2516,2499,17,0,61,0,6
61394,1,2481,2438,43,0,1,0,6
61395,1,2664,2572,92,0,46,0,6
61396,3,2422,2465,-43,0,210,0,6
61397,1,2480,2522,-42,0,130,0,6
61398,2,2558,2417,141,0,50,0,6
61399,2,2500,2599,-99,0,300,0,6
61400,1,2402,2265,137,0,61,1,6
61401,1,2564,2394,170,0,400,0,6
61402,2,2289,2417,-128,0,259,0,6
61403,1,2697,2577,120,0,4,0,6
61404,1,2478,2522,-44,0,190,0,6
61405,1,2402,2324,78,0,15,0,6
61406,2,2535,2247,288,0,4,0,6
61407,2,2428,2409,19,0,84,0,6
61408,1,2654,2439,215,0,0,0,6
61409,1,2483,2484,-1,0,306,0,6
61410,1,2361,2400,-39,0,332,1,6
61411,1,2577,2613,-36,0,463,0,6
61412,1,2475,2471,4,0,143,1,6
61413,1,2556,2514,42,0,125,0,6
61414,2,2377,2440,-63,0,445,1,6
61415,2,2431,2510,-79,0,21,1,6
61416,2,2244,2411,-167,0,224,1,6
61417,1,2555,2393,162,0,111,1,6
61418,1,2399,2612,-213,0,302,1,6
61419,1,2522,2569,-47,0,263,0,6
61420,2,2476,2588,-112,0,300,0,6
61422,1,2733,2517,216,0,340,0,6
61423,2,2462,2351,111,0,210,0,6
61424,1,2652,2704,-52,0,108,0,6
61425,2,2397,2434,-37,0,245,0,6
61426,1,2399,2410,-11,0,36,0,6
61427,1,2599,2456,143,0,28,0,6
61428,2,2325,2451,-126,0,150,0,6
61429,2,2524,2588,-64,0,142,0,6
61430,2,2337,2424,-87,0,143,1,6
61431,1,2459,2581,-122,0,102,1,6
61432,2,2475,2445,30,0,100,0,6
61433,1,2671,2553,118,0,248,0,6
61434,2,2534,2427,107,0,200,0,6
61435,2,2398,2466,-68,0,40,0,6
61436,1,2763,2382,381,0,302,0,6
61437,2,2328,2540,-212,0,354,0,6
61438,2,2441,2393,48,0,45,0,6
61439,2,2412,2293,119,0,123,0,6
61440,2,2701,2487,214,0,191,0,6
61441,1,2403,2225,178,0,124,0,6
61442,2,2674,2615,59,0,14,0,6
61443,2,2435,2372,63,0,1,0,6
61444,2,2681,2511,170,0,244,1,6
61445,1,2432,2339,93,0,190,0,6
61446,1,2599,2473,126,0,0,1,6
61447,2,2623,2712,-89,0,46,0,6
61448,1,2528,2473,55,0,255,0,6
61449,1,2417,2235,182,0,58,0,6
61450,2,2366,2494,-128,0,40,0,6
61451,2,2433,2346,87,0,305,0,6
61452,2,2211,2411,-200,0,146,0,6
61453,2,2395,2510,-115,0,113,0,6
61454,1,2505,2511,-6,0,200,0,6
61455,2,2631,2454,177,0,131,0,6
61456,3,2531,2573,-42,0,200,0,6
61457,1,2562,2719,-157,0,112,0,6
61458,2,2604,2378,226,0,484,0,6
61459,2,2669,2528,141,0,123,1,6
61461,1,2444,2433,11,0,4,1,6
61462,2,2414,2485,-71,0,457,0,6
61463,1,2450,2331,119,0,331,0,6
61464,1,2543,2330,213,0,244,0,6
61465,2,2619,2604,15,0,190,1,6
61466,1,2540,2367,173,0,200,0,6
61467,1,2526,2449,77,0,150,1,6
61468,2,2561,2669,-108,0,1,0,6
61469,2,2670,2625,45,0,6,0,6
61470,1,2451,2480,-29,0,106,0,6
61471,1,2577,2509,68,0,45,0,6
61472,1,2456,2392,64,0,335,0,6
61473,1,2567,2535,32,0,103,0,6
61474,2,2568,2407,161,0,315,0,6
61475,2,2446,2391,55,0,337,1,6
61476,3,2338,2412,-74,0,455,0,6
61477,2,2225,2504,-279,0,300,0,6
61478,3,2475,2502,-27,0,4,0,6
61479,3,2373,2437,-64,0,49,0,6
61480,1,2674,2712,-38,0,253,0,6
61481,1,2461,2379,82,0,432,0,6
61482,1,2400,2391,9,0,304,0,6
61483,2,2409,2366,43,0,418,0,6
61484,1,2465,2407,58,0,400,0,6
61485,1,2657,2470,187,0,216,0,6
61486,2,2515,2603,-88,0,36,0,6
61487,2,2437,2505,-68,0,100,0,6
61488,2,2398,2720,-322,0,121,0,6
61489,1,2289,2521,-232,0,207,1,6
61490,2,2583,2811,-228,0,395,0,6
61491,2,2583,2607,-24,0,102,1,6
61492,2,2294,2504,-210,0,15,0,6
61493,2,2453,2519,-66,0,345,0,6
61494,2,2516,2388,128,0,277,0,6
61495,2,2745,2607,138,0,122,0,6
61496,1,2385,2404,-19,0,201,1,6
61497,2,2418,2487,-69,0,110,0,6
61498,1,2464,2470,-6,0,123,0,6
61499,2,2429,2391,38,0,150,1,6
61500,2,2458,2323,135,0,5,1,6
61501,1,2317,2426,-109,0,6,0,6
61502,1,2464,2303,161,0,103,0,6
61503,1,2704,2652,52,0,45,0,6
61504,2,2496,2668,-172,0,331,0,6
61505,2,2274,2511,-237,0,1,0,6
61506,2,2416,2458,-42,0,110,0,6
61507,2,2622,2690,-68,0,153,0,6
61508,1,2397,2431,-34,0,125,0,6
61509,3,2466,2500,-34,0,107,0,6
61510,1,2583,2484,99,0,371,0,6
61511,2,2515,2418,97,0,302,0,6
61512,1,2604,2692,-88,0,308,0,6
61513,2,2630,2703,-73,0,191,0,6
61514,1,2726,2496,230,0,101,0,6
61515,2,2519,2502,17,0,400,1,6
61517,1,2432,2543,-111,0,144,0,6
61518,1,2285,2443,-158,0,301,0,6
61519,1,2499,2320,179,0,330,0,6
61520,1,2504,2505,-1,0,150,1,6
61521,1,2625,2582,43,0,260,0,6
61522,1,2592,2302,290,0,249,0,6
61523,2,2419,2351,68,0,395,1,6
61524,2,2405,2553,-148,0,404,0,6
61525,1,2510,2262,248,0,200,0,6
61526,2,2284,2506,-222,0,132,1,6
61527,1,2411,2238,173,0,41,0,6
61528,3,2558,2422,136,0,406,0,6
61529,3,2476,2446,30,0,224,0,8
61530,2,2389,2400,-11,0,270,1,6
61531,3,2455,2368,87,0,100,0,6
61532,1,2547,2488,59,0,106,0,6
61533,1,2311,2764,-453,0,101,0,6
61534,2,2335,2420,-85,0,242,0,6
61535,2,2378,2580,-202,0,288,0,6
61536,1,2592,2645,-53,0,178,0,6
61537,2,2437,2392,45,0,5,0,6
61538,2,2409,2452,-43,0,454,0,6
61539,2,2478,2476,2,0,0,0,6
61540,1,2516,2472,44,0,316,0,6
61541,1,2568,2439,129,0,184,0,6
61542,2,2437,2374,63,0,206,0,6
61544,1,2427,2469,-42,0,120,0,6
61545,3,2386,2442,-56,0,112,0,8
61546,2,2459,2356,103,0,106,0,6
61547,2,2210,2461,-251,0,101,1,6
61548,2,2405,2346,59,0,45,1,6
61549,2,2336,2410,-74,0,101,1,6
61550,1,2474,2279,195,0,41,1,6
61551,2,2433,2466,-33,0,277,0,6
61552,2,2268,2476,-208,0,242,0,6
61553,2,2598,2650,-52,0,162,0,6
61554,1,2733,2710,23,0,429,0,6
61555,1,2533,2527,6,0,121,0,6
61556,1,2509,2501,8,0,110,0,6
61557,1,2464,2283,181,0,4,0,6
61558,2,2502,2547,-45,0,1,0,6
61559,1,2572,2571,1,0,307,0,6
61560,1,2486,2432,54,0,146,0,6
61561,1,2530,2263,267,0,123,1,6
61562,2,2376,2520,-144,0,108,1,6
61563,2,2451,2483,-32,0,102,1,6
61564,1,2418,2208,210,0,392,0,6
61565,1,2269,2423,-154,0,135,0,8
61566,1,2673,2658,15,0,46,0,6
61567,1,2525,2339,186,0,125,1,6
61568,1,2490,2480,10,0,204,0,6
61569,2,2587,2519,68,0,405,0,6
61570,1,2510,2301,209,0,1,0,6
61571,2,2722,2557,165,0,202,1,6
61572,1,2351,2465,-114,0,141,0,6
61574,2,2481,2243,238,0,140,0,6
61575,1,2593,2493,100,0,101,0,6
61576,3,2321,2583,-262,0,123,0,6
61577,3,2698,2729,-31,0,0,0,6
61578,1,2432,2468,-36,0,131,1,6
61579,2,2462,2496,-34,0,224,0,6
61580,1,2476,2507,-31,0,28,0,6
61581,1,2362,2428,-66,0,426,0,6
61582,3,2452,2464,-12,0,198,0,6
61583,3,2499,2387,112,0,410,0,6
61584,2,2467,2510,-43,0,333,0,6
61585,2,2388,2411,-23,0,106,1,6
61586,1,2572,2607,-35,0,127,0,6
61587,1,2708,2425,283,0,242,0,6
61588,1,2814,2660,154,0,409,0,6
61589,2,2347,2595,-248,0,405,0,6
61590,1,2330,2625,-295,0,133,0,6
61591,1,2611,2581,30,0,106,0,6
61592,3,2512,2532,-20,0,102,0,6
61593,2,2323,2464,-141,0,115,0,6
61594,2,2422,2390,32,0,201,0,6
61595,2,2422,2363,59,0,40,0,6
61596,1,2219,2446,-227,0,123,0,6
61597,2,2357,2413,-56,0,211,1,6
61598,1,2559,2405,154,0,145,1,6
61599,1,2557,2554,3,0,106,0,6
61600,2,2255,2547,-292,0,38,1,6
61601,2,2529,2684,-155,0,7,0,6
61602,2,2468,2550,-82,0,428,0,6
61603,2,2247,2508,-261,0,40,0,6
61604,1,2491,2359,132,0,213,0,6
61605,1,2695,2404,291,0,302,0,6
61606,2,2403,2425,-22,0,50,0,6
61607,1,2578,2808,-230,0,109,0,6
61608,2,2321,2429,-108,0,80,1,6
61609,2,2423,2541,-118,0,4,0,6
61610,2,2743,2573,170,0,101,0,6
61611,2,2259,2703,-444,0,115,0,6
61612,1,2456,2298,158,0,43,0,6
61613,1,2422,2414,8,0,6,1,6
61614,1,2464,2415,49,0,190,0,6
61615,1,2430,2381,49,0,201,0,6
61616,2,2338,2419,-81,0,312,0,6
61617,1,2705,2577,128,0,301,0,6
61618,1,2469,2619,-150,0,354,0,6
61619,3,2647,2603,44,0,40,0,6
61620,2,2257,2427,-170,0,37,0,6
61621,1,2738,2709,29,0,300,1,6
61622,1,2736,2630,106,0,492,0,6
61623,2,2394,2670,-276,0,45,0,6
61624,2,2368,2526,-158,0,41,0,6
61625,1,2514,2388,126,0,210,0,6
61626,2,2221,2406,-185,0,103,0,6
61627,3,2710,2461,249,0,116,0,6
61628,2,2612,2717,-105,0,123,0,6
61629,1,2547,2626,-79,0,140,0,6
61630,2,2454,2393,61,0,11,0,6
61631,1,2426,2328,98,0,305,1,6
61632,1,2353,2420,-67,0,278,0,6
61633,2,2239,2502,-263,0,375,1,6
61634,1,2526,2525,1,0,277,0,6
61635,2,2415,2560,-145,0,4,0,6
61636,1,2468,2425,43,0,300,0,6
61637,1,2536,2521,15,0,101,1,6
61638,2,2706,2737,-31,0,104,0,6
61639,1,2430,2408,22,0,101,1,6
61640,2,2207,2415,-208,0,202,0,6
61641,1,2542,2420,122,0,16,0,6
61642,2,2458,2623,-165,0,4,0,6
61643,2,2375,2559,-184,0,302,0,6
61644,1,2633,2390,243,0,312,1,6
61645,1,2425,2423,2,0,263,1,6
61646,3,2615,2680,-65,0,310,0,6
61647,2,2436,2403,33,0,131,0,6
61648,1,2531,2508,23,0,102,1,6
61649,1,2398,2457,-59,0,124,0,6
61650,1,2445,2440,5,0,414,0,6
61651,1,2465,2603,-138,0,176,0,6
61652,1,2434,2452,-18,0,302,0,6
61653,1,2450,2545,-95,0,311,1,6
61654,1,2626,2333,293,0,7,1,6
61655,2,2495,2578,-83,0,106,0,6
61656,2,2565,2515,50,0,100,0,6
61657,2,2414,2326,88,0,207,1,6
61658,1,2499,2491,8,0,201,1,6
61659,1,2495,2462,33,0,205,0,6
61660,1,2474,2391,83,0,315,0,6
61661,1,2429,2458,-29,0,127,0,6
61662,2,2511,2495,16,0,365,0,6
61663,1,2475,2427,48,0,106,0,6
61664,2,2661,2678,-17,0,302,0,6
61665,3,2653,2510,143,0,341,0,6
61666,1,2325,2455,-130,0,123,0,6
61667,2,2490,2410,80,0,45,1,6
61668,2,2353,2414,-61,0,411,1,6
61669,1,2573,2549,24,0,220,1,6
61670,2,2418,2221,197,0,4,1,6
61671,3,2704,2516,188,0,338,0,6
61672,3,2526,2493,33,0,211,0,6
61673,1,2514,2594,-80,0,36,0,6
61674,1,2457,2405,52,0,218,0,6
61675,3,2671,2664,7,0,7,0,6
61676,2,2259,2534,-275,0,113,0,6
61677,1,2632,2575,57,0,41,0,6
61678,1,2688,2616,72,0,247,0,6
61679,1,2435,2301,134,0,200,0,6
61680,1,2392,2404,-12,0,205,0,6
61681,1,2385,2572,-187,0,269,0,6
61682,1,2328,2464,-136,0,123,1,6
61683,2,2519,2709,-190,0,117,0,6
61684,2,2672,2339,333,0,45,0,6
61685,1,2449,2502,-53,0,344,0,6
61686,2,2317,2427,-110,0,106,0,6
61687,2,2468,2467,1,0,49,0,6
61688,1,2679,2673,6,0,110,0,6
61689,1,2573,2477,96,0,300,0,6
61690,1,2611,2402,209,0,305,0,6
61691,1,2499,2320,179,0,106,0,6
61692,2,2470,2427,43,0,242,0,6
61693,2,2437,2356,81,0,122,1,6
61694,2,2364,2434,-70,0,460,0,6
61695,1,2406,2240,166,0,245,0,6
61696,1,2350,2401,-51,0,43,0,6
61697,2,2463,2344,119,0,111,0,6
61698,1,2536,2509,27,0,132,0,6
61699,1,2482,2511,-29,0,7,0,6
61700,1,2402,2448,-46,0,200,0,6
61701,1,2545,2555,-10,0,278,0,6
61702,1,2411,2350,61,0,1,0,6
61703,3,2524,2472,52,0,306,0,6
61704,2,2581,2616,-35,0,151,0,6
61705,2,2369,2439,-70,0,0,0,6
61706,3,2478,2463,15,0,45,0,6
61707,1,2734,2597,137,0,112,1,6
61708,1,2504,2507,-3,0,312,1,6
61709,2,2489,2484,5,0,106,1,6
61710,1,2453,2266,187,0,150,0,6
61711,1,2697,2552,145,0,43,0,6
61712,1,2488,2222,266,0,100,0,6
61713,2,2601,2610,-9,0,4,1,6
61714,2,2613,2450,163,0,148,0,6
61715,2,2226,2403,-177,0,153,0,8
61716,1,2799,2593,206,0,13,0,6
61717,2,2571,2617,-46,0,333,0,6
61718,1,2420,2655,-235,0,13,0,6
61719,3,2694,2473,221,0,101,0,6
61720,2,2402,2499,-97,0,301,0,6
61721,1,2512,2416,96,0,211,0,6
61722,1,2604,2587,17,0,0,0,6
61723,2,2298,2497,-199,0,106,0,6
61724,3,2553,2419,134,0,242,0,6
61725,3,2293,2431,-138,0,121,0,6
61726,1,2222,2402,-180,0,406,1,6
61727,2,2646,2637,9,0,304,0,6
61728,1,2331,2419,-88,0,190,0,6
61729,2,2565,2548,17,0,398,1,6
61730,1,2634,2467,167,0,211,0,6
61731,2,2252,2422,-170,0,43,0,6
61732,2,2352,2455,-103,0,45,0,6
61733,2,2467,2406,61,0,6,0,6
61734,1,2252,2436,-184,0,224,0,6
61735,2,2447,2412,35,0,7,1,6
61736,3,2526,2500,26,0,112,0,6
61737,1,2657,2599,58,0,218,0,6
61738,1,2564,2472,92,0,110,0,6
61739,2,2397,2518,-121,0,302,0,6
61740,1,2331,2424,-93,0,225,0,6
61741,1,2566,2817,-251,0,146,0,6
61742,3,2639,2714,-75,0,7,0,6
61743,1,2513,2415,98,0,46,0,6
61744,1,2470,2580,-110,0,315,0,6
61745,2,2271,2405,-134,0,1,0,6
61746,1,2446,2380,66,0,151,0,8
61747,2,2498,2349,149,0,153,0,6
61748,1,2540,2416,124,0,428,0,6
61749,2,2504,2457,47,0,4,0,6
61750,3,2549,2480,69,0,373,0,6
61751,2,2522,2651,-129,0,120,0,6
61752,2,2562,2293,269,0,308,0,6
61753,1,2435,2333,102,0,141,0,6
61754,2,2752,2387,365,0,46,0,6
61755,1,2451,2389,62,0,245,0,6
61756,1,2521,2528,-7,0,405,0,6
61757,2,2512,2664,-152,0,110,0,6
61758,1,2728,2559,169,0,227,0,6
61759,1,2698,2671,27,0,302,0,6
61760,1,2404,2372,32,0,124,0,6
61761,1,2384,2403,-19,0,16,1,6
61762,1,2562,2539,23,0,101,1,6
61763,2,2369,2531,-162,0,20,0,6
61764,1,2501,2482,19,0,302,0,6
61765,1,2519,2344,175,0,229,1,6
61766,2,2583,2477,106,0,111,0,6
61767,1,2532,2538,-6,0,313,0,6
61768,3,2525,2501,24,0,373,0,6
61769,1,2241,2409,-168,0,0,1,6
61770,1,2563,2383,180,0,163,0,6
61771,1,2582,2473,109,0,300,0,6
61772,2,2622,2640,-18,0,255,0,6
61773,2,2493,2566,-73,0,41,0,6
61774,1,2643,2578,65,0,335,0,6
61775,1,2462,2360,102,0,373,1,6
61776,2,2405,2375,30,0,115,0,6
61777,2,2537,2513,24,0,6,0,6
61778,2,2457,2491,-34,0,57,0,6
61780,2,2206,2425,-219,0,261,0,6
61781,1,2419,2369,50,0,310,0,6
61782,1,2439,2359,80,0,192,1,6
61783,1,2339,2424,-85,0,39,0,6
61784,2,2598,2393,205,0,140,1,6
61785,2,2388,2541,-153,0,105,1,6
61786,2,2418,2311,107,0,260,0,6
61787,3,2474,2503,-29,0,267,0,6
61788,1,2433,2382,51,0,1,0,6
61789,2,2399,2474,-75,0,311,0,6
61790,1,2387,2428,-41,0,301,0,6
61791,1,2426,2239,187,0,58,0,6
61792,1,2504,2352,152,0,128,1,6
61793,1,2601,2537,64,0,28,0,6
61794,2,2230,2416,-186,0,40,0,6
61795,1,2542,2614,-72,0,209,0,6
61796,1,2595,2479,116,0,108,0,6
61797,1,2515,2579,-64,0,339,0,6
61798,1,2382,2534,-152,0,52,0,6
61799,2,2524,2554,-30,0,45,0,6
61800,1,2438,2386,52,0,205,0,6
61801,2,2383,2415,-32,0,101,0,6
61802,1,2410,2469,-59,0,218,1,6
61803,1,2232,2401,-169,0,133,0,5
61804,2,2516,2433,83,0,215,0,6
61805,2,2416,2265,151,0,140,1,6
61806,2,2684,2743,-59,0,302,0,6
61807,1,2437,2455,-18,0,380,1,6
61808,2,2444,2404,40,0,191,1,6
61809,2,2291,2425,-134,0,200,0,6
61810,2,2441,2365,76,0,100,0,6
61811,1,2510,2281,229,0,130,0,6
61812,1,2721,2496,225,0,112,0,6
61813,1,2712,2703,9,0,337,0,6
61814,1,2374,2456,-82,0,35,0,6
61815,1,2742,2655,87,0,45,0,6
61816,1,2701,2516,185,0,263,0,6
61817,2,2481,2452,29,0,200,0,6
61818,3,2626,2548,78,0,106,0,6
61819,1,2419,2302,117,0,45,0,6
61820,1,2445,2508,-63,0,40,0,6
61821,2,2265,2531,-266,0,120,0,6
61822,1,2668,2667,1,0,9,0,6
61823,2,2570,2509,61,0,395,0,6
61824,1,2594,2476,118,0,203,0,6
61825,3,2501,2662,-161,0,263,0,6
61826,2,2502,2409,93,0,129,0,6
61827,2,2220,2415,-195,0,300,0,6
61828,1,2616,2521,95,0,405,0,6
61829,2,2317,2587,-270,0,123,0,6
61830,2,2580,2546,34,0,208,0,6
61832,1,2691,2685,6,0,197,0,6
61833,1,2217,2416,-199,0,4,0,6
61834,1,2529,2398,131,0,253,0,6
61835,1,2447,2446,1,0,245,0,6
61836,1,2497,2467,30,0,201,1,6
61837,2,2409,2435,-26,0,315,1,6
61838,2,2376,2447,-71,0,57,0,6
61839,1,2370,2532,-162,0,1,0,6
61840,2,2429,2505,-76,0,100,0,6
61841,2,2359,2489,-130,0,47,0,6
61842,2,2628,2489,139,0,153,0,6
61843,3,2590,2622,-32,0,190,0,6
61844,1,2802,2647,155,0,211,0,6
61845,2,2573,2576,-3,0,43,1,6
61846,2,2505,2451,54,0,104,0,6
61847,2,2434,2331,103,0,316,0,6
61848,2,2412,2347,65,0,490,0,6
61849,1,2407,2389,18,0,17,0,6
61850,1,2619,2554,65,0,200,1,6
61851,2,2401,2351,50,0,41,0,6
61852,1,2526,2357,169,0,236,0,6
61853,2,2338,2659,-321,0,18,0,6
61855,1,2636,2431,205,0,385,0,6
61856,1,2549,2258,291,0,176,0,6
61857,2,2463,2497,-34,0,346,0,6
61858,1,2532,2390,142,0,260,0,6
61859,1,2609,2586,23,0,0,0,6
61860,2,2318,2460,-142,0,354,1,6
61861,2,2254,2430,-176,0,29,0,6
61862,2,2417,2347,70,0,201,0,6
61863,2,2469,2582,-113,0,454,1,6
61864,2,2606,2731,-125,0,10,0,6
61865,1,2522,2706,-184,0,106,0,6
61866,2,2397,2464,-67,0,311,0,6
61867,1,2666,2693,-27,0,373,0,6
61868,1,2409,2295,114,0,125,0,6
61869,1,2555,2612,-57,0,244,0,6
61870,1,2415,2232,183,0,101,1,8
61871,1,2417,2483,-66,0,45,0,6
61872,1,2461,2410,51,0,46,0,6
61873,1,2519,2562,-43,0,120,0,6
61874,2,2528,2398,130,0,123,0,6
61875,1,2673,2704,-31,0,15,0,6
61876,2,2472,2435,37,0,141,0,6
61877,2,2262,2407,-145,0,190,0,6
61878,3,2661,2654,7,0,267,0,6
61879,2,2518,2527,-9,0,22,0,6
61880,1,2349,2495,-146,0,207,1,6
61881,1,2701,2531,170,0,1,0,6
61882,1,2589,2501,88,0,300,0,6
61884,1,2475,2451,24,0,41,0,6
61885,2,2473,2599,-126,0,0,0,6
61886,1,2428,2349,79,0,40,0,6
61887,1,2423,2263,160,0,51,0,6
61888,2,2414,2412,2,0,18,1,6
61889,1,2534,2366,168,0,218,0,6
61890,1,2713,2598,115,0,202,1,6
61891,2,2431,2553,-122,0,46,1,6
61892,1,2472,2538,-66,0,45,0,6
61893,2,2256,2573,-317,0,8,0,6
61894,1,2617,2518,99,0,100,0,6
61895,3,2651,2646,5,0,0,0,6
61896,2,2418,2438,-20,0,4,0,6
61897,1,2607,2640,-33,0,49,0,6
61898,1,2377,2441,-64,0,123,1,6
61899,1,2549,2495,54,0,49,0,6
61900,2,2551,2313,238,0,218,0,6
61901,1,2747,2549,198,0,301,0,6
61902,2,2551,2257,294,0,212,1,6
61903,1,2436,2477,-41,0,122,0,6
61904,1,2538,2513,25,0,113,1,6
61905,1,2411,2295,116,0,201,0,6
61906,1,2462,2399,63,0,225,1,6
61907,1,2467,2413,54,0,131,0,6
61908,1,2490,2416,74,0,307,1,6
61909,2,2387,2401,-14,0,200,0,6
61910,1,2545,2456,89,0,153,0,6
61911,1,2261,2570,-309,0,140,0,6
61912,1,2429,2322,107,0,8,0,6
61913,2,2505,2483,22,0,101,1,6
61914,1,2417,2393,24,0,45,0,6
61915,2,2485,2402,83,0,145,0,6
61916,2,2462,2380,82,0,132,0,6
61917,3,2458,2637,-179,0,36,0,6
61918,1,2459,2345,114,0,4,0,6
61919,2,2424,2555,-131,0,110,0,6
61920,2,2477,2507,-30,0,265,1,6
61921,1,2400,2463,-63,0,202,0,6
61922,1,2525,2248,277,0,211,0,6
61923,2,2213,2514,-301,0,218,0,6
61924,1,2513,2202,311,0,305,0,6
61925,2,2269,2525,-256,0,131,1,6
61926,2,2285,2573,-288,0,123,0,6
61927,1,2532,2283,249,0,190,0,6
61928,2,2305,2608,-303,0,20,1,6
61929,1,2596,2303,293,0,150,0,6
61930,2,2291,2579,-288,0,40,1,6
61931,2,2400,2441,-41,0,300,0,6
61932,2,2544,2605,-61,0,123,1,6
61933,2,2373,2453,-80,0,195,0,6
61934,1,2498,2360,138,0,295,0,6
61935,1,2572,2700,-128,0,267,0,6
61936,2,2458,2504,-46,0,392,0,6
61937,1,2723,2704,19,0,122,0,6
61938,2,2493,2659,-166,0,247,1,6
61939,1,2549,2475,74,0,45,0,6
61940,2,2292,2434,-142,0,120,0,6
61941,2,2513,2522,-9,0,187,0,6
61942,1,2522,2372,150,0,100,0,6
61943,2,2370,2411,-41,4,125,0,13
61944,1,2338,2430,-92,0,264,0,6
61945,3,2615,2529,86,0,315,0,6
61946,1,2426,2424,2,0,127,1,6
61947,1,2515,2398,117,0,100,0,6
61948,2,2405,2364,41,0,110,0,6
61949,2,2224,2510,-286,0,301,0,6
61950,2,2564,2672,-108,0,330,0,6
61951,1,2294,2553,-259,0,4,0,6
61952,2,2516,2679,-163,0,129,0,6
61953,2,2421,2392,29,0,49,0,6
61954,2,2646,2562,84,0,43,0,6
61955,1,2502,2410,92,0,46,0,6
61956,2,2303,2550,-247,0,40,0,6
61957,2,2475,2438,37,0,125,0,6
61958,2,2748,2738,10,0,300,0,6
61959,1,2593,2686,-93,0,240,0,6
61960,3,2469,2429,40,0,337,0,6
61961,1,2509,2515,-6,0,7,0,6
61962,1,2560,2459,101,0,57,0,6
61963,1,2402,2277,125,0,101,0,8
61964,2,2605,2500,105,0,406,0,6
61965,2,2679,2717,-38,0,255,0,6
61966,1,2428,2421,7,0,40,1,6
61967,1,2625,2526,99,0,260,1,6
61968,3,2513,2217,296,0,200,0,6
61969,2,2549,2639,-90,0,123,0,6
61970,2,2303,2400,-97,0,150,0,6
61971,1,2661,2367,294,0,0,0,6
61972,1,2365,2408,-43,0,104,0,6
61974,1,2698,2697,1,0,300,1,6
61975,1,2407,2223,184,0,242,0,8
61976,1,2431,2203,228,0,483,0,6
61977,2,2388,2533,-145,0,452,0,6
61978,2,2354,2403,-49,0,310,0,6
61979,1,2456,2333,123,0,320,0,6
61980,2,2682,2805,-123,0,40,1,6
61981,2,2329,2566,-237,0,256,0,6
61982,2,2621,2644,-23,0,331,0,6
61983,1,2808,2591,217,0,331,0,6
61984,2,2412,2458,-46,0,1,0,6
61985,1,2575,2621,-46,0,246,0,6
61986,3,2698,2740,-42,0,140,0,6
61987,1,2514,2508,6,0,255,0,6
61988,2,2439,2499,-60,0,241,0,6
61989,2,2414,2279,135,0,331,0,6
61990,2,2528,2513,15,0,333,0,6
61991,2,2434,2456,-22,0,454,0,6
61992,2,2291,2463,-172,0,151,1,6
61993,1,2237,2409,-172,0,34,0,6
61994,2,2586,2582,4,0,101,0,6
61995,1,2480,2393,87,0,110,1,6
61996,2,2513,2568,-55,0,10,0,6
61997,1,2517,2516,1,0,207,0,6
61998,1,2567,2465,102,0,332,0,6
61999,1,2334,2427,-93,0,45,1,6
62000,2,2422,2620,-198,0,1,0,6
62001,2,2533,2531,2,0,117,0,6
62002,1,2321,2438,-117,0,247,0,6
62003,2,2418,2366,52,0,133,0,6
62004,2,2519,2574,-55,0,45,0,6
62005,3,2417,2371,46,0,50,0,6
62006,2,2363,2421,-58,0,13,0,6
62007,2,2575,2379,196,0,41,1,6
62008,1,2342,2490,-148,0,176,0,6
62009,3,2697,2639,58,0,13,0,6
62010,1,2546,2651,-105,0,101,0,6
62011,2,2492,2525,-33,0,373,0,6
62013,2,2480,2440,40,0,8,1,6
62014,2,2422,2429,-7,0,300,0,6
62015,1,2318,2429,-111,0,210,1,6
62016,2,2569,2601,-32,0,112,0,6
62017,1,2531,2442,89,0,46,0,6
62018,2,2355,2554,-199,0,302,0,6
62019,1,2446,2368,78,0,100,0,6
62020,1,2750,2680,70,0,45,0,6
62021,1,2509,2479,30,0,101,0,6
62022,1,2467,2290,177,0,46,0,6
62023,2,2723,2288,435,0,4,0,6
62024,2,2457,2464,-7,0,200,0,6
62025,2,2590,2537,53,0,154,1,6
62026,2,2440,2509,-69,0,312,1,6
62027,2,2646,2497,149,0,305,0,6
62028,2,2384,2620,-236,0,0,0,6
62029,2,2433,2251,182,0,39,0,6
62030,2,2402,2388,14,0,4,0,6
62031,1,2603,2503,100,0,455,0,6
62032,1,2419,2271,148,0,1,0,6
62033,1,2478,2469,9,0,112,0,6
62034,2,2533,2589,-56,0,204,1,6
62035,1,2401,2419,-18,0,265,0,6
62036,2,2409,2528,-119,0,34,0,6
62037,2,2283,2507,-224,0,45,0,6
62038,1,2460,2704,-244,0,306,0,6
62039,2,2240,2454,-214,0,190,0,6
62040,2,2382,2470,-88,0,211,0,6
62041,2,2386,2413,-27,0,311,0,6
62042,2,2489,2602,-113,0,45,0,6
62043,2,2588,2588,0,0,241,0,6
62044,1,2676,2580,96,0,5,0,6
62045,3,2327,2411,-84,0,256,0,6
62046,1,2594,2458,136,0,49,0,6
62047,2,2662,2735,-73,0,0,0,6
62048,1,2407,2361,46,0,40,0,6
62049,2,2615,2572,43,0,122,0,6
62050,1,2235,2515,-280,0,100,0,6
62051,1,2430,2502,-72,0,10,0,6
62052,1,2497,2406,91,0,142,0,6
62053,2,2399,2406,-7,0,7,1,6
62054,1,2484,2329,155,0,57,0,6
62055,2,2434,2356,78,0,5,0,6
62056,1,2811,2582,229,0,332,0,6
62057,2,2389,2544,-155,0,0,0,6
62058,1,2443,2415,28,0,242,0,6
62059,2,2490,2499,-9,0,123,0,6
62060,1,2502,2461,41,0,116,0,6
62061,1,2519,2560,-41,0,106,0,6
62062,1,2575,2336,239,0,242,0,6
62063,2,2430,2472,-42,0,374,0,7
62064,1,2417,2504,-87,0,2,0,6
62065,1,2476,2293,183,0,404,0,6
62066,1,2698,2634,64,0,176,1,6
62067,2,2515,2352,163,0,424,0,6
62068,1,2470,2468,2,0,112,0,6
62069,1,2449,2251,198,0,197,0,6
62070,1,2557,2507,50,0,392,1,6
62071,1,2433,2443,-10,0,130,0,6
62072,1,2406,2467,-61,0,112,0,6
62073,1,2569,2405,164,0,218,0,6
62074,3,2650,2729,-79,0,440,0,6
62075,1,2616,2613,3,0,335,0,6
62076,1,2411,2359,52,0,131,1,6
62077,2,2430,2553,-123,0,16,0,6
62078,1,2374,2524,-150,0,122,0,6
62079,3,2634,2460,174,0,60,0,6
62080,2,2341,2522,-181,0,290,1,6
62081,3,2717,2514,203,0,244,0,6
62082,2,2507,2629,-122,0,468,0,6
62083,1,2581,2522,59,0,459,1,6
62084,2,2519,2615,-96,0,100,0,6
62085,2,2573,2598,-25,0,7,1,6
62086,1,2549,2541,8,0,153,0,6
62087,2,2452,2389,63,0,177,0,6
62088,1,2594,2474,120,0,262,0,6
62089,2,2521,2693,-172,0,106,0,6
62090,2,2558,2488,70,0,111,0,6
62092,1,2550,2623,-73,0,110,0,6
62094,1,2559,2420,139,0,408,0,6
62095,1,2564,2674,-110,0,190,0,6
62096,2,2655,2606,49,0,46,0,6
62097,2,2535,2494,41,0,106,0,6
62098,2,2411,2438,-27,0,100,1,6
62099,2,2237,2575,-338,0,226,1,6
62100,1,2556,2339,217,0,253,0,6
62101,1,2723,2661,62,0,404,0,6
62102,2,2440,2403,37,0,180,0,6
62103,1,2322,2407,-85,0,121,0,6
62104,2,2482,2478,4,0,300,0,6
62106,1,2466,2472,-6,0,115,0,6
62107,1,2525,2485,40,0,101,0,6
62108,2,2580,2679,-99,0,129,0,6
62109,2,2524,2536,-12,0,394,0,6
62110,1,2509,2245,264,0,202,1,6
62111,2,2532,2572,-40,0,200,0,6
62112,1,2409,2499,-90,0,106,0,6
62113,2,2442,2405,37,0,140,0,6
62114,2,2416,2395,21,0,113,0,6
62115,1,2476,2424,52,0,45,0,6
62116,1,2446,2370,76,0,113,0,6
62117,1,2553,2451,102,0,88,0,6
62118,2,2463,2503,-40,0,67,1,6
62119,1,2525,2427,98,0,461,1,6
62120,2,2427,2434,-7,0,4,0,6
62121,2,2556,2509,47,0,10,0,6
62122,2,2291,2542,-251,0,46,0,6
62123,2,2553,2608,-55,0,7,0,6
62124,1,2578,2813,-235,0,337,0,6
62125,2,2579,2526,53,0,100,1,6
62126,2,2202,2712,-510,0,45,1,6
62127,1,2545,2485,60,0,0,0,6
62128,1,2622,2504,118,0,45,0,6
62129,1,2463,2355,108,0,9,0,6
62130,2,2463,2632,-169,0,162,0,6
62131,2,2408,2327,81,0,10,0,6
62132,1,2456,2372,84,0,211,0,6
62133,1,2400,2224,176,4,150,0,13
62134,2,2531,2614,-83,0,153,0,6
62135,2,2393,2407,-14,0,394,0,6
62136,1,2419,2200,219,0,201,0,6
62137,2,2394,2415,-21,0,211,1,6
62138,1,2553,2507,46,0,263,0,6
62139,1,2464,2413,51,0,0,0,6
62140,2,2456,2484,-28,0,405,0,6
62141,1,2744,2691,53,0,117,0,6
62142,1,2623,2460,163,0,133,1,6
62143,2,2644,2704,-60,0,46,0,6
62144,2,2437,2467,-30,0,28,0,6
62145,1,2310,2407,-97,0,101,0,6
62146,1,2346,2506,-160,0,100,0,6
62147,2,2496,2373,123,0,45,0,6
62148,2,2412,2505,-93,0,8,0,6
62149,2,2413,2279,134,0,41,1,6
62150,1,2544,2482,62,0,100,1,6
62151,1,2512,2472,40,0,302,0,6
62152,1,2640,2658,-18,0,484,0,6
62153,1,2444,2487,-43,0,130,0,6
62154,2,2332,2577,-245,0,194,1,6
62155,2,2361,2465,-104,0,302,0,6
62156,2,2530,2695,-165,0,265,0,6
62157,1,2740,2742,-2,0,233,0,6
62158,1,2418,2502,-84,0,12,0,6
62159,2,2296,2452,-156,0,120,0,6
62160,1,2696,2470,226,0,1,0,6
62161,1,2362,2422,-60,0,50,0,6
62162,1,2268,2406,-138,0,106,0,6
62163,1,2426,2519,-93,0,13,0,6
62164,1,2431,2312,119,0,127,1,6
62165,2,2462,2354,108,0,110,0,6
62166,2,2412,2555,-143,0,45,1,6
62167,1,2446,2393,53,0,461,1,6
62168,2,2385,2434,-49,0,45,0,6
62169,2,2576,2598,-22,0,218,0,6
62170,1,2470,2505,-35,0,46,0,6
62171,2,2547,2536,11,0,45,0,6
62172,1,2638,2680,-42,0,304,0,6
62173,1,2420,2361,59,0,90,0,6
62174,1,2509,2346,163,0,128,1,6
62175,3,2527,2339,188,0,44,0,6
62176,2,2442,2577,-135,0,1,0,6
62177,1,2575,2373,202,0,398,1,6
62178,3,2610,2499,111,0,10,0,6
62179,1,2581,2450,131,0,483,0,6
62180,2,2324,2534,-210,0,25,0,6
62181,1,2494,2597,-103,0,220,0,6
62182,1,2515,2201,314,0,8,1,6
62183,2,2347,2400,-53,0,442,1,8
62184,2,2366,2520,-154,0,41,0,6
62185,2,2450,2524,-74,0,113,0,6
62186,2,2617,2557,60,0,2,0,6
62187,2,2419,2418,1,0,200,0,6
62188,1,2418,2537,-119,0,150,0,6
62189,1,2425,2474,-49,0,4,0,6
62190,1,2463,2528,-65,0,453,0,6
62191,2,2630,2476,154,0,311,0,6
62192,2,2667,2703,-36,0,125,1,6
62193,2,2657,2619,38,0,100,0,6
62194,2,2629,2567,62,0,374,0,6
62195,1,2739,2576,163,0,305,0,6
62196,1,2443,2476,-33,0,201,0,6
62197,1,2412,2260,152,0,125,0,6
62198,3,2683,2754,-71,0,47,0,6
62199,1,2449,2422,27,0,483,0,6
62200,3,2386,2424,-38,0,144,0,6
62201,1,2484,2491,-7,0,12,0,6
62202,2,2603,2572,31,0,43,0,6
62203,1,2675,2727,-52,0,15,0,6
62204,2,2537,2699,-162,0,302,0,6
62205,1,2609,2514,95,0,100,0,6
62206,2,2413,2401,12,0,46,0,6
62208,1,2455,2474,-19,0,200,1,6
62209,2,2351,2434,-83,0,7,0,6
62210,2,2420,2363,57,0,311,0,6
62211,1,2294,2440,-146,0,250,0,6
62212,2,2513,2390,123,0,255,1,6
62213,3,2515,2586,-71,0,106,0,6
62214,2,2577,2714,-137,0,405,0,6
62215,1,2527,2342,185,0,301,0,6
62216,2,2349,2408,-59,0,40,0,6
62217,2,2457,2469,-12,0,211,1,6
62218,1,2450,2550,-100,0,106,1,6
62219,2,2412,2219,193,0,52,1,6
62220,2,2470,2485,-15,0,133,0,6
62221,2,2708,2737,-29,0,300,1,6
62222,1,2480,2530,-50,0,101,0,6
62223,3,2502,2597,-95,0,301,0,6
62224,2,2517,2467,50,0,206,0,6
62225,1,2594,2639,-45,0,101,0,6
62226,1,2517,2699,-182,0,485,0,6
62227,2,2396,2643,-247,0,247,0,6
62228,1,2356,2413,-57,0,4,0,6
62229,3,2368,2417,-49,0,45,0,6
62230,2,2400,2445,-45,0,1,0,6
62231,2,2582,2746,-164,0,0,0,6
62232,1,2272,2561,-289,0,301,0,6
62233,2,2363,2455,-92,0,146,0,6
62234,1,2480,2607,-127,0,300,0,6
62235,2,2286,2409,-123,4,3,1,13
62236,1,2492,2349,143,0,253,0,6
62237,1,2401,2410,-9,0,300,0,6
62238,2,2406,2559,-153,0,126,0,6
62239,2,2402,2409,-7,0,40,1,6
62240,3,2410,2467,-57,0,5,0,6
62241,1,2686,2648,38,0,132,0,6
62242,2,2613,2607,6,0,211,0,6
62243,1,2421,2290,131,0,404,0,6
62244,1,2749,2622,127,0,150,0,6
62245,2,2479,2276,203,0,302,0,6
62246,1,2400,2380,20,0,400,0,6
62247,2,2204,2435,-231,0,156,0,6
62248,2,2356,2448,-92,0,115,0,6
62249,2,2380,2501,-121,0,153,0,6
62250,2,2229,2418,-189,0,122,1,8
62251,2,2440,2417,23,0,43,1,6
62252,1,2583,2514,69,0,211,0,6
62253,2,2490,2344,146,0,42,0,6
62254,1,2402,2439,-37,0,124,0,6
62255,2,2489,2557,-68,0,300,0,6
62256,1,2594,2396,198,0,453,0,6
62257,1,2625,2533,92,0,0,0,6
62258,2,2504,2529,-25,0,245,1,6
62259,2,2728,2650,78,0,113,0,6
62260,2,2347,2572,-225,0,300,0,6
62261,1,2501,2633,-132,0,485,0,6
62262,1,2437,2299,138,0,328,0,6
62263,1,2512,2299,213,0,311,0,6
62264,2,2437,2528,-91,0,41,0,6
62265,1,2403,2359,44,0,302,0,6
62266,1,2451,2573,-122,0,332,0,6
62267,2,2426,2472,-46,0,483,0,6
62268,2,2387,2422,-35,0,0,0,6
62269,2,2341,2742,-401,0,13,0,6
62270,3,2269,2443,-174,0,41,0,6
62271,1,2516,2424,92,0,190,1,6
62272,1,2230,2454,-224,0,123,0,6
62273,1,2437,2382,55,0,8,1,6
62274,2,2497,2566,-69,0,40,0,6
62275,3,2518,2530,-12,0,192,0,6
62276,3,2646,2549,97,0,40,0,6
62277,1,2499,2265,234,0,145,0,6
62278,2,2499,2652,-153,0,414,0,6
62279,2,2416,2339,77,0,4,0,6
62280,1,2578,2674,-96,0,112,0,6
62281,2,2381,2447,-66,0,4,0,6
62282,1,2408,2557,-149,0,168,0,6
62283,2,2476,2597,-121,0,300,1,6
62284,1,2488,2454,34,0,45,0,6
62285,1,2613,2644,-31,0,255,0,6
62286,1,2696,2469,227,0,302,0,6
62287,2,2427,2467,-40,0,103,1,6
62288,1,2417,2263,154,0,153,1,6
62289,2,2515,2416,99,0,152,0,6
62290,2,2482,2549,-67,0,123,0,6
62291,2,2508,2558,-50,0,34,0,6
62292,1,2806,2558,248,0,4,0,6
62293,1,2471,2435,36,0,123,0,6
62294,1,2495,2525,-30,0,405,0,6
62295,2,2368,2408,-40,0,14,0,6
62296,3,2340,2490,-150,0,243,0,6
62297,2,2585,2609,-24,0,0,0,6
62298,2,2281,2550,-269,0,45,0,6
62299,3,2503,2516,-13,0,128,0,6
62300,1,2260,2420,-160,4,250,0,13
62301,1,2388,2433,-45,0,395,0,6
62302,1,2425,2200,225,0,457,1,7
62303,2,2512,2657,-145,0,112,0,6
62304,2,2407,2413,-6,0,101,0,6
62305,2,2406,2439,-33,0,196,0,6
62306,1,2563,2460,103,0,60,0,6
62307,1,2451,2527,-76,0,6,0,6
62308,2,2498,2225,273,0,96,0,6
62309,1,2512,2529,-17,0,42,0,6
62310,2,2622,2511,111,0,8,1,6
62311,2,2690,2684,6,0,123,0,6
62312,1,2698,2469,229,0,1,0,6
62313,1,2474,2574,-100,0,416,1,6
62314,1,2388,2416,-28,0,57,0,6
62315,1,2753,2526,227,0,300,0,6
62316,2,2297,2423,-126,0,135,0,6
62317,1,2523,2579,-56,0,102,0,6
62318,1,2417,2563,-146,0,110,1,6
62319,2,2393,2495,-102,0,476,0,6
62320,2,2246,2428,-182,0,36,1,6
62321,3,2363,2467,-104,0,332,0,6
62322,1,2541,2562,-21,0,130,1,6
62323,2,2604,2524,80,0,101,1,6
62324,2,2565,2585,-20,0,246,0,6
62325,1,2667,2570,97,0,5,1,6
62326,2,2577,2622,-45,0,132,0,6
62327,2,2456,2439,17,0,148,0,6
62328,2,2412,2521,-109,0,23,0,6
62329,2,2518,2403,115,0,129,1,6
62330,2,2472,2485,-13,0,151,0,6
62331,2,2487,2691,-204,0,123,0,6
62332,1,2465,2289,176,0,4,0,6
62333,2,2424,2340,84,0,5,0,6
62334,2,2392,2432,-40,0,45,0,6
62335,1,2544,2227,317,0,0,0,6
62336,2,2643,2459,184,0,332,0,6
62337,2,2387,2465,-78,0,487,0,6
62338,1,2328,2430,-102,0,312,0,6
62339,2,2466,2288,178,0,15,0,6
62340,2,2563,2610,-47,0,125,0,6
62341,1,2544,2614,-70,0,142,1,6
62342,2,2501,2453,48,0,113,0,6
62343,1,2572,2464,108,0,202,0,6
62344,1,2638,2742,-104,0,49,0,6
62345,2,2377,2420,-43,0,310,0,6
62346,1,2599,2626,-27,0,45,0,6
62347,2,2492,2488,4,0,101,0,6
62348,1,2804,2601,203,0,331,0,6
62349,3,2587,2620,-33,0,300,0,6
62350,2,2510,2647,-137,0,9,0,6
62351,1,2708,2753,-45,0,269,0,6
62352,1,2508,2363,145,0,106,0,6
62353,1,2528,2579,-51,0,101,0,6
62354,2,2467,2494,-27,0,40,0,6
62355,1,2713,2441,272,0,130,0,6
62356,2,2459,2249,210,0,150,0,6
62357,1,2552,2405,147,0,442,0,6
62358,1,2375,2432,-57,0,28,0,6
62360,2,2630,2651,-21,0,0,0,6
62361,1,2346,2415,-69,0,210,0,6
62362,1,2657,2618,39,0,123,0,6
62363,2,2413,2574,-161,0,300,0,6
62364,1,2717,2282,435,0,202,0,6
62365,1,2368,2453,-85,0,405,0,6
62366,2,2452,2435,17,0,250,1,6
62367,1,2743,2662,81,0,150,0,6
62368,3,2400,2374,26,0,315,0,6
62369,2,2542,2626,-84,0,130,0,6
62370,2,2456,2450,6,0,12,0,6
62371,1,2702,2408,294,0,15,0,6
62372,1,2424,2373,51,0,40,1,6
62373,2,2525,2503,22,0,202,0,6
62374,2,2727,2690,37,0,122,0,6
62375,2,2395,2541,-146,0,1,0,6
62376,1,2563,2685,-122,0,106,0,6
62377,1,2526,2455,71,0,128,0,6
62378,1,2492,2407,85,0,308,0,6
62379,3,2259,2424,-165,0,18,0,6
62380,2,2477,2548,-71,0,143,0,6
62381,2,2435,2424,11,0,140,0,6
62382,3,2591,2601,-10,0,246,0,6
62383,2,2347,2415,-68,0,101,0,6
62384,1,2503,2451,52,0,302,0,6
62385,1,2481,2416,65,0,7,0,6
62386,1,2467,2485,-18,0,310,0,6
62387,1,2459,2408,51,0,315,0,6
62388,1,2560,2472,88,0,101,0,6
62389,1,2471,2279,192,0,130,1,6
62390,1,2494,2701,-207,0,300,0,6
62391,2,2246,2664,-418,0,484,0,6
62392,2,2427,2430,-3,0,143,0,6
62393,1,2549,2596,-47,0,0,1,6
62394,1,2337,2402,-65,0,46,0,6
62395,1,2525,2346,179,0,229,0,6
62396,2,2418,2433,-15,0,46,0,6
62397,2,2703,2682,21,0,45,0,6
62398,2,2614,2607,7,0,28,0,6
62399,2,2530,2457,73,0,100,0,6
62400,1,2466,2411,55,0,0,0,6
62402,1,2466,2479,-13,0,245,0,6
62403,2,2542,2519,23,0,245,0,6
62404,2,2427,2580,-153,0,302,0,6
62405,2,2742,2721,21,0,300,0,6
62406,1,2425,2470,-45,0,440,0,6
62407,1,2401,2234,167,0,343,1,6
62408,1,2388,2567,-179,0,8,0,6
62409,2,2446,2377,69,0,106,0,6
62410,1,2409,2400,9,0,487,0,6
62411,1,2445,2410,35,0,57,1,6
62412,1,2698,2458,240,0,302,0,6
62413,1,2450,2386,64,0,127,0,6
62414,1,2575,2555,20,0,147,0,6
62415,2,2432,2475,-43,0,113,1,6
62416,1,2477,2395,82,0,106,0,6
62417,2,2567,2523,44,0,7,0,6
62418,1,2411,2520,-109,0,160,0,6
62419,2,2503,2481,22,0,216,0,6
62420,2,2515,2756,-241,0,102,0,6
62421,2,2486,2421,65,0,4,0,6
62422,1,2509,2588,-79,0,120,1,6
62423,1,2401,2312,89,0,35,0,6
62424,2,2296,2455,-159,0,10,0,6
62425,2,2480,2420,60,0,45,0,6
62426,2,2461,2461,0,0,225,0,6
62427,3,2397,2488,-91,0,130,0,6
62428,2,2495,2498,-3,0,414,0,6
62429,1,2402,2471,-69,0,311,0,6
62430,2,2262,2555,-293,0,224,0,6
62431,2,2696,2671,25,0,302,1,6
62432,1,2566,2721,-155,0,190,0,6
62433,3,2519,2494,25,0,121,0,6
62434,3,2437,2458,-21,0,21,0,6
62435,1,2655,2534,121,0,263,0,6
62436,2,2505,2376,129,0,115,0,6
62437,2,2451,2645,-194,0,140,0,6
62438,2,2404,2267,137,0,310,0,6
62439,3,2340,2468,-128,0,152,0,6
62440,2,2590,2284,306,0,302,0,6
62441,2,2384,2608,-224,0,140,0,6
62442,3,2517,2520,-3,0,38,0,6
62443,2,2537,2502,35,0,170,0,6
62444,2,2501,2512,-11,0,0,0,6
62445,3,2580,2578,2,0,130,0,6
62446,2,2527,2584,-57,0,301,0,6
62447,2,2351,2439,-88,0,101,1,6
62448,1,2446,2202,244,0,112,0,6
62449,2,2351,2402,-51,0,337,1,6
62450,1,2420,2520,-100,0,127,0,6
62451,1,2518,2467,51,0,112,1,6
62452,2,2462,2493,-31,0,40,0,6
62453,3,2808,2715,93,0,135,0,6
62454,2,2533,2358,175,0,4,0,6
62455,2,2746,2535,211,0,100,0,6
62456,2,2635,2509,126,0,4,0,6
62457,2,2254,2416,-162,0,46,0,6
62458,1,2433,2297,136,0,40,0,6
62459,1,2334,2518,-184,0,125,0,6
62460,1,2499,2425,74,0,1,0,6
62461,1,2562,2615,-53,0,45,1,6
62462,2,2410,2485,-75,0,200,0,6
62463,1,2572,2556,16,0,127,0,6
62464,1,2382,2511,-129,0,455,0,6
62465,1,2625,2459,166,0,111,0,6
62466,1,2523,2449,74,0,4,0,6
62467,1,2532,2323,209,0,277,0,6
62468,1,2465,2497,-32,0,17,0,6
62470,2,2620,2488,132,0,13,0,6
62471,2,2326,2537,-211,0,125,0,6
62472,2,2758,2807,-49,0,300,0,6
62473,1,2718,2503,215,0,101,0,6
62474,1,2743,2338,405,0,101,0,6
62475,2,2545,2296,249,0,308,0,6
62476,1,2460,2692,-232,0,254,0,6
62477,1,2631,2281,350,0,212,0,6
62478,1,2598,2513,85,0,125,0,6
62479,1,2501,2605,-104,0,310,0,6
62480,2,2660,2530,130,0,16,0,6
62481,1,2404,2434,-30,0,338,0,6
62482,2,2364,2442,-78,0,474,0,6
62483,1,2472,2441,31,0,4,0,6
62484,2,2478,2484,-6,0,267,0,6
62485,1,2613,2736,-123,0,335,0,6
62486,2,2226,2515,-289,0,1,0,6
62487,2,2317,2546,-229,0,201,1,6
62488,2,2490,2410,80,0,300,1,6
62489,2,2303,2415,-112,0,9,0,6
62490,1,2550,2571,-21,0,56,0,6
62491,1,2727,2663,64,0,404,0,6
62492,1,2519,2473,46,0,302,0,6
62493,3,2694,2646,48,0,282,0,6
62494,3,2735,2677,58,0,487,0,6
62495,1,2467,2342,125,0,226,0,6
62496,2,2574,2530,44,0,109,0,6
62497,1,2500,2358,142,0,201,0,6
62498,3,2305,2456,-151,0,46,0,6
62499,2,2619,2747,-128,0,200,0,6
62500,1,2471,2479,-8,0,124,0,6
62501,2,2439,2381,58,0,334,0,6
62502,1,2552,2205,347,0,337,0,6
62503,2,2588,2564,24,0,300,0,6
62504,2,2421,2472,-51,0,115,0,6
62505,1,2551,2645,-94,0,152,0,6
62506,2,2464,2408,56,0,345,1,6
62507,1,2577,2512,65,0,70,0,6
62508,2,2468,2428,40,0,300,0,6
62509,1,2423,2715,-292,0,151,0,6
62510,2,2433,2403,30,0,101,1,6
62511,1,2436,2360,76,0,107,0,6
62512,1,2508,2383,125,0,45,0,6
62513,1,2658,2578,80,0,0,0,6
62514,1,2339,2427,-88,0,130,0,6
62515,1,2531,2214,317,0,13,0,6
62516,1,2615,2558,57,0,460,1,6
62517,1,2369,2423,-54,0,248,0,6
62518,1,2501,2508,-7,0,190,0,6
62519,2,2683,2536,147,0,40,0,6
62520,2,2487,2602,-115,0,41,0,6
62521,2,2627,2446,181,0,311,0,6
62522,2,2509,2497,12,0,1,0,6
62523,2,2525,2469,56,0,215,0,6
62524,2,2450,2531,-81,0,225,0,6
62525,2,2530,2613,-83,0,319,0,6
62526,2,2348,2454,-106,0,0,0,6
62527,2,2456,2398,58,0,163,0,6
62528,1,2513,2477,36,0,110,0,6
62529,1,2609,2561,48,0,429,0,6
62530,2,2656,2738,-82,0,306,1,6
62531,2,2544,2624,-80,0,100,0,6
62532,2,2419,2416,3,0,270,0,6
62533,2,2387,2450,-63,0,0,1,6
62534,1,2513,2230,283,0,133,0,6
62536,1,2553,2405,148,0,0,0,6
62537,1,2294,2416,-122,0,373,1,6
62538,1,2571,2507,64,0,46,0,6
62539,1,2659,2627,32,0,130,0,6
62540,1,2496,2525,-29,0,4,1,6
62541,1,2478,2227,251,0,338,0,6
62542,1,2556,2612,-56,0,208,0,6
62543,2,2516,2697,-181,0,337,0,6
62544,1,2531,2531,0,0,231,0,6
62545,1,2728,2688,40,0,426,0,6
62546,2,2298,2429,-131,0,301,0,6
62547,1,2368,2400,-32,0,43,0,6
62548,1,2517,2363,154,0,49,0,6
62549,2,2366,2547,-181,0,161,0,6
62550,2,2245,2665,-420,0,4,0,6
62551,2,2464,2597,-133,0,107,0,6
62552,1,2405,2257,148,0,320,0,8
62553,2,2467,2410,57,0,143,0,6
62554,2,2471,2389,82,0,0,0,6
62555,2,2342,2432,-90,0,210,0,6
62556,2,2570,2558,12,0,143,0,6
62557,1,2464,2320,144,0,317,0,6
62558,1,2637,2613,24,0,354,0,6
62559,2,2456,2495,-39,0,1,1,6
62560,3,2406,2381,25,0,110,0,6
62561,2,2629,2518,111,0,101,0,6
62562,1,2580,2574,6,0,48,0,6
62563,1,2503,2482,21,0,246,0,6
62564,3,2621,2582,39,0,441,0,6
62565,1,2430,2429,1,0,107,1,6
62566,3,2473,2357,116,0,5,0,6
62567,1,2490,2513,-23,0,321,0,6
62568,1,2471,2427,44,0,141,0,6
62569,1,2473,2413,60,0,1,0,6
62570,1,2565,2490,75,0,153,0,6
62571,3,2572,2401,171,0,143,0,6
62572,2,2504,2632,-128,0,343,0,6
62573,1,2583,2342,241,0,115,0,6
62574,2,2598,2372,226,0,46,1,6
62575,2,2456,2518,-62,0,6,0,6
62576,1,2713,2556,157,0,106,0,6
62577,1,2409,2479,-70,0,406,0,6
62578,2,2464,2473,-9,0,15,1,6
62579,1,2424,2294,130,0,411,0,6
62580,2,2471,2457,14,0,106,0,6
62581,1,2499,2348,151,0,45,0,6
62582,2,2551,2382,169,0,211,0,6
62583,1,2414,2375,39,0,200,0,6
62584,3,2441,2446,-5,0,110,0,6
62585,2,2427,2474,-47,0,411,1,6
62586,3,2504,2406,98,0,1,0,6
62587,2,2462,2812,-350,0,421,0,6
62588,2,2753,2721,32,0,301,0,6
62589,3,2419,2527,-108,0,332,0,6
62590,2,2489,2511,-22,0,200,0,6
62591,1,2601,2523,78,0,108,0,6
62592,1,2500,2462,38,0,300,0,6
62593,1,2299,2553,-254,0,46,1,6
62594,2,2421,2471,-50,0,15,0,6
62595,1,2466,2291,175,0,302,1,6
62596,1,2444,2509,-65,0,315,1,6
62597,1,2435,2575,-140,0,20,0,6
62598,1,2433,2351,82,0,490,1,6
62599,1,2392,2435,-43,0,41,1,6
62600,2,2446,2423,23,0,381,0,6
62601,1,2421,2226,195,0,101,1,8
62602,2,2431,2421,10,0,40,0,6
62603,2,2416,2336,80,4,53,0,13
62604,1,2555,2425,130,0,408,0,6
62605,2,2606,2690,-84,0,302,0,6
62606,3,2503,2484,19,0,201,0,6
62607,2,2355,2555,-200,0,373,0,6
62608,1,2677,2591,86,0,4,0,6
62609,2,2589,2437,152,0,301,0,6
62610,2,2704,2614,90,0,127,0,6
62611,2,2406,2440,-34,0,16,0,6
62612,1,2384,2536,-152,0,315,0,6
62613,1,2457,2306,151,0,140,0,6
62614,2,2227,2497,-270,0,57,1,6
62615,1,2331,2439,-108,0,248,0,6
62616,1,2300,2427,-127,0,300,0,6
62617,1,2442,2435,7,0,304,0,6
62618,1,2303,2477,-174,0,167,1,6
62619,2,2475,2494,-19,0,123,0,6
62620,2,2335,2474,-139,0,146,1,6
62621,2,2458,2427,31,0,245,1,6
62622,2,2678,2608,70,0,48,0,6
62623,2,2751,2807,-56,0,123,0,6
62624,2,2675,2484,191,0,40,0,6
62625,2,2716,2615,101,0,269,0,6
62626,1,2482,2483,-1,0,40,0,6
62627,2,2516,2734,-218,0,10,0,6
62628,1,2487,2346,141,0,46,0,6
62629,2,2544,2701,-157,0,124,0,6
62630,2,2417,2598,-181,0,40,0,6
62631,1,2556,2568,-12,0,4,0,6
62632,2,2355,2528,-173,0,297,0,6
62633,2,2581,2516,65,0,117,0,6
62634,1,2538,2653,-115,0,112,0,6
62635,2,2251,2744,-493,0,40,0,6
62636,1,2648,2280,368,0,46,0,6
62637,1,2667,2245,422,0,202,0,6
62638,1,2617,2472,145,0,112,0,6
62639,1,2433,2324,109,0,152,0,6
62641,1,2279,2706,-427,0,141,0,6
62642,2,2294,2432,-138,0,124,0,6
62643,2,2490,2693,-203,0,123,0,6
62644,3,2540,2450,90,0,148,0,6
62645,1,2526,2540,-14,0,404,0,6
62646,1,2629,2646,-17,0,0,0,6
62647,1,2419,2244,175,0,211,0,6
62648,1,2535,2279,256,0,241,0,6
62649,2,2408,2477,-69,0,106,0,6
62650,2,2343,2458,-115,0,210,0,6
62651,2,2327,2404,-77,0,385,0,6
62652,1,2351,2435,-84,0,409,1,6
62653,1,2573,2605,-32,0,254,0,6
62654,3,2528,2585,-57,0,345,0,6
62655,1,2422,2392,30,0,115,0,6
62656,1,2569,2519,50,0,253,0,6
62657,1,2333,2437,-104,0,108,0,6
62658,3,2586,2662,-76,0,45,0,6
62659,1,2557,2413,144,0,441,0,6
62660,2,2536,2567,-31,0,46,0,6
62661,1,2421,2344,77,0,242,0,6
62662,2,2302,2449,-147,0,40,0,6
62663,2,2511,2397,114,0,122,1,6
62664,1,2518,2509,9,0,112,0,6
62665,3,2507,2464,43,0,113,0,6
62666,1,2478,2463,15,0,0,1,6
62667,1,2502,2396,106,0,107,1,6
62668,2,2587,2664,-77,0,246,0,6
62669,1,2681,2506,175,0,8,0,6
62670,1,2466,2491,-25,0,111,0,6
62671,1,2550,2476,74,0,200,0,6
62672,2,2397,2582,-185,0,13,0,6
62673,1,2622,2457,165,0,311,0,6
62674,2,2359,2512,-153,0,123,1,6
62675,2,2563,2697,-134,0,151,0,6
62676,1,2513,2451,62,0,81,0,6
62677,1,2558,2451,107,0,200,0,6
62678,1,2732,2747,-15,0,50,0,6
62679,1,2658,2727,-69,0,125,0,6
62680,2,2306,2569,-263,0,259,0,6
62681,3,2621,2553,68,0,27,0,6
62682,2,2500,2523,-23,0,253,0,6
62683,2,2700,2716,-16,0,46,0,6
62684,1,2404,2427,-23,0,40,1,6
62685,1,2745,2372,373,0,4,1,6
62686,2,2380,2467,-87,0,404,0,6
62687,2,2583,2536,47,0,312,0,6
62688,1,2376,2503,-127,0,5,0,6
62689,2,2422,2476,-54,0,129,1,6
62690,2,2298,2523,-225,0,307,0,6
62691,2,2611,2530,81,0,123,0,6
62692,2,2443,2375,68,0,1,0,6
62693,2,2381,2449,-68,0,247,1,6
62695,2,2518,2580,-62,0,131,0,6
62696,1,2578,2520,58,0,453,1,6
62697,2,2589,2508,81,0,483,0,6
62698,1,2355,2446,-91,0,20,1,6
62699,2,2502,2576,-74,0,0,0,6
62700,2,2564,2620,-56,0,106,0,6
62701,1,2443,2643,-200,0,16,0,6
62702,3,2564,2599,-35,0,272,0,6
62703,1,2468,2509,-41,0,487,0,6
62704,1,2582,2580,2,0,6,1,6
62705,2,2394,2668,-274,0,170,1,6
62706,1,2567,2524,43,0,143,0,6
62707,2,2537,2514,23,0,200,0,6
62708,2,2455,2519,-64,0,1,0,6
62709,3,2476,2502,-26,0,242,0,6
62710,1,2409,2477,-68,0,48,1,6
62711,1,2734,2709,25,0,300,0,6
62712,1,2415,2365,50,0,263,0,6
62713,1,2601,2615,-14,0,125,0,6
62714,1,2683,2623,60,0,13,0,6
62715,2,2561,2671,-110,0,49,0,6
62716,3,2548,2375,173,0,100,0,6
62717,1,2422,2314,108,0,45,1,6
62718,2,2238,2454,-216,0,202,1,6
62719,1,2376,2427,-51,0,332,0,6
62720,1,2410,2414,-4,0,154,0,6
62721,2,2292,2405,-113,0,45,1,6
62722,1,2420,2360,60,0,9,0,6
62723,2,2554,2620,-66,0,241,1,6
62724,3,2470,2507,-37,0,125,0,6
62725,1,2669,2502,167,0,263,0,6
62726,1,2484,2625,-141,0,60,0,6
62727,1,2602,2582,20,0,101,0,6
62728,2,2461,2460,1,0,50,0,6
62729,2,2525,2416,109,0,1,1,6
62730,1,2813,2695,118,0,122,0,6
62731,2,2454,2600,-146,0,300,0,6
62732,1,2454,2422,32,0,101,0,6
62733,1,2482,2404,78,0,45,0,6
62734,2,2346,2407,-61,0,38,0,6
62735,2,2390,2543,-153,0,122,0,6
62736,2,2424,2374,50,0,250,0,6
62737,1,2450,2457,-7,0,148,1,6
62738,1,2741,2652,89,0,301,0,6
62739,1,2514,2569,-55,0,103,0,6
62740,2,2224,2490,-266,0,49,0,6
62741,3,2636,2485,151,0,191,0,6
62742,2,2524,2650,-126,0,4,0,6
62743,1,2407,2562,-155,0,123,0,6
62744,1,2480,2290,190,0,36,0,6
62745,3,2405,2450,-45,0,474,0,6
62746,1,2500,2394,106,0,200,0,6
62747,2,2279,2447,-168,0,109,0,6
62748,3,2468,2585,-117,0,8,0,6
62749,3,2376,2423,-47,0,300,0,6
62750,3,2665,2738,-73,0,280,0,6
62751,2,2721,2742,-21,0,106,0,6
62752,2,2574,2621,-47,0,112,1,6
62753,1,2436,2406,30,0,190,0,6
62754,3,2407,2427,-20,0,302,0,6
62755,1,2318,2426,-108,0,225,1,6
62756,1,2403,2279,124,0,394,0,6
62757,3,2446,2441,5,0,9,0,6
62758,1,2346,2403,-57,0,102,1,6
62759,2,2581,2502,79,0,40,0,6
62760,2,2446,2392,54,0,27,0,6
62761,1,2208,2585,-377,0,123,0,6
62762,2,2436,2369,67,0,54,0,6
62763,1,2526,2507,19,0,121,0,6
62764,2,2534,2621,-87,0,120,0,6
62765,2,2345,2529,-184,0,100,0,6
62766,2,2503,2532,-29,0,484,0,6
62767,1,2438,2362,76,0,485,1,6
62768,1,2507,2446,61,0,128,0,6
62769,1,2645,2546,99,0,16,0,6
62770,1,2296,2462,-166,0,40,0,6
62772,1,2696,2452,244,0,198,0,6
62773,2,2562,2487,75,0,45,0,6
62774,1,2461,2401,60,0,144,1,6
62775,2,2634,2562,72,0,442,0,6
62776,2,2302,2502,-200,0,40,1,6
62777,2,2235,2746,-511,0,241,0,6
62778,2,2446,2666,-220,0,110,0,6
62779,1,2493,2524,-31,0,255,0,6
62780,2,2526,2398,128,0,8,0,6
62781,2,2370,2496,-126,0,405,0,6
62782,1,2426,2359,67,0,45,0,6
62783,2,2580,2497,83,0,25,1,6
62784,1,2429,2296,133,0,122,0,6
62785,1,2440,2383,57,0,322,0,6
62786,3,2617,2684,-67,0,255,0,6
62787,2,2479,2465,14,0,4,0,6
62788,2,2350,2589,-239,0,200,1,6
62789,1,2458,2399,59,0,43,0,6
62791,2,2544,2397,147,0,16,0,6
62793,1,2369,2415,-46,0,288,0,6
62794,2,2408,2507,-99,0,45,0,6
62795,2,2737,2685,52,0,337,0,6
62796,3,2482,2347,135,0,40,0,6
62797,3,2469,2334,135,0,343,0,6
62798,1,2479,2422,57,0,45,0,6
62799,2,2427,2458,-31,0,301,1,6
62800,1,2334,2426,-92,0,180,0,6
62801,2,2424,2409,15,0,245,1,8
62802,1,2371,2436,-65,0,25,0,6
62803,2,2387,2408,-21,0,453,0,6
62804,2,2532,2416,116,0,315,0,6
62805,2,2472,2617,-145,0,132,0,6
62806,1,2476,2261,215,0,140,0,6
62807,2,2635,2607,28,0,0,0,6
62808,1,2625,2577,48,0,307,0,6
62809,1,2342,2438,-96,0,172,0,6
62810,3,2640,2560,80,0,200,0,6
62811,1,2555,2492,63,0,200,0,6
62812,1,2443,2427,16,0,270,1,6
62813,2,2499,2572,-73,0,289,0,6
62814,2,2503,2670,-167,0,250,0,6
62815,2,2417,2425,-8,0,492,0,6
62816,1,2470,2392,78,0,301,0,6
62817,1,2501,2406,95,0,163,0,6
62818,2,2342,2437,-95,0,176,0,6
62819,2,2433,2618,-185,0,131,0,6
62820,1,2449,2320,129,0,106,0,6
62821,2,2691,2745,-54,0,47,0,6
62822,2,2669,2607,62,0,313,1,6
62823,2,2452,2537,-85,0,148,0,6
62824,3,2747,2574,173,0,8,0,6
62825,2,2648,2588,60,0,335,0,6
62826,2,2609,2746,-137,0,37,0,6
62827,1,2700,2531,169,0,101,0,6
62828,2,2541,2559,-18,0,121,0,6
62829,2,2812,2817,-5,0,315,0,6
62830,2,2542,2574,-32,0,101,0,6
62831,2,2358,2470,-112,0,469,0,6
62832,3,2416,2402,14,0,40,0,6
62833,2,2573,2455,118,0,112,0,6
62834,3,2695,2518,177,0,40,0,6
62835,2,2399,2451,-52,0,8,0,6
62836,1,2446,2466,-20,0,100,1,6
62837,2,2722,2715,7,0,45,0,6
62838,3,2276,2471,-195,0,45,0,6
62839,3,2382,2478,-96,0,145,0,6
62840,2,2519,2439,80,0,45,0,6
62841,3,2436,2379,57,0,315,0,6
62842,1,2506,2546,-40,0,392,0,6
62843,1,2473,2387,86,0,40,0,6
62844,1,2475,2445,30,0,213,1,6
62845,3,2419,2398,21,0,410,0,6
62846,3,2520,2539,-19,0,4,0,6
62847,3,2604,2598,6,0,280,0,6
62848,1,2653,2450,203,0,302,0,6
62849,1,2429,2319,110,0,74,0,6
62850,1,2452,2275,177,0,63,0,6
62851,2,2388,2420,-32,0,200,0,6
62852,1,2537,2565,-28,0,484,0,6
62853,1,2428,2509,-81,0,101,0,6
62854,1,2554,2569,-15,0,421,0,6
62855,1,2499,2620,-121,0,134,0,6
62856,1,2511,2536,-25,0,106,0,6
62857,1,2528,2565,-37,0,132,0,6
62858,1,2747,2385,362,0,57,0,6
62859,2,2245,2403,-158,0,48,0,6
62860,1,2492,2234,258,0,8,0,6
62861,1,2450,2453,-3,0,141,1,6
62862,2,2674,2547,127,0,123,0,6
62863,1,2672,2529,143,0,100,0,6
62864,3,2494,2404,90,0,132,0,6
62865,3,2626,2627,-1,0,267,0,6
62866,1,2481,2417,64,0,83,1,6
62867,2,2355,2432,-77,0,350,1,6
62868,1,2412,2341,71,0,213,0,6
62869,1,2737,2704,33,0,315,0,6
62870,1,2456,2423,33,0,6,0,6
62871,3,2595,2587,8,0,58,0,6
62872,2,2520,2563,-43,0,36,1,6
62873,1,2463,2520,-57,0,387,0,6
62874,1,2661,2641,20,0,9,0,6
62875,1,2517,2475,42,0,1,0,6
62876,1,2695,2391,304,0,4,0,6
62877,1,2241,2469,-228,0,143,0,6
62878,1,2382,2484,-102,0,5,1,6
62879,2,2531,2565,-34,0,120,0,6
62880,1,2394,2479,-85,0,110,0,6
62881,2,2349,2462,-113,0,455,0,6
62882,1,2502,2394,108,0,108,0,6
62883,2,2329,2420,-91,0,130,0,6
62884,1,2549,2276,273,0,302,0,6
62885,2,2264,2415,-151,0,100,0,6
62886,1,2439,2377,62,0,107,0,6
62888,2,2495,2382,113,0,115,0,6
62889,3,2472,2459,13,0,154,0,6
62890,2,2473,2466,7,0,7,0,6
62891,2,2675,2518,157,0,45,0,6
62892,1,2499,2375,124,0,190,0,6
62893,2,2409,2507,-98,0,143,1,6
62894,2,2554,2470,84,0,244,1,6
62895,2,2515,2410,105,0,41,0,6
62896,1,2396,2483,-87,0,10,0,6
62897,2,2471,2416,55,0,0,0,6
62898,2,2421,2356,65,0,302,0,6
62899,1,2425,2362,63,0,313,1,6
62900,2,2421,2559,-138,0,110,0,6
62901,1,2496,2320,176,0,106,0,6
62902,2,2352,2513,-161,0,57,0,8
62903,1,2602,2604,-2,0,4,0,6
62904,2,2572,2664,-92,0,100,0,6
62905,2,2387,2401,-14,0,153,0,6
62906,1,2556,2505,51,0,200,0,6
62907,1,2494,2569,-75,0,247,0,6
62908,1,2626,2639,-13,0,228,0,6
62909,1,2470,2422,48,0,317,0,6
62910,1,2630,2739,-109,0,335,0,6
62911,1,2704,2561,143,0,201,0,6
62912,2,2263,2412,-149,0,153,0,6
62913,1,2721,2688,33,0,202,0,6
62914,2,2618,2686,-68,0,129,0,6
62915,3,2574,2304,270,0,194,0,6
62916,3,2627,2698,-71,0,4,0,6
62917,1,2341,2426,-85,0,45,1,6
62918,1,2516,2276,240,0,354,0,6
62919,1,2470,2470,0,0,106,0,6
62920,1,2429,2283,146,0,41,0,6
62921,2,2577,2716,-139,0,103,1,6
62922,1,2583,2505,78,0,405,0,6
62923,1,2750,2745,5,0,101,0,6
62924,1,2416,2379,37,0,302,0,6
62925,2,2449,2626,-177,0,16,0,6
62926,1,2469,2512,-43,0,124,0,6
62927,1,2387,2417,-30,0,241,0,6
62928,2,2444,2339,105,0,140,1,6
62929,3,2404,2516,-112,0,123,0,6
62930,1,2656,2560,96,0,414,0,6
62931,1,2606,2561,45,0,101,0,6
62932,1,2517,2523,-6,0,104,0,6
62933,1,2668,2666,2,0,123,0,6
62934,1,2621,2500,121,0,337,0,6
62935,2,2614,2634,-20,0,400,0,6
62936,1,2528,2530,-2,0,265,0,6
62937,2,2636,2568,68,0,43,0,6
62938,1,2470,2478,-8,0,474,0,6
62939,3,2505,2425,80,0,45,0,6
62940,2,2406,2383,23,0,260,1,6
62941,2,2750,2487,263,0,216,1,6
62942,2,2487,2447,40,0,310,0,6
62943,2,2468,2703,-235,0,161,0,6
62944,1,2518,2334,184,0,459,0,6
62945,1,2348,2403,-55,0,150,0,6
62946,2,2258,2424,-166,0,224,0,6
62947,2,2441,2524,-83,0,127,0,6
62948,2,2200,2436,-236,0,40,0,6
62949,2,2347,2604,-257,0,469,0,6
62950,1,2517,2292,225,0,4,0,6
62951,2,2515,2525,-10,0,307,0,6
62952,3,2453,2525,-72,0,131,0,6
62953,2,2585,2582,3,0,207,1,6
62954,1,2515,2583,-68,0,130,1,6
62955,1,2537,2378,159,0,190,0,6
62956,2,2386,2558,-172,0,4,0,6
62957,1,2443,2366,77,0,48,1,6
62958,1,2542,2649,-107,0,112,0,6
62959,1,2531,2352,179,0,102,0,6
62960,2,2305,2409,-104,0,302,0,6
62961,1,2454,2312,142,0,130,0,6
62962,2,2452,2575,-123,0,57,1,6
62963,2,2521,2560,-39,0,41,0,6
62964,1,2418,2662,-244,0,41,1,6
62965,1,2501,2300,201,0,140,1,6
62966,1,2563,2461,102,0,8,0,6
62967,1,2510,2460,50,0,1,1,6
62968,1,2417,2536,-119,0,1,0,6
62969,1,2691,2692,-1,0,7,1,6
62970,2,2559,2730,-171,0,110,0,6
62971,1,2441,2399,42,0,45,0,6
62972,1,2441,2446,-5,0,110,0,6
62973,2,2633,2507,126,0,43,0,6
62974,1,2406,2467,-61,0,45,0,6
62975,1,2748,2381,367,0,4,0,6
62976,1,2382,2402,-20,0,211,1,6
62977,2,2632,2543,89,0,123,0,6
62978,2,2568,2612,-44,0,138,0,6
62979,1,2318,2430,-112,0,245,0,6
62980,1,2505,2526,-21,0,302,1,6
62981,1,2621,2355,266,0,49,0,6
62982,3,2570,2515,55,0,202,0,6
62983,1,2352,2435,-83,0,156,1,6
62984,1,2471,2493,-22,0,190,0,6
62985,2,2372,2433,-61,0,381,1,6
62986,2,2417,2484,-67,0,461,0,6
62987,1,2505,2573,-68,0,200,0,6
62989,2,2739,2674,65,0,110,0,6
62990,2,2316,2448,-132,0,389,0,6
62991,2,2506,2520,-14,0,115,0,6
62992,1,2304,2697,-393,0,48,1,6
62993,1,2691,2756,-65,0,406,0,6
62994,2,2390,2453,-63,0,57,0,6
62995,2,2661,2613,48,0,200,1,6
62996,2,2414,2324,90,0,120,0,6
62997,2,2407,2556,-149,0,140,0,6
62998,2,2682,2526,156,0,4,0,6
62999,1,2496,2446,50,0,300,1,6
63000,2,2495,2545,-50,0,5,0,6
63001,1,2347,2419,-72,0,0,0,6
63002,2,2466,2523,-57,0,68,0,6
63003,1,2665,2345,320,0,0,0,6
63004,2,2575,2614,-39,0,241,1,6
63005,3,2629,2676,-47,0,46,0,6
63006,1,2591,2382,209,0,302,0,6
63007,3,2726,2629,97,0,260,0,6
63008,2,2629,2625,4,0,130,0,6
63009,1,2342,2423,-81,0,241,0,8
63010,2,2412,2330,82,4,80,0,13
63011,2,2260,2435,-175,0,4,0,6
63012,1,2431,2412,19,0,123,1,6
63013,1,2540,2577,-37,0,161,0,6
63014,1,2400,2333,67,0,210,0,6
63015,1,2391,2470,-79,0,151,0,6
63016,2,2618,2683,-65,0,101,0,6
63017,2,2469,2529,-60,0,337,0,6
63018,1,2562,2470,92,0,112,0,6
63019,2,2512,2449,63,0,45,0,6
63020,2,2241,2458,-217,0,434,1,6
63021,2,2272,2422,-150,0,40,0,6
63022,1,2547,2403,144,0,4,0,6
63023,3,2557,2587,-30,0,106,0,6
63024,2,2823,2707,116,0,338,0,6
63025,2,2476,2455,21,0,221,0,6
63026,1,2514,2501,13,0,112,0,6
63027,3,2417,2425,-8,0,101,0,6
63028,1,2806,2595,211,0,190,1,6
63029,2,2476,2349,127,0,200,0,6
63030,1,2430,2437,-7,0,405,1,6
63031,2,2419,2369,50,0,50,0,6
63032,1,2579,2537,42,0,132,1,6
63033,1,2499,2375,124,0,157,0,6
63034,3,2699,2604,95,0,302,0,6
63035,2,2598,2637,-39,0,303,0,6
63036,1,2446,2529,-83,0,11,0,6
63037,1,2732,2742,-10,0,474,0,6
63038,1,2479,2466,13,0,200,0,6
63039,1,2286,2433,-147,0,245,0,6
63040,2,2366,2467,-101,0,103,0,6
63041,2,2514,2406,108,0,101,0,6
63042,2,2329,2488,-159,0,32,1,6
63043,1,2427,2422,5,0,15,0,6
63044,2,2406,2295,111,0,106,0,6
63045,2,2454,2526,-72,0,45,1,6
63046,3,2460,2563,-103,0,227,0,6
63047,1,2460,2325,135,0,303,0,6
63048,2,2255,2464,-209,0,112,0,6
63049,1,2534,2418,116,0,37,0,6
63050,2,2617,2667,-50,0,16,0,6
63051,2,2481,2452,29,0,88,0,6
63052,2,2363,2425,-62,0,101,0,6
63053,1,2483,2315,168,0,302,0,8
63054,2,2642,2549,93,0,490,0,6
63055,1,2419,2332,87,4,252,1,13
63056,2,2337,2417,-80,0,25,0,6
63057,2,2440,2480,-40,0,65,0,6
63058,2,2556,2556,0,0,101,1,6
63059,1,2516,2611,-95,0,78,1,6
63060,1,2459,2388,71,0,15,0,6
63061,2,2565,2660,-95,0,40,0,6
63062,3,2476,2472,4,0,112,0,6
63063,1,2464,2405,59,0,4,0,6
63064,1,2487,2521,-34,0,150,0,6
63065,2,2335,2535,-200,0,196,0,6
63066,2,2377,2523,-146,0,153,0,6
63067,3,2437,2350,87,0,45,0,6
63068,1,2463,2476,-13,0,474,0,6
63069,2,2630,2749,-119,0,47,0,6
63070,2,2558,2476,82,0,112,1,6
63071,1,2719,2626,93,0,300,0,6
63072,2,2472,2476,-4,0,225,1,6
63073,3,2385,2447,-62,0,140,0,6
63074,1,2458,2501,-43,0,48,0,6
63075,1,2456,2466,-10,0,115,0,6
63076,1,2535,2569,-34,0,154,0,6
63077,1,2472,2269,203,0,201,0,6
63078,1,2515,2697,-182,0,129,0,6
63079,1,2357,2407,-50,0,143,1,6
63080,1,2425,2385,40,0,106,0,6
63081,2,2516,2587,-71,0,331,0,6
63082,1,2573,2623,-50,0,151,0,6
63083,2,2500,2526,-26,0,115,0,6
63084,1,2499,2362,137,0,149,1,6
63085,1,2413,2486,-73,0,129,0,6
63086,2,2478,2420,58,0,334,1,6
63087,2,2419,2471,-52,0,15,0,6
63088,1,2482,2487,-5,0,106,1,6
63089,2,2374,2667,-293,0,49,0,6
63090,1,2460,2421,39,0,8,1,6
63091,2,2619,2697,-78,0,115,0,6
63092,1,2372,2534,-162,0,101,0,6
63093,1,2452,2537,-85,0,211,0,6
63094,1,2457,2503,-46,0,53,0,6
63095,2,2706,2567,139,0,140,0,6
63096,1,2534,2620,-86,0,120,0,6
63097,3,2555,2674,-119,0,110,0,6
63098,2,2733,2550,183,0,459,0,6
63099,2,2571,2750,-179,0,210,0,6
63100,2,2570,2625,-55,0,112,0,6
63101,1,2524,2412,112,0,120,0,6
63102,2,2380,2433,-53,0,343,0,6
63103,2,2414,2475,-61,0,284,0,6
63104,3,2687,2654,33,0,43,0,6
63105,2,2451,2359,92,0,4,0,6
63106,3,2384,2429,-45,0,46,0,6
63107,1,2394,2446,-52,0,143,0,6
63108,1,2503,2384,119,0,120,1,6
63109,1,2672,2629,43,0,248,0,6
63110,1,2497,2566,-69,0,57,1,6
63111,2,2639,2528,111,0,107,1,6
63112,2,2697,2740,-43,0,211,0,6
63113,3,2426,2416,10,0,106,0,6
63114,2,2400,2487,-87,0,180,0,6
63115,1,2518,2508,10,0,56,0,6
63116,1,2680,2630,50,0,100,0,6
63117,1,2574,2462,112,0,138,0,6
63118,2,2418,2515,-97,0,304,0,6
63119,2,2465,2612,-147,0,57,0,6
63121,1,2504,2462,42,0,108,0,6
63122,1,2478,2469,9,0,190,0,6
63123,1,2504,2494,10,0,153,0,6
63124,1,2418,2333,85,0,106,1,8
63125,2,2506,2599,-93,0,243,0,6
63126,1,2243,2412,-169,0,46,0,6
63127,2,2387,2411,-24,0,44,0,6
63128,1,2520,2427,93,0,120,1,6
63129,1,2495,2512,-17,0,102,0,6
63130,2,2724,2809,-85,0,45,0,6
63131,3,2519,2501,18,0,101,0,6
63132,1,2400,2403,-3,0,36,1,6
63133,1,2653,2551,102,0,404,0,6
63134,1,2560,2380,180,0,270,1,6
63135,2,2621,2592,29,0,304,0,6
63136,1,2476,2345,131,0,5,0,6
63137,2,2274,2415,-141,0,398,1,8
63138,1,2264,2444,-180,0,0,0,6
63139,2,2570,2546,24,0,380,1,6
63140,1,2489,2465,24,0,52,1,6
63141,2,2494,2426,68,0,202,0,6
63142,3,2486,2475,11,0,125,0,6
63143,2,2460,2464,-4,0,112,0,6
63144,2,2675,2738,-63,0,260,1,6
63145,2,2558,2630,-72,0,200,0,6
63146,3,2623,2354,269,0,306,0,6
63147,2,2412,2409,3,0,40,0,6
63148,2,2587,2441,146,0,150,0,6
63149,1,2736,2459,277,0,80,0,6
63150,3,2669,2416,253,0,243,0,6
63151,2,2353,2423,-70,0,245,0,6
63152,2,2481,2326,155,0,331,0,6
63153,1,2297,2400,-103,0,41,0,6
63154,1,2373,2437,-64,0,265,0,6
63155,2,2362,2527,-165,0,484,1,6
63156,1,2447,2340,107,0,195,0,6
63157,2,2440,2447,-7,0,6,0,6
63158,1,2488,2412,76,0,45,0,6
63159,2,2435,2436,-1,0,41,0,6
63160,2,2491,2528,-37,0,132,1,6
63161,1,2689,2580,109,0,43,0,6
63162,2,2686,2448,238,0,112,0,6
63163,2,2538,2276,262,0,398,0,6
63164,1,2617,2523,94,0,263,0,6
63166,2,2218,2490,-272,0,49,0,6
63167,1,2578,2456,122,0,45,1,6
63168,1,2461,2475,-14,0,41,0,6
63170,1,2588,2520,68,0,40,0,6
63171,1,2576,2454,122,0,483,0,6
63172,2,2439,2581,-142,0,1,0,6
63173,1,2524,2375,149,0,398,1,6
63174,1,2606,2579,27,0,132,1,6
63175,2,2531,2541,-10,0,211,1,6
63176,2,2307,2522,-215,0,177,0,6
63177,3,2478,2283,195,0,211,0,6
63178,3,2401,2350,51,0,0,0,6
63179,2,2266,2643,-377,0,301,0,6
63180,1,2593,2464,129,0,300,1,6
63181,2,2379,2427,-48,0,7,0,6
63182,2,2381,2446,-65,0,35,0,6
63183,2,2406,2567,-161,0,40,0,6
63184,1,2562,2418,144,0,4,0,6
63185,1,2530,2531,-1,0,112,1,6
63186,2,2396,2542,-146,0,435,0,6
63187,3,2495,2514,-19,0,106,0,6
63188,1,2815,2565,250,0,43,0,6
63189,1,2715,2655,60,0,113,0,6
63190,2,2561,2686,-125,0,145,0,6
63191,2,2340,2568,-228,0,311,0,6
63192,2,2625,2630,-5,0,0,0,6
63193,1,2467,2449,18,0,0,0,6
63194,2,2455,2753,-298,0,107,0,6
63195,1,2503,2257,246,0,150,0,6
63196,2,2333,2438,-105,0,300,1,6
63197,1,2538,2433,105,0,242,0,6
63198,1,2501,2437,64,0,244,1,6
63199,3,2413,2514,-101,0,115,0,6
63200,1,2458,2422,36,0,127,0,6
63201,2,2502,2347,155,0,8,0,6
63202,1,2605,2563,42,0,190,0,6
63203,3,2380,2697,-317,0,100,0,6
63204,2,2488,2366,122,0,131,1,6
63205,1,2462,2557,-95,0,466,0,6
63206,2,2559,2685,-126,0,311,1,6
63207,2,2594,2509,85,0,485,0,6
63208,2,2519,2725,-206,0,225,1,6
63209,1,2511,2321,190,0,181,1,6
63210,2,2621,2541,80,0,278,0,6
63211,1,2417,2526,-109,0,101,1,6
63212,2,2463,2462,1,0,4,0,6
63213,2,2616,2673,-57,0,335,0,6
63214,1,2413,2301,112,0,18,0,6
63215,2,2520,2271,249,0,415,0,6
63216,1,2341,2402,-61,0,141,1,6
63217,2,2420,2405,15,0,2,1,6
63218,1,2613,2627,-14,0,102,0,6
63219,2,2541,2615,-74,0,106,0,6
63220,1,2430,2382,48,0,1,1,6
63221,3,2464,2456,8,0,143,0,6
63222,1,2460,2388,72,0,152,0,6
63223,2,2496,2511,-15,0,200,0,6
63225,1,2522,2519,3,0,334,0,6
63226,3,2414,2319,95,0,46,0,6
63227,1,2753,2701,52,0,301,0,6
63228,2,2561,2677,-116,0,463,0,6
63229,2,2425,2370,55,0,466,0,6
63230,1,2428,2316,112,0,41,1,6
63231,1,2598,2614,-16,0,300,1,6
63232,1,2665,2624,41,0,354,0,6
63233,1,2453,2506,-53,0,28,0,6
63234,2,2271,2416,-145,0,261,0,6
63235,2,2312,2405,-93,0,190,1,6
63236,1,2585,2613,-28,0,132,0,6
63237,2,2323,2449,-126,0,306,1,6
63238,1,2517,2348,169,0,380,0,8
63239,1,2634,2693,-59,0,310,0,6
63240,2,2576,2504,72,0,205,0,6
63241,2,2501,2523,-22,0,106,0,6
63242,2,2559,2553,6,0,134,0,6
63243,1,2397,2436,-39,0,171,1,6
63244,3,2470,2604,-134,0,48,0,6
63245,1,2609,2455,154,0,204,1,6
63246,1,2431,2312,119,0,200,0,6
63247,2,2245,2406,-161,0,28,0,6
63248,2,2422,2332,90,0,191,1,6
63249,2,2688,2625,63,0,146,1,6
63250,2,2502,2611,-109,0,45,1,6
63251,2,2650,2579,71,0,109,0,6
63252,2,2401,2273,128,0,7,0,6
63253,2,2406,2473,-67,0,23,0,6
63254,2,2677,2563,114,0,4,0,6
63255,2,2397,2514,-117,0,106,0,6
63256,2,2720,2818,-98,0,146,0,6
63257,1,2444,2495,-51,0,46,1,6
63258,3,2449,2519,-70,0,35,0,6
63259,1,2457,2364,93,0,380,0,6
63260,2,2391,2464,-73,0,200,0,6
63261,2,2430,2380,50,0,454,1,6
63262,2,2478,2500,-22,0,13,0,6
63263,2,2258,2578,-320,0,381,0,6
63264,1,2533,2550,-17,0,4,0,6
63265,1,2433,2375,58,0,108,0,6
63266,2,2401,2509,-108,0,112,1,6
63267,2,2486,2486,0,0,250,1,6
63268,1,2458,2336,122,0,112,0,6
63269,2,2561,2475,86,0,45,0,6
63270,1,2457,2488,-31,0,455,1,6
63271,1,2408,2493,-85,0,461,0,6
63272,3,2463,2398,65,0,300,0,6
63273,1,2202,2439,-237,0,190,0,6
63274,3,2418,2263,155,0,95,0,6
63275,1,2563,2503,60,0,0,0,6
63276,2,2570,2813,-243,0,190,0,6
63277,1,2451,2459,-8,0,15,1,6
63278,2,2575,2558,17,0,4,0,6
63279,1,2698,2458,240,0,208,0,6
63280,2,2635,2725,-90,0,130,0,6
63281,2,2670,2732,-62,0,9,0,6
63282,2,2607,2468,139,0,46,0,6
63283,2,2621,2690,-69,0,9,0,6
63284,2,2537,2719,-182,0,242,0,6
63285,2,2200,2524,-324,0,8,1,6
63286,2,2430,2481,-51,0,201,0,6
63287,1,2503,2406,97,0,40,0,6
63288,1,2619,2620,-1,0,100,0,6
63289,1,2409,2467,-58,0,107,0,6
63290,1,2426,2334,92,0,432,0,6
63291,1,2440,2401,39,0,434,0,6
63292,2,2252,2409,-157,4,194,0,13
63293,2,2253,2411,-158,0,150,1,6
63294,2,2620,2746,-126,0,46,0,6
63295,2,2416,2665,-249,0,49,0,6
63296,1,2483,2469,14,0,334,1,6
63297,1,2547,2465,82,0,5,0,6
63298,1,2550,2692,-142,0,152,0,6
63299,1,2657,2551,106,0,352,0,6
63300,1,2481,2379,102,0,212,0,6
63301,1,2467,2347,120,0,4,0,6
63302,2,2312,2429,-117,0,125,1,6
63303,2,2513,2415,98,0,8,0,6
63304,2,2554,2569,-15,0,101,0,6
63305,2,2394,2459,-65,0,110,0,6
63306,3,2420,2392,28,0,4,0,6
63307,1,2511,2559,-48,0,333,1,6
63308,1,2527,2491,36,0,1,0,6
63309,1,2457,2517,-60,0,1,1,6
63310,3,2738,2536,202,0,352,0,6
63311,1,2336,2451,-115,0,218,0,6
63312,1,2417,2382,35,0,100,1,6
63313,1,2325,2480,-155,0,46,1,6
63314,2,2448,2429,19,0,4,0,6
63315,1,2427,2232,195,0,80,0,6
63316,3,2604,2641,-37,0,338,0,6
63317,1,2563,2460,103,0,143,0,6
63318,1,2632,2464,168,0,133,0,6
63319,1,2406,2386,20,0,40,0,6
63320,1,2608,2728,-120,0,110,0,6
63321,2,2202,2436,-234,0,301,0,6
63322,2,2281,2620,-339,0,45,0,6
63323,3,2469,2265,204,0,201,0,6
63325,1,2535,2516,19,0,244,0,6
63326,2,2456,2467,-11,0,140,1,6
63327,3,2358,2570,-212,0,0,0,6
63328,1,2644,2686,-42,0,310,0,6
63329,3,2287,2475,-188,0,277,0,6
63330,1,2402,2252,150,0,108,0,6
63331,1,2403,2211,192,0,27,0,6
63332,1,2412,2252,160,0,200,1,6
63333,2,2415,2359,56,0,50,0,6
63334,2,2530,2552,-22,0,485,0,6
63335,1,2432,2543,-111,0,190,0,6
63336,1,2619,2554,65,0,31,0,6
63337,1,2482,2429,53,0,310,0,6
63338,2,2742,2758,-16,0,50,1,6
63339,1,2427,2374,53,0,101,1,6
63341,1,2555,2670,-115,0,485,1,6
63342,1,2670,2472,198,0,34,0,6
63343,2,2429,2483,-54,0,40,0,6
63344,2,2367,2427,-60,0,226,0,6
63345,1,2694,2643,51,0,45,0,6
63346,1,2545,2451,94,0,101,0,6
63347,2,2477,2600,-123,0,0,1,6
63348,2,2424,2524,-100,0,101,0,6
63349,1,2586,2616,-30,0,43,0,6
63350,2,2614,2716,-102,0,125,0,6
63351,2,2558,2612,-54,0,147,0,6
63352,2,2476,2597,-121,0,250,0,6
63353,1,2392,2587,-195,0,306,0,6
63354,1,2602,2610,-8,0,7,0,6
63355,2,2338,2529,-191,0,196,0,6
63356,2,2519,2423,96,0,121,1,6
63357,1,2822,2625,197,0,333,0,6
63358,1,2460,2293,167,0,100,0,6
63359,1,2317,2430,-113,0,403,1,6
63360,1,2531,2494,37,0,201,0,6
63361,1,2433,2341,92,0,122,0,6
63362,1,2532,2393,139,0,29,1,6
63363,1,2755,2401,354,0,0,0,6
63364,3,2230,2461,-231,0,123,0,6
63365,2,2548,2498,50,0,101,1,6
63366,1,2615,2564,51,0,16,0,6
63367,2,2518,2614,-96,0,112,0,6
63368,1,2518,2489,29,0,1,0,6
63370,2,2529,2569,-40,0,404,1,6
63371,2,2374,2452,-78,0,45,0,6
63372,1,2582,2453,129,0,123,0,6
63373,2,2517,2394,123,0,150,0,6
63374,2,2570,2403,167,0,45,0,6
63375,3,2539,2512,27,0,110,0,6
63376,1,2607,2591,16,0,101,0,6
63377,1,2816,2722,94,0,104,0,6
63378,1,2370,2481,-111,0,466,0,6
63379,1,2610,2451,159,0,313,0,6
63380,1,2460,2462,-2,0,242,0,6
63381,2,2455,2493,-38,0,15,0,6
63382,1,2668,2463,205,0,0,0,6
63383,1,2592,2534,58,0,46,0,6
63384,1,2416,2384,32,0,301,0,6
63385,1,2332,2435,-103,0,101,0,6
63386,2,2414,2550,-136,0,46,0,6
63387,2,2438,2481,-43,0,123,0,6
63388,1,2377,2403,-26,0,0,1,6
63389,1,2427,2431,-4,0,104,1,6
63390,2,2349,2451,-102,0,470,0,6
63391,1,2510,2435,75,0,46,0,6
63392,2,2612,2580,32,0,10,0,6
63393,1,2525,2527,-2,0,110,0,6
63394,3,2585,2380,205,0,190,0,6
63395,1,2515,2304,211,0,123,0,6
63396,1,2546,2593,-47,0,207,0,6
63397,2,2485,2494,-9,0,301,0,6
63398,2,2344,2520,-176,0,349,1,8
63399,1,2442,2257,185,0,31,0,6
63400,1,2693,2700,-7,0,40,0,6
63401,1,2575,2568,7,0,250,0,6
63402,1,2447,2533,-86,0,100,0,6
63403,2,2579,2435,144,0,190,0,6
63404,2,2590,2557,33,0,40,0,6
63405,1,2681,2616,65,0,104,0,6
63406,1,2684,2548,136,0,292,1,6
63407,2,2439,2469,-30,0,200,0,6
63408,1,2749,2558,191,0,127,0,6
63409,3,2526,2486,40,0,200,0,6
63410,1,2486,2415,71,0,45,1,6
63411,1,2380,2507,-127,0,1,0,6
63412,2,2523,2421,102,0,1,1,6
63413,2,2483,2379,104,0,190,1,6
63414,2,2255,2419,-164,0,311,0,6
63415,3,2219,2506,-287,0,45,0,6
63416,1,2553,2640,-87,0,200,0,6
63417,2,2510,2544,-34,0,22,0,6
63418,2,2487,2539,-52,0,380,0,6
63419,2,2517,2605,-88,0,335,1,6
63420,1,2424,2318,106,0,15,0,6
63421,1,2405,2336,69,0,160,1,6
63422,2,2411,2414,-3,0,120,1,6
63423,1,2268,2419,-151,0,45,0,6
63424,2,2756,2661,95,0,246,0,6
63425,1,2720,2488,232,0,0,0,6
63426,1,2312,2465,-153,0,202,0,6
63427,1,2392,2466,-74,0,107,0,6
63428,2,2432,2351,81,0,333,1,6
63429,1,2464,2616,-152,0,41,0,6
63430,2,2430,2506,-76,0,353,0,6
63431,2,2422,2370,52,0,201,0,6
63432,1,2400,2397,3,0,23,0,6
63433,3,2513,2547,-34,0,314,0,6
63434,1,2507,2415,92,0,311,0,6
63435,2,2329,2488,-159,0,4,1,6
63436,2,2344,2444,-100,0,132,0,6
63438,1,2424,2307,117,0,46,0,6
63439,3,2409,2488,-79,0,130,0,6
63440,2,2419,2570,-151,0,40,0,6
63441,1,2611,2613,-2,0,43,0,6
63442,1,2737,2631,106,0,301,1,6
63443,1,2493,2280,213,0,5,0,6
63444,2,2447,2541,-94,0,27,0,6
63445,1,2486,2381,105,0,112,1,6
63446,2,2686,2665,21,0,110,0,6
63447,1,2729,2622,107,0,122,0,6
63448,2,2650,2825,-175,0,310,0,6
63449,2,2720,2563,157,0,154,0,6
63450,1,2300,2404,-104,0,40,1,6
63451,1,2465,2425,40,0,424,0,6
63452,2,2511,2610,-99,0,100,0,6
63453,2,2340,2414,-74,0,400,0,6
63454,1,2406,2271,135,4,302,0,13
63455,1,2417,2498,-81,0,28,0,6
63456,1,2473,2290,183,0,190,0,6
63457,2,2266,2416,-150,0,100,0,6
63458,1,2460,2525,-65,0,4,0,6
63459,2,2525,2345,180,0,247,0,6
63460,1,2620,2673,-53,0,40,0,6
63461,1,2487,2671,-184,0,172,0,6
63462,2,2559,2469,90,0,112,0,6
63463,2,2680,2764,-84,0,47,0,6
63464,2,2562,2737,-175,0,246,0,6
63465,3,2463,2399,64,0,1,0,6
63466,1,2387,2424,-37,0,265,0,6
63467,1,2437,2406,31,0,122,0,6
63468,1,2507,2324,183,0,120,0,6
63469,1,2558,2631,-73,0,148,0,6
63470,1,2462,2297,165,0,153,0,6
63471,2,2396,2445,-49,0,58,0,6
63472,1,2378,2423,-45,0,330,0,8
63473,2,2580,2560,20,0,204,0,6
63474,2,2633,2663,-30,0,440,0,6
63475,2,2229,2401,-172,0,1,0,6
63476,2,2276,2551,-275,0,106,1,6
63477,1,2499,2539,-40,0,260,0,6
63478,1,2456,2461,-5,0,50,1,6
63479,1,2514,2567,-53,0,147,0,6
63480,2,2456,2286,170,0,107,0,6
63481,2,2474,2411,63,0,249,0,6
63482,1,2505,2553,-48,0,21,0,6
63483,2,2302,2507,-205,0,121,1,6
63484,1,2458,2369,89,0,490,0,6
63485,2,2369,2402,-33,0,40,0,6
63486,1,2718,2472,246,0,332,0,6
63487,1,2454,2450,4,0,218,0,6
63488,3,2608,2820,-212,0,162,0,6
63489,1,2617,2473,144,0,306,0,6
63490,2,2549,2603,-54,0,200,0,6
63491,1,2411,2513,-102,0,0,0,6
63492,2,2524,2382,142,0,84,0,6
63493,2,2463,2431,32,0,109,1,6
63494,1,2472,2345,127,0,4,0,6
63495,2,2618,2529,89,0,106,0,6
63496,2,2401,2471,-70,0,110,1,6
63497,1,2495,2635,-140,0,125,0,6
63498,1,2733,2597,136,0,122,0,6
63499,1,2352,2423,-71,0,270,0,6
63500,3,2460,2528,-68,0,308,0,6
63501,1,2485,2451,34,0,101,0,6
63502,1,2420,2378,42,0,106,0,6
63503,2,2392,2509,-117,0,52,1,6
63504,1,2411,2562,-151,0,13,0,6
63505,2,2377,2422,-45,0,46,1,6
63506,1,2618,2623,-5,0,140,0,6
63507,2,2617,2699,-82,0,305,0,6
63508,2,2525,2412,113,0,331,1,6
63509,1,2621,2411,210,0,311,0,6
63510,1,2443,2514,-71,0,0,0,6
63511,1,2601,2638,-37,0,57,0,6
63512,2,2486,2472,14,0,100,0,6
63513,1,2608,2545,63,0,302,0,6
63514,1,2457,2279,178,0,302,1,6
63515,1,2553,2433,120,0,207,0,6
63516,2,2260,2429,-169,0,5,0,6
63517,1,2433,2565,-132,0,371,1,6
63518,1,2668,2513,155,0,216,0,6
63519,1,2396,2402,-6,0,464,0,6
63520,1,2608,2511,97,0,334,0,6
63521,2,2605,2735,-130,0,140,0,6
63522,2,2386,2547,-161,0,112,0,6
63523,1,2609,2628,-19,0,464,0,6
63524,1,2535,2445,90,0,200,0,6
63525,1,2547,2392,155,0,190,0,6
63526,1,2536,2507,29,0,255,0,6
63527,1,2439,2339,100,0,115,0,6
63528,1,2614,2611,3,0,0,0,6
63529,1,2427,2374,53,0,1,0,6
63530,1,2476,2406,70,0,107,0,6
63531,1,2414,2566,-152,0,113,1,6
63532,2,2417,2473,-56,0,213,1,6
63533,2,2450,2420,30,0,129,1,6
63534,1,2544,2552,-8,0,4,0,6
63535,1,2473,2518,-45,0,57,0,6
63536,2,2398,2412,-14,0,8,0,6
63537,1,2477,2699,-222,0,455,0,6
63539,2,2566,2720,-154,0,1,0,6
63540,2,2695,2482,213,0,190,1,6
63541,1,2229,2459,-230,0,110,0,6
63542,1,2467,2513,-46,0,40,0,6
63543,2,2536,2408,128,0,150,0,6
63544,1,2461,2282,179,4,310,0,13
63545,2,2518,2354,164,0,40,0,6
63546,1,2578,2432,146,0,249,1,6
63547,1,2428,2490,-62,0,9,1,6
63548,2,2689,2737,-48,0,247,0,6
63549,1,2567,2401,166,0,163,0,6
63550,3,2593,2697,-104,0,302,0,6
63551,2,2370,2416,-46,0,4,0,6
63552,1,2446,2688,-242,0,300,0,6
63553,1,2448,2340,108,0,150,0,6
63554,1,2365,2432,-67,0,333,0,6
63555,2,2365,2434,-69,0,61,0,6
63556,1,2418,2443,-25,0,5,0,6
63557,2,2511,2749,-238,0,200,0,6
63558,1,2571,2467,104,0,207,0,6
63559,1,2542,2507,35,0,253,0,6
63560,2,2533,2584,-51,0,215,0,6
63561,2,2511,2455,56,0,45,0,6
63562,1,2740,2676,64,0,43,0,6
63563,1,2430,2669,-239,0,4,1,6
63564,2,2571,2611,-40,0,4,1,6
63565,2,2510,2559,-49,0,60,0,6
63566,2,2768,2817,-49,0,45,1,6
63567,2,2672,2712,-40,0,130,1,6
63568,1,2504,2564,-60,0,106,0,6
63569,2,2337,2408,-71,0,265,0,6
63570,3,2253,2410,-157,0,134,0,6
63571,3,2513,2585,-72,0,335,0,6
63572,1,2450,2466,-16,0,155,1,6
63573,3,2486,2428,58,0,331,0,6
63574,2,2480,2550,-70,0,132,0,6
63575,1,2432,2535,-103,0,1,0,6
63576,2,2449,2239,210,0,200,0,6
63577,2,2540,2624,-84,0,124,0,6
63578,1,2723,2620,103,0,409,0,6
63579,2,2456,2586,-130,0,140,0,6
63580,2,2231,2496,-265,0,0,0,6
63581,1,2752,2612,140,0,125,0,6
63582,2,2478,2524,-46,0,106,0,6
63583,2,2369,2401,-32,0,117,1,6
63584,2,2407,2365,42,0,46,0,6
63585,2,2605,2542,63,0,100,0,6
63586,3,2555,2502,53,0,374,0,6
63587,1,2618,2544,74,0,444,0,6
63588,1,2608,2574,34,0,49,0,6
63589,2,2450,2391,59,0,301,1,6
63590,1,2473,2365,108,0,10,0,6
63591,1,2421,2365,56,0,146,0,6
63592,1,2462,2358,104,0,380,0,6
63593,1,2627,2507,120,0,254,0,6
63594,2,2457,2223,234,0,131,0,6
63595,1,2495,2516,-21,0,106,1,6
63597,1,2628,2613,15,0,101,0,6
63598,1,2503,2450,53,0,116,0,6
63599,1,2704,2536,168,0,46,0,6
63600,1,2384,2444,-60,0,300,0,6
63602,1,2507,2470,37,0,22,0,6
63603,1,2745,2727,18,0,429,0,6
63604,2,2616,2741,-125,0,0,0,6
63605,1,2609,2634,-25,0,49,0,6
63606,2,2671,2616,55,0,46,0,6
63607,2,2448,2371,77,0,213,0,6
63608,1,2425,2383,42,0,190,1,6
63609,1,2477,2462,15,0,344,1,6
63610,2,2627,2756,-129,0,211,0,6
63611,1,2550,2621,-71,0,150,0,6
63612,1,2410,2490,-80,0,45,0,6
63613,2,2507,2538,-31,0,270,1,6
63614,1,2527,2622,-95,0,120,0,6
63615,2,2422,2227,195,0,307,0,6
63616,1,2671,2607,64,0,9,0,6
63617,2,2404,2354,50,0,202,1,6
63618,1,2398,2426,-28,0,200,0,6
63619,1,2828,2742,86,0,45,1,6
63620,2,2632,2680,-48,0,106,0,6
63621,2,2684,2647,37,0,123,0,6
63622,2,2540,2460,80,0,4,0,6
63623,2,2360,2403,-43,0,8,0,6
63624,2,2321,2570,-249,0,123,0,6
63625,1,2474,2251,223,0,13,1,6
63626,2,2445,2481,-36,0,17,0,6
63627,1,2401,2250,151,0,241,1,6
63628,1,2383,2575,-192,0,487,1,6
63629,1,2522,2514,8,0,56,0,6
63630,1,2586,2346,240,0,43,0,6
63631,2,2455,2582,-127,0,106,1,6
63632,2,2586,2553,33,0,426,0,6
63633,1,2530,2518,12,0,201,0,6
63634,1,2338,2442,-104,0,45,0,6
63635,2,2388,2485,-97,0,1,0,6
63636,1,2475,2361,114,0,343,1,6
63637,2,2369,2411,-42,0,112,0,6
63638,3,2420,2405,15,0,177,0,6
63639,1,2417,2393,24,0,454,0,6
63640,1,2416,2248,168,0,217,0,6
63641,1,2402,2284,118,0,310,0,6
63642,2,2401,2553,-152,0,25,0,6
63643,2,2560,2631,-71,0,133,0,6
63644,2,2546,2529,17,0,106,0,6
63645,2,2550,2627,-77,0,4,1,6
63646,2,2503,2473,30,0,100,0,6
63647,2,2436,2435,1,0,21,0,6
63648,1,2451,2462,-11,0,394,1,6
63649,3,2487,2428,59,0,313,0,6
63650,2,2433,2303,130,0,46,0,6
63651,1,2575,2416,159,0,0,1,6
63652,2,2437,2377,60,0,110,0,6
63653,1,2573,2612,-39,0,100,0,6
63654,1,2507,2404,103,0,113,0,6
63655,1,2490,2474,16,0,106,1,6
63656,1,2616,2745,-129,0,123,0,6
63658,3,2393,2478,-85,0,460,0,6
63659,3,2599,2472,127,0,112,0,6
63660,1,2417,2440,-23,0,304,0,6
63661,1,2624,2325,299,0,40,0,6
63662,1,2548,2566,-18,0,101,0,6
63663,2,2336,2452,-116,0,133,0,6
63664,2,2510,2322,188,0,120,0,6
63665,2,2584,2514,70,0,115,0,6
63666,2,2501,2445,56,0,107,0,6
63667,1,2615,2505,110,0,4,0,6
63668,1,2429,2270,159,0,200,0,6
63669,2,2512,2465,47,0,115,0,6
63670,3,2628,2595,33,0,111,0,6
63671,1,2424,2557,-133,0,30,0,6
63672,1,2695,2564,131,0,4,0,6
63673,3,2438,2420,18,0,268,0,6
63674,2,2533,2512,21,0,200,0,6
63675,2,2504,2307,197,0,300,0,6
63676,2,2614,2508,106,0,46,0,6
63677,2,2467,2479,-12,0,144,0,6
63678,3,2569,2547,22,0,7,0,6
63679,3,2462,2576,-114,0,245,0,6
63680,1,2463,2513,-50,0,102,0,6
63681,1,2503,2554,-51,0,4,1,6
63682,2,2408,2408,0,0,448,0,6
63683,2,2343,2416,-73,0,42,0,8
63684,1,2294,2465,-171,0,43,1,6
63685,1,2724,2665,59,0,129,0,6
63686,2,2503,2685,-182,0,228,0,6
63687,1,2622,2563,59,0,463,0,6
63688,1,2636,2601,35,0,310,0,6
63689,2,2554,2511,43,0,8,0,6
63690,2,2356,2552,-196,0,376,1,6
63691,3,2455,2416,39,0,4,0,6
63692,2,2462,2521,-59,0,28,0,6
63693,1,2660,2589,71,0,203,0,6
63694,2,2557,2627,-70,0,46,0,6
63695,2,2498,2348,150,0,373,0,6
63696,1,2528,2431,97,0,250,0,6
63697,2,2560,2750,-190,0,302,0,6
63698,2,2426,2475,-49,0,123,1,6
63699,2,2721,2555,166,0,46,0,6
63700,1,2378,2440,-62,0,191,0,6
63701,2,2519,2679,-160,0,36,0,6
63702,2,2659,2444,215,0,120,0,6
63703,2,2248,2519,-271,0,100,0,6
63704,2,2455,2527,-72,0,300,0,6
63705,2,2487,2372,115,0,40,1,6
63706,1,2540,2606,-66,0,209,0,6
63707,1,2419,2355,64,0,50,0,6
63708,1,2474,2678,-204,0,315,0,6
63709,3,2555,2373,182,0,106,0,6
63710,2,2247,2510,-263,0,11,0,6
63711,2,2491,2751,-260,0,41,0,6
63712,2,2393,2518,-125,0,45,0,6
63713,1,2535,2516,19,0,20,0,6
63714,1,2654,2597,57,0,332,1,6
63715,2,2396,2509,-113,0,101,0,6
63716,1,2477,2491,-14,0,405,0,6
63717,1,2425,2260,165,0,250,0,6
63718,1,2557,2400,157,0,264,0,6
63719,2,2398,2470,-72,0,10,0,6
63720,1,2612,2486,126,0,7,0,6
63721,1,2557,2485,72,0,311,0,6
63722,2,2676,2667,9,0,15,0,6
63723,1,2822,2699,123,0,110,0,6
63724,1,2690,2462,228,0,218,0,6
63725,1,2753,2763,-10,0,50,0,6
63726,2,2429,2485,-56,0,301,1,6
63727,1,2603,2608,-5,0,58,0,6
63728,1,2330,2406,-76,0,487,1,6
63729,3,2404,2504,-100,0,49,0,6
63730,2,2506,2460,46,0,143,1,6
63731,1,2717,2557,160,0,192,0,6
63732,2,2372,2462,-90,0,380,0,6
63733,1,2435,2383,52,0,101,0,6
63734,1,2518,2558,-40,0,300,1,6
63735,1,2627,2548,79,0,463,0,6
63736,1,2312,2496,-184,0,389,0,6
63737,1,2316,2452,-136,0,41,0,6
63738,3,2426,2432,-6,0,201,0,6
63739,2,2266,2590,-324,0,45,0,6
63740,2,2452,2532,-80,0,13,0,6
63741,1,2739,2494,245,0,311,0,6
63742,2,2249,2424,-175,0,463,0,6
63743,1,2415,2322,93,0,28,0,6
63744,1,2552,2316,236,0,46,0,6
63745,1,2437,2355,82,0,300,0,6
63746,1,2456,2457,-1,0,131,0,6
63747,1,2412,2333,79,0,2,0,6
63748,1,2319,2582,-263,0,123,0,6
63749,2,2547,2479,68,0,100,0,6
63750,1,2660,2669,-9,0,300,0,6
63751,2,2729,2619,110,0,101,0,6
63752,1,2501,2579,-78,0,43,0,6
63753,2,2602,2482,120,0,302,0,6
63754,3,2631,2606,25,0,10,0,6
63755,2,2545,2456,89,0,110,0,6
63756,1,2471,2484,-13,0,0,0,6
63757,1,2569,2497,72,0,4,0,6
63759,2,2609,2546,63,0,404,0,6
63760,3,2523,2388,135,0,330,0,8
63761,1,2402,2218,184,0,300,0,6
63762,2,2413,2262,151,0,357,0,6
63763,2,2398,2503,-105,0,145,0,6
63764,1,2558,2422,136,0,415,0,6
63765,2,2388,2423,-35,0,265,0,6
63766,1,2489,2384,105,0,106,1,6
63767,1,2456,2501,-45,0,13,0,6
63768,2,2544,2627,-83,0,457,0,6
63769,1,2688,2623,65,0,6,1,6
63770,2,2290,2440,-150,0,40,1,6
63771,2,2515,2534,-19,0,21,0,6
63772,2,2248,2467,-219,0,123,0,6
63773,1,2624,2707,-83,0,145,1,6
63774,2,2563,2632,-69,0,201,0,6
63775,1,2737,2760,-23,0,107,0,6
63776,1,2682,2533,149,0,241,0,6
63777,2,2595,2500,95,0,43,1,6
63778,2,2282,2401,-119,0,40,0,6
63779,3,2510,2483,27,0,1,0,6
63780,1,2354,2404,-50,0,305,0,6
63781,1,2406,2441,-35,0,45,0,6
63782,2,2532,2547,-15,0,123,0,6
63783,2,2433,2480,-47,0,464,0,6
63784,2,2430,2391,39,0,100,0,6
63785,2,2384,2437,-53,0,332,0,6
63786,2,2463,2453,10,0,143,0,6
63787,2,2419,2476,-57,0,49,0,6
63788,1,2585,2451,134,0,345,0,6
63789,2,2385,2664,-279,0,115,0,6
63790,1,2695,2713,-18,0,4,0,6
63791,1,2600,2615,-15,0,49,0,6
63792,2,2538,2650,-112,0,170,0,6
63793,1,2404,2480,-76,0,4,0,6
63794,1,2397,2561,-164,0,193,0,6
63795,1,2419,2425,-6,0,40,1,6
63796,1,2304,2408,-104,2,234,0,25
63797,1,2240,2411,-171,0,311,1,6
63798,2,2322,2445,-123,0,41,0,6
63799,2,2664,2554,110,0,122,0,6
63800,2,2353,2413,-60,0,127,1,6
63801,1,2591,2463,128,0,344,0,6
63802,1,2616,2541,75,0,7,0,6
63803,2,2490,2720,-230,0,306,1,6
63804,2,2666,2826,-160,0,302,0,6
63805,1,2482,2614,-132,0,4,1,6
63806,1,2632,2594,38,0,101,0,6
63807,1,2486,2552,-66,0,106,0,6
63808,1,2495,2557,-62,0,190,0,6
63809,1,2483,2418,65,0,45,0,6
63810,3,2468,2311,157,0,335,0,6
63811,1,2757,2701,56,0,301,0,6
63812,1,2459,2477,-18,0,112,0,6
63813,1,2627,2672,-45,0,4,0,6
63814,2,2707,2759,-52,0,302,0,6
63815,3,2486,2496,-10,0,200,0,6
63816,1,2574,2412,162,0,110,0,6
63817,2,2423,2464,-41,0,48,0,6
63818,1,2549,2475,74,0,207,1,6
63819,2,2670,2721,-51,0,4,0,6
63820,1,2478,2693,-215,0,265,1,6
63821,1,2513,2432,81,0,121,0,6
63822,3,2468,2439,29,0,0,0,6
63823,1,2434,2330,104,0,434,0,6
63824,1,2441,2354,87,0,0,0,6
63825,1,2510,2340,170,0,151,0,6
63826,1,2240,2405,-165,0,343,1,6
63827,1,2401,2318,83,0,202,0,8
63828,1,2589,2832,-243,0,302,1,6
63829,1,2521,2480,41,0,310,0,6
63830,2,2537,2561,-24,0,162,0,6
63831,1,2447,2540,-93,0,1,1,6
63832,1,2738,2510,228,0,258,0,6
63833,1,2501,2419,82,0,190,1,6
63834,2,2344,2479,-135,0,58,0,6
63835,1,2428,2511,-83,0,311,0,6
63836,1,2696,2631,65,0,5,0,6
63837,3,2636,2762,-126,0,50,0,6
63838,2,2455,2260,195,0,5,0,6
63839,1,2400,2329,71,0,300,1,6
63840,2,2377,2626,-249,0,0,0,6
63841,2,2459,2489,-30,0,151,0,6
63842,1,2637,2573,64,0,106,0,6
63843,1,2417,2356,61,0,386,0,6
63844,3,2220,2477,-257,0,210,0,6
63845,1,2753,2518,235,0,0,0,6
63846,2,2606,2558,48,0,0,0,6
63847,1,2429,2357,72,0,40,1,6
63848,3,2428,2486,-58,0,46,0,6
63849,1,2380,2512,-132,0,200,0,6
63850,2,2296,2509,-213,0,134,1,6
63851,1,2567,2451,116,0,45,0,6
63852,1,2580,2391,189,0,400,0,6
63853,1,2586,2589,-3,0,211,0,6
63854,2,2606,2536,70,0,143,0,6
63855,2,2559,2527,32,0,133,0,6
63856,1,2413,2249,164,4,56,0,13
63857,2,2485,2383,102,0,190,0,6
63858,3,2702,2641,61,0,1,0,6
63859,2,2376,2534,-158,0,5,0,6
63860,1,2428,2552,-124,0,58,0,6
63861,1,2596,2426,170,0,270,0,6
63862,2,2609,2666,-57,0,4,0,6
63863,3,2764,2606,158,0,335,0,6
63864,1,2431,2315,116,0,113,0,6
63865,1,2654,2432,222,0,14,0,6
63866,3,2448,2467,-19,0,141,0,6
63867,1,2445,2478,-33,0,40,1,6
63868,3,2397,2410,-13,0,101,0,6
63869,1,2522,2424,98,0,335,0,6
63870,3,2552,2539,13,0,120,0,6
63871,3,2457,2457,0,0,143,0,6
63872,3,2537,2361,176,0,0,0,6
63873,1,2632,2524,108,0,101,0,6
63874,1,2552,2424,128,0,132,0,6
63875,1,2572,2662,-90,0,0,0,6
63876,2,2829,2508,321,0,216,0,6
63877,3,2490,2602,-112,0,374,0,6
63878,1,2544,2547,-3,0,200,0,6
63879,3,2577,2512,65,0,245,0,6
63880,2,2555,2418,137,0,5,0,6
63881,1,2305,2421,-116,0,42,1,8
63882,1,2428,2368,60,0,211,0,6
63883,1,2254,2413,-159,0,400,0,6
63884,1,2477,2456,21,0,40,0,6
63885,3,2487,2380,107,0,4,0,6
63886,2,2428,2383,45,0,454,0,6
63887,1,2425,2338,87,0,122,0,8
63888,1,2247,2409,-162,4,40,0,13
63889,2,2381,2440,-59,0,307,0,6
63890,1,2485,2513,-28,0,341,1,6
63891,2,2232,2405,-173,0,53,0,6
63892,1,2416,2483,-67,0,242,0,6
63893,1,2394,2493,-99,0,110,0,6
63894,1,2552,2405,147,0,264,1,6
63895,1,2352,2413,-61,0,300,0,6
63896,1,2415,2571,-156,0,400,0,6
63897,1,2537,2370,167,0,192,0,6
63898,1,2413,2488,-75,0,300,1,6
63900,3,2302,2406,-104,0,43,0,8
63901,2,2457,2302,155,0,154,0,6
63902,2,2315,2443,-128,0,301,0,6
63903,1,2314,2485,-171,0,226,1,6
63905,2,2280,2429,-149,0,133,0,6
63906,2,2686,2681,5,0,265,0,6
63907,1,2413,2483,-70,0,57,1,6
63908,2,2541,2452,89,0,255,0,6
63909,2,2392,2418,-26,0,15,1,6
63910,3,2541,2397,144,0,46,0,6
63911,1,2415,2506,-91,0,58,0,6
63912,1,2470,2340,130,0,37,0,6
63913,2,2411,2345,66,0,8,0,6
63914,2,2409,2451,-42,0,0,0,6
63915,1,2344,2436,-92,0,45,0,6
63916,1,2513,2576,-63,0,340,0,6
63917,1,2441,2277,164,0,43,0,6
63918,1,2550,2548,2,0,227,0,6
63919,2,2447,2214,233,0,151,0,6
63920,1,2583,2315,268,0,310,0,6
63921,3,2388,2600,-212,0,338,0,6
63922,1,2534,2580,-46,0,466,0,6
63923,1,2512,2571,-59,0,455,0,6
63924,3,2592,2553,39,0,138,0,6
63925,1,2543,2388,155,0,220,1,6
63926,1,2422,2436,-14,0,44,0,6
63927,2,2486,2401,85,0,4,0,6
63928,2,2419,2561,-142,0,110,0,6
63929,2,2273,2433,-160,0,333,0,6
63930,1,2500,2433,67,0,453,0,6
63931,2,2485,2363,122,0,490,0,6
63932,3,2381,2416,-35,0,45,0,6
63933,1,2389,2421,-32,0,100,0,6
63934,2,2542,2556,-14,0,151,0,6
63935,1,2360,2404,-44,0,134,0,6
63936,2,2554,2555,-1,0,248,0,6
63937,2,2425,2459,-34,0,123,0,6
63938,2,2310,2449,-139,0,121,0,6
63939,2,2403,2278,125,0,0,0,6
63940,1,2555,2452,103,0,335,0,6
63941,1,2423,2376,47,0,133,0,6
63942,1,2432,2386,46,0,40,0,6
63943,3,2467,2497,-30,0,301,0,6
63944,1,2476,2563,-87,0,14,0,6
63945,2,2481,2420,61,0,45,0,6
63946,1,2687,2680,7,0,190,0,6
63947,2,2476,2408,68,0,43,0,6
63948,2,2339,2420,-81,0,200,1,6
63949,1,2401,2429,-28,0,106,1,6
63950,2,2322,2428,-106,0,190,1,6
63951,1,2286,2413,-127,0,120,0,6
63952,2,2391,2539,-148,0,200,0,6
63953,2,2299,2451,-152,0,202,0,6
63954,1,2447,2260,187,0,116,0,8
63955,2,2331,2506,-175,0,1,0,6
63956,2,2489,2478,11,0,300,0,6
63957,2,2367,2540,-173,0,131,0,6
63958,2,2413,2284,129,0,102,1,8
63959,1,2404,2351,53,0,335,0,8
63960,2,2371,2467,-96,0,380,0,6
63961,2,2507,2351,156,0,21,1,6
63962,1,2570,2522,48,0,106,1,6
63963,1,2510,2311,199,4,145,0,13
63964,2,2668,2464,204,0,414,0,6
63965,1,2561,2561,0,0,270,0,6
63966,1,2437,2548,-111,0,107,0,6
63967,2,2394,2471,-77,0,0,0,6
63968,2,2352,2423,-71,0,110,1,6
63969,1,2406,2404,2,0,49,0,6
63970,2,2476,2370,106,0,405,1,6
63971,2,2354,2537,-183,0,302,0,6
63972,3,2396,2404,-8,0,300,0,6
63973,1,2456,2359,97,0,126,0,6
63974,2,2416,2349,67,4,52,0,13
63975,1,2384,2411,-27,0,110,0,6
63976,1,2382,2483,-101,0,45,1,6
63977,1,2693,2675,18,0,101,0,6
63978,2,2313,2597,-284,0,104,0,6
63979,2,2249,2438,-189,0,16,0,6
63980,2,2340,2506,-166,0,106,0,6
63981,1,2554,2281,273,0,110,0,6
63982,3,2585,2540,45,0,385,0,6
63983,1,2518,2546,-28,0,455,0,6
63984,2,2576,2591,-15,0,46,0,6
63985,2,2454,2476,-22,0,201,1,6
63986,1,2427,2475,-48,0,45,0,6
63987,1,2415,2396,19,0,454,0,6
63988,3,2458,2556,-98,0,302,0,6
63989,1,2351,2459,-108,0,45,0,6
63990,2,2470,2444,26,0,487,0,6
63991,2,2444,2415,29,0,40,0,6
63992,1,2543,2364,179,0,110,0,6
63993,1,2543,2388,155,0,46,0,6
63994,3,2406,2428,-22,0,190,0,6
63995,3,2483,2505,-22,0,300,0,6
63996,2,2352,2484,-132,0,110,0,6
63997,1,2421,2438,-17,0,202,0,6
63998,1,2565,2415,150,0,17,0,6
63999,2,2392,2444,-52,0,244,0,6
64000,1,2592,2419,173,0,485,1,6
64001,1,2317,2452,-135,0,151,0,6
64002,2,2488,2424,64,0,40,0,6
64003,2,2405,2233,172,0,354,0,6
64004,2,2541,2540,1,0,9,0,6
64005,3,2502,2351,151,0,100,0,6
64006,2,2473,2659,-186,0,331,1,6
64007,2,2367,2536,-169,0,380,1,6
64008,2,2361,2408,-47,0,335,0,6
64009,1,2516,2575,-59,0,340,1,6
64010,3,2361,2401,-40,0,4,0,6
64011,2,2422,2567,-145,0,190,0,6
64012,2,2475,2389,86,0,40,0,6
64013,1,2670,2698,-28,0,249,1,6
64014,1,2390,2421,-31,0,265,1,6
64015,2,2249,2401,-152,4,353,0,13
64016,1,2555,2549,6,0,100,1,6
64017,2,2384,2546,-162,0,40,0,6
64018,1,2420,2417,3,0,245,0,6
64019,2,2464,2440,24,0,386,0,6
64020,2,2450,2349,101,0,41,1,6
64021,2,2429,2310,119,0,108,1,6
64022,1,2468,2433,35,0,45,0,6
64023,2,2398,2514,-116,0,4,0,6
64024,2,2416,2389,27,0,40,1,6
64025,2,2476,2484,-8,0,344,1,6
64026,2,2359,2432,-73,0,40,1,6
64027,2,2422,2354,68,0,1,0,6
64028,1,2554,2460,94,0,143,0,6
64029,1,2340,2505,-165,0,245,0,6
64030,2,2441,2287,154,0,151,0,6
64031,2,2510,2571,-61,0,5,0,6
64032,1,2541,2597,-56,0,466,1,6
64033,1,2598,2584,14,0,207,0,6
64034,1,2540,2391,149,0,150,0,6
64035,1,2556,2525,31,0,172,0,6
64036,2,2361,2546,-185,0,45,0,6
64037,1,2387,2434,-47,0,269,0,6
64038,1,2406,2409,-3,0,245,0,8
64039,3,2341,2449,-108,0,332,0,6
64040,1,2469,2305,164,0,344,0,6
64041,2,2326,2425,-99,0,317,0,6
64042,2,2404,2350,54,0,62,1,6
64043,2,2428,2546,-118,0,320,0,6
64044,2,2428,2348,80,0,106,0,6
64045,2,2353,2535,-182,0,46,0,6
64046,3,2381,2559,-178,0,128,0,6
64047,1,2439,2367,72,0,300,1,6
64048,1,2317,2428,-111,0,49,0,6
64049,2,2449,2439,10,0,113,1,6
64050,1,2483,2422,61,0,22,0,6
64051,1,2481,2521,-40,0,300,0,6
64052,2,2431,2413,18,0,41,0,6
64053,2,2662,2470,192,0,81,0,6
64054,1,2465,2381,84,0,190,0,6
64055,2,2361,2419,-58,0,1,0,6
64056,1,2551,2424,127,0,110,0,6
64057,1,2411,2273,138,0,2,0,6
64058,2,2568,2524,44,0,106,1,6
64059,1,2364,2458,-94,0,354,0,6
64060,1,2358,2409,-51,4,190,0,13
64061,1,2445,2325,120,0,288,0,6
64062,1,2692,2676,16,0,101,1,6
64063,2,2428,2473,-45,0,457,0,6
64064,2,2489,2470,19,0,380,1,6
64065,1,2455,2397,58,0,48,1,6
64066,1,2412,2369,43,0,305,0,6
64067,2,2339,2442,-103,0,123,0,6
64068,2,2415,2397,18,0,107,0,6
64069,1,2412,2569,-157,0,255,1,6
64070,1,2550,2518,32,0,40,0,6
64071,2,2543,2424,119,0,190,0,6
64072,1,2464,2350,114,0,40,0,6
64073,1,2344,2445,-101,0,380,0,6
64074,2,2571,2538,33,0,148,0,6
64075,1,2285,2437,-152,0,203,0,6
64076,2,2366,2501,-135,0,101,0,6
64077,1,2428,2408,20,0,264,0,6
64078,1,2402,2375,27,0,167,0,6
64079,2,2479,2654,-175,0,300,0,6
64080,1,2549,2358,191,0,214,0,6
64081,2,2413,2396,17,0,40,0,6
64082,1,2540,2561,-21,0,255,0,6
64083,2,2446,2354,92,0,0,0,6
64084,1,2355,2421,-66,0,9,0,6
64085,1,2472,2310,162,0,202,1,6
64086,2,2281,2406,-125,0,101,0,6
64087,2,2497,2447,50,0,386,0,6
64088,1,2446,2334,112,0,490,0,6
64089,2,2604,2548,56,0,112,0,6
64090,1,2576,2579,-3,0,398,0,6
64091,1,2590,2390,200,0,296,0,6
64092,1,2519,2208,311,0,302,0,6
64093,2,2505,2561,-56,0,123,0,6
64094,2,2341,2544,-203,0,177,0,6
64095,2,2364,2472,-108,0,148,1,6
64096,1,2515,2487,28,0,300,0,6
64097,2,2256,2415,-159,0,205,0,6
64098,2,2447,2384,63,0,139,0,6
64100,1,2423,2422,1,0,302,0,6
64101,2,2555,2603,-48,0,310,0,6
64102,3,2425,2432,-7,0,310,0,6
64103,3,2412,2400,12,0,120,0,6
64104,1,2365,2424,-59,0,245,0,6
64105,1,2513,2450,63,0,1,0,6
64106,1,2424,2371,53,0,212,0,6
64107,3,2411,2284,127,0,40,0,8
64108,1,2415,2417,-2,0,1,0,6
64109,2,2409,2277,132,0,405,0,6
64110,2,2490,2449,41,0,124,0,6
64111,2,2436,2550,-114,0,300,0,6
64112,1,2545,2565,-20,0,151,0,6
64113,3,2429,2346,83,0,40,0,6
64114,3,2393,2468,-75,0,130,0,6
64115,3,2471,2343,128,0,312,0,6
64116,1,2438,2483,-45,0,200,0,6
64117,2,2403,2409,-6,0,265,0,6
64118,1,2490,2345,145,0,80,0,6
64119,2,2274,2439,-165,0,100,0,6
64120,3,2426,2382,44,0,4,0,6
64121,2,2355,2552,-197,0,45,0,6
64122,1,2417,2433,-16,0,106,0,6
64123,1,2420,2316,104,0,400,0,6
64124,1,2502,2217,285,0,102,0,6
64125,1,2391,2425,-34,0,102,0,6
64126,2,2470,2433,37,0,15,1,6
64127,2,2657,2476,181,0,123,0,6
64128,3,2555,2546,9,0,228,0,6
64129,2,2559,2551,8,0,132,0,6
64130,2,2407,2460,-53,0,43,0,6
64131,1,2482,2520,-38,0,106,0,6
64132,2,2446,2294,152,0,411,0,6
64133,1,2445,2362,83,0,4,0,6
64134,1,2546,2475,71,0,108,0,6
64135,2,2369,2441,-72,0,334,0,6
64136,3,2415,2322,93,0,210,0,6
64137,1,2433,2270,163,0,131,1,6
64138,2,2339,2597,-258,0,115,0,6
64139,1,2206,2582,-376,0,140,0,6
64140,2,2593,2521,72,0,241,0,6
64141,1,2554,2392,162,0,357,0,6
64142,1,2573,2337,236,0,31,0,6
64143,2,2227,2546,-319,0,0,1,6
64144,2,2387,2566,-179,0,123,0,6
64145,1,2560,2420,140,0,4,1,6
64146,1,2557,2553,4,0,151,0,6
64147,1,2405,2256,149,4,41,1,13
64148,1,2372,2430,-58,0,200,0,6
64149,2,2554,2470,84,0,40,1,6
64150,1,2484,2648,-164,0,320,1,6
64151,1,2483,2321,162,0,302,0,6
64152,2,2391,2413,-22,0,190,0,6
64153,2,2432,2425,7,0,84,0,6
64154,2,2509,2362,147,0,1,0,6
64155,1,2377,2465,-88,0,133,1,6
64156,2,2395,2445,-50,0,333,0,6
64157,3,2411,2421,-10,0,49,0,6
64158,1,2414,2397,17,0,454,0,6
64159,2,2256,2441,-185,0,14,1,6
64160,1,2442,2272,170,0,0,0,6
64161,2,2518,2477,41,0,303,0,6
64162,2,2270,2444,-174,0,245,0,6
64163,1,2423,2402,21,0,7,0,6
64164,2,2547,2562,-15,0,241,0,6
64165,2,2400,2423,-23,0,345,0,6
64166,2,2348,2427,-79,0,4,0,6
64167,2,2349,2443,-94,0,0,0,6
64168,1,2414,2476,-62,0,242,1,6
64169,2,2391,2576,-185,0,200,0,6
64170,2,2345,2469,-124,0,106,0,6
64171,1,2502,2274,228,0,220,0,6
64172,2,2310,2453,-143,0,100,1,6
64173,1,2556,2327,229,0,338,0,6
64174,2,2390,2401,-11,0,321,1,6
64175,2,2455,2481,-26,0,200,0,6
64176,2,2470,2389,81,0,4,1,6
64177,2,2608,2762,-154,0,292,1,6
64178,3,2438,2289,149,0,487,0,6
64179,2,2432,2445,-13,0,4,0,6
64180,2,2418,2341,77,0,2,0,6
64181,1,2447,2313,134,0,122,0,6
64182,2,2425,2532,-107,0,368,1,6
64183,1,2440,2349,91,0,138,0,6
64184,1,2412,2400,12,0,45,0,6
64185,1,2400,2226,174,0,107,0,6
64186,2,2477,2464,13,0,56,0,6
64187,1,2426,2402,24,0,309,0,6
64188,2,2351,2401,-50,0,41,0,6
64189,3,2550,2527,23,0,426,0,6
64190,2,2514,2489,25,0,300,0,6
64191,1,2546,2423,123,0,100,0,6
64192,1,2349,2410,-61,0,302,1,8
64193,2,2420,2379,41,0,132,0,6
64194,2,2568,2542,26,0,151,0,6
64195,1,2431,2376,55,0,310,0,6
64196,1,2428,2310,118,0,454,1,6
64197,1,2483,2327,156,0,492,1,6
64198,2,2438,2547,-109,0,101,0,6
64199,2,2417,2564,-147,0,110,0,6
64200,2,2335,2571,-236,0,112,0,6
64201,1,2576,2384,192,0,398,1,6
64202,2,2227,2558,-331,0,0,1,6
64203,1,2528,2600,-72,0,310,0,6
64204,2,2569,2437,132,0,262,0,6
64205,1,2548,2217,331,0,220,0,6
64206,2,2493,2462,31,0,56,1,6
64207,2,2392,2420,-28,0,265,0,6
64208,1,2529,2366,163,0,104,0,6
64209,1,2380,2444,-64,0,141,0,6
64210,2,2493,2384,109,0,50,0,6
64211,1,2495,2508,-13,0,43,1,6
64212,1,2470,2665,-195,0,4,0,6
64213,1,2403,2279,124,4,440,0,13
64214,1,2407,2341,66,0,108,0,6
64216,1,2419,2396,23,0,6,0,6
64217,2,2555,2550,5,0,211,1,6
64218,2,2470,2412,58,0,49,0,6
64219,1,2431,2364,67,0,129,0,6
64220,1,2321,2411,-90,0,40,0,6
64221,2,2402,2348,54,0,300,0,6
64222,2,2528,2463,65,0,110,0,6
64223,1,2765,2605,160,0,300,0,6
64224,2,2457,2435,22,0,251,0,6
64225,2,2494,2468,26,0,58,1,6
64226,1,2572,2456,116,0,345,0,6
64227,1,2406,2382,24,0,127,1,6
64228,1,2366,2434,-68,0,150,0,6
64229,2,2551,2504,47,0,40,0,6
64230,2,2548,2562,-14,0,241,1,6
64231,1,2431,2487,-56,0,347,1,6
64232,3,2470,2421,49,0,325,0,6
64233,2,2267,2460,-193,0,106,0,6
64234,1,2421,2367,54,0,218,0,6
64235,2,2550,2385,165,0,132,0,6
64236,3,2487,2329,158,0,335,0,6
64237,3,2421,2411,10,0,1,0,6
64238,1,2506,2392,114,0,70,0,6
64239,2,2432,2338,94,0,352,0,6
64240,1,2428,2286,142,0,121,1,6
64241,3,2458,2635,-177,0,45,0,6
64242,3,2488,2450,38,0,5,0,6
64243,1,2568,2413,155,0,4,0,6
64244,2,2544,2387,157,0,49,0,6
64245,2,2306,2473,-167,0,128,0,6
64246,2,2238,2403,-165,0,331,1,8
64247,1,2493,2505,-12,0,46,0,6
64248,1,2511,2545,-34,0,308,1,6
64249,2,2437,2479,-42,0,106,0,6
64250,1,2576,2656,-80,0,140,0,6
64251,2,2544,2555,-11,0,40,0,6
64252,1,2420,2329,91,0,177,0,6
64253,1,2441,2447,-6,0,40,1,6
64254,2,2355,2508,-153,0,45,0,6
64255,1,2513,2213,300,4,263,0,13
64256,1,2425,2443,-18,0,31,1,6
64257,1,2450,2258,192,0,337,0,6
64258,1,2432,2431,1,0,343,0,6
64259,1,2556,2549,7,0,338,0,6
64260,1,2476,2373,103,0,210,0,6
64261,2,2532,2417,115,0,102,0,6
64262,3,2388,2488,-100,0,106,0,6
64263,1,2413,2338,75,0,344,1,6
64264,2,2567,2542,25,0,204,0,6
64265,2,2480,2424,56,0,415,1,6
64266,1,2438,2425,13,0,487,1,6
64267,1,2394,2542,-148,0,278,0,6
64268,2,2299,2411,-112,0,106,0,6
64269,3,2373,2484,-111,0,56,0,6
64270,1,2421,2365,56,0,37,0,6
64271,2,2450,2488,-38,0,130,0,6
64272,1,2425,2561,-136,0,406,1,6
64273,2,2253,2442,-189,4,4,0,13
64274,3,2602,2670,-68,0,101,0,6
64275,2,2345,2461,-116,0,31,0,6
64276,3,2482,2375,107,0,45,0,6
64277,1,2544,2535,9,0,123,0,6
64278,1,2443,2438,5,0,4,0,6
64279,1,2499,2499,0,0,115,1,6
64280,1,2649,2519,130,0,469,1,6
64281,2,2282,2432,-150,0,380,1,6
64282,1,2412,2421,-9,0,40,0,6
64283,1,2561,2538,23,0,200,1,6
64284,1,2511,2338,173,0,110,1,6
64285,1,2351,2437,-86,0,40,0,6
64286,2,2447,2501,-54,0,354,0,6
64287,2,2395,2539,-144,0,320,0,6
64288,2,2314,2484,-170,0,49,0,6
64289,1,2325,2403,-78,0,13,0,6
64290,1,2476,2356,120,0,33,0,6
64291,1,2561,2437,124,0,101,1,6
64292,2,2410,2571,-161,0,110,0,6
64293,3,2315,2426,-111,0,207,0,6
64294,2,2325,2415,-90,0,106,0,6
64295,1,2409,2284,125,4,49,0,13
64296,1,2422,2469,-47,0,242,1,6
64297,2,2334,2417,-83,0,162,0,6
64298,2,2327,2486,-159,0,10,0,6
64299,2,2364,2559,-195,0,45,1,6
64300,1,2463,2387,76,0,300,0,6
64301,1,2510,2326,184,0,405,0,6
64302,2,2419,2443,-24,0,190,1,6
64303,1,2389,2474,-85,0,216,0,6
64304,1,2430,2295,135,0,400,0,6
64305,2,2341,2534,-193,0,221,1,6
64306,2,2276,2406,-130,0,215,0,8
64307,1,2530,2360,170,0,122,0,6
64308,2,2364,2452,-88,4,103,0,13
64309,1,2554,2433,121,0,40,0,6
64310,1,2402,2494,-92,0,110,1,6
64311,2,2426,2370,56,0,50,0,6
64312,2,2554,2549,5,0,300,1,6
64313,2,2374,2449,-75,0,49,0,6
64314,1,2542,2505,37,0,45,0,6
64315,1,2515,2558,-43,0,200,0,6
64316,1,2467,2395,72,0,484,0,6
64317,1,2487,2397,90,0,347,0,6
64318,2,2311,2442,-131,0,46,1,6
64319,1,2436,2341,95,0,141,0,6
64320,1,2506,2583,-77,0,45,0,6
64321,1,2525,2494,31,0,200,1,6
64322,2,2385,2515,-130,0,183,0,6
64323,1,2537,2533,4,0,202,0,6
64324,1,2420,2375,45,0,129,0,6
64325,2,2497,2337,160,0,20,0,6
64326,2,2242,2400,-158,0,365,0,6
64327,2,2292,2434,-142,0,30,0,6
64328,2,2275,2407,-132,4,192,0,13
64329,1,2559,2315,244,0,337,0,6
64330,1,2432,2675,-243,0,122,1,6
64331,2,2433,2565,-132,0,1,1,6
64332,1,2669,2603,66,0,122,0,6
64333,1,2428,2391,37,0,45,1,6
64334,2,2335,2460,-125,0,1,0,6
64335,1,2592,2344,248,0,274,0,6
64336,2,2357,2490,-133,0,10,0,6
64337,3,2441,2448,-7,0,46,0,7
64338,2,2272,2419,-147,0,114,1,6
64339,2,2574,2407,167,0,4,1,6
64340,1,2364,2533,-169,0,45,1,6
64341,1,2428,2499,-71,0,331,0,6
64342,3,2471,2449,22,0,121,0,6
64343,2,2499,2318,181,0,4,0,6
64344,1,2547,2492,55,0,394,1,6
64345,2,2425,2527,-102,0,200,0,6
64346,2,2513,2542,-29,0,310,1,6
64347,1,2408,2429,-21,0,57,0,6
64348,2,2369,2471,-102,0,302,0,6
64349,2,2390,2526,-136,0,260,0,6
64350,1,2438,2395,43,0,310,0,6
64351,3,2462,2428,34,0,58,0,6
64352,1,2486,2409,77,0,6,0,6
64353,1,2440,2279,161,0,112,0,6
64354,2,2337,2414,-77,0,50,0,6
64355,2,2425,2392,33,0,150,0,6
64356,1,2413,2473,-60,4,46,0,13
64357,2,2555,2548,7,0,107,0,6
64358,2,2551,2449,102,0,343,0,6
64359,1,2598,2674,-76,0,101,0,6
64360,2,2338,2446,-108,0,244,0,6
64361,2,2441,2561,-120,0,122,0,6
64362,2,2424,2418,6,0,261,0,6
64363,2,2402,2501,-99,0,140,0,6
64364,1,2426,2392,34,0,7,1,6
64365,1,2410,2257,153,0,240,0,8
64366,2,2569,2522,47,0,143,0,6
64367,1,2430,2423,7,0,1,0,6
64368,1,2475,2298,177,0,50,1,6
64369,2,2434,2381,53,0,300,0,6
64370,3,2532,2467,65,0,347,0,6
64371,2,2425,2530,-105,0,211,0,6
64372,2,2488,2374,114,0,36,0,6
64373,2,2356,2480,-124,0,414,0,6
64374,2,2379,2487,-108,0,43,0,6
64375,2,2404,2374,30,0,127,0,6
64376,2,2342,2507,-165,0,266,0,6
64377,1,2492,2204,288,0,176,0,6
64378,2,2302,2418,-116,0,212,0,6
64379,2,2494,2491,3,0,441,1,6
64380,1,2405,2387,18,0,107,0,6
64381,3,2415,2566,-151,0,110,0,6
64382,2,2447,2437,10,0,209,0,6
64383,2,2374,2507,-133,0,168,0,6
64384,2,2218,2533,-315,0,60,0,6
64385,1,2291,2418,-127,0,45,0,6
64386,1,2465,2333,132,0,65,0,6
64387,2,2333,2443,-110,0,409,0,6
64388,2,2378,2443,-65,0,121,0,6
64389,3,2425,2562,-137,0,207,0,6
64390,2,2244,2476,-232,0,40,1,6
64391,1,2420,2334,86,0,113,1,6
64392,1,2451,2279,172,0,243,0,6
64393,1,2467,2339,128,4,300,0,13
64394,1,2536,2549,-13,0,255,0,6
64395,2,2456,2419,37,0,41,1,6
64396,2,2300,2463,-163,0,41,0,6
64397,1,2491,2316,175,0,315,0,6
64398,1,2529,2562,-33,0,147,0,6
64399,2,2417,2435,-18,0,40,0,6
64400,1,2491,2478,13,0,6,1,6
64401,1,2411,2381,30,0,466,0,6
64402,2,2299,2454,-155,0,226,0,6
64403,1,2429,2462,-33,0,130,1,6
64404,2,2488,2336,152,0,469,0,6
64405,1,2531,2554,-23,0,16,1,6
64406,2,2346,2479,-133,0,487,0,6
64407,2,2444,2301,143,0,485,0,6
64408,1,2468,2410,58,0,132,0,6
64409,2,2447,2373,74,0,400,1,6
64410,2,2497,2565,-68,0,15,1,6
64411,1,2436,2207,229,0,165,0,6
64412,2,2276,2416,-140,0,121,0,6
64413,2,2376,2488,-112,0,106,0,6
64414,1,2543,2542,1,0,107,1,6
64415,2,2207,2450,-243,0,0,0,6
64416,1,2484,2318,166,0,310,1,6
64417,1,2313,2430,-117,0,120,0,6
64418,1,2534,2329,205,0,448,1,6
64419,2,2420,2320,100,0,40,0,6
64420,1,2534,2397,137,0,131,0,6
64421,1,2494,2382,112,0,12,0,6
64422,1,2374,2424,-50,0,414,0,6
64423,2,2441,2412,29,0,1,1,6
64424,2,2447,2556,-109,0,130,0,6
64425,2,2365,2418,-53,0,207,0,6
64426,2,2616,2610,6,0,84,0,6
64427,1,2425,2450,-25,0,152,0,6
64428,1,2457,2368,89,0,122,1,6
64429,2,2272,2425,-153,0,4,0,6
64430,2,2564,2417,147,0,4,1,6
64431,1,2566,2230,336,0,469,0,6
64432,3,2239,2443,-204,0,200,0,6
64433,1,2473,2372,101,0,484,0,6
64434,3,2492,2497,-5,0,335,0,6
64435,1,2473,2537,-64,0,215,1,6
64436,1,2470,2212,258,0,70,1,6
64437,2,2557,2598,-41,0,140,0,6
64438,3,2432,2449,-17,4,112,0,13
64439,1,2456,2435,21,0,58,1,6
64440,2,2536,2549,-13,0,40,1,6
64441,2,2326,2428,-102,0,31,1,6
64442,2,2204,2515,-311,4,29,0,13
64443,2,2238,2412,-174,0,4,0,6
64444,2,2436,2328,108,0,337,1,6
64445,2,2570,2498,72,0,437,0,6
64446,2,2467,2444,23,0,45,0,6
64447,2,2418,2435,-17,0,50,0,6
64448,3,2482,2427,55,0,300,0,6
64449,1,2559,2273,286,0,95,0,6
64450,2,2308,2452,-144,0,101,0,6
64451,2,2423,2348,75,0,212,0,6
64452,2,2477,2316,161,0,245,0,6
64453,1,2444,2431,13,0,40,0,6
64454,2,2319,2505,-186,0,300,1,6
64455,2,2362,2518,-156,0,101,0,6
64456,1,2469,2376,93,0,102,0,6
64457,3,2418,2295,123,0,17,0,8
64458,2,2372,2505,-133,0,45,0,6
64459,2,2473,2563,-90,0,122,1,6
64460,2,2509,2492,17,0,4,0,6
64461,1,2368,2460,-92,0,300,0,6
64462,2,2462,2296,166,0,122,1,6
64463,3,2424,2409,15,0,4,0,6
64464,2,2340,2477,-137,0,302,0,6
64465,1,2375,2429,-54,0,45,1,6
64466,1,2507,2548,-41,0,62,1,6
64467,1,2373,2568,-195,0,46,0,6
64468,1,2368,2400,-32,0,153,0,6
64469,3,2497,2530,-33,0,4,0,6
64470,2,2511,2480,31,0,347,0,6
64471,1,2415,2282,133,0,45,0,6
64472,1,2436,2304,132,0,485,0,6
64473,2,2421,2500,-79,0,300,0,6
64474,2,2347,2472,-125,0,58,0,6
64475,1,2377,2466,-89,0,41,1,6
64476,1,2413,2350,63,0,454,0,6
64477,2,2425,2556,-131,0,255,0,6
64478,2,2555,2531,24,0,123,0,6
64479,1,2560,2556,4,0,248,1,6
64480,1,2427,2236,191,0,302,1,6
64481,3,2440,2309,131,0,122,0,6
64482,2,2456,2610,-154,0,3,0,6
64483,2,2557,2322,235,0,142,1,6
64484,2,2298,2462,-164,0,121,0,6
64485,2,2284,2429,-145,0,306,0,6
64486,1,2511,2335,176,0,337,1,6
64487,2,2363,2419,-56,4,404,0,13
64488,2,2450,2450,0,0,426,1,6
64489,1,2391,2487,-96,0,4,1,6
64490,2,2430,2461,-31,0,140,0,6
64491,2,2498,2481,17,0,345,0,6
64492,2,2324,2644,-320,0,196,0,6
64493,2,2306,2496,-190,0,6,1,6
64494,1,2347,2505,-158,0,157,0,6
64495,1,2503,2487,16,0,9,0,6
64496,2,2290,2480,-190,4,102,0,13
64497,1,2419,2262,157,0,110,0,6
64498,2,2422,2382,40,0,300,1,6
64499,3,2304,2418,-114,0,45,0,6
64500,2,2529,2568,-39,0,309,0,6
64501,1,2440,2497,-57,0,411,0,6
64502,1,2505,2332,173,0,440,0,6
64503,1,2541,2513,28,0,301,0,6
64504,1,2603,2320,283,0,16,0,6
64505,1,2448,2369,79,4,404,1,13
64506,2,2257,2444,-187,0,115,0,7
64507,1,2613,2522,91,0,306,0,6
64508,2,2537,2549,-12,0,300,1,6
64509,2,2374,2497,-123,0,153,0,6
64510,1,2432,2275,157,0,380,0,6
64511,1,2341,2508,-167,0,106,1,6
64512,1,2324,2465,-141,0,131,1,6
64513,1,2459,2295,164,0,130,0,6
64514,1,2566,2532,34,0,207,1,6
64515,1,2551,2426,125,0,4,1,6
64516,1,2458,2430,28,0,345,0,6
64517,2,2226,2469,-243,0,210,1,6
64518,1,2453,2284,169,0,221,0,6
64519,2,2366,2436,-70,0,106,0,6
64520,1,2497,2379,118,0,200,0,6
64521,2,2416,2455,-39,0,352,0,6
64522,1,2449,2362,87,0,123,0,7
64523,2,2492,2331,161,0,335,1,6
64524,1,2487,2444,43,0,484,0,6
64525,1,2423,2423,0,0,106,0,6
64526,3,2475,2398,77,0,400,0,6
64527,1,2573,2490,83,0,18,0,6
64528,3,2508,2524,-16,0,394,0,6
64529,3,2501,2547,-46,0,65,0,6
64530,2,2461,2390,71,0,131,0,6
64531,1,2441,2371,70,0,45,0,6
64532,1,2416,2306,110,0,337,0,6
64533,2,2318,2400,-82,0,248,1,6
64534,2,2416,2447,-31,0,286,1,6
64535,1,2432,2319,113,4,101,0,13
64536,2,2402,2353,49,0,302,0,6
64537,1,2281,2456,-175,0,101,0,6
64539,2,2211,2447,-236,0,110,0,7
64540,1,2560,2315,245,0,330,0,6
64541,2,2554,2518,36,0,125,0,6
64542,1,2530,2532,-2,0,381,0,6
64543,1,2340,2457,-117,0,129,0,6
64544,1,2307,2454,-147,0,140,0,6
64545,1,2472,2216,256,0,107,0,6
64546,2,2315,2422,-107,0,106,0,6
64547,1,2518,2618,-100,0,244,0,6
64548,1,2403,2284,119,0,0,1,6
64549,2,2424,2363,61,0,131,0,6
64550,1,2453,2333,120,0,108,0,7
64551,2,2420,2577,-157,0,308,0,6
64552,1,2508,2370,138,0,434,0,6
64553,2,2524,2508,16,0,345,0,6
64554,1,2439,2401,38,0,477,1,6
64555,1,2486,2400,86,0,4,1,6
64556,2,2424,2481,-57,0,374,1,6
64557,1,2484,2384,100,0,50,0,6
64558,1,2339,2417,-78,0,454,0,6
64559,1,2429,2350,79,0,140,0,6
64560,2,2537,2293,244,0,12,0,6
64561,2,2313,2425,-112,0,484,1,6
64562,1,2255,2429,-174,0,131,0,7
64563,1,2452,2411,41,0,409,0,6
64564,1,2535,2548,-13,0,270,1,6
64565,2,2426,2444,-18,0,150,0,6
64566,1,2441,2562,-121,0,122,0,6
64567,2,2446,2537,-91,0,288,0,6
64568,2,2498,2348,150,0,108,1,6
64569,2,2391,2526,-135,0,469,1,6
64570,1,2311,2596,-285,0,40,0,6
64571,2,2581,2487,94,0,28,0,6
64572,2,2280,2407,-127,0,4,0,6
64573,3,2388,2434,-46,0,45,0,6
64574,2,2448,2453,-5,0,2,0,6
64575,2,2285,2499,-214,0,320,0,6
64576,3,2432,2451,-19,0,242,0,6
64577,1,2488,2334,154,0,57,1,6
64578,2,2384,2431,-47,0,41,0,6
64579,2,2328,2518,-190,0,205,1,6
64580,2,2395,2490,-95,0,110,1,6
64581,1,2528,2328,200,0,123,0,6
64582,2,2421,2473,-52,0,107,0,6
64583,1,2317,2410,-93,0,49,1,6
64584,2,2450,2406,44,0,426,1,6
64585,2,2546,2514,32,0,301,0,6
64586,3,2371,2432,-61,0,4,0,6
64587,1,2300,2436,-136,4,32,0,13
64588,1,2610,2525,85,0,489,0,6
64589,1,2442,2421,21,0,107,1,6
64590,2,2417,2512,-95,0,106,0,6
64591,2,2429,2309,120,0,360,1,6
64592,1,2541,2346,195,0,141,0,6
64593,1,2411,2277,134,0,300,1,6
64594,1,2314,2587,-273,0,1,0,6
64595,1,2340,2468,-128,0,210,1,6
64596,1,2559,2573,-14,0,308,0,6
64597,1,2495,2490,5,0,45,1,6
64598,2,2457,2338,119,0,485,1,6
64599,2,2287,2463,-176,4,113,0,13
64600,1,2349,2418,-69,0,115,0,6
64601,2,2635,2449,186,0,211,1,6
64602,2,2212,2458,-246,0,210,0,7
64603,1,2459,2442,17,0,101,0,6
64604,1,2530,2393,137,0,150,0,6
64605,2,2478,2433,45,0,44,1,6
64606,1,2259,2436,-177,0,13,0,6
64607,2,2451,2433,18,0,106,0,6
64608,1,2417,2238,179,0,302,0,6
64609,1,2517,2412,105,0,57,0,6
64610,1,2606,2330,276,0,13,0,6
64611,2,2521,2512,9,0,394,0,6
64612,1,2419,2412,7,0,7,0,6
64613,2,2318,2476,-158,0,40,0,6
64614,1,2533,2540,-7,0,107,1,6
64615,1,2436,2283,153,0,6,0,6
64616,2,2521,2544,-23,0,376,0,6
64617,1,2531,2391,140,0,4,0,6
64618,2,2332,2491,-159,0,106,0,6
64619,3,2230,2403,-173,0,123,0,8
64620,1,2304,2451,-147,0,110,0,7
64621,1,2476,2495,-19,0,15,0,6
64622,1,2403,2420,-17,0,107,0,6
64623,2,2412,2443,-31,0,141,1,6
64624,2,2378,2408,-30,0,347,1,6
64625,2,2296,2401,-105,0,218,1,6
64626,2,2273,2415,-142,0,150,1,6
64627,1,2316,2422,-106,0,40,0,6
64628,1,2565,2567,-2,0,140,1,6
64629,2,2343,2485,-142,0,40,0,6
64630,3,2325,2447,-122,0,143,0,6
64631,1,2549,2500,49,0,250,0,6
64632,1,2516,2466,50,0,331,0,6
64633,2,2449,2514,-65,0,317,0,6
64634,3,2449,2241,208,0,133,0,6
64635,2,2384,2436,-52,0,96,0,6
64636,2,2330,2534,-204,0,351,1,6
64637,1,2439,2394,45,0,40,1,6
64638,1,2394,2439,-45,0,41,0,6
64639,2,2518,2344,174,0,40,0,6
64640,1,2353,2495,-142,0,3,0,6
64641,2,2437,2464,-27,0,2,0,6
64642,2,2341,2677,-336,0,194,0,6
64643,2,2534,2539,-5,0,200,0,6
64644,1,2533,2461,72,0,185,0,6
64645,2,2400,2521,-121,0,394,0,6
64646,1,2488,2414,74,0,4,0,6
64647,2,2487,2411,76,0,110,1,6
64648,2,2409,2340,69,0,46,1,6
64649,1,2554,2482,72,0,250,0,6
64650,2,2489,2509,-20,0,4,0,6
64651,1,2449,2407,42,0,395,0,6
64652,1,2414,2324,90,0,351,1,6
64653,3,2460,2421,39,0,106,0,7
64654,1,2327,2413,-86,0,288,0,6
64655,1,2362,2424,-62,0,120,0,6
64656,3,2445,2441,4,0,203,0,6
64657,1,2445,2312,133,0,46,0,7
64658,1,2346,2416,-70,0,58,0,6
64659,2,2392,2416,-24,0,115,0,6
64660,2,2632,2631,1,0,39,0,6
64661,2,2331,2433,-102,0,4,0,6
64662,2,2299,2444,-145,0,44,0,6
64663,2,2457,2389,68,0,40,0,6
64664,1,2406,2334,72,0,4,0,6
64665,1,2461,2374,87,0,8,0,6
64666,2,2525,2545,-20,0,54,0,6
64668,2,2405,2237,168,0,140,1,6
64669,1,2493,2336,157,0,4,0,6
64670,2,2402,2454,-52,0,191,0,6
64672,1,2562,2460,102,0,16,0,6
64673,1,2557,2627,-70,0,112,0,6
64674,1,2478,2559,-81,0,36,0,6
64675,2,2422,2483,-61,0,115,0,6
64676,1,2515,2374,141,0,300,1,6
64677,2,2351,2401,-50,0,4,0,6
64678,1,2544,2501,43,0,331,0,6
64679,1,2320,2419,-99,0,484,1,6
64680,1,2402,2361,41,0,1,0,6
64681,2,2347,2445,-98,0,310,0,6
64682,1,2404,2308,96,0,2,0,6
64683,1,2441,2450,-9,0,311,0,6
64684,3,2357,2447,-90,0,45,0,6
64685,2,2437,2456,-19,0,4,0,6
64686,1,2440,2361,79,0,28,1,6
64687,1,2566,2528,38,0,16,1,6
64688,2,2550,2519,31,0,215,1,6
64689,1,2449,2204,245,0,302,0,7
64690,1,2418,2394,24,0,293,0,6
64691,2,2496,2363,133,0,4,1,6
64692,1,2450,2271,179,0,353,0,6
64693,1,2440,2267,173,0,135,1,6
64694,1,2459,2397,62,0,406,0,6
64695,1,2679,2342,337,0,138,0,6
64697,2,2304,2408,-104,0,245,0,6
64698,1,2330,2411,-81,0,288,0,6
64699,2,2320,2460,-140,0,210,0,7
64700,2,2283,2422,-139,0,463,0,7
64701,2,2449,2538,-89,0,260,0,6
64702,1,2571,2608,-37,0,200,1,6
64703,1,2418,2416,2,0,4,0,6
64704,1,2480,2343,137,0,335,0,6
64705,1,2411,2444,-33,0,300,0,6
64706,2,2392,2463,-71,0,154,1,6
64707,1,2488,2418,70,0,4,1,6
64708,2,2411,2327,84,0,200,0,6
64709,1,2467,2286,181,0,30,0,6
64710,3,2496,2549,-53,0,30,0,6
64711,1,2518,2536,-18,0,245,0,6
64712,1,2445,2316,129,0,260,0,6
64713,1,2542,2552,-10,0,289,0,6
64714,1,2323,2472,-149,0,46,0,6
64715,1,2466,2370,96,0,202,0,6
64716,1,2357,2432,-75,0,10,1,6
64717,2,2548,2497,51,0,331,0,6
64718,2,2356,2445,-89,0,112,1,6
64719,2,2312,2453,-141,0,100,0,6
64720,1,2446,2358,88,0,111,0,6
64721,1,2462,2488,-26,0,43,1,6
64722,2,2526,2544,-18,0,42,0,6
64723,2,2523,2533,-10,0,301,0,6
64724,1,2412,2300,112,0,2,0,6
64725,2,2334,2404,-70,0,466,0,6
64726,1,2404,2337,67,0,5,0,6
64727,1,2365,2497,-132,0,115,0,6
64728,1,2406,2357,49,0,4,0,6
64729,2,2485,2443,42,0,30,0,6
64730,2,2376,2423,-47,0,121,0,6
64731,2,2548,2449,99,0,142,0,6
64732,2,2339,2470,-131,0,454,0,6
64733,2,2354,2450,-96,0,45,0,6
64734,2,2296,2416,-120,0,264,0,6
64735,2,2417,2506,-89,0,300,0,6
64736,2,2311,2451,-140,0,110,0,7
64737,1,2493,2530,-37,0,6,0,6
64738,1,2411,2272,139,0,0,0,6
64739,2,2389,2423,-34,0,112,0,6
64740,1,2468,2524,-56,0,415,0,6
64741,1,2510,2401,109,0,101,0,6
64742,1,2504,2542,-38,0,30,1,6
64743,2,2276,2431,-155,4,248,0,13
64744,1,2456,2413,43,0,107,0,6
64745,1,2409,2330,79,0,200,0,6
64746,2,2550,2520,30,0,200,1,6
64747,2,2425,2515,-90,0,13,0,6
64748,1,2398,2508,-110,0,42,0,6
64749,2,2332,2408,-76,0,288,1,6
64750,3,2680,2298,382,0,112,0,6
64751,1,2455,2350,105,0,110,0,6
64753,2,2279,2415,-136,0,4,0,6
64754,1,2546,2622,-76,0,112,0,6
64755,3,2455,2216,239,0,48,0,7
64756,2,2325,2413,-88,0,454,1,6
64757,2,2524,2474,50,0,485,0,6
64758,3,2360,2401,-41,0,483,0,6
64759,2,2518,2514,4,0,45,1,6
64760,1,2426,2464,-38,0,7,0,7
64761,1,2264,2451,-187,0,110,0,7
64762,1,2461,2475,-14,0,123,0,6
64763,1,2535,2510,25,0,331,0,6
64764,1,2429,2384,45,0,295,1,6
64765,1,2449,2310,139,0,107,1,6
64766,3,2336,2418,-82,0,40,0,6
64767,2,2340,2421,-81,0,40,0,6
64768,1,2519,2404,115,0,40,0,6
64769,1,2527,2543,-16,0,44,0,6
64771,2,2326,2483,-157,0,121,1,6
64772,1,2428,2345,83,0,4,0,6
64773,2,2438,2541,-103,0,388,0,6
64774,1,2517,2378,139,0,335,1,6
64775,2,2482,2421,61,0,7,0,6
64776,1,2336,2481,-145,0,255,0,6
64777,1,2450,2382,68,0,127,1,6
64778,1,2572,2553,19,0,45,0,6
64779,2,2505,2541,-36,0,202,0,6
64780,2,2410,2353,57,0,240,1,6
64781,2,2400,2231,169,0,122,0,8
64782,3,2418,2321,97,0,306,0,6
64783,1,2357,2432,-75,0,248,1,6
64784,3,2579,2511,68,0,4,0,6
64785,2,2520,2512,8,0,107,0,6
64786,1,2469,2467,2,0,315,1,6
64787,2,2417,2310,107,0,246,1,6
64788,2,2397,2537,-140,0,40,0,6
64789,2,2333,2400,-67,0,40,0,6
64790,1,2223,2428,-205,0,225,0,6
64791,1,2434,2408,26,0,41,0,6
64792,1,2458,2214,244,0,250,0,7
64793,1,2449,2383,66,0,40,1,6
64794,1,2379,2434,-55,0,57,1,6
64795,3,2443,2302,141,0,46,0,7
64796,2,2468,2545,-77,0,302,0,6
64797,1,2521,2367,154,0,380,0,6
64798,1,2518,2514,4,0,302,1,6
64799,1,2320,2433,-113,0,121,0,6
64800,1,2360,2404,-44,0,140,0,6
64801,2,2487,2374,113,0,440,0,6
64802,2,2322,2416,-94,0,40,1,6
64803,1,2541,2393,148,0,101,0,6
64804,2,2444,2439,5,4,13,1,13
64805,1,2578,2691,-113,0,65,1,6
64806,1,2462,2475,-13,0,195,1,6
64807,1,2475,2322,153,0,5,0,6
64808,1,2425,2305,120,0,400,0,6
64809,2,2404,2516,-112,0,1,0,6
64810,2,2457,2211,246,0,241,0,6
64811,2,2426,2439,-13,0,112,0,6
64812,1,2390,2544,-154,0,40,1,6
64813,2,2550,2589,-39,0,101,0,6
64814,2,2359,2524,-165,0,253,0,6
64815,2,2238,2447,-209,0,144,0,6
64816,2,2473,2548,-75,0,258,0,6
64817,1,2220,2408,-188,0,120,0,6
64818,2,2454,2353,101,0,4,0,6
64819,2,2492,2509,-17,0,101,1,6
64820,2,2283,2460,-177,0,4,0,7
64821,2,2421,2382,39,0,205,0,6
64822,1,2421,2318,103,0,201,0,6
64823,2,2479,2463,16,0,16,1,6
64824,1,2512,2279,233,0,110,0,6
64825,2,2337,2461,-124,0,398,1,6
64826,3,2427,2386,41,0,295,0,6
64827,3,2552,2524,28,0,112,0,6
64828,2,2360,2400,-40,0,40,0,6
64829,1,2520,2683,-163,0,143,1,6
64830,2,2469,2468,1,0,30,0,6
64832,1,2361,2403,-42,0,2,1,6
64833,2,2381,2445,-64,0,245,1,6
64834,2,2435,2299,136,0,0,0,7
64835,3,2421,2437,-16,0,132,0,6
64836,1,2536,2398,138,0,7,0,6
64837,1,2406,2373,33,0,1,0,6
64838,2,2388,2415,-27,0,11,0,6
64839,1,2528,2364,164,0,484,0,6
64840,1,2314,2425,-111,0,253,0,6
64841,2,2469,2379,90,0,4,0,6
64842,2,2535,2523,12,0,245,0,6
64843,2,2514,2594,-80,0,101,1,6
64844,2,2394,2540,-146,0,40,0,6
64845,1,2429,2372,57,0,346,0,6
64846,1,2677,2226,451,0,112,0,6
64847,1,2529,2524,5,0,400,0,6
64848,2,2571,2585,-14,0,337,0,6
64849,1,2410,2427,-17,0,16,0,6
64850,2,2468,2487,-19,0,201,0,6
64851,1,2474,2463,11,0,110,0,6
64852,1,2492,2463,29,0,245,0,6
64853,1,2544,2416,128,0,107,1,6
64854,2,2421,2416,5,0,106,0,6
64855,2,2417,2322,95,0,200,0,6
64856,1,2403,2421,-18,0,80,0,6
64857,2,2352,2444,-92,0,120,0,6
64858,1,2368,2411,-43,0,135,0,6
64859,2,2675,2531,144,0,267,1,6
64860,2,2280,2453,-173,0,147,0,6
64861,2,2468,2370,98,0,301,0,6
64862,2,2296,2474,-178,4,112,1,13
64863,2,2458,2498,-40,0,201,0,6
64864,1,2420,2383,37,0,200,0,6
64865,1,2637,2653,-16,0,141,1,6
64866,1,2422,2416,6,0,474,0,6
64867,1,2319,2677,-358,0,464,0,6
64868,3,2386,2427,-41,0,320,0,6
64869,2,2519,2689,-170,0,109,1,6
64870,1,2510,2391,119,0,101,0,6
64871,1,2329,2410,-81,0,454,0,6
64872,2,2458,2479,-21,0,218,0,6
64873,3,2464,2282,182,0,201,0,7
64874,2,2415,2566,-151,0,140,1,6
64875,2,2503,2453,50,0,245,0,6
64876,2,2449,2547,-98,0,40,1,6
64877,1,2404,2374,30,0,1,1,6
64878,2,2535,2539,-4,0,330,0,6
64879,2,2348,2465,-117,0,250,1,6
64880,2,2591,2667,-76,0,66,1,6
64881,1,2471,2473,-2,0,434,1,6
64882,2,2363,2402,-39,0,3,0,6
64883,1,2285,2437,-152,0,221,0,6
64884,1,2449,2384,65,4,36,0,13
64885,3,2329,2513,-184,0,373,0,6
64886,1,2468,2202,266,0,107,1,6
64887,1,2308,2405,-97,0,123,0,6
64888,1,2572,2383,189,0,112,0,6
64889,2,2304,2445,-141,0,127,0,6
64890,2,2409,2452,-43,0,300,0,6
64891,2,2392,2514,-122,0,102,0,6
64892,1,2545,2387,158,0,335,0,6
64893,1,2459,2496,-37,0,201,0,6
64894,1,2403,2336,67,0,200,1,6
64895,1,2523,2375,148,0,40,0,6
64896,2,2692,2515,177,0,0,0,6
64897,3,2285,2454,-169,4,242,0,13
64898,2,2564,2569,-5,0,140,0,6
64899,2,2412,2351,61,0,138,0,6
64900,3,2305,2430,-125,0,113,0,6
64901,2,2369,2410,-41,0,106,1,6
64902,3,2212,2449,-237,0,40,0,6
64903,2,2445,2446,-1,0,354,0,6
64904,1,2292,2460,-168,0,302,0,6
64905,2,2469,2518,-49,0,10,0,6
64906,2,2426,2387,39,0,295,0,6
64907,2,2407,2357,50,0,10,0,6
64908,1,2384,2443,-59,0,311,0,6
64909,1,2389,2453,-64,0,386,0,6
64910,1,2388,2464,-76,0,295,0,6
64911,2,2523,2383,140,0,115,1,6
64912,2,2651,2672,-21,0,65,1,6
64913,1,2524,2684,-160,0,40,0,6
64914,1,2490,2457,33,0,190,0,6
64915,2,2417,2404,13,0,107,1,6
64916,1,2459,2334,125,0,156,0,6
64917,3,2579,2395,184,0,49,0,6
64918,1,2337,2527,-190,0,405,0,6
64919,1,2332,2408,-76,0,454,1,6
64920,2,2579,2293,286,0,7,0,6
64921,2,2290,2511,-221,0,373,0,6
64922,1,2575,2587,-12,0,337,0,6
64923,1,2405,2433,-28,0,235,0,6
64924,1,2428,2294,134,0,405,0,6
64925,1,2358,2485,-127,0,121,0,6
64926,1,2415,2364,51,0,0,1,6
64927,1,2466,2545,-79,0,253,1,6
64928,2,2319,2450,-131,0,128,1,6
64929,1,2364,2400,-36,0,130,1,6
64930,1,2361,2439,-78,0,302,0,6
64931,1,2528,2599,-71,0,101,1,6
64932,1,2513,2300,213,0,8,0,6
64933,2,2452,2495,-43,0,57,0,6
64934,1,2676,2532,144,0,0,1,6
64935,1,2367,2452,-85,0,1,0,6
64936,1,2436,2281,155,0,311,1,6
64937,2,2457,2339,118,0,13,0,6
64938,1,2515,2396,119,0,153,0,6
64939,1,2215,2448,-233,0,389,1,6
64940,1,2370,2463,-93,0,20,0,6
64941,2,2252,2427,-175,0,200,0,6
64942,1,2668,2235,433,0,138,0,6
64943,1,2427,2411,16,0,125,0,6
64944,1,2468,2374,94,0,13,1,6
64945,2,2470,2645,-175,0,335,0,6
64946,1,2303,2566,-263,0,409,1,6
64947,1,2516,2278,238,0,45,0,6
64948,1,2477,2410,67,0,41,0,6
64949,2,2287,2449,-162,0,40,0,6
64950,1,2677,2581,96,0,45,0,6
64951,3,2393,2420,-27,0,320,0,6
64952,1,2657,2390,267,0,47,0,6
64953,2,2432,2519,-87,0,9,0,6
64954,2,2401,2339,62,0,200,0,6
64955,2,2359,2420,-61,0,135,0,6
64956,2,2538,2473,65,0,265,0,6
64957,2,2566,2581,-15,0,140,0,6
64958,1,2448,2265,183,4,255,0,13
64959,1,2500,2447,53,0,245,0,6
64960,1,2392,2523,-131,0,297,0,6
64961,1,2361,2449,-88,0,284,0,6
64962,2,2433,2346,87,0,143,0,6
64963,1,2625,2406,219,0,135,1,6
64964,1,2370,2473,-103,0,1,1,6
64965,1,2615,2440,175,0,39,0,6
64966,2,2383,2428,-45,0,100,0,6
64967,2,2647,2592,55,0,13,1,6
64968,1,2442,2515,-73,0,426,1,6
64969,1,2482,2400,82,0,455,0,6
64970,1,2454,2315,139,0,30,0,6
64971,2,2529,2679,-150,0,40,0,6
64972,2,2456,2322,134,0,150,0,6
64973,2,2405,2437,-32,0,43,1,6
64974,1,2648,2467,181,0,387,1,6
64975,3,2669,2233,436,0,112,0,6
64976,2,2387,2659,-272,0,406,0,6
64977,1,2426,2344,82,0,195,0,6
64978,1,2292,2454,-162,0,40,0,6
64979,1,2420,2353,67,0,2,0,6
64980,1,2557,2312,245,0,100,0,6
64981,1,2681,2505,176,0,45,1,6
64982,1,2577,2535,42,0,157,1,6
64983,2,2323,2442,-119,0,224,0,6
64984,1,2520,2342,178,0,456,0,6
64985,2,2368,2433,-65,0,204,0,6
64986,2,2586,2561,25,0,244,0,6
64987,1,2531,2464,67,0,100,0,6
64988,2,2618,2529,89,0,337,0,6
64989,2,2395,2486,-91,0,143,0,6
64990,3,2683,2525,158,0,0,0,6
64991,2,2391,2627,-236,0,414,0,6
64992,1,2441,2236,205,0,7,1,6
64993,1,2599,2640,-41,0,107,0,6
64994,1,2442,2330,112,0,4,0,6
64995,2,2201,2471,-270,0,1,0,6
64996,1,2312,2457,-145,0,128,0,6
64997,2,2448,2242,206,0,245,0,6
64998,2,2400,2430,-30,0,40,0,6
64999,3,2509,2480,29,0,265,0,6
65000,2,2302,2450,-148,0,127,1,6
65001,2,2310,2559,-249,0,398,0,6
65002,2,2464,2449,15,0,311,0,6
65003,2,2651,2468,183,0,435,0,6
65004,2,2348,2404,-56,0,124,0,6
65005,1,2437,2366,71,0,47,0,6
65006,2,2465,2377,88,0,31,0,6
65007,1,2291,2523,-232,0,127,0,6
65008,1,2431,2360,71,0,409,0,6
65009,1,2491,2391,100,0,46,0,6
65010,2,2357,2508,-151,0,302,0,6
65011,1,2480,2582,-102,0,140,0,6
65012,1,2446,2331,115,0,30,0,6
65013,2,2409,2536,-127,0,48,1,6
65014,1,2661,2385,276,0,300,0,6
65015,2,2336,2404,-68,0,454,1,6
65016,2,2502,2530,-28,0,144,0,6
65017,2,2537,2685,-148,0,62,0,6
65018,1,2404,2415,-11,0,200,0,6
65019,2,2455,2458,-3,0,375,0,6
65020,1,2438,2343,95,0,0,0,6
65021,2,2436,2256,180,0,46,1,6
65022,1,2446,2442,4,0,409,0,6
65023,1,2571,2338,233,0,107,0,6
65024,1,2514,2282,232,0,45,0,6
65025,1,2378,2436,-58,0,10,0,6
65026,2,2528,2680,-152,0,200,1,6
65027,2,2413,2395,18,0,4,0,6
65028,1,2580,2643,-63,0,352,1,6
65029,3,2510,2423,87,0,46,0,6
65030,1,2495,2344,151,0,108,1,6
65031,2,2512,2630,-118,0,241,0,6
65032,1,2483,2309,174,0,143,0,6
65033,1,2562,2308,254,0,100,0,6
65034,2,2385,2458,-73,0,1,1,6
65035,2,2383,2663,-280,0,313,0,6
65036,2,2301,2464,-163,0,241,1,6
65037,1,2539,2574,-35,0,133,0,6
65038,1,2450,2410,40,0,17,0,6
65039,2,2384,2406,-22,0,0,0,6
65040,2,2476,2362,114,0,28,1,6
65041,1,2442,2533,-91,0,252,1,6
65042,1,2463,2339,124,0,142,1,6
65043,2,2324,2409,-85,0,463,0,6
65044,2,2464,2450,14,0,454,0,6
65045,1,2465,2488,-23,0,212,0,6
65046,1,2424,2366,58,0,302,0,6
65047,2,2436,2452,-16,0,315,0,6
65048,1,2401,2298,103,0,201,0,6
65049,2,2470,2423,47,0,492,1,6
65050,2,2429,2385,44,0,123,0,6
65051,2,2370,2449,-79,0,35,1,6
65052,2,2411,2401,10,0,41,1,6
65053,3,2407,2243,164,0,39,0,6
65054,1,2665,2381,284,0,45,0,6
65055,3,2684,2524,160,0,0,0,6
65056,3,2636,2587,49,0,335,0,6
65057,2,2317,2424,-107,0,354,1,6
65058,1,2688,2498,190,0,218,0,6
65059,2,2284,2446,-162,0,414,0,6
65060,2,2425,2508,-83,0,1,0,6
65061,3,2467,2298,169,0,62,0,6
65062,2,2633,2635,-2,0,123,0,6
65063,2,2306,2564,-258,0,302,0,6
65064,2,2455,2348,107,0,10,1,6
65065,1,2568,2405,163,0,18,1,6
65066,1,2546,2691,-145,0,151,1,6
65067,1,2456,2458,-2,0,13,0,6
65068,1,2413,2277,136,0,130,0,6
65069,1,2379,2667,-288,0,110,0,6
65070,2,2319,2450,-131,0,123,1,6
65071,2,2335,2431,-96,0,113,0,6
65072,1,2518,2276,242,0,45,0,6
65073,2,2314,2405,-91,0,127,1,6
65074,2,2535,2407,128,0,241,1,6
65075,1,2391,2423,-32,0,10,0,6
65076,1,2454,2338,116,0,310,1,6
65077,2,2301,2465,-164,0,241,1,6
65078,2,2527,2681,-154,0,40,0,6
65079,1,2461,2452,9,0,177,0,6
65080,2,2273,2537,-264,0,112,0,6
65081,2,2417,2421,-4,0,107,1,6
65082,2,2311,2520,-209,0,134,0,6
65083,2,2440,2383,57,0,106,0,6
65084,1,2588,2554,34,0,45,1,6
65085,1,2495,2387,108,0,373,0,6
65086,1,2641,2529,112,0,437,0,6
65087,1,2566,2304,262,0,26,1,6
65088,2,2416,2448,-32,0,268,1,6
65089,1,2446,2355,91,0,42,1,6
65090,2,2401,2435,-34,0,110,1,6
65091,2,2452,2462,-10,0,463,0,6
65092,2,2331,2410,-79,0,40,0,6
65093,1,2658,2389,269,0,300,0,6
65094,2,2683,2643,40,0,131,0,6
65095,1,2571,2453,118,0,190,0,6
65096,1,2523,2301,222,0,45,0,6
65097,3,2394,2423,-29,0,487,0,6
65098,1,2468,2297,171,0,62,0,6
65099,2,2415,2555,-140,0,45,0,6
65100,1,2528,2359,169,0,45,0,6
65101,1,2297,2458,-161,0,415,0,6
65102,2,2246,2577,-331,0,100,0,6
65103,2,2383,2499,-116,0,311,0,6
65104,1,2285,2428,-143,0,404,0,6
65105,2,2271,2411,-140,0,225,0,6
65106,1,2525,2316,209,0,374,0,6
65107,3,2645,2549,96,0,426,0,6
65108,2,2414,2411,3,0,107,1,6
65109,2,2387,2660,-273,0,110,0,6
65110,1,2558,2467,91,0,150,1,6
65111,2,2294,2471,-177,0,241,1,6
65112,2,2327,2453,-126,0,337,0,6
65113,2,2345,2411,-66,0,255,1,6
65114,2,2471,2450,21,0,153,1,6
65115,1,2650,2677,-27,0,190,0,6
65116,3,2441,2575,-134,0,302,0,6
65117,1,2450,2396,54,0,122,1,6
65118,2,2322,2578,-256,0,40,1,6
65119,1,2469,2387,82,0,16,0,6
65120,2,2415,2503,-88,0,310,0,6
65121,2,2271,2526,-255,0,380,0,6
65122,1,2550,2593,-43,0,133,0,6
65123,2,2457,2392,65,0,13,1,6
65124,1,2671,2656,15,0,131,0,6
65125,3,2528,2412,116,0,41,0,6
65126,2,2328,2450,-122,0,424,1,6
65127,2,2408,2323,85,0,46,1,6
65128,1,2417,2428,-11,0,45,0,6
65129,2,2465,2521,-56,0,311,0,6
65130,2,2440,2296,144,0,107,0,6
65131,1,2495,2562,-67,0,107,0,6
65132,1,2463,2416,47,0,40,0,6
65133,1,2474,2291,183,0,48,1,6
65134,1,2650,2676,-26,0,123,0,6
65135,3,2662,2385,277,0,40,0,6
65136,2,2454,2355,99,0,202,0,6
65137,1,2557,2451,106,0,289,0,6
65139,3,2471,2414,57,0,135,0,6
65140,2,2319,2410,-91,0,410,1,6
65141,1,2573,2511,62,0,441,0,6
65142,3,2239,2411,-172,0,453,0,6
65143,2,2423,2362,61,0,4,0,6
65145,2,2299,2529,-230,0,412,0,6
65146,2,2390,2473,-83,0,121,0,6
65147,1,2443,2373,70,0,80,0,6
65148,2,2587,2556,31,0,45,1,6
65149,2,2411,2468,-57,0,195,0,6
65150,1,2382,2450,-68,0,295,1,6
65151,1,2415,2204,211,0,1,0,6
65152,2,2314,2459,-145,0,302,0,6
65153,2,2423,2578,-155,0,301,0,6
65154,2,2605,2670,-65,0,196,0,6
65155,2,2243,2401,-158,0,135,1,6
65156,2,2324,2446,-122,0,40,0,6
65157,2,2507,2561,-54,0,301,0,6
65159,1,2418,2313,105,0,301,0,6
65160,2,2389,2658,-269,0,110,0,6
65161,3,2288,2477,-189,0,107,0,6
65162,2,2451,2366,85,0,107,0,6
65163,3,2473,2447,26,0,484,0,6
65164,1,2660,2387,273,0,49,0,6
65165,2,2478,2447,31,0,13,1,6
65166,2,2243,2473,-230,0,0,0,6
65167,2,2317,2408,-91,0,264,1,6
65168,1,2532,2296,236,0,211,0,6
65169,1,2421,2207,214,0,1,0,6
65170,2,2363,2462,-99,0,207,0,6
65171,1,2455,2319,136,0,111,0,6
65172,1,2221,2414,-193,0,300,0,6
65173,1,2675,2572,103,0,131,0,6
65174,2,2373,2442,-69,0,277,0,6
65175,1,2209,2418,-209,0,415,1,6
65176,2,2566,2502,64,0,104,0,6
65177,2,2454,2465,-11,0,46,0,6
65178,2,2448,2420,28,0,107,0,6
65179,2,2369,2444,-75,0,277,0,6
65180,1,2581,2405,176,0,10,1,6
65181,2,2448,2472,-24,0,122,0,6
65182,1,2677,2600,77,0,4,0,6
65183,2,2429,2232,197,0,414,0,6
65184,2,2294,2534,-240,0,14,0,6
65185,1,2529,2279,250,0,45,0,6
65186,3,2413,2389,24,0,345,0,6
65187,2,2568,2679,-111,0,65,0,6
65188,2,2287,2460,-173,0,110,0,6
65189,1,2287,2448,-161,0,80,0,6
65190,2,2413,2240,173,0,301,1,6
65191,2,2315,2501,-186,0,121,0,6
65192,2,2380,2423,-43,0,330,0,6
65193,1,2389,2459,-70,0,195,1,6
65194,1,2406,2267,139,0,4,0,6
65195,1,2537,2292,245,0,133,0,6
65196,2,2426,2454,-28,0,44,0,6
65197,2,2358,2440,-82,0,25,1,6
65198,1,2448,2364,84,0,483,0,6
65199,2,2509,2585,-76,0,300,1,6
65200,2,2402,2295,107,0,302,1,6
65201,2,2596,2682,-86,0,199,0,6
65202,1,2457,2305,152,0,4,1,6
65203,2,2453,2478,-25,0,30,1,6
65204,2,2417,2360,57,0,5,0,6
65205,2,2203,2521,-318,0,42,0,6
65206,1,2683,2564,119,0,151,0,6
65207,1,2464,2319,145,2,18,0,18
65208,2,2303,2413,-110,0,127,0,6
65209,2,2306,2594,-288,0,302,1,6
65210,3,2422,2242,180,0,46,0,6
65211,1,2517,2504,13,0,436,0,6
65212,2,2417,2341,76,0,385,1,6
65213,1,2502,2452,50,0,80,1,6
65214,2,2289,2539,-250,0,13,0,6
65215,2,2459,2396,63,0,46,0,6
65216,1,2686,2592,94,0,4,0,6
65217,1,2444,2421,23,0,41,0,6
65218,2,2312,2428,-116,0,0,0,6
65219,2,2589,2489,100,0,35,1,6
65220,1,2366,2469,-103,0,277,0,6
65221,2,2475,2447,28,0,400,0,6
65222,3,2328,2512,-184,0,320,0,6
65223,2,2483,2472,11,0,405,0,6
65224,2,2561,2687,-126,0,311,1,6
65225,1,2507,2229,278,0,110,0,8
65226,1,2510,2426,84,0,300,0,6
65227,1,2468,2220,248,0,112,0,6
65228,1,2412,2313,99,0,454,1,6
65229,1,2452,2432,20,0,302,0,6
65230,3,2499,2403,96,0,347,0,6
65231,2,2426,2349,77,0,3,1,6
65232,1,2507,2504,3,0,301,0,6
65233,1,2450,2389,61,0,115,0,6
65234,2,2415,2466,-51,0,40,0,6
65235,2,2657,2690,-33,0,254,0,6
65236,1,2264,2516,-252,0,107,1,6
65237,1,2596,2383,213,0,145,0,6
65238,1,2228,2400,-172,4,13,0,13
65239,2,2478,2477,1,0,31,1,6
65240,1,2287,2523,-236,0,338,0,6
65241,1,2453,2497,-44,0,35,0,6
65242,1,2410,2582,-172,0,301,0,6
65243,1,2696,2652,44,0,8,0,6
65244,2,2241,2438,-197,0,108,0,6
65245,2,2261,2434,-173,0,317,0,6
65246,2,2691,2557,134,0,303,1,6
65247,1,2421,2470,-49,0,302,0,6
65249,3,2374,2423,-49,0,242,0,6
65250,1,2474,2458,16,0,302,0,6
65251,2,2426,2454,-28,0,84,0,6
65252,1,2647,2701,-54,0,190,0,6
65253,1,2385,2417,-32,0,483,0,6
65254,1,2514,2212,302,0,45,0,6
65255,2,2255,2514,-259,0,327,0,6
65256,2,2420,2390,30,0,6,0,6
65257,3,2694,2653,41,0,167,0,6
65258,1,2447,2412,35,0,111,1,6
65259,1,2314,2442,-128,0,463,0,6
65260,1,2441,2240,201,0,403,0,6
65261,1,2463,2303,160,0,57,0,6
65262,1,2382,2448,-66,0,302,1,6
65263,1,2507,2233,274,0,0,0,6
65264,2,2483,2574,-91,0,348,0,6
65265,2,2419,2413,6,0,40,1,6
65266,2,2460,2421,39,0,400,0,6
65267,2,2473,2440,33,0,110,0,6
65268,3,2565,2683,-118,0,151,0,6
65269,1,2428,2464,-36,0,302,0,6
65270,1,2452,2459,-7,0,46,0,6
65271,1,2410,2308,102,0,150,0,6
65272,2,2253,2516,-263,0,37,0,6
65273,2,2522,2499,23,0,440,1,6
65274,1,2441,2233,208,0,7,0,6
65275,2,2508,2201,307,0,389,0,6
65276,2,2246,2444,-198,0,0,1,6
65277,1,2578,2521,57,0,16,0,6
65278,1,2497,2479,18,0,463,0,6
65279,1,2512,2419,93,0,100,1,6
65280,1,2411,2413,-2,0,107,0,6
65281,1,2330,2517,-187,0,117,0,6
65282,2,2428,2453,-25,0,387,0,6
65283,2,2404,2379,25,0,119,0,6
65284,1,2681,2567,114,0,107,0,6
65285,2,2319,2509,-190,0,41,0,6
65286,1,2599,2310,289,0,138,0,6
65287,1,2458,2485,-27,0,41,0,6
65288,1,2325,2453,-128,0,141,0,6
65289,2,2214,2435,-221,0,300,0,6
65290,1,2375,2440,-65,0,211,0,5
65291,2,2414,2410,4,0,107,1,6
65292,1,2583,2407,176,0,241,0,6
65293,2,2516,2505,11,0,103,1,6
65294,1,2519,2206,313,0,45,0,6
65295,2,2576,2561,15,0,5,0,6
65296,2,2429,2317,112,0,80,0,6
65297,1,2446,2474,-28,0,311,1,6
65298,1,2405,2464,-59,0,265,1,6
65299,2,2517,2503,14,0,168,0,6
65300,1,2299,2479,-180,0,190,0,6
65301,1,2475,2285,190,0,310,0,6
65302,2,2459,2422,37,0,335,0,6
65303,2,2328,2508,-180,0,327,0,6
65304,1,2759,2586,173,0,140,0,6
65305,1,2563,2685,-122,0,70,1,6
65306,1,2348,2401,-53,0,190,0,6
65307,3,2404,2447,-43,0,301,0,6
65308,2,2445,2357,88,0,153,0,6
65309,2,2214,2481,-267,0,405,1,6
65310,1,2278,2416,-138,4,300,0,13
65311,1,2472,2453,19,0,32,0,6
65312,2,2345,2447,-102,0,11,1,6
65313,2,2374,2511,-137,0,46,0,6
65314,1,2511,2308,203,0,0,0,6
65315,2,2257,2601,-344,0,337,0,6
65316,1,2416,2416,0,0,45,0,6
65317,1,2409,2421,-12,0,113,0,6
65318,1,2471,2308,163,0,0,0,6
65320,1,2467,2453,14,0,16,0,6
65321,1,2304,2474,-170,0,190,0,6
65322,1,2446,2405,41,0,41,1,6
65323,2,2316,2461,-145,0,310,0,6
65324,2,2511,2509,2,0,46,0,6
65325,2,2571,2568,3,0,200,1,6
65326,1,2510,2460,50,0,100,0,6
65327,2,2411,2464,-53,0,217,0,6
65328,1,2429,2458,-29,0,311,1,6
65329,1,2462,2240,222,0,113,0,6
65330,2,2583,2434,149,0,213,1,6
65331,2,2331,2478,-147,0,143,0,6
65332,2,2568,2763,-195,0,345,1,6
65334,1,2466,2313,153,0,0,0,6
65335,1,2343,2477,-134,0,0,1,6
65336,2,2309,2415,-106,0,264,0,6
65337,1,2438,2514,-76,0,305,0,6
65338,2,2247,2415,-168,0,115,0,6
65339,2,2524,2640,-116,0,215,1,6
65340,1,2401,2455,-54,0,206,0,6
65341,1,2455,2515,-60,0,301,1,6
65342,1,2539,2387,152,0,0,0,6
65343,3,2511,2427,84,0,46,0,6
65344,2,2451,2391,60,0,311,1,6
65345,1,2451,2364,87,0,464,1,6
65346,1,2447,2473,-26,0,311,0,6
65347,1,2411,2400,11,0,41,1,6
65348,1,2602,2285,317,0,138,0,6
65349,3,2530,2480,50,0,112,0,6
65350,1,2457,2431,26,0,28,0,6
65351,2,2505,2565,-60,0,45,0,6
65352,1,2482,2313,169,0,48,0,6
65353,2,2457,2575,-118,0,123,1,6
65354,2,2310,2469,-159,0,197,0,6
65355,1,2452,2435,17,0,302,0,6
65356,2,2418,2369,49,0,301,0,6
65357,1,2572,2676,-104,0,65,0,6
65358,1,2328,2407,-79,0,123,0,6
65359,3,2507,2565,-58,0,181,0,6
65360,2,2384,2445,-61,0,10,0,6
65361,2,2238,2531,-293,0,211,0,6
65362,1,2428,2214,214,0,4,0,6
65363,2,2644,2520,124,0,65,1,6
65364,2,2404,2468,-64,0,254,0,6
65365,1,2465,2462,3,0,107,0,6
65366,1,2473,2306,167,0,0,1,6
65367,2,2444,2309,135,0,311,0,6
65368,1,2467,2417,50,0,58,0,6
65369,3,2421,2480,-59,0,132,0,6
65370,1,2508,2453,55,0,210,0,6
65371,1,2431,2385,46,0,107,0,6
65372,1,2388,2456,-68,0,278,0,6
65373,2,2570,2500,70,0,103,0,6
65374,2,2368,2448,-80,0,219,1,6
65375,1,2472,2448,24,0,415,0,6
65376,1,2516,2604,-88,0,0,0,6
65377,1,2628,2579,49,0,345,0,6
65378,2,2376,2464,-88,0,135,1,6
65379,2,2430,2457,-27,0,43,0,6
65380,2,2450,2473,-23,0,269,1,6
65381,1,2429,2429,0,0,259,0,6
65382,2,2508,2453,55,0,296,0,6
65383,2,2564,2669,-105,0,77,1,6
65384,1,2766,2580,186,0,113,1,6
65385,1,2485,2400,85,0,46,0,6
65386,1,2417,2316,101,0,40,0,6
65387,3,2513,2437,76,0,215,0,6
65388,2,2448,2567,-119,0,40,0,6
65389,1,2303,2476,-173,0,190,0,6
65390,1,2527,2637,-110,0,343,0,6
65391,1,2449,2395,54,0,89,0,6
65392,1,2443,2477,-34,0,310,1,6
65393,1,2507,2563,-56,0,105,1,6
65394,1,2571,2502,69,0,7,0,6
65395,1,2453,2364,89,0,45,0,6
65396,1,2437,2294,143,0,4,0,6
65397,2,2359,2457,-98,0,211,0,6
65398,1,2436,2425,11,0,225,0,6
65399,3,2463,2512,-49,0,46,0,6
65400,1,2438,2395,43,0,468,0,6
65401,1,2403,2382,21,0,122,1,6
65402,1,2560,2459,101,0,395,0,6
65403,2,2398,2445,-47,0,483,0,6
65404,2,2468,2312,156,0,0,0,6
65405,3,2401,2212,189,0,302,0,10
65406,1,2412,2223,189,0,4,0,10
65407,2,2220,2440,-220,0,4,1,10
65408,2,2231,2429,-198,0,154,1,10
65409,2,2208,2424,-216,0,17,0,10
65410,1,2426,2239,187,0,122,0,10
65411,1,2428,2245,183,0,202,0,10
65412,2,2673,2587,86,0,310,0,6
65413,2,2577,2769,-192,0,344,0,6
65414,2,2275,2468,-193,0,102,0,6
65415,2,2478,2497,-19,0,268,0,6
65416,1,2571,2424,147,0,110,1,6
65417,3,2444,2421,23,0,4,0,5
65418,1,2437,2559,-122,0,48,0,5
65419,1,2602,2502,100,0,45,0,6
65420,1,2453,2360,93,0,455,1,6
65421,1,2420,2261,159,0,125,0,6
65422,1,2299,2442,-143,0,101,1,6
65423,1,2305,2405,-100,0,405,0,6
65424,2,2471,2449,22,0,410,1,6
65425,1,2556,2514,42,0,104,0,6
65426,3,2384,2441,-57,0,7,0,6
65427,1,2435,2375,60,0,484,0,6
65428,2,2467,2423,44,0,4,1,6
65429,2,2389,2424,-35,0,45,0,6
65430,1,2534,2236,298,0,375,1,6
65431,2,2511,2463,48,0,448,0,6
65432,2,2772,2574,198,0,107,1,6
65433,1,2462,2501,-39,0,301,0,6
65434,1,2320,2459,-139,0,154,0,6
65435,2,2462,2355,107,0,200,1,6
65436,1,2503,2393,110,0,113,0,6
65437,1,2400,2357,43,0,205,1,6
65438,1,2450,2470,-20,0,143,1,6
65439,3,2595,2580,15,0,140,0,6
65440,2,2564,2666,-102,0,77,0,6
65441,2,2421,2574,-153,0,40,0,6
65442,1,2509,2561,-52,0,103,1,6
65443,1,2370,2458,-88,0,108,0,6
65444,2,2453,2457,-4,0,132,0,6
65445,1,2390,2443,-53,0,200,1,6
65446,1,2455,2465,-10,0,123,0,6
65447,1,2495,2671,-176,0,5,1,6
65448,2,2386,2421,-35,0,122,0,6
65449,1,2455,2504,-49,0,123,0,6
65450,1,2400,2303,97,0,150,0,6
65451,2,2452,2328,124,0,1,0,6
65452,1,2470,2560,-90,0,48,0,6
65453,2,2451,2377,74,0,454,0,6
65454,2,2335,2470,-135,0,112,0,5
65455,3,2282,2452,-170,0,469,0,5
65456,2,2421,2271,150,0,40,1,5
65457,1,2558,2370,188,0,457,0,5
65458,1,2487,2390,97,0,15,0,5
65459,1,2432,2347,85,0,43,0,5
65460,2,2497,2398,99,0,409,0,5
65461,2,2506,2360,146,0,373,1,5
65462,1,2591,2336,255,0,15,0,5
65463,3,2480,2393,87,0,10,0,5
65464,1,2376,2409,-33,0,106,1,5
65465,3,2365,2441,-76,0,123,0,5
65466,1,2472,2520,-48,0,106,0,5
65467,1,2525,2412,113,0,48,0,5
65468,3,2408,2349,59,0,216,0,5
65469,2,2309,2525,-216,0,140,0,5
65470,2,2309,2689,-380,0,143,0,5
65471,1,2479,2483,-4,0,15,0,5
65472,1,2694,2385,309,0,106,0,5
65473,2,2352,2422,-70,0,12,0,5
65474,2,2400,2526,-126,0,106,0,5
65475,1,2462,2416,46,0,106,0,5
65476,2,2379,2405,-26,0,46,0,5
65477,2,2347,2463,-116,0,405,0,5
65478,2,2322,2511,-189,0,49,0,5
65479,2,2265,2420,-155,0,127,0,5
65480,1,2413,2261,152,0,0,1,5
65481,1,2469,2252,217,0,341,0,5
65482,3,2435,2536,-101,0,254,0,6
65483,1,2507,2397,110,0,172,1,6
65484,2,2583,2763,-180,0,485,1,6
65485,2,2352,2502,-150,0,195,1,6
65486,1,2670,2581,89,0,2,0,6
65487,2,2456,2503,-47,0,265,0,6
65488,1,2454,2418,36,0,300,1,6
65489,2,2555,2516,39,0,8,1,6
65490,3,2498,2462,36,0,249,0,6
65491,2,2459,2461,-2,0,411,0,6
65492,1,2336,2444,-108,0,197,0,6
65493,1,2252,2406,-154,0,45,0,6
65494,1,2463,2432,31,0,190,0,6
65495,1,2412,2253,159,0,123,1,6
65496,1,2469,2310,159,0,15,0,6
65497,1,2447,2444,3,0,108,0,6
65498,1,2431,2300,131,0,123,1,6
65499,1,2469,2412,57,0,57,1,6
65500,2,2263,2451,-188,0,405,1,6
65501,2,2311,2431,-120,0,331,1,10
65502,1,2432,2385,47,0,130,0,10
65503,1,2427,2267,160,0,307,0,10
65504,2,2396,2429,-33,0,250,1,10
65505,2,2443,2291,152,0,6,0,10
65506,2,2438,2384,54,0,107,0,6
65507,1,2319,2401,-82,0,52,1,6
65508,1,2766,2580,186,0,107,0,6
65509,2,2553,2453,100,0,318,1,6
65510,1,2464,2516,-52,0,335,1,6
65511,1,2432,2477,-45,0,300,1,6
65512,2,2307,2472,-165,0,123,1,6
65513,1,2406,2391,15,0,107,0,6
65514,1,2508,2436,72,0,4,0,6
65515,1,2332,2511,-179,0,7,0,6
65516,2,2303,2470,-167,4,110,0,8
65517,2,2577,2769,-192,0,312,1,6
65518,2,2413,2459,-46,0,40,0,6
65519,1,2437,2343,94,0,0,0,6
65520,2,2505,2453,52,0,484,0,6
65521,1,2584,2435,149,0,58,0,6
65522,2,2576,2674,-98,0,110,0,6
65523,2,2438,2435,3,0,257,1,6
65524,2,2329,2468,-139,0,132,1,6
65525,2,2296,2443,-147,0,268,0,6
65526,3,2324,2415,-91,0,7,0,6
65527,2,2284,2432,-148,0,153,0,6
65528,1,2522,2513,9,0,301,1,6
65529,2,2467,2474,-7,0,43,1,6
65530,1,2455,2535,-80,0,150,0,6
65531,2,2497,2545,-48,0,181,0,6
65532,1,2464,2408,56,0,300,1,6
65533,2,2284,2414,-130,0,30,0,6
65534,2,2460,2510,-50,0,110,0,6
65535,3,2210,2472,-262,0,228,0,5
65536,1,2424,2298,126,0,46,0,5
65537,1,2272,2469,-197,0,45,1,5
65538,2,2367,2403,-36,0,106,0,5
65539,1,2233,2490,-257,0,304,0,5
65540,1,2450,2359,91,0,382,0,5
65541,1,2463,2498,-35,0,113,0,5
65542,1,2423,2326,97,0,119,0,5
65543,2,2440,2260,180,0,400,0,5
65544,2,2291,2479,-188,0,101,0,5
65545,2,2305,2407,-102,0,123,0,5
65546,2,2364,2514,-150,0,405,0,5
65547,2,2310,2437,-127,0,115,0,5
65548,2,2320,2484,-164,0,269,0,5
65549,1,2232,2419,-187,0,106,0,5
65550,2,2372,2446,-74,0,103,0,5
65551,2,2313,2468,-155,0,315,0,5
65552,2,2368,2695,-327,0,151,0,5
65553,1,2580,2479,101,0,100,0,5
65554,1,2467,2602,-135,0,245,0,5
65555,2,2530,2561,-31,0,48,0,5
65556,2,2348,2492,-144,0,49,0,5
65557,1,2514,2316,198,0,106,0,5
65558,1,2411,2288,123,0,121,1,5
65559,1,2426,2285,141,0,36,0,5
65560,2,2405,2529,-124,0,115,0,5
65561,1,2528,2352,176,0,453,0,5
65562,1,2691,2318,373,0,373,0,5
65563,2,2471,2438,33,0,462,0,6
65564,2,2502,2386,116,0,107,0,6
65565,1,2431,2328,103,0,354,0,6
65566,3,2658,2815,-157,0,280,0,6
65567,1,2339,2441,-102,0,107,0,6
65568,1,2492,2341,151,0,241,0,6
65569,1,2460,2499,-39,0,415,0,6
65570,2,2772,2574,198,0,211,1,6
65571,2,2227,2446,-219,0,107,0,6
65572,2,2475,2550,-75,0,373,0,6
65573,1,2410,2303,107,0,5,0,6
65574,1,2434,2346,88,0,0,0,6
65575,1,2414,2465,-51,0,300,1,6
65576,1,2435,2349,86,0,320,0,6
65577,1,2280,2409,-129,0,121,0,6
65578,1,2420,2507,-87,0,315,0,6
65579,1,2515,2455,60,0,310,0,6
65580,1,2469,2322,147,0,45,0,6
65581,1,2403,2496,-93,0,405,0,6
65582,1,2462,2296,166,0,320,0,6
65583,3,2528,2442,86,0,20,0,6
65584,2,2433,2462,-29,0,116,1,6
65585,2,2299,2414,-115,0,106,1,6
65586,2,2342,2438,-96,0,190,1,6
65587,2,2462,2331,131,0,167,1,6
65588,2,2293,2465,-172,0,128,0,6
65589,2,2255,2462,-207,0,220,1,6
65590,1,2470,2375,95,0,28,0,6
65591,1,2812,2662,150,0,400,0,6
65592,2,2495,2471,24,0,135,0,6
65593,2,2393,2473,-80,0,206,0,6
65594,1,2492,2467,25,0,310,0,6
65595,2,2583,2763,-180,0,43,1,6
65596,3,2438,2224,214,0,43,0,10
65597,1,2402,2390,12,0,302,0,10
65598,1,2434,2299,135,0,122,1,10
65599,1,2435,2439,-4,0,150,0,10
65600,2,2252,2430,-178,0,302,0,10
65601,1,2415,2406,9,0,8,0,10
65602,2,2252,2435,-183,0,343,0,10
65603,2,2527,2228,299,0,16,1,6
65604,2,2444,2451,-7,0,101,1,6
65605,1,2431,2325,106,0,35,1,6
65606,2,2440,2489,-49,0,418,1,6
65607,1,2437,2435,2,0,202,0,6
65608,1,2443,2288,155,0,101,0,6
65609,2,2500,2407,93,0,5,0,6
65610,1,2420,2357,63,0,301,1,6
65611,2,2451,2458,-7,0,113,0,6
65612,2,2520,2489,31,0,405,0,6
65613,2,2389,2468,-79,0,128,1,6
65614,1,2477,2410,67,0,43,1,6
65615,3,2418,2295,123,0,5,0,6
65616,1,2461,2498,-37,0,400,1,6
65618,1,2396,2454,-58,0,302,1,6
65619,1,2587,2627,-40,0,3,0,6
65620,2,2270,2431,-161,0,194,0,5
65621,2,2268,2525,-257,0,302,0,5
65622,1,2474,2454,20,0,124,0,5
65623,1,2405,2273,132,0,5,0,5
65624,3,2397,2401,-4,0,152,0,5
65625,2,2430,2384,46,0,45,0,5
65626,2,2482,2597,-115,0,18,0,5
65627,2,2286,2469,-183,0,25,0,5
65628,2,2447,2410,37,0,18,1,5
65629,3,2468,2446,22,0,315,0,5
65630,1,2284,2475,-191,0,8,0,5
65631,1,2697,2531,166,0,4,0,5
65632,2,2488,2415,73,0,20,0,5
65633,1,2567,2547,20,0,52,1,5
65634,2,2411,2301,110,0,48,0,5
65635,2,2451,2693,-242,0,25,0,5
65636,1,2533,2240,293,0,47,0,5
65637,1,2411,2308,103,0,108,1,5
65638,1,2495,2351,144,0,13,1,5
65639,1,2471,2585,-114,0,70,0,5
65640,1,2312,2428,-116,0,4,0,5
65641,1,2452,2327,125,0,245,0,5
65642,1,2441,2298,143,0,300,0,5
65643,2,2328,2475,-147,0,102,0,5
65644,2,2574,2468,106,0,100,0,6
65645,1,2456,2517,-61,0,19,0,6
65646,1,2428,2438,-10,0,1,0,6
65647,1,2767,2580,187,0,216,0,6
65648,2,2380,2440,-60,0,213,0,6
65649,3,2664,2816,-152,0,358,0,6
65650,2,2357,2445,-88,0,101,0,6
65651,1,2517,2445,72,0,0,0,6
65652,1,2464,2437,27,0,46,0,6
65653,1,2495,2435,60,0,215,0,6
65654,1,2494,2513,-19,0,46,0,6
65655,2,2353,2474,-121,0,13,0,6
65656,1,2493,2425,68,0,7,0,6
65657,3,2374,2429,-55,0,75,0,6
65658,1,2620,2594,26,0,0,1,6
65659,1,2497,2414,83,0,190,0,6
65660,1,2492,2468,24,0,335,1,6
65661,2,2473,2384,89,0,107,0,6
65662,1,2406,2482,-76,0,200,0,6
65663,2,2411,2418,-7,0,302,0,6
65664,2,2475,2413,62,0,43,0,6
65665,2,2340,2441,-101,0,190,0,6
65667,2,2447,2403,44,0,144,1,6
65668,2,2477,2375,102,0,311,0,6
65669,2,2577,2769,-192,0,485,0,6
65670,3,2434,2463,-29,0,110,0,6
65671,3,2441,2567,-126,0,140,0,6
65672,1,2430,2253,177,0,57,1,6
65673,2,2515,2500,15,0,436,0,6
65674,2,2433,2380,53,0,133,0,5
65675,1,2814,2666,148,0,455,0,6
65676,2,2469,2468,1,0,40,1,6
65677,2,2507,2578,-71,0,40,0,6
65678,2,2419,2470,-51,0,134,1,6
65679,1,2442,2498,-56,0,311,1,6
65680,1,2420,2332,88,0,0,0,6
65681,1,2512,2435,77,0,31,0,6
65682,1,2445,2336,109,0,0,0,6
65683,1,2453,2398,55,0,37,1,6
65684,1,2428,2357,71,0,410,0,6
65686,1,2449,2356,93,0,0,0,6
65687,2,2506,2626,-120,0,196,0,6
65688,1,2270,2432,-162,0,457,0,10
65689,1,2401,2383,18,0,147,1,10
65690,3,2314,2409,-95,0,4,0,10
65691,2,2276,2421,-145,0,194,1,10
65692,2,2348,2438,-90,0,266,0,10
65693,2,2433,2441,-8,0,331,0,10
65694,1,2424,2293,131,0,52,0,6
65695,1,2462,2497,-35,0,14,0,6
65696,1,2630,2476,154,0,100,0,6
65697,2,2502,2443,59,0,246,1,6
65698,1,2410,2441,-31,0,333,0,6
65699,1,2401,2317,84,0,56,0,5
65700,1,2434,2279,155,0,41,1,5
65701,1,2405,2397,8,0,252,0,5
65702,1,2466,2243,223,0,311,0,5
65703,1,2348,2424,-76,0,202,0,5
65704,1,2527,2449,78,0,300,0,5
65705,3,2480,2317,163,0,152,0,5
65706,2,2472,2385,87,0,143,0,5
65707,1,2446,2345,101,0,51,0,5
65708,3,2330,2519,-189,0,147,0,5
65709,1,2479,2375,104,0,203,1,5
65710,1,2577,2319,258,0,153,0,5
65711,1,2414,2319,95,0,150,1,5
65712,1,2285,2411,-126,0,107,1,5
65713,2,2601,2415,186,0,127,0,5
65714,1,2542,2357,185,0,108,0,5
65715,2,2352,2480,-128,0,28,0,5
65716,1,2416,2316,100,0,374,0,5
65717,1,2297,2534,-237,0,110,1,5
65718,2,2309,2700,-391,0,49,0,5
65719,2,2283,2456,-173,0,0,0,5
65720,2,2252,2468,-216,0,43,0,5
65721,2,2390,2481,-91,0,406,0,5
65722,2,2444,2518,-74,0,4,0,5
65723,1,2420,2260,160,0,302,1,5
65724,2,2516,2570,-54,0,225,0,5
65725,3,2478,2499,-21,0,115,0,5
65726,1,2422,2320,102,0,101,0,5
65727,2,2387,2572,-185,0,127,0,5
65728,1,2696,2228,468,0,373,0,5
65729,1,2449,2266,183,0,40,0,5
65730,1,2552,2281,271,0,130,1,5
65731,1,2503,2501,2,0,57,0,6
65732,2,2330,2401,-71,0,125,0,6
65733,1,2238,2464,-226,0,112,1,6
65734,2,2433,2397,36,0,56,0,6
65735,2,2332,2425,-93,0,115,0,6
65736,2,2285,2517,-232,0,150,1,6
65737,3,2589,2522,67,0,2,0,6
65738,2,2269,2448,-179,0,123,1,6
65739,1,2491,2463,28,0,4,0,6
65740,1,2474,2346,128,0,124,0,6
65741,2,2453,2372,81,0,0,0,6
65742,1,2447,2376,71,0,0,0,6
65744,1,2442,2383,59,0,49,1,6
65745,2,2491,2469,22,0,310,0,6
65746,1,2279,2427,-148,0,306,0,6
65747,2,2472,2633,-161,0,300,0,6
65748,1,2435,2416,19,0,144,0,6
65749,1,2458,2295,163,0,37,0,6
65750,2,2497,2478,19,0,4,0,6
65751,2,2406,2325,81,0,426,0,6
65752,1,2636,2469,167,0,100,0,6
65753,2,2258,2429,-171,0,123,0,6
65754,2,2427,2495,-68,0,421,0,6
65755,2,2371,2452,-81,0,0,0,6
65756,2,2449,2458,-9,0,200,0,6
65757,2,2444,2446,-2,0,41,0,6
65758,2,2363,2476,-113,0,46,1,6
65759,2,2409,2379,30,0,221,0,6
65760,1,2429,2247,182,0,45,0,6
65761,2,2475,2485,-10,0,445,1,6
65762,3,2543,2375,168,0,0,0,6
65763,1,2452,2438,14,0,0,0,6
65764,2,2292,2462,-170,0,56,0,6
65765,3,2408,2452,-44,0,301,0,6
65766,2,2466,2639,-173,0,300,1,6
65767,1,2519,2456,63,0,40,0,6
65768,1,2428,2423,5,0,101,0,6
65769,2,2415,2417,-2,0,40,1,6
65770,1,2342,2509,-167,0,8,1,6
65771,2,2388,2475,-87,0,300,1,6
65772,2,2456,2367,89,0,0,0,6
65773,2,2376,2446,-70,0,130,0,6
65774,2,2500,2496,4,0,215,0,6
65775,1,2411,2440,-29,0,334,0,6
65776,1,2404,2328,76,0,426,0,6
65777,1,2213,2405,-192,0,150,1,6
65778,3,2356,2641,-285,0,46,0,6
65779,2,2348,2484,-136,0,0,0,6
65780,2,2554,2588,-34,0,87,0,6
65781,1,2488,2491,-3,0,300,1,6
65782,1,2464,2433,31,0,302,0,6
65783,2,2444,2490,-46,0,152,0,6
65784,3,2322,2434,-112,0,127,0,10
65785,2,2273,2406,-133,0,115,0,10
65786,1,2315,2428,-113,0,45,0,10
65787,1,2407,2314,93,0,302,0,10
65788,2,2442,2386,56,0,263,0,10
65789,1,2446,2424,22,0,150,0,10
65790,2,2398,2511,-113,0,0,0,5
65791,2,2282,2554,-272,0,48,0,5
65792,2,2295,2438,-143,0,122,0,5
65793,1,2425,2294,131,0,119,0,5
65794,2,2299,2477,-178,0,267,1,5
65795,2,2226,2469,-243,0,114,0,5
65796,3,2479,2410,69,0,16,0,5
65797,2,2269,2592,-323,0,45,0,5
65798,1,2485,2293,192,0,10,0,5
65799,1,2484,2301,183,0,200,0,5
65800,1,2261,2420,-159,0,300,0,5
65801,1,2591,2236,355,0,20,0,5
65802,2,2516,2375,141,0,133,1,5
65803,1,2380,2440,-60,0,9,0,5
65804,3,2375,2529,-154,0,142,0,5
65805,3,2525,2531,-6,0,40,0,5
65806,2,2322,2579,-257,0,300,0,5
65807,1,2409,2419,-10,0,4,0,5
65808,3,2244,2424,-180,0,40,0,5
65809,1,2247,2450,-203,0,373,0,5
65810,1,2459,2426,33,0,263,0,5
65811,1,2523,2306,217,0,107,0,5
65812,2,2424,2479,-55,0,103,1,5
65813,1,2701,2394,307,0,5,0,5
65814,3,2575,2697,-122,0,34,0,5
65815,1,2498,2483,15,0,15,1,5
65816,1,2406,2224,182,0,40,0,5
65817,2,2337,2417,-80,0,315,0,5
65818,2,2291,2452,-161,0,107,0,5
65819,2,2270,2524,-254,0,122,1,6
65820,1,2465,2540,-75,0,13,0,6
65821,1,2643,2463,180,0,100,0,6
65822,1,2408,2395,13,0,426,0,6
65824,2,2562,2306,256,0,255,0,6
65826,1,2402,2488,-86,0,13,1,6
65827,2,2318,2404,-86,0,137,0,6
65828,1,2434,2417,17,0,218,1,6
65829,1,2451,2502,-51,0,45,0,6
65830,2,2486,2365,121,0,305,0,6
65831,1,2374,2549,-175,0,248,1,6
65832,2,2460,2646,-186,0,107,0,6
65833,1,2557,2381,176,0,151,0,6
65834,2,2565,2449,116,0,345,0,6
65835,1,2239,2422,-183,0,200,1,6
65836,2,2495,2439,56,0,310,0,6
65837,2,2251,2436,-185,0,230,0,6
65838,2,2324,2494,-170,0,331,0,6
65839,3,2485,2618,-133,0,8,0,6
65840,1,2519,2574,-55,0,210,1,6
65841,1,2649,2457,192,0,104,0,6
65842,1,2469,2757,-288,0,302,0,6
65843,2,2446,2489,-43,0,110,0,6
65844,1,2526,2421,105,0,464,0,6
65845,1,2414,2382,32,0,20,0,6
65846,2,2378,2560,-182,0,113,0,6
65847,1,2497,2318,179,0,45,0,6
65848,2,2289,2413,-124,0,127,1,6
65849,3,2390,2414,-24,0,132,0,6
65850,1,2533,2487,46,0,246,0,6
65851,1,2386,2413,-27,0,140,1,6
65852,1,2409,2423,-14,0,306,0,6
65853,1,2501,2472,29,0,45,0,6
65854,1,2439,2281,158,0,123,0,6
65855,2,2564,2375,189,0,127,0,6
65856,1,2343,2452,-109,0,134,1,6
65857,1,2615,2494,121,0,143,0,6
65858,1,2442,2417,25,0,101,0,6
65859,2,2411,2440,-29,0,0,1,6
65860,2,2315,2450,-135,0,409,0,6
65861,1,2454,2652,-198,0,107,1,6
65862,1,2495,2457,38,0,144,0,6
65863,3,2459,2530,-71,0,374,0,6
65864,2,2483,2203,280,0,302,0,6
65865,2,2358,2414,-56,0,40,1,6
65866,1,2377,2420,-43,0,45,1,6
65868,2,2577,2525,52,0,458,0,5
65869,2,2695,2504,191,0,7,0,5
65870,3,2464,2703,-239,0,147,0,5
65871,2,2227,2461,-234,0,140,0,5
65872,1,2409,2395,14,0,45,1,5
65873,1,2421,2208,213,0,36,0,5
65874,1,2413,2433,-20,0,112,0,5
65875,1,2219,2446,-227,0,102,0,5
65876,2,2411,2508,-97,0,120,0,5
65877,1,2467,2384,83,0,106,0,5
65878,3,2455,2272,183,0,67,0,5
65879,1,2515,2320,195,0,123,0,5
65880,1,2534,2215,319,0,106,0,5
65881,3,2556,2460,96,0,130,0,5
65882,3,2441,2378,63,0,388,0,5
65883,1,2408,2271,137,0,323,0,5
65884,1,2421,2268,153,0,302,0,5
65885,2,2320,2526,-206,0,310,0,5
65886,1,2526,2396,130,0,40,0,5
65887,1,2471,2480,-9,0,487,0,5
65888,1,2228,2419,-191,0,123,0,5
65889,2,2339,2429,-90,0,48,0,5
65890,2,2597,2396,201,0,96,0,5
65891,1,2488,2314,174,0,16,0,5
65892,2,2318,2487,-169,0,225,0,5
65893,3,2582,2427,155,0,140,0,5
65894,1,2421,2269,152,0,140,0,5
65895,1,2484,2398,86,0,101,1,5
65896,1,2383,2555,-172,0,113,0,6
65897,1,2494,2441,53,0,310,0,6
65898,3,2482,2466,16,0,7,0,6
65899,1,2446,2538,-92,0,47,0,6
65900,1,2420,2285,135,0,123,1,6
65901,2,2452,2428,24,0,300,0,6
65902,1,2449,2457,-8,0,151,0,6
65903,1,2430,2277,153,0,140,0,6
65904,3,2444,2527,-83,0,315,0,6
65905,1,2669,2481,188,0,436,0,6
65906,1,2446,2311,135,0,0,1,6
65907,1,2435,2311,124,0,140,0,6
65908,1,2445,2406,39,0,144,1,6
65909,1,2643,2463,180,0,100,0,6
65910,2,2460,2499,-39,0,150,0,6
65911,3,2413,2384,29,0,20,0,6
65912,1,2433,2356,77,0,102,0,6
65913,3,2531,2454,77,0,197,0,6
65914,1,2547,2392,155,0,176,0,6
65915,1,2419,2252,167,0,394,0,6
65916,2,2384,2428,-44,0,135,1,6
65917,2,2241,2445,-204,0,211,1,6
65918,2,2415,2417,-2,0,311,0,6
65919,2,2469,2424,45,0,415,0,6
65920,2,2482,2422,60,0,4,0,6
65921,1,2466,2479,-13,0,119,0,6
65922,2,2389,2550,-161,0,115,0,6
65923,1,2455,2362,93,0,140,0,6
65924,1,2549,2504,45,0,122,0,6
65925,1,2452,2434,18,0,107,1,6
65926,1,2384,2413,-29,0,205,1,6
65927,1,2446,2422,24,0,96,0,6
65928,1,2523,2480,43,0,1,1,6
65929,1,2525,2347,178,0,45,0,6
65930,1,2401,2450,-49,0,233,0,6
65931,2,2359,2513,-154,0,302,0,6
65932,2,2455,2530,-75,0,47,0,6
65933,3,2553,2385,168,0,0,0,6
65934,2,2348,2413,-65,0,385,1,6
65935,3,2478,2672,-194,0,330,0,6
65936,1,2437,2379,58,0,123,1,6
65937,1,2449,2463,-14,0,0,0,6
65939,1,2423,2410,13,0,130,0,6
65940,3,2646,2492,154,0,144,0,6
65941,2,2499,2554,-55,0,414,1,6
65942,1,2437,2326,111,0,15,0,5
65943,1,2427,2204,223,0,300,1,5
65944,1,2512,2228,284,0,101,1,5
65945,1,2474,2259,215,0,127,1,5
65946,2,2411,2415,-4,0,106,0,5
65947,2,2242,2555,-313,0,48,1,5
65948,1,2461,2240,221,0,110,0,5
65949,2,2365,2440,-75,0,150,0,5
65950,3,2379,2472,-93,0,190,0,5
65951,2,2227,2424,-197,0,302,0,5
65952,1,2480,2327,153,0,25,0,5
65953,2,2323,2535,-212,0,103,0,5
65954,3,2221,2518,-297,0,106,0,5
65955,1,2683,2298,385,0,8,1,5
65956,2,2530,2563,-33,0,453,0,5
65957,2,2321,2411,-90,0,15,0,5
65958,2,2258,2579,-321,0,45,0,5
65959,1,2393,2533,-140,0,40,1,5
65960,1,2595,2477,118,0,110,0,5
65961,1,2434,2265,169,0,45,0,5
65962,1,2528,2424,104,0,40,0,5
65963,1,2513,2468,45,0,302,1,5
65964,2,2433,2571,-138,0,127,0,5
65965,1,2416,2491,-75,0,13,0,5
65966,2,2311,2478,-167,0,16,0,5
65967,1,2700,2532,168,0,5,1,5
65968,2,2425,2488,-63,0,102,0,5
65969,1,2473,2460,13,0,302,0,6
65970,2,2388,2551,-163,0,113,0,6
65971,1,2380,2507,-127,0,216,0,6
65972,2,2344,2528,-184,0,11,1,6
65973,2,2407,2390,17,0,438,1,6
65974,1,2447,2296,151,0,337,1,6
65975,1,2457,2455,2,0,40,0,6
65976,1,2444,2408,36,0,142,1,6
65977,1,2426,2319,107,0,170,0,6
65978,2,2315,2417,-102,0,0,0,6
65979,1,2528,2516,12,0,45,1,6
65980,3,2457,2324,133,0,403,0,6
65981,2,2289,2448,-159,0,474,0,6
65982,2,2382,2451,-69,0,134,0,6
65983,2,2500,2535,-35,0,20,1,6
65984,2,2554,2385,169,0,45,0,6
65985,2,2374,2446,-72,0,135,1,6
65986,1,2404,2428,-24,0,1,0,6
65987,2,2495,2644,-149,0,152,0,6
65988,1,2418,2461,-43,0,52,1,6
65989,2,2429,2475,-46,0,267,1,6
65990,2,2536,2359,177,0,466,0,6
65991,1,2494,2463,31,0,310,0,6
65992,3,2475,2450,25,0,440,0,6
65993,1,2559,2455,104,0,122,0,6
65994,1,2421,2438,-17,0,331,0,6
65995,2,2396,2401,-5,0,228,0,6
65996,2,2456,2377,79,0,302,1,6
65997,1,2435,2479,-44,0,352,1,6
65998,2,2403,2449,-46,0,300,1,6
65999,1,2428,2313,115,0,109,0,6
66000,2,2321,2450,-129,0,335,0,6
66001,1,2647,2491,156,0,144,0,6
66002,1,2499,2454,45,0,485,0,6
66003,1,2422,2410,12,0,114,0,6
66004,2,2393,2546,-153,0,215,0,6
66005,1,2451,2363,88,0,102,0,6
66006,1,2458,2499,-41,0,400,0,6
66007,1,2454,2370,84,0,1,0,6
66008,1,2511,2563,-52,0,301,0,6
66009,2,2549,2390,159,0,45,0,6
66010,2,2406,2391,15,0,15,1,6
66011,1,2528,2547,-19,0,208,0,6
66012,2,2266,2423,-157,0,132,0,6
66013,2,2210,2405,-195,0,43,0,5
66014,2,2238,2430,-192,0,112,0,5
66015,1,2557,2270,287,0,115,0,5
66016,1,2525,2323,202,0,57,0,5
66017,2,2477,2380,97,0,151,0,5
66018,2,2514,2272,242,0,123,1,5
66019,1,2420,2464,-44,0,302,0,5
66020,1,2296,2429,-133,0,38,0,5
66021,1,2454,2525,-71,0,58,0,5
66022,2,2388,2421,-33,0,352,0,5
66023,1,2470,2316,154,0,133,0,5
66024,1,2473,2381,92,0,310,1,5
66025,1,2447,2514,-67,0,36,1,5
66026,2,2420,2485,-65,0,130,0,5
66027,1,2427,2308,119,0,10,0,5
66028,3,2538,2355,183,0,108,0,5
66029,3,2581,2684,-103,0,140,0,5
66030,1,2583,2532,51,0,11,0,5
66031,2,2599,2443,156,0,111,0,5
66032,1,2481,2349,132,0,343,0,5
66033,2,2463,2402,61,0,101,0,5
66034,2,2416,2574,-158,0,373,1,5
66035,1,2445,2325,120,0,400,0,5
66036,3,2529,2431,98,0,265,0,5
66037,1,2493,2490,3,0,100,0,5
66038,1,2703,2518,185,0,7,0,5
66039,1,2480,2427,53,0,8,1,6
66040,2,2307,2475,-168,0,13,0,6
66041,2,2432,2368,64,0,156,0,6
66042,1,2422,2365,57,0,48,0,6
66043,2,2366,2462,-96,0,106,0,6
66044,1,2449,2273,176,0,40,0,6
66045,2,2488,2651,-163,0,190,0,6
66046,2,2309,2432,-123,0,135,1,6
66047,1,2493,2464,29,0,310,1,6
66048,2,2230,2405,-175,0,101,0,6
66049,1,2472,2424,48,0,347,0,6
66050,1,2454,2398,56,0,218,1,6
66051,3,2603,2432,171,0,313,0,6
66052,1,2405,2428,-23,0,1,1,6
66053,1,2541,2534,7,0,45,0,6
66054,1,2556,2372,184,0,107,0,6
66055,3,2455,2518,-63,0,311,0,6
66056,1,2284,2425,-141,0,123,0,6
66057,2,2303,2452,-149,0,310,0,6
66058,2,2654,2485,169,0,211,1,6
66059,3,2397,2400,-3,0,45,0,6
66060,2,2278,2408,-130,0,11,0,6
66061,2,2449,2302,147,0,334,1,6
66062,2,2422,2485,-63,0,311,0,6
66063,1,2469,2361,108,0,0,0,6
66064,2,2477,2423,54,0,46,1,6
66065,2,2455,2528,-73,0,302,0,6
66066,2,2504,2484,20,0,310,0,6
66067,2,2427,2443,-16,0,48,1,6
66068,1,2459,2498,-39,0,112,0,6
66069,3,2393,2559,-166,0,1,0,6
66070,2,2393,2459,-66,0,131,1,6
66071,2,2478,2369,109,0,55,1,6
66072,3,2434,2600,-166,0,225,0,6
66073,1,2490,2403,87,0,330,0,6
66074,2,2422,2411,11,0,114,0,6
66075,1,2540,2300,240,0,14,0,6
66076,3,2357,2475,-118,0,101,0,6
66077,1,2527,2400,127,0,115,0,6
66078,1,2400,2397,3,0,44,0,6
66079,2,2493,2646,-153,0,219,0,6
66080,1,2462,2325,137,0,128,0,5
66081,1,2518,2261,257,0,406,0,5
66082,2,2315,2422,-107,0,194,1,5
66083,1,2313,2470,-157,0,487,1,5
66084,3,2320,2408,-88,0,39,0,5
66085,1,2507,2222,285,0,35,0,5
66086,1,2437,2256,181,0,49,0,5
66087,2,2282,2474,-192,0,124,0,5
66088,3,2433,2294,139,0,300,0,5
66089,1,2230,2415,-185,0,40,1,5
66090,2,2528,2461,67,0,45,0,5
66091,2,2364,2591,-227,0,46,0,5
66092,2,2388,2559,-171,0,297,0,5
66093,2,2263,2427,-164,0,40,0,5
66094,2,2412,2456,-44,0,398,1,5
66095,2,2231,2535,-304,0,127,1,5
66096,2,2478,2278,200,0,302,0,5
66097,2,2426,2528,-102,0,300,0,5
66098,1,2489,2449,40,0,30,0,5
66099,1,2485,2431,54,0,200,0,5
66100,1,2262,2454,-192,0,373,1,5
66101,3,2484,2583,-99,0,405,0,5
66102,2,2346,2600,-254,0,457,1,5
66103,3,2466,2682,-216,0,45,0,5
66104,1,2410,2435,-25,0,40,0,5
66105,1,2578,2485,93,0,12,0,5
66106,3,2515,2527,-12,0,48,0,5
66107,2,2499,2706,-207,0,190,0,5
66108,3,2419,2495,-76,0,134,0,6
66109,2,2383,2418,-35,0,8,0,6
66110,1,2489,2649,-160,0,7,0,6
66111,2,2542,2315,227,0,28,1,6
66112,2,2298,2451,-153,0,311,0,6
66113,2,2449,2421,28,0,15,0,6
66114,1,2417,2357,60,0,284,1,6
66115,1,2531,2357,174,0,144,0,6
66116,2,2417,2416,1,0,302,0,6
66117,3,2445,2436,9,0,41,0,6
66118,2,2401,2259,142,0,282,0,8
66119,2,2492,2465,27,0,491,1,6
66120,2,2396,2456,-60,0,127,0,6
66121,2,2598,2437,161,0,315,0,6
66122,1,2441,2471,-30,0,110,1,6
66123,1,2463,2388,75,0,210,0,6
66124,1,2275,2406,-131,0,142,0,6
66125,2,2391,2490,-99,0,303,0,6
66126,3,2280,2427,-147,0,45,0,5
66127,1,2472,2359,113,0,123,0,6
66128,3,2593,2641,-48,0,3,0,6
66129,2,2412,2378,34,0,106,0,6
66130,3,2451,2271,180,0,310,0,6
66131,1,2290,2454,-164,0,310,1,6
66132,2,2396,2417,-21,0,375,1,6
66133,1,2366,2534,-168,0,112,0,6
66134,2,2402,2391,11,0,57,1,6
66135,1,2494,2337,157,0,278,0,6
66136,2,2422,2411,11,0,113,0,6
66137,1,2443,2227,216,0,123,1,6
66138,2,2398,2428,-30,0,200,0,6
66139,2,2445,2590,-145,0,212,0,6
66140,1,2472,2486,-14,0,14,0,6
66141,1,2507,2533,-26,0,325,1,6
66142,1,2355,2479,-124,0,106,0,6
66143,2,2471,2461,10,0,13,1,6
66144,2,2417,2416,1,0,302,0,6
66145,2,2334,2497,-163,0,33,1,6
66146,2,2640,2594,46,0,101,1,6
66147,2,2384,2468,-84,0,335,1,6
66148,2,2433,2306,127,0,339,1,6
66149,3,2448,2464,-16,0,110,0,6
66150,1,2526,2384,142,0,108,0,6
66151,2,2433,2374,59,0,302,0,6
66152,1,2308,2446,-138,0,130,0,6
66153,1,2406,2277,129,0,242,1,5
66154,3,2426,2321,105,0,101,0,5
66155,2,2273,2440,-167,0,102,1,5
66156,2,2316,2521,-205,0,115,0,5
66157,2,2431,2459,-28,0,45,0,5
66158,1,2385,2520,-135,0,57,0,5
66159,2,2373,2469,-96,0,119,0,5
66160,2,2297,2422,-125,0,487,0,5
66161,2,2229,2407,-178,0,115,0,5
66162,2,2329,2509,-180,0,45,1,5
66163,2,2389,2593,-204,0,106,0,5
66164,1,2468,2537,-69,0,56,0,5
66165,1,2430,2562,-132,0,49,0,5
66166,3,2678,2461,217,0,7,0,5
66167,2,2532,2361,171,0,320,0,5
66168,1,2494,2271,223,0,15,0,5
66169,3,2477,2287,190,0,113,0,5
66170,1,2366,2474,-108,0,61,0,5
66171,3,2450,2490,-40,0,46,0,5
66172,1,2581,2338,243,0,101,0,5
66173,2,2422,2486,-64,0,15,0,5
66174,2,2481,2608,-127,0,245,0,5
66175,3,2709,2582,127,0,5,0,5
66176,3,2515,2417,98,0,302,0,5
66177,3,2527,2496,31,0,5,0,5
66178,2,2274,2406,-132,0,101,0,6
66179,2,2308,2400,-92,0,490,0,6
66180,2,2428,2396,32,0,121,0,6
66181,2,2480,2478,2,0,58,0,6
66182,2,2401,2350,51,0,117,0,6
66183,1,2448,2397,51,0,57,0,6
66184,3,2464,2593,-129,0,48,0,6
66185,1,2422,2411,11,0,43,0,6
66186,1,2467,2363,104,0,123,0,6
66187,2,2448,2533,-85,0,302,0,6
66188,1,2246,2483,-237,0,474,0,6
66189,1,2393,2426,-33,0,212,0,6
66190,2,2618,2527,91,0,343,0,6
66191,2,2406,2513,-107,0,253,1,6
66192,2,2422,2436,-14,0,331,0,6
66193,1,2512,2421,91,0,347,1,6
66194,1,2600,2634,-34,0,0,0,6
66195,2,2472,2380,92,0,218,0,6
66196,1,2467,2445,22,0,132,0,6
66197,2,2390,2530,-140,0,447,0,6
66198,1,2404,2304,100,0,466,0,6
66199,2,2359,2473,-114,0,249,1,6
66200,2,2483,2474,9,0,14,1,6
66201,1,2537,2444,93,0,107,0,6
66202,1,2591,2589,2,0,427,0,6
66203,2,2494,2479,15,0,13,0,6
66204,2,2300,2408,-108,0,456,1,6
66205,1,2390,2421,-31,0,142,0,6
66206,1,2620,2386,234,0,110,0,6
66207,2,2301,2401,-100,0,246,0,8
66208,1,2442,2327,115,0,106,1,6
66209,1,2406,2410,-4,0,319,0,6
66210,1,2533,2400,133,0,314,1,6
66211,2,2458,2560,-102,0,13,1,6
66212,1,2515,2409,106,0,0,1,6
66213,2,2263,2425,-162,0,205,0,6
66214,1,2516,2611,-95,0,4,0,6
66215,2,2387,2465,-78,0,300,1,6
66216,3,2713,2698,15,0,249,0,6
66217,2,2479,2355,124,0,123,0,6
66218,2,2391,2473,-82,0,343,1,6
66219,1,2583,2597,-14,0,330,0,6
66220,1,2480,2478,2,0,492,0,6
66221,2,2350,2464,-114,0,246,0,5
66222,2,2313,2506,-193,0,106,0,5
66223,1,2264,2410,-146,0,10,0,5
66224,1,2467,2232,235,0,10,0,5
66225,1,2426,2362,64,0,300,1,5
66226,1,2444,2225,219,0,16,0,5
66227,2,2201,2524,-323,0,106,1,5
66228,1,2530,2336,194,0,46,0,5
66229,1,2554,2413,141,0,246,0,5
66230,1,2473,2340,133,0,404,0,5
66231,1,2410,2306,104,0,453,0,5
66232,1,2512,2477,35,0,194,1,5
66233,1,2348,2446,-98,0,426,0,5
66234,2,2464,2427,37,0,101,1,5
66235,2,2269,2474,-205,0,46,0,5
66236,1,2455,2327,128,0,40,0,5
66237,3,2490,2451,39,0,330,0,5
66238,1,2674,2475,199,0,455,0,5
66239,1,2369,2527,-158,0,140,0,5
66240,3,2338,2447,-109,0,102,0,5
66241,2,2489,2438,51,0,127,0,5
66242,3,2596,2583,13,0,28,0,5
66243,1,2620,2513,107,0,11,0,5
66244,2,2419,2707,-288,0,48,0,5
66245,3,2584,2497,87,0,13,0,5
66246,1,2496,2374,122,0,128,0,5
66247,2,2513,2254,259,0,46,0,5
66248,1,2471,2416,55,0,143,1,6
66249,1,2336,2437,-101,0,302,0,6
66250,1,2657,2623,34,0,46,0,6
66251,2,2278,2419,-141,0,250,0,10
66252,1,2428,2269,159,0,491,0,10
66253,1,2442,2348,94,0,304,0,10
66254,1,2419,2265,154,0,460,1,10
66255,2,2378,2413,-35,0,100,0,10
66256,3,2393,2452,-59,0,110,0,10
66257,1,2410,2436,-26,0,302,0,10
66258,1,2505,2549,-44,0,306,1,6
66259,1,2412,2296,116,0,490,0,6
66260,1,2397,2442,-45,0,157,0,6
66261,2,2446,2412,34,0,115,0,6
66262,2,2591,2589,2,0,17,0,6
66263,1,2447,2400,47,0,403,1,6
66264,1,2698,2713,-15,0,243,0,6
66265,3,2400,2319,81,0,113,0,6
66266,1,2516,2533,-17,0,310,0,6
66267,1,2523,2603,-80,0,150,0,6
66268,2,2363,2468,-105,0,249,0,6
66269,2,2474,2443,31,0,440,1,6
66270,1,2440,2449,-9,0,4,0,6
66271,1,2470,2382,88,0,211,1,6
66272,2,2564,2454,110,0,490,0,6
66273,2,2574,2480,94,0,101,0,6
66274,2,2472,2486,-14,0,400,0,6
66275,1,2440,2386,54,0,205,0,6
66276,1,2527,2522,5,0,106,0,6
66277,2,2418,2542,-124,0,40,0,6
66278,3,2617,2663,-46,0,110,0,6
66279,2,2512,2399,113,0,105,1,6
66280,1,2577,2317,260,0,398,0,8
66281,1,2476,2410,66,0,190,0,6
66282,2,2260,2465,-205,4,100,0,0
66283,2,2292,2416,-124,0,474,0,6
66284,2,2595,2585,10,0,40,0,6
66285,1,2429,2325,104,0,308,0,6
66286,1,2420,2384,36,0,388,0,6
66287,1,2405,2286,119,0,242,1,6
66288,3,2474,2359,115,0,123,0,6
66289,2,2401,2414,-13,0,106,0,6
66290,2,2301,2430,-129,0,265,0,6
66291,2,2596,2530,66,0,0,0,6
66292,1,2420,2288,132,0,474,0,6
66293,2,2662,2618,44,0,45,1,6
66294,2,2492,2444,48,0,310,0,6
66295,2,2477,2443,34,0,405,0,6
66296,1,2402,2325,77,0,107,0,5
66297,2,2264,2524,-260,0,302,0,5
66298,3,2386,2468,-82,0,487,0,5
66299,1,2406,2215,191,0,4,0,5
66300,1,2509,2291,218,0,123,1,5
66301,2,2439,2470,-31,0,466,0,5
66302,2,2285,2472,-187,0,123,1,5
66303,2,2290,2458,-168,0,140,0,5
66304,2,2304,2446,-142,0,0,1,5
66305,1,2533,2289,244,0,240,0,5
66306,3,2525,2477,48,0,65,0,5
66307,2,2445,2430,15,0,10,1,5
66308,1,2472,2340,132,0,426,0,5
66309,1,2558,2483,75,0,100,0,5
66310,1,2519,2415,104,0,119,0,5
66311,3,2433,2518,-85,0,35,0,5
66312,2,2316,2596,-280,0,106,0,5
66313,3,2477,2417,60,0,101,0,5
66314,3,2509,2490,19,0,15,0,5
66315,2,2451,2464,-13,0,302,0,5
66316,1,2584,2370,214,0,241,0,5
66317,1,2445,2498,-53,0,47,1,5
66318,3,2708,2633,75,0,5,0,5
66319,1,2582,2500,82,0,13,0,5
66320,2,2377,2677,-300,0,140,1,5
66321,2,2388,2442,-54,4,477,0,13
66322,2,2297,2579,-282,0,125,1,8
66323,1,2414,2406,8,0,453,1,6
66324,2,2449,2487,-38,0,101,0,6
66325,1,2376,2402,-26,0,143,0,6
66326,2,2284,2424,-140,0,491,0,6
66327,1,2461,2556,-95,0,20,1,6
66328,2,2469,2404,65,0,113,0,6
66329,1,2449,2481,-32,0,308,1,6
66330,2,2454,2395,59,0,249,0,6
66331,2,2392,2537,-145,0,102,0,6
66332,2,2545,2590,-45,0,241,1,6
66333,2,2342,2400,-58,0,43,1,6
66334,1,2409,2440,-31,0,151,1,6
66335,1,2493,2262,231,0,150,0,6
66336,2,2386,2433,-47,0,34,0,6
66337,2,2451,2485,-34,0,414,0,6
66338,1,2435,2345,90,0,40,0,6
66339,1,2425,2384,41,0,130,1,10
66340,2,2383,2431,-48,0,258,0,10
66341,2,2430,2271,159,0,257,0,10
66342,3,2394,2416,-22,0,112,0,10
66343,3,2451,2446,5,0,111,0,10
66344,1,2420,2422,-2,0,48,0,10
66345,1,2427,2281,146,0,485,0,6
66346,1,2655,2500,155,0,374,0,6
66347,1,2393,2401,-8,0,45,0,6
66348,2,2375,2425,-50,0,209,0,6
66349,1,2471,2337,134,0,254,0,6
66350,1,2660,2701,-41,0,8,0,6
66351,1,2455,2544,-89,0,295,0,6
66352,1,2402,2378,24,0,112,0,6
66353,3,2455,2532,-77,0,107,0,6
66354,1,2277,2431,-154,0,474,0,6
66355,3,2595,2405,190,0,36,0,6
66356,1,2541,2540,1,0,7,0,6
66357,2,2342,2495,-153,0,4,0,6
66358,1,2434,2321,113,0,190,0,6
66359,1,2549,2469,80,0,15,0,6
66360,1,2418,2562,-144,0,48,0,5
66361,1,2490,2434,56,0,11,1,5
66362,2,2496,2586,-90,0,111,1,5
66363,2,2476,2476,0,0,135,0,5
66364,1,2598,2450,148,0,102,0,5
66365,2,2436,2523,-87,0,45,0,5
66366,3,2492,2478,14,0,11,0,5
66367,1,2361,2680,-319,0,58,1,5
66368,3,2637,2587,50,0,30,0,5
66369,2,2451,2707,-256,0,49,0,5
66370,1,2505,2319,186,0,41,1,5
66371,2,2313,2427,-114,0,115,1,5
66372,2,2410,2267,143,0,112,1,5
66373,1,2466,2407,59,0,42,0,5
66374,1,2457,2423,34,0,459,0,5
66375,1,2526,2293,233,0,40,0,5
66376,2,2512,2278,234,0,111,1,5
66377,1,2367,2478,-111,0,345,1,5
66378,1,2475,2344,131,0,320,1,5
66379,2,2307,2411,-104,0,246,0,5
66380,1,2478,2220,258,0,190,0,5
66381,1,2402,2314,88,0,0,1,5
66382,2,2475,2524,-49,0,11,1,5
66383,2,2214,2509,-295,0,466,0,5
66384,2,2516,2376,140,0,332,1,5
66385,1,2461,2446,15,0,216,0,5
66386,2,2295,2536,-241,0,106,0,5
66387,1,2458,2490,-32,0,46,0,6
66388,1,2423,2286,137,0,474,1,6
66389,2,2694,2666,28,0,310,1,6
66390,2,2389,2625,-236,0,107,0,6
66391,2,2219,2581,-362,0,143,0,8
66392,1,2373,2457,-84,0,355,1,6
66393,2,2499,2530,-31,0,101,0,6
66394,2,2438,2381,57,0,41,0,6
66395,2,2253,2414,-161,0,491,0,6
66396,1,2430,2274,156,0,45,0,6
66397,1,2436,2270,166,0,305,0,6
66398,2,2484,2445,39,0,331,0,6
66399,1,2414,2469,-55,0,134,0,6
66400,1,2542,2592,-50,0,346,0,6
66401,2,2367,2440,-73,0,132,0,6
66402,2,2365,2438,-73,0,16,0,6
66403,2,2408,2535,-127,0,278,1,6
66404,1,2290,2428,-138,0,106,1,6
66405,3,2405,2443,-38,0,332,0,3
66406,1,2329,2434,-105,0,118,1,6
66407,1,2494,2354,140,0,113,1,6
66408,1,2536,2323,213,0,49,0,6
66409,1,2464,2554,-90,0,11,1,6
66410,2,2517,2443,74,0,143,0,6
66411,2,2515,2659,-144,0,10,0,6
66412,1,2400,2234,166,0,106,0,6
66414,2,2439,2478,-39,0,18,0,6
66415,2,2463,2405,58,0,45,0,6
66416,2,2430,2497,-67,0,40,0,6
66417,1,2492,2442,50,0,302,0,6
66418,1,2295,2445,-150,0,132,0,6
66419,1,2434,2352,82,0,48,0,10
66420,1,2416,2280,136,0,17,0,10
66421,3,2427,2451,-24,0,302,0,10
66422,1,2446,2243,203,0,304,0,10
66423,1,2436,2262,174,0,461,0,10
66424,1,2585,2407,178,0,101,1,6
66425,3,2450,2370,80,0,40,0,6
66426,2,2497,2635,-138,0,188,1,6
66427,1,2412,2456,-44,0,133,0,6
66428,3,2442,2406,36,0,250,0,3
66429,1,2483,2431,52,0,335,0,6
66430,1,2582,2231,351,0,311,0,8
66431,2,2294,2447,-153,0,57,1,6
66432,1,2426,2355,71,0,130,0,6
66433,2,2497,2538,-41,0,41,0,6
66434,2,2539,2550,-11,0,136,0,6
66435,1,2340,2450,-110,0,151,0,6
66436,1,2468,2446,22,0,300,0,6
66437,1,2416,2271,145,0,8,0,6
66438,2,2662,2510,152,0,40,0,6
66439,2,2450,2418,32,0,45,0,6
66440,1,2266,2406,-140,0,120,0,6
66441,1,2502,2426,76,0,201,1,6
66442,3,2407,2442,-35,0,250,0,3
66443,1,2411,2355,56,0,400,1,6
66444,2,2547,2472,75,0,453,1,6
66445,2,2277,2449,-172,0,136,0,6
66446,2,2436,2431,5,0,305,0,6
66447,3,2442,2465,-23,0,140,0,6
66448,1,2406,2209,197,4,132,0,13
66449,2,2639,2526,113,0,43,0,6
66450,1,2423,2488,-65,0,18,0,6
66451,2,2303,2479,-176,0,4,0,6
66452,2,2481,2434,47,0,335,0,6
66453,2,2580,2588,-8,0,41,0,6
66454,2,2341,2582,-241,0,10,0,6
66455,1,2492,2321,171,0,302,0,6
66456,1,2543,2520,23,0,302,0,6
66457,2,2493,2474,19,0,200,0,6
66458,2,2533,2409,124,0,190,1,6
66459,2,2424,2443,-19,0,133,0,6
66460,1,2401,2293,108,0,107,0,6
66461,3,2556,2654,-98,0,331,0,6
66462,2,2428,2495,-67,0,312,0,6
66463,1,2452,2274,178,0,153,0,6
66464,3,2387,2425,-38,0,43,0,6
66465,2,2421,2380,41,0,48,1,6
66466,1,2505,2533,-28,0,201,0,6
66467,1,2507,2327,180,0,201,0,6
66468,1,2437,2291,146,0,45,0,6
66469,2,2225,2583,-358,0,142,0,8
66470,1,2443,2398,45,0,190,0,6
66471,2,2482,2300,182,0,4,1,6
66472,3,2441,2407,34,0,288,0,3
66473,2,2261,2429,-168,0,100,0,6
66474,2,2444,2475,-31,0,18,0,6
66475,1,2324,2405,-81,0,389,0,6
66476,2,2631,2471,160,0,56,0,6
66477,2,2358,2419,-61,0,16,1,6
66478,1,2549,2376,173,0,49,0,6
66479,1,2479,2540,-61,0,30,1,6
66480,3,2261,2421,-160,0,40,0,6
66481,2,2594,2607,-13,0,406,0,6
66482,2,2534,2446,88,0,13,1,6
66483,1,2480,2424,56,0,414,0,6
66484,2,2589,2487,102,0,123,0,6
66485,1,2615,2574,41,0,226,1,6
66486,1,2271,2455,-184,0,301,0,6
66487,2,2440,2373,67,0,45,1,6
66488,2,2584,2480,104,0,45,0,6
66489,2,2400,2329,71,0,13,1,6
66490,1,2405,2396,9,0,20,0,6
66491,1,2411,2244,167,0,110,0,10
66492,2,2305,2440,-135,0,278,0,10
66493,2,2240,2441,-201,0,487,0,10
66494,2,2420,2449,-29,0,4,0,10
66495,1,2450,2418,32,0,110,0,10
66496,3,2398,2427,-29,0,250,0,10
66497,3,2623,2525,98,0,338,0,6
66498,2,2462,2448,14,0,411,0,6
66499,2,2250,2600,-350,0,242,0,6
66500,1,2552,2572,-20,0,46,0,6
66501,2,2449,2493,-44,0,115,1,6
66502,2,2392,2424,-32,0,15,0,6
66503,2,2388,2415,-27,0,56,1,6
66504,1,2433,2350,83,0,0,0,6
66505,2,2418,2485,-67,0,14,0,6
66506,2,2406,2558,-152,0,41,1,6
66507,1,2527,2384,143,0,147,0,6
66508,2,2453,2316,137,0,207,0,8
66509,2,2411,2581,-170,0,31,1,6
66510,1,2430,2293,137,0,20,1,5
66511,2,2470,2329,141,0,62,0,5
66512,1,2440,2206,234,0,4,0,5
66513,2,2419,2403,16,0,15,0,5
66514,2,2432,2411,21,0,45,0,5
66515,2,2667,2375,292,0,455,0,5
66516,1,2492,2408,84,0,10,0,5
66517,1,2479,2283,196,0,210,0,5
66518,1,2529,2492,37,0,436,0,5
66519,3,2322,2511,-189,0,487,0,5
66520,3,2482,2449,33,0,469,0,5
66521,3,2527,2495,32,0,5,0,5
66522,3,2538,2426,112,0,8,0,5
66523,3,2591,2710,-119,0,140,0,5
66524,2,2601,2634,-33,0,277,0,5
66525,1,2373,2508,-135,0,211,0,5
66526,1,2417,2356,61,0,119,0,5
66527,2,2317,2503,-186,0,106,0,5
66528,2,2527,2438,89,0,100,0,6
66529,2,2569,2566,3,0,402,0,6
66530,2,2417,2258,159,0,110,1,6
66531,3,2393,2448,-55,0,45,0,6
66532,2,2453,2419,34,0,70,1,6
66533,2,2576,2439,137,0,107,1,6
66534,2,2259,2423,-164,0,51,1,6
66535,2,2495,2577,-82,0,107,0,6
66536,2,2448,2455,-7,0,381,1,6
66537,1,2490,2413,77,0,382,1,6
66538,1,2420,2420,0,0,43,0,6
66539,1,2433,2324,109,0,256,0,8
66540,3,2511,2317,194,0,49,0,6
66541,1,2562,2447,115,0,49,0,6
66542,2,2430,2321,109,0,130,0,6
66543,3,2447,2274,173,4,392,0,13
66544,3,2313,2465,-152,0,45,0,6
66545,1,2572,2563,9,0,446,0,6
66546,2,2479,2431,48,0,109,0,6
66547,2,2381,2531,-150,0,410,0,6
66548,2,2444,2533,-89,0,267,0,6
66549,1,2585,2490,95,0,215,0,6
66550,1,2581,2558,23,0,300,0,6
66551,1,2467,2446,21,0,40,0,6
66552,2,2578,2520,58,0,246,0,6
66553,1,2403,2336,67,0,56,0,6
66554,2,2407,2447,-40,0,415,1,6
66555,2,2361,2432,-71,0,319,0,6
66556,3,2306,2509,-203,0,395,0,6
66557,2,2398,2437,-39,0,7,0,6
66558,2,2446,2348,98,0,380,0,6
66559,2,2461,2442,19,0,1,0,6
66560,1,2467,2352,115,0,311,1,6
66561,2,2414,2536,-122,0,48,0,6
66562,2,2339,2426,-87,0,344,1,6
66563,2,2292,2435,-143,0,0,0,6
66564,1,2494,2316,178,0,310,1,6
66565,2,2422,2463,-41,0,140,0,6
66566,1,2530,2427,103,0,101,0,6
66567,2,2331,2408,-77,0,4,1,6
66568,1,2553,2571,-18,0,337,0,6
66569,1,2454,2375,79,0,106,0,6
66570,3,2408,2441,-33,0,250,0,3
66571,1,2475,2565,-90,0,101,0,6
66572,1,2527,2472,55,0,190,0,6
66573,1,2408,2455,-47,0,487,0,6
66574,1,2447,2534,-87,0,130,1,6
66575,1,2402,2242,160,0,102,0,5
66576,2,2470,2404,66,0,1,0,5
66577,1,2422,2233,189,0,205,0,5
66578,1,2508,2224,284,0,194,0,5
66579,1,2506,2426,80,0,124,0,5
66580,2,2487,2417,70,0,110,0,5
66581,1,2409,2478,-69,0,101,0,5
66582,2,2402,2443,-41,0,0,0,5
66583,3,2212,2655,-443,0,58,0,5
66584,2,2528,2554,-26,0,48,0,5
66585,2,2462,2472,-10,0,1,0,5
66586,2,2480,2325,155,0,100,0,5
66587,3,2481,2481,0,0,310,0,5
66588,3,2467,2535,-68,0,106,0,5
66589,3,2508,2375,133,0,25,0,5
66590,2,2450,2536,-86,0,49,0,5
66591,2,2385,2496,-111,0,406,0,5
66592,2,2384,2649,-265,0,255,0,5
66593,1,2428,2596,-168,0,303,0,5
66594,3,2592,2588,4,0,240,0,5
66595,1,2708,2495,213,0,17,0,5
66596,2,2371,2527,-156,0,466,0,5
66597,1,2468,2394,74,0,10,1,6
66598,2,2486,2589,-103,0,142,1,6
66599,1,2402,2304,98,0,102,1,6
66600,2,2370,2400,-30,0,194,1,6
66601,2,2452,2314,138,0,10,0,6
66602,3,2324,2506,-182,0,46,0,6
66603,1,2393,2402,-9,0,1,0,6
66604,2,2474,2523,-49,0,154,0,6
66605,3,2407,2386,21,0,48,0,6
66606,1,2405,2436,-31,0,7,0,6
66607,2,2448,2455,-7,0,307,1,6
66608,2,2437,2248,189,0,106,0,8
66609,1,2537,2440,97,0,406,0,6
66610,1,2585,2230,355,0,306,1,8
66611,2,2565,2559,6,0,255,1,6
66612,2,2430,2339,91,0,48,1,6
66613,1,2431,2412,19,0,4,1,6
66614,2,2438,2386,52,0,45,0,6
66615,1,2450,2367,83,0,101,0,6
66616,2,2497,2411,86,0,58,0,6
66617,1,2322,2444,-122,0,394,1,6
66618,1,2423,2246,177,0,305,0,6
66619,1,2477,2246,231,0,125,0,8
66620,2,2289,2402,-113,0,120,0,6
66621,2,2501,2519,-18,0,385,0,6
66622,1,2527,2455,72,0,123,1,6
66623,1,2403,2328,75,0,13,0,6
66624,1,2423,2383,40,0,45,0,6
66625,1,2448,2333,115,0,201,0,6
66626,1,2455,2450,5,0,127,0,6
66627,1,2433,2320,113,0,244,0,6
66628,1,2472,2387,85,0,16,0,6
66629,1,2593,2587,6,0,110,0,6
66630,3,2429,2363,66,0,150,0,6
66631,1,2339,2415,-76,0,10,0,6
66632,2,2482,2672,-190,0,245,0,6
66633,2,2460,2597,-137,0,1,0,6
66634,1,2497,2376,121,0,48,0,6
66635,2,2490,2437,53,0,414,0,6
66636,2,2220,2558,-338,0,301,0,6
66637,1,2549,2532,17,0,278,0,6
66638,1,2565,2559,6,0,145,0,6
66639,1,2437,2407,30,0,4,1,6
66640,1,2436,2510,-74,0,15,0,6
66641,2,2220,2463,-243,0,0,0,5
66642,1,2223,2502,-279,0,30,0,5
66643,2,2410,2294,116,0,101,0,5
66644,1,2422,2336,86,0,45,0,5
66645,2,2359,2510,-151,0,122,0,5
66646,1,2523,2425,98,0,45,0,5
66647,1,2456,2480,-24,0,103,1,5
66648,3,2465,2314,151,0,461,0,5
66649,1,2463,2219,244,0,303,0,5
66650,1,2588,2342,246,0,152,0,5
66651,1,2649,2224,425,0,4,0,5
66652,2,2296,2472,-176,0,0,1,5
66653,2,2448,2510,-62,0,10,0,5
66654,1,2493,2381,112,0,16,0,5
66655,2,2279,2445,-166,0,40,0,5
66656,1,2448,2377,71,0,5,0,5
66657,3,2478,2382,96,0,107,0,5
66658,3,2534,2506,28,0,48,0,5
66659,1,2435,2416,19,0,16,0,5
66660,2,2530,2541,-11,0,4,0,5
66661,2,2333,2468,-135,0,46,0,5
66662,1,2424,2481,-57,0,311,0,5
66663,2,2560,2481,79,0,127,0,5
66664,1,2588,2437,151,0,311,0,5
66665,3,2500,2710,-210,0,15,0,5
66666,1,2654,2592,62,0,20,0,5
66667,2,2423,2425,-2,0,43,1,6
66668,1,2414,2289,125,0,15,0,6
66669,3,2504,2313,191,0,151,0,6
66670,1,2406,2519,-113,0,40,0,6
66671,1,2428,2436,-8,0,40,0,6
66672,2,2542,2469,73,0,310,1,6
66673,3,2288,2428,-140,0,256,0,8
66674,1,2600,2457,143,0,246,0,6
66675,2,2446,2409,37,0,4,0,6
66676,2,2323,2410,-87,0,40,0,6
66677,2,2450,2532,-82,0,202,0,6
66678,3,2331,2501,-170,0,4,0,6
66679,2,2653,2599,54,0,107,1,6
66680,1,2480,2437,43,0,253,0,6
66681,1,2330,2418,-88,0,265,0,6
66682,2,2332,2477,-145,0,3,0,6
66683,2,2526,2559,-33,0,101,0,6
66684,2,2268,2427,-159,0,310,0,6
66685,2,2404,2411,-7,0,130,0,6
66686,2,2600,2501,99,0,4,0,6
66688,2,2453,2604,-151,0,112,0,6
66689,3,2498,2317,181,0,5,0,6
66690,1,2601,2484,117,0,4,0,6
66691,2,2357,2521,-164,0,118,0,6
66692,3,2235,2414,-179,0,201,0,6
66693,2,2550,2444,106,0,3,0,6
66694,2,2378,2443,-65,0,315,0,6
66695,1,2536,2446,90,0,9,0,6
66696,2,2804,2522,282,0,113,1,6
66697,2,2442,2480,-38,0,15,0,6
66698,2,2430,2428,2,0,158,0,6
66699,1,2450,2328,122,0,414,1,6
66700,2,2323,2432,-109,0,344,0,6
66701,3,2280,2462,-182,0,40,0,8
66702,3,2440,2408,32,0,331,0,3
66703,3,2607,2450,157,0,107,0,6
66704,1,2416,2324,92,0,15,0,6
66705,1,2418,2521,-103,0,40,0,6
66706,1,2564,2605,-41,0,46,0,6
66707,1,2402,2451,-49,0,480,0,6
66708,2,2298,2416,-118,0,145,1,6
66709,1,2646,2425,221,0,41,0,6
66711,1,2317,2448,-131,0,315,0,6
66712,1,2411,2312,99,0,170,0,6
66713,2,2480,2605,-125,0,320,0,6
66714,2,2437,2319,118,0,14,0,6
66715,2,2599,2406,193,0,109,0,6
66716,2,2543,2570,-27,0,107,0,6
66717,3,2466,2473,-7,0,1,0,5
66718,2,2474,2293,181,0,112,0,5
66719,1,2329,2443,-114,0,40,0,5
66720,3,2421,2296,125,0,133,0,5
66721,1,2215,2462,-247,0,1,1,5
66722,2,2316,2426,-110,0,106,0,5
66723,2,2411,2527,-116,0,110,0,5
66724,2,2329,2463,-134,0,388,0,5
66725,1,2514,2412,102,0,228,0,5
66726,2,2475,2468,7,0,101,0,5
66727,1,2475,2354,121,0,313,0,5
66728,1,2507,2590,-83,0,14,0,5
66729,2,2515,2650,-135,0,124,0,5
66730,1,2553,2352,201,0,171,0,5
66731,1,2434,2453,-19,0,302,0,5
66732,1,2449,2476,-27,0,46,0,5
66733,2,2374,2497,-123,0,325,1,5
66734,2,2588,2441,147,0,218,0,5
66735,3,2472,2666,-194,0,268,0,5
66736,1,2430,2503,-73,0,413,0,5
66737,3,2488,2591,-103,0,382,0,5
66738,1,2524,2533,-9,0,106,0,5
66739,2,2546,2707,-161,0,461,0,5
66740,1,2264,2413,-149,0,114,0,6
66741,2,2319,2423,-104,0,352,0,6
66742,1,2452,2485,-33,0,46,1,6
66743,1,2430,2271,159,0,49,0,6
66744,2,2504,2514,-10,0,250,0,6
66745,2,2406,2476,-70,0,192,0,6
66746,2,2347,2418,-71,0,331,0,6
66747,1,2308,2405,-97,0,400,0,6
66748,1,2298,2432,-134,0,131,0,6
66749,1,2535,2403,132,0,108,0,6
66750,2,2315,2434,-119,0,4,0,6
66751,1,2412,2294,118,0,242,0,6
66752,2,2411,2608,-197,0,326,0,6
66753,1,2445,2408,37,0,123,1,6
66754,1,2481,2402,79,0,310,0,6
66755,1,2452,2428,24,0,1,0,6
66756,2,2324,2586,-262,0,100,0,6
66757,1,2511,2416,95,0,105,1,6
66758,2,2576,2381,195,0,46,0,6
66759,3,2253,2442,-189,4,130,0,13
66760,2,2401,2314,87,0,20,0,6
66761,2,2420,2327,93,0,39,1,6
66762,3,2535,2500,35,0,375,0,6
66763,2,2459,2503,-44,0,0,0,8
66764,2,2434,2424,10,0,34,1,6
66765,2,2510,2325,185,0,128,0,6
66766,2,2388,2440,-52,0,7,1,6
66767,1,2230,2504,-274,0,117,0,8
66768,2,2525,2649,-124,0,344,0,6
66769,2,2458,2590,-132,0,302,0,6
66770,2,2347,2528,-181,0,120,0,6
66771,2,2236,2415,-179,0,108,0,6
66772,2,2312,2452,-140,0,483,1,6
66773,1,2439,2260,179,0,302,1,6
66774,1,2424,2492,-68,0,107,0,6
66775,1,2479,2326,153,0,13,0,6
66776,1,2438,2297,141,0,323,0,6
66777,2,2485,2441,44,0,41,0,6
66778,2,2423,2426,-3,0,300,0,8
66779,1,2589,2322,267,0,300,0,6
66780,2,2611,2572,39,0,4,0,6
66781,1,2291,2441,-150,0,122,0,6
66782,1,2435,2329,106,0,13,0,6
66783,1,2405,2410,-5,0,49,1,6
66784,1,2450,2338,112,0,227,0,6
66785,3,2486,2336,150,0,5,0,6
66786,2,2371,2403,-32,0,43,0,6
66787,2,2498,2501,-3,0,106,0,6
66788,2,2316,2402,-86,0,17,0,6
66789,2,2483,2431,52,0,10,1,6
66790,1,2353,2416,-63,0,216,0,6
66791,1,2433,2334,99,0,45,0,6
66792,1,2334,2411,-77,0,49,0,6
66793,2,2390,2501,-111,0,380,0,6
66794,2,2352,2413,-61,0,490,1,6
66795,2,2581,2516,65,0,4,0,6
66796,3,2653,2522,131,0,40,0,6
66797,1,2404,2457,-53,0,110,0,6
66798,2,2485,2594,-109,0,4,0,6
66799,1,2453,2247,206,0,44,0,5
66800,1,2436,2291,145,0,20,0,5
66801,1,2405,2409,-4,0,106,0,5
66802,2,2376,2407,-31,0,301,0,5
66803,1,2280,2469,-189,0,46,0,5
66804,1,2405,2337,68,0,15,0,5
66805,2,2271,2430,-159,0,40,0,5
66806,2,2283,2511,-228,0,108,0,5
66807,2,2466,2531,-65,0,8,0,5
66808,2,2655,2543,112,0,456,0,5
66809,2,2496,2555,-59,0,15,0,5
66810,1,2518,2479,39,0,484,0,5
66811,1,2583,2370,213,0,344,1,5
66812,1,2447,2580,-133,0,301,1,5
66813,2,2514,2455,59,0,10,0,5
66814,2,2280,2474,-194,0,302,0,5
66815,2,2440,2530,-90,0,48,0,5
66816,1,2481,2490,-9,0,45,0,5
66817,1,2659,2437,222,0,15,0,5
66818,3,2501,2590,-89,0,36,0,5
66819,1,2711,2449,262,0,4,0,5
66820,1,2448,2479,-31,0,121,0,6
66821,2,2456,2308,148,0,201,1,6
66822,1,2429,2441,-12,0,106,0,6
66823,1,2409,2320,89,0,343,0,6
66824,1,2579,2605,-26,0,115,0,6
66825,3,2430,2428,2,0,341,0,6
66826,1,2433,2267,166,0,304,0,6
66827,1,2428,2505,-77,0,373,0,6
66828,1,2454,2321,133,0,229,1,6
66829,1,2508,2296,212,0,125,0,8
66830,1,2334,2494,-160,0,344,0,6
66831,1,2407,2234,173,0,245,1,6
66832,1,2404,2341,63,0,143,0,6
66833,2,2507,2404,103,0,153,0,6
66834,1,2360,2437,-77,0,317,0,6
66835,3,2341,2484,-143,0,434,0,6
66836,1,2435,2290,145,0,331,0,6
66837,3,2438,2435,3,0,123,0,6
66838,2,2266,2431,-165,0,389,0,6
66839,2,2402,2394,8,0,381,0,6
66840,2,2524,2492,32,0,490,0,6
66841,2,2295,2418,-123,0,45,0,6
66842,1,2476,2418,58,0,335,0,6
66843,1,2437,2474,-37,0,415,1,6
66844,1,2389,2401,-12,0,45,0,6
66845,2,2537,2480,57,0,106,0,6
66846,2,2598,2577,21,0,22,1,6
66847,2,2323,2500,-177,0,0,1,6
66848,3,2546,2367,179,0,0,0,6
66849,1,2599,2473,126,0,4,0,6
66850,2,2413,2482,-69,0,415,0,6
66851,2,2498,2357,141,0,253,0,6
66852,1,2499,2229,270,0,7,0,6
66853,1,2432,2510,-78,0,242,0,8
66854,1,2421,2327,94,0,15,0,6
66855,1,2488,2530,-42,0,5,0,6
66856,1,2353,2504,-151,0,200,1,6
66857,2,2316,2478,-162,0,127,1,6
66858,2,2336,2409,-73,0,45,0,6
66859,2,2410,2396,14,0,154,0,6
66860,2,2291,2439,-148,0,40,0,6
66861,1,2651,2785,-134,0,476,0,6
66862,2,2423,2230,193,0,4,1,6
66863,2,2499,2525,-26,0,35,0,6
66864,1,2501,2244,257,0,8,1,6
66865,2,2285,2428,-143,0,115,1,6
66866,2,2408,2481,-73,0,46,0,6
66867,3,2490,2417,73,0,253,0,6
66868,1,2469,2438,31,0,43,1,6
66869,1,2390,2442,-52,0,106,0,6
66870,3,2364,2436,-72,0,261,0,6
66871,2,2494,2618,-124,0,411,0,6
66872,3,2487,2543,-56,0,241,0,6
66873,1,2503,2452,51,0,176,0,6
66874,1,2606,2592,14,0,30,0,6
66875,1,2410,2306,104,0,341,0,8
66876,1,2489,2217,272,0,40,1,5
66877,1,2403,2287,116,0,150,0,5
66878,2,2474,2353,121,0,242,1,5
66879,3,2468,2360,108,0,1,0,5
66880,3,2416,2278,138,0,242,0,5
66881,2,2332,2456,-124,0,45,0,5
66882,2,2224,2439,-215,0,1,0,5
66883,3,2346,2411,-65,0,4,0,5
66884,1,2412,2345,67,0,130,0,5
66885,3,2572,2355,217,0,248,0,5
66886,2,2474,2289,185,0,200,0,5
66887,1,2433,2413,20,0,40,0,5
66888,2,2355,2462,-107,0,487,1,5
66889,1,2331,2492,-161,0,47,0,5
66890,2,2514,2507,7,0,106,0,5
66891,2,2277,2435,-158,0,302,1,5
66892,2,2380,2560,-180,0,255,0,5
66893,1,2646,2586,60,0,373,0,5
66894,1,2484,2523,-39,0,310,0,5
66895,1,2527,2455,72,0,335,1,5
66896,1,2536,2535,1,0,48,0,5
66897,3,2551,2502,49,0,4,0,5
66898,2,2447,2435,12,0,13,0,5
66899,3,2462,2665,-203,0,49,0,5
66900,3,2588,2477,111,0,15,0,5
66901,3,2713,2493,220,0,5,0,5
66902,2,2430,2414,16,0,300,1,6
66904,1,2468,2456,12,0,115,0,6
66905,1,2334,2404,-70,0,18,0,6
66906,2,2426,2402,24,0,9,0,6
66907,2,2509,2536,-27,0,45,1,6
66908,1,2454,2298,156,0,0,0,8
66909,2,2542,2488,54,0,0,0,6
66910,1,2436,2398,38,0,300,0,6
66911,2,2454,2284,170,0,45,0,6
66912,2,2432,2441,-9,0,126,1,6
66913,3,2481,2398,83,0,153,0,6
66914,1,2503,2439,64,0,220,0,8
66915,2,2447,2474,-27,0,121,0,6
66916,2,2587,2537,50,0,123,0,6
66917,1,2630,2622,8,0,395,0,6
66918,1,2425,2490,-65,0,118,0,6
66919,2,2420,2363,57,0,245,0,6
66920,1,2418,2402,16,0,37,0,6
66921,2,2455,2414,41,0,302,0,8
66922,2,2435,2419,16,0,302,0,6
66923,1,2581,2508,73,0,46,0,6
66924,1,2408,2272,136,0,58,1,6
66925,1,2525,2424,101,0,40,0,6
66926,2,2432,2443,-11,0,300,0,6
66927,2,2423,2421,2,0,123,0,6
66928,1,2443,2231,212,0,46,0,6
66929,2,2348,2401,-53,0,310,1,6
66930,2,2484,2426,58,0,268,1,6
66931,1,2425,2328,97,0,44,0,6
66932,2,2494,2535,-41,0,107,0,6
66933,1,2432,2480,-48,0,118,1,6
66934,3,2441,2272,169,0,72,0,6
66935,2,2405,2446,-41,0,103,1,6
66936,2,2427,2429,-2,0,242,0,6
66937,2,2541,2601,-60,0,227,0,6
66938,2,2404,2322,82,0,101,0,6
66939,2,2636,2653,-17,0,111,0,6
66940,1,2480,2427,53,0,40,0,6
66941,1,2617,2454,163,0,324,1,6
66942,1,2447,2418,29,0,45,1,6
66943,1,2435,2264,171,0,41,0,6
66944,2,2420,2585,-165,0,37,1,6
66945,1,2503,2334,169,0,242,1,6
66946,1,2541,2489,52,0,0,1,6
66947,2,2516,2542,-26,0,88,1,6
66948,2,2258,2412,-154,0,242,0,6
66949,3,2420,2458,-38,0,138,0,8
66950,1,2424,2339,85,0,101,0,6
66951,1,2434,2508,-74,0,242,0,8
66952,1,2415,2255,160,0,424,0,6
66953,1,2375,2540,-165,0,483,0,6
66954,1,2413,2278,135,0,101,0,6
66955,1,2435,2378,57,0,56,0,6
66956,2,2402,2421,-19,0,242,0,6
66957,1,2495,2477,18,0,109,0,6
66958,2,2432,2400,32,0,43,1,6
66959,1,2448,2341,107,0,120,1,6
66960,1,2520,2340,180,0,7,0,6
66961,2,2397,2426,-29,0,245,1,6
66963,2,2473,2439,34,0,50,0,6
66964,2,2428,2427,1,0,242,0,6
66965,2,2451,2478,-27,0,458,0,6
66966,1,2674,2613,61,0,130,0,6
66967,1,2365,2438,-73,0,250,0,6
66968,1,2422,2370,52,0,113,0,6
66969,2,2239,2401,-162,0,306,0,6
66970,2,2451,2620,-169,0,150,0,6
66971,2,2452,2284,168,0,45,1,6
66972,1,2413,2279,134,0,201,0,6
66973,1,2422,2309,113,0,112,0,6
66974,1,2485,2546,-61,0,107,0,6
66975,2,2416,2472,-56,0,20,0,6
66976,1,2432,2506,-74,0,46,1,6
66977,2,2418,2523,-105,0,45,0,6
66978,2,2308,2417,-109,0,453,0,6
66979,2,2434,2377,57,0,352,0,6
66980,3,2414,2320,94,0,427,0,6
66981,2,2623,2448,175,0,128,0,6
66982,1,2491,2425,66,0,4,0,6
66983,2,2305,2426,-121,0,454,0,6
66984,1,2445,2467,-22,0,195,0,6
66985,1,2418,2297,121,0,85,1,8
66986,3,2411,2277,134,0,299,0,8
66987,1,2472,2419,53,0,4,0,6
66988,2,2319,2477,-158,0,101,0,6
66989,2,2532,2412,120,0,0,1,6
66990,2,2447,2310,137,0,302,1,6
66991,1,2311,2440,-129,0,49,0,6
66992,1,2529,2502,27,0,340,0,6
66993,1,2406,2232,174,0,218,0,6
66994,2,2477,2460,17,0,7,0,6
66995,1,2426,2331,95,0,399,1,6
66996,1,2388,2431,-43,0,253,0,6
66997,2,2276,2446,-170,0,104,0,6
66998,2,2277,2442,-165,0,121,1,6
66999,1,2471,2373,98,0,44,1,6
67000,1,2403,2290,113,0,0,1,6
67001,3,2501,2441,60,0,226,0,8
67003,1,2539,2491,48,0,0,0,6
67004,3,2407,2240,167,0,4,0,6
67005,2,2608,2692,-84,0,111,0,6
67006,3,2536,2574,-38,0,344,0,6
67007,1,2275,2417,-142,0,11,0,6
67008,1,2244,2403,-159,0,304,1,6
67009,1,2614,2365,249,0,211,0,6
67010,2,2304,2432,-128,0,0,0,6
67011,2,2497,2534,-37,0,205,0,6
67012,2,2319,2458,-139,0,343,0,6
67013,1,2496,2486,10,0,15,1,6
67014,1,2465,2484,-19,0,152,0,6
67015,2,2420,2278,142,0,2,0,6
67016,1,2476,2466,10,0,302,0,6
67017,2,2452,2419,33,0,110,0,6
67018,1,2461,2451,10,0,74,0,6
67019,2,2591,2615,-24,0,45,1,6
67020,2,2432,2372,60,0,304,1,6
67021,1,2437,2337,100,0,125,1,6
67022,2,2471,2316,155,0,320,0,6
67023,1,2508,2551,-43,0,46,0,6
67024,2,2436,2415,21,0,46,0,6
67025,1,2449,2300,149,0,429,0,6
67026,2,2427,2372,55,0,15,0,6
67027,3,2435,2529,-94,0,115,0,6
67028,1,2421,2257,164,0,464,0,6
67029,3,2321,2412,-91,0,341,0,6
67030,1,2404,2301,103,0,111,0,6
67031,2,2425,2417,8,0,134,0,6
67032,1,2540,2492,48,0,302,1,6
67033,2,2279,2409,-130,0,295,0,8
67034,1,2416,2478,-62,0,390,1,6
67035,2,2500,2362,138,0,190,0,6
67036,1,2272,2407,-135,0,170,1,6
67037,2,2379,2420,-41,0,250,0,6
67038,2,2285,2421,-136,0,247,0,8
67039,2,2454,2485,-31,0,303,0,6
67040,3,2445,2494,-49,0,45,0,6
67041,1,2445,2439,6,0,4,0,6
67042,2,2478,2567,-89,0,398,0,6
67043,1,2445,2294,151,0,45,0,6
67044,2,2446,2467,-21,0,118,0,6
67045,1,2462,2316,146,0,15,0,6
67046,2,2430,2366,64,0,370,0,6
67047,2,2311,2430,-119,0,483,0,6
67048,1,2326,2404,-78,0,233,0,6
67049,2,2620,2654,-34,0,418,0,6
67050,1,2480,2450,30,0,55,1,6
67051,1,2461,2467,-6,0,394,1,6
67052,2,2381,2482,-101,0,4,1,6
67053,2,2425,2616,-191,0,151,0,6
67054,1,2295,2472,-177,0,20,0,6
67055,2,2447,2446,1,0,246,0,6
67056,1,2469,2438,31,0,157,0,6
67057,1,2462,2434,28,0,16,0,6
67058,1,2544,2527,17,0,0,0,6
67059,3,2571,2604,-33,0,130,0,6
67060,1,2419,2297,122,0,278,0,6
67061,2,2522,2549,-27,0,107,0,6
67062,1,2487,2545,-58,0,205,1,6
67063,1,2370,2446,-76,0,469,0,6
67064,1,2522,2474,48,0,484,0,6
67065,1,2449,2381,68,0,45,0,6
67066,1,2428,2466,-38,0,65,0,6
67067,1,2619,2423,196,0,112,0,6
67068,2,2534,2573,-39,0,343,0,6
67069,1,2492,2473,19,0,101,1,6
67070,1,2425,2295,130,0,46,0,6
67071,1,2323,2423,-100,0,10,0,6
67072,1,2615,2603,12,0,344,0,6
67073,2,2331,2411,-80,0,45,0,6
67074,2,2451,2500,-49,0,106,0,6
67075,1,2434,2424,10,0,246,0,6
67076,1,2293,2421,-128,0,455,0,6
67077,1,2472,2373,99,0,383,1,6
67078,1,2445,2318,127,0,45,0,6
67079,2,2279,2404,-125,0,106,0,6
67080,3,2461,2331,130,0,226,0,6
67081,1,2555,2516,39,0,0,0,6
67082,3,2358,2451,-93,0,41,0,8
67083,1,2425,2374,51,0,112,0,6
67084,1,2445,2485,-40,0,46,1,6
67085,2,2422,2419,3,0,209,0,6
67086,2,2476,2446,30,0,199,1,6
67087,2,2400,2377,23,0,414,1,6
67088,2,2418,2319,99,0,400,0,6
67089,1,2429,2300,129,0,302,1,6
67090,1,2456,2424,32,0,311,0,6
67091,1,2415,2449,-34,0,147,0,6
67092,2,2420,2416,4,0,203,0,6
67093,1,2572,2536,36,0,115,0,6
67094,3,2469,2354,115,0,335,0,6
67095,1,2211,2454,-243,0,133,0,6
67096,2,2459,2383,76,0,15,1,6
67097,2,2514,2581,-67,0,46,0,6
67098,1,2439,2377,62,0,121,1,6
67099,2,2597,2621,-24,0,5,0,6
67100,3,2603,2683,-80,0,200,0,6
67101,1,2452,2441,11,0,200,0,6
67102,2,2323,2434,-111,0,311,0,6
67103,3,2369,2430,-61,0,250,0,6
67104,2,2511,2560,-49,0,107,0,6
67105,2,2469,2461,8,0,334,1,6
67106,1,2415,2337,78,0,120,0,8
67107,2,2333,2449,-116,0,106,1,6
67108,3,2439,2461,-22,0,126,0,6
67109,1,2369,2476,-107,0,4,0,6
67110,1,2453,2414,39,0,302,0,6
67111,2,2301,2416,-115,0,45,0,6
67112,2,2527,2527,0,0,45,0,6
67113,1,2371,2429,-58,0,261,0,6
67114,1,2403,2220,183,0,140,0,6
67115,1,2411,2310,101,0,453,0,6
67116,3,2521,2537,-16,0,43,0,6
67117,1,2307,2479,-172,0,343,1,6
67118,1,2531,2577,-46,0,331,0,6
67119,1,2565,2507,58,0,0,0,6
67120,2,2305,2422,-117,0,288,1,6
67121,2,2456,2586,-130,0,130,1,6
67122,2,2443,2395,48,0,80,0,6
67123,2,2568,2452,116,0,150,1,6
67124,1,2404,2343,61,0,32,0,6
67125,2,2434,2452,-18,0,150,0,6
67126,2,2505,2510,-5,0,201,1,6
67127,2,2571,2538,33,0,115,0,6
67128,2,2502,2570,-68,0,241,0,6
67129,1,2592,2469,123,0,4,0,6
67130,1,2586,2475,111,0,461,1,8
67131,1,2376,2439,-63,0,4,0,6
67132,2,2578,2626,-48,0,9,0,6
67133,3,2299,2449,-150,0,41,0,8
67134,1,2675,2470,205,0,454,0,6
67135,3,2485,2342,143,0,40,0,6
67136,1,2351,2444,-93,0,107,0,6
67137,2,2433,2453,-20,0,40,1,6
67138,1,2458,2378,80,0,392,0,6
67139,1,2409,2404,5,0,247,0,6
67140,2,2461,2467,-6,0,332,0,6
67141,3,2502,2440,62,0,43,0,6
67142,1,2379,2442,-63,0,312,0,8
67143,1,2420,2293,127,0,245,0,6
67144,2,2536,2522,14,0,140,0,6
67145,2,2293,2476,-183,0,247,1,6
67146,1,2306,2415,-109,0,11,1,6
67147,1,2422,2378,44,0,48,0,6
67148,1,2344,2404,-60,0,41,0,6
67149,1,2380,2430,-50,0,241,0,6
67150,2,2458,2491,-33,0,15,0,6
67151,2,2492,2497,-5,0,9,0,6
67152,1,2604,2628,-24,0,150,1,6
67153,2,2535,2467,68,0,101,0,6
67154,1,2436,2323,113,0,5,0,6
67155,2,2590,2453,137,0,123,0,6
67156,1,2462,2289,173,0,405,0,6
67157,1,2429,2370,59,0,112,0,6
67158,1,2458,2405,53,0,15,0,6
67159,1,2533,2426,107,0,85,0,6
67160,2,2347,2409,-62,0,106,0,6
67161,2,2442,2403,39,0,404,1,6
67162,2,2295,2402,-107,0,245,0,6
67163,2,2458,2387,71,0,120,0,6
67164,1,2574,2521,53,0,0,0,6
67165,2,2383,2560,-177,0,7,0,6
67166,2,2319,2499,-180,0,106,1,6
67167,1,2291,2440,-149,0,0,0,6
67168,1,2402,2276,126,0,49,1,6
67169,2,2471,2504,-33,0,7,0,6
67170,1,2460,2596,-136,0,373,0,6
67171,2,2515,2723,-208,0,373,1,6
67172,1,2631,2544,87,0,405,0,6
67173,2,2356,2483,-127,0,106,1,6
67174,1,2467,2690,-223,0,4,0,6
67175,2,2518,2374,144,0,106,0,6
67176,1,2237,2413,-176,0,57,0,6
67177,1,2496,2495,1,0,112,1,6
67178,1,2735,2547,188,0,40,0,6
67179,2,2465,2441,24,0,310,0,6
67181,1,2376,2502,-126,0,40,0,6
67182,1,2441,2415,26,0,303,0,6
67183,1,2409,2295,114,0,0,0,6
67184,2,2527,2387,140,0,4,0,6
67185,1,2447,2363,84,0,104,1,8
67186,2,2476,2327,149,0,106,0,6
67187,1,2540,2636,-96,0,426,0,6
67188,3,2533,2552,-19,0,311,0,6
67189,2,2333,2408,-75,0,268,0,6
67190,1,2433,2300,133,0,100,1,6
67191,1,2588,2519,69,0,4,0,6
67192,1,2644,2476,168,0,454,0,6
67193,1,2461,2321,140,0,255,0,6
67194,1,2413,2434,-21,0,347,0,6
67195,1,2422,2316,106,0,107,0,6
67196,3,2429,2471,-42,0,132,0,8
67197,2,2382,2510,-128,0,41,0,6
67198,2,2463,2487,-24,0,15,1,6
67199,1,2590,2281,309,0,106,0,8
67200,2,2497,2453,44,0,307,1,6
67201,2,2528,2461,67,0,128,1,6
67202,2,2537,2400,137,0,484,1,6
67203,1,2517,2579,-62,0,46,0,6
67204,2,2494,2290,204,0,6,0,6
67205,1,2409,2338,71,0,32,0,6
67206,2,2607,2563,44,0,110,0,6
67207,2,2413,2227,186,0,0,0,6
67208,1,2410,2380,30,0,300,0,6
67209,2,2405,2380,25,0,123,0,6
67210,3,2621,2410,211,0,254,0,6
67211,1,2479,2323,156,0,190,0,6
67212,3,2415,2350,65,0,41,0,6
67213,1,2534,2375,159,0,4,1,6
67214,3,2508,2513,-5,0,315,0,6
67215,2,2447,2459,-12,0,195,0,6
67216,1,2412,2293,119,0,226,0,6
67217,3,2542,2738,-196,0,7,0,6
67218,2,2473,2660,-187,0,200,0,6
67219,2,2611,2593,18,0,110,0,6
67220,1,2514,2272,242,0,4,0,6
67221,2,2573,2523,50,0,0,0,6
67222,2,2419,2293,126,0,45,0,6
67223,2,2382,2400,-18,0,0,1,6
67224,2,2509,2451,58,0,10,0,6
67225,2,2426,2502,-76,0,210,0,6
67226,1,2628,2547,81,0,115,1,6
67227,1,2318,2464,-146,0,211,0,6
67228,1,2419,2259,160,4,474,1,13
67229,1,2427,2487,-60,0,305,1,6
67230,1,2471,2246,225,2,16,0,18
67231,1,2413,2513,-100,0,246,1,6
67232,2,2397,2592,-195,0,406,0,8
67233,1,2401,2378,23,0,25,0,6
67234,2,2352,2468,-116,0,213,1,6
67235,2,2499,2378,121,0,395,1,6
67236,1,2296,2436,-140,0,0,0,6
67237,2,2514,2592,-78,0,0,0,6
67238,1,2412,2315,97,0,62,0,6
67239,1,2530,2566,-36,0,46,0,6
67240,1,2299,2427,-128,0,45,0,6
67241,1,2429,2293,136,0,331,1,6
67242,2,2320,2458,-138,0,487,0,6
67243,2,2492,2416,76,0,148,1,6
67244,2,2408,2449,-41,0,135,0,6
67245,2,2560,2536,24,0,313,0,6
67246,3,2468,2529,-61,0,2,0,6
67247,2,2353,2462,-109,0,106,1,6
67248,1,2624,2605,19,0,335,0,6
67249,2,2513,2600,-87,0,410,0,6
67250,2,2289,2416,-127,0,52,0,6
67251,1,2392,2570,-178,0,7,1,6
67252,1,2736,2547,189,0,40,0,6
67253,1,2340,2410,-70,0,112,0,6
67254,3,2372,2537,-165,0,13,0,6
67255,2,2470,2408,62,0,200,0,6
67256,1,2315,2516,-201,0,194,0,6
67257,1,2618,2599,19,0,110,1,6
67258,2,2300,2458,-158,0,112,0,6
67259,1,2457,2326,131,0,250,0,6
67260,2,2465,2512,-47,0,80,0,6
67261,2,2351,2421,-70,0,4,0,6
67262,1,2423,2419,4,0,123,1,6
67263,3,2422,2428,-6,0,331,0,6
67264,2,2543,2633,-90,0,0,0,6
67265,2,2406,2386,20,0,345,0,6
67266,1,2466,2338,128,0,336,0,6
67267,1,2401,2482,-81,0,45,0,6
67268,1,2461,2316,145,0,153,0,6
67269,1,2502,2414,88,0,16,0,6
67270,2,2218,2421,-203,0,252,0,6
67271,1,2322,2460,-138,0,211,0,6
67272,2,2542,2597,-55,0,7,0,6
67273,1,2506,2420,86,0,245,0,6
67274,1,2304,2428,-124,0,44,0,6
67275,2,2400,2406,-6,0,470,1,6
67276,1,2534,2374,160,0,30,0,6
67277,1,2433,2399,34,0,142,0,6
67278,2,2492,2334,158,0,306,0,6
67279,3,2386,2454,-68,0,45,0,6
67280,2,2420,2298,122,0,302,0,6
67281,2,2241,2415,-174,0,101,0,6
67282,2,2336,2400,-64,0,153,0,8
67283,2,2459,2417,42,0,310,0,6
67284,2,2420,2463,-43,0,30,0,6
67285,1,2543,2554,-11,0,46,0,6
67286,2,2637,2573,64,0,111,0,6
67287,2,2419,2310,109,0,110,0,6
67288,2,2485,2416,69,0,4,0,6
67289,2,2507,2323,184,0,4,0,6
67290,1,2472,2400,72,0,291,0,6
67291,2,2363,2442,-79,0,35,0,6
67292,2,2528,2469,59,0,107,0,6
67293,1,2376,2472,-96,0,152,0,6
67294,1,2461,2465,-4,0,121,1,6
67295,1,2426,2343,83,0,267,0,6
67296,1,2593,2424,169,0,4,0,6
67297,2,2468,2412,56,0,200,0,6
67298,3,2443,2334,109,0,337,0,6
67299,3,2392,2400,-8,0,120,0,6
67300,3,2461,2281,180,0,110,0,6
67301,3,2452,2330,122,0,250,0,6
67302,2,2349,2484,-135,0,136,0,6
67303,2,2414,2429,-15,0,106,0,6
67304,1,2673,2508,165,0,335,1,6
67305,1,2453,2416,37,0,303,1,6
67306,1,2424,2296,128,0,311,0,6
67307,1,2596,2460,136,0,4,0,6
67308,2,2421,2312,109,0,215,0,6
67309,2,2397,2412,-15,0,268,0,6
67310,1,2421,2446,-25,0,106,1,6
67311,2,2331,2595,-264,0,143,0,8
67312,2,2489,2596,-107,0,200,0,6
67314,2,2423,2436,-13,0,15,0,6
67315,2,2506,2534,-28,0,240,1,6
67316,1,2434,2408,26,0,123,0,6
67317,2,2412,2408,4,0,113,1,6
67318,2,2462,2605,-143,0,140,0,6
67319,2,2470,2394,76,0,469,0,6
67320,1,2548,2549,-1,0,313,0,6
67321,2,2580,2630,-50,0,13,1,6
67322,1,2333,2477,-144,0,404,1,6
67323,2,2423,2452,-29,0,41,0,6
67324,1,2462,2438,24,0,300,0,6
67325,2,2528,2418,110,0,300,0,6
67326,2,2332,2451,-119,0,211,0,6
67327,1,2485,2384,101,0,181,0,6
67328,2,2395,2499,-104,0,80,0,6
67329,2,2430,2219,211,0,218,1,6
67330,2,2332,2477,-145,0,107,0,6
67331,1,2425,2272,153,0,316,0,6
67332,2,2487,2521,-34,0,395,0,6
67333,2,2403,2440,-37,0,138,0,6
67334,2,2416,2507,-91,0,45,0,6
67335,1,2340,2421,-81,0,110,0,8
67336,1,2418,2463,-45,0,45,0,6
67337,1,2459,2345,114,0,16,0,6
67338,3,2319,2418,-99,0,1,0,6
67339,2,2458,2467,-9,0,140,0,6
67340,2,2608,2599,9,0,132,0,6
67341,1,2284,2458,-174,0,6,0,6
67342,1,2411,2412,-1,0,246,0,6
67343,2,2303,2453,-150,0,469,0,6
67344,2,2342,2434,-92,0,110,1,6
67345,2,2475,2688,-213,0,200,1,6
67346,1,2400,2351,49,0,218,0,6
67347,1,2455,2600,-145,0,305,0,6
67348,2,2312,2454,-142,0,80,0,6
67349,1,2519,2411,108,0,106,0,6
67350,1,2465,2383,82,0,145,0,6
67351,1,2440,2405,35,0,125,0,6
67352,1,2456,2425,31,0,55,1,6
67353,2,2433,2302,131,0,40,0,6
67354,1,2543,2554,-11,0,300,0,6
67355,2,2406,2416,-10,0,250,0,6
67356,2,2467,2510,-43,0,436,0,6
67357,2,2380,2489,-109,0,487,0,6
67358,1,2501,2407,94,0,115,0,6
67359,1,2500,2512,-12,0,100,0,6
67360,2,2401,2467,-66,0,57,0,6
67361,2,2319,2463,-144,0,9,0,6
67362,2,2411,2418,-7,0,300,1,6
67363,2,2391,2458,-67,0,107,1,6
67364,1,2414,2406,8,0,45,0,6
67365,1,2450,2434,16,0,220,0,6
67366,2,2483,2403,80,0,54,1,6
67367,1,2401,2296,105,4,46,0,8
67368,1,2505,2503,2,0,4,0,6
67369,2,2401,2245,156,0,172,0,6
67370,1,2419,2635,-216,0,45,0,6
67371,2,2445,2398,47,0,80,0,6
67372,2,2420,2382,38,0,31,1,6
67373,1,2341,2408,-67,0,43,0,6
67374,2,2284,2416,-132,0,374,0,6
67375,3,2549,2552,-3,0,45,0,6
67376,2,2423,2321,102,0,40,0,6
67377,2,2241,2401,-160,0,122,0,6
67378,1,2422,2316,106,4,365,0,13
67379,2,2592,2506,86,0,7,1,6
67380,1,2457,2486,-29,0,241,0,6
67381,1,2377,2442,-65,0,211,0,6
67382,2,2506,2328,178,0,0,0,6
67383,2,2284,2422,-138,0,85,0,6
67384,2,2379,2597,-218,0,46,0,8
67385,1,2482,2428,54,0,306,0,6
67386,1,2527,2453,74,0,41,0,6
67387,3,2418,2505,-87,0,10,0,6
67388,2,2605,2627,-22,0,150,0,6
67389,1,2269,2425,-156,0,4,0,6
67390,1,2699,2473,226,0,320,0,6
67392,2,2495,2463,32,0,338,0,6
67393,1,2423,2441,-18,0,36,0,6
67394,1,2467,2386,81,0,30,0,6
67395,3,2401,2348,53,0,130,0,6
67396,2,2497,2472,25,0,6,0,6
67397,1,2425,2521,-96,0,4,0,6
67398,2,2400,2386,14,0,131,0,6
67399,1,2473,2383,90,0,354,0,6
67400,1,2405,2352,53,0,216,0,6
67401,1,2508,2511,-3,0,113,1,6
67402,2,2420,2296,124,0,14,0,6
67403,2,2359,2420,-61,0,123,0,6
67404,2,2479,2463,16,0,487,0,6
67405,1,2422,2461,-39,0,190,0,6
67406,2,2404,2438,-34,0,2,0,6
67407,1,2632,2480,152,0,108,0,6
67408,3,2265,2414,-149,0,318,0,8
67409,3,2371,2424,-53,0,311,0,6
67410,2,2313,2585,-272,0,50,0,6
67411,2,2516,2455,61,0,10,1,6
67412,1,2328,2497,-169,0,10,0,6
67413,1,2427,2352,75,0,40,0,6
67414,3,2424,2410,14,0,45,0,6
67415,2,2458,2386,72,0,130,0,6
67416,1,2455,2429,26,0,331,1,6
67417,2,2419,2328,91,0,111,0,8
67418,2,2431,2210,221,0,40,1,6
67419,2,2406,2487,-81,0,300,1,6
67420,1,2587,2311,276,0,150,0,6
67421,1,2388,2414,-26,0,102,0,6
67423,1,2419,2259,160,0,400,0,6
67424,2,2489,2423,66,0,306,0,6
67425,1,2591,2410,181,0,311,0,6
67426,3,2513,2504,9,0,481,0,6
67427,1,2585,2419,166,0,30,1,6
67428,2,2448,2478,-30,0,153,0,6
67429,1,2491,2344,147,0,302,0,6
67430,1,2497,2335,162,0,300,1,6
67431,1,2429,2463,-34,0,9,0,6
67432,2,2292,2462,-170,0,4,0,6
67433,1,2378,2427,-49,0,90,0,6
67434,1,2406,2221,185,0,8,0,6
67435,2,2428,2489,-61,0,4,0,6
67436,2,2400,2337,63,0,100,1,6
67437,2,2435,2417,18,0,90,0,6
67438,2,2470,2709,-239,0,200,0,6
67439,1,2370,2518,-148,0,426,0,6
67440,2,2433,2433,0,0,218,0,6
67441,1,2532,2469,63,0,112,0,6
67442,2,2379,2477,-98,0,31,0,6
67443,1,2414,2382,32,0,326,0,6
67444,2,2378,2491,-113,0,487,0,6
67445,2,2421,2471,-50,0,150,0,6
67446,2,2396,2454,-58,0,201,1,6
67447,2,2425,2291,134,0,300,0,6
67448,2,2429,2254,175,0,4,0,6
67449,3,2423,2250,173,0,134,0,6
67450,1,2636,2538,98,0,112,0,6
67451,2,2430,2495,-65,0,80,0,6
67452,1,2394,2466,-72,0,150,0,6
67453,3,2497,2537,-40,0,246,0,6
67454,1,2407,2395,12,0,277,0,6
67455,1,2413,2508,-95,0,4,0,6
67456,2,2413,2482,-69,0,9,0,6
67458,2,2278,2433,-155,0,101,0,6
67459,1,2235,2500,-265,0,123,0,6
67460,3,2475,2426,49,0,102,0,6
67461,1,2423,2445,-22,0,43,0,6
67462,2,2363,2422,-59,0,200,0,6
67463,2,2267,2442,-175,0,45,0,6
67464,1,2487,2408,79,0,476,0,6
67465,2,2465,2536,-71,0,46,0,6
67466,2,2423,2588,-165,0,112,0,6
67467,1,2718,2468,250,0,320,1,6
67469,2,2407,2594,-187,0,1,1,6
67470,2,2553,2505,48,0,110,0,6
67471,2,2416,2314,102,0,40,0,6
67472,1,2513,2433,80,0,13,0,6
67473,1,2460,2294,166,0,97,1,6
67474,1,2494,2401,93,0,0,0,6
67475,2,2412,2402,10,0,113,0,6
67476,3,2335,2405,-70,0,102,0,6
67477,2,2356,2483,-127,0,300,0,6
67478,1,2549,2552,-3,0,45,0,6
67479,1,2283,2419,-136,0,38,0,6
67480,2,2456,2443,13,0,130,0,6
67481,1,2351,2580,-229,0,100,0,6
67482,1,2402,2442,-40,4,480,0,13
67483,2,2491,2388,103,0,337,0,6
67484,2,2428,2246,182,0,46,1,6
67485,1,2417,2347,70,0,300,0,6
67486,2,2328,2462,-134,0,331,0,6
67487,1,2487,2377,110,0,291,0,6
67488,1,2513,2500,13,0,474,0,6
67489,3,2404,2491,-87,0,389,0,6
67490,2,2375,2421,-46,0,31,0,6
67491,2,2683,2481,202,0,130,0,6
67492,1,2476,2416,60,0,13,0,6
67493,2,2384,2509,-125,0,211,0,6
67494,1,2534,2640,-106,0,432,0,6
67495,2,2316,2421,-105,0,101,0,6
67496,2,2422,2373,49,0,288,0,6
67497,1,2436,2300,136,0,128,0,6
67498,2,2366,2439,-73,0,405,0,6
67499,1,2296,2415,-119,4,113,0,13
67500,1,2459,2401,58,0,7,0,6
67501,2,2274,2412,-138,0,112,0,8
67502,2,2336,2412,-76,0,302,0,8
67503,3,2442,2453,-11,0,36,0,6
67504,2,2546,2555,-9,0,201,0,6
67505,1,2421,2391,30,0,134,1,6
67506,2,2413,2359,54,0,118,1,6
67507,2,2378,2513,-135,0,46,0,6
67508,2,2440,2318,122,0,101,0,6
67509,2,2536,2498,38,0,40,1,6
67510,2,2541,2460,81,0,7,0,6
67511,2,2425,2478,-53,0,46,1,6
67512,1,2491,2439,52,0,226,0,6
67513,3,2465,2394,71,0,103,0,6
67514,2,2490,2484,6,0,6,0,6
67515,2,2456,2435,21,0,440,0,6
67516,1,2459,2406,53,0,485,0,6
67517,1,2408,2318,90,0,27,0,6
67518,2,2366,2475,-109,0,330,0,6
67519,1,2343,2408,-65,0,438,1,6
67520,3,2426,2422,4,0,460,0,6
67521,1,2426,2469,-43,0,300,0,6
67522,2,2581,2537,44,0,10,0,6
67523,2,2466,2726,-260,0,200,1,6
67524,2,2439,2420,19,0,6,0,6
67525,1,2397,2498,-101,0,40,1,6
67526,2,2547,2592,-45,0,110,0,6
67527,2,2419,2495,-76,0,4,0,6
67528,1,2597,2427,170,4,115,0,13
67529,1,2597,2518,79,0,315,0,6
67530,2,2404,2490,-86,0,302,0,6
67531,2,2512,2589,-77,0,302,1,6
67532,1,2440,2451,-11,0,8,1,6
67533,1,2405,2325,80,0,15,0,6
67534,2,2449,2503,-54,0,241,1,6
67535,2,2284,2412,-128,0,123,0,6
67536,2,2411,2481,-70,0,154,0,6
67537,2,2434,2496,-62,0,123,0,6
67538,2,2467,2484,-17,0,80,1,6
67539,1,2353,2464,-111,0,190,0,6
67540,1,2417,2320,97,0,121,0,8
67541,1,2389,2490,-101,0,134,0,6
67542,1,2361,2410,-49,0,106,1,6
67543,3,2544,2575,-31,0,40,0,6
67544,1,2632,2542,90,0,45,0,6
67545,1,2409,2269,140,0,106,0,6
67546,3,2647,2450,197,0,80,0,6
67547,3,2560,2674,-114,0,45,0,6
67548,1,2425,2283,142,0,84,0,8
67549,1,2354,2490,-136,0,125,0,6
67550,2,2371,2542,-171,0,46,0,6
67551,3,2466,2325,141,0,120,0,6
67552,1,2467,2534,-67,0,46,0,6
67553,1,2426,2422,4,0,140,0,6
67554,1,2597,2433,164,0,7,1,6
67555,2,2416,2280,136,0,10,1,6
67556,1,2386,2407,-21,0,219,1,6
67557,2,2464,2460,4,0,484,0,6
67558,1,2401,2504,-103,0,40,0,6
67559,1,2590,2516,74,0,255,1,6
67560,2,2307,2410,-103,0,145,0,6
67561,2,2489,2561,-72,0,302,0,7
67562,1,2499,2529,-30,0,43,0,6
67563,1,2396,2464,-68,0,150,1,6
67564,1,2389,2420,-31,0,41,0,6
67565,1,2494,2483,11,0,411,1,6
67566,1,2538,2637,-99,0,380,0,6
67567,2,2428,2518,-90,0,247,1,6
67568,1,2410,2331,79,0,115,0,8
67569,2,2422,2392,30,0,301,0,6
67570,2,2428,2426,2,0,269,0,6
67571,1,2349,2420,-71,0,4,1,6
67572,1,2540,2450,90,0,112,0,6
67573,3,2402,2370,32,0,14,0,6
67574,3,2430,2401,29,0,123,0,6
67575,1,2426,2313,113,0,108,0,6
67576,1,2371,2401,-30,0,31,0,6
67577,2,2311,2405,-94,0,434,0,6
67578,1,2734,2464,270,0,320,0,6
67579,3,2481,2354,127,2,484,0,25
67580,1,2420,2545,-125,0,46,1,6
67581,1,2311,2446,-135,0,119,1,6
67582,1,2497,2408,89,0,108,0,6
67583,1,2490,2326,164,0,4,1,6
67584,1,2416,2328,88,0,45,1,6
67585,2,2482,2362,120,0,21,0,6
67586,1,2365,2485,-120,0,151,0,6
67587,2,2457,2390,67,0,414,0,6
67588,1,2412,2407,5,0,200,0,6
67589,2,2349,2430,-81,0,151,0,6
67590,1,2464,2274,190,0,15,0,6
67591,2,2414,2483,-69,0,0,0,6
67592,2,2423,2458,-35,0,102,0,6
67593,2,2383,2438,-55,0,312,0,6
67594,2,2461,2741,-280,0,202,1,6
67595,2,2574,2544,30,0,201,0,6
67596,2,2672,2562,110,0,216,1,6
67597,1,2319,2441,-122,0,253,0,6
67598,1,2453,2303,150,0,101,0,6
67599,1,2422,2450,-28,0,190,0,6
67600,2,2341,2435,-94,0,302,1,6
67601,2,2523,2506,17,0,265,0,6
67602,2,2401,2392,9,0,463,0,6
67603,2,2512,2435,77,0,11,1,6
67604,2,2442,2410,32,0,15,1,6
67605,1,2629,2545,84,0,45,0,6
67606,2,2288,2408,-120,0,245,0,6
67607,1,2430,2545,-115,0,45,0,6
67608,2,2350,2409,-59,0,132,1,6
67609,1,2432,2500,-68,0,210,0,6
67610,1,2432,2368,64,0,132,0,6
67611,1,2379,2412,-33,0,258,1,6
67612,1,2594,2510,84,0,106,0,6
67613,1,2413,2289,124,0,310,0,6
67614,2,2377,2414,-37,0,49,0,8
67615,1,2401,2429,-28,0,230,0,6
67616,2,2463,2418,45,0,325,1,6
67617,2,2474,2463,11,0,302,0,6
67618,1,2401,2390,11,0,101,0,6
67620,1,2537,2551,-14,0,201,0,6
67621,2,2487,2437,50,0,306,0,6
67622,2,2370,2475,-105,0,125,0,6
67623,2,2444,2449,-5,0,414,0,6
67624,1,2522,2424,98,0,10,0,6
67625,2,2425,2568,-143,0,40,0,6
67626,1,2444,2420,24,0,140,0,6
67627,1,2252,2462,-210,0,41,0,6
67628,1,2508,2421,87,0,4,0,6
67629,1,2327,2464,-137,0,103,0,6
67630,2,2404,2501,-97,0,43,1,6
67631,2,2391,2493,-102,0,152,0,6
67632,2,2512,2517,-5,0,57,0,6
67633,1,2433,2327,106,0,202,0,6
67634,3,2493,2429,64,0,317,0,6
67635,1,2403,2428,-25,0,245,0,6
67636,1,2648,2777,-129,0,71,0,6
67637,3,2423,2602,-179,4,41,0,13
67638,1,2747,2460,287,0,320,0,6
67639,2,2384,2407,-23,0,300,0,6
67640,1,2572,2439,133,0,13,1,6
67641,1,2425,2309,116,0,330,0,6
67642,2,2415,2287,128,0,45,0,6
67643,2,2469,2468,1,0,389,0,6
67644,1,2437,2267,170,0,264,0,6
67645,3,2492,2450,42,0,306,0,6
67646,1,2570,2665,-95,0,429,0,6
67647,2,2350,2417,-67,0,60,1,6
67648,1,2510,2436,74,0,302,1,6
67649,1,2409,2457,-48,0,202,0,6
67650,2,2402,2215,187,4,278,0,13
67651,1,2541,2634,-93,0,315,0,6
67652,2,2478,2325,153,0,15,1,6
67653,2,2389,2404,-15,0,463,0,6
67654,2,2444,2543,-99,0,228,0,6
67655,1,2416,2309,107,0,249,0,6
67656,3,2395,2513,-118,0,484,0,6
67657,2,2275,2429,-154,0,340,0,8
67658,1,2497,2414,83,0,4,0,6
67659,2,2429,2378,51,0,405,1,6
67660,1,2505,2438,67,0,20,0,6
67661,1,2412,2379,33,0,101,0,6
67662,2,2481,2555,-74,0,332,0,6
67663,2,2506,2400,106,0,108,0,6
67664,2,2368,2407,-39,0,301,0,6
67665,3,2323,2457,-134,0,122,0,6
67666,1,2404,2373,31,0,40,1,6
67667,2,2365,2408,-43,0,289,0,6
67668,1,2349,2420,-71,0,490,1,6
67669,2,2440,2395,45,0,149,1,6
67670,1,2770,2655,115,0,345,1,6
67671,1,2570,2627,-57,0,190,0,6
67672,3,2523,2507,16,0,352,0,6
67673,1,2406,2336,70,0,190,0,6
67674,2,2458,2753,-295,0,46,1,6
67675,2,2352,2424,-72,0,0,1,6
67676,1,2467,2316,151,0,4,0,6
67677,2,2409,2468,-59,4,143,0,13
67678,3,2547,2491,56,0,112,0,6
67679,1,2424,2282,142,4,50,0,13
67680,2,2451,2435,16,0,254,0,6
67681,1,2285,2413,-128,0,101,0,6
67682,1,2441,2278,163,0,111,0,6
67683,2,2479,2575,-96,0,40,1,6
67684,1,2413,2365,48,0,74,0,6
67685,1,2658,2577,81,0,216,0,6
67686,2,2422,2409,13,0,6,0,6
67687,1,2478,2470,8,0,70,0,6
67688,2,2282,2432,-150,0,341,1,8
67689,2,2341,2403,-62,0,9,1,6
67690,1,2433,2557,-124,0,10,0,6
67691,2,2474,2515,-41,0,41,0,6
67692,2,2450,2415,35,0,131,0,6
67693,1,2409,2384,25,0,67,0,6
67694,1,2453,2376,77,0,7,0,6
67695,2,2421,2576,-155,0,100,0,6
67696,2,2324,2471,-147,0,473,0,6
67697,2,2313,2430,-117,0,117,1,6
67698,3,2374,2417,-43,0,300,0,6
67699,1,2444,2476,-32,0,300,0,6
67700,1,2498,2359,139,0,110,0,6
67701,1,2409,2408,1,0,45,1,6
67702,1,2575,2523,52,0,15,0,6
67703,2,2387,2508,-121,0,143,1,6
67704,2,2456,2450,6,0,110,0,6
67705,1,2405,2269,136,0,5,0,6
67706,2,2620,2577,43,0,344,0,6
67707,2,2652,2774,-122,0,485,0,6
67708,1,2416,2486,-70,0,123,0,6
67709,2,2402,2365,37,0,101,1,6
67710,2,2494,2446,48,0,130,0,6
67711,2,2486,2373,113,0,113,0,6
67712,2,2501,2331,170,0,152,0,6
67713,2,2272,2460,-188,0,30,0,6
67714,1,2433,2510,-77,0,9,0,6
67715,2,2422,2341,81,0,128,0,6
67716,1,2480,2428,52,0,40,0,6
67717,3,2569,2472,97,0,248,0,6
67718,3,2450,2386,64,0,302,0,6
67719,1,2462,2471,-9,0,35,0,6
67720,3,2550,2444,106,0,218,0,6
67721,1,2356,2418,-62,0,54,0,6
67722,1,2573,2662,-89,0,474,0,6
67723,2,2464,2469,-5,0,111,1,6
67724,1,2759,2456,303,0,320,1,6
67725,1,2492,2484,8,0,300,0,6
67726,3,2511,2599,-88,0,4,0,6
67727,2,2421,2520,-99,0,41,0,6
67728,3,2384,2479,-95,0,120,0,6
67729,1,2428,2347,81,0,40,0,6
67730,1,2492,2547,-55,0,49,0,6
67731,1,2405,2395,10,0,304,1,6
67732,2,2337,2470,-133,0,131,0,6
67734,1,2445,2441,4,0,109,0,6
67735,3,2474,2450,24,0,302,0,6
67736,1,2580,2535,45,0,463,0,6
67737,2,2441,2485,-44,0,133,0,6
67738,1,2478,2469,9,0,0,0,6
67739,2,2333,2419,-86,0,5,0,8
67740,2,2423,2534,-111,0,40,0,6
67741,2,2455,2290,165,0,4,0,6
67742,1,2479,2326,153,0,146,0,6
67743,1,2777,2648,129,0,21,1,6
67744,1,2372,2457,-85,0,463,0,6
67745,1,2583,2614,-31,0,426,0,6
67746,1,2417,2374,43,0,101,0,6
67747,1,2386,2444,-58,0,80,0,6
67748,2,2452,2487,-35,0,242,0,6
67749,1,2416,2442,-26,0,15,1,6
67750,1,2410,2369,41,0,112,0,6
67751,3,2499,2540,-41,0,49,0,6
67752,2,2247,2415,-168,0,87,1,6
67753,3,2492,2498,-6,0,304,0,6
67754,2,2473,2478,-5,0,7,1,6
67755,1,2287,2446,-159,0,133,0,6
67756,1,2402,2415,-13,0,415,1,6
67757,3,2396,2464,-68,0,46,0,6
67758,3,2443,2450,-7,0,40,0,6
67759,2,2561,2383,178,0,12,1,6
67760,1,2343,2433,-90,0,222,0,6
67761,1,2483,2249,234,0,301,0,6
67762,1,2302,2411,-109,0,1,0,6
67763,2,2447,2548,-101,0,10,0,6
67764,1,2415,2363,52,0,43,0,6
67765,2,2408,2390,18,0,394,0,6
67766,1,2622,2502,120,0,243,0,6
67767,2,2330,2565,-235,2,301,0,24
67769,2,2266,2420,-154,0,46,0,6
67770,3,2459,2585,-126,0,36,0,6
67771,2,2530,2559,-29,0,306,0,6
67772,2,2531,2368,163,0,106,0,6
67773,3,2508,2521,-13,0,404,0,6
67774,2,2401,2490,-89,0,45,0,6
67775,1,2524,2436,88,0,245,0,6
67776,1,2608,2524,84,0,106,0,6
67777,1,2422,2419,3,0,106,0,6
67778,2,2413,2379,34,0,211,0,6
67779,1,2411,2297,114,0,49,0,6
67780,1,2474,2446,28,0,40,0,6
67781,1,2494,2361,133,0,435,0,6
67782,3,2454,2492,-38,0,110,0,6
67783,3,2498,2396,102,0,300,0,6
67784,2,2437,2393,44,0,131,0,6
67785,1,2450,2451,-1,0,300,0,6
67786,2,2369,2422,-53,0,210,0,6
67787,1,2594,2474,120,0,45,0,6
67788,1,2518,2414,104,0,414,0,6
67789,3,2404,2418,-14,4,201,0,13
67790,1,2463,2469,-6,0,22,0,6
67791,3,2449,2458,-9,0,48,0,6
67792,2,2375,2503,-128,0,265,1,6
67793,2,2396,2402,-6,0,30,0,6
67794,1,2447,2436,11,0,190,1,6
67795,2,2439,2538,-99,0,4,0,6
67796,1,2349,2415,-66,0,113,0,6
67797,2,2434,2314,120,0,395,0,6
67798,2,2214,2567,-353,0,111,0,6
67799,1,2473,2395,78,4,0,0,13
67800,2,2403,2492,-89,0,45,0,6
67801,2,2440,2317,123,0,341,0,6
67802,1,2426,2392,34,0,400,1,6
67803,1,2384,2511,-127,0,123,1,6
67804,1,2601,2525,76,0,42,0,6
67806,1,2275,2414,-139,0,11,0,8
67807,2,2482,2350,132,0,101,0,6
67808,1,2305,2415,-110,0,302,0,6
67809,2,2420,2418,2,0,306,0,6
67810,3,2301,2456,-155,0,104,0,6
67811,2,2445,2539,-94,0,45,0,6
67812,1,2373,2435,-62,0,107,0,6
67813,1,2441,2542,-101,0,43,1,6
67814,1,2486,2353,133,0,45,0,6
67815,2,2409,2496,-87,0,300,0,6
67816,1,2463,2398,65,0,9,0,6
67817,2,2274,2422,-148,0,156,0,6
67818,1,2544,2432,112,0,250,0,6
67819,2,2431,2358,73,0,130,1,6
67820,1,2415,2367,48,0,130,0,6
67821,2,2404,2461,-57,0,70,0,6
67822,2,2520,2494,26,0,0,0,6
67823,2,2540,2513,27,0,21,0,6
67824,1,2569,2375,194,0,248,0,6
67825,2,2380,2427,-47,0,131,0,6
67826,1,2583,2546,37,0,16,0,6
67827,1,2424,2340,84,0,143,0,8
67828,1,2491,2390,101,0,46,0,6
67829,1,2468,2360,108,0,404,0,6
67830,1,2463,2223,240,0,257,0,6
67831,1,2280,2478,-198,4,122,0,13
67832,3,2470,2598,-128,0,107,0,6
67833,2,2351,2451,-100,0,373,0,6
67834,1,2489,2418,71,0,46,0,6
67835,1,2427,2365,62,0,101,1,6
67836,2,2287,2450,-163,0,200,0,6
67837,1,2428,2281,147,0,33,0,6
67838,1,2450,2443,7,0,220,0,6
67839,1,2410,2515,-105,0,302,0,6
67840,2,2407,2299,108,0,4,0,6
67841,2,2538,2400,138,0,201,0,6
67842,2,2458,2279,179,0,152,0,6
67843,2,2268,2426,-158,0,46,0,6
67844,1,2508,2500,8,0,302,1,6
67845,1,2386,2496,-110,0,460,0,6
67846,1,2430,2312,118,0,197,0,6
67847,2,2406,2244,162,0,50,0,8
67848,1,2318,2474,-156,0,45,0,6
67849,1,2454,2501,-47,0,345,0,6
67850,1,2503,2321,182,0,228,0,6
67851,1,2464,2305,159,0,336,0,6
67852,2,2500,2414,86,0,484,0,6
67853,2,2541,2588,-47,0,106,0,6
67854,1,2422,2431,-9,0,7,0,6
67855,1,2507,2371,136,0,35,0,6
67856,3,2461,2483,-22,0,327,0,6
67857,1,2405,2432,-27,0,40,1,6
67858,3,2393,2455,-62,0,45,0,6
67859,2,2387,2416,-29,0,200,1,6
67860,2,2488,2448,40,0,302,0,6
67861,1,2535,2548,-13,0,49,0,6
67862,2,2428,2560,-132,0,112,0,6
67863,3,2356,2409,-53,0,113,0,6
67864,1,2358,2466,-108,0,302,1,6
67865,1,2365,2424,-59,0,80,0,6
67866,2,2519,2534,-15,0,4,0,6
67867,1,2572,2314,258,0,128,0,6
67868,2,2372,2465,-93,0,301,1,6
67869,1,2306,2404,-98,4,80,0,13
67870,2,2215,2490,-275,0,302,1,6
67871,2,2414,2493,-79,0,250,0,6
67872,2,2494,2460,34,0,304,0,6
67873,1,2391,2432,-41,0,151,0,6
67874,2,2308,2482,-174,0,45,0,6
67875,3,2355,2493,-138,0,304,0,6
67876,2,2325,2425,-100,0,46,0,6
67877,1,2324,2450,-126,0,485,0,6
67878,3,2407,2487,-80,0,243,0,6
67879,2,2406,2287,119,0,122,0,6
67880,2,2241,2431,-190,0,7,0,6
67881,2,2485,2376,109,0,55,0,6
67882,1,2364,2467,-103,0,248,0,6
67883,2,2479,2472,7,0,343,0,6
67884,1,2457,2468,-11,0,490,0,6
67885,2,2367,2510,-143,0,305,0,6
67886,3,2423,2414,9,0,134,0,6
67887,2,2400,2302,98,0,100,0,6
67888,1,2432,2395,37,0,28,0,6
67889,3,2456,2323,133,0,120,0,6
67890,2,2453,2376,77,0,45,0,6
67891,1,2442,2259,183,0,300,1,6
67892,2,2424,2350,74,0,130,0,6
67893,2,2468,2323,145,0,4,0,6
67894,1,2507,2284,223,0,145,0,6
67895,2,2245,2417,-172,4,321,0,13
67896,2,2593,2536,57,0,52,0,6
67897,2,2318,2459,-141,0,380,0,6
67898,3,2501,2250,251,0,7,0,6
67899,1,2498,2498,0,0,226,0,6
67900,2,2567,2334,233,0,42,0,7
67901,2,2600,2549,51,0,13,0,6
67902,1,2422,2460,-38,0,243,0,6
67903,2,2432,2376,56,0,344,0,6
67904,1,2323,2438,-115,0,300,0,6
67905,2,2564,2542,22,0,380,0,6
67906,1,2424,2425,-1,0,247,1,6
67907,1,2409,2254,155,0,102,1,6
67908,2,2485,2441,44,0,432,0,6
67909,2,2400,2360,40,0,269,0,6
67910,1,2428,2490,-62,0,400,1,6
67911,1,2424,2349,75,0,487,0,6
67912,1,2467,2331,136,0,8,0,6
67913,1,2374,2511,-137,0,106,0,6
67914,2,2474,2574,-100,0,20,0,6
67915,2,2349,2438,-89,0,4,1,6
67916,1,2539,2513,26,0,4,0,6
67917,1,2487,2443,44,0,6,0,6
67918,1,2408,2411,-3,0,132,0,6
67919,2,2394,2478,-84,0,45,0,6
67920,1,2458,2365,93,0,10,0,6
67921,1,2482,2306,176,0,304,0,6
67922,1,2417,2372,45,0,128,0,6
67923,1,2425,2255,170,0,4,0,6
67924,3,2498,2483,15,0,246,0,6
67925,3,2589,2390,199,0,101,0,6
67926,1,2492,2358,134,0,301,0,6
67927,2,2479,2401,78,0,41,0,6
67928,2,2469,2509,-40,0,46,0,6
67929,2,2414,2473,-59,0,302,0,6
67930,1,2397,2463,-66,0,277,0,6
67931,2,2491,2386,105,0,380,0,6
67932,1,2453,2394,59,0,101,0,6
67933,1,2362,2462,-100,0,109,0,6
67934,3,2492,2438,54,0,46,0,6
67935,2,2521,2677,-156,0,70,1,6
67936,1,2458,2382,76,0,46,0,6
67937,1,2417,2270,147,0,100,0,6
67938,1,2331,2428,-97,0,200,1,6
67939,2,2543,2586,-43,0,40,1,6
67940,1,2414,2360,54,0,4,0,6
67941,2,2366,2403,-37,0,4,0,6
67942,2,2454,2472,-18,0,15,0,6
67943,1,2391,2446,-55,0,110,0,6
67944,2,2459,2430,29,0,34,0,6
67945,2,2439,2379,60,0,49,1,6
67946,2,2345,2498,-153,0,104,0,6
67947,1,2578,2296,282,0,131,0,6
67948,1,2450,2450,0,0,311,1,6
67950,2,2289,2403,-114,0,337,1,6
67951,2,2419,2338,81,0,400,1,6
67952,2,2558,2430,128,0,331,0,6
67953,2,2377,2463,-86,0,127,1,6
67954,2,2548,2727,-179,0,151,0,6
67955,1,2468,2215,253,0,5,1,6
67956,2,2404,2382,22,0,130,0,6
67957,2,2391,2435,-44,0,45,0,6
67958,1,2389,2458,-69,0,15,0,6
67959,3,2430,2513,-83,0,15,0,6
67960,1,2430,2321,109,0,305,0,6
67961,1,2452,2374,78,0,80,0,6
67962,2,2508,2544,-36,0,4,0,6
67963,2,2393,2485,-92,0,45,0,6
67964,1,2408,2406,2,0,409,1,6
67966,2,2367,2423,-56,0,89,0,6
67967,1,2337,2456,-119,0,140,1,6
67968,1,2540,2406,134,0,28,1,6
67969,2,2387,2407,-20,0,373,0,6
67970,2,2408,2472,-64,0,373,0,6
67971,1,2250,2413,-163,0,46,1,6
67972,1,2483,2498,-15,0,43,1,6
67973,2,2386,2496,-110,0,134,0,6
67974,3,2408,2381,27,0,45,0,6
67975,1,2563,2521,42,0,338,1,6
67976,2,2419,2309,110,0,4,0,6
67977,3,2394,2417,-23,0,310,0,6
67978,2,2439,2491,-52,0,205,1,6
67979,2,2550,2478,72,0,335,0,6
67980,1,2447,2286,161,0,145,1,6
67981,2,2591,2538,53,0,16,0,6
67982,1,2402,2355,47,0,101,0,6
67983,1,2545,2421,124,0,241,0,6
67984,1,2420,2409,11,0,4,0,6
67985,1,2469,2242,227,4,107,0,13
67986,1,2493,2449,44,0,110,0,6
67987,3,2404,2409,-5,0,152,0,6
67988,2,2328,2442,-114,0,45,0,6
67989,1,2412,2219,193,0,130,1,6
67990,2,2306,2429,-123,0,6,0,6
67991,2,2254,2471,-217,0,277,1,6
67992,2,2456,2445,11,0,125,1,6
67993,2,2388,2479,-91,0,127,0,6
67994,2,2355,2407,-52,0,331,0,6
67995,1,2467,2373,94,0,40,0,6
67996,1,2426,2337,89,4,302,0,13
67997,1,2580,2248,332,0,248,0,6
67998,1,2440,2458,-18,0,394,0,6
67999,1,2412,2398,14,0,43,0,6
68000,2,2389,2454,-65,0,45,0,6
68001,2,2423,2489,-66,0,110,1,6
68002,2,2527,2353,174,0,211,1,6
68003,2,2295,2428,-133,0,1,1,6
68004,1,2592,2326,266,2,101,0,24
68005,2,2548,2368,180,0,0,0,6
68006,2,2417,2549,-132,0,250,0,6
68007,2,2207,2557,-350,0,4,0,7
68008,1,2477,2404,73,0,21,1,6
68009,2,2409,2463,-54,0,202,0,6
68010,1,2543,2480,63,0,4,0,6
68011,3,2520,2500,20,0,127,0,6
68012,2,2350,2411,-61,0,121,0,6
68013,2,2400,2413,-13,0,45,1,6
68014,1,2475,2560,-85,0,4,0,6
68015,2,2552,2444,108,0,112,0,6
68016,2,2383,2405,-22,0,130,1,6
68017,2,2362,2484,-122,0,347,0,6
68018,2,2492,2489,3,0,327,0,6
68019,2,2330,2413,-83,0,320,1,6
68020,2,2425,2549,-124,0,226,0,6
68021,1,2407,2316,91,0,103,0,6
68022,1,2485,2394,91,0,389,0,6
68023,2,2408,2417,-9,0,300,1,6
68024,3,2516,2384,132,0,101,0,6
68025,1,2305,2427,-122,0,203,0,6
68026,2,2465,2386,79,0,250,0,6
68027,1,2569,2544,25,0,40,1,6
68028,1,2436,2420,16,0,158,1,6
68029,1,2496,2472,24,0,49,0,6
68030,2,2437,2505,-68,0,158,0,6
68031,2,2299,2440,-141,0,115,1,6
68032,2,2451,2585,-134,0,106,0,6
68033,1,2418,2461,-43,0,400,0,6
68034,2,2401,2472,-71,0,120,0,6
68035,3,2550,2503,47,0,40,0,6
68036,2,2246,2450,-204,0,49,0,6
68037,1,2384,2416,-32,0,122,0,6
68038,2,2418,2434,-16,0,120,0,6
68039,3,2411,2360,51,0,241,0,6
68040,3,2498,2434,64,0,56,0,6
68041,2,2370,2405,-35,0,110,1,6
68043,1,2485,2327,158,0,57,0,6
68044,1,2432,2388,44,0,52,1,6
68045,2,2483,2296,187,0,462,1,6
68046,2,2417,2506,-89,0,49,0,6
68047,2,2458,2548,-90,0,386,0,6
68048,2,2494,2553,-59,0,305,0,6
68049,2,2510,2404,106,0,288,0,6
68050,1,2514,2345,169,0,101,0,6
68051,2,2257,2418,-161,0,320,0,6
68052,2,2394,2400,-6,0,45,0,6
68053,2,2446,2383,63,0,4,0,6
68054,2,2456,2449,7,0,100,0,6
68055,1,2481,2442,39,0,16,0,6
68056,3,2426,2324,102,0,14,0,6
68057,1,2450,2447,3,0,302,1,6
68058,2,2409,2468,-59,0,40,0,6
68059,2,2495,2486,9,0,453,0,6
68060,1,2385,2400,-15,0,458,0,6
68061,2,2317,2488,-171,0,204,0,6
68062,2,2424,2280,144,0,140,0,6
68063,3,2500,2453,47,0,212,0,6
68064,2,2504,2549,-45,0,45,1,6
68065,1,2500,2529,-29,0,267,1,6
68066,2,2455,2367,88,0,40,0,6
68067,2,2477,2520,-43,0,36,0,6
68068,1,2538,2399,139,0,22,0,6
68069,2,2333,2424,-91,0,300,0,6
68070,1,2444,2225,219,4,480,0,13
68071,1,2451,2382,69,0,4,0,6
68072,2,2313,2402,-89,0,54,0,6
68073,1,2422,2256,166,0,43,1,6
68074,1,2459,2247,212,0,111,0,6
68075,3,2393,2499,-106,0,43,0,6
68076,1,2444,2385,59,0,15,1,6
68077,2,2413,2341,72,0,241,0,6
68078,2,2422,2377,45,0,150,0,6
68079,2,2318,2486,-168,0,160,0,6
68080,2,2409,2437,-28,0,303,0,6
68081,2,2268,2408,-140,0,46,0,6
68082,1,2471,2503,-32,0,122,0,6
68083,1,2440,2421,19,0,107,0,6
68084,1,2615,2448,167,0,411,0,6
68085,1,2552,2356,196,0,4,0,6
68086,2,2221,2445,-224,0,1,0,6
68087,2,2402,2351,51,0,45,1,6
68088,2,2307,2403,-96,0,46,0,6
68089,1,2410,2454,-44,0,41,1,6
68090,1,2552,2383,169,0,18,0,6
68091,1,2411,2315,96,0,122,0,6
68092,2,2272,2401,-129,4,10,1,13
68093,2,2475,2435,40,0,9,0,6
68094,1,2511,2412,99,0,43,0,6
68095,1,2420,2369,51,0,106,1,6
68096,2,2334,2437,-103,0,38,1,6
68097,2,2361,2489,-128,0,131,0,6
68098,2,2373,2410,-37,0,115,0,6
68099,2,2342,2517,-175,0,45,0,6
68100,1,2406,2389,17,0,130,0,6
68101,1,2503,2318,185,0,200,0,6
68102,1,2473,2415,58,0,4,0,6
68103,2,2433,2311,122,0,404,1,6
68104,2,2439,2458,-19,0,387,1,6
68105,1,2421,2343,78,0,343,1,6
68106,2,2581,2296,285,0,153,0,6
68108,1,2491,2489,2,0,492,0,6
68109,1,2558,2580,-22,0,110,0,6
68110,2,2492,2489,3,0,244,0,6
68111,1,2471,2395,76,0,31,1,6
68112,3,2497,2302,195,0,176,0,6
68113,1,2538,2385,153,0,311,0,6
68114,2,2408,2515,-107,0,265,0,6
68115,1,2490,2314,176,0,354,0,6
68116,2,2306,2448,-142,0,207,1,6
68117,1,2246,2416,-170,0,26,0,6
68118,1,2466,2365,101,0,43,1,6
68119,3,2415,2442,-27,0,218,0,6
68120,2,2469,2456,13,0,404,0,6
68121,1,2499,2313,186,0,212,1,6
68123,1,2445,2618,-173,0,36,1,6
68124,3,2407,2309,98,0,45,0,6
68125,2,2441,2419,22,0,254,0,6
68126,1,2283,2404,-121,0,110,0,6
68127,1,2411,2335,76,0,45,1,6
68128,1,2357,2406,-49,0,305,0,6
68129,1,2443,2443,0,0,122,1,6
68130,1,2320,2410,-90,0,464,1,6
68131,2,2442,2542,-100,0,389,1,6
68132,1,2415,2328,87,0,100,0,6
68133,1,2464,2238,226,0,101,0,6
68134,2,2296,2448,-152,0,113,0,6
68135,2,2416,2445,-29,0,151,0,6
68136,1,2311,2493,-182,0,156,0,6
68137,1,2307,2456,-149,0,112,0,6
68138,2,2487,2268,219,0,4,0,6
68139,1,2523,2519,4,0,122,0,6
68140,1,2559,2315,244,0,124,0,7
68141,3,2343,2487,-144,0,310,0,7
68142,2,2525,2338,187,0,18,1,6
68143,1,2472,2455,17,0,4,0,6
68144,2,2645,2517,128,0,134,0,6
68145,1,2380,2426,-46,0,310,0,6
68146,1,2508,2404,104,0,109,0,6
68147,1,2253,2419,-166,0,107,1,6
68148,2,2356,2441,-85,0,45,1,6
68149,1,2495,2487,8,0,63,0,6
68150,2,2487,2307,180,0,110,0,6
68151,2,2518,2556,-38,0,317,1,6
68152,2,2468,2473,-5,0,13,1,6
68153,2,2415,2364,51,0,110,0,6
68154,2,2448,2313,135,0,308,0,6
68155,2,2380,2416,-36,0,145,0,6
68156,1,2409,2348,61,0,115,0,6
68157,1,2353,2555,-202,0,105,0,6
68158,2,2464,2434,30,0,46,0,6
68159,2,2364,2425,-61,0,85,0,6
68160,1,2492,2484,8,0,485,0,6
68161,3,2339,2497,-158,0,200,0,6
68162,1,2439,2301,138,0,344,1,6
68163,1,2468,2296,172,0,302,0,6
68164,2,2490,2414,76,0,0,0,6
68165,1,2499,2409,90,0,102,0,6
68166,2,2411,2330,81,0,56,1,6
68167,2,2371,2450,-79,0,267,0,6
68168,2,2406,2383,23,0,130,1,6
68169,1,2369,2487,-118,0,62,0,8
68170,1,2481,2501,-20,0,244,0,6
68171,2,2412,2419,-7,0,107,0,6
68172,1,2317,2426,-109,0,203,0,6
68173,2,2415,2375,40,0,250,0,6
68174,1,2513,2528,-15,0,245,0,6
68175,2,2393,2463,-70,0,136,0,6
68176,3,2404,2419,-15,0,115,0,6
68177,1,2451,2387,64,0,300,0,6
68178,1,2484,2320,164,0,18,0,6
68179,1,2359,2462,-103,0,337,0,6
68180,1,2410,2440,-30,0,101,0,6
68181,2,2320,2405,-85,0,301,0,6
68182,1,2435,2471,-36,0,127,0,6
68183,3,2603,2580,23,0,207,0,6
68184,3,2430,2450,-20,0,224,0,6
68185,1,2490,2347,143,0,41,1,6
68186,2,2435,2318,117,0,41,0,6
68187,2,2450,2382,68,0,101,0,6
68188,1,2310,2467,-157,0,69,0,6
68189,3,2502,2477,25,0,301,0,6
68190,1,2329,2405,-76,0,280,0,6
68191,1,2437,2401,36,0,382,0,6
68192,2,2462,2448,14,0,15,1,6
68193,2,2448,2315,133,0,15,0,6
68194,2,2381,2451,-70,0,58,1,6
68195,1,2546,2384,162,0,45,0,6
68196,1,2325,2443,-118,0,222,0,6
68197,1,2411,2408,3,0,107,0,6
68198,1,2309,2434,-125,0,123,0,6
68199,1,2438,2513,-75,0,150,0,6
68200,1,2548,2561,-13,0,380,0,6
68201,3,2280,2478,-198,0,108,0,6
68202,1,2446,2344,102,0,9,0,6
68203,3,2451,2501,-50,0,305,0,6
68204,1,2478,2225,253,0,107,0,6
68205,2,2440,2458,-18,0,387,1,6
68206,1,2610,2542,68,0,70,0,6
68207,2,2488,2364,124,0,30,0,6
68209,2,2381,2549,-168,0,118,0,6
68210,2,2376,2401,-25,0,10,0,6
68211,1,2387,2414,-27,0,120,0,6
68212,3,2411,2384,27,0,107,0,6
68213,2,2450,2422,28,0,491,0,6
68214,1,2478,2386,92,0,302,0,6
68215,2,2369,2464,-95,0,344,0,6
68216,1,2442,2415,27,0,278,0,6
68217,1,2425,2271,154,0,121,0,6
68218,3,2500,2572,-72,0,20,0,6
68219,1,2347,2452,-105,0,324,0,6
68220,1,2494,2378,116,0,380,0,6
68221,2,2333,2467,-134,0,127,0,6
68222,1,2453,2330,123,0,223,0,6
68223,2,2495,2487,8,0,41,0,6
68224,1,2478,2434,44,0,487,0,6
68225,3,2386,2454,-68,0,40,0,6
68226,1,2417,2227,190,0,112,0,6
68227,1,2337,2462,-125,0,40,0,6
68228,1,2403,2400,3,0,200,0,6
68229,2,2390,2498,-108,0,300,1,6
68230,1,2304,2415,-111,0,135,0,6
68231,2,2375,2456,-81,0,200,0,6
68232,2,2432,2404,28,0,140,0,6
68233,1,2547,2362,185,0,265,1,6
68234,2,2483,2442,41,0,302,0,6
68235,1,2340,2403,-63,0,45,0,6
68236,1,2522,2519,3,0,132,0,6
68237,1,2459,2480,-21,0,170,0,6
68238,3,2405,2253,152,4,201,0,13
68239,1,2455,2382,73,0,313,0,6
68240,2,2382,2444,-62,0,463,0,6
68241,1,2428,2426,2,0,9,0,6
68242,2,2387,2553,-166,0,405,1,6
68243,2,2284,2410,-126,0,140,0,6
68244,2,2383,2517,-134,0,147,0,6
68245,1,2404,2256,148,0,250,0,8
68246,2,2429,2356,73,0,334,1,6
68247,1,2532,2413,119,0,311,1,6
68248,1,2326,2427,-101,0,40,0,6
68249,1,2419,2342,77,0,40,1,6
68250,1,2404,2430,-26,0,203,0,6
68251,2,2298,2436,-138,0,226,0,6
68252,2,2442,2388,54,0,79,1,6
68253,1,2555,2519,36,0,236,0,6
68254,2,2411,2346,65,0,101,0,6
68255,2,2478,2506,-28,0,4,0,6
68256,1,2468,2365,103,0,115,0,6
68257,1,2457,2310,147,0,145,0,6
68258,1,2471,2472,-1,0,31,0,6
68259,3,2356,2440,-84,0,242,0,6
68260,2,2446,2367,79,0,466,1,6
68261,1,2476,2310,166,0,304,0,6
68262,1,2485,2292,193,0,49,0,7
68263,3,2333,2561,-228,0,330,0,7
68264,1,2463,2530,-67,0,300,0,6
68265,2,2602,2554,48,0,110,0,6
68266,2,2403,2355,48,0,300,0,6
68267,1,2387,2498,-111,0,343,0,6
68268,1,2567,2505,62,0,46,0,6
68269,2,2372,2480,-108,0,304,0,6
68270,3,2357,2403,-46,0,336,0,6
68271,1,2308,2433,-125,0,138,1,6
68272,2,2358,2411,-53,0,331,1,6
68273,1,2208,2502,-294,0,46,0,6
68274,2,2493,2489,4,0,244,0,6
68275,2,2481,2449,32,0,194,1,6
68276,3,2417,2420,-3,0,21,0,6
68277,1,2513,2528,-15,0,267,1,6
68278,1,2417,2244,173,0,205,0,6
68279,1,2514,2511,3,0,46,0,6
68280,1,2457,2483,-26,0,200,0,6
68281,2,2429,2413,16,0,53,0,6
68282,2,2335,2429,-94,0,45,0,6
68284,1,2407,2210,197,0,43,0,6
68285,2,2417,2409,8,0,110,0,6
68286,2,2330,2427,-97,0,1,0,6
68287,1,2459,2367,92,0,354,1,6
68288,2,2240,2406,-166,0,200,0,6
68289,1,2420,2325,95,0,330,0,6
68290,1,2436,2419,17,0,15,0,6
68291,1,2378,2454,-76,0,40,0,6
68292,2,2500,2571,-71,0,212,0,6
68293,1,2423,2378,45,0,484,0,6
68294,2,2583,2397,186,0,255,0,6
68295,2,2402,2266,136,0,138,1,6
68296,1,2428,2561,-133,0,278,1,6
68297,2,2322,2448,-126,0,10,0,6
68298,2,2472,2385,87,0,101,0,6
68299,1,2294,2420,-126,0,56,0,6
68300,1,2455,2329,126,0,335,0,6
68301,1,2539,2410,129,0,49,0,6
68302,1,2420,2333,87,0,3,1,6
68303,2,2442,2422,20,0,111,0,6
68304,1,2439,2337,102,0,44,0,6
68305,2,2400,2312,88,0,414,0,6
68306,2,2409,2556,-147,0,46,0,6
68307,1,2460,2342,118,0,45,0,6
68308,3,2383,2424,-41,0,311,0,6
68309,1,2495,2487,8,0,306,0,6
68310,3,2474,2492,-18,0,125,0,6
68311,1,2397,2403,-6,0,138,0,6
68312,2,2359,2550,-191,0,105,0,6
68313,1,2426,2410,16,0,332,0,6
68314,3,2435,2479,-44,0,485,0,6
68315,3,2337,2439,-102,0,113,0,6
68316,3,2470,2404,66,0,300,0,6
68317,1,2614,2526,88,0,400,0,6
68318,2,2575,2576,-1,0,200,0,6
68319,1,2491,2414,77,0,300,0,6
68320,1,2446,2465,-19,0,455,0,6
68321,1,2402,2358,44,0,105,0,6
68322,1,2397,2417,-20,0,48,0,6
68323,2,2420,2266,154,0,131,0,6
68324,2,2371,2463,-92,0,127,0,6
68325,1,2521,2375,146,0,202,1,6
68326,1,2374,2466,-92,0,107,1,6
68327,1,2484,2368,116,0,334,1,6
68328,2,2451,2596,-145,0,22,0,6
68329,1,2434,2375,59,0,51,0,6
68330,1,2414,2263,151,0,300,0,6
68331,1,2479,2572,-93,0,31,0,6
68332,1,2522,2519,3,0,122,0,6
68333,2,2482,2501,-19,0,246,0,6
68334,2,2454,2471,-17,0,225,0,6
68335,2,2395,2428,-33,0,114,0,6
68336,2,2447,2439,8,0,107,1,6
68337,1,2428,2378,50,0,462,1,6
68338,3,2406,2545,-139,0,277,0,6
68339,2,2289,2465,-176,0,206,0,6
68340,2,2408,2373,35,0,200,1,6
68341,1,2348,2407,-59,0,380,0,6
68342,3,2422,2403,19,0,15,0,6
68343,1,2425,2327,98,0,61,0,6
68344,2,2401,2331,70,0,40,0,6
68345,2,2392,2553,-161,0,300,0,6
68346,3,2436,2471,-35,0,115,0,6
68347,1,2411,2354,57,0,130,0,6
68348,1,2403,2311,92,0,48,1,6
68349,2,2411,2519,-108,0,466,1,6
68350,2,2383,2447,-64,0,380,0,6
68351,1,2406,2436,-30,0,80,1,6
68352,2,2559,2524,35,0,310,0,6
68353,1,2451,2459,-8,0,453,0,6
68354,1,2339,2413,-74,0,15,0,6
68355,1,2443,2329,114,0,112,0,6
68356,3,2426,2470,-44,0,4,0,6
68357,2,2582,2569,13,0,302,1,6
68358,2,2423,2483,-60,0,48,0,6
68359,3,2424,2518,-94,0,102,0,6
68360,2,2294,2419,-125,0,432,0,6
68361,2,2474,2354,120,0,101,1,6
68362,1,2492,2354,138,0,301,0,6
68363,1,2401,2361,40,0,110,0,6
68364,2,2410,2348,62,0,205,1,6
68365,2,2495,2343,152,0,107,0,6
68366,3,2456,2319,137,0,127,0,6
68367,1,2341,2424,-83,0,4,1,6
68368,1,2383,2473,-90,0,271,0,6
68369,1,2512,2305,207,0,225,0,6
68370,1,2412,2469,-57,0,118,0,6
68371,2,2405,2545,-140,0,277,0,6
68372,1,2506,2476,30,0,40,0,6
68373,1,2437,2324,113,0,6,0,6
68374,1,2401,2326,75,0,40,1,6
68375,1,2448,2418,30,0,11,0,6
68376,3,2405,2406,-1,0,302,0,6
68377,1,2599,2488,111,0,132,0,6
68378,1,2591,2436,155,0,111,0,6
68379,1,2415,2373,42,0,134,0,8
68380,2,2260,2418,-158,0,123,1,6
68381,2,2433,2448,-15,0,306,0,6
68382,1,2352,2418,-66,0,305,1,6
68383,1,2462,2479,-17,0,45,0,6
68384,2,2415,2411,4,0,112,0,6
68385,1,2459,2217,242,0,140,0,6
68386,3,2447,2452,-5,0,112,0,6
68387,1,2297,2424,-127,0,246,0,8
68388,2,2476,2467,9,0,4,0,6
68389,3,2390,2403,-13,0,50,0,6
68390,2,2561,2553,8,0,426,1,6
68391,2,2321,2408,-87,0,302,0,6
68392,1,2564,2217,347,0,248,0,6
68393,1,2469,2389,80,0,101,0,6
68394,2,2530,2564,-34,0,250,0,6
68395,2,2433,2281,152,0,400,0,6
68396,2,2463,2497,-34,0,411,0,6
68397,2,2356,2453,-97,0,190,0,6
68398,2,2522,2619,-97,0,265,0,6
68399,1,2452,2271,181,0,457,0,6
68400,1,2452,2524,-72,0,46,0,6
68401,2,2364,2401,-37,0,40,0,6
68402,1,2542,2409,133,0,43,0,6
68403,2,2463,2354,109,0,40,0,6
68404,2,2422,2421,1,0,45,0,6
68405,1,2352,2407,-55,0,389,0,6
68406,2,2373,2433,-60,0,302,0,6
68407,1,2455,2487,-32,0,300,1,6
68408,2,2227,2461,-234,0,0,0,6
68409,2,2404,2495,-91,0,138,0,6
68410,2,2403,2430,-27,0,176,0,6
68411,2,2453,2396,57,0,487,0,6
68412,1,2377,2412,-35,0,310,0,6
68413,1,2413,2293,120,0,48,0,6
68414,2,2339,2463,-124,0,121,1,6
68415,1,2406,2409,-3,0,205,0,6
68416,3,2377,2416,-39,0,453,0,6
68417,2,2431,2306,125,0,57,0,6
68418,1,2417,2305,112,0,257,0,8
68419,1,2488,2225,263,0,4,0,6
68420,2,2471,2511,-40,0,398,0,6
68421,1,2421,2324,97,0,300,0,6
68422,1,2585,2603,-18,0,141,0,6
68423,1,2405,2445,-40,0,241,0,6
68424,2,2484,2433,51,0,272,0,6
68425,2,2279,2403,-124,4,196,0,13
68426,1,2574,2405,169,0,254,0,6
68427,2,2467,2448,19,0,245,0,6
68428,2,2361,2449,-88,0,45,0,6
68429,2,2438,2549,-111,0,288,1,6
68430,1,2417,2299,118,0,300,0,6
68431,1,2446,2428,18,0,414,0,6
68432,2,2405,2548,-143,0,277,0,6
68433,1,2468,2437,31,0,45,0,6
68434,2,2302,2412,-110,0,141,0,6
68435,2,2278,2566,-288,0,110,0,6
68436,1,2580,2605,-25,0,40,0,6
68437,1,2367,2482,-115,0,45,0,6
68438,2,2422,2426,-4,0,107,1,6
68439,2,2403,2473,-70,0,112,1,6
68440,2,2570,2600,-30,0,115,0,6
68441,1,2428,2349,79,0,438,0,6
68442,2,2406,2425,-19,0,231,1,6
68443,2,2216,2402,-186,0,45,0,6
68444,2,2277,2421,-144,0,307,1,6
68445,1,2589,2575,14,0,21,0,6
68446,3,2473,2470,3,0,255,0,6
68447,2,2291,2473,-182,0,135,1,6
68448,2,2417,2474,-57,0,112,1,6
68449,3,2392,2469,-77,0,110,0,6
68450,1,2475,2384,91,0,311,1,6
68451,1,2559,2458,101,0,43,1,6
68452,1,2517,2490,27,0,36,0,6
68453,3,2439,2455,-16,0,190,0,6
68454,1,2401,2412,-11,0,380,1,6
68455,1,2369,2485,-116,0,102,0,6
68456,2,2597,2555,42,0,110,1,6
68457,1,2470,2390,80,0,4,1,6
68458,2,2425,2427,-2,0,41,0,6
68459,2,2351,2489,-138,0,110,1,6
68460,3,2457,2352,105,0,265,0,6
68461,2,2455,2417,38,0,8,0,6
68462,2,2417,2429,-12,0,302,1,6
68463,2,2453,2432,21,0,459,0,6
68464,3,2500,2454,46,0,212,0,6
68465,2,2400,2461,-61,0,123,1,6
68466,3,2439,2478,-39,0,484,0,6
68467,3,2310,2432,-122,0,354,0,6
68468,1,2453,2400,53,0,111,1,6
68469,1,2553,2401,152,0,278,0,6
68470,1,2454,2461,-7,0,102,0,6
68471,3,2408,2441,-33,0,202,0,6
68472,2,2438,2369,69,0,41,0,6
68473,1,2406,2367,39,0,130,1,6
68474,3,2477,2393,84,0,311,0,6
68475,2,2293,2424,-131,0,205,0,6
68476,1,2541,2390,151,0,45,1,6
68477,2,2469,2449,20,0,385,1,6
68478,2,2454,2357,97,0,258,0,6
68479,1,2499,2465,34,0,301,0,6
68480,1,2605,2564,41,0,7,0,6
68481,1,2399,2481,-82,0,200,1,6
68482,1,2416,2361,55,0,130,1,6
68483,1,2457,2461,-4,0,302,0,6
68484,1,2289,2453,-164,0,255,0,6
68485,1,2552,2406,146,0,108,0,6
68486,1,2578,2408,170,0,255,0,6
68487,1,2401,2292,109,0,120,1,6
68488,1,2517,2384,133,0,311,0,6
68489,3,2434,2432,2,0,101,0,6
68490,2,2591,2730,-139,0,241,0,6
68491,1,2435,2267,168,0,121,0,6
68492,2,2452,2345,107,0,335,1,6
68493,2,2422,2454,-32,0,11,0,6
68494,1,2420,2397,23,0,292,0,8
68495,3,2598,2587,11,0,0,0,6
68496,1,2463,2460,3,0,46,0,6
68497,1,2426,2300,126,0,4,0,6
68498,2,2439,2323,116,0,151,0,6
68499,2,2579,2455,124,0,102,0,6
68500,2,2250,2413,-163,0,101,0,6
68501,1,2466,2225,241,0,4,0,6
68502,1,2329,2514,-185,0,106,0,6
68503,1,2301,2421,-120,0,100,1,8
68504,2,2355,2419,-64,0,54,1,6
68505,2,2331,2473,-142,0,17,1,6
68506,2,2438,2470,-32,0,267,0,6
68507,3,2405,2460,-55,0,359,0,6
68508,1,2371,2401,-30,0,40,1,6
68509,1,2352,2400,-48,0,302,0,6
68510,1,2476,2466,10,0,242,0,6
68511,2,2380,2492,-112,0,45,0,6
68512,2,2380,2521,-141,0,394,0,6
68513,2,2323,2479,-156,0,284,0,6
68514,1,2556,2478,78,0,114,0,6
68515,2,2200,2581,-381,0,101,0,6
68516,2,2478,2454,24,0,4,0,6
68517,1,2563,2377,186,0,354,0,6
68518,2,2398,2558,-160,0,284,0,6
68519,1,2406,2335,71,0,101,0,6
68520,1,2356,2424,-68,0,45,0,6
68521,2,2377,2523,-146,0,194,1,6
68522,1,2485,2345,140,0,330,1,6
68523,2,2394,2542,-148,0,83,0,6
68524,3,2398,2401,-3,0,345,0,6
68525,2,2264,2480,-216,4,112,0,13
68527,1,2477,2440,37,0,272,0,6
68528,1,2323,2412,-89,0,80,1,6
68529,1,2400,2234,166,0,371,0,6
68530,2,2439,2250,189,0,131,0,6
68531,2,2294,2470,-176,0,453,0,6
68532,2,2257,2450,-193,0,101,0,6
68533,1,2247,2410,-163,0,151,1,6
68534,1,2700,2296,404,0,123,1,6
68535,1,2419,2402,17,0,49,0,6
68536,2,2353,2411,-58,0,245,0,6
68537,1,2379,2460,-81,0,225,0,6
68538,1,2496,2434,62,0,200,0,6
68539,1,2376,2455,-79,0,300,0,6
68540,1,2430,2443,-13,0,7,0,6
68541,1,2312,2431,-119,0,0,1,6
68542,1,2297,2411,-114,0,142,1,6
68543,2,2474,2421,53,0,7,1,6
68544,1,2655,2463,192,0,218,0,6
68545,1,2375,2475,-100,0,399,0,6
68546,3,2459,2447,12,0,474,0,6
68547,3,2364,2465,-101,0,43,0,6
68548,1,2406,2395,11,0,333,0,6
68549,1,2407,2449,-42,4,136,0,13
68550,1,2552,2448,104,0,485,0,6
68551,2,2454,2559,-105,0,253,1,6
68552,1,2474,2468,6,0,300,0,6
68553,1,2409,2441,-32,0,202,0,6
68554,1,2399,2582,-183,0,43,0,6
68555,2,2292,2412,-120,0,484,1,6
68556,2,2354,2475,-121,0,310,0,6
68557,1,2598,2443,155,0,0,0,6
68558,3,2462,2416,46,0,338,0,6
68559,1,2569,2272,297,0,130,0,6
68560,2,2356,2432,-76,0,490,1,6
68561,1,2468,2338,130,0,8,0,6
68562,2,2425,2434,-9,0,414,0,6
68563,1,2406,2526,-120,0,405,0,6
68564,2,2373,2459,-86,0,245,1,6
68565,1,2434,2410,24,0,103,1,6
68566,2,2476,2407,69,0,268,0,6
68567,1,2453,2351,102,0,123,0,6
68568,2,2302,2424,-122,0,5,1,6
68569,1,2354,2444,-90,0,192,0,6
68570,2,2392,2463,-71,0,120,0,6
68571,2,2480,2414,66,0,407,1,6
68572,2,2417,2350,67,0,337,0,6
68573,3,2374,2415,-41,0,117,0,8
68574,1,2377,2430,-53,0,380,0,6
68575,3,2492,2571,-79,0,190,0,6
68576,1,2477,2328,149,0,184,0,6
68577,1,2482,2331,151,0,200,0,6
68578,1,2602,2474,128,0,0,0,6
68579,3,2427,2366,61,0,340,0,6
68580,1,2447,2358,89,0,300,1,6
68581,3,2459,2488,-29,0,5,0,6
68582,1,2460,2472,-12,0,40,1,6
68583,2,2267,2525,-258,0,112,0,6
68584,1,2424,2447,-23,0,103,0,6
68586,2,2440,2566,-126,0,110,0,6
68587,1,2430,2448,-18,0,302,0,6
68588,1,2464,2332,132,4,45,0,13
68589,1,2421,2391,30,0,217,0,6
68590,3,2481,2405,76,0,73,0,6
68591,3,2435,2482,-47,0,58,0,6
68592,2,2405,2342,63,0,335,0,6
68593,1,2505,2459,46,0,343,0,6
68594,2,2488,2374,114,0,400,0,6
68595,2,2458,2526,-68,0,46,0,6
68596,2,2383,2456,-73,0,40,0,6
68597,1,2445,2349,96,0,4,1,6
68598,2,2658,2588,70,0,101,0,6
68599,2,2437,2273,164,0,43,0,6
68600,3,2563,2450,113,0,152,0,6
68601,1,2460,2411,49,0,18,0,6
68602,1,2574,2305,269,0,152,0,6
68603,2,2224,2570,-346,0,115,0,6
68604,1,2430,2312,118,0,485,0,6
68605,3,2559,2517,42,0,14,0,6
68606,2,2491,2304,187,0,337,0,6
68607,1,2410,2350,60,0,4,1,6
68608,1,2561,2485,76,0,0,0,6
68609,2,2464,2309,155,0,100,0,6
68610,2,2459,2352,107,0,48,1,6
68611,3,2610,2468,142,0,5,0,6
68612,2,2242,2482,-240,0,247,0,6
68613,1,2507,2228,279,0,226,0,6
68614,2,2320,2427,-107,0,0,0,6
68615,2,2423,2518,-95,0,394,1,6
68616,2,2393,2404,-11,0,101,0,6
68617,1,2437,2305,132,0,386,0,6
68618,1,2468,2362,106,0,344,0,6
68619,2,2415,2401,14,0,250,0,6
68620,3,2357,2437,-80,0,474,0,6
68621,2,2527,2265,262,0,453,1,6
68622,2,2209,2403,-194,0,110,0,6
68623,2,2420,2353,67,0,151,0,6
68624,1,2417,2440,-23,0,15,0,6
68625,1,2549,2507,42,0,453,0,6
68626,2,2463,2570,-107,0,45,0,6
68627,1,2393,2464,-71,0,311,0,6
68628,1,2473,2469,4,0,464,0,6
68629,2,2357,2439,-82,0,0,0,6
68630,2,2238,2405,-167,0,385,0,6
68631,2,2428,2327,101,0,40,0,6
68632,1,2408,2576,-168,0,43,1,6
68633,1,2413,2300,113,0,121,0,8
68634,2,2319,2416,-97,0,344,0,6
68635,2,2249,2403,-154,0,315,1,6
68636,1,2310,2403,-93,0,373,1,6
68637,1,2400,2313,87,0,45,1,6
68638,1,2453,2327,126,0,140,0,6
68639,2,2360,2706,-346,0,455,0,6
68640,1,2475,2365,110,0,191,1,6
68641,2,2323,2463,-140,0,147,0,6
68642,1,2570,2383,187,0,315,0,6
68643,1,2414,2430,-16,0,18,0,6
68644,2,2480,2473,7,0,204,0,6
68645,2,2405,2400,5,0,250,0,6
68647,1,2531,2347,184,0,11,1,6
68648,1,2441,2307,134,0,17,0,6
68649,1,2436,2606,-170,0,100,0,6
68650,2,2470,2504,-34,0,80,0,6
68651,1,2491,2253,238,4,432,0,13
68652,1,2442,2502,-60,0,133,0,6
68653,2,2466,2414,52,0,15,1,6
68654,3,2507,2257,250,0,226,0,6
68655,2,2255,2468,-213,0,382,0,6
68656,1,2286,2572,-286,0,114,0,6
68657,1,2481,2436,45,0,200,1,6
68658,2,2434,2406,28,0,104,1,6
68659,2,2382,2458,-76,0,104,0,6
68660,2,2454,2472,-18,0,46,0,6
68661,2,2518,2559,-41,0,330,0,6
68662,1,2565,2600,-35,0,133,1,6
68663,2,2423,2561,-138,0,1,1,6
68664,3,2452,2562,-110,0,13,0,6
68665,1,2391,2456,-65,0,120,0,6
68666,1,2403,2465,-62,0,207,0,6
68667,3,2303,2409,-106,0,115,0,6
68668,1,2420,2315,105,0,216,0,6
68669,1,2461,2458,3,0,323,1,6
68670,1,2445,2327,118,0,13,0,6
68671,1,2428,2553,-125,0,45,0,6
68672,1,2499,2379,120,0,101,0,6
68673,2,2594,2651,-57,0,269,0,6
68674,1,2443,2414,29,4,120,0,13
68675,2,2352,2472,-120,0,152,0,6
68676,3,2374,2479,-105,0,135,0,6
68677,1,2481,2359,122,0,373,0,6
68678,3,2440,2294,146,0,113,0,6
68679,1,2424,2301,123,0,385,0,6
68680,3,2411,2426,-15,0,400,0,6
68681,3,2431,2436,-5,0,250,0,6
68682,1,2421,2377,44,0,40,1,6
68683,2,2420,2461,-41,0,31,0,6
68684,2,2502,2380,122,0,373,0,6
68685,2,2491,2608,-117,0,326,0,6
68686,1,2470,2387,83,0,4,1,6
68687,1,2403,2419,-16,0,247,0,6
68688,1,2428,2349,79,0,200,0,6
68689,1,2479,2415,64,0,374,1,6
68690,1,2326,2479,-153,0,313,0,6
68691,1,2406,2568,-162,0,6,0,6
68692,2,2474,2311,163,0,192,0,6
68693,1,2407,2216,191,0,73,0,6
68694,1,2381,2426,-45,0,67,0,6
68695,3,2335,2460,-125,0,206,0,6
68696,1,2522,2459,63,0,306,0,6
68697,2,2251,2518,-267,0,115,1,6
68698,2,2438,2346,92,0,0,1,6
68699,2,2509,2397,112,0,343,0,6
68700,2,2308,2434,-126,0,214,0,6
68701,2,2484,2509,-25,0,40,0,6
68702,1,2452,2407,45,0,302,0,6
68703,1,2570,2460,110,0,130,0,6
68704,1,2408,2354,54,0,122,0,6
68705,2,2360,2413,-53,0,0,0,6
68706,1,2268,2402,-134,4,300,0,13
68707,3,2406,2376,30,0,303,0,6
68708,2,2390,2429,-39,0,311,0,6
68709,2,2302,2418,-116,0,374,0,6
68710,2,2574,2556,18,0,140,1,6
68711,2,2380,2573,-193,0,405,0,6
68713,1,2445,2345,100,0,4,1,6
68714,1,2449,2386,63,0,215,0,6
68715,3,2564,2513,51,0,8,0,6
68716,1,2560,2465,95,0,118,0,6
68717,1,2509,2467,42,0,122,0,6
68718,2,2296,2417,-121,0,284,1,8
68719,1,2426,2406,20,0,257,0,6
68720,3,2259,2407,-148,0,240,0,6
68721,1,2448,2314,134,0,402,0,6
68722,1,2554,2476,78,0,115,0,6
68723,2,2562,2459,103,0,249,0,6
68724,1,2463,2346,117,0,200,1,6
68725,1,2459,2352,107,0,4,1,6
68726,2,2553,2656,-103,0,250,0,6
68727,1,2443,2385,58,0,112,0,6
68728,1,2597,2574,23,0,0,0,6
68729,1,2350,2449,-99,0,118,0,6
68730,2,2459,2420,39,0,28,0,6
68731,2,2471,2420,51,0,380,0,6
68732,1,2445,2566,-121,0,224,1,6
68733,1,2445,2313,132,0,35,0,6
68734,1,2414,2432,-18,0,260,0,6
68735,2,2473,2419,54,0,45,0,6
68736,1,2297,2467,-170,0,107,0,6
68737,2,2494,2428,66,0,4,0,6
68738,2,2372,2426,-54,0,140,0,6
68739,2,2461,2564,-103,0,300,0,6
68740,3,2314,2486,-172,0,4,0,6
68741,1,2534,2510,24,0,36,0,6
68742,2,2344,2449,-105,0,4,0,6
68743,3,2466,2457,9,0,80,0,6
68744,3,2309,2405,-96,0,101,0,6
68745,3,2714,2483,231,0,111,0,6
68746,1,2456,2434,22,0,130,0,6
68747,1,2420,2248,172,0,205,0,6
68748,2,2453,2332,121,0,121,0,6
68749,1,2467,2415,52,0,311,1,6
68750,3,2365,2545,-180,0,4,0,6
68751,1,2406,2480,-74,0,245,0,6
68752,2,2354,2438,-84,0,10,0,6
68753,2,2436,2431,5,0,320,1,6
68754,1,2454,2384,70,0,132,0,6
68755,1,2472,2206,266,4,152,0,13
68756,2,2471,2558,-87,0,132,0,6
68757,1,2559,2300,259,0,111,0,6
68758,2,2213,2539,-326,0,4,0,6
68759,1,2505,2410,95,0,301,0,6
68760,1,2422,2237,185,0,201,0,6
68761,1,2381,2475,-94,0,192,0,6
68762,3,2385,2456,-71,0,191,0,6
68763,2,2306,2413,-107,0,253,0,6
68764,1,2362,2445,-83,0,180,1,6
68765,1,2420,2269,151,0,57,0,6
68766,2,2413,2464,-51,0,204,0,6
68767,1,2427,2502,-75,0,306,1,6
68768,1,2408,2305,103,0,131,0,6
68769,1,2406,2411,-5,0,46,0,6
68770,1,2520,2270,250,0,311,0,6
68771,2,2594,2695,-101,0,111,0,6
68772,2,2449,2341,108,0,14,0,6
68773,2,2345,2442,-97,0,110,0,6
68774,1,2454,2494,-40,0,40,0,6
68775,2,2405,2452,-47,0,310,0,6
68776,1,2423,2426,-3,0,140,0,6
68777,2,2216,2485,-269,0,115,0,6
68778,2,2370,2478,-108,0,153,0,6
68779,1,2311,2424,-113,0,442,0,6
68780,2,2576,2633,-57,0,337,0,6
68781,1,2477,2234,243,0,5,0,6
68782,2,2244,2423,-179,0,49,0,6
68783,1,2487,2644,-157,0,415,0,6
68784,2,2514,2563,-49,0,302,0,6
68785,1,2568,2457,111,0,118,0,6
68786,2,2446,2509,-63,0,130,1,6
68787,1,2340,2406,-66,0,304,1,6
68788,2,2299,2417,-118,0,6,0,6
68789,2,2330,2511,-181,0,40,0,6
68790,2,2260,2400,-140,0,115,1,6
68791,2,2471,2333,138,0,8,1,6
68792,2,2401,2527,-126,0,145,0,6
68793,1,2511,2272,239,0,111,1,6
68794,3,2563,2467,96,0,310,0,6
68795,1,2562,2416,146,0,110,0,6
68796,2,2378,2514,-136,0,483,0,6
68797,2,2404,2302,102,0,128,1,6
68798,1,2549,2434,115,0,151,0,6
68799,1,2568,2603,-35,0,100,0,6
68800,1,2303,2468,-165,4,200,0,13
68801,1,2450,2400,50,0,241,0,6
68802,2,2429,2383,46,0,378,0,6
68803,1,2402,2420,-18,0,46,0,6
68804,1,2276,2457,-181,0,112,0,6
68805,3,2443,2379,64,0,0,0,6
68806,2,2467,2467,0,0,45,0,6
68807,1,2541,2555,-14,0,113,0,6
68808,2,2453,2614,-161,2,140,0,24
68809,1,2555,2452,103,0,49,0,6
68810,2,2431,2434,-3,0,150,0,6
68811,3,2405,2309,96,0,45,0,6
68812,2,2467,2369,98,0,8,0,6
68813,1,2483,2356,127,0,152,0,6
68814,2,2457,2431,26,0,140,0,6
68815,1,2403,2300,103,0,138,0,6
68816,1,2436,2488,-52,0,56,1,6
68817,2,2348,2442,-94,0,300,0,6
68818,2,2569,2636,-67,0,123,0,6
68819,3,2437,2430,7,0,250,0,6
68820,1,2469,2392,77,0,80,0,6
68821,2,2273,2408,-135,0,48,0,6
68822,1,2264,2429,-165,0,122,1,6
68823,2,2268,2522,-254,0,112,0,6
68824,2,2392,2571,-179,0,429,0,6
68825,3,2379,2407,-28,0,411,0,6
68826,2,2350,2400,-50,0,40,0,6
68827,1,2379,2458,-79,0,300,0,6
68828,2,2561,2638,-77,0,46,1,6
68829,1,2428,2328,100,0,394,0,6
68830,3,2450,2374,76,0,127,0,6
68831,2,2501,2453,48,0,405,0,6
68832,3,2414,2406,8,0,409,0,6
68833,1,2565,2380,185,0,110,0,6
68834,1,2597,2461,136,0,0,0,6
68835,2,2240,2408,-168,4,150,1,13
68836,1,2427,2238,189,0,16,0,6
68837,2,2482,2432,50,0,292,1,6
68838,2,2421,2407,14,0,30,0,6
68839,1,2568,2509,59,0,8,0,6
68840,2,2397,2448,-51,0,277,1,6
68841,2,2446,2547,-101,0,4,0,6
68842,2,2487,2549,-62,0,33,0,6
68843,1,2375,2490,-115,0,40,0,6
68844,1,2494,2363,131,0,300,0,6
68845,1,2289,2451,-162,0,424,0,6
68846,1,2422,2428,-6,0,310,1,6
68847,2,2532,2453,79,0,387,0,6
68848,2,2437,2315,122,0,45,0,6
68849,1,2412,2473,-61,0,240,1,6
68850,2,2574,2389,185,0,464,0,6
68851,1,2423,2287,136,0,339,0,6
68852,2,2317,2531,-214,0,1,0,6
68853,1,2468,2561,-93,0,112,0,6
68854,2,2340,2424,-84,0,40,0,6
68855,2,2574,2560,14,0,280,0,6
68856,1,2590,2553,37,0,380,0,6
68857,2,2487,2374,113,0,200,0,6
68858,2,2379,2467,-88,0,260,0,6
68859,1,2446,2344,102,0,14,0,6
68860,2,2513,2376,137,0,200,0,6
68861,1,2480,2406,74,0,302,1,6
68862,1,2528,2515,13,0,45,1,6
68863,1,2408,2568,-160,0,302,0,6
68864,2,2504,2573,-69,0,246,0,6
68865,2,2408,2386,22,0,241,0,6
68866,1,2302,2466,-164,0,45,1,6
68867,1,2641,2552,89,0,54,1,6
68868,3,2329,2472,-143,0,45,0,6
68869,2,2399,2461,-62,0,487,0,6
68870,2,2324,2442,-118,0,490,0,6
68871,1,2417,2411,6,0,145,0,6
68872,2,2276,2430,-154,0,380,0,6
68873,1,2521,2369,152,0,190,1,6
68874,2,2299,2430,-131,0,57,1,6
68875,3,2514,2407,107,0,45,0,6
68876,3,2432,2401,31,0,100,0,6
68877,1,2403,2466,-63,0,45,1,6
68878,1,2488,2374,114,0,216,0,6
68879,2,2457,2311,146,0,190,1,6
68880,2,2268,2697,-429,0,101,0,6
68881,2,2301,2474,-173,4,147,0,13
68882,2,2440,2413,27,0,177,1,6
68883,1,2392,2449,-57,0,106,1,6
68884,3,2404,2300,104,0,303,0,6
68885,2,2308,2524,-216,0,30,0,6
68886,1,2455,2495,-40,0,277,1,6
68887,1,2534,2600,-66,0,40,0,6
68888,1,2457,2453,4,0,45,1,6
68889,2,2430,2437,-7,0,302,1,6
68890,1,2398,2407,-9,0,354,1,8
68891,2,2376,2474,-98,0,202,0,6
68892,1,2320,2460,-140,0,405,0,6
68893,3,2481,2634,-153,0,4,0,6
68894,1,2405,2386,19,0,414,0,6
68895,1,2464,2456,8,0,46,0,6
68896,2,2351,2404,-53,0,404,0,6
68897,2,2452,2359,93,0,225,0,6
68898,2,2412,2498,-86,0,101,1,6
68899,1,2426,2460,-34,0,45,1,6
68900,2,2449,2284,165,0,487,0,6
68901,2,2561,2417,144,0,110,0,6
68902,1,2459,2388,71,0,80,0,6
68903,1,2379,2429,-50,0,55,0,6
68904,2,2511,2309,202,0,121,1,6
68905,2,2312,2422,-110,0,0,0,6
68906,2,2214,2602,-388,0,306,0,6
68907,2,2516,2362,154,0,101,0,6
68908,1,2643,2566,77,0,49,0,6
68909,2,2304,2418,-114,0,115,0,6
68910,2,2480,2382,98,0,101,1,6
68911,1,2477,2298,179,4,263,0,13
68912,1,2478,2337,141,0,56,0,6
68913,2,2475,2371,104,0,135,0,6
68914,1,2548,2595,-47,0,250,0,6
68915,2,2464,2441,23,0,409,1,6
68916,2,2393,2463,-70,0,456,0,6
68917,2,2283,2427,-144,0,200,1,6
68918,2,2340,2450,-110,0,311,0,6
68919,2,2421,2454,-33,0,400,0,6
68920,1,2422,2382,40,0,201,0,6
68921,2,2566,2568,-2,0,151,0,6
68922,1,2554,2476,78,0,0,0,6
68923,2,2283,2427,-144,0,200,1,6
68924,2,2329,2446,-117,0,101,1,6
68925,2,2454,2495,-41,0,288,0,6
68926,2,2300,2471,-171,0,302,0,6
68927,1,2239,2453,-214,0,392,0,6
68928,3,2264,2428,-164,0,3,0,6
68929,2,2578,2499,79,0,14,0,6
68930,1,2398,2470,-72,0,48,0,6
68931,1,2402,2427,-25,0,46,1,6
68932,1,2527,2314,213,0,40,0,6
68933,1,2547,2460,87,0,110,0,6
68934,1,2645,2450,195,0,406,0,6
68935,1,2423,2295,128,0,300,1,6
68936,2,2414,2593,-179,0,40,0,6
68937,2,2434,2390,44,0,16,0,6
68938,1,2554,2623,-69,0,37,1,6
68939,1,2471,2559,-88,0,3,0,6
68940,1,2632,2479,153,0,28,0,6
68941,2,2272,2485,-213,0,115,0,6
68942,2,2306,2508,-202,0,106,1,6
68943,1,2422,2365,57,0,104,0,6
68944,1,2434,2483,-49,0,259,0,6
68945,1,2444,2273,171,0,4,0,6
68946,1,2600,2533,67,0,337,0,6
68947,1,2366,2524,-158,0,270,0,6
68948,1,2405,2343,62,0,100,0,6
68949,2,2381,2410,-29,0,45,0,6
68950,2,2540,2399,141,0,57,0,6
68951,1,2443,2424,19,0,203,0,6
68952,2,2453,2330,123,0,120,0,6
68953,3,2466,2419,47,0,85,0,6
68954,1,2561,2612,-51,0,380,0,6
68955,1,2552,2478,74,0,0,0,6
68956,2,2367,2415,-48,0,288,1,6
68957,2,2456,2552,-96,0,45,0,6
68958,1,2454,2502,-48,0,7,1,6
68960,1,2429,2433,-4,0,40,0,6
68961,1,2401,2327,74,0,404,0,8
68962,2,2286,2405,-119,0,253,0,6
68963,1,2452,2423,29,0,339,0,6
68964,1,2402,2449,-47,0,4,0,6
68965,2,2370,2432,-62,0,404,1,6
68966,1,2460,2306,154,0,301,0,6
68967,1,2702,2410,292,0,101,0,6
68968,2,2319,2495,-176,0,112,0,6
68969,2,2507,2571,-64,0,302,0,6
68970,2,2335,2427,-92,0,400,0,6
68971,2,2531,2473,58,0,127,0,6
68972,2,2709,2647,62,0,7,0,6
68973,2,2293,2441,-148,0,112,0,6
68974,2,2309,2459,-150,0,70,0,6
68975,1,2445,2311,134,0,101,0,6
68976,1,2589,2554,35,0,380,0,6
68977,2,2450,2416,34,0,440,1,6
68978,2,2379,2483,-104,0,8,0,6
68979,3,2474,2450,24,0,4,0,6
68980,1,2377,2479,-102,0,463,1,6
68981,1,2474,2525,-51,0,415,0,6
68982,2,2568,2556,12,0,9,0,6
68983,2,2372,2401,-29,0,200,0,6
68984,1,2529,2285,244,0,46,0,6
68985,2,2529,2605,-76,0,224,0,6
68986,1,2596,2648,-52,0,0,0,6
68987,2,2447,2285,162,0,130,0,6
68988,2,2306,2427,-121,0,140,0,6
68989,1,2221,2427,-206,0,46,1,6
68990,1,2448,2407,41,0,250,0,6
68991,3,2409,2400,9,0,330,0,6
68992,3,2486,2426,60,4,343,0,13
68993,2,2549,2568,-19,0,46,1,6
68994,1,2360,2435,-75,0,40,0,6
68995,1,2610,2524,86,0,344,0,6
68996,2,2427,2422,5,0,110,0,6
68997,2,2241,2428,-187,0,453,0,6
68998,1,2420,2533,-113,0,45,0,6
68999,1,2527,2408,119,0,102,0,6
69000,1,2494,2457,37,0,405,0,6
69001,1,2432,2293,139,0,310,0,6
69002,1,2416,2431,-15,0,54,0,6
69003,1,2463,2306,157,0,14,0,6
69004,2,2388,2411,-23,0,112,1,6
69005,1,2419,2483,-64,0,331,0,6
69006,2,2282,2406,-124,0,112,0,6
69007,1,2556,2441,115,0,150,1,6
69008,2,2575,2502,73,0,14,0,6
69009,2,2452,2451,1,0,0,0,6
69010,2,2404,2303,101,0,17,0,6
69011,2,2329,2503,-174,0,40,0,6
69012,1,2488,2378,110,0,409,1,6
69013,2,2699,2494,205,0,242,0,6
69014,1,2406,2376,30,0,122,0,6
69015,2,2562,2562,0,0,194,0,6
69016,2,2417,2449,-32,0,180,0,6
69017,1,2490,2549,-59,0,388,0,6
69018,1,2453,2361,92,0,250,0,6
69019,1,2335,2461,-126,0,15,0,6
69020,1,2496,2471,25,0,43,0,6
69021,2,2330,2451,-121,0,312,1,6
69022,1,2520,2614,-94,0,300,1,6
69023,1,2487,2374,113,0,491,0,6
69024,1,2408,2363,45,0,123,1,6
69025,2,2233,2405,-172,0,43,0,6
69026,3,2370,2421,-51,0,101,0,6
69027,1,2363,2446,-83,0,141,0,8
69028,1,2431,2370,61,4,405,1,13
69029,2,2353,2439,-86,0,46,0,6
69030,3,2315,2452,-137,0,120,0,6
69031,3,2616,2561,55,0,81,0,6
69032,2,2603,2594,9,0,0,0,6
69033,2,2641,2701,-60,0,41,0,6
69034,2,2402,2443,-41,0,101,0,6
69035,3,2472,2377,95,0,200,0,6
69036,1,2409,2339,70,0,16,0,6
69037,1,2283,2532,-249,0,110,0,6
69038,1,2444,2296,148,0,173,0,6
69039,3,2459,2461,-2,0,123,0,6
69040,2,2451,2474,-23,0,260,0,6
69041,2,2419,2465,-46,0,277,0,6
69042,1,2518,2336,182,0,311,0,6
69043,1,2481,2312,169,0,337,0,6
69044,2,2458,2404,54,0,84,1,6
69045,3,2427,2484,-57,4,414,0,13
69046,1,2228,2478,-250,0,200,1,6
69047,2,2423,2526,-103,0,409,0,6
69048,2,2338,2466,-128,0,40,0,6
69049,1,2218,2451,-233,0,45,0,8
69050,1,2274,2443,-169,0,200,0,6
69051,2,2410,2307,103,0,121,0,6
69052,1,2457,2446,11,0,112,0,6
69053,1,2425,2357,68,0,300,0,6
69054,1,2443,2365,78,0,207,0,6
69055,1,2408,2408,0,0,45,1,6
69056,1,2275,2463,-188,0,140,0,6
69057,3,2500,2265,235,0,217,0,6
69058,3,2437,2711,-274,0,278,0,6
69059,2,2345,2422,-77,0,330,0,6
69060,1,2371,2521,-150,0,190,0,6
69061,2,2590,2652,-62,0,130,0,6
69062,1,2381,2466,-85,0,45,1,6
69063,2,2412,2354,58,4,242,0,13
69064,1,2573,2445,128,0,106,0,6
69065,1,2476,2426,50,0,15,1,6
69066,1,2537,2458,79,0,56,0,6
69067,1,2509,2341,168,0,101,0,6
69068,1,2323,2405,-82,0,123,1,6
69069,2,2509,2569,-60,0,56,1,6
69070,2,2562,2615,-53,0,35,0,6
69071,1,2568,2526,42,0,460,0,6
69072,1,2452,2328,124,0,131,1,6
69073,2,2437,2560,-123,0,132,0,6
69074,1,2502,2400,102,0,6,0,6
69075,3,2707,2637,70,0,5,0,6
69076,3,2307,2449,-142,0,300,0,6
69077,1,2400,2373,27,0,110,0,8
69078,2,2264,2420,-156,0,46,1,6
69079,3,2358,2413,-55,0,48,0,6
69080,1,2409,2417,-8,0,310,0,6
69081,1,2370,2491,-121,0,205,0,6
69082,1,2603,2412,191,0,0,0,6
69083,2,2216,2434,-218,0,453,0,6
69084,2,2276,2423,-147,0,377,1,8
69085,1,2343,2424,-81,0,21,0,6
69086,1,2428,2421,7,0,152,0,6
69087,1,2507,2249,258,0,124,0,6
69088,2,2344,2492,-148,0,228,0,6
69089,3,2369,2484,-115,0,130,0,6
69090,2,2350,2403,-53,0,202,0,6
69091,1,2558,2607,-49,0,331,0,6
69092,1,2448,2484,-36,0,315,0,6
69093,1,2479,2444,35,0,247,1,6
69094,1,2401,2389,12,0,144,0,8
69095,2,2426,2397,29,0,77,0,6
69096,1,2523,2349,174,0,311,0,6
69097,1,2358,2414,-56,0,200,0,6
69098,1,2466,2419,47,0,458,1,6
69099,3,2344,2501,-157,0,7,0,6
69100,2,2327,2456,-129,0,244,0,6
69101,1,2691,2527,164,0,103,1,6
69102,1,2470,2334,136,0,101,0,6
69103,2,2400,2448,-48,0,335,1,6
69104,2,2319,2448,-129,0,45,0,6
69105,1,2411,2448,-37,0,1,0,6
69106,2,2461,2470,-9,0,113,0,6
69107,2,2352,2411,-59,0,113,0,6
69108,1,2412,2292,120,0,241,0,8
69109,2,2501,2535,-34,0,43,1,6
69110,1,2426,2309,117,0,153,1,6
69111,2,2435,2546,-111,0,151,0,6
69112,2,2358,2474,-116,0,212,1,6
69113,2,2262,2436,-174,0,45,0,6
69114,1,2573,2564,9,0,41,0,6
69115,1,2596,2331,265,0,1,0,6
69116,2,2441,2435,6,0,107,0,6
69117,2,2577,2600,-23,0,106,0,6
69118,1,2564,2433,131,0,123,1,6
69119,1,2598,2445,153,0,56,0,6
69120,1,2429,2383,46,0,45,1,6
69121,1,2276,2409,-133,0,41,0,6
69122,2,2346,2526,-180,0,4,0,6
69123,1,2530,2513,17,0,483,0,6
69124,2,2311,2462,-151,0,143,0,6
69125,1,2440,2459,-19,0,45,1,6
69126,1,2415,2433,-18,0,112,0,6
69127,1,2573,2504,69,0,8,1,6
69128,2,2319,2441,-122,0,132,0,6
69129,2,2638,2706,-68,0,40,0,6
69130,3,2409,2339,70,0,112,0,6
69131,1,2360,2478,-118,0,138,0,6
69132,2,2455,2330,125,0,56,0,6
69133,1,2398,2452,-54,0,157,1,6
69134,2,2329,2598,-269,0,45,0,6
69135,1,2531,2573,-42,0,190,0,6
69136,2,2417,2233,184,0,40,0,6
69137,2,2415,2421,-6,0,487,1,6
69138,3,2462,2379,83,0,130,0,6
69139,2,2342,2403,-61,0,50,0,6
69140,1,2508,2398,110,0,484,0,6
69141,2,2396,2403,-7,0,45,0,6
69142,2,2470,2414,56,0,85,0,6
69143,1,2413,2327,86,0,19,0,6
69144,1,2406,2371,35,0,226,0,8
69145,2,2513,2343,170,0,373,0,6
69146,2,2420,2340,80,0,302,0,6
69147,1,2408,2211,197,0,172,0,6
69148,1,2388,2426,-38,0,49,0,6
69149,1,2455,2311,144,0,16,0,6
69150,1,2202,2447,-245,0,101,0,6
69151,2,2403,2308,95,0,13,1,6
69152,1,2403,2440,-37,0,129,1,6
69153,1,2694,2268,426,0,200,0,6
69154,2,2414,2494,-80,0,45,0,6
69155,2,2335,2529,-194,0,110,0,6
69156,1,2469,2594,-125,0,48,0,6
69157,2,2349,2547,-198,0,106,0,6
69158,2,2380,2420,-40,0,343,0,6
69159,2,2305,2482,-177,0,200,1,6
69160,1,2495,2403,92,0,62,0,6
69161,1,2474,2371,103,0,455,0,6
69162,1,2606,2456,150,0,306,0,6
69163,3,2409,2606,-197,0,306,0,6
69164,2,2365,2476,-111,0,115,1,6
69165,2,2416,2572,-156,0,46,1,6
69166,1,2483,2346,137,0,225,1,6
69167,1,2437,2484,-47,0,260,1,6
69168,1,2536,2402,134,0,4,0,6
69169,1,2509,2340,169,0,200,1,6
69170,1,2495,2317,178,0,405,0,6
69171,3,2317,2423,-106,0,40,0,6
69172,2,2445,2315,130,0,125,0,6
69173,1,2471,2441,30,0,343,0,6
69174,2,2477,2354,123,0,253,0,6
69175,1,2455,2324,131,0,36,1,6
69176,1,2430,2419,11,0,147,0,8
69177,2,2327,2416,-89,0,45,0,6
69178,2,2309,2407,-98,0,310,0,6
69179,1,2447,2370,77,0,45,1,8
69180,1,2431,2447,-16,0,101,0,6
69181,1,2466,2512,-46,0,153,0,6
69182,2,2381,2496,-115,0,108,0,6
69183,1,2446,2309,137,0,101,0,6
69184,1,2453,2447,6,0,10,0,6
69185,1,2524,2584,-60,0,300,1,6
69186,2,2388,2425,-37,0,0,0,6
69187,2,2281,2434,-153,0,55,0,6
69188,1,2470,2414,56,0,4,0,6
69189,2,2461,2384,77,0,211,0,6
69190,1,2567,2633,-66,0,150,0,6
69191,2,2429,2409,20,0,105,0,6
69192,2,2420,2311,109,0,113,0,6
69193,1,2441,2323,118,0,40,0,6
69194,2,2566,2518,48,0,181,0,6
69195,2,2261,2405,-144,4,190,1,13
69196,2,2415,2463,-48,0,460,0,6
69197,1,2354,2402,-48,0,453,0,6
69198,1,2248,2404,-156,0,61,1,6
69199,2,2445,2358,87,0,107,0,6
69200,1,2428,2421,7,0,207,0,6
69201,2,2369,2427,-58,0,255,1,8
69202,2,2405,2372,33,4,102,1,13
69203,1,2408,2338,70,0,112,0,6
69204,1,2449,2354,95,0,8,0,6
69205,2,2427,2410,17,0,345,1,6
69206,1,2478,2302,176,0,123,0,6
69207,2,2436,2500,-64,0,102,0,6
69208,2,2453,2282,171,0,192,0,6
69209,1,2476,2341,135,0,456,0,6
69210,3,2452,2458,-6,0,262,0,6
69211,2,2523,2412,111,0,278,0,6
69212,3,2358,2450,-92,0,125,0,6
69213,1,2401,2283,118,0,260,0,6
69214,2,2457,2529,-72,0,327,0,6
69215,1,2357,2403,-46,0,37,0,6
69216,1,2428,2326,102,4,335,0,13
69217,2,2276,2412,-136,0,246,0,6
69218,1,2603,2412,191,0,0,0,6
69219,1,2552,2545,7,0,62,0,6
69220,2,2438,2385,53,0,41,0,6
69221,1,2343,2430,-87,0,133,0,6
69222,1,2654,2575,79,0,352,1,6
69223,2,2399,2413,-14,0,115,0,6
69224,2,2311,2439,-128,0,30,0,6
69225,2,2361,2407,-46,0,123,0,6
69226,1,2448,2335,113,0,345,1,6
69227,2,2361,2475,-114,0,127,0,6
69228,3,2441,2323,118,0,90,0,6
69229,1,2627,2451,176,0,57,0,6
69230,1,2480,2233,247,0,4,0,6
69231,1,2505,2694,-189,0,80,0,6
69232,1,2436,2486,-50,0,4,0,6
69233,1,2445,2500,-55,0,133,0,6
69234,1,2362,2470,-108,0,40,0,6
69235,1,2422,2278,144,0,0,0,6
69236,2,2325,2498,-173,0,300,0,6
69237,1,2525,2560,-35,0,191,1,6
69238,2,2365,2445,-80,0,365,0,6
69239,1,2441,2459,-18,0,303,1,6
69240,1,2599,2254,345,0,85,0,8
69241,1,2421,2464,-43,0,255,0,6
69242,1,2458,2410,48,0,48,0,6
69243,2,2434,2299,135,0,101,1,6
69244,1,2698,2218,480,0,111,1,6
69245,2,2267,2410,-143,0,101,0,6
69246,3,2502,2289,213,0,45,0,6
69247,2,2391,2415,-24,0,307,1,6
69248,3,2572,2531,41,0,103,0,6
69249,1,2630,2442,188,0,343,0,6
69250,1,2332,2412,-80,0,0,0,6
69251,2,2399,2454,-55,0,38,0,6
69252,1,2404,2423,-19,0,121,0,6
69253,2,2409,2312,97,0,132,0,6
69254,1,2255,2413,-158,0,54,0,6
69255,2,2325,2411,-86,0,300,0,8
69256,2,2460,2394,66,0,313,0,6
69257,1,2330,2413,-83,0,302,0,6
69258,2,2256,2411,-155,0,115,0,6
69259,2,2408,2358,50,0,300,0,6
69260,1,2481,2572,-91,0,331,0,6
69261,2,2273,2532,-259,0,117,0,6
69262,2,2555,2537,18,0,312,1,6
69263,1,2378,2480,-102,0,101,1,6
69264,2,2452,2337,115,0,485,0,6
69265,3,2504,2425,79,0,40,0,6
69266,1,2441,2280,161,0,207,0,6
69267,1,2644,2292,352,2,153,0,24
69268,1,2448,2434,14,0,311,1,6
69269,3,2418,2257,161,0,302,0,6
69270,1,2637,2360,277,0,113,1,6
69272,2,2781,2738,43,0,295,0,6
69273,1,2445,2413,32,0,268,0,6
69274,3,2376,2454,-78,0,34,0,6
69275,1,2439,2633,-194,0,7,0,6
69276,3,2393,2421,-28,0,206,0,6
69277,1,2533,2431,102,0,122,0,6
69278,1,2272,2427,-155,0,330,0,6
69279,1,2419,2314,105,0,190,0,6
69280,2,2412,2237,175,0,313,1,6
69281,2,2431,2438,-7,0,45,0,6
69282,1,2423,2267,156,0,414,0,6
69283,1,2439,2452,-13,0,7,0,6
69284,1,2542,2597,-55,0,12,0,6
69285,2,2350,2563,-213,0,106,0,6
69286,1,2457,2611,-154,0,310,0,6
69287,1,2514,2516,-2,0,490,0,6
69288,2,2571,2685,-114,0,80,0,6
69289,1,2440,2321,119,0,218,0,6
69290,1,2534,2294,240,0,40,0,6
69291,1,2404,2528,-124,0,265,1,6
69292,2,2416,2433,-17,0,302,0,6
69293,2,2336,2400,-64,0,331,0,6
69294,2,2455,2352,103,0,373,0,6
69295,2,2400,2462,-62,0,400,0,6
69296,2,2304,2410,-106,0,202,0,6
69297,1,2482,2370,112,0,8,0,6
69298,1,2493,2454,39,0,440,0,6
69299,1,2510,2353,157,0,245,1,8
69300,2,2447,2518,-71,0,45,0,6
69301,1,2417,2427,-10,0,133,0,6
69302,1,2554,2531,23,0,181,1,6
69303,2,2423,2417,6,0,140,1,6
69304,1,2500,2488,12,0,480,1,6
69305,1,2337,2445,-108,0,102,0,6
69306,3,2280,2405,-125,0,343,0,6
69307,2,2405,2312,93,0,150,0,6
69308,2,2471,2350,121,0,255,0,8
69309,2,2249,2501,-252,0,300,0,6
69310,2,2386,2503,-117,0,57,0,6
69311,1,2498,2624,-126,0,301,1,6
69312,2,2415,2601,-186,0,4,0,8
69313,2,2420,2415,5,0,45,0,6
69314,1,2465,2442,23,0,375,0,6
69315,1,2420,2376,44,0,241,0,6
69316,1,2523,2448,75,0,210,0,6
69317,2,2469,2327,142,0,8,0,6
69318,1,2420,2394,26,0,57,0,6
69319,2,2322,2433,-111,4,110,1,13
69320,1,2572,2531,41,0,0,0,6
69321,1,2467,2395,72,0,105,1,6
69322,2,2366,2445,-79,0,45,0,6
69323,3,2446,2547,-101,0,245,0,6
69324,1,2453,2326,127,0,311,0,6
69325,1,2401,2220,181,0,343,1,6
69326,3,2366,2567,-201,0,45,0,6
69327,3,2426,2463,-37,0,0,0,6
69328,2,2411,2413,-2,0,130,0,6
69329,2,2443,2520,-77,0,330,0,6
69330,2,2745,2775,-30,0,453,0,6
69331,2,2416,2426,-10,0,46,0,6
69332,1,2459,2310,149,0,301,0,6
69333,1,2317,2426,-109,0,295,1,6
69334,1,2264,2440,-176,0,101,0,6
69335,1,2293,2413,-120,0,101,0,6
69336,2,2463,2701,-238,0,48,1,6
69337,2,2405,2497,-92,0,218,1,6
69338,1,2457,2428,29,0,405,0,6
69339,1,2429,2464,-35,0,45,1,6
69340,1,2658,2612,46,0,324,1,6
69341,1,2453,2337,116,0,156,1,6
69342,2,2292,2536,-244,0,50,0,6
69343,2,2340,2600,-260,0,107,0,6
69344,2,2427,2465,-38,0,315,1,6
69345,2,2245,2404,-159,0,46,0,6
69346,2,2408,2450,-42,0,112,1,6
69347,1,2437,2347,90,0,337,0,6
69348,1,2780,2740,40,0,295,0,6
69349,2,2568,2443,125,0,41,1,6
69350,2,2635,2526,109,0,28,1,6
69351,1,2507,2574,-67,0,40,1,6
69352,1,2366,2486,-120,0,115,1,6
69353,1,2449,2382,67,0,201,1,6
69354,2,2448,2498,-50,0,207,1,6
69355,2,2421,2593,-172,0,102,0,6
69356,3,2305,2414,-109,0,105,0,6
69357,2,2360,2405,-45,0,15,0,6
69358,2,2377,2405,-28,0,222,0,6
69359,1,2263,2415,-152,0,310,0,8
69360,2,2442,2309,133,0,485,0,6
69361,2,2437,2298,139,4,335,0,13
69362,2,2591,2549,42,0,105,0,6
69363,3,2520,2316,204,0,153,0,6
69364,1,2307,2403,-96,4,300,0,13
69365,1,2462,2302,160,0,106,1,6
69366,2,2618,2557,61,0,377,0,6
69367,3,2394,2523,-129,0,41,0,6
69368,1,2564,2369,195,0,25,1,6
69369,2,2305,2458,-153,0,21,0,6
69370,1,2426,2358,68,0,335,0,6
69371,1,2421,2393,28,0,335,0,6
69372,2,2483,2505,-22,0,249,0,6
69373,2,2276,2462,-186,4,45,0,13
69374,2,2321,2502,-181,0,405,1,6
69375,1,2423,2418,5,0,292,0,6
69376,2,2412,2253,159,0,103,1,6
69377,2,2285,2402,-117,0,288,0,8
69378,1,2371,2545,-174,0,255,0,6
69379,2,2307,2470,-163,0,1,0,6
69380,2,2419,2355,64,0,5,0,6
69381,1,2524,2448,76,0,306,0,6
69382,1,2603,2496,107,0,107,0,6
69383,1,2488,2248,240,0,311,0,8
69384,2,2565,2559,6,0,151,0,6
69385,1,2514,2205,309,0,110,0,6
69386,3,2504,2249,255,0,302,0,6
69387,2,2290,2539,-249,0,40,1,6
69388,2,2372,2401,-29,0,255,0,6
69389,3,2439,2410,29,0,128,0,6
69390,1,2463,2474,-11,0,4,1,6
69391,2,2527,2785,-258,0,25,0,6
69393,2,2342,2517,-175,0,240,0,6
69394,2,2415,2461,-46,0,5,0,6
69395,1,2412,2279,133,0,4,0,8
69396,2,2410,2350,60,0,302,0,6
69397,2,2423,2304,119,0,40,1,6
69398,1,2379,2431,-52,0,140,0,6
69399,2,2458,2380,78,0,46,0,6
69400,2,2607,2663,-56,0,7,0,6
69401,1,2550,2422,128,0,400,0,6
69402,2,2470,2440,30,0,307,0,6
69403,1,2300,2414,-114,0,202,0,6
69404,2,2348,2412,-64,0,12,0,6
69405,3,2343,2408,-65,0,310,0,6
69406,1,2413,2429,-16,0,46,1,6
69407,2,2402,2514,-112,0,104,0,6
69408,1,2431,2604,-173,0,5,0,8
69409,3,2565,2627,-62,0,141,0,6
69410,2,2534,2568,-34,0,0,0,6
69411,3,2451,2554,-103,0,4,0,6
69412,1,2407,2242,165,0,302,0,6
69413,2,2358,2407,-49,0,15,1,8
69414,2,2445,2307,138,0,157,0,6
69415,2,2417,2435,-18,0,113,0,6
69416,1,2517,2386,131,0,121,0,6
69417,2,2358,2437,-79,0,80,0,6
69418,1,2600,2674,-74,0,6,0,6
69419,1,2365,2502,-137,0,4,1,6
69420,2,2430,2396,34,0,58,0,6
69421,2,2404,2242,162,0,176,0,8
69422,2,2403,2282,121,0,260,0,6
69423,1,2503,2442,61,0,434,0,6
69424,2,2411,2410,1,0,130,1,6
69425,1,2422,2463,-41,0,297,0,6
69426,2,2499,2454,45,0,190,0,6
69427,2,2411,2334,77,0,302,0,6
69428,2,2520,2529,-9,0,0,0,6
69429,2,2444,2433,11,0,241,0,6
69430,1,2555,2584,-29,0,5,0,6
69431,2,2511,2477,34,0,335,0,6
69432,2,2404,2377,27,0,207,0,6
69433,2,2457,2249,208,0,242,1,6
69434,1,2518,2343,175,0,336,0,6
69435,2,2567,2538,29,0,320,0,6
69436,2,2366,2612,-246,0,107,1,6
69437,2,2353,2535,-182,0,245,0,6
69438,1,2461,2309,152,0,107,0,6
69439,2,2455,2403,52,0,159,1,6
69440,1,2417,2343,74,0,142,0,6
69441,1,2668,2602,66,0,325,0,6
69442,1,2465,2461,4,0,301,0,6
69443,2,2383,2439,-56,0,107,0,6
69444,3,2787,2525,262,0,116,0,6
69445,2,2406,2299,107,0,49,1,8
69446,1,2404,2425,-21,0,40,1,6
69447,2,2474,2639,-165,0,200,0,6
69448,1,2414,2316,98,0,101,1,6
69449,2,2689,2651,38,0,210,0,6
69450,2,2510,2333,177,0,352,0,6
69451,1,2301,2429,-128,4,300,0,13
69452,2,2300,2435,-135,0,389,0,6
69453,1,2353,2405,-52,0,454,0,6
69454,2,2425,2518,-93,0,45,0,6
69455,2,2239,2410,-171,0,46,0,6
69456,2,2315,2437,-122,0,146,0,6
69457,2,2573,2529,44,0,103,0,6
69458,1,2446,2402,44,0,142,0,6
69459,1,2543,2415,128,0,202,1,6
69460,2,2436,2508,-72,0,207,0,6
69461,2,2318,2594,-276,0,113,1,6
69462,1,2338,2408,-70,0,245,0,6
69463,2,2253,2516,-263,0,40,0,6
69464,2,2203,2500,-297,0,3,0,6
69465,1,2602,2398,204,0,1,0,6
69466,3,2400,2277,123,0,43,0,6
69467,2,2325,2404,-79,0,118,1,6
69468,2,2349,2436,-87,4,300,0,13
69469,1,2411,2438,-27,0,0,0,6
69470,1,2493,2514,-21,0,118,0,6
69472,1,2372,2403,-31,0,203,0,6
69473,1,2361,2449,-88,0,463,0,6
69474,2,2426,2407,19,0,265,1,6
69475,2,2461,2535,-74,0,46,0,6
69476,1,2373,2432,-59,0,130,0,6
69477,1,2344,2403,-59,0,45,0,6
69478,1,2431,2423,8,0,152,1,6
69479,1,2402,2424,-22,0,217,1,6
69480,2,2666,2607,59,0,112,0,6
69481,2,2538,2453,85,0,41,1,6
69482,1,2521,2412,109,0,28,0,6
69483,2,2412,2354,58,0,228,0,8
69484,1,2484,2504,-20,0,247,0,6
69485,2,2364,2420,-56,0,122,0,6
69486,2,2346,2421,-75,0,140,1,6
69487,2,2598,2683,-85,0,4,0,6
69488,2,2384,2551,-167,0,41,0,6
69489,2,2441,2465,-24,0,300,1,6
69490,3,2658,2784,-126,0,125,0,6
69491,1,2628,2614,14,0,106,1,6
69492,1,2544,2379,165,0,122,1,6
69493,1,2342,2419,-77,0,100,1,6
69494,1,2566,2526,40,0,245,0,6
69495,1,2444,2350,94,0,335,0,6
69496,1,2340,2448,-108,0,148,0,6
69497,2,2378,2437,-59,0,133,0,6
69498,3,2527,2398,129,0,122,0,6
69499,2,2304,2460,-156,0,21,1,6
69500,2,2596,2322,274,0,439,1,8
69501,2,2341,2453,-112,0,0,1,6
69502,2,2561,2605,-44,0,61,0,6
69503,1,2288,2459,-171,0,120,0,6
69504,2,2494,2410,84,0,110,0,6
69505,2,2513,2430,83,0,434,0,6
69506,2,2290,2656,-366,2,122,0,24
69507,2,2262,2409,-147,0,389,0,6
69508,1,2438,2272,166,0,90,0,6
69509,1,2596,2312,284,0,38,1,6
69510,1,2401,2354,47,0,374,0,6
69511,1,2521,2572,-51,0,45,0,6
69512,1,2451,2443,8,0,190,1,6
69513,1,2345,2541,-196,0,112,1,6
69514,2,2453,2396,57,0,13,0,6
69515,2,2578,2562,16,0,246,0,6
69516,2,2418,2324,94,0,151,0,8
69517,1,2411,2395,16,0,331,0,6
69518,2,2535,2597,-62,0,40,0,6
69519,1,2539,2713,-174,0,311,1,6
69520,1,2477,2456,21,0,335,0,6
69521,2,2323,2448,-125,0,241,0,6
69522,1,2318,2510,-192,0,409,0,6
69523,1,2323,2465,-142,0,45,1,6
69524,1,2626,2606,20,0,28,0,6
69525,1,2409,2447,-38,0,44,0,6
69526,1,2456,2429,27,0,83,0,6
69527,1,2508,2499,9,0,463,0,6
69528,2,2346,2525,-179,0,131,0,6
69529,2,2530,2408,122,0,40,1,6
69530,2,2614,2659,-45,0,6,1,6
69531,2,2419,2397,22,0,80,0,6
69532,1,2359,2418,-59,0,202,0,6
69533,1,2498,2490,8,0,480,1,6
69534,2,2460,2557,-97,0,10,0,6
69535,1,2442,2296,146,0,108,0,6
69536,3,2596,2541,55,0,9,0,6
69537,1,2310,2425,-115,0,16,0,6
69538,3,2432,2417,15,0,100,0,6
69539,1,2413,2328,85,0,335,0,6
69540,2,2593,2576,17,0,7,0,6
69541,2,2418,2466,-48,0,107,0,6
69542,2,2388,2470,-82,0,325,0,6
69543,1,2687,2525,162,0,210,0,6
69544,2,2400,2451,-51,0,140,1,6
69545,3,2376,2547,-171,0,23,0,6
69546,1,2436,2402,34,0,300,0,6
69547,2,2370,2480,-110,0,61,0,6
69548,1,2609,2633,-24,0,310,1,6
69549,1,2347,2509,-162,0,169,0,6
69550,1,2447,2398,49,0,122,0,6
69551,1,2468,2422,46,0,315,1,6
69552,2,2321,2419,-98,0,123,1,6
69553,2,2610,2556,54,0,113,0,6
69554,2,2450,2441,9,0,15,1,6
69555,1,2417,2373,44,0,302,0,6
69556,2,2313,2404,-91,0,380,1,6
69557,1,2401,2287,114,0,115,1,6
69558,1,2416,2403,13,0,267,0,6
69559,1,2404,2356,48,0,277,0,6
69560,2,2457,2500,-43,0,13,0,6
69561,1,2452,2294,158,0,36,0,6
69562,3,2582,2588,-6,0,373,0,6
69563,2,2408,2337,71,0,4,0,6
69564,2,2431,2446,-15,0,302,0,6
69565,2,2417,2341,76,0,466,0,6
69566,2,2416,2307,109,0,203,1,6
69567,1,2439,2506,-67,0,207,0,6
69568,2,2742,2718,24,0,190,0,6
69569,2,2403,2474,-71,0,6,0,6
69570,2,2471,2384,87,0,46,0,6
69571,2,2572,2503,69,0,106,0,6
69572,2,2413,2522,-109,0,210,0,6
69573,2,2306,2598,-292,0,39,1,6
69574,2,2350,2463,-113,0,1,0,6
69575,1,2668,2548,120,0,15,0,6
69576,1,2437,2285,152,0,46,0,6
69577,1,2533,2295,238,0,306,1,6
69578,2,2334,2413,-79,0,4,0,6
69579,3,2456,2602,-146,0,100,0,6
69580,2,2522,2457,65,0,302,0,6
69581,1,2415,2349,66,0,14,1,6
69582,1,2441,2311,130,0,284,0,6
69583,1,2418,2351,67,0,45,0,6
69584,1,2412,2365,47,0,345,0,6
69585,2,2383,2521,-138,0,0,0,6
69586,2,2416,2453,-37,0,49,0,6
69587,2,2664,2609,55,0,112,0,6
69588,2,2418,2484,-66,0,241,0,6
69589,1,2615,2531,84,0,429,0,6
69590,2,2421,2564,-143,0,106,1,6
69591,2,2460,2423,37,0,5,1,6
69592,2,2324,2410,-86,0,40,0,6
69593,1,2604,2576,28,0,190,1,6
69594,2,2389,2457,-68,0,106,0,6
69595,2,2380,2452,-72,0,103,1,6
69596,1,2586,2309,277,0,10,1,8
69597,1,2499,2462,37,0,413,0,6
69598,2,2346,2418,-72,0,45,0,6
69599,2,2467,2423,44,0,483,1,6
69600,2,2441,2487,-46,0,45,0,6
69601,2,2343,2454,-111,0,241,0,6
69602,2,2347,2422,-75,0,54,0,6
69603,1,2445,2395,50,0,140,0,6
69604,3,2544,2484,60,0,325,0,6
69605,1,2318,2409,-91,0,107,1,6
69606,1,2431,2351,80,0,250,0,6
69607,1,2502,2450,52,0,45,0,6
69608,2,2447,2464,-17,0,267,0,6
69609,2,2408,2368,40,0,46,0,6
69610,2,2376,2422,-46,0,2,0,6
69611,2,2365,2405,-40,0,110,0,6
69612,1,2404,2292,112,0,415,0,8
69613,1,2404,2319,85,0,331,0,6
69614,2,2311,2477,-166,0,301,1,6
69615,1,2724,2705,19,0,211,0,6
69616,1,2452,2298,154,0,4,0,6
69617,3,2479,2525,-46,0,255,0,6
69618,1,2443,2327,116,0,8,0,6
69619,1,2565,2492,73,0,150,0,6
69620,2,2463,2442,21,0,40,0,6
69621,2,2462,2455,7,0,41,0,6
69622,1,2427,2384,43,0,45,0,6
69623,1,2452,2267,185,0,222,0,6
69624,1,2464,2587,-123,0,315,0,6
69625,2,2417,2473,-56,0,153,1,6
69626,1,2313,2451,-138,0,119,0,8
69627,2,2452,2425,27,0,210,1,6
69628,1,2458,2391,67,0,4,0,6
69629,1,2293,2535,-242,0,0,0,6
69630,1,2545,2326,219,0,122,0,6
69631,1,2400,2217,183,4,461,0,13
69632,2,2430,2206,224,0,8,0,6
69633,3,2544,2409,135,0,409,0,6
69634,3,2458,2345,113,0,80,0,6
69635,1,2489,2361,128,0,146,1,6
69636,2,2282,2441,-159,0,118,0,6
69637,2,2526,2414,112,0,122,1,6
69638,1,2464,2358,106,0,210,1,6
69639,1,2417,2432,-15,0,0,0,6
69640,2,2434,2557,-123,0,133,1,6
69641,1,2782,2735,47,0,140,0,6
69642,1,2418,2353,65,0,107,0,6
69643,2,2344,2451,-107,0,211,1,6
69644,1,2421,2313,108,4,332,1,13
69645,2,2361,2417,-56,0,200,0,6
69646,1,2660,2633,27,0,125,0,6
69647,1,2616,2657,-41,0,1,0,6
69648,1,2455,2247,208,0,313,0,6
69649,2,2526,2620,-94,0,106,0,6
69650,2,2422,2455,-33,0,469,0,6
69652,2,2444,2279,165,0,45,0,6
69653,2,2445,2268,177,0,65,0,6
69654,1,2418,2420,-2,0,105,0,6
69655,1,2570,2319,251,0,96,0,6
69656,2,2470,2441,29,0,426,0,6
69657,2,2456,2445,11,0,211,1,6
69658,2,2461,2464,-3,0,13,0,6
69659,3,2457,2504,-47,0,73,0,6
69660,2,2699,2729,-30,0,0,1,6
69661,2,2414,2360,54,0,50,0,6
69662,2,2473,2493,-20,0,190,1,6
69663,1,2270,2427,-157,0,40,0,6
69664,2,2609,2474,135,0,172,0,6
69665,2,2406,2378,28,0,253,0,6
69666,1,2472,2402,70,0,138,0,6
69667,1,2379,2403,-24,0,152,0,6
69668,2,2472,2432,40,0,140,0,6
69669,3,2549,2622,-73,0,302,0,6
69670,2,2387,2580,-193,0,326,0,6
69671,2,2390,2463,-73,0,153,0,6
69672,2,2524,2480,44,0,325,1,6
69673,1,2461,2436,25,0,18,1,6
69674,1,2346,2526,-180,0,113,1,6
69675,2,2421,2356,65,0,81,0,6
69676,1,2450,2285,165,0,113,1,6
69677,2,2357,2421,-64,0,124,0,6
69678,1,2579,2450,129,0,46,1,6
69679,2,2422,2325,97,0,48,1,6
69680,1,2402,2286,116,0,122,0,6
69681,1,2317,2574,-257,0,45,1,6
69682,3,2300,2431,-131,0,41,0,6
69683,2,2237,2406,-169,0,354,0,6
69684,2,2448,2456,-8,0,106,0,6
69685,1,2441,2377,64,0,4,0,6
69686,2,2600,2555,45,0,0,0,6
69687,3,2487,2480,7,0,110,0,6
69688,1,2446,2570,-124,0,15,0,6
69689,1,2493,2424,69,0,122,0,6
69690,2,2257,2409,-152,0,107,1,6
69691,2,2730,2787,-57,0,112,1,6
69692,1,2446,2261,185,0,15,0,6
69693,2,2507,2543,-36,0,45,0,6
69694,2,2275,2409,-134,0,6,0,6
69695,1,2624,2522,102,0,427,0,6
69696,2,2305,2437,-132,0,101,0,6
69697,2,2432,2542,-110,0,302,0,6
69698,1,2437,2257,180,0,152,0,6
69699,1,2335,2468,-133,0,307,0,6
69700,1,2234,2447,-213,0,463,1,6
69701,1,2650,2622,28,0,112,1,6
69702,2,2461,2417,44,0,487,0,6
69703,1,2438,2466,-28,0,43,0,6
69704,1,2419,2354,65,0,302,1,6
69705,1,2411,2455,-44,0,294,0,6
69706,2,2414,2424,-10,0,277,0,6
69707,1,2469,2408,61,0,96,0,6
69708,2,2456,2396,60,0,21,0,6
69709,2,2289,2408,-119,0,288,0,8
69710,1,2456,2339,117,0,46,0,6
69711,2,2565,2561,4,0,130,1,6
69713,2,2468,2421,47,0,130,0,6
69714,1,2426,2423,3,0,100,0,6
69715,1,2397,2477,-80,0,13,0,6
69716,1,2424,2348,76,0,470,1,6
69717,1,2429,2408,21,0,190,1,6
69718,2,2271,2449,-178,0,315,1,6
69719,2,2386,2450,-64,0,102,0,6
69720,2,2284,2402,-118,0,338,0,6
69721,1,2502,2449,53,0,400,0,6
69722,1,2400,2216,184,0,302,0,6
69723,1,2335,2460,-125,0,58,0,6
69724,3,2304,2453,-149,0,43,0,6
69725,1,2432,2320,112,0,459,0,6
69726,1,2559,2326,233,0,0,1,6
69727,1,2453,2485,-32,0,14,0,6
69728,2,2517,2514,3,0,312,0,6
69729,1,2446,2562,-116,0,15,0,6
69730,2,2254,2440,-186,0,308,0,6
69731,2,2314,2456,-142,0,50,0,6
69732,2,2466,2355,111,0,335,0,6
69733,2,2415,2368,47,0,41,0,6
69734,1,2502,2346,156,0,330,0,6
69735,1,2666,2267,399,2,147,0,24
69736,1,2546,2486,60,0,325,0,6
69737,2,2518,2334,184,0,41,0,6
69738,1,2428,2426,2,0,46,0,6
69739,2,2792,2724,68,0,101,0,6
69740,1,2338,2467,-129,0,123,1,6
69741,1,2445,2439,6,0,45,0,6
69742,1,2460,2356,104,0,466,0,6
69743,1,2548,2497,51,0,45,0,6
69744,1,2289,2440,-151,0,456,0,6
69745,2,2403,2554,-151,0,151,0,6
69746,2,2460,2313,147,0,190,1,6
69747,3,2621,2583,38,0,406,0,6
69748,1,2412,2457,-45,0,414,0,6
69749,3,2413,2410,3,0,122,0,6
69750,2,2417,2424,-7,0,115,0,6
69751,1,2442,2296,146,0,106,0,6
69752,2,2368,2403,-35,0,80,0,6
69753,1,2449,2510,-61,0,288,0,6
69754,1,2264,2427,-163,0,46,0,6
69755,2,2474,2419,55,0,107,1,6
69756,2,2617,2656,-39,0,4,1,6
69757,1,2459,2318,141,0,455,0,6
69758,2,2518,2589,-71,0,15,1,6
69759,2,2461,2470,-9,0,380,0,6
69760,2,2404,2433,-29,0,0,0,6
69761,2,2343,2437,-94,0,436,0,6
69762,1,2383,2456,-73,0,150,0,6
69763,1,2374,2444,-70,0,258,0,6
69764,2,2428,2487,-59,0,106,0,6
69765,1,2530,2581,-51,0,112,1,6
69766,2,2555,2559,-4,0,267,1,6
69767,2,2403,2435,-32,0,315,0,6
69768,1,2444,2455,-11,0,415,0,6
69769,1,2452,2411,41,0,9,0,6
69770,1,2409,2456,-47,0,48,0,6
69771,1,2322,2429,-107,0,241,0,6
69772,2,2282,2428,-146,0,122,0,6
69773,1,2432,2324,108,0,35,0,6
69774,1,2334,2453,-119,0,152,0,6
69775,3,2732,2785,-53,0,405,0,6
69776,2,2333,2509,-176,0,46,0,6
69777,2,2344,2451,-107,0,186,0,6
69778,2,2417,2450,-33,0,45,0,6
69779,2,2432,2460,-28,0,484,0,6
69780,2,2422,2416,6,0,112,0,6
69781,2,2479,2363,116,0,300,0,6
69782,2,2324,2563,-239,0,40,0,6
69783,1,2418,2547,-129,0,327,0,6
69784,1,2520,2472,48,0,124,0,6
69785,2,2390,2533,-143,0,85,0,6
69786,1,2468,2313,155,0,41,1,6
69787,1,2437,2319,118,0,41,1,6
69788,2,2448,2475,-27,0,49,0,6
69789,3,2265,2400,-135,0,4,0,6
69790,1,2482,2478,4,0,250,0,6
69791,1,2328,2432,-104,0,28,1,6
69792,2,2412,2328,84,0,343,0,8
69793,1,2582,2433,149,0,454,0,6
69794,1,2411,2393,18,0,40,0,6
69795,1,2423,2492,-69,0,244,1,6
69796,1,2567,2381,186,0,381,0,6
69797,1,2519,2412,107,0,122,1,6
69798,1,2503,2631,-128,0,41,0,6
69799,2,2346,2452,-106,0,307,0,6
69800,1,2324,2529,-205,0,103,1,6
69801,1,2492,2413,79,0,107,1,6
69802,3,2434,2386,48,0,386,0,6
69803,1,2406,2280,126,0,190,1,6
69804,1,2408,2280,128,0,140,0,6
69805,2,2285,2455,-170,0,130,0,6
69806,1,2261,2425,-164,0,150,0,6
69807,1,2482,2334,148,0,41,0,6
69808,1,2452,2349,103,0,321,0,6
69809,2,2419,2464,-45,0,378,1,6
69810,1,2274,2455,-181,0,167,1,6
69811,2,2432,2340,92,0,470,0,6
69812,2,2267,2427,-160,0,101,0,6
69813,1,2661,2612,49,0,112,0,6
69814,1,2609,2468,141,0,337,0,6
69815,1,2513,2330,183,0,302,0,6
69816,1,2293,2455,-162,0,102,1,6
69817,3,2420,2361,59,0,48,0,8
69818,1,2482,2300,182,4,133,0,13
69819,1,2440,2398,42,0,190,0,6
69820,2,2361,2497,-136,0,15,0,6
69821,2,2384,2400,-16,0,324,0,6
69822,1,2449,2217,232,0,125,0,6
69823,3,2407,2223,184,0,108,0,6
69824,1,2593,2586,7,0,47,0,6
69825,1,2565,2549,16,0,130,0,6
69826,2,2384,2605,-221,0,427,0,6
69827,1,2440,2328,112,0,8,0,6
69828,2,2784,2733,51,0,46,0,6
69829,3,2410,2379,31,0,90,0,6
69830,1,2458,2504,-46,0,20,0,6
69831,1,2566,2456,110,0,307,0,6
69832,1,2521,2326,195,0,300,0,6
69833,2,2467,2291,176,0,250,0,6
69834,1,2525,2303,222,0,111,0,6
69835,1,2516,2436,80,0,269,1,6
69836,2,2406,2416,-10,0,374,0,6
69837,1,2449,2426,23,0,120,0,6
69838,2,2261,2419,-158,0,310,0,6
69839,1,2376,2424,-48,4,230,0,13
69840,2,2234,2412,-178,0,102,0,6
69841,2,2442,2574,-132,0,110,1,6
69842,1,2451,2431,20,0,409,1,6
69843,2,2246,2738,-492,0,40,0,6
69844,1,2448,2450,-2,0,15,0,6
69845,2,2311,2464,-153,0,1,1,6
69846,2,2370,2456,-86,0,140,0,6
69847,3,2513,2613,-100,0,216,0,6
69848,2,2355,2459,-104,0,331,0,6
69849,1,2608,2380,228,0,45,0,6
69850,2,2264,2675,-411,2,45,0,24
69851,1,2516,2236,280,0,40,0,6
69853,1,2624,2492,132,0,28,1,6
69854,2,2544,2571,-27,0,253,0,6
69855,1,2511,2463,48,0,301,0,6
69856,2,2441,2387,54,0,258,0,6
69857,1,2516,2294,222,0,46,0,6
69858,2,2362,2528,-166,0,106,0,6
69859,1,2422,2435,-13,0,202,1,6
69860,2,2499,2479,20,0,105,1,6
69861,1,2429,2539,-110,0,221,0,6
69862,2,2473,2471,2,0,110,0,6
69863,2,2570,2589,-19,0,418,1,6
69864,2,2314,2447,-133,0,113,0,6
69865,2,2431,2433,-2,0,70,0,6
69866,2,2421,2455,-34,0,86,0,6
69867,1,2398,2491,-93,0,240,0,6
69868,3,2374,2457,-83,0,152,0,6
69869,2,2311,2487,-176,0,21,0,6
69871,2,2297,2408,-111,0,335,0,6
69872,2,2438,2314,124,0,104,0,8
69873,3,2317,2441,-124,0,3,0,6
69874,2,2607,2666,-59,0,4,0,6
69875,1,2430,2496,-66,0,429,0,6
69876,1,2376,2400,-24,0,200,0,6
69877,2,2565,2673,-108,0,45,0,6
69878,1,2446,2269,177,0,240,1,6
69879,2,2498,2465,33,0,60,1,6
69880,1,2460,2416,44,0,150,0,6
69881,1,2487,2283,204,0,210,0,6
69882,2,2444,2455,-11,0,207,1,6
69883,1,2447,2267,180,0,133,0,6
69884,1,2308,2403,-95,0,202,0,6
69885,2,2424,2402,22,0,288,0,6
69886,2,2452,2362,90,0,107,1,6
69887,2,2573,2553,20,0,394,0,6
69888,3,2226,2526,-300,0,46,0,6
69889,1,2463,2287,176,0,7,1,6
69890,1,2308,2401,-93,0,120,1,6
69891,1,2386,2427,-41,0,11,0,6
69892,1,2435,2308,127,0,140,0,6
69893,3,2292,2518,-226,0,46,0,6
69894,3,2533,2542,-9,0,486,0,6
69895,1,2527,2506,21,0,121,0,6
69896,3,2642,2658,-16,0,190,0,6
69897,1,2552,2552,0,0,409,0,6
69898,2,2321,2404,-83,0,41,0,6
69899,1,2469,2443,26,0,202,0,6
69900,1,2439,2409,30,0,140,0,6
69901,2,2553,2607,-54,0,101,0,6
69902,1,2445,2307,138,0,131,0,6
69904,1,2360,2469,-109,0,131,1,6
69905,2,2308,2410,-102,0,122,0,6
69906,1,2531,2207,324,0,100,0,6
69907,2,2411,2465,-54,0,375,0,6
69908,1,2490,2366,124,0,250,0,6
69909,1,2467,2437,30,0,458,0,6
69910,2,2414,2456,-42,0,411,0,6
69911,2,2438,2389,49,0,225,0,6
69912,1,2460,2611,-151,0,300,0,6
69913,1,2432,2399,33,0,10,0,6
69914,1,2376,2425,-49,0,190,0,6
69915,1,2677,2550,127,0,353,0,6
69916,3,2658,2533,125,0,310,0,6
69917,1,2542,2525,17,0,302,0,6
69918,2,2322,2517,-195,0,268,0,6
69919,1,2409,2490,-81,0,148,0,6
69920,1,2406,2377,29,0,115,1,6
69921,1,2501,2548,-47,0,101,0,6
69922,2,2612,2533,79,0,247,0,6
69923,2,2465,2437,28,0,20,1,6
69924,1,2425,2359,66,0,345,1,6
69925,2,2439,2464,-25,0,440,0,6
69926,2,2368,2426,-58,0,128,1,6
69927,3,2627,2515,112,0,28,0,6
69928,2,2412,2268,144,0,122,0,6
69929,1,2444,2348,96,0,327,0,6
69930,1,2453,2464,-11,0,15,0,6
69931,1,2671,2603,68,0,112,1,6
69932,1,2468,2453,15,0,487,0,6
69933,2,2422,2360,62,0,333,0,6
69934,1,2507,2221,286,0,240,0,6
69935,1,2448,2450,-2,0,4,0,6
69936,2,2395,2430,-35,0,140,0,6
69937,2,2520,2359,161,0,331,1,6
69938,1,2426,2334,92,0,374,0,6
69939,1,2559,2563,-4,0,41,0,6
69940,2,2304,2495,-191,0,106,0,6
69941,2,2304,2448,-144,0,455,0,6
69942,1,2537,2385,152,0,302,0,6
69943,3,2468,2417,51,0,45,0,6
69944,1,2603,2488,115,0,311,1,6
69945,1,2304,2414,-110,0,48,0,6
69946,1,2547,2535,12,0,40,0,6
69947,2,2541,2509,32,0,121,0,6
69948,1,2520,2382,138,0,0,0,6
69949,1,2470,2406,64,0,31,0,6
69950,1,2410,2279,131,0,139,0,6
69951,1,2439,2461,-22,0,394,0,6
69952,1,2642,2444,198,0,123,1,6
69953,2,2558,2547,11,0,474,0,6
69954,2,2466,2358,108,0,8,0,6
69955,3,2519,2542,-23,0,46,0,6
69956,2,2470,2436,34,0,315,0,6
69957,1,2445,2325,120,0,100,0,6
69958,2,2537,2681,-144,0,100,0,6
69959,1,2515,2295,220,0,46,0,6
69960,1,2442,2471,-29,0,130,0,6
69961,1,2450,2408,42,0,150,0,6
69962,1,2333,2417,-84,0,121,1,6
69963,2,2424,2429,-5,0,112,0,6
69964,1,2275,2411,-136,0,288,0,8
69965,1,2431,2374,57,0,456,0,6
69966,2,2372,2413,-41,0,200,0,6
69967,2,2272,2431,-159,0,466,0,8
69968,1,2555,2565,-10,0,394,0,6
69969,1,2491,2472,19,0,335,0,6
69970,1,2300,2417,-117,0,125,0,6
69971,1,2484,2384,100,0,405,0,6
69972,1,2387,2533,-146,0,40,0,6
69973,2,2301,2439,-138,0,320,1,6
69974,2,2418,2367,51,0,107,0,6
69975,2,2445,2240,205,0,7,0,6
69976,1,2432,2483,-51,0,221,0,6
69977,2,2245,2535,-290,0,382,0,6
69978,1,2516,2552,-36,0,115,0,6
69979,2,2381,2402,-21,0,107,0,6
69980,2,2302,2494,-192,0,180,0,6
69981,1,2578,2418,160,0,5,1,6
69982,2,2361,2486,-125,4,338,0,13
69983,1,2417,2493,-76,0,127,0,6
69984,1,2465,2494,-29,0,325,0,6
69985,2,2387,2457,-70,0,483,0,8
69986,2,2362,2459,-97,0,175,0,6
69987,1,2520,2406,114,0,80,1,6
69988,2,2370,2498,-128,0,107,1,6
69989,2,2462,2462,0,0,432,0,6
69990,3,2454,2522,-68,0,102,0,6
69991,1,2469,2311,158,0,302,0,6
69992,2,2436,2390,46,0,23,1,6
69993,2,2350,2402,-52,0,20,0,8
69994,1,2314,2430,-116,0,101,0,6
69995,1,2451,2489,-38,0,45,0,6
69996,1,2740,2626,114,0,241,0,6
69997,1,2445,2359,86,0,454,1,6
69998,1,2518,2312,206,0,41,0,6
69999,2,2287,2459,-172,0,132,0,6
70000,1,2684,2526,158,0,0,0,6
70001,1,2421,2375,46,0,41,0,6
70002,2,2414,2412,2,0,48,0,6
70003,1,2449,2373,76,0,241,0,6
70004,2,2598,2676,-78,0,1,1,6
70005,2,2262,2524,-262,0,103,0,6
70006,1,2467,2264,203,0,45,0,6
70007,2,2597,2517,80,0,104,0,6
70008,1,2444,2418,26,0,110,0,6
70009,2,2406,2553,-147,0,45,0,6
70010,2,2441,2553,-112,0,265,0,6
70011,1,2403,2401,2,0,117,0,6
70012,2,2409,2511,-102,0,5,0,6
70013,1,2414,2454,-40,0,49,1,6
70014,1,2607,2442,165,0,312,0,6
70015,2,2515,2418,97,0,49,0,6
70016,2,2380,2527,-147,0,405,0,6
70017,2,2331,2444,-113,0,120,0,6
70018,2,2467,2439,28,0,238,0,6
70019,2,2431,2262,169,0,0,0,6
70020,2,2452,2526,-74,0,103,0,6
70021,2,2332,2437,-105,0,48,0,6
70022,2,2557,2657,-100,0,154,0,6
70023,1,2522,2538,-16,0,316,0,6
70024,2,2532,2437,95,0,205,0,6
70025,2,2546,2524,22,0,9,0,6
70026,1,2462,2407,55,0,0,0,8
70027,2,2488,2497,-9,0,250,0,6
70028,2,2471,2438,33,0,107,0,6
70029,1,2541,2486,55,0,45,1,6
70030,2,2448,2367,81,0,302,0,6
70031,2,2205,2490,-285,0,4,1,6
70032,2,2622,2592,30,0,13,1,6
70033,2,2486,2506,-20,0,411,0,6
70034,2,2309,2520,-211,0,301,0,6
70035,1,2417,2364,53,0,107,0,6
70036,2,2530,2379,151,0,211,1,6
70037,2,2455,2540,-85,0,112,0,6
70038,2,2243,2596,-353,0,320,0,6
70039,1,2438,2595,-157,0,200,0,6
70040,2,2581,2424,157,0,7,0,6
70041,1,2422,2398,24,0,438,0,6
70042,1,2442,2383,59,0,242,0,6
70043,3,2261,2502,-241,0,106,0,6
70044,2,2407,2366,41,0,45,1,6
70045,1,2410,2357,53,0,40,0,6
70046,1,2497,2307,190,0,101,1,6
70047,1,2564,2265,299,0,315,1,6
70048,1,2445,2646,-201,0,151,0,6
70049,1,2516,2473,43,0,46,0,6
70050,3,2443,2336,107,0,373,0,6
70051,1,2301,2414,-113,0,414,0,6
70052,1,2525,2376,149,0,111,0,6
70053,2,2473,2461,12,0,343,0,6
70054,2,2445,2463,-18,0,172,1,6
70055,2,2515,2688,-173,0,25,0,6
70056,1,2358,2470,-112,0,140,0,6
70057,1,2488,2330,158,0,404,0,6
70058,1,2744,2603,141,0,215,1,6
70059,1,2392,2448,-56,0,226,0,6
70060,2,2438,2587,-149,0,112,0,6
70061,1,2441,2353,88,0,373,0,6
70062,3,2661,2528,133,0,308,0,6
70063,2,2328,2523,-195,0,40,1,6
70064,1,2524,2508,16,0,103,1,6
70065,2,2369,2454,-85,0,100,0,6
70066,3,2434,2451,-17,0,241,0,8
70067,2,2425,2456,-31,0,2,1,6
70068,1,2531,2559,-28,0,250,0,6
70069,2,2507,2462,45,0,210,0,6
70070,1,2429,2377,52,0,200,0,6
70071,1,2573,2478,95,0,5,1,6
70072,2,2449,2238,211,0,206,0,6
70073,1,2530,2361,169,0,0,0,6
70074,1,2499,2317,182,0,222,1,6
70075,1,2448,2284,164,0,151,0,6
70076,2,2420,2523,-103,0,286,0,6
70077,1,2435,2454,-19,0,41,1,6
70078,1,2527,2544,-17,0,115,0,6
70079,2,2407,2409,-2,0,405,0,6
70080,1,2453,2522,-69,0,131,0,6
70081,2,2387,2530,-143,0,43,0,6
70082,2,2637,2659,-22,0,190,0,6
70083,1,2502,2483,19,0,325,0,6
70084,2,2248,2528,-280,0,41,0,6
70085,1,2444,2450,-6,0,414,1,6
70086,1,2691,2506,185,0,406,0,6
70087,1,2374,2521,-147,0,476,0,6
70088,2,2323,2441,-118,0,260,0,6
70089,2,2481,2283,198,4,456,0,13
70090,2,2254,2403,-149,0,315,1,8
70091,3,2262,2470,-208,0,117,0,6
70092,1,2497,2694,-197,0,130,1,6
70093,1,2456,2287,169,0,466,0,6
70094,2,2289,2448,-159,0,463,0,6
70095,1,2481,2428,53,0,456,0,6
70096,1,2289,2530,-241,0,0,0,6
70097,2,2482,2546,-64,0,145,0,6
70098,2,2492,2447,45,0,48,0,6
70099,2,2359,2417,-58,0,0,1,6
70100,1,2598,2616,-18,0,107,0,6
70101,1,2402,2355,47,0,45,1,6
70102,2,2422,2319,103,0,133,0,6
70103,3,2420,2540,-120,0,40,0,6
70104,1,2533,2299,234,0,0,0,6
70105,1,2428,2211,217,0,27,0,6
70106,1,2592,2448,144,0,245,0,6
70107,1,2557,2460,97,0,49,1,6
70108,1,2531,2553,-22,0,485,0,6
70109,1,2435,2485,-50,0,167,0,6
70110,1,2263,2566,-303,0,46,0,6
70111,1,2366,2415,-49,0,192,1,6
70112,1,2364,2469,-105,0,132,0,6
70114,1,2665,2533,132,0,365,0,6
70115,3,2413,2450,-37,0,104,0,6
70116,1,2467,2401,66,0,373,1,6
70117,2,2331,2503,-172,0,253,0,8
70118,2,2403,2632,-229,0,45,0,6
70119,2,2314,2467,-153,0,336,1,6
70120,1,2457,2415,42,0,46,0,6
70121,3,2420,2322,98,0,151,0,6
70122,1,2587,2466,121,0,1,0,6
70123,1,2526,2325,201,0,41,0,6
70124,2,2420,2537,-117,0,200,0,6
70125,1,2461,2314,147,0,0,1,6
70126,1,2347,2502,-155,0,4,0,6
70127,2,2534,2668,-134,0,196,0,6
70128,1,2439,2484,-45,0,43,0,6
70129,3,2373,2492,-119,0,46,0,6
70130,2,2365,2434,-69,0,140,1,6
70131,1,2401,2223,178,0,302,0,8
70132,2,2503,2393,110,0,315,0,6
70133,2,2536,2280,256,0,0,0,6
70134,1,2285,2436,-151,0,114,0,6
70135,2,2247,2449,-202,0,313,0,6
70136,3,2377,2440,-63,0,150,0,6
70137,2,2223,2401,-178,4,120,0,13
70138,2,2375,2458,-83,0,0,0,6
70139,1,2477,2441,36,0,13,0,6
70140,2,2521,2451,70,0,225,0,6
70141,1,2523,2552,-29,0,106,0,6
70142,2,2336,2400,-64,0,21,0,6
70143,1,2513,2578,-65,0,326,1,6
70144,1,2474,2600,-126,0,7,1,6
70145,1,2422,2401,21,0,107,0,6
70146,1,2634,2561,73,0,246,0,6
70147,2,2456,2516,-60,0,131,0,6
70148,1,2477,2295,182,0,309,0,6
70149,1,2748,2591,157,0,40,1,6
70150,2,2459,2423,36,0,101,0,6
70151,1,2477,2508,-31,0,302,0,6
70152,3,2559,2425,134,0,250,0,6
70153,1,2454,2486,-32,0,10,1,6
70154,1,2454,2444,10,0,33,0,6
70155,1,2453,2450,3,0,221,0,6
70156,1,2382,2430,-48,0,426,0,6
70157,2,2478,2441,37,0,245,0,6
70158,1,2557,2386,171,0,7,0,6
70159,2,2468,2262,206,0,41,0,6
70160,1,2467,2298,169,0,125,0,6
70161,3,2597,2446,151,0,110,0,6
70162,3,2599,2537,62,0,106,0,6
70163,1,2551,2477,74,0,45,0,6
70164,1,2681,2594,87,0,112,0,6
70165,2,2604,2445,159,0,261,0,6
70166,1,2415,2273,142,0,101,0,6
70167,1,2448,2472,-24,0,167,0,6
70168,2,2327,2422,-95,0,215,0,6
70169,1,2451,2354,97,0,5,0,6
70170,2,2461,2323,138,0,45,0,6
70171,3,2451,2303,148,0,113,0,8
70172,1,2412,2345,67,0,132,0,6
70173,2,2314,2434,-120,0,140,0,8
70174,2,2541,2416,125,0,142,0,6
70175,1,2672,2524,148,0,365,0,6
70176,1,2520,2530,-10,0,0,0,6
70177,1,2229,2402,-173,0,301,0,8
70178,2,2455,2462,-7,0,127,1,6
70179,1,2539,2598,-59,0,330,0,6
70180,2,2438,2403,35,0,395,1,6
70181,1,2460,2529,-69,0,8,0,6
70182,1,2300,2471,-171,0,253,0,6
70183,1,2510,2221,289,0,61,0,6
70184,1,2436,2471,-35,0,80,0,6
70185,3,2319,2490,-171,4,45,0,13
70186,2,2640,2560,80,0,100,0,6
70187,2,2465,2483,-18,0,0,0,6
70188,1,2326,2462,-136,0,0,0,6
70189,2,2468,2210,258,0,306,0,6
70190,1,2370,2486,-116,0,4,0,6
70191,1,2367,2460,-93,0,159,0,6
70192,1,2445,2315,130,0,81,0,6
70193,2,2382,2514,-132,0,41,0,6
70194,2,2322,2529,-207,0,40,1,6
70195,2,2480,2495,-15,0,468,0,6
70196,1,2334,2426,-92,0,105,0,6
70197,2,2287,2439,-152,0,114,0,6
70198,3,2447,2323,124,0,7,0,6
70199,2,2392,2527,-135,0,457,1,6
70200,1,2292,2458,-166,0,262,1,6
70201,1,2521,2526,-5,0,121,0,6
70202,2,2524,2676,-152,0,150,0,6
70203,2,2429,2448,-19,0,485,0,6
70204,1,2482,2470,12,0,125,0,6
70205,1,2401,2325,76,0,292,1,6
70207,2,2370,2428,-58,0,40,0,6
70208,1,2424,2339,85,0,130,0,6
70209,1,2335,2467,-132,0,121,0,8
70210,1,2370,2456,-86,0,112,1,6
70211,3,2453,2571,-118,0,110,0,6
70212,2,2349,2409,-60,0,302,1,6
70213,2,2520,2389,131,0,301,0,6
70214,2,2472,2556,-84,0,141,0,6
70215,1,2502,2484,18,0,435,0,6
70216,1,2592,2482,110,0,0,0,6
70217,2,2271,2459,-188,0,145,0,6
70218,3,2427,2556,-129,0,253,0,6
70219,1,2523,2358,165,0,188,1,6
70220,1,2453,2386,67,0,110,0,6
70221,1,2588,2520,68,0,302,0,6
70222,1,2449,2414,35,0,110,1,6
70223,1,2467,2595,-128,0,4,0,6
70224,1,2488,2367,121,0,151,0,6
70225,1,2474,2471,3,0,43,0,6
70226,1,2518,2459,59,0,124,0,6
70227,2,2461,2407,54,0,11,0,6
70228,2,2355,2448,-93,0,113,0,6
70229,1,2424,2289,135,0,315,0,6
70230,1,2458,2453,5,0,241,0,6
70231,2,2617,2751,-134,0,382,0,6
70232,1,2466,2323,143,0,133,0,6
70233,2,2351,2633,-282,0,151,0,6
70234,2,2567,2548,19,0,48,0,6
70235,1,2222,2438,-216,0,241,1,6
70236,2,2277,2416,-139,0,134,0,6
70237,1,2589,2685,-96,0,1,0,6
70238,2,2361,2505,-144,0,222,0,6
70239,2,2334,2428,-94,0,454,0,6
70240,3,2439,2322,117,0,110,0,6
70241,3,2403,2224,179,4,306,0,13
70242,2,2294,2523,-229,0,41,0,6
70243,1,2455,2424,31,0,101,0,6
70244,1,2400,2416,-16,0,45,1,6
70245,3,2591,2526,65,0,45,0,6
70246,2,2521,2381,140,0,301,1,6
70247,1,2458,2546,-88,0,110,1,6
70248,2,2422,2565,-143,0,49,0,6
70249,1,2449,2404,45,0,249,1,8
70250,1,2378,2429,-51,0,115,1,6
70251,1,2462,2334,128,0,112,0,6
70252,2,2419,2509,-90,0,245,0,6
70253,1,2442,2307,135,0,122,0,6
70254,2,2527,2530,-3,0,43,0,6
70255,1,2452,2378,74,0,410,0,6
70256,3,2569,2479,90,0,5,0,6
70257,1,2466,2318,148,0,468,0,6
70258,1,2452,2336,116,0,406,1,6
70259,2,2269,2419,-150,0,49,0,6
70260,2,2468,2449,19,0,303,0,6
70261,1,2498,2284,214,0,80,0,6
70262,1,2492,2281,211,0,127,0,6
70263,1,2433,2432,1,0,34,0,6
70264,1,2560,2468,92,0,45,0,6
70265,1,2450,2388,62,0,106,0,6
70266,2,2525,2530,-5,0,102,1,6
70267,1,2463,2465,-2,0,80,0,6
70268,1,2479,2442,37,0,14,1,6
70269,2,2531,2319,212,0,41,0,6
70270,2,2469,2475,-6,0,487,0,6
70271,1,2538,2425,113,0,40,0,6
70272,2,2465,2488,-23,0,106,0,6
70273,2,2522,2501,21,0,16,0,6
70274,2,2635,2521,114,0,123,1,6
70275,1,2679,2561,118,0,474,0,6
70276,3,2448,2375,73,0,267,0,6
70277,2,2596,2460,136,0,117,0,6
70278,1,2433,2386,47,0,43,0,6
70279,1,2229,2446,-217,0,43,0,6
70280,2,2478,2592,-114,0,4,0,6
70281,2,2506,2455,51,0,460,0,6
70282,1,2321,2405,-84,0,6,1,6
70283,2,2420,2460,-40,0,217,0,6
70284,3,2462,2268,194,0,0,0,6
70285,1,2308,2403,-95,0,190,0,6
70286,1,2469,2317,152,0,112,0,6
70287,1,2508,2209,299,0,41,1,8
70288,2,2389,2590,-201,0,101,0,6
70289,1,2528,2465,63,0,201,0,6
70290,1,2539,2513,26,0,9,0,6
70291,2,2515,2512,3,0,48,0,6
70292,2,2506,2443,63,0,113,0,6
70293,3,2682,2261,421,2,147,0,24
70294,2,2478,2448,30,0,140,0,6
70295,2,2561,2314,247,0,0,1,6
70296,1,2396,2432,-36,0,474,0,6
70297,2,2526,2467,59,0,200,1,6
70298,3,2725,2641,84,0,101,0,6
70299,2,2414,2473,-59,0,45,0,6
70300,1,2430,2210,220,0,302,0,8
70301,2,2587,2691,-104,0,80,0,6
70302,1,2507,2555,-48,0,45,0,6
70303,3,2409,2454,-45,0,242,0,6
70304,2,2419,2518,-99,0,244,0,6
70306,2,2397,2452,-55,0,160,0,6
70307,2,2278,2501,-223,0,40,0,6
70308,2,2427,2480,-53,0,484,0,6
70309,2,2509,2590,-81,0,41,0,6
70310,1,2507,2469,38,0,60,0,6
70311,1,2387,2463,-76,0,104,1,6
70312,2,2252,2457,-205,0,0,0,6
70313,1,2678,2597,81,0,112,0,6
70314,2,2374,2523,-149,0,109,1,6
70315,2,2450,2438,12,0,133,0,6
70316,1,2437,2460,-23,0,202,0,6
70317,1,2453,2315,138,0,123,1,6
70318,1,2439,2339,100,0,20,0,6
70319,1,2536,2359,177,0,0,0,6
70320,2,2383,2520,-137,0,4,1,6
70321,1,2408,2266,142,0,310,0,6
70322,2,2529,2755,-226,0,16,0,6
70323,1,2568,2455,113,0,8,0,6
70324,2,2593,2339,254,0,300,0,6
70325,2,2361,2455,-94,0,262,0,6
70326,3,2291,2523,-232,0,117,0,6
70327,2,2469,2395,74,0,375,0,6
70328,1,2528,2443,85,0,123,0,6
70329,1,2454,2627,-173,0,151,0,6
70330,1,2520,2420,100,0,133,1,6
70331,1,2409,2414,-5,4,45,0,13
70332,2,2309,2426,-117,0,464,0,6
70333,1,2449,2363,86,0,4,0,6
70334,3,2536,2534,2,0,242,0,6
70335,1,2548,2522,26,0,40,0,6
70337,2,2244,2459,-215,4,311,0,13
70338,3,2429,2552,-123,0,253,0,6
70339,1,2596,2505,91,0,315,1,6
70340,3,2588,2474,114,0,108,0,6
70341,1,2534,2439,95,0,121,0,6
70342,2,2536,2533,3,0,152,0,6
70343,2,2421,2422,-1,0,457,0,6
70344,2,2227,2416,-189,0,130,0,6
70345,2,2384,2453,-69,0,40,0,6
70346,2,2464,2564,-100,0,141,1,6
70347,2,2484,2333,151,0,203,0,6
70348,3,2507,2437,70,0,46,0,6
70349,1,2388,2484,-96,0,131,0,6
70350,1,2449,2291,158,0,13,0,6
70351,2,2235,2488,-253,0,110,0,6
70352,1,2438,2255,183,0,101,0,6
70353,2,2357,2499,-142,0,153,1,6
70354,2,2503,2476,27,0,106,0,6
70355,1,2538,2418,120,0,310,0,6
70356,1,2568,2409,159,0,423,0,6
70357,2,2481,2300,181,0,313,0,6
70358,1,2317,2423,-106,0,109,0,6
70359,1,2506,2595,-89,0,331,0,6
70361,1,2523,2324,199,0,111,0,6
70362,2,2412,2454,-42,0,301,1,6
70363,1,2454,2540,-86,0,83,0,6
70364,1,2467,2453,14,0,330,0,6
70365,1,2328,2406,-78,0,190,0,6
70366,3,2557,2522,35,0,483,0,6
70367,2,2271,2401,-130,0,89,0,6
70368,2,2477,2512,-35,0,245,0,6
70369,1,2642,2724,-82,0,133,1,6
70370,1,2486,2387,99,0,373,0,6
70371,1,2678,2584,94,0,325,0,6
70372,1,2539,2311,228,0,0,0,6
70373,1,2472,2499,-27,0,140,1,6
70374,1,2735,2583,152,0,216,0,6
70375,1,2432,2206,226,0,107,1,6
70376,1,2457,2329,128,0,53,0,6
70377,2,2343,2519,-176,0,130,1,6
70378,2,2592,2682,-90,0,4,1,6
70379,3,2619,2554,65,0,250,0,6
70380,1,2514,2463,51,0,107,0,6
70381,2,2539,2558,-19,0,244,0,6
70382,1,2459,2276,183,0,277,0,6
70383,2,2444,2462,-18,0,249,0,6
70384,2,2358,2444,-86,0,311,0,6
70385,2,2453,2542,-89,0,4,0,6
70386,3,2549,2431,118,0,250,0,6
70387,2,2346,2526,-180,0,25,0,6
70388,1,2430,2300,130,0,145,0,6
70389,1,2402,2346,56,0,414,0,6
70390,1,2407,2278,129,0,255,0,8
70391,1,2456,2451,5,0,15,0,6
70392,1,2553,2394,159,0,45,0,6
70393,2,2449,2320,129,0,112,1,6
70394,2,2268,2415,-147,0,25,0,6
70395,1,2519,2333,186,0,306,0,6
70396,1,2399,2419,-20,0,454,0,6
70397,1,2467,2335,132,0,57,0,6
70398,1,2539,2545,-6,0,115,0,6
70399,1,2682,2530,152,0,43,0,6
70400,2,2397,2579,-182,0,40,0,6
70401,1,2757,2531,226,0,345,0,6
70402,2,2328,2479,-151,0,200,0,6
70403,2,2553,2236,317,0,7,0,6
70404,1,2475,2586,-111,0,4,0,6
70405,2,2383,2490,-107,0,46,0,6
70406,2,2320,2441,-121,0,143,0,6
70407,2,2366,2497,-131,0,4,0,6
70408,2,2519,2518,1,0,106,0,6
70409,1,2442,2428,14,0,212,0,6
70410,1,2354,2434,-80,0,268,0,6
70411,2,2438,2601,-163,0,46,1,6
70412,1,2482,2542,-60,0,105,0,6
70413,2,2419,2310,109,0,335,0,6
70414,1,2485,2468,17,0,16,1,6
70415,1,2539,2336,203,0,9,0,6
70416,3,2361,2462,-101,0,45,0,6
70417,1,2533,2426,107,0,45,1,6
70418,2,2461,2386,75,0,46,0,6
70419,1,2363,2437,-74,0,111,1,6
70420,2,2506,2406,100,0,330,1,6
70421,1,2588,2525,63,0,110,0,6
70422,3,2411,2303,108,0,172,0,6
70423,1,2454,2409,45,0,3,0,6
70424,2,2568,2460,108,0,45,1,6
70425,2,2335,2473,-138,0,242,0,6
70426,1,2455,2301,154,0,335,1,6
70427,1,2459,2203,256,0,404,0,6
70428,1,2582,2394,188,0,1,0,6
70429,1,2413,2234,179,0,125,0,6
70430,1,2223,2519,-296,0,344,0,6
70431,1,2518,2472,46,0,386,1,6
70432,2,2530,2507,23,0,107,0,6
70433,1,2523,2542,-19,0,301,0,6
70434,1,2320,2483,-163,0,200,1,6
70435,2,2485,2455,30,0,485,0,6
70436,3,2405,2460,-55,0,218,0,6
70437,1,2372,2407,-35,0,43,0,6
70438,2,2468,2407,61,0,375,0,6
70439,1,2579,2483,96,0,4,0,6
70440,2,2695,2526,169,0,112,0,6
70441,2,2501,2513,-12,0,400,0,6
70442,1,2579,2738,-159,0,45,0,6
70443,1,2455,2208,247,0,100,0,6
70444,2,2359,2494,-135,0,241,0,6
70445,1,2525,2522,3,0,302,1,6
70446,1,2487,2334,153,4,115,0,13
70447,1,2337,2432,-95,0,83,0,8
70448,1,2448,2514,-66,0,131,0,6
70450,1,2534,2542,-8,0,201,0,6
70451,1,2564,2396,168,0,302,1,6
70452,1,2365,2478,-113,0,143,0,6
70453,1,2330,2522,-192,0,0,1,6
70454,3,2406,2542,-136,0,112,0,6
70455,2,2293,2430,-137,0,0,0,6
70456,3,2687,2588,99,0,112,0,6
70457,2,2244,2739,-495,0,306,0,6
70458,2,2606,2593,13,0,395,0,6
70459,2,2529,2358,171,0,123,1,6
70460,2,2462,2531,-69,0,223,0,6
70461,1,2528,2652,-124,0,61,0,6
70462,1,2510,2360,150,0,4,0,6
70463,2,2323,2572,-249,0,409,1,6
70464,1,2477,2321,156,0,46,0,6
70465,2,2447,2473,-26,0,14,1,6
70467,2,2446,2493,-47,0,100,0,6
70468,2,2529,2454,75,0,301,0,6
70469,2,2427,2338,89,0,330,0,6
70470,1,2343,2400,-57,4,110,0,13
70471,1,2490,2526,-36,0,105,0,6
70472,3,2390,2556,-166,0,113,0,6
70473,2,2393,2411,-18,0,101,0,6
70474,1,2358,2441,-83,0,6,0,6
70475,1,2527,2391,136,0,110,0,6
70476,1,2585,2618,-33,0,1,0,6
70477,1,2536,2402,134,0,122,0,6
70478,1,2421,2461,-40,0,158,1,6
70479,2,2265,2496,-231,0,40,0,6
70480,2,2520,2295,225,0,0,0,6
70481,2,2415,2301,114,0,13,0,6
70482,2,2536,2557,-21,0,4,0,6
70483,2,2425,2416,9,0,202,0,6
70484,1,2368,2460,-92,0,15,0,6
70485,2,2335,2539,-204,0,152,0,6
70486,1,2396,2471,-75,0,110,0,6
70487,2,2410,2456,-46,0,1,0,6
70488,2,2317,2481,-164,0,112,0,6
70489,1,2545,2685,-140,0,485,0,6
70490,2,2569,2617,-48,0,278,0,6
70491,2,2280,2424,-144,0,143,1,6
70492,1,2512,2436,76,0,310,0,6
70493,2,2604,2435,169,0,130,0,6
70494,1,2536,2526,10,0,145,0,6
70495,1,2407,2372,35,0,455,0,6
70496,1,2409,2471,-62,0,325,1,6
70497,2,2401,2378,23,0,310,1,6
70499,3,2476,2457,19,0,46,0,6
70500,2,2644,2536,108,0,277,0,6
70501,2,2458,2259,199,0,223,0,6
70502,3,2547,2495,52,0,113,0,6
70503,1,2476,2381,95,0,46,0,6
70504,1,2498,2422,76,0,108,0,6
70505,1,2599,2457,142,0,15,0,6
70506,1,2562,2530,32,0,43,0,6
70507,2,2512,2530,-18,0,43,1,6
70508,2,2521,2532,-11,0,102,0,6
70509,1,2467,2561,-94,0,190,0,6
70510,2,2225,2427,-202,0,122,0,6
70511,2,2576,2687,-111,0,115,0,6
70512,1,2281,2502,-221,0,207,0,6
70513,2,2415,2522,-107,0,289,1,6
70514,2,2730,2588,142,0,216,0,6
70515,2,2420,2336,84,0,440,1,6
70516,2,2507,2592,-85,0,300,0,6
70517,1,2402,2404,-2,0,245,0,6
70518,2,2467,2523,-56,0,245,0,6
70519,1,2479,2583,-104,0,7,0,6
70520,1,2513,2334,179,0,306,0,6
70521,2,2404,2459,-55,0,331,0,6
70522,1,2461,2328,133,0,45,1,6
70523,1,2434,2289,145,0,200,0,6
70524,2,2394,2491,-97,4,277,0,13
70525,1,2490,2288,202,0,106,0,6
70526,1,2498,2511,-13,0,140,0,6
70527,2,2339,2517,-178,0,0,0,6
70528,3,2514,2322,192,0,311,0,6
70529,1,2475,2340,135,0,46,0,6
70530,1,2428,2499,-71,0,128,0,6
70532,1,2589,2685,-96,0,6,1,6
70533,1,2542,2445,97,0,201,0,6
70534,2,2257,2406,-149,0,80,0,6
70535,2,2268,2505,-237,0,458,0,6
70536,1,2540,2408,132,0,344,0,6
70537,2,2362,2456,-94,0,112,1,6
70538,1,2543,2602,-59,0,45,1,6
70539,2,2457,2399,58,0,123,1,6
70540,1,2601,2422,179,0,201,0,6
70541,2,2538,2276,262,0,7,0,6
70542,2,2349,2516,-167,0,10,0,6
70543,2,2270,2434,-164,0,302,1,6
70544,2,2417,2392,25,0,454,0,6
70546,2,2409,2386,23,0,124,0,6
70547,2,2242,2411,-169,0,35,0,6
70548,1,2430,2294,136,0,57,1,6
70549,1,2498,2530,-32,0,110,0,6
70550,1,2324,2444,-120,0,131,1,6
70551,3,2484,2461,23,0,304,0,6
70552,1,2554,2393,161,0,140,0,6
70553,3,2677,2596,81,0,107,0,6
70554,2,2536,2553,-17,0,302,0,6
70555,2,2413,2372,41,0,337,1,6
70556,2,2691,2594,97,0,190,0,6
70557,1,2504,2567,-63,0,301,1,6
70558,1,2525,2507,18,0,106,0,6
70559,2,2400,2517,-117,0,45,1,6
70560,1,2768,2572,196,0,310,1,6
70561,3,2623,2284,339,0,145,0,6
70562,2,2478,2442,36,0,352,0,6
70563,1,2461,2337,124,0,113,0,6
70564,1,2459,2480,-21,0,373,0,6
70565,2,2453,2353,100,0,151,0,6
70566,2,2328,2448,-120,0,249,1,6
70567,1,2596,2502,94,0,244,0,6
70568,1,2337,2478,-141,0,200,0,6
70569,2,2443,2464,-21,0,302,1,6
70570,2,2528,2463,65,0,476,0,6
70571,3,2289,2435,-146,0,46,0,6
70572,1,2519,2368,151,0,145,1,6
70573,2,2596,2722,-126,0,45,0,6
70574,2,2454,2503,-49,0,156,0,6
70575,1,2378,2546,-168,0,226,0,6
70576,1,2420,2384,36,0,107,1,6
70577,1,2514,2626,-112,0,45,1,6
70578,1,2589,2602,-13,0,319,0,6
70579,2,2514,2544,-30,0,248,0,6
70580,2,2353,2451,-98,0,331,0,6
70581,1,2556,2676,-120,0,48,0,6
70582,3,2442,2383,59,0,140,0,6
70583,1,2455,2332,123,0,315,0,6
70584,1,2494,2519,-25,0,106,0,6
70585,1,2428,2270,158,0,115,0,6
70586,2,2500,2683,-183,0,113,0,6
70587,1,2576,2486,90,0,108,1,6
70588,1,2554,2442,112,0,45,0,6
70589,2,2335,2449,-114,0,326,0,6
70590,1,2413,2337,76,0,490,0,6
70591,3,2343,2459,-116,0,41,0,6
70592,1,2526,2411,115,0,301,0,6
70593,1,2407,2382,25,0,253,0,6
70594,1,2402,2227,175,0,302,1,6
70595,2,2430,2475,-45,0,127,0,6
70596,1,2470,2345,125,0,46,0,6
70597,2,2547,2428,119,0,40,1,6
70598,2,2422,2389,33,0,404,0,6
70599,1,2482,2465,17,0,143,0,6
70600,2,2520,2506,14,0,40,0,6
70601,3,2435,2543,-108,0,253,0,8
70602,3,2409,2254,155,0,101,0,6
70603,1,2414,2316,98,0,315,1,6
70604,2,2256,2564,-308,0,151,0,6
70605,2,2405,2396,9,0,302,0,8
70606,1,2411,2283,128,0,386,0,6
70607,1,2726,2592,134,0,216,0,6
70608,2,2331,2511,-180,0,114,0,6
70609,1,2398,2413,-15,0,185,0,6
70610,2,2492,2447,45,0,438,1,6
70611,3,2297,2488,-191,0,289,0,8
70612,2,2303,2508,-205,0,15,0,6
70613,1,2678,2597,81,0,112,1,6
70614,2,2482,2449,33,0,102,0,6
70615,1,2463,2516,-53,0,221,0,6
70616,2,2405,2544,-139,0,270,0,6
70617,2,2602,2550,52,0,112,0,6
70618,1,2513,2341,172,0,200,0,6
70619,2,2386,2500,-114,0,109,0,6
70620,2,2357,2484,-127,0,15,0,6
70621,1,2438,2306,132,0,202,0,6
70622,2,2461,2524,-63,0,330,0,6
70623,2,2355,2456,-101,0,132,1,6
70624,1,2320,2446,-126,0,45,1,6
70625,1,2426,2486,-60,0,257,1,6
70626,2,2502,2595,-93,0,301,0,6
70627,1,2433,2417,16,0,225,0,6
70628,2,2464,2400,64,0,110,0,6
70629,2,2359,2493,-134,0,4,0,6
70630,2,2469,2521,-52,0,245,0,6
70631,1,2505,2316,189,0,40,0,6
70632,3,2416,2379,37,0,336,0,6
70633,2,2400,2379,21,0,310,1,6
70634,2,2318,2406,-88,0,20,1,6
70635,1,2441,2336,105,0,130,0,6
70636,2,2305,2462,-157,0,102,0,6
70637,1,2498,2349,149,0,54,1,6
70638,1,2465,2438,27,0,400,0,6
70639,2,2484,2529,-45,0,109,0,6
70640,3,2245,2412,-167,0,411,0,6
70641,2,2470,2384,86,0,140,1,6
70642,1,2687,2499,188,0,112,0,6
70643,2,2533,2497,36,0,192,0,6
70644,3,2458,2345,113,0,244,0,6
70645,2,2535,2496,39,0,46,0,6
70646,1,2596,2595,1,0,110,0,6
70647,1,2496,2412,84,0,4,0,6
70648,2,2569,2689,-120,0,4,0,6
70649,2,2516,2300,216,0,200,0,6
70650,2,2511,2504,7,0,0,0,6
70651,2,2537,2771,-234,0,28,0,6
70652,2,2399,2416,-17,0,241,0,6
70653,2,2377,2425,-48,0,121,1,6
70654,1,2341,2474,-133,0,200,1,6
70655,2,2280,2435,-155,0,120,0,6
70656,1,2460,2327,133,0,110,0,6
70657,2,2348,2452,-104,0,45,0,6
70658,1,2409,2326,83,0,120,0,6
70659,1,2407,2372,35,0,46,0,6
70660,3,2297,2491,-194,0,110,0,6
70661,2,2482,2580,-98,0,4,1,6
70662,2,2439,2441,-2,0,103,0,6
70663,2,2405,2415,-10,0,484,1,6
70664,1,2469,2460,9,0,120,0,6
70665,1,2456,2474,-18,0,48,0,6
70666,1,2456,2475,-19,0,49,0,6
70667,2,2326,2450,-124,0,121,1,6
70668,2,2588,2730,-142,0,45,0,6
70669,2,2408,2501,-93,0,0,0,6
70670,1,2619,2512,107,0,219,0,6
70671,1,2542,2493,49,0,250,0,6
70672,1,2448,2472,-24,0,432,0,6
70673,1,2440,2205,235,0,200,0,6
70674,3,2477,2438,39,0,58,0,6
70675,2,2412,2384,28,0,315,0,6
70676,1,2548,2401,147,0,332,0,6
70677,1,2378,2414,-36,0,394,0,6
70678,1,2419,2385,34,0,101,1,6
70679,1,2530,2557,-27,0,312,0,6
70680,2,2322,2418,-96,0,16,0,6
70681,1,2438,2558,-120,0,302,0,6
70682,1,2510,2430,80,0,167,0,6
70683,1,2404,2313,91,0,7,0,6
70684,2,2487,2417,70,0,380,1,6
70685,1,2592,2682,-90,0,301,1,6
70686,2,2301,2407,-106,0,80,0,6
70687,1,2599,2613,-14,0,348,0,6
70688,1,2521,2327,194,0,310,0,6
70690,2,2495,2351,144,4,145,0,13
70691,2,2480,2407,73,0,187,0,6
70692,1,2454,2401,53,0,45,0,6
70693,2,2330,2402,-72,0,188,0,6
70694,1,2526,2465,61,0,386,1,6
70695,2,2406,2457,-51,0,110,0,6
70696,1,2468,2463,5,0,46,1,6
70697,1,2296,2409,-113,0,301,0,6
70698,2,2535,2507,28,0,4,0,6
70699,2,2262,2423,-161,0,335,1,6
70700,1,2405,2270,135,0,45,0,6
70701,2,2438,2369,69,0,106,0,6
70702,1,2504,2502,2,0,133,1,6
70703,1,2539,2384,155,0,46,0,6
70705,1,2456,2432,24,0,400,1,6
70706,2,2279,2421,-142,0,241,1,6
70707,2,2523,2475,48,0,110,0,6
70708,2,2347,2456,-109,0,84,0,6
70709,2,2463,2393,70,0,106,0,6
70710,3,2379,2411,-32,0,192,0,6
70711,3,2540,2437,103,0,250,0,8
70712,2,2409,2385,24,0,200,0,6
70714,2,2336,2555,-219,0,15,1,6
70715,2,2347,2505,-158,0,210,1,6
70716,2,2435,2486,-51,0,100,0,6
70717,1,2479,2349,130,0,453,1,6
70718,2,2510,2453,57,0,131,0,6
70719,1,2435,2505,-70,0,102,0,6
70720,1,2401,2471,-70,0,215,1,6
70721,2,2396,2459,-63,0,16,0,6
70722,2,2221,2403,-182,2,12,0,18
70723,2,2439,2476,-37,0,118,0,6
70724,2,2447,2341,106,0,190,0,6
70725,2,2294,2426,-132,0,426,0,8
70726,1,2439,2396,43,0,334,1,6
70727,3,2235,2459,-224,0,103,0,6
70728,2,2373,2513,-140,0,40,1,6
70729,2,2312,2529,-217,0,130,1,6
70730,3,2490,2536,-46,0,248,0,6
70731,3,2693,2585,108,0,216,0,6
70732,1,2398,2551,-153,0,265,1,6
70733,1,2608,2534,74,0,345,0,6
70734,1,2509,2503,6,0,110,1,6
70735,1,2551,2547,4,0,45,0,6
70736,1,2466,2454,12,0,344,0,6
70737,2,2324,2524,-200,0,46,0,6
70738,1,2420,2338,82,0,438,1,6
70739,2,2402,2403,-1,0,21,1,8
70740,2,2391,2459,-68,0,45,0,6
70741,2,2318,2419,-101,0,131,0,6
70742,2,2407,2349,58,0,33,0,6
70743,2,2453,2496,-43,0,240,0,6
70744,1,2481,2318,163,0,120,0,6
70745,1,2484,2260,224,0,201,0,8
70746,2,2481,2351,130,0,305,0,6
70747,1,2473,2424,49,0,228,0,6
70748,3,2675,2600,75,0,112,0,6
70749,2,2414,2473,-59,0,127,1,6
70750,1,2453,2330,123,0,91,0,6
70751,1,2402,2248,154,0,406,1,8
70752,2,2426,2460,-34,0,101,1,6
70753,2,2462,2402,60,0,45,0,6
70754,2,2498,2393,105,0,0,0,6
70755,1,2442,2292,150,0,106,0,6
70756,2,2410,2380,30,0,336,1,6
70757,1,2542,2557,-15,0,80,0,6
70758,1,2556,2502,54,0,4,0,6
70759,1,2408,2403,5,0,0,1,6
70760,1,2485,2398,87,0,110,0,6
70761,2,2262,2566,-304,0,141,0,6
70762,1,2409,2266,143,0,245,0,6
70763,1,2460,2531,-71,0,245,0,6
70764,1,2371,2520,-149,0,308,1,6
70765,1,2744,2234,510,0,106,0,6
70766,1,2649,2373,276,2,245,0,24
70767,2,2599,2478,121,0,40,0,6
70768,1,2425,2286,139,0,140,1,6
70769,1,2343,2434,-91,0,31,0,6
70770,2,2274,2620,-346,0,248,0,6
70771,1,2364,2541,-177,0,222,0,6
70772,1,2773,2642,131,0,335,1,6
70773,1,2496,2391,105,0,207,0,6
70774,3,2321,2513,-192,0,41,0,6
70775,1,2503,2491,12,0,104,1,6
70776,1,2460,2339,121,0,1,0,6
70777,3,2474,2535,-61,0,48,0,6
70778,2,2458,2426,32,4,111,1,13
70779,1,2283,2456,-173,0,7,0,6
70780,2,2500,2612,-112,0,153,1,6
70781,3,2464,2491,-27,0,45,0,6
70782,1,2517,2400,117,0,225,0,6
70783,1,2508,2551,-43,0,81,0,6
70784,2,2567,2543,24,0,270,0,6
70785,3,2556,2607,-51,0,80,0,6
70786,3,2550,2445,105,0,338,0,6
70787,1,2548,2509,39,0,245,0,6
70788,1,2397,2427,-30,0,400,1,6
70789,1,2428,2314,114,0,120,0,6
70790,2,2505,2529,-24,0,6,0,6
70791,1,2406,2387,19,0,106,0,6
70792,1,2382,2445,-63,0,61,1,6
70793,2,2346,2408,-62,0,4,0,6
70794,2,2464,2467,-3,0,20,1,6
70795,1,2410,2458,-48,0,111,0,8
70796,1,2469,2342,127,0,204,0,6
70797,1,2386,2407,-21,0,183,1,6
70798,1,2497,2692,-195,0,3,1,6
70799,1,2508,2279,229,0,405,0,6
70800,1,2574,2401,173,0,381,0,6
70801,2,2462,2442,20,0,309,1,6
70802,1,2553,2562,-9,0,140,0,6
70803,2,2488,2350,138,0,107,0,6
70804,3,2448,2372,76,0,122,0,6
70805,2,2387,2500,-113,0,404,0,6
70806,2,2333,2425,-92,0,41,1,6
70807,2,2312,2463,-151,0,130,0,6
70808,1,2431,2415,16,0,59,0,6
70809,2,2420,2348,72,0,303,0,6
70810,2,2328,2400,-72,0,156,1,6
70811,2,2557,2515,42,0,300,0,6
70812,2,2321,2521,-200,0,40,0,6
70813,1,2356,2464,-108,0,55,0,6
70814,2,2233,2745,-512,0,4,0,6
70815,2,2438,2203,235,0,38,0,6
70816,2,2491,2431,60,0,440,0,6
70817,2,2601,2674,-73,0,1,0,6
70818,1,2419,2350,69,0,275,0,6
70819,1,2490,2473,17,0,113,0,6
70820,2,2306,2487,-181,4,245,0,13
70821,1,2297,2400,-103,0,345,0,6
70822,3,2413,2364,49,0,130,0,6
70823,1,2394,2468,-74,0,411,0,6
70824,1,2465,2489,-24,0,110,0,6
70825,2,2534,2497,37,0,118,1,6
70826,2,2557,2548,9,0,207,0,6
70827,1,2524,2288,236,0,225,0,6
70828,1,2475,2417,58,0,80,0,6
70829,2,2534,2500,34,0,110,1,6
70830,2,2510,2299,211,0,45,0,6
70831,1,2449,2472,-23,0,432,0,6
70832,2,2310,2437,-127,0,337,0,6
70833,1,2468,2324,144,0,40,1,6
70834,1,2543,2406,137,0,4,0,6
70835,1,2403,2223,180,0,14,0,6
70836,1,2472,2310,162,0,190,0,6
70837,2,2424,2353,71,0,15,1,6
70838,1,2427,2496,-69,0,140,0,6
70839,1,2380,2509,-129,0,40,0,6
70840,2,2485,2390,95,0,0,0,6
70841,1,2447,2292,155,0,1,1,6
70842,1,2382,2411,-29,0,1,0,6
70843,3,2415,2421,-6,0,242,0,6
70844,1,2403,2390,13,0,426,0,6
70845,3,2313,2409,-96,0,104,0,6
70846,1,2386,2440,-54,0,153,0,6
70847,3,2334,2445,-111,0,4,0,6
70848,2,2306,2463,-157,0,27,0,6
70849,1,2524,2467,57,0,386,0,6
70850,1,2591,2478,113,0,487,0,6
70851,1,2504,2345,159,0,246,0,6
70852,1,2457,2392,65,0,45,0,6
70853,2,2408,2455,-47,0,107,0,6
70854,1,2467,2210,257,0,1,0,6
70855,1,2483,2471,12,0,120,0,6
70856,3,2383,2405,-22,0,310,0,6
70857,2,2486,2639,-153,0,7,0,6
70858,1,2411,2324,87,0,241,0,6
70859,3,2488,2403,85,0,15,0,6
70860,1,2246,2533,-287,0,122,0,6
70861,2,2434,2367,67,0,210,0,6
70862,2,2683,2735,-52,0,295,0,6
70863,1,2421,2440,-19,0,258,0,6
70864,2,2355,2404,-49,0,406,0,6
70865,1,2529,2391,138,0,334,0,6
70866,1,2466,2455,11,0,344,0,6
70867,1,2555,2401,154,0,411,1,6
70868,1,2495,2379,116,0,107,1,6
70869,2,2533,2504,29,0,255,1,6
70870,2,2210,2561,-351,0,142,0,6
70871,1,2409,2242,167,0,119,0,8
70872,1,2473,2507,-34,0,57,1,6
70873,1,2608,2458,150,0,301,0,6
70874,2,2207,2478,-271,0,102,0,6
70875,2,2398,2469,-71,0,57,0,6
70876,1,2425,2425,0,0,462,0,6
70877,1,2531,2533,-2,0,106,0,6
70878,3,2402,2397,5,0,300,0,6
70879,3,2490,2499,-9,0,327,0,6
70880,1,2607,2669,-62,0,122,0,6
70881,3,2604,2542,62,0,250,0,6
70882,2,2525,2506,19,0,301,0,6
70883,2,2437,2441,-4,0,1,0,6
70884,2,2401,2384,17,0,140,0,6
70885,1,2560,2577,-17,0,130,0,6
70886,1,2448,2459,-11,0,190,1,6
70887,1,2277,2501,-224,0,1,0,6
70888,2,2416,2397,19,0,207,0,6
70889,1,2558,2514,44,0,253,0,6
70890,1,2509,2393,116,0,317,0,6
70891,1,2679,2596,83,0,112,1,6
70892,1,2521,2436,85,0,47,1,6
70893,2,2373,2421,-48,0,121,0,6
70894,2,2456,2466,-10,0,130,0,6
70895,2,2342,2424,-82,0,250,0,6
70896,3,2397,2468,-71,0,302,0,6
70897,2,2428,2375,53,0,307,0,6
70898,1,2315,2480,-165,0,16,0,6
70899,2,2528,2412,116,0,96,0,6
70900,1,2405,2278,127,0,17,0,6
70901,3,2467,2431,36,0,7,0,6
70902,1,2429,2268,161,0,106,0,6
70903,1,2642,2482,160,0,463,0,6
70904,1,2329,2412,-83,0,485,0,6
70905,2,2462,2529,-67,0,112,0,6
70906,2,2484,2413,71,0,57,1,6
70907,1,2392,2501,-109,0,107,0,6
70908,2,2474,2293,181,0,0,0,6
70909,3,2346,2524,-178,0,260,0,6
70910,2,2429,2379,50,0,115,0,6
70911,1,2397,2486,-89,0,358,0,8
70912,2,2507,2528,-21,0,4,0,6
70913,1,2490,2536,-46,0,43,0,6
70914,2,2564,2514,50,0,147,0,6
70915,1,2390,2505,-115,0,307,0,6
70916,1,2549,2595,-46,0,41,1,6
70917,1,2321,2476,-155,0,45,1,6
70918,1,2306,2417,-111,0,127,0,6
70919,1,2549,2474,75,0,460,1,6
70920,1,2777,2528,249,0,310,0,6
70922,3,2466,2489,-23,0,108,0,6
70923,2,2357,2405,-48,0,225,0,6
70924,1,2529,2404,125,0,218,0,6
70925,2,2280,2449,-169,0,110,0,8
70926,3,2485,2551,-66,0,45,0,6
70927,1,2492,2527,-35,0,106,0,6
70928,2,2462,2458,4,0,40,1,6
70929,1,2506,2361,145,0,138,0,6
70930,1,2446,2467,-21,0,104,0,6
70931,1,2339,2431,-92,0,115,0,6
70932,1,2678,2566,112,0,190,0,6
70933,1,2405,2330,75,0,300,0,6
70934,1,2563,2555,8,0,278,1,6
70935,1,2439,2345,94,0,100,0,6
70936,2,2415,2360,55,0,112,1,6
70937,3,2472,2387,85,0,247,0,6
70938,1,2400,2245,155,0,101,0,6
70939,1,2534,2384,150,0,207,0,6
70940,2,2434,2384,50,0,35,0,6
70941,1,2460,2403,57,0,45,0,6
70942,1,2533,2457,76,0,44,0,6
70943,1,2329,2427,-98,0,335,0,6
70944,1,2434,2360,74,0,17,0,6
70945,2,2373,2480,-107,0,469,0,6
70946,1,2450,2471,-21,0,436,0,6
70947,2,2334,2401,-67,0,272,1,6
70948,2,2403,2409,-6,0,125,0,6
70949,1,2494,2326,168,0,45,1,6
70950,3,2461,2559,-98,0,15,0,6
70951,2,2454,2611,-157,0,335,0,6
70952,2,2460,2547,-87,0,80,0,6
70953,1,2396,2499,-103,0,152,0,6
70954,2,2428,2338,90,0,265,1,6
70955,1,2476,2465,11,0,123,1,6
70956,1,2461,2421,40,0,5,0,6
70957,2,2424,2387,37,0,4,0,6
70958,1,2453,2599,-146,0,192,0,6
70959,1,2521,2465,56,0,41,0,6
70960,1,2562,2617,-55,0,434,0,6
70961,2,2409,2350,59,0,400,1,6
70962,1,2472,2443,29,0,11,0,6
70963,2,2365,2529,-164,0,143,0,6
70964,1,2302,2521,-219,0,41,0,6
70965,3,2222,2422,-200,0,45,0,6
70966,2,2682,2779,-97,0,278,1,6
70967,2,2397,2526,-129,0,405,0,6
70968,1,2445,2426,19,0,16,0,6
70969,2,2398,2526,-128,0,4,0,6
70970,1,2521,2347,174,0,56,0,6
70971,2,2562,2595,-33,0,33,1,6
70972,1,2476,2432,44,0,433,0,6
70973,2,2375,2432,-57,0,101,0,6
70974,3,2363,2500,-137,0,28,0,6
70975,1,2389,2521,-132,0,255,1,6
70976,2,2479,2408,71,0,474,1,6
70977,1,2201,2470,-269,0,102,0,6
70978,1,2662,2289,373,0,40,0,6
70979,1,2517,2462,55,0,40,0,6
70980,2,2333,2417,-84,0,144,0,6
70981,2,2299,2400,-101,0,106,1,6
70982,2,2395,2533,-138,0,152,0,6
70983,2,2393,2524,-131,0,126,0,6
70984,2,2234,2623,-389,0,278,1,6
70985,1,2356,2438,-82,0,0,0,6
70986,2,2479,2554,-75,0,7,0,6
70987,2,2418,2314,104,0,0,0,6
70988,2,2396,2461,-65,0,218,0,6
70989,1,2468,2466,2,0,101,0,6
70990,2,2469,2433,36,0,132,0,6
70991,3,2460,2311,149,0,133,0,6
70992,2,2512,2499,13,0,126,0,6
70993,3,2421,2385,36,0,10,0,6
70994,2,2518,2669,-151,0,278,0,6
70995,2,2252,2416,-164,0,190,0,6
70996,2,2400,2589,-189,0,414,0,6
70997,2,2380,2536,-156,0,483,0,6
70998,1,2533,2501,32,0,359,0,6
70999,2,2464,2450,14,0,105,0,6
71000,1,2461,2526,-65,0,0,0,6
71001,1,2420,2266,154,0,123,1,6
71002,1,2503,2556,-53,0,153,0,6
71003,1,2531,2389,142,0,203,0,6
71004,1,2497,2528,-31,0,400,0,6
71005,2,2491,2464,27,0,34,0,6
71006,1,2410,2201,209,0,253,0,6
71007,1,2487,2410,77,0,215,0,6
71008,1,2394,2453,-59,0,8,0,6
71009,2,2388,2422,-34,0,107,1,6
71010,2,2419,2292,127,0,13,0,6
71011,1,2479,2404,75,0,302,0,8
71012,2,2238,2568,-330,0,122,0,6
71013,2,2358,2403,-45,0,45,1,6
71015,3,2200,2433,-233,0,150,0,6
71016,1,2558,2263,295,0,268,0,6
71017,3,2566,2594,-28,0,140,0,6
71018,1,2459,2409,50,0,81,0,6
71019,2,2405,2225,180,0,0,0,6
71020,3,2388,2467,-79,0,150,0,6
71021,1,2480,2352,128,0,301,0,6
71022,1,2406,2304,102,0,310,0,6
71023,2,2530,2477,53,0,44,0,6
71024,2,2663,2398,265,0,310,0,6
71025,1,2357,2402,-45,0,411,0,6
71026,2,2255,2519,-264,0,5,0,6
71027,1,2394,2468,-74,0,15,1,6
71028,3,2302,2427,-125,0,61,0,6
71029,1,2427,2459,-32,0,44,1,6
71030,1,2592,2389,203,0,125,0,6
71031,2,2477,2441,36,0,459,0,6
71032,2,2540,2463,77,0,268,0,6
71033,2,2345,2421,-76,0,250,0,6
71034,1,2458,2245,213,0,255,0,6
71035,1,2400,2385,15,0,52,0,6
71036,1,2406,2377,29,0,302,0,6
71037,2,2403,2382,21,0,203,0,6
71038,1,2540,2458,82,0,192,0,6
71039,2,2610,2678,-68,0,80,0,6
71040,2,2245,2459,-214,0,105,0,6
71041,2,2328,2456,-128,0,103,0,6
71042,2,2270,2546,-276,0,380,0,6
71043,2,2601,2557,44,0,194,0,6
71044,2,2470,2485,-15,0,10,1,6
71045,1,2402,2494,-92,0,40,0,6
71046,3,2594,2432,162,0,1,0,6
71047,2,2437,2370,67,0,80,0,6
71048,1,2450,2411,39,0,250,0,6
71049,2,2333,2404,-71,0,108,0,6
71050,2,2495,2289,206,0,25,0,6
71051,3,2489,2388,101,0,301,0,6
71052,2,2435,2559,-124,0,1,0,6
71053,3,2392,2592,-200,0,61,0,6
71054,1,2592,2475,117,0,0,0,6
71055,1,2568,2419,149,0,8,1,6
71056,2,2492,2481,11,0,100,0,6
71057,1,2399,2431,-32,0,3,0,6
71058,2,2294,2415,-121,0,5,0,6
71059,2,2452,2463,-11,0,487,1,6
71060,2,2521,2400,121,0,0,0,6
71061,3,2564,2341,223,0,204,0,6
71062,2,2336,2509,-173,0,201,1,6
71063,1,2440,2420,20,0,125,0,6
71064,1,2292,2412,-120,0,40,0,6
71065,1,2497,2401,96,0,45,0,6
71066,1,2396,2406,-10,0,57,0,6
71067,2,2455,2473,-18,0,175,0,6
71068,1,2399,2465,-66,0,261,0,6
71069,1,2403,2352,51,0,253,0,6
71070,1,2672,2515,157,0,123,0,6
71071,1,2359,2545,-186,0,418,1,6
71072,1,2550,2551,-1,0,113,1,6
71073,1,2589,2412,177,0,1,0,6
71074,2,2521,2569,-48,0,453,0,6
71075,1,2505,2299,206,0,225,0,6
71076,2,2325,2423,-98,0,211,0,6
71077,2,2456,2486,-30,0,322,0,6
71078,2,2389,2439,-50,0,133,0,6
71079,2,2549,2513,36,0,375,0,6
71080,1,2323,2410,-87,0,245,1,6
71081,2,2496,2557,-61,0,6,0,6
71082,3,2266,2594,-328,0,492,0,6
71083,2,2335,2503,-168,0,110,0,6
71084,2,2404,2464,-60,0,127,0,6
71086,2,2536,2321,215,0,241,0,6
71087,2,2411,2343,68,0,488,1,6
71088,1,2462,2275,187,0,301,0,6
71089,2,2461,2413,48,0,0,0,6
71090,1,2303,2461,-158,0,300,0,6
71091,2,2309,2410,-101,0,102,0,6
71092,2,2426,2340,86,0,270,1,6
71093,1,2409,2353,56,0,42,1,6
71094,2,2488,2533,-45,0,123,0,6
71095,1,2454,2612,-158,0,335,0,6
71096,2,2453,2484,-31,0,0,0,6
71097,1,2408,2312,96,0,343,0,6
71098,3,2404,2295,109,0,0,0,6
71099,1,2465,2325,140,0,30,0,6
71100,1,2426,2398,28,0,109,0,6
71101,1,2563,2466,97,0,102,0,6
71102,2,2391,2431,-40,0,141,0,6
71103,1,2361,2429,-68,0,191,0,6
71104,2,2386,2426,-40,0,45,0,6
71105,2,2311,2469,-158,0,10,0,6
71106,1,2486,2473,13,0,154,1,6
71107,2,2487,2402,85,0,484,0,6
71108,1,2410,2378,32,0,333,0,6
71109,2,2594,2596,-2,0,241,0,6
71110,1,2489,2228,261,0,40,0,6
71111,1,2331,2430,-99,0,45,0,6
71112,2,2255,2571,-316,0,190,0,6
71113,1,2507,2461,46,0,49,0,6
71114,1,2442,2490,-48,0,41,1,6
71115,3,2508,2412,96,0,267,0,6
71116,1,2308,2507,-199,0,40,0,6
71117,2,2321,2517,-196,0,106,0,6
71118,1,2592,2332,260,0,1,0,6
71119,1,2499,2319,180,0,46,0,6
71120,2,2240,2597,-357,4,288,0,18
71121,1,2484,2465,19,0,436,0,6
71122,2,2384,2408,-24,0,202,0,6
71123,1,2430,2467,-37,0,190,0,6
71124,2,2557,2471,86,0,106,0,6
71125,2,2404,2431,-27,0,4,0,6
71126,2,2538,2483,55,0,211,1,6
71127,3,2567,2420,147,0,42,0,6
71128,2,2325,2408,-83,0,230,0,6
71129,3,2462,2399,63,0,4,0,6
71130,2,2358,2654,-296,0,45,0,6
71131,1,2433,2423,10,0,492,0,6
71132,3,2469,2399,70,0,0,0,6
71133,2,2329,2514,-185,0,474,0,6
71134,2,2372,2451,-79,0,40,0,6
71135,2,2461,2527,-66,0,37,0,6
71136,3,2400,2590,-190,0,49,0,6
71137,1,2604,2462,142,0,301,0,6
71138,2,2562,2491,71,0,45,1,6
71139,1,2271,2472,-201,4,123,0,8
71140,2,2419,2437,-18,0,43,1,6
71141,2,2364,2446,-82,0,45,1,6
71142,2,2469,2479,-10,0,171,0,6
71143,1,2488,2517,-29,0,301,0,6
71144,2,2606,2622,-16,0,300,0,6
71145,2,2523,2543,-20,0,175,0,6
71146,1,2499,2378,121,0,176,0,6
71147,2,2427,2450,-23,0,331,0,6
71148,2,2450,2468,-18,0,158,1,6
71149,1,2536,2683,-147,0,113,0,6
71150,1,2453,2491,-38,0,140,0,6
71151,1,2258,2506,-248,0,4,0,6
71152,1,2427,2419,8,0,200,0,6
71153,1,2416,2321,95,0,4,0,8
71154,1,2514,2273,241,0,484,1,6
71155,2,2272,2561,-289,0,50,0,6
71156,1,2361,2400,-39,0,454,0,6
71157,1,2444,2281,163,0,100,0,6
71158,1,2437,2414,23,0,229,0,6
71159,2,2417,2422,-5,0,466,0,6
71160,2,2446,2403,43,0,245,0,6
71161,2,2402,2321,81,0,491,1,6
71162,1,2348,2419,-71,0,250,1,6
71163,3,2512,2594,-82,0,404,0,6
71164,3,2456,2403,53,0,244,0,6
71165,2,2201,2409,-208,0,43,0,6
71166,2,2422,2455,-33,0,215,0,6
71167,3,2404,2495,-91,0,307,0,6
71168,1,2511,2565,-54,0,43,0,6
71169,1,2552,2240,312,0,132,0,6
71170,2,2511,2676,-165,0,110,0,6
71171,2,2436,2342,94,0,100,0,6
71172,1,2511,2605,-94,0,113,1,6
71173,1,2418,2308,110,0,57,0,6
71174,2,2422,2471,-49,0,0,0,6
71175,2,2408,2386,22,0,335,0,6
71176,1,2305,2442,-137,0,140,1,6
71177,2,2517,2337,180,0,7,0,6
71178,3,2425,2304,121,0,16,0,6
71179,2,2329,2458,-129,0,102,0,6
71180,3,2593,2456,137,0,302,0,6
71181,2,2532,2513,19,0,255,0,6
71182,3,2508,2442,66,0,325,0,6
71183,1,2545,2566,-21,0,330,0,6
71184,2,2280,2573,-293,0,440,0,6
71185,1,2468,2439,29,0,374,1,6
71186,3,2458,2405,53,0,15,0,6
71187,1,2303,2574,-271,0,225,0,6
71188,3,2493,2591,-98,0,41,0,6
71189,2,2406,2343,63,0,110,0,6
71190,3,2438,2367,71,0,302,0,6
71191,3,2406,2332,74,0,312,0,6
71192,2,2458,2335,123,0,37,0,6
71193,2,2485,2330,155,0,135,0,6
71194,2,2356,2501,-145,0,107,0,6
71195,2,2286,2625,-339,0,0,0,6
71196,1,2485,2397,88,0,204,0,6
71197,1,2399,2499,-100,0,4,0,6
71198,2,2346,2492,-146,0,40,0,6
71199,2,2410,2389,21,0,176,0,6
71200,3,2396,2467,-71,0,125,0,6
71201,2,2548,2515,33,0,440,0,6
71202,2,2458,2608,-150,0,335,0,6
71203,1,2520,2348,172,0,135,1,6
71204,1,2453,2314,139,0,47,0,6
71205,2,2437,2657,-220,0,1,0,6
71206,1,2321,2415,-94,0,0,0,6
71207,1,2460,2318,142,0,128,0,6
71208,2,2381,2544,-163,0,301,0,6
71209,2,2497,2324,173,0,180,1,6
71210,1,2376,2488,-112,0,188,0,6
71211,2,2478,2550,-72,0,7,0,6
71212,1,2476,2417,59,0,106,0,6
71213,2,2675,2498,177,0,299,1,6
71214,2,2312,2411,-99,0,3,0,6
71215,3,2413,2343,70,0,404,0,6
71216,2,2321,2450,-129,0,156,0,6
71217,3,2319,2414,-95,0,45,0,6
71218,1,2319,2443,-124,0,331,0,6
71219,2,2361,2400,-39,0,85,0,6
71220,2,2470,2489,-19,0,128,0,6
71221,2,2526,2517,9,0,140,0,6
71222,1,2519,2559,-40,0,398,0,6
71223,2,2263,2419,-156,0,300,1,6
71224,3,2428,2281,147,0,131,0,6
71225,2,2284,2403,-119,0,454,0,6
71226,1,2588,2567,21,0,101,0,6
71227,1,2440,2394,46,0,145,0,6
71228,3,2405,2417,-12,0,460,0,6
71229,2,2412,2461,-49,0,455,1,6
71230,2,2378,2507,-129,0,1,0,6
71231,2,2439,2444,-5,0,306,0,6
71232,3,2300,2467,-167,0,40,0,6
71233,1,2451,2454,-3,0,302,1,6
71234,2,2628,2784,-156,0,426,0,6
71235,1,2600,2422,178,0,45,0,6
71236,2,2405,2383,22,0,440,0,6
71237,1,2407,2405,2,0,202,0,6
71238,3,2552,2589,-37,0,201,0,6
71239,2,2333,2495,-162,0,131,0,6
71240,3,2589,2526,63,0,255,0,6
71241,1,2554,2244,310,0,112,1,6
71242,1,2374,2447,-73,0,122,0,6
71243,2,2491,2392,99,0,123,0,6
71244,2,2291,2445,-154,0,13,1,6
71245,1,2473,2413,60,0,200,0,6
71246,1,2565,2300,265,0,120,0,6
71247,1,2377,2462,-85,0,102,0,6
71248,3,2458,2505,-47,0,107,0,6
71249,3,2408,2313,95,0,339,0,6
71250,1,2523,2329,194,0,454,0,6
71251,2,2527,2520,7,0,43,0,6
71252,1,2659,2588,71,0,50,0,6
71253,1,2431,2521,-90,0,200,0,6
71254,1,2413,2481,-68,0,301,0,6
71255,3,2422,2435,-13,0,13,0,6
71256,2,2412,2354,58,0,310,1,6
71257,1,2527,2429,98,0,133,0,6
71258,2,2455,2454,1,0,120,0,6
71259,2,2489,2327,162,0,204,0,6
71260,1,2405,2204,201,0,43,0,6
71261,2,2251,2516,-265,0,245,1,6
71262,3,2563,2208,355,0,118,0,6
71263,1,2507,2523,-16,0,411,0,6
71264,1,2369,2415,-46,0,380,0,6
71265,2,2492,2338,154,0,152,0,6
71266,2,2356,2422,-66,0,332,0,6
71267,1,2320,2404,-84,0,0,0,6
71268,1,2435,2412,23,0,0,1,6
71269,2,2441,2477,-36,0,143,0,6
71270,2,2490,2473,17,0,122,0,6
71271,2,2248,2575,-327,0,140,0,6
71272,1,2443,2598,-155,0,267,1,6
71273,1,2496,2437,59,0,45,0,6
71274,3,2498,2418,80,0,301,0,6
71275,1,2400,2344,56,0,45,0,6
71276,1,2526,2385,141,0,203,0,6
71277,1,2565,2521,44,0,305,0,6
71278,2,2338,2548,-210,0,245,0,6
71279,1,2409,2463,-54,0,0,0,6
71280,1,2463,2478,-15,0,153,0,6
71281,1,2648,2526,122,0,300,0,6
71282,1,2627,2278,349,0,145,0,6
71283,1,2502,2463,39,0,388,1,6
71284,3,2589,2454,135,0,1,0,6
71285,1,2339,2412,-73,0,90,0,6
71286,2,2489,2531,-42,0,253,0,6
71287,3,2271,2404,-133,0,262,0,6
71288,1,2392,2511,-119,0,213,0,6
71289,2,2419,2345,74,0,331,0,6
71290,1,2679,2508,171,0,440,1,6
71291,1,2344,2406,-62,0,152,0,6
71292,2,2314,2411,-97,0,228,0,6
71293,1,2656,2603,53,0,338,0,6
71294,1,2415,2347,68,0,373,0,6
71295,2,2484,2481,3,0,102,1,6
71296,1,2667,2482,185,0,142,0,6
71297,2,2436,2458,-22,0,211,1,6
71298,2,2315,2457,-142,0,241,0,6
71299,2,2341,2445,-104,0,167,0,6
71300,2,2471,2209,262,0,57,1,6
71301,3,2466,2435,31,0,140,0,6
71302,1,2462,2517,-55,0,106,0,6
71303,2,2560,2552,8,0,255,0,6
71304,1,2450,2365,85,0,11,0,6
71305,2,2406,2237,169,0,311,0,6
71306,2,2664,2530,134,0,43,0,6
71307,2,2415,2325,90,0,0,0,6
71308,1,2525,2516,9,0,10,0,6
71309,2,2456,2480,-24,0,118,0,6
71310,2,2266,2468,-202,0,306,0,6
71311,1,2432,2332,100,0,193,1,6
71312,2,2262,2501,-239,0,4,0,6
71313,3,2583,2587,-4,0,242,0,6
71314,1,2375,2404,-29,0,130,0,6
71315,1,2354,2504,-150,0,107,0,6
71316,2,2625,2594,31,0,310,0,6
71317,2,2495,2571,-76,0,434,0,6
71318,2,2414,2405,9,0,101,0,6
71319,1,2629,2557,72,0,270,1,6
71320,1,2398,2497,-99,0,307,0,6
71321,1,2787,2555,232,0,311,0,6
71322,2,2400,2349,51,0,57,0,6
71323,1,2584,2570,14,0,223,0,6
71324,3,2587,2516,71,0,227,0,6
71325,2,2306,2423,-117,0,323,1,6
71326,1,2448,2311,137,0,128,0,6
71327,2,2400,2241,159,4,88,0,13
71328,1,2434,2281,153,0,41,0,6
71329,2,2324,2412,-88,0,301,1,6
71330,2,2485,2451,34,0,487,0,6
71331,1,2409,2311,98,0,230,0,6
71332,2,2420,2422,-2,0,101,0,6
71333,2,2400,2317,83,0,284,0,6
71334,1,2216,2409,-193,0,202,0,6
71335,3,2517,2526,-9,0,43,0,6
71336,1,2586,2553,33,0,211,1,6
71337,1,2422,2358,64,0,106,0,6
71338,2,2481,2517,-36,0,28,1,6
71339,1,2466,2464,2,0,466,0,6
71340,2,2407,2487,-80,0,106,0,6
71341,1,2448,2410,38,0,11,0,6
71342,2,2361,2405,-44,0,250,0,6
71343,2,2472,2470,2,0,211,0,6
71344,2,2416,2363,53,0,333,1,6
71345,1,2402,2383,19,0,400,0,6
71346,2,2550,2509,41,0,113,1,6
71347,2,2298,2567,-269,0,100,0,6
71348,2,2315,2478,-163,0,106,0,6
71349,2,2277,2558,-281,0,300,0,6
71350,2,2212,2516,-304,0,337,1,6
71351,1,2415,2453,-38,0,40,1,6
71352,1,2403,2313,90,0,4,0,6
71353,1,2490,2400,90,0,300,1,6
71354,2,2332,2465,-133,0,335,0,6
71355,3,2652,2572,80,0,388,0,6
71356,2,2304,2484,-180,0,121,0,6
71357,2,2355,2416,-61,0,102,0,6
71358,2,2451,2536,-85,0,288,0,6
71359,2,2427,2344,83,0,0,0,6
71360,1,2479,2458,21,0,127,1,6
71361,2,2349,2514,-165,0,106,0,6
71362,2,2219,2589,-370,0,45,0,6
71363,2,2436,2403,33,0,106,0,6
71364,1,2450,2447,3,0,41,0,6
71365,1,2370,2440,-70,0,107,0,6
71366,3,2317,2538,-221,0,101,0,6
71367,1,2491,2240,251,0,278,1,6
71368,2,2317,2412,-95,0,254,0,8
71369,1,2402,2420,-18,0,456,0,6
71370,3,2458,2538,-80,0,114,0,6
71371,3,2479,2670,-191,0,81,0,6
71372,3,2420,2590,-170,0,122,0,6
71373,1,2436,2395,41,0,1,0,6
71374,2,2275,2465,-190,0,217,0,6
71376,2,2573,2651,-78,0,115,0,6
71377,2,2243,2410,-167,0,202,0,6
71378,3,2359,2442,-83,0,124,0,6
71379,2,2507,2531,-24,0,46,1,6
71380,3,2365,2567,-202,0,102,0,6
71381,1,2416,2246,170,0,40,1,6
71382,2,2415,2402,13,0,200,1,6
71383,1,2379,2418,-39,0,152,0,6
71384,1,2598,2394,204,4,7,0,13
71385,3,2428,2414,14,0,463,0,6
71386,1,2401,2336,65,0,225,0,6
71387,2,2467,2515,-48,0,260,0,6
71388,2,2399,2482,-83,0,40,0,6
71389,1,2449,2356,93,0,200,0,6
71390,1,2449,2347,102,0,101,0,6
71391,2,2405,2548,-143,0,70,0,6
71392,2,2462,2591,-129,0,40,0,6
71393,1,2413,2409,4,0,122,0,6
71394,1,2442,2456,-14,0,150,0,6
71395,1,2421,2346,75,0,395,0,6
71396,1,2335,2430,-95,0,16,0,6
71397,3,2398,2402,-4,0,45,0,6
71398,1,2409,2330,79,0,4,0,6
71399,1,2514,2588,-74,0,11,1,6
71401,1,2496,2408,88,0,45,0,6
71402,1,2423,2565,-142,0,248,0,6
71403,2,2454,2420,34,0,176,0,6
71404,1,2410,2358,52,0,110,1,6
71405,2,2577,2278,299,0,101,1,6
71406,1,2469,2331,138,0,116,0,6
71407,1,2569,2475,94,0,391,0,6
71408,1,2405,2246,159,0,210,1,6
71409,2,2390,2408,-18,0,43,0,6
71410,1,2588,2441,147,0,143,0,6
71411,1,2452,2432,20,0,250,0,6
71412,1,2376,2438,-62,0,130,0,6
71413,1,2404,2349,55,0,296,0,6
71415,2,2279,2634,-355,0,245,0,6
71416,1,2460,2618,-158,0,40,1,6
71417,3,2458,2320,138,0,5,0,6
71418,2,2558,2524,34,0,31,0,6
71419,2,2381,2491,-110,0,322,0,6
71420,2,2372,2456,-84,0,327,1,6
71421,2,2535,2552,-17,0,151,0,6
71422,1,2404,2394,10,0,15,0,6
71423,2,2522,2475,47,0,120,0,6
71424,1,2465,2487,-22,0,15,1,6
71425,3,2319,2477,-158,2,16,0,25
71426,1,2416,2419,-3,0,386,0,6
71427,1,2517,2352,165,0,4,0,6
71428,2,2567,2322,245,0,101,0,6
71429,1,2279,2406,-127,4,4,0,13
71430,2,2441,2315,126,0,0,0,6
71431,1,2468,2305,163,0,170,0,6
71432,1,2559,2422,137,0,4,0,6
71433,3,2406,2358,48,0,308,0,6
71434,1,2655,2600,55,0,300,0,6
71435,1,2541,2447,94,0,103,1,6
71436,1,2393,2405,-12,0,255,0,6
71437,3,2414,2206,208,0,394,0,6
71438,2,2517,2657,-140,0,459,0,6
71439,1,2526,2357,169,0,61,0,6
71440,1,2469,2328,141,0,241,0,6
71441,2,2435,2472,-37,0,306,1,6
71442,3,2381,2477,-96,0,4,0,6
71443,2,2557,2479,78,0,320,1,6
71444,1,2372,2494,-122,0,124,0,6
71445,2,2404,2471,-67,0,484,0,6
71446,1,2595,2591,4,0,123,0,6
71447,2,2396,2459,-63,0,106,0,6
71448,1,2385,2437,-52,0,4,0,6
71449,1,2560,2260,300,0,104,1,6
71450,2,2365,2544,-179,0,426,1,6
71451,2,2402,2423,-21,0,61,0,6
71452,1,2493,2398,95,0,140,0,6
71453,1,2463,2360,103,4,15,0,11
71454,1,2667,2789,-122,0,156,0,6
71455,1,2452,2485,-33,0,141,0,6
71456,1,2415,2335,80,0,130,0,6
71457,2,2253,2486,-233,0,300,0,6
71458,3,2418,2313,105,0,305,0,6
71459,2,2447,2611,-164,0,277,0,6
71460,1,2414,2428,-14,0,3,0,6
71461,1,2459,2435,24,0,100,0,6
71462,1,2660,2431,229,0,474,0,6
71463,2,2557,2514,43,0,305,0,6
71464,2,2465,2413,52,0,409,1,6
71465,2,2470,2434,36,0,455,0,6
71466,1,2404,2304,100,0,140,0,6
71467,2,2516,2482,34,0,135,0,6
71468,2,2323,2489,-166,0,106,0,6
71469,2,2408,2403,5,0,343,0,6
71470,2,2459,2453,6,0,156,1,6
71471,1,2569,2296,273,0,0,1,6
71472,2,2308,2420,-112,0,264,0,6
71473,2,2448,2462,-14,0,140,0,6
71474,1,2352,2434,-82,0,300,0,6
71475,2,2513,2537,-24,0,301,1,6
71476,1,2408,2201,207,0,100,1,6
71477,1,2450,2448,2,0,331,0,6
71478,2,2341,2432,-91,0,466,0,6
71479,2,2316,2425,-109,0,45,0,8
71480,1,2396,2402,-6,0,0,1,6
71481,3,2274,2486,-212,0,307,0,6
71482,2,2320,2498,-178,0,0,1,6
71483,3,2428,2416,12,0,106,0,6
71484,1,2520,2347,173,0,80,1,6
71485,1,2460,2456,4,0,190,0,6
71486,2,2331,2427,-96,0,106,1,6
71487,2,2234,2405,-171,0,245,0,6
71488,2,2459,2508,-49,0,247,0,6
71489,1,2448,2479,-31,0,140,0,6
71490,1,2431,2457,-26,0,330,0,6
71491,3,2586,2529,57,0,101,0,6
71492,1,2557,2291,266,0,171,0,6
71493,3,2488,2509,-21,0,0,0,6
71494,2,2416,2307,109,0,210,0,8
71495,1,2413,2422,-9,0,101,0,6
71496,1,2521,2546,-25,0,22,0,6
71497,1,2381,2428,-47,0,250,0,6
71498,2,2492,2495,-3,0,200,0,6
71499,1,2411,2251,160,0,311,1,6
71500,1,2410,2357,53,0,1,0,6
71501,1,2556,2698,-142,0,453,0,6
71502,1,2636,2567,69,0,194,0,6
71503,2,2403,2212,191,0,196,0,6
71504,2,2526,2552,-26,0,343,0,6
71505,3,2663,2318,345,2,202,0,24
71506,2,2286,2432,-146,0,27,0,6
71507,2,2340,2412,-72,0,310,1,6
71508,1,2408,2410,-2,0,42,0,6
71509,1,2516,2454,62,0,487,1,6
71510,2,2420,2385,35,0,47,0,6
71511,1,2403,2293,110,0,9,0,6
71512,2,2516,2610,-94,0,106,0,6
71513,1,2454,2254,200,0,120,0,6
71514,2,2389,2409,-20,0,203,1,6
71515,2,2495,2377,118,0,300,0,6
71516,2,2471,2482,-11,0,20,0,6
71517,1,2420,2385,35,0,200,0,6
71518,2,2408,2250,158,0,133,0,6
71519,2,2595,2660,-65,0,112,0,6
71520,2,2344,2409,-65,0,112,0,6
71521,1,2481,2337,144,0,205,0,6
71522,2,2381,2424,-43,0,248,0,6
71523,1,2409,2376,33,0,409,0,6
71524,2,2430,2464,-34,0,100,1,6
71525,2,2452,2404,48,0,331,0,6
71526,3,2782,2543,239,0,380,0,6
71527,3,2585,2663,-78,0,123,0,6
71528,1,2530,2429,101,0,127,0,6
71529,1,2422,2420,2,0,45,0,6
71530,2,2547,2501,46,0,134,1,6
71531,1,2443,2357,86,0,11,0,6
71532,1,2475,2326,149,0,110,0,6
71533,1,2501,2322,179,0,131,0,6
71534,2,2682,2512,170,0,330,0,6
71535,3,2614,2444,170,0,320,0,6
71536,1,2530,2559,-29,0,309,0,6
71537,2,2416,2355,61,0,41,0,6
71538,1,2419,2300,119,0,122,0,6
71539,2,2523,2563,-40,0,414,0,6
71540,2,2432,2292,140,4,335,0,13
71541,3,2520,2601,-81,0,46,0,6
71542,2,2420,2399,21,0,1,0,6
71543,2,2476,2551,-75,0,100,0,6
71544,2,2416,2487,-71,0,4,1,6
71545,2,2501,2428,73,0,112,0,6
71546,1,2488,2289,199,0,242,0,6
71547,2,2430,2464,-34,0,48,1,6
71548,2,2440,2409,31,0,101,0,6
71549,1,2433,2328,105,0,40,0,6
71550,1,2556,2416,140,0,7,0,6
71551,2,2366,2422,-56,0,5,0,6
71552,2,2346,2419,-73,0,120,0,6
71553,2,2383,2521,-138,0,22,0,6
71554,2,2382,2402,-20,0,100,0,6
71555,2,2467,2451,16,0,320,1,6
71556,2,2432,2342,90,0,202,0,6
71557,2,2293,2437,-144,0,40,0,6
71558,1,2599,2414,185,0,111,0,6
71559,2,2258,2414,-156,0,200,0,6
71560,1,2416,2249,167,0,46,0,6
71561,1,2404,2508,-104,0,15,1,6
71562,1,2467,2442,25,0,300,1,6
71563,3,2428,2407,21,0,140,0,6
71564,1,2442,2414,28,0,208,1,6
71565,1,2424,2460,-36,0,106,0,6
71566,2,2293,2534,-241,0,41,0,6
71567,2,2454,2456,-2,0,112,0,6
71568,1,2413,2320,93,0,45,0,6
71569,1,2616,2560,56,0,386,0,6
71570,1,2285,2434,-149,0,255,0,6
71571,1,2431,2416,15,0,312,0,6
71572,2,2406,2459,-53,0,125,1,6
71573,2,2662,2536,126,0,331,0,6
71574,1,2553,2586,-33,0,43,0,6
71575,1,2435,2283,152,0,107,0,6
71576,1,2615,2512,103,0,310,1,6
71577,2,2403,2399,4,0,412,0,6
71578,2,2289,2432,-143,0,45,0,8
71579,3,2408,2504,-96,0,48,0,6
71580,1,2408,2261,147,0,56,1,6
71581,1,2426,2402,24,0,43,1,6
71582,1,2557,2521,36,0,330,0,6
71583,3,2330,2489,-159,0,127,0,6
71584,2,2452,2289,163,0,121,1,6
71585,2,2201,2417,-216,0,4,0,6
71586,1,2293,2426,-133,0,310,1,8
71587,1,2466,2415,51,0,15,0,6
71588,3,2405,2344,61,0,41,0,6
71589,1,2260,2414,-154,0,140,0,6
71590,3,2537,2324,213,0,241,0,6
71591,2,2279,2439,-160,0,45,0,6
71592,2,2223,2402,-179,0,227,1,6
71593,2,2508,2629,-121,0,244,0,6
71594,1,2690,2564,126,0,288,0,6
71595,2,2665,2591,74,0,300,0,6
71596,1,2429,2485,-56,0,150,1,6
71597,1,2449,2523,-74,0,247,0,6
71598,2,2294,2571,-277,0,100,0,6
71599,2,2431,2263,168,0,310,0,6
71600,2,2491,2409,82,0,123,0,6
71601,1,2502,2412,90,0,100,1,6
71602,3,2379,2602,-223,0,200,0,6
71603,1,2485,2471,14,0,211,0,6
71604,3,2555,2525,30,0,305,0,6
71605,1,2410,2441,-31,0,106,0,6
71606,3,2620,2527,93,0,332,0,6
71607,1,2450,2551,-101,0,80,1,6
71608,2,2383,2414,-31,0,45,1,6
71609,1,2634,2504,130,0,134,0,6
71610,1,2328,2417,-89,0,41,0,6
71611,2,2426,2541,-115,0,241,0,6
71612,2,2383,2410,-27,0,300,0,6
71613,3,2435,2354,81,0,101,0,6
71614,2,2420,2289,131,0,50,0,6
71615,2,2397,2555,-158,0,100,0,6
71616,1,2525,2463,62,0,330,0,6
71617,2,2353,2423,-70,0,103,0,6
71618,1,2516,2568,-52,0,22,0,6
71619,1,2642,2294,348,0,145,0,6
71620,1,2252,2457,-205,0,112,0,6
71621,2,2444,2518,-74,0,46,0,6
71622,2,2447,2342,105,0,30,1,6
71623,2,2479,2347,132,0,280,1,6
71624,2,2559,2399,160,0,171,0,6
71625,1,2580,2312,268,0,125,0,6
71626,3,2325,2412,-87,0,214,0,6
71627,3,2559,2469,90,0,245,0,6
71628,3,2474,2469,5,0,28,0,6
71629,2,2270,2402,-132,0,122,1,6
71630,3,2416,2383,33,0,338,0,6
71631,1,2516,2563,-47,0,343,0,6
71632,2,2462,2449,13,0,325,0,6
71633,2,2464,2433,31,0,45,0,6
71634,3,2394,2490,-96,0,307,0,6
71635,2,2466,2411,55,0,133,0,6
71636,2,2437,2500,-63,0,247,0,6
71637,3,2474,2208,266,0,124,0,6
71638,1,2501,2308,193,0,469,0,6
71639,2,2442,2276,166,0,400,0,6
71640,1,2365,2545,-180,0,256,1,6
71641,1,2457,2351,106,0,211,1,6
71642,1,2473,2447,26,0,300,0,6
71643,3,2405,2461,-56,0,121,0,6
71644,2,2200,2522,-322,0,110,1,6
71645,3,2417,2466,-49,0,150,0,6
71646,2,2270,2444,-174,0,3,1,6
71647,1,2404,2304,100,0,43,0,6
71648,2,2453,2396,57,0,338,0,6
71649,1,2489,2431,58,0,107,0,6
71650,2,2456,2445,11,0,211,1,6
71651,1,2427,2323,104,0,466,0,6
71652,2,2251,2405,-154,0,3,0,6
71653,2,2271,2479,-208,0,306,0,6
71654,3,2533,2545,-12,0,140,0,6
71655,3,2327,2599,-272,0,267,0,6
71656,2,2268,2429,-161,0,143,1,6
71657,2,2428,2348,80,0,101,0,6
71658,2,2464,2373,91,0,200,0,6
71659,2,2387,2582,-195,0,123,0,6
71660,2,2401,2330,71,0,260,0,6
71661,1,2619,2437,182,0,469,0,6
71662,2,2416,2253,163,0,45,1,6
71663,2,2529,2619,-90,0,11,0,6
71664,2,2435,2490,-55,0,56,1,6
71665,1,2458,2360,98,0,45,0,6
71666,2,2654,2530,124,0,112,0,6
71667,2,2593,2446,147,0,153,1,6
71668,2,2245,2412,-167,0,256,0,6
71669,1,2561,2524,37,0,176,1,6
71670,3,2522,2472,50,0,218,0,6
71671,1,2486,2432,54,0,0,0,6
71672,2,2373,2436,-63,0,49,0,6
71673,2,2505,2694,-189,0,301,1,6
71674,1,2478,2340,138,0,253,0,6
71675,2,2595,2558,37,0,1,0,6
71676,1,2402,2551,-149,0,311,0,6
71677,1,2407,2331,76,0,456,0,6
71678,1,2447,2394,53,0,330,0,6
71679,2,2644,2548,96,0,247,1,6
71680,2,2598,2658,-60,0,112,0,6
71681,2,2222,2411,-189,0,455,0,6
71682,2,2358,2455,-97,0,21,0,6
71683,1,2416,2300,116,0,131,0,6
71684,2,2410,2456,-46,0,300,0,6
71685,2,2508,2500,8,0,120,0,6
71686,2,2488,2335,153,0,315,0,6
71687,2,2267,2415,-148,0,101,0,6
71688,1,2573,2292,281,0,0,0,6
71689,2,2319,2490,-171,0,127,1,6
71690,2,2302,2408,-106,0,312,0,6
71691,2,2585,2494,91,0,125,0,6
71692,2,2426,2384,42,0,112,0,6
71693,2,2239,2402,-163,4,130,0,13
71694,1,2421,2327,94,0,230,1,6
71695,1,2285,2434,-149,0,482,0,6
71696,2,2480,2522,-42,0,225,0,6
71697,1,2564,2418,146,0,46,0,6
71698,3,2459,2589,-130,0,210,0,6
71699,1,2411,2212,199,0,0,1,6
71700,2,2352,2440,-88,0,40,1,6
71701,3,2470,2562,-92,0,4,0,6
71702,2,2314,2506,-192,0,150,0,8
71703,2,2325,2411,-86,0,42,1,6
71705,2,2390,2448,-58,0,311,1,6
71706,1,2408,2233,175,0,46,0,6
71707,2,2419,2473,-54,0,337,0,6
71708,1,2461,2521,-60,0,43,1,6
71709,1,2418,2373,45,0,112,0,8
71710,3,2410,2452,-42,0,106,0,6
71711,2,2543,2587,-44,0,101,0,6
71712,2,2368,2478,-110,0,460,1,6
71713,2,2442,2552,-110,0,101,0,6
71714,2,2333,2457,-124,0,134,0,6
71715,1,2367,2508,-141,0,167,0,6
71716,1,2460,2406,54,0,306,0,6
71717,1,2220,2412,-192,0,121,0,6
71718,2,2431,2458,-27,0,40,0,6
71719,1,2420,2411,9,0,245,0,6
71720,2,2647,2391,256,0,447,0,6
71721,1,2440,2461,-21,0,300,0,6
71722,2,2536,2502,34,0,101,0,6
71723,1,2441,2316,125,0,88,0,6
71724,1,2543,2405,138,0,406,0,6
71725,1,2629,2437,192,0,320,0,6
71726,1,2411,2231,180,0,131,0,8
71727,1,2418,2363,55,0,40,1,6
71728,2,2409,2410,-1,0,102,0,8
71729,3,2568,2412,156,0,49,0,6
71730,1,2415,2326,89,0,456,0,6
71731,1,2482,2363,119,0,45,0,6
71732,1,2416,2393,23,0,202,0,6
71733,2,2399,2440,-41,0,0,0,6
71734,1,2545,2462,83,0,50,0,6
71735,1,2453,2534,-81,0,43,0,6
71736,2,2425,2269,156,0,310,0,6
71737,3,2430,2373,57,0,414,0,6
71738,2,2344,2480,-136,0,300,0,6
71739,1,2369,2455,-86,0,325,0,6
71740,2,2409,2357,52,0,122,0,6
71741,3,2539,2566,-27,0,405,0,6
71742,1,2592,2414,178,0,1,0,6
71743,1,2495,2482,13,0,200,1,6
71744,1,2527,2622,-95,0,40,0,6
71745,2,2383,2414,-31,0,146,0,6
71746,3,2471,2323,148,2,217,0,25
71747,3,2697,2663,34,0,190,0,6
71748,1,2502,2524,-22,0,301,0,6
71749,3,2315,2413,-98,0,242,0,6
71750,2,2578,2264,314,0,3,0,6
71751,2,2482,2445,37,0,20,1,6
71752,2,2408,2372,36,0,45,0,6
71753,3,2518,2623,-105,0,22,0,6
71754,2,2361,2414,-53,0,45,0,6
71755,1,2446,2372,74,0,315,1,6
71756,1,2385,2420,-35,0,151,1,6
71757,1,2463,2298,165,0,101,0,6
71758,1,2567,2663,-96,0,111,0,6
71759,2,2316,2491,-175,0,106,0,6
71760,2,2471,2458,13,0,192,0,6
71761,2,2465,2418,47,0,218,0,6
71762,2,2421,2385,36,0,202,1,6
71763,2,2427,2438,-11,0,331,0,6
71764,2,2458,2638,-180,0,16,0,6
71765,1,2419,2392,27,0,400,0,6
71766,2,2400,2549,-149,0,126,0,6
71767,2,2514,2556,-42,0,101,0,6
71768,1,2290,2575,-285,0,40,0,6
71769,1,2261,2635,-374,0,250,0,6
71770,2,2292,2402,-110,0,310,0,6
71771,1,2542,2577,-35,0,10,0,6
71772,3,2406,2466,-60,0,484,0,6
71773,1,2459,2501,-42,0,250,0,6
71774,2,2371,2586,-215,0,49,1,6
71775,2,2432,2325,107,0,456,0,6
71776,2,2323,2471,-148,0,374,0,6
71777,1,2560,2493,67,0,313,0,6
71778,2,2434,2632,-198,0,121,0,6
71779,1,2465,2460,5,0,106,0,6
71780,3,2351,2425,-74,0,102,0,6
71781,1,2355,2448,-93,4,45,0,13
71782,1,2468,2484,-16,0,453,0,6
71783,2,2414,2343,71,0,0,0,6
71784,1,2444,2348,96,0,36,1,6
71785,3,2449,2377,72,0,8,0,6
71786,2,2403,2410,-7,0,110,0,6
71787,1,2401,2465,-64,0,121,0,6
71788,1,2502,2539,-37,0,0,0,6
71789,2,2413,2568,-155,0,43,0,6
71790,1,2478,2458,20,0,301,0,6
71791,1,2482,2321,161,0,45,0,6
71792,2,2454,2500,-46,0,286,0,6
71793,3,2504,2344,160,0,347,0,6
71794,2,2565,2595,-30,0,46,0,6
71795,1,2352,2429,-77,0,40,0,6
71796,2,2385,2445,-60,0,40,0,6
71797,1,2521,2327,194,0,0,0,6
71798,1,2445,2461,-16,0,130,1,6
71799,2,2374,2415,-41,0,426,1,6
71800,3,2508,2428,80,0,301,0,6
71801,3,2477,2264,213,0,152,0,8
71802,2,2483,2340,143,0,315,0,6
71803,2,2423,2353,70,0,178,0,8
71804,1,2518,2509,9,0,22,0,6
71805,2,2340,2494,-154,0,127,0,6
71806,2,2561,2508,53,0,45,0,6
71807,2,2406,2376,30,0,320,0,6
71808,3,2552,2424,128,0,331,0,6
71809,1,2552,2420,132,0,196,0,6
71810,2,2565,2502,63,0,40,0,6
71811,1,2441,2327,114,4,174,1,13
71812,1,2289,2423,-134,0,41,0,6
71813,1,2663,2696,-33,0,289,0,6
71814,2,2489,2460,29,0,196,1,6
71815,2,2295,2624,-329,0,245,0,6
71816,1,2250,2411,-161,0,143,0,6
71817,3,2485,2417,68,0,40,0,6
71818,2,2364,2402,-38,0,213,0,6
71819,2,2532,2452,80,0,28,1,6
71820,2,2458,2401,57,0,10,0,6
71821,2,2228,2401,-173,0,185,0,6
71822,2,2485,2474,11,0,45,0,6
71823,1,2361,2403,-42,0,302,0,6
71824,2,2476,2500,-24,0,106,0,6
71825,2,2444,2425,19,0,103,0,6
71826,2,2458,2408,50,0,106,1,6
71827,2,2463,2422,41,0,195,1,6
71828,1,2483,2375,108,0,107,0,6
71829,2,2474,2555,-81,0,10,0,6
71830,2,2524,2547,-23,0,1,0,6
71831,1,2515,2458,57,0,300,0,6
71832,1,2407,2237,170,0,48,1,6
71833,1,2451,2361,90,0,132,1,6
71834,2,2521,2656,-135,0,30,0,6
71835,3,2367,2488,-121,0,335,0,6
71836,2,2494,2320,174,0,132,0,6
71837,2,2319,2465,-146,0,140,1,6
71838,2,2360,2416,-56,0,348,0,8
71839,1,2424,2290,134,0,234,0,6
71840,2,2401,2396,5,0,112,0,6
71841,1,2419,2401,18,0,125,0,6
71842,3,2429,2439,-10,0,215,0,6
71843,3,2607,2593,14,0,200,0,6
71844,3,2560,2561,-1,0,49,0,6
71845,1,2510,2533,-23,0,301,0,6
71846,1,2416,2509,-93,0,3,0,8
71847,1,2450,2373,77,0,440,1,6
71848,1,2566,2300,266,0,201,0,6
71849,1,2589,2368,221,0,453,0,6
71850,3,2533,2554,-21,0,57,0,6
71851,1,2425,2459,-34,0,61,0,6
71852,2,2416,2448,-32,0,106,1,6
71853,2,2415,2369,46,0,343,0,6
71854,3,2416,2297,119,0,14,0,6
71855,3,2449,2674,-225,0,112,0,6
71856,1,2367,2408,-41,0,152,0,6
71857,3,2402,2296,106,0,100,0,6
71858,1,2344,2448,-104,0,40,0,6
71859,2,2348,2400,-52,0,300,0,6
71860,1,2455,2452,3,0,245,0,6
71861,1,2538,2202,336,0,344,0,6
71862,2,2429,2456,-27,0,244,0,6
71863,1,2553,2441,112,0,256,0,6
71864,2,2315,2435,-120,0,203,0,6
71865,2,2484,2369,115,0,400,1,8
71866,1,2413,2387,26,0,41,0,6
71867,1,2382,2504,-122,0,395,0,6
71868,1,2559,2524,35,0,332,0,6
71869,2,2267,2588,-321,0,411,0,8
71870,2,2411,2455,-44,0,130,1,6
71871,1,2520,2373,147,0,301,0,6
71872,2,2322,2416,-94,0,311,0,6
71873,1,2509,2373,136,0,214,1,6
71874,2,2401,2245,156,0,338,0,6
71875,1,2533,2470,63,0,1,0,6
71876,1,2561,2402,159,0,40,0,6
71877,1,2690,2600,90,0,130,0,6
71878,2,2406,2249,157,4,13,0,13
71879,1,2402,2527,-125,0,10,1,6
71880,1,2420,2223,197,0,112,0,6
71881,1,2465,2552,-87,0,265,0,6
71882,2,2328,2486,-158,0,440,1,6
71883,1,2480,2480,0,0,46,0,6
71884,1,2420,2327,93,0,57,0,6
71885,2,2535,2438,97,0,330,0,6
71886,1,2239,2407,-168,0,0,1,6
71887,2,2286,2561,-275,0,378,0,6
71888,1,2402,2291,111,0,9,0,6
71889,2,2365,2445,-80,0,40,0,6
71890,3,2269,2541,-272,0,45,0,6
71891,3,2307,2414,-107,0,200,0,6
71892,3,2506,2471,35,0,0,0,6
71893,3,2415,2452,-37,0,22,0,6
71894,2,2371,2523,-152,0,464,0,6
71895,1,2295,2557,-262,0,248,0,6
71896,3,2452,2431,21,0,111,0,6
71897,3,2466,2486,-20,0,218,0,6
71898,2,2459,2378,81,0,130,0,6
71899,1,2582,2659,-77,0,331,0,6
71900,1,2596,2695,-99,0,49,0,6
71901,1,2360,2405,-45,0,315,0,6
71902,3,2262,2413,-151,0,40,0,6
71903,2,2389,2417,-28,0,315,0,6
71904,2,2428,2334,94,0,228,1,6
71905,1,2320,2423,-103,0,4,0,6
71906,2,2441,2351,90,0,11,1,6
71907,1,2560,2601,-41,0,7,0,6
71908,1,2496,2404,92,0,200,0,6
71909,3,2262,2408,-146,0,49,0,6
71910,2,2366,2591,-225,0,311,0,6
71911,2,2428,2538,-110,0,300,0,6
71912,2,2469,2390,79,0,250,1,6
71913,3,2514,2399,115,0,211,0,6
71914,1,2281,2424,-143,4,485,0,8
71915,2,2349,2510,-161,0,128,0,6
71916,1,2438,2385,53,0,380,0,6
71917,1,2413,2387,26,0,110,0,6
71918,2,2410,2442,-32,0,385,1,6
71919,1,2485,2565,-80,0,300,0,6
71921,2,2410,2379,31,0,229,0,6
71922,2,2519,2671,-152,0,88,0,6
71923,2,2299,2414,-115,0,469,0,6
71924,1,2304,2512,-208,0,134,0,6
71925,3,2558,2586,-28,0,310,0,6
71927,1,2360,2405,-45,0,415,0,6
71928,1,2428,2324,104,0,150,1,6
71929,1,2298,2568,-270,0,200,0,6
71930,2,2326,2443,-117,0,200,1,6
71931,2,2411,2425,-14,0,40,0,6
71932,1,2453,2330,123,0,127,0,6
71933,1,2446,2461,-15,0,130,0,6
71934,1,2497,2295,202,0,211,0,6
71935,1,2322,2492,-170,0,404,0,6
71936,1,2460,2527,-67,0,226,0,6
71937,3,2409,2567,-158,0,40,0,6
71938,3,2519,2399,120,0,143,0,6
71939,1,2636,2274,362,2,153,0,24
71940,2,2499,2364,135,0,1,0,6
71941,1,2347,2474,-127,0,140,0,6
71942,1,2500,2453,47,0,190,0,6
71943,2,2502,2423,79,0,103,0,8
71944,1,2641,2396,245,0,335,0,6
71945,1,2424,2376,48,0,247,0,6
71946,2,2406,2512,-106,0,212,0,6
71947,1,2327,2423,-96,0,57,0,6
71948,1,2406,2266,140,0,4,0,6
71949,1,2590,2226,364,0,106,0,8
71950,2,2287,2424,-137,0,474,0,6
71951,2,2400,2433,-33,0,15,0,6
71952,3,2406,2368,38,0,112,0,6
71953,2,2369,2502,-133,0,240,0,6
71954,1,2489,2325,164,0,0,0,6
71955,2,2471,2505,-34,0,106,0,6
71956,1,2593,2313,280,0,132,0,6
71957,2,2564,2503,61,0,307,1,6
71958,1,2542,2424,118,0,45,1,6
71959,1,2515,2445,70,0,330,1,6
71960,2,2379,2492,-113,0,394,0,6
71961,3,2525,2379,146,0,80,0,6
71962,1,2530,2338,192,0,14,0,6
71963,1,2545,2472,73,0,460,0,6
71964,2,2438,2379,59,0,335,0,6
71965,1,2364,2421,-57,0,150,0,8
71966,2,2397,2505,-108,0,315,0,6
71967,2,2451,2416,35,0,320,0,6
71968,2,2516,2448,68,0,120,1,6
71969,1,2548,2311,237,0,134,0,6
71970,3,2564,2595,-31,0,46,0,6
71971,2,2616,2649,-33,0,335,0,6
71972,1,2591,2521,70,0,408,0,8
71973,2,2433,2451,-18,0,404,0,6
71974,2,2341,2420,-79,0,38,0,6
71975,1,2652,2621,31,0,45,0,6
71976,3,2466,2339,127,0,40,0,6
71977,1,2462,2402,60,0,250,1,6
71978,1,2590,2625,-35,0,326,0,6
71979,1,2404,2307,97,0,45,0,6
71980,2,2397,2496,-99,0,394,0,6
71981,1,2358,2434,-76,0,40,1,6
71982,2,2464,2372,92,0,455,1,6
71983,2,2342,2409,-67,0,40,0,6
71984,2,2318,2542,-224,0,176,0,6
71985,2,2404,2394,10,0,202,0,6
71986,3,2393,2405,-12,0,106,0,6
71987,1,2558,2307,251,0,45,0,6
71988,2,2447,2334,113,0,4,0,6
71989,3,2335,2500,-165,0,200,0,6
71990,1,2635,2670,-35,0,43,0,6
71991,1,2370,2558,-188,0,101,0,6
71992,1,2419,2413,6,0,405,1,6
71993,2,2399,2527,-128,0,45,0,6
71994,3,2394,2550,-156,0,256,0,6
71995,1,2453,2285,168,0,337,0,6
71996,2,2412,2352,60,0,40,0,6
71997,1,2594,2363,231,0,27,1,6
71998,3,2326,2457,-131,0,106,0,6
71999,2,2432,2453,-21,0,151,0,6
72000,1,2361,2520,-159,0,45,1,6
72001,1,2510,2466,44,0,0,0,6
72002,1,2538,2368,170,0,456,0,6
72003,3,2281,2564,-283,0,250,0,6
72004,2,2455,2332,123,0,221,1,6
72005,1,2483,2422,61,0,40,1,6
72006,3,2595,2595,0,0,122,0,6
72007,1,2429,2565,-136,0,246,0,6
72008,1,2414,2338,76,0,101,0,6
72009,2,2400,2393,7,0,335,0,6
72010,2,2452,2470,-18,0,415,1,6
72011,2,2422,2346,76,0,110,0,6
72012,2,2381,2480,-99,0,142,0,6
72013,1,2457,2374,83,0,385,0,8
72014,2,2555,2316,239,0,107,1,6
72015,2,2318,2402,-84,0,207,0,6
72016,1,2243,2401,-158,0,40,0,6
72017,1,2471,2414,57,0,40,0,6
72018,1,2412,2400,12,0,49,0,6
72019,1,2418,2294,124,0,15,1,6
72020,1,2619,2441,178,0,246,0,6
72021,1,2531,2433,98,0,211,0,6
72023,2,2305,2560,-255,0,13,1,6
72024,1,2517,2294,223,0,242,0,6
72025,1,2431,2452,-21,0,0,0,6
72026,3,2400,2478,-78,0,28,0,6
72027,1,2385,2522,-137,0,231,0,6
72028,2,2385,2498,-113,0,45,1,6
72029,2,2366,2546,-180,0,11,0,6
72030,2,2494,2420,74,0,0,0,6
72031,1,2400,2367,33,0,111,0,6
72032,3,2510,2595,-85,0,241,0,6
72033,1,2432,2558,-126,0,268,0,6
72034,2,2595,2644,-49,0,190,0,6
72035,2,2432,2291,141,0,130,1,6
72036,1,2538,2658,-120,0,322,0,6
72037,2,2425,2337,88,0,110,0,6
72038,1,2497,2352,145,0,112,1,6
72039,2,2297,2455,-158,0,148,1,6
72040,2,2400,2398,2,0,106,0,6
72041,1,2251,2403,-152,0,43,0,6
72042,1,2422,2445,-23,0,123,1,6
72043,1,2548,2316,232,0,485,0,6
72044,2,2403,2385,18,0,110,0,6
72045,3,2455,2510,-55,0,211,0,6
72046,2,2311,2467,-156,0,323,1,6
72047,2,2396,2456,-60,0,127,0,6
72048,1,2548,2310,238,0,123,0,6
72049,1,2550,2464,86,0,45,0,6
72050,1,2385,2453,-68,0,310,0,6
72051,1,2557,2439,118,0,49,0,6
72052,2,2438,2427,11,0,132,0,6
72053,1,2427,2365,62,0,36,1,6
72054,1,2520,2252,268,0,116,0,6
72055,2,2410,2405,5,0,37,0,6
72056,1,2495,2328,167,0,300,0,8
72057,2,2256,2423,-167,0,120,1,6
72058,2,2549,2398,151,0,45,0,6
72059,1,2482,2393,89,0,326,1,6
72060,2,2642,2471,171,0,131,0,6
72061,1,2440,2341,99,0,6,0,6
72062,2,2350,2476,-126,0,201,1,6
72063,3,2409,2261,148,0,101,0,6
72064,1,2509,2431,78,0,200,0,6
72065,2,2243,2445,-202,4,42,0,13
72066,2,2461,2515,-54,0,106,0,6
72067,1,2382,2447,-65,0,211,0,6
72068,2,2404,2380,24,0,167,1,6
72069,1,2372,2550,-178,0,5,0,6
72070,1,2467,2447,20,0,108,0,6
72071,2,2512,2395,117,0,300,0,6
72072,2,2286,2488,-202,0,7,0,6
72073,2,2429,2399,30,0,190,0,6
72074,1,2494,2213,281,0,267,0,3
72075,2,2535,2476,59,0,5,0,6
72076,1,2649,2398,251,0,447,0,6
72077,1,2387,2590,-203,0,487,0,6
72078,1,2427,2396,31,0,49,0,6
72079,2,2459,2434,25,0,196,0,6
72080,2,2447,2554,-107,0,101,0,6
72081,1,2488,2403,85,0,300,0,6
72082,1,2416,2460,-44,0,55,0,6
72083,2,2314,2554,-240,0,126,0,6
72084,2,2340,2420,-80,0,200,0,6
72085,1,2289,2545,-256,0,122,0,6
72086,3,2597,2547,50,0,265,0,6
72087,3,2397,2561,-164,0,100,0,6
72088,2,2422,2367,55,0,15,0,6
72089,1,2344,2418,-74,0,386,0,6
72090,3,2515,2455,60,0,45,0,6
72091,1,2595,2522,73,0,0,0,6
72092,1,2250,2511,-261,0,307,0,6
72093,2,2408,2469,-61,0,130,1,6
72094,2,2427,2446,-19,0,300,0,6
72095,1,2408,2267,141,0,207,0,6
72096,3,2651,2233,418,0,327,0,6
72097,1,2432,2505,-73,0,106,0,6
72098,1,2433,2453,-20,0,151,0,6
72099,1,2470,2307,163,0,250,0,6
72100,2,2395,2444,-49,0,15,0,6
72101,1,2337,2403,-66,0,48,0,6
72102,1,2407,2350,57,0,140,1,6
72103,1,2410,2290,120,0,453,0,6
72104,2,2437,2436,1,0,200,1,6
72105,1,2297,2435,-138,0,373,0,8
72106,1,2520,2457,63,0,200,0,6
72107,1,2603,2514,89,0,319,0,6
72108,1,2454,2291,163,0,45,0,6
72109,2,2390,2558,-168,0,21,0,6
72110,1,2439,2428,11,0,483,1,6
72111,1,2443,2457,-14,0,241,0,6
72112,1,2353,2416,-63,0,4,1,6
72113,2,2388,2432,-44,0,444,0,6
72114,2,2317,2432,-115,0,380,0,6
72115,1,2440,2486,-46,0,278,0,6
72116,2,2240,2416,-176,0,151,0,6
72117,1,2541,2442,99,0,313,0,6
72118,2,2361,2432,-71,0,40,1,6
72119,2,2542,2418,124,0,42,0,6
72120,1,2550,2381,169,0,330,0,6
72121,2,2439,2436,3,0,250,0,6
72122,1,2451,2353,98,0,123,0,6
72123,1,2518,2260,258,0,171,0,6
72124,1,2502,2400,102,0,211,0,6
72125,2,2558,2599,-41,0,1,0,6
72126,1,2552,2546,6,0,335,0,6
72127,2,2446,2504,-58,0,255,0,6
72128,2,2462,2396,66,0,353,0,6
72129,2,2283,2415,-132,0,45,1,6
72130,2,2427,2447,-20,0,124,0,6
72131,1,2402,2203,199,0,28,0,6
72132,2,2540,2557,-17,0,302,0,6
72133,1,2374,2423,-49,0,207,0,6
72134,1,2405,2483,-78,0,444,1,6
72135,1,2491,2419,72,0,40,0,6
72136,1,2458,2381,77,0,332,1,6
72137,1,2431,2441,-10,0,246,0,6
72138,2,2604,2405,199,0,5,0,6
72139,2,2327,2407,-80,0,41,0,6
72140,2,2287,2433,-146,0,122,0,6
72141,1,2501,2346,155,0,107,0,6
72142,1,2443,2498,-55,0,455,0,6
72143,1,2449,2311,138,0,483,1,6
72144,2,2452,2351,101,0,45,0,6
72145,1,2436,2545,-109,0,10,0,6
72146,1,2634,2478,156,0,140,0,6
72147,2,2414,2421,-7,0,152,0,6
72148,1,2436,2313,123,0,315,1,6
72149,2,2474,2457,17,0,140,0,6
72150,1,2390,2411,-21,0,122,1,6
72151,2,2301,2400,-99,0,123,1,6
72152,2,2431,2394,37,0,108,0,6
72153,2,2418,2344,74,0,140,0,6
72154,3,2455,2401,54,0,130,0,6
72155,1,2497,2474,23,0,132,1,6
72156,3,2452,2525,-73,0,107,0,6
72157,1,2437,2435,2,0,49,1,6
72158,1,2659,2549,110,0,151,0,6
72159,2,2406,2514,-108,0,242,0,6
72160,1,2510,2412,98,0,140,0,6
72161,2,2466,2453,13,0,337,0,6
72162,3,2403,2646,-243,0,40,0,6
72163,1,2506,2455,51,0,106,0,6
72164,3,2438,2359,79,0,30,0,6
72165,2,2416,2289,127,0,248,0,6
72166,1,2414,2390,24,0,404,0,6
72167,3,2530,2380,150,0,156,0,6
72168,1,2330,2498,-168,0,245,1,8
72169,3,2286,2408,-122,0,250,0,6
72170,1,2561,2507,54,0,45,0,6
72171,2,2349,2504,-155,0,107,0,6
72172,3,2416,2554,-138,0,104,0,6
72173,2,2554,2520,34,0,4,0,6
72174,2,2425,2607,-182,0,352,0,6
72175,2,2447,2304,143,0,455,0,6
72176,2,2346,2538,-192,0,374,0,6
72177,2,2402,2479,-77,0,268,1,6
72178,1,2437,2518,-81,0,242,0,6
72179,1,2329,2436,-107,0,253,1,8
72180,2,2427,2408,19,0,142,1,8
72181,1,2615,2453,162,0,302,0,6
72182,1,2535,2217,318,0,45,1,6
72183,3,2264,2412,-148,0,218,0,6
72184,3,2387,2596,-209,0,108,0,6
72185,2,2270,2400,-130,4,132,0,13
72186,1,2421,2364,57,0,101,0,6
72187,2,2461,2501,-40,0,45,1,6
72188,2,2444,2374,70,0,154,0,6
72189,2,2436,2356,80,0,30,1,6
72190,2,2450,2390,60,0,222,0,6
72191,1,2593,2511,82,0,0,0,6
72192,2,2487,2444,43,0,0,0,6
72193,1,2563,2535,28,0,331,0,6
72194,2,2282,2495,-213,0,315,0,6
72195,3,2447,2493,-46,0,278,0,6
72196,2,2351,2453,-102,0,108,1,6
72197,1,2535,2582,-47,0,205,1,6
72198,2,2401,2442,-41,0,245,1,6
72199,1,2350,2419,-69,0,48,0,6
72200,2,2509,2369,140,0,43,1,6
72201,2,2434,2319,115,0,110,1,6
72202,1,2497,2315,182,0,300,0,6
72203,2,2485,2454,31,0,9,0,6
72204,1,2246,2441,-195,0,1,0,6
72205,1,2402,2355,47,0,14,0,6
72206,1,2405,2397,8,0,203,0,6
72207,1,2408,2514,-106,0,302,0,6
72208,1,2416,2272,144,0,112,0,6
72209,1,2463,2468,-5,0,300,0,6
72210,1,2491,2456,35,0,107,0,6
72211,1,2408,2289,119,0,101,0,6
72212,2,2258,2442,-184,0,45,0,6
72213,1,2500,2421,79,0,220,0,8
72214,1,2539,2312,227,0,40,0,6
72215,1,2383,2448,-65,0,386,1,6
72216,1,2440,2330,110,0,80,1,6
72217,2,2287,2418,-131,0,123,0,6
72218,2,2246,2551,-305,0,455,0,6
72219,1,2408,2481,-73,0,310,1,6
72220,1,2502,2649,-147,0,4,0,6
72221,1,2423,2237,186,0,148,0,6
72222,2,2443,2355,88,0,373,0,6
72223,1,2430,2304,126,0,41,0,6
72224,1,2403,2302,101,0,150,1,6
72225,1,2404,2231,173,0,131,0,6
72226,2,2453,2541,-88,0,112,0,6
72227,2,2469,2502,-33,0,242,0,6
72228,1,2397,2411,-14,0,338,0,6
72229,1,2446,2496,-50,0,455,0,6
72230,1,2585,2618,-33,0,106,0,6
72231,1,2472,2201,271,0,255,0,6
72232,1,2528,2361,167,0,42,0,6
72233,1,2446,2463,-17,0,140,0,6
72234,2,2510,2460,50,0,6,0,6
72235,1,2383,2481,-98,0,42,0,6
72236,1,2451,2472,-21,0,45,0,6
72237,2,2643,2270,373,0,442,0,6
72238,1,2411,2287,124,0,305,1,6
72239,2,2576,2547,29,0,225,0,6
72240,3,2526,2597,-71,0,210,0,6
72241,2,2507,2542,-35,0,0,0,6
72242,1,2342,2505,-163,0,110,0,6
72243,1,2469,2327,142,0,40,0,6
72244,3,2450,2379,71,0,101,0,6
72245,1,2511,2462,49,0,300,0,6
72246,3,2545,2449,96,0,40,0,6
72247,1,2437,2427,10,0,190,0,6
72248,3,2314,2415,-101,0,267,0,6
72249,1,2554,2527,27,0,304,0,6
72250,1,2427,2346,81,0,0,0,6
72251,1,2596,2405,191,0,1,0,6
72252,1,2405,2258,147,0,127,0,6
72254,1,2452,2377,75,0,111,0,6
72255,1,2425,2458,-33,0,21,0,6
72256,2,2457,2502,-45,0,27,0,6
72257,1,2240,2420,-180,0,302,0,6
72258,1,2650,2641,9,0,300,1,6
72259,1,2360,2437,-77,0,49,0,6
72260,3,2403,2559,-156,0,453,0,6
72261,2,2522,2570,-48,0,106,0,6
72262,1,2484,2304,180,0,406,0,6
72263,1,2564,2596,-32,0,121,1,6
72264,2,2415,2240,175,0,332,0,6
72265,2,2445,2557,-112,0,461,1,6
72266,3,2422,2405,17,0,245,0,6
72267,1,2432,2400,32,0,242,0,6
72268,1,2363,2429,-66,0,40,1,6
72269,1,2457,2347,110,0,101,0,6
72270,2,2409,2392,17,0,255,0,6
72271,1,2553,2632,-79,0,45,0,6
72272,2,2335,2448,-113,0,353,0,6
72273,1,2474,2399,75,0,0,1,6
72274,2,2610,2508,102,0,312,0,6
72275,1,2506,2390,116,0,156,1,6
72276,1,2220,2408,-188,0,40,0,6
72277,1,2492,2352,140,0,107,0,6
72278,3,2422,2436,-14,0,244,0,6
72279,2,2363,2435,-72,0,110,0,6
72280,1,2391,2411,-20,0,104,1,6
72281,1,2437,2471,-34,0,45,1,6
72282,1,2460,2308,152,0,127,0,6
72283,1,2243,2412,-169,0,40,1,6
72284,1,2409,2235,174,0,50,0,6
72285,1,2506,2370,136,0,4,1,6
72286,2,2529,2518,11,0,437,0,6
72287,1,2434,2362,72,0,200,0,6
72288,1,2547,2256,291,0,112,0,6
72289,1,2412,2544,-132,0,411,0,6
72290,1,2422,2443,-21,0,300,1,6
72291,2,2250,2418,-168,0,301,0,6
72292,1,2421,2256,165,0,211,0,8
72293,2,2444,2524,-80,0,49,0,6
72294,2,2300,2474,-174,0,40,0,6
72295,1,2612,2448,164,0,463,0,6
72296,2,2464,2432,32,0,106,0,6
72297,2,2287,2405,-118,0,277,0,6
72298,2,2383,2503,-120,0,134,0,6
72299,3,2575,2599,-24,0,201,0,6
72300,2,2402,2517,-115,0,123,0,6
72301,1,2502,2367,135,0,211,0,6
72303,2,2285,2456,-171,0,394,0,6
72304,1,2507,2497,10,0,300,0,6
72305,2,2448,2453,-5,0,219,0,6
72306,2,2341,2495,-154,0,188,0,6
72307,2,2283,2415,-132,0,331,1,6
72309,3,2516,2448,68,0,300,0,6
72310,1,2380,2409,-29,0,80,0,6
72311,1,2626,2398,228,0,447,0,6
72312,3,2408,2521,-113,0,70,0,6
72313,2,2323,2457,-134,0,141,0,6
72314,2,2512,2211,301,0,211,1,3
72315,2,2319,2455,-136,0,15,0,6
72316,2,2324,2505,-181,0,40,0,8
72317,2,2451,2472,-21,0,45,0,6
72318,2,2272,2417,-145,0,454,0,6
72319,2,2420,2472,-52,0,406,1,6
72320,1,2416,2328,88,0,185,0,6
72321,1,2476,2440,36,0,13,0,6
72322,2,2238,2425,-187,0,301,0,8
72323,1,2545,2329,216,0,40,0,6
72324,1,2480,2441,39,0,375,1,6
72325,2,2409,2222,187,0,153,0,6
72326,1,2400,2283,117,0,151,0,6
72327,3,2343,2452,-109,0,30,0,6
72328,2,2542,2660,-118,0,436,0,6
72329,2,2561,2598,-37,0,1,0,6
72330,2,2441,2422,19,0,0,0,6
72331,2,2490,2377,113,0,332,1,6
72332,3,2410,2628,-218,0,40,0,6
72333,2,2636,2656,-20,0,331,0,6
72334,1,2503,2512,-9,0,4,0,6
72335,1,2358,2438,-80,0,40,0,6
72336,1,2397,2413,-16,0,337,0,6
72337,1,2496,2362,134,0,143,0,6
72338,2,2457,2452,5,0,438,0,6
72339,1,2519,2406,113,0,268,0,6
72340,2,2343,2446,-103,0,305,0,6
72341,2,2391,2478,-87,0,54,0,6
72342,1,2447,2316,131,0,140,0,6
72343,2,2423,2354,69,0,10,1,6
72344,2,2492,2506,-14,0,432,0,6
72345,2,2516,2449,67,0,45,1,6
72346,2,2526,2524,2,0,306,1,6
72347,1,2409,2376,33,0,120,1,6
72348,2,2403,2327,76,0,4,0,6
72349,1,2404,2386,18,0,140,0,6
72350,1,2405,2397,8,0,211,1,6
72351,2,2318,2412,-94,0,464,1,6
72352,1,2378,2404,-26,0,200,0,6
72353,1,2490,2281,209,0,176,0,8
72354,2,2251,2400,-149,0,122,0,6
72355,1,2499,2338,161,0,132,0,6
72356,1,2406,2251,155,0,17,0,6
72357,3,2604,2550,54,0,0,0,6
72358,2,2296,2510,-214,0,46,0,6
72359,3,2506,2561,-55,0,301,0,6
72360,2,2435,2285,150,0,302,0,6
72361,1,2365,2503,-138,0,108,0,6
72362,1,2548,2558,-10,0,41,0,6
72363,1,2590,2615,-25,0,106,1,6
72364,2,2481,2443,38,0,15,1,6
72365,1,2431,2365,66,0,107,0,6
72366,2,2438,2438,0,0,106,1,6
72367,1,2413,2356,57,0,311,1,6
72368,1,2362,2400,-38,0,120,0,6
72369,2,2451,2312,139,0,14,0,6
72370,2,2259,2579,-320,0,110,0,6
72371,1,2363,2505,-142,0,49,1,6
72372,3,2575,2603,-28,0,203,0,6
72373,1,2551,2413,138,0,190,0,6
72374,2,2394,2625,-231,0,10,0,6
72375,1,2417,2360,57,4,111,1,13
72376,2,2428,2552,-124,0,45,0,6
72377,1,2406,2300,106,0,123,0,6
72378,3,2437,2285,152,0,145,0,6
72379,1,2450,2339,111,0,40,0,6
72380,1,2449,2553,-104,0,41,0,6
72381,2,2396,2515,-119,0,312,0,6
72382,1,2401,2219,182,0,255,0,6
72383,1,2511,2458,53,0,315,0,6
72384,1,2348,2443,-95,0,153,0,6
72385,3,2299,2412,-113,0,188,0,6
72386,2,2507,2509,-2,0,45,1,6
72387,2,2246,2556,-310,0,40,0,6
72388,2,2422,2294,128,0,113,0,6
72389,2,2242,2409,-167,0,335,1,6
72390,2,2528,2460,68,0,106,0,6
72391,2,2387,2401,-14,0,153,1,6
72392,3,2664,2538,126,0,46,0,6
72393,3,2407,2253,154,0,0,0,6
72394,2,2224,2403,-179,0,48,0,6
72395,3,2436,2435,1,0,247,0,6
72396,1,2482,2478,4,0,45,0,6
72397,2,2661,2630,31,0,320,0,6
72398,1,2569,2486,83,0,118,0,6
72399,1,2475,2282,193,0,302,0,6
72400,2,2335,2454,-119,0,302,0,6
72401,1,2581,2290,291,0,4,0,6
72402,2,2357,2439,-82,0,225,0,6
72403,2,2403,2380,23,0,127,0,6
72404,1,2334,2436,-102,0,120,0,6
72405,3,2453,2456,-3,0,315,0,6
72406,2,2296,2401,-105,0,380,1,6
72407,1,2405,2267,138,4,10,0,13
72408,2,2460,2521,-61,0,301,1,6
72409,2,2312,2451,-139,0,10,0,6
72410,2,2264,2404,-140,0,43,1,6
72411,1,2478,2297,181,0,46,0,6
72412,1,2509,2416,93,0,302,1,6
72413,1,2414,2248,166,0,202,0,8
72414,2,2456,2513,-57,0,133,0,6
72415,2,2392,2436,-44,0,14,0,6
72416,2,2627,2435,192,0,365,0,6
72417,3,2461,2342,119,0,101,0,6
72418,1,2637,2516,121,0,104,0,6
72419,1,2433,2280,153,0,133,0,6
72420,1,2248,2407,-159,0,405,1,6
72421,1,2414,2345,69,0,357,0,6
72422,2,2349,2405,-56,0,226,0,6
72423,2,2382,2408,-26,0,0,0,6
72424,2,2392,2410,-18,0,242,1,6
72425,2,2274,2428,-154,0,106,0,6
72426,1,2507,2524,-17,0,107,0,6
72427,2,2305,2466,-161,0,224,1,6
72428,1,2472,2529,-57,0,8,1,6
72429,2,2425,2255,170,0,135,0,6
72430,2,2379,2409,-30,0,320,0,6
72431,1,2451,2436,15,0,453,1,6
72432,1,2563,2502,61,0,268,0,6
72433,2,2402,2294,108,0,331,0,6
72434,2,2558,2554,4,0,305,0,6
72435,2,2488,2428,60,0,45,0,6
72436,2,2335,2416,-81,0,101,1,6
72437,2,2409,2470,-61,0,101,0,6
72438,1,2412,2475,-63,0,459,0,6
72439,2,2637,2655,-18,0,331,0,6
72440,1,2387,2427,-40,0,13,1,6
72441,1,2294,2450,-156,0,133,1,6
72442,1,2360,2436,-76,0,45,1,6
72443,1,2458,2331,127,0,40,1,6
72444,2,2498,2390,108,0,40,0,6
72445,1,2397,2405,-8,0,305,1,6
72446,1,2256,2478,-222,0,310,0,6
72447,1,2479,2444,35,0,485,1,6
72448,3,2307,2428,-121,0,49,0,8
72449,1,2513,2265,248,0,211,0,6
72450,2,2518,2381,137,0,248,0,6
72451,1,2540,2662,-122,0,411,0,6
72452,1,2340,2424,-84,0,315,0,6
72453,1,2609,2596,13,0,428,0,6
72454,1,2312,2557,-245,0,124,0,6
72455,3,2432,2584,-152,0,113,0,6
72456,3,2501,2666,-165,0,43,0,6
72457,2,2381,2498,-117,0,277,0,6
72458,1,2327,2444,-117,0,108,1,6
72459,2,2459,2449,10,0,300,0,6
72460,1,2457,2388,69,0,347,1,6
72461,3,2458,2451,7,0,140,0,6
72462,1,2410,2296,114,0,151,0,6
72463,2,2333,2403,-70,0,4,0,6
72464,2,2504,2519,-15,0,227,0,6
72465,3,2206,2602,-396,0,115,0,6
72466,3,2482,2573,-91,0,330,0,6
72467,1,2561,2424,137,0,455,0,6
72468,1,2414,2478,-64,0,127,0,6
72469,1,2413,2406,7,0,455,0,6
72470,1,2536,2372,164,0,201,0,6
72471,1,2646,2453,193,0,311,0,6
72472,2,2296,2416,-120,0,200,0,6
72473,2,2518,2363,155,0,140,0,6
72474,2,2515,2501,14,0,6,0,6
72475,1,2413,2268,145,0,113,0,6
72476,1,2576,2552,24,0,100,0,6
72477,3,2560,2510,50,0,154,0,6
72478,2,2456,2481,-25,0,45,0,6
72479,1,2465,2382,83,0,215,0,6
72480,1,2373,2454,-81,0,4,0,6
72481,2,2406,2308,98,0,414,0,6
72482,2,2406,2239,167,0,302,0,6
72483,1,2572,2590,-18,0,105,0,6
72484,2,2307,2435,-128,0,151,0,6
72485,1,2415,2374,41,0,342,1,6
72486,1,2619,2410,209,0,335,0,6
72487,3,2444,2419,25,0,43,0,6
72488,2,2297,2644,-347,2,145,0,25
72489,1,2367,2415,-48,0,101,1,6
72490,3,2420,2561,-141,0,103,0,6
72491,1,2435,2468,-33,0,100,0,6
72492,1,2351,2475,-124,0,301,1,6
72493,1,2414,2216,198,0,152,0,6
72494,1,2341,2428,-87,0,345,0,6
72495,1,2511,2516,-5,0,302,0,6
72496,3,2399,2559,-160,0,345,0,6
72497,1,2483,2458,25,0,123,0,6
72498,2,2380,2410,-30,0,45,1,6
72499,1,2412,2399,13,0,0,0,6
72500,1,2256,2432,-176,0,106,0,6
72501,1,2419,2405,14,0,278,0,6
72502,1,2379,2513,-134,0,302,0,6
72503,1,2408,2260,148,0,202,0,6
72504,1,2377,2459,-82,0,320,1,6
72505,1,2417,2347,70,0,354,0,6
72506,2,2408,2367,41,0,41,0,6
72507,3,2363,2400,-37,0,120,0,6
72508,1,2451,2432,19,0,310,0,6
72509,2,2447,2380,67,0,111,0,6
72510,2,2415,2408,7,0,4,0,6
72511,2,2523,2483,40,0,484,1,6
72512,2,2421,2329,92,0,60,1,6
72513,1,2419,2225,194,0,461,0,6
72514,1,2429,2330,99,0,130,0,6
72515,3,2422,2622,-200,0,122,0,6
72516,3,2558,2582,-24,0,58,0,6
72517,2,2408,2547,-139,0,40,0,6
72518,1,2572,2483,89,0,118,0,6
72519,1,2548,2255,293,0,285,0,6
72520,3,2359,2504,-145,0,120,0,6
72521,1,2355,2430,-75,0,426,0,6
72522,2,2661,2631,30,0,7,0,6
72523,2,2417,2462,-45,0,13,1,6
72524,2,2401,2328,73,0,128,1,6
72525,1,2654,2548,106,0,1,0,6
72526,2,2415,2481,-66,0,52,0,6
72527,1,2477,2328,149,0,13,0,6
72528,1,2408,2328,80,0,126,1,6
72529,3,2424,2401,23,0,338,0,6
72530,3,2442,2211,231,0,123,0,6
72531,3,2598,2557,41,0,1,0,6
72532,1,2421,2453,-32,0,190,0,6
72533,1,2675,2661,14,0,101,0,6
72534,2,2502,2484,18,0,45,0,6
72535,2,2472,2439,33,0,0,0,6
72536,3,2444,2338,106,0,4,0,6
72537,1,2248,2403,-155,0,107,0,6
72538,2,2410,2239,171,0,211,0,6
72539,3,2524,2434,90,0,300,0,6
72540,3,2584,2615,-31,0,319,0,6
72541,2,2539,2582,-43,0,313,1,6
72542,3,2507,2509,-2,0,45,0,6
72543,2,2416,2417,-1,0,217,1,6
72544,1,2368,2439,-71,0,305,0,6
72545,1,2436,2335,101,0,123,0,6
72546,2,2400,2425,-25,0,196,0,6
72547,2,2203,2404,-201,0,447,0,6
72548,1,2450,2507,-57,0,247,0,6
72549,2,2430,2482,-52,0,7,0,6
72550,1,2402,2294,108,0,302,1,6
72551,3,2365,2456,-91,0,400,0,6
72552,2,2387,2440,-53,0,5,0,6
72553,2,2257,2411,-154,0,43,1,6
72554,2,2420,2510,-90,0,18,0,6
72555,1,2426,2456,-30,0,310,0,6
72556,1,2443,2315,128,0,46,0,6
72557,1,2307,2472,-165,0,205,0,6
72558,1,2343,2421,-78,0,202,0,6
72559,3,2362,2504,-142,0,432,0,6
72560,1,2499,2550,-51,0,247,0,6
72561,2,2226,2516,-290,0,110,0,6
72562,3,2479,2576,-97,0,330,0,6
72563,3,2468,2461,7,0,20,0,6
72564,1,2415,2397,18,0,130,0,6
72565,1,2399,2496,-97,0,288,1,6
72566,1,2505,2490,15,0,46,1,6
72567,1,2421,2294,127,0,120,0,6
72568,1,2591,2659,-68,0,428,0,6
72569,1,2584,2323,261,0,6,0,6
72570,1,2452,2387,65,0,101,0,6
72571,2,2628,2446,182,0,15,0,6
72572,2,2277,2426,-149,0,150,1,8
72573,1,2467,2412,55,0,4,1,6
72574,2,2614,2585,29,0,106,0,6
72575,1,2384,2433,-49,0,250,1,6
72576,1,2530,2363,167,0,100,1,6
72577,1,2494,2517,-23,0,8,1,6
72578,1,2414,2350,64,0,354,0,6
72579,1,2523,2467,56,0,43,1,6
72580,1,2428,2436,-8,0,132,0,6
72581,1,2414,2315,99,0,0,1,6
72582,2,2204,2550,-346,0,130,0,6
72583,3,2447,2414,33,0,101,0,6
72584,2,2451,2458,-7,0,438,0,6
72585,1,2500,2457,43,0,127,0,6
72586,1,2377,2454,-77,0,439,0,6
72587,1,2425,2480,-55,0,45,1,6
72588,1,2514,2332,182,0,132,0,6
72589,2,2304,2415,-111,0,144,0,6
72590,1,2424,2333,91,0,103,0,6
72591,2,2469,2469,0,0,38,0,6
72592,1,2437,2507,-70,0,132,1,6
72593,2,2501,2326,175,0,145,0,6
72594,2,2247,2513,-266,0,201,1,6
72595,2,2487,2375,112,0,300,1,6
72596,1,2302,2466,-164,0,45,0,6
72597,1,2605,2694,-89,0,108,0,6
72598,2,2438,2369,69,0,153,0,6
72599,1,2544,2377,167,0,45,0,6
72600,2,2308,2471,-163,0,461,0,6
72601,1,2518,2200,318,0,45,0,6
72602,1,2451,2346,105,0,353,1,6
72603,2,2421,2331,90,0,49,0,6
72604,1,2652,2597,55,0,0,0,6
72605,1,2472,2354,118,0,130,0,6
72606,2,2391,2421,-30,0,414,0,6
72607,2,2425,2364,61,0,8,1,6
72608,2,2314,2422,-108,4,107,0,13
72609,2,2345,2419,-74,0,315,1,6
72610,1,2534,2506,28,0,45,0,6
72611,1,2423,2253,170,0,112,0,6
72612,2,2587,2430,157,0,18,0,6
72613,1,2447,2384,63,0,113,1,6
72614,2,2402,2254,148,0,49,1,6
72615,3,2554,2591,-37,0,46,0,6
72616,2,2450,2447,3,0,310,1,6
72617,2,2400,2310,90,0,80,0,6
72618,1,2432,2434,-2,0,211,1,6
72619,2,2502,2608,-106,0,106,1,6
72620,2,2452,2505,-53,0,246,1,6
72621,2,2321,2414,-93,0,101,1,6
72622,2,2444,2521,-77,0,134,0,6
72623,2,2329,2488,-159,0,45,0,6
72624,1,2415,2443,-28,0,277,0,6
72625,2,2553,2517,36,0,122,0,6
72626,2,2414,2461,-47,0,302,0,6
72627,2,2408,2307,101,2,200,0,8
72628,2,2437,2445,-8,0,150,0,6
72629,1,2508,2441,67,0,404,0,6
72630,3,2354,2468,-114,0,121,0,6
72631,2,2244,2409,-165,0,46,1,6
72632,2,2467,2464,3,0,143,1,6
72633,1,2414,2510,-96,0,436,1,6
72634,2,2348,2403,-55,0,277,1,8
72635,2,2247,2428,-181,0,115,1,6
72636,2,2485,2534,-49,0,35,0,6
72637,2,2291,2453,-162,0,11,0,6
72638,2,2407,2472,-65,0,10,1,6
72639,2,2275,2443,-168,0,215,0,6
72640,2,2294,2406,-112,0,269,0,6
72641,1,2433,2397,36,0,101,0,6
72642,1,2384,2586,-202,0,115,0,6
72643,2,2354,2547,-193,0,200,0,6
72644,2,2247,2419,-172,0,215,0,6
72645,1,2288,2464,-176,0,200,0,6
72646,2,2418,2427,-9,0,0,1,6
72647,1,2490,2430,60,0,306,1,6
72648,2,2401,2543,-142,0,245,1,6
72649,1,2528,2345,183,0,40,0,6
72650,1,2407,2289,118,0,151,0,6
72651,2,2402,2424,-22,0,211,0,6
72652,1,2462,2507,-45,0,27,1,6
72653,2,2360,2439,-79,0,301,0,6
72654,1,2526,2386,140,0,108,1,6
72655,1,2432,2476,-44,0,45,1,6
72656,2,2448,2261,187,4,112,0,13
72657,2,2590,2774,-184,0,0,0,6
72658,1,2455,2367,88,0,42,0,6
72659,1,2458,2405,53,0,359,0,6
72660,1,2422,2310,112,0,200,0,6
72661,1,2474,2312,162,0,327,0,6
72662,3,2446,2376,70,0,190,0,6
72663,3,2648,2591,57,0,335,0,6
72664,1,2499,2315,184,0,20,1,6
72665,1,2593,2657,-64,0,106,0,6
72666,2,2411,2360,51,0,336,0,6
72667,1,2216,2519,-303,0,113,0,6
72668,2,2432,2441,-9,0,453,0,6
72669,1,2456,2426,30,0,106,0,6
72670,2,2479,2310,169,0,45,0,6
72671,1,2524,2555,-31,0,107,0,6
72672,1,2426,2386,40,0,123,1,6
72673,1,2424,2341,83,0,313,0,6
72674,1,2315,2414,-99,0,5,0,8
72675,1,2431,2358,73,0,133,1,6
72676,2,2383,2539,-156,0,40,0,6
72677,1,2400,2367,33,0,112,0,6
72678,2,2438,2579,-141,0,115,1,6
72679,2,2385,2419,-34,0,40,0,6
72680,3,2492,2501,-9,0,40,0,6
72681,2,2349,2512,-163,0,120,0,6
72682,2,2364,2431,-67,0,111,0,6
72683,3,2317,2427,-110,4,107,0,13
72684,1,2342,2455,-113,0,15,1,6
72685,1,2510,2447,63,0,127,0,6
72686,3,2451,2432,19,0,200,0,6
72687,1,2329,2504,-175,0,16,0,6
72688,2,2454,2511,-57,0,265,0,6
72689,1,2469,2498,-29,0,105,1,6
72690,2,2401,2285,116,0,310,1,6
72691,1,2390,2463,-73,0,277,0,6
72692,1,2429,2254,175,0,100,0,8
72693,2,2466,2439,27,0,190,1,6
72694,1,2477,2403,74,0,103,0,6
72695,1,2612,2480,132,0,469,1,6
72696,2,2550,2335,215,0,49,0,6
72697,2,2385,2539,-154,0,119,0,6
72698,1,2285,2405,-120,0,256,0,6
72699,2,2515,2320,195,0,6,0,6
72700,2,2306,2402,-96,0,45,0,6
72701,1,2336,2428,-92,0,315,1,6
72702,3,2503,2428,75,0,411,0,6
72703,2,2456,2327,129,0,305,0,6
72704,2,2286,2461,-175,0,205,0,6
72705,3,2421,2411,10,0,127,0,6
72706,1,2650,2599,51,0,303,1,6
72707,1,2219,2400,-181,0,101,0,6
72708,3,2500,2317,183,0,138,0,6
72709,1,2470,2475,-5,0,45,1,6
72710,1,2420,2423,-3,0,45,1,6
72711,1,2415,2367,48,0,210,0,6
72712,2,2434,2444,-10,0,12,0,6
72713,2,2449,2494,-45,0,181,0,6
72714,2,2365,2531,-166,0,242,1,6
72715,2,2432,2513,-81,0,101,0,6
72716,2,2281,2413,-132,0,200,0,6
72717,1,2418,2264,154,0,4,0,6
72718,2,2238,2422,-184,0,456,0,6
72719,2,2515,2461,54,0,400,0,6
72720,2,2342,2444,-102,0,133,0,6
72721,1,2418,2397,21,0,46,0,6
72722,2,2436,2448,-12,0,121,0,6
72723,3,2498,2496,2,0,40,0,6
72724,2,2430,2423,7,0,301,1,6
72725,2,2415,2418,-3,0,130,0,6
72726,2,2392,2400,-8,0,374,0,6
72727,2,2398,2481,-83,0,20,1,6
72728,2,2281,2448,-167,0,4,0,6
72729,3,2538,2220,318,0,250,0,8
72730,1,2474,2464,10,0,392,0,6
72731,2,2547,2398,149,0,333,0,6
72732,2,2402,2496,-94,0,312,0,6
72733,1,2425,2431,-6,0,128,1,6
72734,2,2501,2468,33,0,45,0,6
72735,2,2530,2444,86,0,132,0,6
72736,1,2424,2303,121,0,113,0,6
72737,2,2377,2439,-62,0,331,0,6
72738,1,2381,2431,-50,0,414,0,6
72739,1,2518,2549,-31,0,330,1,6
72740,1,2492,2403,89,0,46,0,6
72741,1,2777,2648,129,0,400,0,6
72742,2,2390,2542,-152,0,200,0,6
72743,3,2456,2550,-94,0,313,0,6
72744,1,2424,2326,98,0,13,0,6
72745,2,2259,2403,-144,0,200,0,6
72746,2,2351,2579,-228,0,306,0,6
72747,1,2351,2406,-55,0,298,0,8
72748,1,2411,2282,129,0,151,0,6
72749,1,2464,2421,43,0,201,0,6
72750,1,2452,2501,-49,0,200,0,6
72751,1,2407,2340,67,0,268,1,6
72752,3,2446,2336,110,0,102,0,6
72753,3,2543,2380,163,0,337,0,6
72754,1,2449,2330,119,0,241,0,6
72755,1,2478,2348,130,0,41,1,6
72756,2,2442,2471,-29,0,140,0,6
72757,1,2475,2494,-19,0,27,0,6
72758,3,2409,2331,78,0,101,0,6
72759,3,2306,2476,-170,0,454,0,6
72760,2,2421,2361,60,0,4,0,6
72761,2,2430,2396,34,0,337,0,6
72762,2,2542,2387,155,0,17,0,6
72763,1,2516,2356,160,0,84,0,6
72764,1,2583,2435,148,0,181,1,6
72765,2,2334,2472,-138,0,40,0,6
72766,1,2354,2428,-74,0,45,0,6
72767,2,2450,2347,103,0,101,0,6
72768,1,2459,2297,162,0,404,0,6
72769,2,2350,2465,-115,0,200,0,6
72770,2,2616,2592,24,0,335,0,6
72771,2,2406,2431,-25,0,122,1,6
72772,3,2299,2420,-121,0,317,0,6
72773,1,2345,2476,-131,0,123,0,6
72774,1,2328,2470,-142,0,305,0,6
72775,1,2408,2267,141,0,45,1,8
72776,1,2492,2397,95,0,277,0,6
72777,3,2335,2447,-112,0,152,0,6
72778,2,2385,2410,-25,0,255,0,6
72779,2,2350,2445,-95,0,49,0,6
72780,2,2293,2460,-167,0,123,0,6
72781,3,2425,2293,132,0,40,0,6
72782,2,2358,2424,-66,0,0,1,6
72783,1,2424,2285,139,0,333,0,6
72784,2,2421,2344,77,0,406,0,6
72785,1,2423,2260,163,0,107,0,6
72786,2,2500,2502,-2,0,105,0,6
72787,2,2208,2412,-204,0,5,0,6
72788,1,2281,2417,-136,0,40,0,6
72789,2,2405,2279,126,0,22,0,6
72790,1,2595,2655,-60,0,428,0,6
72791,2,2429,2204,225,0,353,0,6
72792,1,2458,2443,15,0,310,0,6
72793,2,2334,2479,-145,0,277,1,6
72794,1,2317,2469,-152,0,211,0,6
72795,1,2382,2416,-34,0,215,0,6
72796,1,2486,2498,-12,0,41,0,6
72797,1,2486,2394,92,0,40,0,6
72798,1,2451,2519,-68,0,131,1,6
72799,2,2389,2523,-134,0,350,0,6
72800,2,2541,2352,189,0,151,0,6
72801,1,2469,2395,74,0,138,0,6
72802,2,2447,2335,112,0,9,0,6
72803,1,2409,2272,137,0,0,0,6
72804,2,2509,2534,-25,0,330,1,6
72805,1,2505,2450,55,0,405,0,6
72806,3,2453,2355,98,0,315,0,6
72807,1,2496,2430,66,0,49,0,6
72808,2,2498,2341,157,0,414,1,6
72809,1,2372,2412,-40,0,40,0,6
72810,1,2448,2443,5,0,302,0,6
72811,2,2316,2428,-112,0,264,0,6
72812,1,2518,2496,22,0,48,0,6
72813,3,2475,2444,31,0,453,0,6
72814,1,2418,2401,17,0,374,0,6
72815,3,2397,2441,-44,0,4,0,6
72816,1,2545,2371,174,0,45,0,6
72817,1,2511,2230,281,0,302,0,6
72818,2,2425,2388,37,0,123,0,6
72819,1,2494,2431,63,0,133,0,6
72820,3,2383,2428,-45,0,485,0,6
72821,2,2543,2527,16,0,46,0,6
72822,2,2322,2407,-85,0,103,1,6
72823,3,2409,2368,41,0,4,0,6
72824,1,2449,2355,94,0,101,0,6
72825,1,2440,2330,110,0,123,0,6
72826,1,2549,2644,-95,0,127,0,6
72827,1,2457,2300,157,0,80,1,6
72828,2,2317,2504,-187,0,315,1,6
72829,3,2341,2497,-156,0,246,0,6
72830,1,2425,2527,-102,0,130,0,6
72831,1,2438,2355,83,0,406,0,6
72832,1,2476,2437,39,0,45,0,6
72833,2,2378,2403,-25,0,48,0,6
72834,1,2350,2427,-77,0,300,0,6
72835,2,2429,2349,80,0,45,0,6
72836,2,2209,2542,-333,0,52,0,6
72837,1,2327,2453,-126,0,120,1,6
72838,1,2409,2256,153,0,112,0,6
72839,1,2511,2482,29,0,4,0,6
72840,1,2281,2420,-139,0,426,0,6
72841,2,2496,2578,-82,0,107,1,6
72842,1,2400,2357,43,0,255,0,8
72843,1,2393,2540,-147,0,100,0,6
72844,1,2502,2403,99,0,388,1,6
72845,2,2560,2426,134,0,302,0,6
72846,1,2432,2405,27,0,269,0,8
72847,1,2277,2404,-127,0,127,0,6
72848,2,2421,2385,36,0,4,1,6
72849,1,2425,2336,89,4,113,0,13
72850,1,2457,2382,75,0,13,0,6
72851,1,2383,2411,-28,0,335,0,6
72852,2,2484,2361,123,0,133,0,6
72853,2,2431,2350,81,0,107,0,6
72854,1,2426,2396,30,0,214,0,6
72855,1,2393,2452,-59,0,331,1,6
72856,1,2335,2610,-275,0,106,1,6
72857,2,2390,2490,-100,0,10,1,6
72858,2,2396,2463,-67,0,8,0,6
72859,1,2500,2356,144,0,40,0,6
72860,1,2406,2260,146,0,0,1,6
72861,1,2492,2501,-9,0,190,0,6
72862,1,2535,2537,-2,0,6,0,6
72863,1,2445,2368,77,0,123,0,6
72864,2,2378,2454,-76,0,380,0,6
72865,1,2420,2448,-28,0,333,0,6
72866,1,2345,2477,-132,0,40,0,6
72867,1,2508,2397,111,0,46,1,6
72868,1,2423,2391,32,0,40,1,6
72869,1,2355,2548,-193,0,200,0,6
72870,2,2351,2414,-63,0,6,1,6
72871,2,2401,2413,-12,0,106,0,6
72872,2,2481,2495,-14,0,463,1,6
72873,1,2437,2464,-27,0,111,1,6
72874,1,2556,2459,97,0,152,1,6
72875,2,2518,2444,74,0,201,0,6
72876,3,2469,2428,41,0,42,0,6
72877,1,2412,2395,17,0,200,0,6
72878,2,2296,2425,-129,0,474,0,6
72879,1,2637,2481,156,0,54,0,6
72880,1,2476,2359,117,0,100,0,6
72881,1,2648,2432,216,0,48,0,6
72882,1,2415,2310,105,0,16,0,6
72883,1,2462,2348,114,0,192,0,6
72884,2,2492,2440,52,0,46,0,6
72885,3,2440,2423,17,0,100,0,6
72886,1,2451,2278,173,0,1,1,6
72887,2,2298,2444,-146,0,200,0,6
72888,1,2473,2568,-95,0,484,0,6
72889,2,2345,2420,-75,0,448,1,6
72890,2,2368,2486,-118,0,365,0,6
72891,1,2446,2532,-86,0,40,1,6
72892,1,2424,2348,76,0,57,0,6
72893,2,2407,2311,96,0,211,0,6
72894,2,2443,2345,98,0,4,0,6
72895,1,2425,2247,178,0,302,0,6
72896,1,2491,2560,-69,0,302,0,6
72897,1,2295,2453,-158,0,56,0,6
72898,1,2418,2397,21,0,483,1,6
72899,1,2263,2418,-155,0,106,0,6
72900,1,2483,2523,-40,0,315,1,6
72901,2,2519,2401,118,0,221,0,6
72902,1,2433,2539,-106,0,227,0,6
72903,1,2445,2461,-16,0,297,0,6
72904,1,2309,2422,-113,0,300,0,6
72905,1,2462,2468,-6,0,107,1,6
72906,1,2499,2296,203,0,190,0,6
72907,2,2473,2419,54,0,0,0,6
72908,1,2487,2498,-11,0,341,1,6
72909,2,2468,2504,-36,0,253,1,6
72910,2,2317,2450,-133,0,352,0,6
72911,2,2260,2443,-183,0,310,0,6
72912,3,2450,2403,47,4,151,0,13
72913,1,2421,2356,65,0,385,0,6
72914,2,2427,2412,15,0,102,0,6
72915,2,2318,2458,-140,0,245,1,6
72916,2,2489,2445,44,0,411,0,6
72917,1,2405,2348,57,0,106,0,6
72918,1,2355,2480,-125,0,0,0,6
72919,2,2324,2403,-79,0,323,0,6
72920,2,2208,2508,-300,0,344,0,6
72921,1,2419,2321,98,0,11,0,6
72922,1,2434,2228,206,0,213,0,6
72923,1,2536,2374,162,0,106,0,6
72924,2,2409,2370,39,0,112,1,6
72925,2,2428,2469,-41,0,12,0,6
72926,2,2336,2415,-79,0,145,0,6
72927,3,2382,2445,-63,0,45,0,6
72928,2,2430,2411,19,0,10,0,8
72929,2,2415,2504,-89,0,40,0,6
72930,1,2494,2386,108,0,40,0,6
72931,1,2400,2290,110,0,0,0,6
72932,1,2324,2466,-142,0,303,0,6
72933,1,2424,2340,84,0,297,1,6
72934,1,2430,2651,-221,0,101,0,6
72935,1,2473,2363,110,0,40,0,6
72936,3,2491,2458,33,0,264,0,6
72937,2,2540,2398,142,0,300,0,6
72938,1,2295,2652,-357,2,52,1,24
72939,1,2410,2331,79,0,0,0,6
72940,1,2439,2317,122,0,120,0,6
72941,2,2221,2429,-208,0,483,0,6
72942,3,2442,2378,64,0,211,0,6
72943,1,2363,2455,-92,0,426,0,6
72944,2,2302,2462,-160,0,11,1,6
72945,1,2532,2451,81,0,45,0,6
72946,3,2531,2543,-12,0,46,0,6
72947,3,2411,2230,181,0,91,0,6
72948,1,2445,2410,35,0,409,0,6
72949,2,2424,2400,24,0,7,0,6
72950,3,2419,2346,73,0,330,0,6
72951,2,2500,2512,-12,0,104,0,6
72952,1,2600,2440,160,0,55,0,6
72953,2,2345,2400,-55,0,196,0,6
72954,1,2539,2512,27,0,127,0,6
72955,1,2478,2640,-162,0,300,0,6
72956,1,2508,2492,16,0,302,0,6
72957,1,2446,2289,157,0,40,0,6
72958,2,2448,2405,43,0,111,1,6
72959,2,2392,2469,-77,0,56,0,6
72960,1,2443,2374,69,0,211,0,6
72961,1,2454,2271,183,0,456,0,6
72962,2,2410,2313,97,0,112,0,6
72963,2,2458,2408,50,0,345,1,6
72964,3,2364,2558,-194,0,106,0,6
72965,2,2475,2302,173,0,335,0,6
72966,1,2541,2231,310,0,4,0,6
72967,2,2354,2428,-74,0,70,1,6
72968,2,2418,2392,26,0,117,0,6
72969,2,2451,2495,-44,0,132,0,6
72970,3,2421,2453,-32,0,150,0,6
72971,1,2385,2498,-113,0,278,1,6
72972,3,2401,2289,112,0,113,0,6
72973,2,2313,2418,-105,0,300,0,6
72974,1,2445,2363,82,0,200,0,6
72975,2,2778,2587,191,0,46,0,6
72976,1,2553,2481,72,0,151,1,6
72977,2,2252,2449,-197,4,52,0,13
72978,1,2405,2275,130,0,253,0,8
72979,1,2501,2387,114,0,112,0,6
72980,1,2507,2517,-10,0,101,0,6
72981,2,2357,2414,-57,0,13,0,6
72982,1,2382,2498,-116,0,13,0,6
72983,3,2406,2514,-108,0,40,0,6
72984,3,2486,2392,94,0,485,0,6
72985,2,2425,2423,2,0,40,1,6
72986,2,2334,2468,-134,0,140,0,6
72987,2,2475,2463,12,0,311,0,6
72988,1,2492,2399,93,0,123,0,6
72989,3,2267,2404,-137,0,40,0,6
72990,3,2446,2417,29,0,242,0,6
72991,2,2355,2424,-69,0,140,0,6
72992,1,2448,2369,79,0,43,1,6
72993,2,2436,2533,-97,0,200,0,6
72994,2,2423,2461,-38,0,27,0,6
72995,2,2360,2489,-129,0,211,0,6
72996,2,2456,2320,136,0,13,0,6
72997,2,2427,2467,-40,0,28,0,6
72998,2,2256,2410,-154,4,195,0,13
72999,2,2351,2450,-99,0,331,1,6
73000,2,2405,2292,113,0,300,1,6
73001,1,2512,2309,203,0,404,0,6
73002,2,2422,2408,14,0,487,0,6
73003,2,2408,2318,90,0,189,0,6
73004,2,2455,2369,86,0,1,0,6
73005,2,2359,2477,-118,0,0,0,6
73006,2,2208,2436,-228,0,122,0,6
73007,1,2380,2403,-23,0,389,0,6
73008,2,2452,2447,5,0,190,0,6
73009,2,2443,2444,-1,0,46,1,6
73010,1,2642,2439,203,0,0,0,6
73011,3,2510,2562,-52,0,164,0,6
73012,2,2394,2491,-97,0,331,0,6
73013,2,2347,2418,-71,0,202,0,6
73014,2,2456,2604,-148,0,106,0,6
73015,2,2509,2632,-123,0,400,0,6
73016,2,2294,2441,-147,0,250,0,6
73017,2,2555,2400,155,0,277,1,6
73018,2,2379,2429,-50,0,305,0,6
73019,2,2511,2495,16,0,45,1,6
73020,2,2517,2425,92,0,46,0,6
73021,1,2427,2311,116,0,244,1,6
73022,1,2419,2384,35,0,0,0,6
73023,2,2218,2452,-234,0,40,0,6
73024,2,2512,2469,43,0,140,0,6
73025,2,2606,2680,-74,0,88,0,6
73026,1,2418,2283,135,0,45,1,8
73027,2,2462,2486,-24,0,55,0,6
73028,2,2343,2448,-105,0,300,0,6
73029,1,2427,2332,95,0,43,0,6
73030,2,2251,2457,-206,0,310,0,6
73031,1,2428,2340,88,0,434,0,6
73032,1,2432,2339,93,0,121,1,6
73033,1,2426,2405,21,0,485,1,6
73034,1,2437,2505,-68,0,131,0,6
73035,1,2444,2383,61,0,115,0,6
73036,1,2596,2769,-173,0,490,0,6
73037,1,2454,2290,164,0,20,0,6
73038,1,2382,2508,-126,0,112,0,6
73039,2,2218,2416,-198,0,100,0,6
73040,3,2305,2414,-109,0,310,0,6
73041,2,2402,2293,109,0,0,0,6
73042,2,2509,2531,-22,0,253,0,6
73043,1,2696,2581,115,0,7,0,6
73044,1,2513,2420,93,0,480,0,6
73045,2,2270,2425,-155,0,0,0,6
73046,2,2300,2515,-215,0,1,0,6
73047,2,2270,2448,-178,0,127,1,6
73048,2,2491,2389,102,0,40,0,6
73049,2,2355,2451,-96,0,11,0,6
73050,2,2412,2329,83,0,101,0,6
73051,2,2325,2442,-117,0,0,0,6
73052,2,2453,2558,-105,0,110,0,6
73053,1,2490,2421,69,0,306,1,6
73054,2,2436,2645,-209,0,101,0,6
73056,2,2258,2431,-173,0,13,0,6
73057,1,2395,2467,-72,0,34,0,6
73058,2,2370,2459,-89,0,113,0,6
73059,2,2607,2596,11,0,469,1,6
73060,1,2415,2497,-82,0,104,1,6
73061,3,2484,2420,64,0,320,0,6
73062,1,2518,2456,62,0,40,0,6
73063,2,2476,2493,-17,0,15,1,6
73064,2,2440,2542,-102,0,120,0,6
73065,1,2384,2409,-25,0,310,1,8
73066,1,2509,2226,283,0,45,0,6
73067,1,2460,2406,54,0,40,0,6
73068,1,2452,2330,122,0,333,1,6
73069,2,2324,2418,-94,0,106,0,6
73070,1,2419,2352,67,0,4,0,6
73071,1,2525,2453,72,0,45,1,6
73072,2,2537,2418,119,0,0,0,6
73073,2,2452,2468,-16,0,218,0,6
73074,1,2499,2280,219,0,88,0,6
73075,2,2221,2431,-210,0,101,0,6
73076,1,2495,2481,14,0,102,0,6
73077,2,2430,2381,49,4,145,0,13
73078,2,2351,2405,-54,0,28,0,6
73079,1,2456,2517,-61,0,46,0,6
73080,2,2379,2506,-127,0,306,0,6
73081,1,2492,2390,102,0,44,1,6
73082,2,2433,2359,74,0,40,1,6
73083,3,2455,2345,110,0,315,0,6
73084,1,2412,2423,-11,0,211,0,6
73085,2,2297,2449,-152,0,302,0,6
73086,1,2397,2405,-8,0,2,0,6
73087,1,2401,2269,132,0,151,0,6
73088,2,2465,2451,14,0,311,0,6
73089,1,2450,2437,13,0,212,0,6
73090,1,2636,2505,131,0,335,1,6
73091,1,2510,2476,34,0,320,0,6
73092,1,2647,2433,214,0,106,0,6
73093,1,2385,2401,-16,0,405,0,6
73094,1,2441,2328,113,0,4,1,6
73095,2,2469,2468,1,0,0,0,6
73096,1,2422,2343,79,0,47,0,6
73097,2,2327,2477,-150,0,144,1,6
73098,1,2200,2421,-221,0,322,1,6
73099,1,2761,2605,156,0,112,0,6
73100,2,2475,2350,125,0,183,0,6
73101,1,2561,2501,60,0,105,0,6
73102,1,2363,2434,-71,0,406,1,6
73103,2,2422,2355,67,0,4,0,6
73104,2,2397,2483,-86,0,10,1,6
73105,1,2538,2415,123,0,250,0,6
73106,1,2505,2382,123,0,46,0,6
73107,2,2403,2389,14,0,28,1,6
73108,2,2474,2501,-27,0,15,1,6
73109,1,2421,2346,75,0,202,0,6
73110,2,2565,2501,64,0,7,0,6
73111,3,2418,2522,-104,0,319,0,6
73112,3,2417,2352,65,0,8,0,6
73113,1,2449,2320,129,0,120,0,6
73114,1,2391,2483,-92,0,7,0,6
73115,1,2455,2351,104,0,345,0,6
73116,1,2434,2218,216,0,49,1,6
73117,1,2433,2335,98,0,18,0,6
73118,2,2458,2447,11,0,15,1,6
73119,1,2324,2449,-125,0,365,0,6
73120,2,2431,2650,-219,0,6,0,6
73121,3,2562,2510,52,0,151,0,6
73122,1,2405,2265,140,0,200,0,6
73123,2,2458,2374,84,0,123,0,6
73124,1,2334,2402,-68,0,27,0,6
73125,2,2383,2400,-17,0,332,1,6
73126,1,2545,2463,82,0,146,1,6
73127,1,2521,2356,165,0,49,0,6
73128,3,2436,2420,16,0,255,0,6
73129,1,2472,2314,158,0,302,1,6
73130,2,2470,2468,2,0,45,1,6
73131,2,2446,2451,-5,0,134,0,6
73132,1,2548,2376,172,0,455,0,6
73133,2,2416,2353,63,0,474,0,6
73134,1,2495,2329,166,0,49,0,6
73135,1,2417,2460,-43,0,245,0,6
73136,1,2445,2306,139,0,101,0,6
73137,1,2223,2419,-196,0,303,0,6
73138,1,2448,2530,-82,0,277,0,6
73139,3,2441,2360,81,0,107,0,6
73140,3,2331,2437,-106,0,147,0,6
73141,3,2388,2521,-133,0,40,0,6
73142,2,2601,2764,-163,0,490,0,6
73143,2,2577,2704,-127,0,7,1,6
73144,1,2419,2251,168,0,4,0,6
73145,2,2453,2326,127,0,101,0,6
73146,1,2449,2530,-81,0,200,0,6
73147,2,2294,2455,-161,0,302,0,6
73148,1,2499,2359,140,0,483,0,6
73149,2,2432,2455,-23,0,43,1,6
73150,1,2510,2451,59,0,100,0,6
73151,2,2427,2455,-28,0,40,1,6
73152,1,2343,2476,-133,0,0,0,6
73153,1,2365,2459,-94,0,215,0,6
73154,1,2457,2408,49,0,40,0,6
73155,3,2243,2403,-160,0,227,0,6
73156,1,2529,2444,85,0,114,0,6
73157,1,2452,2481,-29,4,140,0,13
73159,1,2422,2511,-89,0,265,0,6
73160,1,2435,2384,51,0,200,0,6
73161,2,2452,2386,66,0,455,0,6
73162,1,2375,2471,-96,0,483,1,6
73163,2,2380,2463,-83,0,151,0,6
73164,2,2496,2350,146,0,300,0,6
73165,1,2412,2334,78,0,41,0,6
73166,2,2386,2409,-23,0,335,0,6
73167,2,2317,2502,-185,0,49,0,6
73168,1,2317,2498,-181,0,469,0,6
73169,1,2523,2456,67,0,300,0,6
73170,2,2338,2427,-89,0,300,0,6
73171,1,2472,2346,126,0,101,0,6
73172,1,2411,2394,17,0,170,0,6
73173,2,2250,2416,-166,0,106,1,6
73174,3,2420,2524,-104,0,319,0,6
73175,1,2453,2436,17,0,484,0,6
73176,2,2639,2582,57,0,335,0,6
73177,2,2403,2441,-38,0,145,1,6
73178,1,2501,2566,-65,0,402,1,6
73179,1,2490,2446,44,0,426,0,6
73180,2,2324,2427,-103,0,190,0,6
73181,1,2381,2450,-69,0,70,0,6
73182,2,2496,2552,-56,0,128,0,6
73183,1,2523,2477,46,0,300,0,6
73184,2,2321,2403,-82,0,0,0,6
73185,2,2209,2422,-213,0,43,0,6
73186,2,2330,2412,-82,0,322,0,6
73187,2,2461,2419,42,0,253,0,6
73188,2,2336,2401,-65,0,190,0,6
73189,2,2511,2558,-47,0,326,0,6
73190,2,2561,2488,73,0,16,0,6
73191,2,2258,2445,-187,0,310,0,6
73192,3,2653,2428,225,0,48,0,6
73193,1,2522,2324,198,0,46,0,6
73194,1,2469,2305,164,0,41,0,6
73195,1,2459,2522,-63,0,43,0,6
73196,3,2468,2575,-107,0,13,0,6
73197,3,2299,2422,-123,0,17,0,6
73198,2,2403,2382,21,0,101,0,6
73199,2,2462,2363,99,0,337,0,6
73200,2,2445,2282,163,0,105,0,6
73201,2,2391,2422,-31,0,8,0,6
73202,1,2403,2263,140,0,106,0,8
73203,1,2582,2549,33,0,249,0,6
73204,1,2334,2414,-80,0,201,0,6
73205,1,2530,2209,321,0,243,0,6
73206,1,2347,2459,-112,0,315,1,6
73207,2,2480,2453,27,0,5,0,6
73208,2,2399,2401,-2,0,181,1,6
73209,1,2426,2256,170,0,44,1,6
73210,2,2462,2291,171,0,210,0,6
73211,3,2457,2429,28,0,311,0,6
73212,3,2486,2418,68,0,245,0,6
73213,2,2767,2598,169,0,444,0,6
73214,2,2340,2416,-76,0,300,0,6
73215,1,2386,2472,-86,0,201,1,6
73216,2,2593,2673,-80,0,133,0,6
73217,2,2344,2440,-96,0,151,1,6
73218,1,2463,2282,181,0,404,0,6
73219,1,2413,2285,128,0,127,0,6
73220,3,2358,2452,-94,0,34,0,6
73221,1,2295,2448,-153,0,310,0,6
73222,2,2458,2490,-32,0,476,0,6
73223,1,2400,2245,155,0,30,0,6
73224,2,2292,2403,-111,0,51,0,6
73225,2,2289,2512,-223,0,112,0,6
73226,3,2300,2425,-125,0,56,0,6
73227,2,2525,2451,74,0,40,0,6
73228,2,2489,2561,-72,0,345,0,6
73229,2,2379,2563,-184,0,326,0,6
73230,3,2319,2454,-135,0,473,0,8
73231,2,2461,2427,34,0,301,0,6
73232,2,2459,2528,-69,0,200,0,6
73233,2,2291,2450,-159,0,338,0,6
73234,1,2451,2528,-77,0,106,0,6
73235,2,2321,2427,-106,0,43,0,6
73236,2,2297,2458,-161,0,331,0,6
73237,2,2431,2386,45,0,122,1,6
73238,2,2515,2466,49,0,324,0,6
73239,2,2397,2455,-58,0,112,0,6
73240,1,2467,2295,172,0,145,0,6
73241,2,2390,2417,-27,0,306,0,6
73242,1,2442,2388,54,0,123,0,6
73243,2,2431,2334,97,0,313,0,6
73244,2,2495,2320,175,0,300,0,6
73245,2,2506,2440,66,0,107,0,6
73246,1,2431,2339,92,0,218,0,6
73247,2,2506,2461,45,0,107,0,6
73249,2,2421,2351,70,0,5,0,6
73250,2,2299,2531,-232,0,57,0,6
73251,2,2425,2453,-28,0,152,0,6
73252,3,2463,2510,-47,0,4,0,6
73253,1,2422,2288,134,0,113,0,6
73254,3,2587,2589,-2,0,300,0,6
73255,1,2518,2371,147,0,45,1,6
73256,2,2239,2416,-177,0,48,0,6
73257,2,2606,2633,-27,0,127,0,6
73258,2,2465,2302,163,0,300,1,6
73259,3,2423,2393,30,0,211,0,6
73260,3,2419,2382,37,0,110,0,6
73261,1,2559,2508,51,0,244,1,6
73262,2,2449,2386,63,0,201,1,6
73263,1,2573,2470,103,0,207,0,6
73264,2,2431,2650,-219,0,101,0,6
73265,1,2460,2325,135,0,120,1,6
73266,2,2416,2518,-102,0,310,1,6
73267,2,2364,2491,-127,0,411,0,6
73268,1,2325,2421,-96,0,310,0,8
73269,1,2431,2251,180,0,244,1,6
73270,2,2544,2587,-43,0,106,0,6
73271,1,2685,2696,-11,0,270,1,6
73272,3,2431,2212,219,0,200,0,6
73273,1,2566,2465,101,0,250,0,6
73274,1,2466,2325,141,0,100,0,6
73275,1,2406,2253,153,4,90,0,13
73276,1,2433,2436,-3,0,40,0,6
73277,3,2589,2587,2,0,7,0,6
73278,2,2284,2407,-123,0,304,0,6
73279,2,2472,2476,-4,0,302,0,6
73280,2,2507,2459,48,0,335,0,6
73281,1,2387,2460,-73,0,304,0,6
73282,2,2606,2759,-153,0,80,0,6
73283,1,2441,2495,-54,0,357,0,6
73284,1,2404,2431,-27,0,151,0,6
73285,1,2638,2601,37,0,447,0,6
73286,1,2462,2394,68,0,354,0,6
73287,3,2414,2242,172,0,401,0,6
73288,2,2358,2422,-64,0,301,0,6
73289,1,2499,2475,24,0,57,1,6
73290,1,2677,2599,78,0,120,0,6
73291,3,2481,2570,-89,0,310,0,6
73292,1,2461,2487,-26,0,460,0,6
73294,2,2425,2453,-28,0,191,0,6
73295,1,2440,2302,138,0,398,0,6
73296,1,2444,2328,116,0,277,0,6
73297,2,2495,2452,43,0,311,1,6
73298,2,2404,2328,76,0,112,0,6
73299,1,2459,2302,157,0,48,0,6
73300,1,2362,2456,-94,0,313,0,6
73301,2,2467,2500,-33,0,130,0,6
73302,3,2495,2389,106,0,132,0,6
73303,2,2343,2470,-127,0,45,0,6
73304,3,2341,2424,-83,0,306,0,6
73305,2,2464,2430,34,0,300,0,6
73306,1,2427,2345,82,0,40,0,6
73307,1,2353,2457,-104,0,0,0,6
73308,1,2477,2500,-23,0,112,0,6
73309,2,2241,2419,-178,0,260,0,6
73310,2,2230,2413,-183,0,46,0,6
73311,2,2428,2439,-11,0,13,0,6
73312,3,2421,2457,-36,0,107,0,6
73313,2,2460,2420,40,0,253,0,6
73314,1,2448,2267,181,0,123,0,6
73315,1,2228,2418,-190,0,490,0,6
73317,1,2466,2577,-111,0,13,0,6
73318,1,2316,2466,-150,0,331,1,6
73319,2,2315,2428,-113,0,43,0,6
73320,2,2475,2433,42,0,35,0,6
73321,3,2423,2343,80,0,45,0,6
73322,1,2447,2569,-122,0,103,0,6
73323,3,2381,2429,-48,0,70,0,6
73324,2,2383,2434,-51,0,424,0,6
73325,2,2493,2393,100,0,246,0,6
73326,2,2279,2466,-187,0,330,0,6
73327,2,2479,2494,-15,0,62,0,6
73328,1,2464,2401,63,0,4,1,6
73329,3,2393,2412,-19,0,131,0,6
73330,2,2215,2424,-209,0,212,0,6
73331,2,2344,2421,-77,0,300,0,6
73332,1,2652,2429,223,0,23,0,6
73333,1,2522,2465,57,0,40,0,6
73334,1,2763,2603,160,0,112,0,6
73335,1,2340,2406,-66,0,228,1,8
73336,2,2392,2554,-162,0,112,1,6
73337,2,2381,2531,-150,0,252,0,6
73338,1,2361,2410,-49,0,61,0,6
73339,3,2503,2564,-61,0,400,0,6
73340,2,2509,2458,51,0,123,1,6
73341,2,2384,2442,-58,0,40,1,6
73342,2,2293,2459,-166,4,124,0,13
73343,1,2411,2360,51,0,460,0,6
73344,2,2426,2655,-229,0,101,0,6
73345,1,2410,2284,126,0,455,1,6
73346,2,2481,2467,14,0,300,0,6
73347,1,2390,2443,-53,0,216,0,6
73348,3,2587,2589,-2,0,300,0,6
73349,1,2508,2349,159,0,225,0,6
73350,3,2358,2431,-73,0,16,0,6
73351,1,2449,2286,163,0,41,0,6
73352,1,2521,2467,54,0,113,0,6
73353,2,2376,2427,-51,0,41,1,6
73354,1,2690,2596,94,0,415,0,6
73355,1,2432,2395,37,0,101,1,6
73356,1,2517,2333,184,0,50,0,8
73357,1,2444,2420,24,0,40,0,6
73358,1,2448,2337,111,0,110,1,6
73359,1,2453,2312,141,0,347,0,6
73360,1,2331,2458,-127,0,14,0,6
73361,2,2413,2450,-37,0,13,0,6
73362,2,2459,2311,148,0,120,0,6
73363,2,2426,2452,-26,0,152,0,6
73364,1,2420,2474,-54,0,40,1,6
73365,1,2380,2473,-93,0,255,1,6
73366,2,2319,2452,-133,0,41,0,8
73367,1,2505,2500,5,0,113,0,6
73368,3,2459,2378,81,0,40,0,6
73369,2,2462,2439,23,0,201,1,6
73370,1,2675,2682,-7,0,288,0,6
73371,2,2356,2527,-171,0,310,0,6
73372,2,2569,2489,80,0,244,0,6
73373,2,2415,2355,60,0,29,1,6
73374,1,2458,2452,6,0,332,1,6
73375,1,2449,2333,116,0,398,0,6
73376,1,2468,2493,-25,0,341,0,6
73377,1,2596,2297,299,2,143,0,24
73378,3,2207,2504,-297,0,303,0,6
73379,1,2494,2475,19,0,330,1,6
73380,2,2511,2535,-24,0,107,0,6
73381,1,2657,2424,233,0,20,1,6
73382,2,2259,2439,-180,0,140,1,6
73383,2,2566,2474,92,0,8,0,6
73384,1,2427,2332,95,0,100,1,6
73385,2,2213,2416,-203,0,315,0,6
73386,2,2430,2449,-19,0,106,0,6
73387,2,2475,2367,108,0,45,1,6
73388,2,2459,2469,-10,0,260,0,6
73389,1,2426,2340,86,0,46,0,6
73390,2,2409,2252,157,0,300,1,6
73391,1,2456,2422,34,0,43,0,6
73392,2,2411,2288,123,0,320,1,6
73393,2,2592,2695,-103,0,102,0,6
73394,3,2600,2766,-166,0,49,0,6
73395,1,2458,2393,65,0,487,0,6
73396,2,2456,2530,-74,0,101,0,6
73397,2,2412,2315,97,0,411,0,6
73398,2,2352,2471,-119,0,200,0,6
73399,3,2459,2534,-75,0,286,0,6
73400,1,2461,2401,60,0,190,1,6
73401,1,2426,2219,207,0,313,1,6
73402,1,2390,2453,-63,0,102,0,6
73403,2,2325,2425,-100,0,45,0,6
73404,2,2455,2406,49,0,302,1,6
73405,1,2699,2587,112,0,102,0,6
73406,2,2511,2454,57,0,123,0,6
73407,2,2563,2504,59,0,267,0,6
73408,1,2407,2379,28,0,134,0,6
73409,1,2419,2437,-18,0,4,0,6
73410,1,2378,2422,-44,0,123,0,6
73411,1,2469,2276,193,0,154,1,6
73412,1,2437,2206,231,0,455,0,6
73413,1,2417,2427,-10,0,46,1,6
73414,1,2463,2374,89,0,311,1,6
73415,2,2390,2526,-136,0,343,1,6
73416,2,2589,2587,2,0,7,1,6
73417,2,2421,2376,45,0,50,0,6
73418,3,2453,2562,-109,0,311,0,6
73419,3,2339,2496,-157,0,453,0,6
73420,2,2335,2430,-95,0,202,1,6
73421,1,2450,2210,240,0,113,0,6
73422,3,2288,2450,-162,0,337,0,6
73423,3,2487,2475,12,0,182,0,6
73424,2,2315,2414,-99,0,485,0,6
73425,1,2465,2289,176,0,426,0,6
73426,3,2417,2461,-44,0,141,0,6
73427,2,2524,2397,127,0,135,0,6
73428,2,2446,2558,-112,0,128,0,6
73429,1,2557,2391,166,0,101,0,6
73430,1,2448,2301,147,0,188,0,6
73431,1,2535,2347,188,0,80,0,6
73432,2,2389,2452,-63,0,151,0,6
73433,1,2573,2448,125,0,15,0,6
73434,1,2381,2540,-159,0,46,1,6
73435,3,2676,2681,-5,0,109,0,6
73436,1,2333,2458,-125,0,315,1,6
73437,1,2218,2402,-184,0,405,0,6
73438,2,2383,2457,-74,0,43,0,6
73439,2,2247,2425,-178,0,100,0,6
73440,1,2446,2431,15,0,45,0,6
73441,1,2329,2429,-100,0,74,0,6
73442,1,2431,2396,35,0,43,0,6
73443,2,2391,2412,-21,0,0,1,6
73444,1,2456,2311,145,0,152,1,8
73445,2,2335,2428,-93,0,15,0,6
73446,1,2379,2525,-146,0,310,0,6
73447,1,2474,2427,47,0,5,0,6
73449,1,2432,2294,138,0,202,0,6
73450,2,2429,2456,-27,0,43,1,6
73451,2,2357,2409,-52,0,476,0,6
73452,3,2610,2347,263,0,1,0,6
73453,2,2266,2437,-171,0,140,0,8
73454,2,2306,2408,-102,0,484,0,6
73455,2,2422,2660,-238,0,101,0,6
73456,1,2502,2466,36,0,15,1,6
73457,1,2404,2388,16,0,330,0,6
73458,1,2540,2505,35,0,120,1,6
73459,1,2454,2457,-3,0,242,0,6
73460,3,2464,2384,80,0,464,0,6
73461,1,2560,2499,61,0,113,0,6
73462,2,2258,2439,-181,0,310,0,6
73463,2,2203,2461,-258,0,111,0,6
73464,3,2462,2418,44,4,131,0,13
73465,3,2538,2453,85,0,40,0,6
73466,1,2482,2416,66,0,132,0,6
73467,2,2402,2370,32,0,112,1,6
73468,1,2467,2385,82,0,300,0,6
73469,2,2590,2601,-11,0,264,0,6
73470,1,2763,2602,161,0,331,0,6
73471,1,2559,2393,166,0,5,0,6
73472,1,2447,2355,92,0,106,0,6
73473,2,2533,2591,-58,0,141,0,6
73474,1,2462,2448,14,0,202,0,6
73475,1,2415,2448,-33,0,45,0,6
73476,1,2422,2455,-33,0,40,0,6
73477,2,2391,2405,-14,0,134,0,6
73478,2,2216,2436,-220,0,40,0,6
73479,1,2511,2556,-45,0,330,0,6
73480,2,2463,2384,79,0,0,0,6
73481,2,2445,2474,-29,0,102,1,6
73482,2,2461,2507,-46,0,241,1,6
73483,2,2226,2403,-177,0,43,1,6
73484,3,2442,2381,61,0,106,0,6
73485,1,2455,2387,68,0,0,0,6
73486,1,2592,2563,29,0,300,1,6
73487,1,2439,2428,11,0,315,0,6
73488,2,2410,2463,-53,0,331,1,6
73489,2,2565,2488,77,0,253,0,6
73490,1,2421,2245,176,0,206,0,6
73491,2,2495,2499,-4,0,43,0,6
73492,1,2393,2487,-94,0,45,0,6
73493,1,2426,2342,84,0,202,0,6
73494,1,2322,2451,-129,0,300,0,6
73496,3,2435,2331,104,0,46,0,6
73497,1,2493,2387,106,0,46,0,6
73498,1,2475,2529,-54,0,100,0,6
73499,2,2347,2516,-169,0,40,1,6
73500,1,2562,2442,120,0,461,0,6
73501,1,2377,2452,-75,0,394,0,6
73502,1,2426,2401,25,0,50,0,6
73503,1,2461,2418,43,0,250,0,6
73504,2,2377,2445,-68,0,5,0,7
73505,1,2662,2419,243,0,48,0,6
73506,2,2312,2459,-147,0,365,0,6
73507,1,2447,2222,225,0,110,1,6
73508,3,2445,2378,67,0,341,0,6
73509,3,2681,2676,5,0,40,0,6
73510,2,2370,2467,-97,0,107,1,6
73511,2,2351,2463,-112,0,300,1,6
73512,1,2383,2443,-60,0,424,0,6
73513,2,2599,2767,-168,0,490,0,6
73514,1,2600,2600,0,0,319,0,6
73515,2,2383,2571,-188,0,440,0,6
73516,1,2461,2422,39,0,122,0,6
73518,1,2442,2423,19,0,43,0,6
73519,1,2819,2856,-37,0,110,1,6
73520,1,2631,2653,-22,0,1,0,6
73521,1,2574,2578,-4,0,207,0,6
73522,1,2409,2410,-1,0,46,0,6
73523,3,2492,2486,6,0,140,0,6
73524,1,2550,2561,-11,0,28,0,6
73525,2,2510,2508,2,0,107,0,6
73526,2,2405,2401,4,0,49,0,6
73527,2,2718,2728,-10,0,45,1,6
73528,3,2602,2601,1,0,411,0,6
73529,1,2449,2468,-19,0,40,1,6
73530,1,2428,2431,-3,0,225,0,6
73531,2,2661,2689,-28,0,123,0,6
73532,2,2420,2354,66,0,313,0,6
73533,1,2414,2267,147,0,15,0,6
73534,2,2334,2448,-114,0,331,0,6
73535,1,2453,2534,-81,0,311,0,6
73536,2,2399,2405,-6,0,150,0,6
73537,1,2461,2312,149,0,122,0,6
73538,2,2409,2509,-100,0,313,0,6
73539,2,2596,2507,89,0,135,0,6
73540,1,2429,2414,15,0,122,0,6
73541,2,2424,2431,-7,0,49,0,6
73542,2,2430,2396,34,0,211,0,6
73543,1,2515,2286,229,0,457,0,7
73544,2,2386,2486,-100,0,457,1,6
73545,2,2514,2403,111,0,459,0,6
73546,1,2402,2401,1,0,162,0,6
73547,1,2671,2604,67,0,265,0,6
73548,2,2416,2413,3,0,302,0,6
73549,2,2469,2469,0,0,315,0,6
73550,1,2417,2425,-8,0,484,0,6
73551,2,2527,2515,12,0,327,0,6
73552,3,2602,2561,41,0,335,0,6
73553,1,2508,2503,5,0,100,0,6
73554,3,2472,2472,0,0,427,0,6
73555,2,2472,2498,-26,0,111,0,6
73556,3,2433,2452,-19,0,338,0,6
73557,3,2404,2406,-2,0,201,0,6
73558,3,2467,2391,76,0,29,0,6
73559,1,2607,2584,23,0,43,1,6
73560,2,2514,2505,9,0,167,0,6
73562,1,2435,2261,174,0,300,0,6
73563,2,2281,2405,-124,0,114,0,6
73564,1,2458,2466,-8,0,193,0,6
73565,2,2550,2535,15,0,327,1,6
73566,2,2500,2545,-45,0,208,0,6
73567,1,2305,2404,-99,0,113,0,6
73568,2,2687,2672,15,0,414,0,6
73569,2,2510,2473,37,0,213,0,6
73570,1,2408,2404,4,0,118,0,6
73571,2,2424,2416,8,0,468,0,6
73572,3,2494,2542,-48,0,263,0,6
73574,1,2427,2428,-1,0,335,0,6
73575,3,2401,2392,9,0,320,0,6
73576,3,2406,2415,-9,0,45,0,6
73577,1,2458,2439,19,0,205,0,6
73578,1,2564,2550,14,0,20,0,6
73579,1,2487,2537,-50,0,106,0,6
73580,2,2470,2505,-35,0,61,0,6
73581,2,2486,2512,-26,0,80,0,6
73582,1,2551,2545,6,0,330,0,6
73583,1,2573,2579,-6,0,302,0,6
73584,2,2525,2545,-20,0,4,0,6
73585,3,2599,2602,-3,0,167,0,6
73586,1,2425,2422,3,0,176,0,6
73587,2,2401,2409,-8,0,13,1,6
73588,1,2472,2470,2,0,46,0,6
73589,1,2554,2578,-24,0,45,0,6
73590,1,2453,2440,13,0,151,0,6
73591,2,2477,2485,-8,0,1,0,6
73592,3,2545,2499,46,0,101,0,6
73593,1,2438,2459,-21,0,464,0,6
73594,1,2476,2473,3,0,277,0,6
73596,1,2503,2427,76,0,280,1,6
73597,2,2526,2591,-65,0,228,0,6
73598,1,2496,2486,10,0,128,1,6
73599,2,2435,2440,-5,0,133,0,6
73600,1,2426,2397,29,0,80,0,6
73601,2,2428,2421,7,0,45,0,6
73602,2,2444,2450,-6,0,4,0,6
73603,3,2474,2482,-8,0,56,0,6
73604,1,2529,2541,-12,0,16,1,6
73605,3,2528,2504,24,0,20,0,6
73606,1,2554,2525,29,0,190,0,6
73607,1,2451,2467,-16,0,242,0,6
73608,3,2440,2465,-25,0,370,0,6
73609,2,2400,2384,16,0,487,0,6
73610,2,2472,2502,-30,0,18,1,6
73612,1,2434,2313,121,0,306,0,6
73613,3,2452,2372,80,0,131,0,6
73614,1,2499,2552,-53,0,302,0,6
73615,2,2431,2437,-6,0,40,0,6
73616,1,2486,2465,21,0,45,0,6
73617,2,2372,2425,-53,0,48,0,6
73618,2,2447,2466,-19,0,5,0,6
73619,3,2564,2528,36,0,122,0,6
73620,3,2461,2416,45,0,207,0,6
73621,3,2323,2410,-87,0,335,0,6
73622,1,2600,2499,101,0,0,0,6
73623,1,2518,2512,6,0,201,0,6
73624,2,2415,2419,-4,0,49,0,6
73625,2,2436,2464,-28,0,190,0,6
73627,1,2626,2540,86,0,309,0,6
73628,1,2476,2469,7,0,4,0,6
73629,2,2505,2489,16,0,112,1,6
73630,1,2437,2308,129,0,119,0,6
73631,2,2281,2509,-228,0,344,0,6
73632,1,2477,2447,30,0,335,0,6
73633,2,2423,2450,-27,0,378,1,6
73634,1,2386,2416,-30,0,140,0,6
73635,1,2555,2630,-75,0,106,1,6
73636,1,2437,2239,198,0,80,1,6
73637,1,2417,2577,-160,0,4,0,6
73638,1,2245,2439,-194,0,414,0,6
73639,1,2454,2399,55,0,5,0,6
73640,1,2425,2416,9,0,200,0,6
73641,3,2422,2621,-199,0,389,0,6
73642,2,2265,2406,-141,0,43,0,6
73643,3,2201,2668,-467,0,143,0,6
73644,3,2201,2419,-218,0,241,0,6
73645,2,2583,2474,109,0,338,0,6
73646,2,2489,2352,137,0,330,0,6
73647,2,2445,2479,-34,0,241,0,6
73649,2,2384,2463,-79,0,103,0,6
73650,2,2328,2450,-122,0,46,0,6
73651,3,2430,2272,158,0,171,0,6
73652,2,2270,2493,-223,0,104,0,6
73653,1,2550,2518,32,0,118,0,6
73654,1,2437,2482,-45,0,150,0,6
73655,1,2598,2352,246,0,387,0,6
73656,2,2216,2514,-298,0,200,0,6
73657,2,2517,2551,-34,0,200,0,6
73658,1,2516,2454,62,0,335,0,6
73659,2,2383,2475,-92,0,344,0,6
73660,1,2446,2288,158,0,130,0,6
73661,1,2450,2558,-108,0,112,0,6
73662,1,2496,2373,123,0,190,0,6
73663,2,2444,2515,-71,0,202,0,6
73664,1,2218,2588,-370,0,310,0,6
73665,2,2701,2255,446,0,4,0,6
73666,1,2440,2522,-82,0,124,0,6
73667,2,2264,2459,-195,0,190,0,8
73668,1,2393,2501,-108,0,112,0,6
73669,1,2412,2436,-24,0,7,0,6
73670,1,2619,2432,187,0,101,0,6
73671,3,2480,2461,19,0,17,0,6
73672,1,2293,2606,-313,2,113,0,24
73673,1,2411,2328,83,0,107,0,6
73674,3,2557,2598,-41,0,5,0,6
73675,1,2539,2545,-6,0,138,0,6
73676,1,2446,2480,-34,0,13,0,6
73677,2,2417,2664,-247,0,101,0,6
73678,1,2441,2322,119,0,48,0,6
73679,1,2333,2433,-100,0,201,1,6
73680,1,2417,2466,-49,0,129,0,6
73681,1,2380,2625,-245,0,50,0,6
73682,1,2469,2225,244,0,40,0,6
73683,2,2214,2579,-365,0,58,0,6
73684,1,2467,2379,88,0,0,0,6
73685,1,2460,2425,35,0,226,0,6
73686,2,2413,2466,-53,0,7,0,6
73687,2,2446,2333,113,0,218,0,6
73688,1,2564,2319,245,0,11,0,6
73689,1,2306,2443,-137,0,203,0,6
73691,1,2476,2234,242,0,96,0,6
73692,1,2293,2422,-129,0,106,1,6
73693,2,2440,2401,39,0,107,1,6
73694,1,2530,2226,304,0,332,0,6
73695,2,2479,2201,278,0,143,0,6
73696,2,2223,2479,-256,0,373,0,6
73697,1,2370,2479,-109,0,123,0,6
73698,1,2366,2504,-138,0,121,0,6
73699,1,2525,2372,153,0,75,0,6
73700,1,2386,2575,-189,0,4,0,6
73701,3,2410,2278,132,0,45,0,6
73702,1,2468,2571,-103,0,491,0,6
73703,3,2600,2463,137,0,463,0,6
73704,2,2674,2326,348,0,112,0,6
73705,1,2402,2326,76,0,122,1,6
73706,1,2566,2382,184,0,135,0,6
73707,1,2429,2591,-162,0,210,0,6
73708,1,2484,2477,7,0,487,1,6
73709,2,2416,2448,-32,0,4,0,6
73710,2,2390,2437,-47,0,20,1,6
73711,1,2594,2516,78,0,58,0,6
73712,1,2770,2596,174,0,437,0,6
73714,2,2414,2570,-156,0,190,0,6
73715,1,2354,2506,-152,0,50,0,6
73716,1,2703,2440,263,0,130,0,6
73717,2,2373,2414,-41,0,45,0,6
73718,3,2466,2542,-76,0,268,0,6
73719,2,2456,2500,-44,0,49,0,6
73720,2,2438,2589,-151,0,143,0,6
73721,1,2417,2386,31,0,135,0,6
73722,2,2676,2681,-5,0,258,0,6
73723,2,2288,2417,-129,0,4,0,6
73724,1,2474,2551,-77,0,1,0,6
73725,2,2260,2411,-151,0,45,0,6
73726,2,2308,2431,-123,0,1,0,6
73727,1,2416,2290,126,0,202,0,6
73728,2,2214,2655,-441,0,200,0,6
73729,3,2408,2467,-59,0,310,0,6
73730,3,2492,2651,-159,0,122,0,6
73731,1,2486,2372,114,0,15,0,6
73732,2,2436,2393,43,0,15,0,6
73733,2,2285,2449,-164,0,176,0,6
73734,2,2467,2467,0,0,311,1,6
73735,3,2399,2826,-427,0,108,0,6
73736,2,2411,2421,-10,0,245,0,6
73737,1,2507,2362,145,0,40,0,6
73738,2,2630,2524,106,0,44,0,6
73739,1,2507,2463,44,0,462,0,6
73740,1,2354,2604,-250,0,13,0,6
73741,1,2496,2243,253,0,130,0,6
73742,2,2478,2268,210,0,4,0,6
73743,1,2475,2525,-50,0,210,1,6
73744,1,2480,2612,-132,0,7,1,6
73745,1,2405,2344,61,0,41,0,6
73746,3,2562,2282,280,0,37,0,6
73747,2,2304,2482,-178,0,301,0,6
73748,2,2385,2421,-36,0,176,0,6
73749,1,2472,2399,73,0,310,0,6
73750,1,2692,2562,130,0,263,0,6
73751,2,2490,2348,142,0,138,0,6
73752,1,2375,2472,-97,0,484,0,6
73753,2,2451,2257,194,0,470,0,6
73754,2,2441,2511,-70,0,4,0,6
73755,2,2220,2431,-211,0,80,0,6
73756,1,2485,2284,201,0,245,0,6
73757,2,2498,2522,-24,0,237,0,6
73758,3,2205,2408,-203,0,13,0,6
73759,1,2521,2511,10,0,45,0,6
73760,2,2472,2350,122,0,101,0,6
73761,3,2293,2443,-150,0,110,0,6
73762,2,2332,2681,-349,0,230,0,6
73763,1,2681,2374,307,0,315,0,6
73764,2,2286,2507,-221,0,305,1,6
73765,2,2397,2580,-183,0,110,0,6
73766,3,2495,2401,94,0,107,0,6
73767,1,2399,2479,-80,0,226,0,6
73768,1,2495,2465,30,0,436,0,6
73769,3,2257,2436,-179,0,46,0,6
73770,1,2545,2422,123,0,151,0,6
73771,1,2451,2394,57,0,123,0,6
73772,2,2321,2429,-108,0,192,0,6
73773,2,2418,2563,-145,0,241,0,6
73774,1,2667,2415,252,0,48,0,6
73775,3,2334,2401,-67,0,0,0,6
73776,2,2395,2532,-137,0,118,0,6
73777,3,2550,2476,74,0,304,0,6
73778,2,2225,2481,-256,0,112,0,6
73779,3,2400,2354,46,0,109,0,6
73780,1,2464,2419,45,0,140,1,6
73781,2,2463,2431,32,0,0,0,6
73782,1,2470,2482,-12,0,131,0,6
73783,2,2495,2484,11,0,113,0,6
73784,1,2334,2455,-121,0,304,0,6
73785,1,2248,2535,-287,0,447,0,6
73786,2,2508,2581,-73,0,435,0,6
73787,1,2599,2468,131,0,40,0,6
73788,2,2511,2501,10,0,211,0,6
73789,3,2387,2559,-172,0,125,0,6
73790,3,2442,2237,205,0,9,0,6
73791,2,2419,2385,34,0,40,0,6
73792,1,2474,2255,219,0,129,0,6
73793,1,2507,2244,263,0,240,0,6
73794,1,2622,2361,261,0,241,0,6
73795,2,2456,2330,126,0,200,0,6
73796,1,2479,2384,95,0,6,0,6
73797,1,2430,2237,193,0,310,1,6
73798,1,2556,2373,183,0,300,0,6
73799,1,2512,2555,-43,0,302,1,6
73800,2,2227,2446,-219,0,201,0,6
73801,2,2408,2354,54,0,20,0,6
73802,1,2512,2234,278,0,45,0,6
73803,3,2435,2234,201,0,40,0,6
73804,1,2439,2227,212,0,104,0,6
73805,1,2431,2696,-265,0,48,0,6
73806,2,2383,2850,-467,0,37,1,6
73807,1,2558,2602,-44,0,211,0,6
73808,2,2572,2509,63,0,150,0,6
73809,3,2392,2406,-14,0,101,0,6
73810,2,2325,2545,-220,0,395,0,6
73811,3,2325,2506,-181,0,141,0,6
73812,2,2415,2487,-72,0,45,0,6
73813,1,2465,2374,91,0,136,0,6
73814,2,2437,2229,208,0,108,1,6
73815,1,2378,2459,-81,0,200,0,6
73816,2,2359,2503,-144,0,162,0,6
73817,2,2328,2446,-118,0,191,0,6
73818,3,2450,2433,17,0,46,0,6
73819,1,2405,2352,53,0,40,0,6
73820,2,2284,2571,-287,0,7,0,6
73821,3,2353,2475,-122,0,310,0,6
73822,2,2201,2637,-436,0,104,0,6
73823,2,2391,2463,-72,0,123,0,6
73824,1,2439,2202,237,0,310,1,6
73825,3,2515,2558,-43,0,110,0,6
73826,1,2412,2471,-59,0,50,0,6
73827,2,2461,2476,-15,0,41,1,6
73828,2,2406,2335,71,0,226,0,6
73829,3,2360,2427,-67,0,122,0,6
73830,2,2358,2422,-64,0,131,0,6
73831,2,2592,2597,-5,0,207,1,6
73832,1,2458,2201,257,0,41,0,6
73833,1,2425,2297,128,0,49,0,6
73834,2,2404,2409,-5,0,70,0,6
73835,1,2426,2340,86,0,46,0,6
73836,2,2230,2401,-171,0,1,1,6
73837,2,2518,2493,25,0,3,0,6
73839,2,2239,2549,-310,0,244,0,6
73840,1,2369,2433,-64,0,311,0,6
73841,3,2403,2258,145,0,45,0,6
73842,1,2293,2452,-159,0,112,0,6
73843,1,2401,2301,100,0,4,0,6
73844,3,2256,2469,-213,0,302,0,6
73845,1,2505,2451,54,0,111,1,6
73846,1,2529,2244,285,0,1,0,6
73847,2,2408,2426,-18,0,0,0,6
73848,2,2481,2821,-340,0,107,0,6
73849,1,2493,2213,280,0,100,0,6
73850,1,2467,2219,248,0,22,0,6
73851,3,2226,2510,-284,0,200,0,6
73852,1,2428,2251,177,0,40,0,6
73853,1,2487,2444,43,0,315,0,6
73854,2,2453,2410,43,0,40,1,6
73855,2,2386,2487,-101,0,317,0,6
73856,2,2593,2773,-180,0,454,0,6
73857,1,2447,2313,134,0,31,1,6
73858,3,2485,2478,7,0,311,0,6
73859,1,2550,2467,83,0,135,0,6
73860,1,2682,2308,374,0,45,0,6
73861,3,2517,2622,-105,0,7,0,6
73862,2,2511,2354,157,0,269,0,6
73863,2,2498,2656,-158,0,202,0,6
73864,2,2447,2648,-201,0,113,0,6
73865,1,2498,2433,65,0,202,0,6
73866,1,2390,2450,-60,0,210,0,6
73867,2,2544,2504,40,0,253,1,6
73868,3,2421,2506,-85,0,43,0,6
73869,2,2507,2606,-99,0,316,0,6
73870,2,2456,2482,-26,0,250,0,6
73871,1,2480,2575,-95,0,113,0,6
73872,1,2417,2339,78,0,41,0,6
73873,2,2363,2433,-70,0,4,0,6
73874,1,2240,2528,-288,0,8,0,6
73875,3,2454,2220,234,0,4,0,6
73876,1,2708,2423,285,0,265,0,6
73877,1,2404,2438,-34,0,122,0,6
73878,3,2572,2279,293,0,202,0,6
73879,1,2687,2670,17,0,244,1,6
73880,1,2416,2306,110,0,300,0,6
73881,1,2224,2469,-245,0,201,0,6
73882,2,2602,2465,137,0,345,0,6
73883,1,2584,2301,283,0,46,0,6
73884,3,2211,2573,-362,0,194,0,6
73885,1,2236,2664,-428,0,190,0,6
73886,2,2414,2282,132,0,404,0,6
73887,1,2466,2382,84,0,103,1,6
73888,2,2240,2404,-164,0,474,0,6
73889,2,2310,2457,-147,0,107,0,6
73891,1,2471,2359,112,0,338,0,6
73892,1,2409,2282,127,0,349,0,6
73893,1,2686,2301,385,0,107,0,6
73894,1,2595,2387,208,0,46,0,6
73895,1,2447,2564,-117,0,43,0,6
73896,2,2263,2495,-232,0,491,0,6
73897,2,2690,2510,180,0,200,0,6
73898,2,2294,2482,-188,0,300,0,6
73899,2,2307,2501,-194,0,83,0,6
73900,2,2285,2438,-153,0,133,0,6
73901,2,2483,2447,36,0,203,1,6
73902,2,2459,2380,79,0,310,0,6
73903,2,2404,2241,163,0,255,1,8
73904,2,2257,2442,-185,0,45,1,6
73905,1,2529,2266,263,0,276,0,6
73906,2,2456,2364,92,0,96,0,6
73907,2,2415,2400,15,0,14,0,6
73908,1,2295,2493,-198,0,106,0,6
73909,3,2409,2259,150,0,310,0,6
73910,2,2459,2378,81,0,394,0,6
73911,1,2585,2500,85,0,61,0,6
73912,2,2284,2435,-151,0,5,0,6
73913,1,2529,2362,167,0,300,0,6
73914,3,2438,2238,200,0,101,0,6
73915,2,2384,2557,-173,0,147,0,6
73916,1,2460,2400,60,0,114,0,6
73917,3,2424,2304,120,0,157,0,6
73918,2,2251,2541,-290,0,302,0,6
73919,1,2307,2405,-98,0,337,0,6
73920,2,2408,2355,53,0,140,0,6
73921,2,2356,2473,-117,0,112,0,6
73922,1,2418,2461,-43,0,4,1,6
73923,1,2359,2532,-173,0,49,0,6
73924,1,2508,2456,52,0,45,0,6
73925,2,2503,2412,91,0,127,0,6
73926,1,2604,2490,114,0,469,1,6
73927,1,2400,2603,-203,0,6,0,6
73928,2,2601,2257,344,0,61,1,6
73929,2,2519,2482,37,0,122,0,6
73930,1,2651,2342,309,0,1,1,6
73931,2,2428,2472,-44,0,122,0,6
73932,2,2406,2200,206,0,310,0,6
73933,2,2684,2555,129,0,56,1,6
73934,2,2347,2471,-124,0,45,0,6
73935,1,2575,2323,252,0,80,0,6
73936,1,2483,2463,20,0,125,0,6
73937,3,2527,2375,152,0,319,0,6
73938,2,2224,2532,-308,0,100,0,6
73939,3,2407,2408,-1,0,45,0,6
73940,1,2372,2460,-88,0,229,0,6
73941,2,2405,2488,-83,0,458,0,6
73942,1,2713,2441,272,0,490,0,6
73943,3,2414,2243,171,0,40,0,6
73944,1,2482,2341,141,0,365,0,6
73945,2,2231,2418,-187,0,218,0,6
73946,2,2338,2442,-104,0,4,1,6
73947,2,2222,2420,-198,0,40,0,6
73948,2,2407,2586,-179,0,300,0,6
73949,1,2402,2314,88,0,245,0,6
73950,3,2498,2362,136,0,211,0,6
73951,1,2207,2500,-293,0,40,1,6
73952,2,2504,2475,29,0,330,0,6
73953,3,2230,2518,-288,0,130,0,6
73954,2,2425,2402,23,0,46,0,6
73955,2,2308,2498,-190,0,0,0,6
73956,2,2402,2438,-36,0,4,0,6
73957,1,2421,2461,-40,4,463,0,13
73958,2,2201,2625,-424,0,200,0,6
73959,2,2399,2532,-133,0,44,0,6
73960,2,2372,2496,-124,0,45,0,6
73961,1,2688,2518,170,0,211,0,6
73962,2,2214,2559,-345,0,122,0,6
73963,1,2519,2545,-26,0,90,0,6
73964,3,2438,2324,114,0,127,0,6
73965,1,2433,2260,173,0,115,0,6
73966,2,2342,2428,-86,0,130,0,6
73967,2,2285,2474,-189,0,106,0,6
73968,1,2422,2464,-42,0,40,0,6
73969,2,2358,2522,-164,0,120,0,6
73970,2,2222,2624,-402,0,45,0,6
73971,1,2572,2420,152,0,460,0,6
73972,1,2384,2464,-80,0,160,0,6
73973,1,2400,2371,29,0,49,0,6
73974,2,2466,2294,172,0,4,0,6
73975,2,2537,2259,278,0,106,0,6
73976,1,2440,2537,-97,0,331,0,6
73977,1,2372,2423,-51,0,416,0,6
73978,1,2549,2273,276,0,112,0,6
73979,2,2526,2331,195,0,330,0,6
73980,1,2649,2473,176,0,245,0,6
73981,1,2822,2392,430,0,335,0,6
73982,2,2405,2583,-178,0,82,0,6
73983,2,2380,2400,-20,0,109,0,6
73984,1,2531,2261,270,0,200,0,6
73985,2,2537,2314,223,0,101,0,6
73986,1,2502,2536,-34,0,242,0,6
73987,2,2336,2460,-124,0,40,0,6
73988,3,2546,2261,285,0,143,0,6
73989,3,2549,2519,30,0,118,0,6
73990,1,2465,2291,174,0,6,1,6
73991,1,2524,2381,143,0,301,0,6
73992,1,2412,2585,-173,0,45,1,6
73993,1,2431,2234,197,0,40,0,6
73994,1,2535,2299,236,0,337,0,6
73995,1,2501,2389,112,0,170,0,6
73996,2,2422,2492,-70,0,100,0,6
73997,2,2454,2597,-143,0,0,0,6
73998,2,2228,2465,-237,0,45,1,6
73999,2,2416,2607,-191,0,151,0,6
74000,1,2460,2245,215,0,80,1,6
74001,2,2477,2352,125,0,464,0,6
74002,2,2336,2430,-94,0,1,0,6
74003,3,2339,2469,-130,0,34,0,6
74004,2,2275,2500,-225,0,41,0,6
74005,2,2620,2380,240,0,381,0,6
74006,2,2450,2512,-62,0,241,0,6
74007,3,2282,2426,-144,0,122,0,6
74008,2,2393,2552,-159,0,211,0,6
74009,3,2432,2611,-179,0,250,0,6
74010,2,2257,2428,-171,0,45,0,6
74011,2,2436,2272,164,0,120,0,6
74012,3,2448,2597,-149,0,325,0,6
74013,1,2418,2447,-29,0,0,1,6
74014,2,2473,2402,71,0,211,0,6
74015,2,2425,2217,208,0,310,0,6
74016,3,2434,2311,123,0,122,0,6
74017,1,2444,2320,124,0,100,1,6
74018,1,2527,2404,123,0,49,0,6
74019,1,2652,2459,193,0,245,0,6
74020,1,2851,2557,294,0,4,0,6
74021,1,2470,2300,170,0,41,0,6
74022,1,2776,2590,186,0,331,0,6
74023,2,2356,2422,-66,0,245,1,6
74024,1,2298,2451,-153,0,2,0,6
74025,2,2360,2416,-56,0,46,0,6
74026,1,2445,2561,-116,0,4,0,6
74027,2,2504,2455,49,0,143,0,6
74028,2,2431,2441,-10,0,386,0,6
74029,1,2350,2577,-227,0,43,0,6
74030,1,2482,2365,117,0,107,0,6
74031,3,2557,2456,101,0,4,0,6
74032,1,2503,2253,250,0,301,0,6
74033,2,2428,2427,1,0,46,0,6
74034,1,2394,2448,-54,0,31,0,6
74035,1,2569,2501,68,0,22,0,6
74036,1,2525,2216,309,0,143,0,6
74037,2,2562,2485,77,0,260,0,6
74038,1,2557,2467,90,0,253,0,6
74039,1,2432,2524,-92,0,7,0,6
74040,1,2463,2273,190,0,69,0,6
74041,2,2301,2653,-352,0,202,0,6
74042,2,2224,2403,-179,0,59,0,6
74043,1,2406,2269,137,0,455,1,6
74044,2,2327,2433,-106,0,121,0,6
74045,1,2425,2300,125,0,131,0,6
74046,1,2433,2477,-44,0,49,0,6
74047,3,2561,2492,69,0,122,0,6
74048,2,2397,2446,-49,0,13,0,6
74049,1,2422,2233,189,0,122,0,6
74050,1,2598,2412,186,0,302,0,6
74051,1,2431,2494,-63,0,153,0,6
74052,1,2660,2518,142,0,210,0,6
74053,3,2376,2505,-129,0,28,0,6
74054,2,2415,2595,-180,0,40,0,6
74055,1,2512,2446,66,0,46,0,6
74056,1,2691,2587,104,0,43,0,6
74057,2,2222,2533,-311,0,388,0,6
74058,1,2442,2252,190,0,211,0,6
74059,1,2200,2507,-307,0,313,0,6
74060,1,2611,2428,183,0,60,0,6
74061,1,2567,2503,64,0,302,0,6
74062,2,2401,2510,-109,0,460,0,6
74063,2,2453,2537,-84,0,114,0,6
74064,2,2248,2463,-215,0,2,0,6
74065,2,2274,2435,-161,0,123,0,6
74066,1,2443,2493,-50,0,247,0,6
74067,1,2677,2343,334,0,4,0,6
74068,1,2475,2206,269,0,106,0,6
74069,1,2665,2692,-27,0,245,0,6
74070,3,2393,2442,-49,0,101,0,6
74071,1,2485,2520,-35,0,267,0,6
74072,2,2351,2620,-269,0,10,0,6
74073,1,2549,2467,82,0,315,0,6
74074,1,2601,2394,207,0,40,0,6
74075,1,2497,2453,44,0,395,0,6
74076,2,2371,2461,-90,0,108,0,6
74077,1,2445,2256,189,0,311,0,6
74078,1,2426,2307,119,0,415,0,6
74079,1,2392,2471,-79,0,187,0,6
74080,2,2594,2498,96,0,459,0,6
74081,1,2464,2409,55,0,120,1,6
74082,1,2583,2221,362,0,31,0,6
74083,2,2451,2301,150,0,101,0,6
74084,1,2446,2201,245,0,200,0,6
74085,2,2496,2590,-94,0,436,0,6
74086,1,2555,2414,141,0,127,0,6
74087,2,2610,2718,-108,0,45,1,6
74088,2,2473,2853,-380,0,373,0,6
74089,2,2397,2465,-68,0,46,0,6
74090,1,2464,2288,176,0,454,0,6
74091,1,2543,2573,-30,0,172,0,6
74092,3,2505,2638,-133,0,246,0,6
74093,2,2382,2476,-94,0,152,1,6
74094,1,2450,2224,226,0,346,0,6
74095,1,2428,2231,197,0,244,1,6
74096,3,2487,2423,64,0,405,0,6
74097,1,2386,2514,-128,0,461,0,6
74098,1,2424,2397,27,0,4,1,6
74099,1,2365,2625,-260,0,138,1,6
74100,2,2410,2435,-25,0,400,0,6
74101,2,2241,2495,-254,0,125,0,6
74102,1,2577,2556,21,0,5,0,6
74103,1,2241,2425,-184,0,344,0,6
74104,1,2506,2226,280,0,4,0,8
74105,2,2261,2823,-562,0,4,0,6
74106,1,2390,2406,-16,0,216,0,6
74107,2,2420,2528,-108,0,45,0,6
74108,3,2432,2302,130,0,300,0,6
74109,1,2511,2357,154,0,250,0,6
74110,2,2257,2436,-179,0,43,1,6
74111,2,2290,2476,-186,0,120,0,6
74112,1,2451,2313,138,0,4,0,6
74113,2,2476,2200,276,0,244,1,6
74114,2,2395,2503,-108,0,46,0,6
74115,2,2455,2327,128,0,112,0,6
74116,2,2276,2419,-143,0,36,0,6
74117,2,2280,2429,-149,0,205,0,6
74118,2,2234,2423,-189,0,140,0,6
74119,2,2289,2408,-119,0,4,0,6
74120,1,2436,2400,36,0,122,0,6
74121,3,2486,2608,-122,0,264,0,6
74122,2,2408,2283,125,0,0,0,6
74123,1,2557,2313,244,0,40,0,6
74124,2,2287,2477,-190,0,40,0,6
74125,2,2519,2653,-134,0,112,1,6
74126,1,2492,2420,72,0,336,0,6
74127,2,2406,2538,-132,0,100,0,6
74128,2,2309,2515,-206,0,248,1,6
74129,1,2530,2407,123,0,107,0,6
74130,3,2229,2551,-322,0,126,0,6
74131,2,2457,2655,-198,0,193,0,6
74132,2,2598,2563,35,0,0,0,6
74133,2,2214,2566,-352,0,15,0,6
74134,2,2391,2604,-213,0,354,0,6
74136,1,2601,2314,287,0,46,0,6
74137,1,2302,2448,-146,0,115,0,6
74138,2,2362,2614,-252,0,225,0,6
74139,2,2638,2641,-3,0,338,0,6
74140,2,2515,2655,-140,0,57,0,6
74141,2,2455,2691,-236,0,48,0,6
74142,2,2587,2779,-192,0,490,0,6
74143,2,2416,2575,-159,0,188,0,6
74144,3,2357,2513,-156,0,132,0,6
74145,1,2485,2326,159,0,365,0,6
74146,1,2367,2441,-74,0,152,0,6
74147,1,2406,2280,126,0,45,0,6
74148,3,2488,2336,152,0,176,0,6
74149,1,2478,2361,117,0,41,0,6
74150,2,2247,2447,-200,0,0,0,6
74151,1,2416,2529,-113,0,302,0,6
74152,2,2269,2566,-297,0,46,0,6
74153,2,2409,2429,-20,0,110,1,6
74154,1,2452,2291,161,0,123,0,6
74155,3,2440,2234,206,0,155,0,6
74156,1,2477,2310,167,0,353,0,6
74157,2,2349,2444,-95,0,202,1,6
74158,1,2464,2380,84,0,386,0,6
74159,2,2402,2331,71,0,48,0,6
74160,1,2824,2385,439,0,135,0,6
74161,2,2513,2421,92,0,255,0,6
74162,1,2479,2333,146,0,203,0,6
74163,2,2215,2481,-266,0,180,0,6
74164,1,2451,2231,220,0,5,0,6
74165,1,2560,2411,149,0,41,0,6
74166,2,2330,2400,-70,0,107,0,6
74167,1,2423,2445,-22,0,411,0,6
74168,2,2214,2517,-303,0,241,0,6
74169,3,2424,2488,-64,0,128,0,6
74170,2,2486,2209,277,0,410,0,6
74172,2,2434,2332,102,0,46,0,6
74173,1,2469,2359,110,0,464,1,6
74174,3,2239,2444,-205,0,121,0,6
74175,2,2559,2554,5,0,213,0,6
74176,3,2487,2238,249,0,1,0,6
74177,1,2410,2439,-29,0,106,0,6
74178,2,2485,2379,106,0,300,0,6
74179,1,2311,2545,-234,0,115,1,6
74180,1,2459,2360,99,0,302,0,6
74181,3,2483,2365,118,0,15,0,6
74182,1,2346,2419,-73,0,301,1,6
74183,2,2425,2572,-147,0,330,0,6
74184,2,2450,2593,-143,0,49,0,6
74185,1,2503,2534,-31,0,10,0,6
74186,2,2222,2463,-241,0,107,0,6
74187,1,2525,2368,157,0,401,0,6
74188,2,2457,2488,-31,0,300,0,6
74190,2,2515,2495,20,0,40,0,6
74191,2,2296,2664,-368,0,400,0,6
74192,1,2453,2288,165,0,30,0,6
74193,1,2427,2352,75,0,395,1,6
74194,2,2440,2425,15,0,40,0,6
74195,1,2412,2380,32,0,61,0,6
74196,2,2366,2679,-313,0,110,0,6
74197,2,2406,2463,-57,0,302,0,6
74198,3,2503,2482,21,0,125,0,6
74199,2,2435,2448,-13,0,255,0,6
74200,1,2356,2466,-110,0,132,0,6
74201,1,2542,2468,74,0,113,0,6
74202,2,2854,2559,295,0,4,0,6
74203,2,2553,2601,-48,0,112,0,6
74204,2,2416,2472,-56,0,108,0,6
74205,3,2530,2539,-9,0,80,0,6
74206,1,2535,2282,253,0,352,0,6
74207,3,2578,2584,-6,0,327,0,6
74208,2,2277,2519,-242,0,116,0,6
74209,1,2590,2390,200,0,119,0,6
74210,2,2251,2452,-201,0,106,0,6
74211,1,2567,2304,263,0,200,1,6
74212,1,2535,2263,272,0,231,0,6
74213,2,2332,2432,-100,0,101,0,6
74214,2,2331,2413,-82,0,244,1,8
74215,1,2271,2410,-139,0,241,0,6
74216,2,2465,2268,197,0,100,0,6
74217,1,2446,2418,28,0,40,0,6
74218,1,2549,2481,68,0,133,0,6
74219,1,2307,2507,-200,0,104,0,6
74220,1,2782,2584,198,0,315,0,6
74221,1,2450,2345,105,0,466,1,6
74222,1,2569,2235,334,0,103,0,6
74223,2,2229,2422,-193,0,122,0,6
74224,2,2475,2218,257,0,43,1,6
74225,1,2409,2229,180,0,5,0,6
74226,1,2679,2583,96,0,302,0,6
74227,1,2550,2528,22,0,289,0,6
74228,1,2332,2523,-191,0,463,0,6
74229,2,2612,2357,255,0,7,0,6
74230,2,2498,2587,-89,0,89,1,6
74231,3,2236,2426,-190,0,5,0,6
74232,1,2535,2448,87,0,120,0,6
74233,2,2528,2611,-83,0,241,0,6
74234,2,2400,2272,128,0,172,0,6
74235,3,2531,2497,34,0,399,0,6
74237,1,2505,2296,209,0,380,0,6
74238,1,2338,2443,-105,0,4,0,6
74239,1,2446,2415,31,0,205,0,6
74240,1,2825,2451,374,0,225,0,6
74241,2,2253,2693,-440,0,45,1,6
74242,1,2616,2404,212,0,318,0,6
74243,1,2505,2471,34,0,122,0,6
74244,1,2520,2429,91,0,106,1,6
74245,2,2458,2254,204,0,123,0,6
74246,1,2528,2496,32,0,148,0,6
74247,1,2488,2389,99,0,31,0,6
74248,2,2439,2271,168,0,113,0,6
74249,1,2451,2368,83,0,408,0,6
74250,2,2442,2517,-75,0,140,0,6
74251,2,2472,2447,25,0,200,0,6
74252,2,2209,2422,-213,0,118,0,6
74253,1,2468,2207,261,0,209,0,6
74254,1,2411,2257,154,0,48,0,6
74255,1,2486,2436,50,0,7,0,6
74256,2,2468,2393,75,0,201,0,6
74257,1,2442,2397,45,4,50,0,13
74258,1,2440,2244,196,0,15,0,6
74259,1,2455,2583,-128,0,123,0,6
74260,2,2375,2450,-75,0,394,0,6
74261,3,2373,2467,-94,0,0,0,6
74262,2,2464,2399,65,0,175,0,6
74263,1,2417,2260,157,0,201,0,6
74264,1,2442,2264,178,0,172,1,6
74265,2,2257,2493,-236,0,207,0,6
74266,3,2316,2455,-139,4,131,0,13
74267,1,2595,2452,143,0,122,0,6
74268,1,2607,2402,205,0,411,0,6
74269,1,2390,2455,-65,0,102,0,6
74270,1,2573,2377,196,0,462,0,6
74271,2,2315,2504,-189,0,106,0,6
74272,1,2504,2556,-52,0,461,0,6
74274,1,2421,2356,65,0,150,0,6
74275,3,2244,2521,-277,0,300,0,6
74276,1,2433,2424,9,0,103,0,6
74277,2,2418,2464,-46,0,302,1,6
74278,1,2392,2548,-156,0,300,0,6
74279,1,2546,2310,236,0,160,0,6
74280,1,2413,2463,-50,0,247,1,6
74281,1,2497,2328,169,0,380,0,6
74282,1,2476,2327,149,0,311,0,8
74283,1,2507,2356,151,0,135,0,6
74284,1,2428,2490,-62,0,490,0,6
74285,1,2396,2449,-53,0,491,0,6
74286,1,2453,2230,223,0,4,0,6
74287,2,2417,2404,13,0,4,0,6
74288,1,2341,2498,-157,0,120,1,6
74289,2,2249,2408,-159,0,123,0,6
74290,1,2521,2326,195,0,61,1,6
74291,2,2367,2455,-88,0,345,0,6
74292,3,2464,2511,-47,0,211,0,6
74293,2,2659,2728,-69,0,245,0,6
74294,1,2242,2433,-191,0,4,1,6
74295,3,2401,2292,109,0,202,0,6
74296,1,2329,2481,-152,0,45,0,6
74297,1,2359,2422,-63,0,225,0,6
74298,1,2409,2246,163,0,40,1,6
74299,1,2439,2254,185,0,101,1,6
74300,3,2435,2429,6,0,9,0,6
74301,1,2440,2299,141,0,122,0,6
74302,2,2313,2482,-169,0,312,0,6
74303,1,2408,2358,50,0,272,0,6
74304,1,2384,2484,-100,0,40,0,6
74305,1,2661,2334,327,0,45,1,6
74306,2,2666,2826,-160,0,245,0,6
74307,1,2252,2449,-197,0,40,0,6
74308,1,2546,2546,0,0,115,0,6
74309,1,2402,2311,91,0,4,0,6
74310,2,2444,2257,187,0,400,0,6
74311,1,2428,2376,52,0,133,1,6
74312,2,2404,2316,88,0,265,0,6
74313,2,2365,2471,-106,0,302,1,6
74314,2,2440,2465,-25,0,73,0,6
74315,2,2437,2467,-30,0,131,0,6
74316,1,2261,2448,-187,0,8,0,6
74317,2,2607,2488,119,0,463,0,6
74318,2,2474,2445,29,0,40,0,6
74319,1,2292,2423,-131,0,150,0,6
74320,1,2587,2499,88,0,483,0,6
74321,1,2416,2514,-98,0,106,1,6
74322,2,2339,2656,-317,0,0,1,6
74323,1,2432,2400,32,0,45,0,6
74324,1,2432,2435,-3,0,0,1,6
74325,1,2491,2418,73,0,40,0,6
74326,1,2250,2443,-193,0,112,0,6
74328,2,2205,2506,-301,0,240,0,6
74329,1,2537,2403,134,0,55,0,6
74330,2,2505,2390,115,0,110,1,6
74331,1,2441,2337,104,0,466,0,6
74332,1,2657,2297,360,0,106,0,6
74333,1,2455,2301,154,0,109,0,6
74334,2,2467,2458,9,0,6,0,6
74335,1,2568,2341,227,0,137,0,6
74336,2,2436,2393,43,0,278,0,6
74337,1,2490,2251,239,0,115,0,6
74338,2,2596,2398,198,0,49,0,6
74339,2,2215,2472,-257,0,112,0,6
74340,2,2511,2282,229,0,125,0,6
74341,1,2494,2452,42,0,246,0,6
74342,1,2434,2404,30,0,203,1,6
74343,2,2413,2405,8,0,45,0,6
74344,2,2228,2533,-305,0,150,0,6
74345,2,2242,2496,-254,0,147,0,6
74346,1,2466,2204,262,0,453,0,6
74347,3,2406,2515,-109,0,104,0,6
74348,3,2426,2256,170,0,150,0,6
74349,1,2287,2447,-160,0,4,0,6
74351,1,2266,2448,-182,0,269,0,6
74352,1,2479,2509,-30,0,302,0,6
74353,1,2528,2367,161,0,45,0,6
74354,2,2336,2505,-169,0,201,1,6
74355,1,2617,2242,375,0,478,0,6
74356,1,2477,2465,12,0,311,1,6
74357,2,2548,2520,28,0,244,1,6
74358,2,2444,2249,195,0,122,1,6
74359,1,2434,2401,33,0,13,0,6
74360,2,2411,2578,-167,0,40,0,6
74361,1,2584,2407,177,0,306,0,6
74362,1,2325,2423,-98,0,46,0,6
74363,1,2311,2470,-159,0,301,0,6
74364,1,2448,2603,-155,0,282,0,6
74365,1,2569,2239,330,0,303,0,6
74366,3,2426,2288,138,0,109,0,6
74367,3,2452,2297,155,0,288,0,6
74368,1,2319,2454,-135,0,127,1,6
74369,1,2436,2501,-65,0,40,1,6
74370,1,2509,2218,291,0,80,0,6
74372,2,2229,2432,-203,0,6,0,6
74373,1,2309,2481,-172,0,40,0,6
74374,1,2433,2416,17,0,200,0,6
74375,2,2254,2468,-214,4,335,0,11
74376,1,2402,2464,-62,0,4,0,6
74377,2,2557,2412,145,0,4,1,6
74378,2,2359,2538,-179,0,154,0,6
74379,3,2587,2556,31,0,455,0,6
74380,2,2404,2523,-119,0,45,0,6
74381,2,2266,2424,-158,0,48,1,6
74382,2,2408,2283,125,0,101,0,6
74383,2,2576,2493,83,0,400,0,6
74384,2,2250,2416,-166,0,107,0,6
74385,3,2431,2397,34,0,311,0,6
74386,3,2430,2291,139,0,331,0,6
74387,1,2347,2461,-114,0,100,0,6
74388,1,2420,2342,78,0,152,0,6
74389,1,2593,2275,318,0,61,0,6
74390,1,2396,2409,-13,0,133,0,6
74391,2,2606,2844,-238,0,387,0,6
74392,1,2569,2261,308,0,45,0,6
74393,1,2541,2455,86,0,130,0,6
74394,1,2616,2525,91,0,107,0,6
74395,2,2520,2510,10,0,2,1,6
74396,1,2436,2385,51,0,123,0,6
74397,2,2286,2434,-148,0,128,1,6
74398,1,2443,2249,194,0,45,0,6
74399,1,2499,2659,-160,0,191,0,6
74400,2,2418,2610,-192,0,300,0,6
74401,1,2511,2619,-108,0,228,1,6
74402,1,2415,2592,-177,0,319,0,6
74403,2,2364,2400,-36,0,278,1,6
74404,1,2474,2400,74,0,106,0,6
74405,1,2540,2300,240,0,246,0,6
74406,1,2415,2393,22,0,40,0,6
74407,2,2263,2542,-279,0,135,0,6
74408,2,2300,2422,-122,0,85,0,6
74409,3,2508,2553,-45,0,107,0,6
74410,2,2308,2402,-94,0,469,1,6
74411,1,2453,2325,128,0,15,0,6
74412,1,2379,2400,-21,0,145,0,6
74413,2,2527,2542,-15,0,345,0,6
74414,2,2436,2298,138,0,40,0,6
74415,1,2324,2417,-93,0,0,0,6
74416,1,2425,2402,23,0,378,0,6
74417,1,2365,2470,-105,0,45,0,6
74418,1,2363,2431,-68,0,131,0,6
74419,2,2274,2408,-134,0,123,0,6
74420,1,2251,2489,-238,0,4,0,6
74421,1,2568,2245,323,0,40,0,6
74422,2,2460,2455,5,0,227,0,6
74423,1,2494,2298,196,0,48,0,6
74424,2,2592,2422,170,0,261,0,6
74425,3,2450,2457,-7,0,4,0,6
74426,1,2448,2309,139,0,241,0,6
74427,1,2517,2423,94,0,120,0,6
74428,1,2400,2467,-67,0,128,0,6
74429,1,2514,2248,266,0,308,0,6
74430,2,2204,2456,-252,0,57,0,6
74431,3,2276,2500,-224,0,153,0,6
74432,1,2454,2355,99,0,302,0,6
74433,1,2454,2274,180,0,200,0,6
74434,1,2353,2467,-114,0,100,0,6
74435,1,2435,2429,6,0,9,0,6
74436,1,2639,2513,126,0,202,0,6
74437,2,2343,2555,-212,0,106,0,6
74438,2,2226,2564,-338,0,148,0,6
74439,1,2221,2412,-191,0,49,0,6
74440,1,2405,2468,-63,0,300,0,6
74441,3,2412,2347,65,0,40,0,6
74442,2,2694,2288,406,0,190,0,6
74443,2,2379,2494,-115,0,5,0,6
74444,2,2496,2599,-103,0,0,1,6
74445,2,2353,2467,-114,0,63,0,6
74446,2,2442,2481,-39,0,106,0,6
74447,2,2354,2408,-54,4,0,0,13
74448,1,2435,2454,-19,0,338,0,6
74449,1,2616,2567,49,0,28,0,6
74450,3,2617,2366,251,0,400,0,6
74451,1,2469,2369,100,0,453,0,6
74452,1,2482,2432,50,0,487,0,6
74453,3,2240,2424,-184,0,140,0,6
74454,1,2436,2459,-23,0,320,0,6
74455,2,2447,2491,-44,0,45,0,6
74456,3,2437,2569,-132,0,306,0,6
74457,3,2455,2300,155,0,7,0,6
74458,1,2404,2297,107,0,258,0,6
74459,2,2429,2438,-9,0,40,0,6
74460,2,2406,2829,-423,0,224,1,6
74461,2,2588,2662,-74,0,302,0,6
74462,1,2477,2344,133,0,1,0,6
74463,1,2448,2391,57,0,113,1,6
74464,2,2410,2451,-41,0,36,0,6
74465,2,2349,2496,-147,0,248,0,6
74466,2,2240,2619,-379,0,200,0,6
74467,2,2219,2496,-277,0,10,0,6
74469,2,2205,2528,-323,0,63,0,6
74470,1,2425,2320,105,0,203,0,6
74471,2,2498,2470,28,0,484,0,6
74472,2,2272,2473,-201,0,131,0,6
74473,2,2439,2530,-91,0,46,0,6
74474,1,2536,2272,264,0,490,1,6
74475,1,2422,2300,122,0,46,0,6
74476,1,2418,2321,97,0,231,0,6
74477,2,2420,2413,7,0,211,0,6
74478,2,2439,2350,89,0,101,0,6
74479,1,2509,2273,236,0,41,0,6
74480,1,2418,2338,80,0,311,0,6
74481,3,2575,2510,65,0,245,0,6
74482,3,2352,2483,-131,0,200,0,6
74483,1,2667,2439,228,0,255,0,6
74484,2,2738,2667,71,0,211,0,6
74485,2,2332,2400,-68,0,440,0,6
74486,1,2654,2583,71,0,202,0,6
74487,3,2322,2436,-114,0,4,0,6
74488,2,2411,2683,-272,0,45,0,6
74489,1,2578,2485,93,0,317,0,6
74490,1,2423,2455,-32,0,405,0,6
74491,1,2357,2476,-119,0,103,0,6
74492,2,2308,2478,-170,0,40,1,6
74493,1,2518,2349,169,0,110,0,6
74494,2,2457,2395,62,0,120,0,6
74495,1,2530,2529,1,0,311,0,6
74496,1,2508,2369,139,0,120,0,6
74497,1,2412,2252,160,0,45,0,6
74498,2,2265,2540,-275,0,45,0,6
74499,2,2455,2576,-121,0,113,0,6
74500,2,2473,2545,-72,0,11,1,6
74501,2,2396,2404,-8,0,115,0,6
74502,1,2571,2398,173,0,45,0,6
74503,3,2259,2478,-219,0,46,0,6
74504,1,2514,2412,102,0,315,0,6
74505,3,2485,2467,18,0,107,0,6
74506,1,2503,2302,201,0,14,0,6
74507,2,2371,2541,-170,0,456,1,6
74508,1,2595,2437,158,0,400,0,6
74509,1,2378,2560,-182,0,332,0,6
74510,1,2486,2233,253,0,1,0,6
74511,1,2442,2508,-66,0,15,0,6
74512,2,2339,2599,-260,0,344,0,6
74513,2,2411,2477,-66,0,245,0,6
74514,1,2503,2554,-51,0,320,0,6
74515,1,2476,2211,265,0,41,0,6
74516,2,2444,2238,206,0,156,0,6
74517,2,2298,2500,-202,0,40,0,6
74518,2,2265,2451,-186,0,8,0,6
74519,2,2453,2466,-13,0,115,0,6
74520,3,2293,2561,-268,0,13,0,6
74521,1,2425,2236,189,0,302,0,6
74522,1,2426,2222,204,0,140,0,6
74523,2,2658,2498,160,0,1,0,6
74524,1,2505,2394,111,0,200,0,6
74525,2,2410,2371,39,0,45,0,6
74526,2,2427,2410,17,0,176,0,6
74527,1,2439,2327,112,0,267,0,8
74528,3,2282,2404,-122,0,45,0,8
74529,1,2318,2462,-144,0,110,1,8
74530,2,2450,2221,229,0,410,0,8
74531,2,2475,2243,232,0,354,0,8
74532,1,2243,2470,-227,0,400,0,6
74533,2,2442,2476,-34,0,253,0,6
74534,2,2409,2424,-15,0,6,0,6
74535,2,2249,2477,-228,0,278,0,6
74536,2,2501,2536,-35,0,243,0,6
74537,1,2681,2294,387,0,8,0,6
74538,2,2414,2318,96,0,176,0,8
74539,1,2603,2492,111,0,463,0,6
74540,2,2846,2684,162,0,9,0,6
74541,1,2304,2604,-300,0,376,0,6
74542,2,2463,2297,166,0,242,0,6
74543,2,2270,2511,-241,0,230,0,6
74544,1,2431,2496,-65,0,127,0,6
74545,2,2269,2409,-140,0,4,0,6
74546,3,2310,2497,-187,0,455,0,6
74547,2,2399,2568,-169,0,112,0,6
74548,2,2374,2425,-51,0,260,1,6
74549,2,2297,2482,-185,0,394,0,6
74550,2,2460,2502,-42,0,302,0,6
74551,1,2358,2542,-184,0,307,0,6
74552,3,2394,2472,-78,0,7,0,6
74553,2,2474,2552,-78,0,110,1,6
74554,1,2441,2617,-176,0,211,0,6
74555,2,2246,2519,-273,0,122,0,6
74556,1,2431,2399,32,0,400,1,6
74557,1,2484,2498,-14,0,15,1,6
74558,1,2583,2370,213,0,31,0,6
74559,2,2479,2593,-114,0,300,0,6
74560,2,2225,2620,-395,0,42,0,6
74561,3,2565,2521,44,0,70,0,6
74562,3,2410,2597,-187,0,10,0,6
74563,1,2495,2218,277,0,100,0,6
74564,2,2404,2446,-42,0,225,0,6
74565,3,2398,2451,-53,0,414,0,6
74566,2,2571,2507,64,0,46,1,6
74567,1,2397,2509,-112,0,200,0,6
74568,2,2412,2375,37,0,43,0,6
74569,1,2351,2458,-107,0,115,0,6
74570,3,2416,2216,200,0,46,0,6
74571,2,2239,2495,-256,0,113,0,6
74572,1,2457,2349,108,0,131,0,6
74573,3,2468,2494,-26,0,373,0,6
74574,1,2539,2409,130,0,46,0,6
74575,3,2581,2587,-6,0,314,0,6
74576,3,2516,2536,-20,0,6,0,6
74577,3,2356,2445,-89,0,245,0,6
74578,1,2445,2423,22,0,4,1,6
74579,1,2408,2341,67,0,103,1,6
74580,2,2242,2524,-282,0,8,0,6
74581,1,2405,2438,-33,0,45,0,6
74582,1,2651,2478,173,0,315,0,6
74583,1,2403,2208,195,0,130,0,6
74584,2,2224,2508,-284,0,194,0,8
74585,2,2309,2538,-229,0,200,1,6
74587,1,2424,2260,164,0,227,0,6
74588,1,2521,2370,151,0,226,0,6
74589,3,2542,2257,285,0,8,0,6
74590,2,2562,2214,348,0,180,0,6
74591,2,2444,2497,-53,0,265,0,6
74592,1,2484,2450,34,0,40,0,6
74593,2,2318,2574,-256,0,96,0,6
74594,3,2424,2388,36,0,122,0,6
74595,1,2405,2359,46,0,123,1,6
74596,2,2455,2336,119,0,247,0,6
74597,2,2392,2469,-77,0,201,0,6
74598,3,2518,2439,79,0,463,0,6
74599,1,2612,2365,247,0,484,0,6
74600,1,2408,2377,31,0,80,0,6
74601,1,2570,2274,296,0,34,0,6
74602,2,2457,2450,7,0,110,0,6
74603,2,2281,2432,-151,0,106,0,6
74604,1,2480,2387,93,0,337,0,6
74605,3,2214,2494,-280,0,151,0,6
74606,1,2581,2247,334,0,0,0,6
74607,3,2299,2621,-322,0,140,0,6
74608,3,2424,2435,-11,0,242,0,6
74609,1,2240,2558,-318,0,106,0,6
74610,2,2388,2511,-123,0,131,0,6
74611,1,2455,2253,202,0,112,0,6
74612,2,2354,2455,-101,0,106,0,6
74613,2,2368,2481,-113,0,250,0,6
74614,1,2711,2686,25,0,4,0,6
74615,3,2448,2395,53,0,337,0,6
74616,1,2429,2430,-1,0,40,0,6
74617,1,2690,2259,431,0,302,0,6
74618,1,2288,2460,-172,0,302,0,6
74619,2,2456,2405,51,0,112,0,6
74620,1,2722,2398,324,0,4,0,6
74621,2,2505,2487,18,0,125,0,6
74622,1,2359,2516,-157,0,4,1,6
74623,1,2293,2402,-109,0,200,0,6
74624,2,2348,2403,-55,0,40,0,6
74625,2,2354,2561,-207,0,145,0,6
74626,2,2442,2574,-132,0,45,1,6
74627,1,2399,2479,-80,0,302,0,8
74628,1,2612,2403,209,0,318,0,6
74629,1,2429,2519,-90,0,255,0,6
74630,1,2506,2513,-7,0,15,0,6
74631,1,2472,2252,220,0,113,0,6
74632,2,2236,2620,-384,0,212,0,6
74633,1,2448,2366,82,0,332,0,6
74634,2,2260,2516,-256,0,80,0,6
74635,2,2230,2431,-201,0,250,0,6
74636,1,2509,2423,86,0,248,0,6
74637,1,2404,2306,98,0,315,0,6
74638,2,2451,2358,93,0,20,0,6
74639,1,2448,2473,-25,0,147,0,6
74640,1,2614,2382,232,0,4,0,6
74641,2,2289,2441,-152,0,40,0,6
74642,3,2377,2539,-162,0,121,0,6
74643,1,2286,2452,-166,0,10,1,6
74644,1,2418,2443,-25,0,120,0,8
74645,1,2459,2366,93,0,301,0,6
74646,1,2270,2459,-189,0,43,0,6
74647,2,2419,2315,104,0,49,0,6
74648,2,2364,2522,-158,0,309,0,6
74649,1,2390,2498,-108,0,120,0,6
74650,1,2830,2677,153,0,123,1,6
74651,2,2437,2357,80,0,125,0,6
74652,2,2475,2405,70,0,45,0,6
74653,1,2480,2244,236,0,202,0,6
74654,2,2457,2408,49,0,30,0,6
74655,2,2422,2251,171,0,101,0,6
74656,2,2262,2437,-175,0,398,0,6
74657,1,2458,2317,141,0,245,0,6
74658,3,2201,2422,-221,0,31,0,6
74659,2,2267,2583,-316,0,101,0,6
74660,1,2488,2607,-119,0,9,1,6
74661,1,2450,2206,244,0,109,0,6
74662,1,2419,2414,5,0,48,1,6
74663,2,2254,2534,-280,0,45,0,6
74664,2,2332,2411,-79,0,205,0,6
74665,2,2613,2682,-69,0,331,0,6
74666,2,2502,2415,87,0,120,0,6
74667,1,2464,2451,13,0,4,0,6
74668,1,2411,2241,170,0,109,0,6
74669,3,2692,2262,430,0,174,0,6
74670,2,2485,2838,-353,0,49,1,6
74671,2,2386,2455,-69,0,302,0,6
74672,1,2423,2723,-300,0,315,0,6
74673,1,2535,2457,78,0,190,0,6
74674,1,2507,2293,214,0,45,0,6
74675,2,2367,2401,-34,0,85,0,6
74676,1,2531,2274,257,0,45,0,6
74677,2,2501,2365,136,0,106,0,6
74678,2,2489,2586,-97,0,244,0,6
74679,1,2399,2435,-36,0,320,1,6
74680,2,2227,2407,-180,0,86,0,6
74681,1,2481,2614,-133,0,310,0,6
74682,1,2622,2500,122,0,122,0,6
74683,3,2373,2523,-150,0,302,0,6
74684,2,2435,2383,52,0,190,0,6
74685,1,2550,2471,79,0,250,0,6
74686,1,2208,2413,-205,0,455,1,6
74687,2,2306,2482,-176,0,200,0,6
74688,1,2426,2254,172,0,2,0,6
74689,1,2428,2306,122,0,40,0,6
74690,3,2544,2518,26,0,346,0,6
74691,2,2277,2426,-149,0,1,1,6
74692,3,2476,2472,4,0,107,0,6
74693,2,2293,2406,-113,0,331,0,6
74694,1,2457,2382,75,0,152,0,6
74695,1,2296,2458,-162,0,405,0,6
74696,2,2290,2439,-149,0,10,1,6
74697,2,2448,2408,40,0,317,0,6
74698,2,2221,2485,-264,0,347,0,6
74699,1,2467,2343,124,0,53,0,6
74700,1,2413,2279,134,0,253,0,6
74701,1,2427,2291,136,0,202,0,6
74702,2,2409,2282,127,0,125,0,6
74703,2,2674,2576,98,0,120,0,6
74704,1,2512,2510,2,0,404,0,6
74705,2,2511,2438,73,0,278,0,6
74706,3,2311,2481,-170,0,245,0,6
74707,1,2416,2521,-105,0,48,0,6
74708,1,2685,2316,369,0,131,0,6
74709,1,2405,2404,1,0,310,0,6
74710,1,2404,2317,87,0,373,0,6
74711,1,2373,2542,-169,0,248,0,6
74712,2,2402,2204,198,0,101,0,6
74713,2,2255,2442,-187,0,48,0,6
74714,2,2530,2320,210,0,107,0,6
74715,3,2350,2436,-86,0,302,0,6
74716,3,2372,2474,-102,0,106,0,6
74717,1,2506,2382,124,0,46,0,6
74718,2,2369,2650,-281,0,40,0,6
74719,1,2368,2431,-63,0,414,1,6
74720,3,2573,2442,131,0,190,0,6
74721,1,2301,2423,-122,0,45,0,6
74722,1,2510,2356,154,0,471,0,6
74723,1,2536,2521,15,0,268,0,6
74724,1,2547,2324,223,0,80,0,6
74725,2,2545,2517,28,0,211,1,6
74726,1,2248,2569,-321,0,172,0,6
74727,3,2281,2463,-182,0,373,0,6
74728,1,2224,2418,-194,0,45,0,6
74729,1,2574,2418,156,0,132,0,6
74730,1,2571,2231,340,0,244,1,6
74731,1,2405,2268,137,0,45,0,6
74732,1,2494,2238,256,0,113,0,6
74733,3,2541,2468,73,0,40,0,6
74734,1,2459,2357,102,0,48,0,6
74735,3,2441,2454,-13,0,260,0,6
74736,1,2491,2346,145,0,300,0,6
74737,3,2218,2414,-196,0,469,0,6
74738,1,2450,2419,31,0,242,0,6
74739,2,2519,2496,23,0,41,0,6
74740,1,2430,2351,79,0,60,0,6
74741,2,2536,2637,-101,0,40,0,6
74742,1,2434,2492,-58,0,46,0,6
74743,1,2441,2453,-12,0,40,0,6
74744,2,2367,2429,-62,0,110,0,6
74745,3,2386,2538,-152,0,85,0,6
74746,1,2459,2350,109,0,250,0,6
74747,1,2394,2436,-42,0,245,0,6
74748,1,2259,2480,-221,0,201,0,6
74749,2,2474,2247,227,0,106,1,6
74750,1,2259,2449,-190,0,106,0,6
74751,1,2512,2614,-102,0,228,0,6
74752,2,2580,2437,143,0,338,0,6
74753,1,2367,2400,-33,0,162,0,6
74754,1,2411,2262,149,0,44,0,6
74755,1,2585,2659,-74,0,123,0,6
74756,1,2453,2443,10,0,245,0,6
74757,1,2502,2372,130,0,136,0,6
74758,1,2439,2448,-9,0,46,0,6
74759,1,2413,2411,2,0,115,0,6
74760,3,2500,2431,69,0,212,0,6
74761,3,2557,2492,65,0,315,0,6
74762,3,2453,2319,134,4,256,0,13
74763,2,2536,2370,166,0,20,1,6
74764,1,2412,2299,113,0,302,0,6
74765,1,2681,2717,-36,0,242,0,6
74766,2,2476,2405,71,0,106,0,6
74767,1,2438,2224,214,0,103,0,6
74768,2,2410,2451,-41,0,247,0,6
74769,1,2497,2283,214,0,48,0,6
74770,1,2523,2335,188,0,40,0,6
74771,2,2265,2440,-175,0,45,0,6
74772,1,2369,2408,-39,0,0,0,6
74773,3,2258,2569,-311,0,80,0,6
74774,1,2518,2246,272,0,101,0,6
74775,2,2377,2425,-48,0,140,0,6
74776,1,2406,2288,118,0,334,1,6
74777,2,2364,2592,-228,0,7,0,6
74778,2,2407,2533,-126,0,307,0,6
74779,2,2428,2239,189,0,40,0,6
74780,2,2325,2525,-200,0,110,0,6
74781,1,2271,2428,-157,0,334,0,6
74782,1,2366,2444,-78,0,101,0,6
74783,3,2607,2590,17,0,310,0,6
74784,1,2652,2424,228,0,1,0,6
74785,1,2563,2291,272,0,203,1,6
74786,2,2367,2579,-212,0,40,0,6
74787,1,2412,2393,19,0,200,0,6
74788,2,2265,2538,-273,0,46,0,6
74789,1,2572,2380,192,0,16,0,6
74790,1,2601,2285,316,0,113,0,6
74791,2,2417,2404,13,0,4,0,6
74792,1,2378,2449,-71,0,227,0,6
74793,2,2597,2434,163,0,104,0,6
74794,2,2281,2429,-148,0,162,0,6
74795,2,2236,2475,-239,0,140,0,6
74796,1,2424,2500,-76,0,409,0,6
74797,2,2413,2316,97,0,253,0,6
74798,2,2608,2540,68,0,1,0,6
74799,1,2272,2449,-177,0,133,0,6
74800,2,2335,2417,-82,0,46,0,6
74801,2,2410,2509,-99,0,145,0,6
74802,1,2547,2333,214,0,112,0,6
74803,3,2475,2473,2,0,41,0,6
74804,1,2528,2646,-118,0,45,0,6
74805,2,2582,2289,293,0,0,0,6
74806,2,2359,2544,-185,0,123,0,6
74807,1,2488,2252,236,0,1,0,6
74808,1,2665,2510,155,0,20,0,6
74809,1,2336,2449,-113,0,0,0,6
74810,2,2834,2539,295,0,302,0,6
74811,1,2390,2468,-78,0,40,0,6
74812,1,2430,2442,-12,0,57,0,6
74813,2,2554,2462,92,0,140,0,6
74814,2,2448,2377,71,0,46,0,6
74815,2,2471,2448,23,0,200,0,6
74816,2,2354,2466,-112,0,112,0,6
74817,2,2516,2494,22,0,135,0,6
74818,3,2494,2448,46,0,7,0,6
74819,1,2489,2429,60,0,404,0,6
74820,2,2298,2418,-120,0,112,0,6
74821,2,2472,2516,-44,0,343,0,6
74822,2,2451,2323,128,0,257,0,6
74823,2,2291,2434,-143,0,210,0,6
74824,2,2331,2535,-204,0,400,0,6
74825,2,2364,2687,-323,0,106,0,6
74826,3,2514,2303,211,0,141,0,6
74827,2,2248,2508,-260,0,121,0,6
74828,3,2488,2571,-83,0,113,0,6
74829,2,2523,2541,-18,0,6,0,6
74830,2,2306,2481,-175,0,300,0,6
74831,2,2317,2417,-100,0,369,0,6
74832,1,2362,2410,-48,0,45,0,6
74833,1,2548,2298,250,0,19,0,6
74834,3,2384,2493,-109,0,179,0,6
74835,1,2348,2441,-93,0,110,0,6
74836,3,2497,2599,-102,0,210,0,6
74837,1,2315,2485,-170,0,200,0,6
74838,1,2435,2327,108,0,101,0,6
74839,2,2446,2477,-31,0,110,0,6
74840,2,2394,2519,-125,0,4,0,6
74841,3,2445,2374,71,0,61,0,6
74842,1,2303,2415,-112,0,156,1,6
74843,3,2294,2485,-191,0,120,0,6
74844,2,2475,2512,-37,0,218,0,6
74845,2,2437,2459,-22,0,321,0,6
74846,1,2544,2554,-10,0,311,0,6
74847,2,2429,2448,-19,0,133,0,6
74848,1,2299,2405,-106,0,43,0,6
74849,1,2521,2539,-18,0,245,1,6
74850,2,2496,2534,-38,0,463,0,6
74851,2,2584,2625,-41,0,326,0,6
74852,2,2564,2381,183,0,394,0,6
74853,2,2348,2557,-209,0,338,0,6
74854,2,2368,2484,-116,0,5,0,6
74855,2,2840,2667,173,0,112,0,6
74856,2,2584,2704,-120,0,338,0,6
74857,2,2222,2517,-295,0,112,0,6
74858,2,2338,2503,-165,0,31,0,6
74859,2,2390,2436,-46,0,426,0,6
74860,1,2563,2350,213,0,132,0,6
74861,2,2475,2266,209,0,426,1,6
74862,3,2596,2654,-58,0,483,0,6
74863,1,2311,2437,-126,0,0,1,8
74864,2,2237,2485,-248,0,101,0,6
74865,1,2447,2272,175,0,125,0,6
74866,3,2211,2484,-273,0,130,0,6
74867,2,2435,2365,70,0,4,0,6
74868,2,2332,2412,-80,0,11,0,6
74869,1,2424,2323,101,0,120,0,8
74870,3,2235,2409,-174,0,306,0,8
74871,2,2401,2262,139,0,115,0,6
74872,1,2414,2315,99,0,0,0,6
74873,1,2404,2349,55,0,57,0,6
74874,2,2498,2518,-20,0,45,0,6
74875,1,2457,2369,88,0,4,0,6
74876,1,2468,2384,84,0,45,0,6
74877,1,2515,2230,285,0,302,0,6
74878,1,2481,2408,73,0,127,1,6
74879,1,2385,2559,-174,0,300,0,6
74880,1,2511,2564,-53,0,191,0,6
74881,2,2306,2550,-244,0,301,1,6
74882,3,2430,2258,172,0,80,0,6
74883,1,2416,2274,142,0,151,0,6
74884,2,2414,2504,-90,0,302,0,6
74885,1,2403,2430,-27,0,125,0,6
74886,2,2549,2371,178,0,411,0,6
74887,1,2472,2358,114,0,29,1,6
74888,2,2265,2467,-202,0,100,0,8
74889,2,2437,2373,64,0,244,0,6
74890,1,2654,2510,144,0,5,1,6
74891,1,2582,2421,161,0,40,0,6
74892,1,2407,2488,-81,0,250,0,6
74893,1,2464,2431,33,0,245,0,6
74894,1,2425,2469,-44,0,103,0,6
74895,1,2595,2251,344,0,302,0,6
74896,1,2451,2320,131,0,0,0,6
74897,2,2271,2506,-235,0,34,0,6
74898,2,2306,2493,-187,0,301,0,6
74899,2,2340,2452,-112,0,330,0,6
74900,2,2344,2472,-128,0,8,0,6
74901,1,2402,2298,104,0,127,0,6
74902,2,2323,2414,-91,0,203,0,6
74903,1,2420,2302,118,0,300,1,6
74904,3,2422,2408,14,0,40,0,6
74905,1,2495,2422,73,0,120,0,6
74906,3,2607,2572,35,0,345,0,6
74907,1,2445,2540,-95,0,242,1,6
74908,1,2414,2445,-31,0,124,0,6
74910,2,2316,2430,-114,0,300,0,6
74911,2,2484,2300,184,0,108,0,6
74912,1,2549,2497,52,0,240,0,6
74913,1,2317,2824,-507,0,492,0,6
74914,2,2215,2525,-310,0,317,0,6
74915,2,2400,2415,-15,0,132,0,6
74916,1,2377,2500,-123,0,25,0,6
74917,2,2410,2391,19,0,46,0,6
74918,1,2271,2411,-140,0,174,0,6
74919,1,2483,2424,59,0,49,0,6
74920,2,2340,2469,-129,0,245,0,6
74921,1,2484,2573,-89,0,40,0,6
74922,1,2526,2550,-24,0,40,0,6
74923,3,2447,2466,-19,0,7,0,6
74924,2,2443,2429,14,0,110,0,6
74925,2,2493,2405,88,0,4,0,6
74926,2,2437,2513,-76,0,150,0,6
74927,2,2260,2419,-159,0,46,0,6
74928,1,2453,2463,-10,0,303,0,6
74929,1,2442,2388,54,0,111,0,6
74930,2,2302,2430,-128,0,202,0,6
74931,2,2455,2502,-47,0,107,0,6
74932,2,2537,2344,193,0,314,0,6
74933,2,2321,2451,-130,4,170,1,13
74934,3,2516,2433,83,0,258,0,6
74935,2,2458,2304,154,0,120,0,6
74936,2,2424,2365,59,0,301,0,6
74937,2,2314,2430,-116,0,4,0,6
74938,1,2412,2401,11,0,102,0,6
74939,2,2342,2409,-67,0,109,0,6
74940,1,2419,2270,149,0,112,0,6
74941,3,2462,2205,257,0,106,0,6
74942,2,2230,2450,-220,0,40,1,6
74943,2,2387,2472,-85,0,427,0,6
74944,2,2278,2520,-242,0,83,0,6
74945,1,2433,2260,173,0,122,0,6
74946,1,2499,2332,167,0,103,0,6
74949,2,2510,2329,181,0,191,0,6
74950,1,2415,2319,96,0,106,0,6
74951,1,2485,2289,196,0,70,0,6
74952,2,2364,2422,-58,0,454,0,6
74953,1,2653,2484,169,0,167,0,6
74954,2,2490,2517,-27,0,201,0,6
74955,3,2363,2408,-45,0,123,0,6
74956,1,2527,2240,287,0,122,0,6
74957,1,2460,2556,-96,0,288,0,6
74958,1,2514,2277,237,0,261,0,6
74959,2,2465,2499,-34,0,110,0,6
74960,3,2420,2393,27,0,210,0,6
74961,2,2433,2412,21,0,101,0,6
74962,1,2551,2455,96,0,380,0,6
74963,2,2548,2550,-2,0,133,1,6
74964,2,2432,2387,45,0,453,1,6
74965,1,2569,2517,52,0,20,1,6
74966,3,2550,2394,156,0,409,0,6
74967,1,2492,2418,74,0,110,0,6
74968,2,2689,2554,135,0,255,0,6
74969,1,2470,2350,120,0,30,0,6
74970,3,2260,2540,-280,0,404,0,6
74971,2,2420,2395,25,0,46,1,6
74972,1,2487,2309,178,0,140,0,6
74973,1,2526,2602,-76,0,200,0,6
74974,3,2200,2528,-328,0,208,0,6
74975,1,2420,2320,100,0,1,0,6
74976,2,2577,2547,30,0,115,0,6
74977,2,2278,2687,-409,0,302,0,6
74978,1,2435,2460,-25,0,148,0,6
74979,1,2608,2375,233,0,335,0,6
74980,3,2564,2439,125,0,46,0,6
74981,1,2423,2243,180,0,356,0,6
74982,1,2486,2391,95,0,122,0,6
74983,1,2523,2443,80,0,228,0,6
74984,2,2255,2507,-252,0,45,0,6
74985,1,2677,2366,311,0,106,0,6
74986,1,2396,2400,-4,0,122,0,6
74987,2,2439,2267,172,0,107,0,6
74988,1,2556,2275,281,2,153,0,25
74989,1,2455,2469,-14,0,241,0,6
74990,2,2596,2547,49,0,122,0,6
74991,2,2477,2395,82,0,339,1,6
74992,3,2390,2418,-28,0,106,0,6
74993,2,2337,2687,-350,0,278,0,6
74994,1,2322,2556,-234,0,301,0,6
74995,1,2562,2336,226,0,0,0,6
74996,3,2602,2487,115,0,250,0,6
74997,1,2479,2424,55,0,57,0,6
74998,1,2491,2499,-8,0,113,0,6
74999,3,2445,2472,-27,0,210,0,6
75000,2,2462,2442,20,0,45,0,6
75001,3,2502,2585,-83,0,362,0,6
75002,2,2418,2410,8,0,130,1,6
75003,2,2211,2443,-232,0,251,0,6
75004,1,2526,2532,-6,0,330,1,6
75005,1,2434,2310,124,0,10,1,6
75006,2,2267,2473,-206,0,106,0,6
75007,1,2552,2231,321,0,255,1,6
75008,2,2522,2533,-11,0,308,0,6
75009,1,2537,2467,70,0,40,0,6
75010,1,2444,2270,174,0,456,1,6
75011,2,2595,2403,192,0,1,0,6
75012,3,2330,2514,-184,0,240,0,6
75013,1,2485,2596,-111,0,162,1,6
75014,1,2496,2517,-21,0,491,0,6
75015,1,2547,2388,159,0,161,0,6
75016,1,2557,2617,-60,0,241,0,6
75017,2,2636,2419,217,0,341,0,6
75018,3,2474,2445,29,0,345,0,6
75019,1,2323,2434,-111,0,201,0,6
75020,1,2463,2286,177,0,460,0,6
75021,1,2813,2273,540,0,123,0,6
75022,1,2507,2298,209,0,253,0,6
75023,1,2618,2214,404,0,40,0,6
75024,2,2370,2434,-64,0,244,0,6
75025,3,2347,2414,-67,0,245,0,6
75026,2,2488,2441,47,0,4,1,6
75027,2,2401,2335,66,0,36,0,6
75028,1,2507,2450,57,0,100,1,6
75029,3,2314,2476,-162,0,40,0,6
75030,2,2269,2573,-304,0,218,0,6
75031,1,2248,2451,-203,0,41,1,6
75032,1,2547,2490,57,0,106,0,6
75033,3,2331,2410,-79,0,460,0,6
75034,2,2587,2303,284,0,40,1,6
75035,3,2443,2582,-139,0,403,0,6
75036,1,2411,2381,30,0,453,0,6
75037,2,2493,2589,-96,0,115,0,6
75038,2,2376,2527,-151,0,229,0,6
75039,2,2505,2377,128,0,205,0,6
75040,1,2410,2424,-14,0,7,0,6
75041,1,2675,2333,342,0,154,0,6
75042,2,2395,2831,-436,0,110,0,6
75043,1,2492,2338,154,0,112,0,6
75044,2,2387,2616,-229,0,49,0,6
75045,1,2566,2522,44,0,0,0,6
75046,2,2441,2372,69,0,454,0,6
75047,2,2413,2295,118,4,107,0,13
75048,1,2517,2433,84,0,128,0,6
75049,1,2424,2385,39,0,191,0,6
75050,3,2352,2401,-49,0,394,0,6
75051,3,2221,2470,-249,0,455,0,8
75052,1,2401,2387,14,0,130,1,6
75053,1,2441,2328,113,0,211,0,6
75054,2,2712,2681,31,0,41,0,6
75055,2,2415,2683,-268,0,112,0,6
75056,2,2364,2519,-155,0,0,0,6
75057,2,2592,2453,139,0,250,0,6
75058,1,2562,2462,100,0,246,0,6
75059,2,2458,2359,99,0,46,1,6
75060,2,2429,2454,-25,0,111,0,6
75062,2,2524,2390,134,0,49,0,6
75063,1,2548,2467,81,0,150,0,6
75064,2,2509,2541,-32,0,326,0,6
75065,1,2466,2261,205,0,337,0,6
75066,1,2688,2528,160,0,7,0,6
75067,2,2450,2336,114,0,113,1,6
75068,1,2537,2383,154,0,45,0,6
75069,3,2555,2466,89,0,57,0,6
75070,1,2473,2304,169,0,126,1,6
75071,3,2426,2469,-43,0,398,0,6
75073,1,2527,2341,186,0,113,0,6
75074,3,2375,2469,-94,0,0,0,6
75075,2,2431,2314,117,0,154,0,6
75076,2,2402,2334,68,0,5,0,6
75077,1,2235,2431,-196,0,106,0,6
75078,1,2423,2427,-4,0,148,1,6
75079,1,2380,2422,-42,0,210,0,6
75080,2,2422,2313,109,0,8,0,6
75081,2,2417,2404,13,0,45,1,6
75082,1,2323,2444,-121,0,192,0,6
75083,1,2499,2387,112,0,8,0,6
75084,1,2597,2571,26,0,320,0,6
75085,2,2220,2462,-242,0,478,0,8
75086,1,2400,2297,103,0,269,0,8
75087,2,2269,2556,-287,0,15,0,6
75089,1,2264,2445,-181,0,43,0,6
75090,1,2270,2436,-166,0,341,0,6
75091,1,2403,2264,139,0,8,0,6
75092,2,2539,2368,171,0,40,0,6
75093,1,2397,2491,-94,0,260,0,6
75094,2,2420,2430,-10,0,125,1,6
75095,3,2580,2658,-78,0,40,0,6
75096,1,2507,2363,144,0,40,0,6
75097,2,2240,2532,-292,0,8,0,6
75098,2,2413,2327,86,0,71,0,6
75099,2,2201,2511,-310,0,122,0,6
75100,3,2342,2411,-69,0,45,0,6
75101,1,2482,2465,17,0,125,0,6
75102,1,2470,2215,255,0,107,0,6
75103,1,2444,2256,188,0,302,0,6
75104,2,2454,2465,-11,0,115,0,6
75105,1,2570,2531,39,0,140,0,6
75106,3,2421,2500,-79,0,100,0,6
75107,2,2456,2337,119,0,300,1,6
75108,1,2437,2303,134,0,25,0,6
75109,1,2493,2276,217,0,300,0,6
75110,1,2523,2416,107,0,107,0,6
75111,1,2418,2316,102,0,118,0,6
75112,2,2400,2336,64,0,120,0,6
75113,2,2832,2814,18,0,462,0,6
75114,1,2687,2710,-23,0,106,0,6
75115,1,2401,2414,-13,0,4,1,6
75116,1,2406,2380,26,0,311,0,8
75117,1,2434,2206,228,0,337,0,6
75118,2,2240,2482,-242,0,330,0,6
75119,1,2416,2334,82,0,7,1,8
75120,2,2386,2606,-220,0,21,0,6
75121,2,2284,2455,-171,0,120,0,6
75122,2,2418,2264,154,0,122,0,6
75123,1,2265,2586,-321,0,40,0,6
75124,2,2427,2431,-4,0,177,0,6
75125,3,2304,2481,-177,0,459,0,6
75126,1,2473,2459,14,0,45,0,6
75127,3,2453,2656,-203,0,172,0,6
75128,1,2547,2385,162,0,453,0,6
75129,1,2414,2331,83,0,45,0,6
75130,1,2327,2571,-244,0,100,0,6
75131,3,2473,2406,67,0,107,0,6
75132,1,2517,2314,203,0,110,0,6
75133,2,2514,2475,39,0,0,0,6
75134,2,2450,2418,32,0,120,0,6
75136,2,2468,2412,56,0,345,0,6
75137,1,2416,2513,-97,0,45,0,6
75138,1,2513,2347,166,0,245,0,6
75139,1,2485,2234,251,0,28,0,6
75140,2,2400,2310,90,0,330,0,6
75141,3,2447,2327,120,0,4,0,6
75142,1,2490,2322,168,0,302,0,6
75143,1,2508,2306,202,0,51,0,6
75144,2,2269,2509,-240,0,33,0,6
75145,2,2413,2481,-68,0,5,0,6
75146,1,2509,2569,-60,0,315,1,6
75148,1,2415,2237,178,0,25,0,6
75149,2,2329,2493,-164,0,45,0,6
75150,2,2423,2579,-156,0,65,0,6
75151,2,2289,2501,-212,0,255,0,6
75152,2,2272,2416,-144,0,405,0,6
75153,2,2463,2555,-92,0,46,1,6
75154,1,2393,2443,-50,0,106,0,6
75155,1,2315,2564,-249,0,123,0,6
75156,1,2610,2323,287,0,41,0,6
75157,1,2537,2264,273,0,130,0,6
75158,2,2468,2380,88,0,190,1,6
75159,1,2202,2523,-321,0,122,0,6
75160,2,2309,2429,-120,0,106,0,6
75161,2,2485,2364,121,0,120,0,6
75162,1,2522,2408,114,0,456,0,6
75163,1,2456,2359,97,0,319,0,6
75164,2,2247,2406,-159,0,438,1,8
75165,1,2378,2453,-75,0,303,0,6
75166,2,2477,2502,-25,0,300,0,6
75167,2,2382,2522,-140,0,118,0,6
75168,1,2395,2440,-45,0,302,1,6
75169,1,2481,2343,138,0,1,0,6
75170,3,2523,2584,-61,0,40,0,6
75171,1,2700,2510,190,0,96,1,6
75172,1,2496,2361,135,0,106,0,6
75173,3,2352,2514,-162,0,95,0,6
75174,1,2435,2233,202,0,300,0,6
75175,2,2463,2553,-90,0,288,0,6
75176,1,2653,2472,181,0,210,0,6
75177,2,2537,2382,155,0,457,0,6
75178,2,2276,2446,-170,0,151,0,6
75179,3,2638,2284,354,0,140,0,6
75180,1,2597,2328,269,0,400,1,6
75181,1,2486,2406,80,0,1,0,6
75182,2,2334,2552,-218,0,42,0,6
75183,1,2570,2241,329,0,345,0,6
75184,3,2373,2484,-111,0,265,0,6
75185,3,2420,2400,20,0,132,0,6
75186,1,2422,2251,171,0,131,1,6
75187,2,2276,2455,-179,0,140,0,6
75188,1,2376,2422,-46,0,113,0,6
75189,2,2312,2403,-91,0,250,0,6
75190,1,2306,2438,-132,0,487,0,6
75191,3,2531,2441,90,0,201,0,6
75192,3,2328,2412,-84,0,40,0,6
75193,1,2687,2331,356,0,190,0,6
75194,2,2426,2677,-251,0,302,0,6
75195,1,2409,2332,77,0,10,0,6
75196,3,2416,2269,147,0,302,0,6
75197,2,2430,2334,96,0,133,0,8
75198,1,2408,2292,116,0,127,0,6
75199,2,2377,2574,-197,0,123,0,6
75200,1,2691,2531,160,0,49,0,6
75201,2,2512,2341,171,0,11,0,6
75202,2,2333,2428,-95,0,335,0,6
75203,1,2454,2314,140,0,57,0,6
75204,1,2372,2428,-56,0,245,0,8
75205,2,2470,2346,124,0,300,0,6
75206,2,2437,2483,-46,0,310,0,6
75207,2,2240,2420,-180,0,143,0,6
75208,1,2456,2357,99,0,303,0,6
75209,3,2396,2566,-170,0,43,0,6
75210,2,2458,2575,-117,0,13,0,6
75211,1,2375,2400,-25,0,140,0,6
75212,1,2357,2435,-78,0,145,0,6
75213,2,2257,2419,-162,0,142,0,6
75214,1,2553,2463,90,0,112,0,6
75215,1,2412,2542,-130,0,307,0,6
75216,3,2576,2445,131,0,388,0,6
75217,1,2522,2446,76,0,254,0,6
75218,1,2506,2286,220,0,40,0,6
75219,2,2203,2424,-221,0,150,0,6
75220,2,2324,2550,-226,0,122,0,6
75221,2,2250,2476,-226,0,106,0,6
75222,2,2411,2273,138,0,403,1,6
75223,2,2284,2495,-211,0,49,0,6
75224,3,2262,2427,-165,0,48,0,6
75225,1,2433,2475,-42,0,211,0,6
75226,2,2370,2466,-96,0,11,0,6
75227,1,2575,2262,313,0,244,0,6
75228,3,2348,2529,-181,0,122,0,6
75229,1,2491,2443,48,0,244,0,6
75230,1,2589,2529,60,0,57,0,6
75231,1,2276,2413,-137,0,307,1,6
75232,2,2690,2584,106,0,311,1,6
75233,1,2464,2286,178,0,13,0,6
75234,1,2215,2425,-210,0,241,0,6
75235,2,2258,2427,-169,0,248,0,6
75236,2,2347,2469,-122,0,160,0,6
75237,1,2353,2447,-94,0,301,1,6
75238,1,2541,2229,312,0,246,0,6
75239,2,2583,2351,232,0,445,0,6
75240,1,2221,2420,-199,0,106,0,6
75241,2,2463,2362,101,0,4,0,6
75242,3,2408,2519,-111,0,58,0,6
75243,3,2552,2336,216,0,106,0,6
75244,1,2619,2562,57,0,14,0,6
75245,2,2282,2540,-258,0,0,0,6
75246,1,2555,2422,133,0,125,0,6
75247,1,2259,2462,-203,0,45,0,6
75248,1,2526,2733,-207,0,122,1,6
75249,2,2307,2478,-171,0,45,0,6
75250,1,2215,2442,-227,0,241,0,6
75251,2,2417,2682,-265,0,21,0,6
75252,1,2253,2421,-168,0,48,0,6
75253,2,2335,2499,-164,0,185,1,6
75254,1,2452,2516,-64,0,265,0,6
75255,1,2496,2336,160,0,301,0,6
75256,1,2418,2279,139,0,0,0,6
75257,3,2534,2695,-161,0,255,0,6
75258,2,2394,2440,-46,0,190,0,6
75259,3,2688,2577,111,0,215,0,6
75260,2,2528,2273,255,0,302,0,6
75261,1,2460,2260,200,0,404,0,6
75262,2,2477,2419,58,0,205,0,6
75263,1,2563,2378,185,0,16,0,6
75264,1,2454,2504,-50,0,256,0,6
75265,1,2565,2269,296,0,200,0,6
75266,1,2326,2603,-277,0,365,1,6
75267,2,2546,2428,118,0,7,0,6
75268,2,2703,2694,9,0,257,0,6
75269,1,2414,2362,52,0,7,0,6
75270,1,2826,2500,326,0,240,1,6
75271,1,2583,2472,111,0,304,0,6
75272,1,2820,2524,296,0,112,1,6
75273,2,2372,2438,-66,0,211,0,6
75274,2,2462,2516,-54,0,415,0,6
75275,2,2263,2485,-222,0,245,0,6
75276,2,2249,2411,-162,0,165,0,6
75277,1,2490,2359,131,0,4,1,6
75278,1,2497,2370,127,0,41,0,6
75279,3,2314,2427,-113,0,119,0,6
75280,3,2566,2445,121,0,0,0,6
75281,1,2484,2409,75,0,1,0,6
75282,1,2486,2581,-95,0,40,0,6
75283,1,2657,2512,145,0,1,0,6
75284,1,2579,2390,189,0,1,0,6
75285,3,2374,2402,-28,0,123,0,6
75286,3,2422,2445,-23,0,0,0,6
75287,1,2434,2352,82,0,29,0,6
75288,1,2446,2231,215,0,311,0,6
75289,2,2349,2504,-155,0,426,0,6
75290,1,2276,2577,-301,0,123,1,6
75291,1,2505,2503,2,0,40,0,6
75292,1,2489,2460,29,0,36,0,6
75293,2,2408,2407,1,0,40,0,6
75294,1,2234,2410,-176,0,341,0,6
75295,1,2557,2458,99,0,150,0,6
75296,2,2410,2484,-74,0,211,0,6
75297,2,2508,2383,125,0,110,0,8
75298,2,2224,2448,-224,0,0,0,6
75299,2,2210,2432,-222,0,220,0,6
75300,1,2382,2411,-29,0,253,0,6
75301,2,2563,2510,53,0,246,0,6
75302,1,2582,2445,137,0,100,0,6
75303,1,2308,2443,-135,0,246,0,6
75304,2,2282,2400,-118,0,330,0,6
75305,1,2495,2286,209,0,233,0,6
75306,1,2589,2287,302,0,392,0,6
75307,2,2504,2579,-75,0,207,0,6
75308,1,2404,2278,126,0,153,0,6
75309,3,2692,2687,5,0,46,0,6
75310,1,2483,2536,-53,0,31,1,6
75311,2,2428,2350,78,0,122,0,6
75312,1,2435,2497,-62,0,42,0,6
75313,2,2414,2490,-76,0,102,0,6
75314,1,2548,2305,243,0,210,0,6
75315,1,2420,2343,77,0,5,0,6
75316,2,2437,2444,-7,0,310,0,6
75317,1,2400,2382,18,0,111,1,6
75318,3,2679,2280,399,0,154,0,6
75319,3,2357,2420,-63,0,0,0,6
75320,2,2442,2310,132,0,56,0,6
75321,1,2422,2221,201,0,150,1,8
75322,3,2445,2463,-18,0,302,0,6
75323,1,2492,2221,271,0,241,0,6
75324,2,2320,2410,-90,0,135,0,6
75325,1,2593,2570,23,0,345,0,6
75326,3,2438,2525,-87,0,45,0,6
75327,1,2564,2567,-3,0,122,0,6
75328,1,2447,2298,149,0,4,0,6
75329,2,2411,2530,-119,0,70,0,6
75330,1,2619,2396,223,0,221,0,6
75331,1,2502,2547,-45,0,310,0,6
75332,2,2216,2451,-235,0,0,0,6
75333,1,2526,2405,121,0,145,0,6
75334,2,2407,2610,-203,0,168,0,6
75335,1,2419,2261,158,0,109,1,6
75336,1,2441,2467,-26,0,190,0,6
75337,1,2411,2402,9,0,151,0,6
75338,1,2452,2458,-6,0,92,0,6
75339,1,2428,2323,105,0,50,0,6
75340,2,2424,2363,61,0,325,1,6
75341,2,2304,2420,-116,0,45,0,6
75342,2,2366,2444,-78,0,242,0,6
75343,2,2329,2413,-84,0,4,0,6
75344,1,2425,2423,2,0,202,0,6
75345,3,2203,2423,-220,0,110,0,6
75346,3,2517,2511,6,0,310,0,6
75347,1,2402,2205,197,0,109,0,6
75348,2,2229,2539,-310,0,416,0,6
75349,1,2260,2539,-279,0,10,0,6
75350,1,2434,2327,107,0,115,0,6
75351,1,2445,2422,23,0,107,1,6
75352,2,2445,2550,-105,0,43,0,6
75353,1,2382,2412,-30,0,460,0,6
75354,2,2424,2376,48,0,48,0,6
75355,1,2439,2236,203,0,145,0,6
75357,1,2465,2316,149,0,206,0,6
75358,2,2413,2359,54,0,130,0,6
75359,1,2329,2445,-116,0,414,0,6
75360,2,2525,2623,-98,0,45,0,6
75361,2,2418,2691,-273,0,0,0,6
75362,1,2557,2327,230,0,0,0,6
75363,2,2387,2461,-74,0,70,0,6
75364,1,2468,2375,93,0,247,1,6
75365,3,2435,2309,126,0,112,0,6
75366,2,2420,2526,-106,0,409,0,6
75367,1,2534,2368,166,0,300,0,6
75368,3,2404,2447,-43,0,110,0,6
75369,2,2447,2358,89,0,101,0,6
75370,2,2204,2574,-370,0,205,0,6
75371,1,2419,2264,155,0,199,0,6
75372,1,2490,2210,280,0,201,0,6
75373,1,2469,2427,42,0,245,0,6
75374,2,2354,2457,-103,0,200,1,6
75375,3,2527,2235,292,0,101,0,6
75376,3,2394,2553,-159,0,151,0,6
75377,3,2228,2406,-178,0,172,0,6
75378,2,2252,2448,-196,0,112,0,6
75379,1,2516,2354,162,0,125,0,6
75380,2,2622,2489,133,0,121,0,6
75381,3,2556,2360,196,0,260,0,6
75382,1,2318,2429,-111,0,200,0,6
75383,1,2441,2288,153,0,302,0,6
75384,1,2562,2308,254,0,140,0,6
75385,1,2416,2374,42,0,201,0,6
75386,2,2432,2406,26,0,9,0,6
75387,2,2235,2460,-225,0,331,0,6
75388,3,2234,2412,-178,0,115,0,6
75389,1,2572,2279,293,0,84,0,6
75390,2,2257,2706,-449,0,45,0,6
75391,2,2494,2653,-159,0,49,0,6
75392,3,2541,2377,164,0,46,0,6
75393,2,2384,2468,-84,0,313,0,6
75394,2,2347,2509,-162,0,11,0,6
75395,1,2268,2534,-266,0,31,1,6
75396,1,2475,2383,92,0,4,0,6
75397,1,2579,2463,116,0,207,0,6
75398,1,2424,2388,36,0,41,0,6
75399,2,2389,2476,-87,0,278,0,6
75400,1,2432,2225,207,0,485,0,6
75401,2,2468,2376,92,0,307,0,6
75402,2,2423,2265,158,0,102,0,6
75403,3,2428,2554,-126,0,154,0,6
75404,1,2499,2391,108,0,120,0,6
75405,2,2454,2620,-166,0,123,0,6
75406,1,2450,2431,19,0,58,0,6
75407,1,2689,2574,115,0,200,0,6
75408,2,2366,2497,-131,0,490,1,6
75409,1,2444,2402,42,0,43,0,6
75410,1,2454,2561,-107,0,288,1,6
75411,1,2467,2291,176,0,277,0,8
75412,2,2539,2594,-55,0,5,0,6
75413,2,2245,2473,-228,0,130,0,6
75414,2,2582,2375,207,0,1,0,6
75415,1,2401,2387,14,0,302,0,6
75416,2,2403,2494,-91,0,10,0,6
75417,2,2435,2634,-199,0,113,0,6
75418,1,2558,2321,237,0,107,0,6
75419,1,2444,2331,113,0,111,0,6
75420,2,2493,2326,167,0,100,0,6
75421,1,2363,2465,-102,0,102,0,6
75422,1,2482,2612,-130,0,41,0,6
75423,1,2461,2205,256,0,58,0,6
75424,1,2458,2301,157,0,190,0,6
75425,2,2338,2612,-274,0,43,0,6
75426,2,2307,2463,-156,0,0,0,6
75427,1,2512,2232,280,0,201,0,6
75428,1,2453,2307,146,0,48,0,6
75429,2,2262,2407,-145,0,47,0,6
75430,2,2312,2624,-312,0,320,0,6
75431,2,2303,2543,-240,0,136,0,6
75432,2,2446,2273,173,0,320,1,6
75433,1,2471,2448,23,0,200,1,6
75434,1,2540,2305,235,0,190,0,6
75435,2,2360,2421,-61,0,12,0,6
75436,2,2472,2418,54,0,300,0,6
75437,2,2357,2574,-217,0,45,0,6
75438,1,2268,2411,-143,0,250,0,6
75439,2,2567,2576,-9,0,202,0,6
75440,2,2384,2449,-65,0,0,0,6
75441,3,2522,2666,-144,0,311,0,6
75442,2,2591,2822,-231,0,110,0,6
75443,1,2365,2417,-52,0,385,0,6
75444,1,2406,2413,-7,0,211,1,6
75445,2,2404,2354,50,0,7,0,6
75446,1,2405,2270,135,0,241,0,6
75447,2,2392,2571,-179,0,46,0,6
75448,1,2468,2242,226,0,46,0,6
75449,1,2448,2265,183,0,225,0,6
75450,1,2451,2315,136,0,127,0,6
75451,2,2296,2423,-127,0,103,0,6
75452,2,2287,2418,-131,0,404,0,6
75453,2,2511,2375,136,0,190,0,6
75454,3,2517,2420,97,0,46,0,6
75455,1,2558,2528,30,0,101,0,6
75456,1,2459,2477,-18,0,302,0,6
75457,2,2356,2489,-133,0,350,0,6
75458,2,2707,2557,150,0,263,0,6
75459,2,2517,2828,-311,0,40,1,6
75460,1,2508,2418,90,0,219,0,6
75461,3,2511,2342,169,0,4,0,6
75462,1,2517,2444,73,0,246,0,6
75463,1,2410,2507,-97,0,80,0,6
75464,2,2306,2422,-116,0,123,0,6
75465,1,2523,2253,270,0,190,0,6
75466,1,2440,2360,80,0,100,0,6
75467,1,2615,2226,389,0,106,0,6
75468,1,2449,2303,146,0,110,0,6
75469,1,2254,2431,-177,0,269,0,6
75470,1,2459,2660,-201,0,40,0,6
75471,1,2397,2508,-111,0,150,0,6
75472,1,2448,2358,90,0,263,0,6
75473,1,2417,2417,0,0,40,1,6
75474,1,2327,2443,-116,0,208,1,6
75475,1,2593,2331,262,0,308,0,6
75476,1,2514,2473,41,0,484,0,6
75477,2,2366,2407,-41,0,104,1,6
75478,1,2519,2498,21,0,302,0,6
75479,2,2282,2499,-217,0,307,0,6
75480,2,2396,2408,-12,0,101,0,6
75481,1,2344,2427,-83,0,120,0,6
75482,3,2384,2558,-174,0,49,0,6
75483,1,2283,2407,-124,0,242,0,6
75484,2,2550,2275,275,0,167,1,6
75485,2,2244,2484,-240,0,113,0,6
75486,1,2419,2500,-81,0,49,0,6
75487,2,2460,2459,1,0,244,0,6
75488,1,2436,2594,-158,0,150,0,6
75489,2,2405,2432,-27,0,144,0,6
75490,2,2248,2566,-318,0,112,0,6
75491,1,2270,2423,-153,0,4,0,6
75492,1,2587,2495,92,0,46,0,6
75493,1,2463,2489,-26,0,141,0,6
75494,1,2285,2404,-119,0,48,0,6
75495,1,2566,2389,177,0,16,0,6
75496,2,2376,2478,-102,0,127,0,6
75497,1,2671,2700,-29,0,223,0,6
75498,1,2263,2411,-148,4,245,0,13
75499,1,2497,2518,-21,0,4,0,6
75500,3,2300,2416,-116,0,80,0,6
75501,2,2280,2488,-208,0,302,0,6
75502,1,2487,2354,133,0,16,0,6
75503,3,2490,2614,-124,0,327,0,6
75504,1,2497,2530,-33,0,31,0,6
75505,2,2200,2448,-248,0,100,0,6
75506,2,2375,2525,-150,0,255,1,6
75507,1,2455,2438,17,0,15,0,6
75508,2,2253,2724,-471,0,40,0,6
75509,3,2459,2583,-124,0,300,0,6
75510,2,2444,2573,-129,0,112,0,6
75511,3,2674,2692,-18,0,45,0,6
75512,2,2453,2350,103,0,242,0,6
75513,3,2466,2390,76,0,107,0,6
75514,2,2287,2421,-134,0,16,0,6
75515,2,2222,2507,-285,0,49,0,6
75516,1,2475,2322,153,0,115,0,6
75517,1,2238,2426,-188,0,119,0,6
75518,2,2414,2579,-165,0,49,0,6
75519,3,2319,2539,-220,0,302,0,6
75520,2,2383,2405,-22,0,380,0,6
75521,2,2268,2543,-275,0,0,0,6
75522,2,2491,2407,84,0,106,0,6
75523,1,2534,2524,10,0,244,0,6
75524,2,2229,2526,-297,0,113,0,6
75525,1,2390,2425,-35,0,200,0,6
75526,1,2824,2565,259,0,4,0,6
75527,1,2589,2519,70,0,150,0,6
75528,1,2498,2363,135,0,256,0,6
75529,1,2549,2281,268,0,133,0,6
75530,2,2418,2498,-80,0,48,0,6
75531,3,2451,2310,141,0,90,0,6
75532,2,2284,2614,-330,0,7,0,6
75533,3,2418,2413,5,0,343,0,6
75534,3,2601,2300,301,0,210,0,6
75535,2,2482,2489,-7,0,473,0,6
75536,1,2447,2463,-16,0,190,0,6
75537,1,2400,2329,71,0,210,1,6
75538,3,2297,2437,-140,0,108,0,6
75539,1,2407,2242,165,0,107,1,6
75540,1,2447,2319,128,0,87,0,6
75541,2,2383,2612,-229,0,124,0,6
75542,1,2507,2383,124,0,11,0,6
75543,1,2692,2574,118,0,302,0,6
75544,1,2687,2492,195,0,453,0,6
75545,1,2455,2339,116,0,123,0,6
75546,2,2422,2401,21,0,101,0,6
75547,1,2443,2268,175,0,167,0,6
75548,1,2470,2260,210,0,125,0,6
75549,2,2366,2656,-290,0,5,1,6
75550,2,2469,2387,82,0,440,0,6
75551,1,2637,2382,255,0,255,0,6
75552,1,2559,2381,178,0,0,0,6
75553,1,2481,2325,156,0,207,0,6
75554,3,2503,2383,120,0,101,0,6
75555,1,2425,2256,169,0,335,0,6
75556,1,2492,2248,244,0,45,0,6
75557,2,2342,2494,-152,0,285,0,6
75558,1,2454,2426,28,0,151,0,6
75559,2,2530,2535,-5,0,133,1,6
75560,1,2504,2204,300,0,37,1,6
75561,2,2410,2258,152,0,311,1,6
75562,1,2510,2245,265,0,45,1,6
75563,2,2312,2465,-153,0,40,0,6
75564,1,2576,2570,6,0,337,0,6
75565,3,2567,2696,-129,0,20,0,6
75566,1,2554,2354,200,0,41,0,6
75567,3,2406,2394,12,0,385,0,6
75568,2,2414,2441,-27,0,57,0,6
75569,2,2502,2477,25,0,122,0,6
75570,2,2355,2445,-90,0,4,0,6
75571,1,2509,2397,112,0,57,0,6
75572,2,2426,2426,0,0,111,0,6
75573,1,2486,2463,23,0,125,0,6
75574,1,2470,2222,248,0,112,0,6
75575,2,2203,2492,-289,0,7,0,6
75576,3,2479,2586,-107,0,40,0,6
75577,3,2595,2259,336,0,335,0,6
75578,2,2599,2534,65,0,326,0,6
75579,1,2530,2219,311,0,21,0,6
75580,2,2461,2455,6,0,300,0,6
75581,3,2375,2429,-54,0,246,0,6
75582,2,2320,2576,-256,0,212,0,6
75583,1,2523,2517,6,0,233,0,6
75584,1,2580,2212,368,0,405,0,6
75585,1,2438,2319,119,0,23,0,6
75586,2,2456,2404,52,0,46,0,6
75587,1,2417,2351,66,0,46,0,6
75588,1,2725,2451,274,0,210,0,6
75589,3,2380,2514,-134,0,240,0,6
75590,1,2417,2363,54,0,45,0,6
75591,3,2273,2405,-132,0,302,0,6
75592,2,2543,2613,-70,0,314,0,6
75593,1,2290,2415,-125,0,207,0,6
75595,3,2664,2241,423,0,45,0,6
75596,1,2404,2368,36,0,112,0,6
75597,1,2343,2450,-107,0,440,0,6
75598,1,2207,2418,-211,0,130,0,6
75599,2,2347,2425,-78,0,46,0,6
75600,2,2286,2616,-330,0,170,0,6
75601,2,2273,2441,-168,0,210,0,6
75602,1,2626,2387,239,0,210,0,6
75603,1,2465,2460,5,0,202,0,6
75604,2,2419,2379,40,0,107,0,6
75605,2,2239,2594,-355,0,352,0,6
75606,1,2430,2389,41,0,260,0,6
75607,1,2396,2523,-127,0,227,0,6
75608,2,2465,2408,57,0,54,0,8
75609,1,2406,2410,-4,0,4,1,6
75610,2,2432,2344,88,0,315,1,6
75611,2,2353,2446,-93,0,150,1,6
75612,2,2400,2371,29,0,331,0,6
75613,2,2306,2403,-97,0,200,0,6
75614,2,2529,2247,282,0,225,1,6
75615,2,2353,2540,-187,0,245,0,6
75616,1,2254,2424,-170,0,123,0,6
75617,2,2554,2462,92,0,195,0,6
75618,2,2570,2490,80,0,45,0,6
75619,1,2693,2591,102,0,110,0,6
75620,1,2483,2340,143,0,1,1,6
75621,2,2383,2477,-94,0,225,0,6
75622,1,2468,2454,14,0,58,1,6
75623,2,2344,2490,-146,0,106,0,6
75624,2,2491,2442,49,0,13,0,6
75625,2,2424,2288,136,0,233,0,6
75626,1,2430,2284,146,0,15,0,6
75627,2,2410,2545,-135,0,112,0,6
75628,1,2426,2258,168,0,269,0,6
75629,1,2561,2378,183,0,112,0,6
75630,1,2252,2570,-318,0,241,0,6
75631,1,2328,2526,-198,0,58,1,6
75632,1,2615,2450,165,0,194,0,6
75633,3,2382,2417,-35,0,107,0,6
75634,2,2381,2407,-26,0,123,0,6
75635,1,2518,2286,232,0,300,0,6
75636,2,2397,2552,-155,0,110,0,6
75637,1,2334,2657,-323,0,487,1,6
75638,2,2292,2462,-170,0,48,0,6
75639,1,2474,2293,181,0,123,0,6
75640,2,2274,2551,-277,0,190,0,6
75641,1,2512,2230,282,0,132,0,6
75642,1,2504,2441,63,0,5,0,6
75643,2,2346,2524,-178,0,45,0,6
75644,1,2433,2403,30,0,45,1,6
75645,2,2350,2426,-76,0,265,0,6
75646,2,2314,2489,-175,0,343,0,6
75647,3,2422,2373,49,0,277,0,6
75648,1,2285,2452,-167,0,248,1,6
75649,1,2203,2440,-237,0,1,0,6
75650,2,2439,2274,165,0,300,1,6
75651,1,2659,2826,-167,0,22,0,6
75652,2,2563,2524,39,0,112,0,6
75653,1,2471,2461,10,0,1,0,6
75654,1,2401,2515,-114,0,241,0,6
75655,1,2499,2231,268,0,133,0,6
75656,2,2320,2404,-84,0,35,0,6
75657,2,2583,2454,129,0,40,0,6
75658,2,2268,2574,-306,0,241,0,6
75659,3,2522,2562,-40,0,100,0,6
75661,2,2383,2448,-65,0,45,1,6
75662,3,2356,2512,-156,0,302,0,6
75663,2,2361,2532,-171,0,300,1,6
75664,2,2555,2493,62,0,101,0,6
75665,1,2487,2407,80,0,201,0,6
75666,1,2411,2270,141,0,107,0,6
75667,2,2431,2515,-84,0,49,0,6
75668,1,2692,2651,41,0,484,0,6
75669,1,2830,2471,359,0,245,0,6
75670,2,2269,2491,-222,0,123,0,6
75671,1,2475,2291,184,0,38,0,6
75672,1,2531,2342,189,0,13,0,6
75673,2,2434,2570,-136,0,4,0,6
75674,1,2472,2291,181,0,455,0,6
75675,1,2201,2499,-298,0,108,0,6
75676,1,2437,2400,37,0,466,0,6
75677,1,2545,2495,50,0,143,0,6
75678,1,2412,2244,168,0,106,0,8
75679,1,2415,2493,-78,0,209,0,6
75680,1,2218,2431,-213,0,112,0,6
75681,2,2397,2415,-18,0,1,0,6
75682,2,2279,2477,-198,0,303,0,6
75683,2,2463,2298,165,0,250,0,6
75684,3,2548,2264,284,0,487,0,6
75685,2,2598,2611,-13,0,200,0,6
75686,2,2693,2556,137,0,373,0,6
75687,2,2381,2416,-35,0,15,0,6
75688,2,2435,2420,15,0,411,0,6
75689,3,2520,2333,187,0,45,0,6
75690,2,2431,2445,-14,0,157,0,6
75691,2,2422,2474,-52,0,40,0,6
75692,3,2499,2456,43,0,15,0,6
75693,1,2426,2254,172,0,112,0,6
75694,1,2524,2293,231,0,345,0,6
75695,2,2408,2444,-36,0,122,0,6
75696,2,2268,2425,-157,0,373,0,8
75697,2,2273,2566,-293,2,145,0,25
75698,2,2313,2479,-166,0,106,0,6
75699,2,2581,2588,-7,0,107,0,6
75700,1,2406,2532,-126,0,215,0,6
75701,2,2221,2597,-376,0,323,0,6
75702,2,2511,2355,156,0,31,0,6
75703,3,2417,2522,-105,0,58,0,6
75704,3,2600,2311,289,0,57,0,6
75705,1,2500,2562,-62,0,406,0,6
75706,1,2468,2352,116,0,136,0,6
75707,1,2493,2252,241,0,458,1,6
75708,2,2311,2549,-238,0,123,0,6
75709,3,2420,2390,30,0,180,0,6
75710,3,2338,2450,-112,0,300,0,6
75711,1,2497,2411,86,0,411,0,6
75712,2,2217,2407,-190,0,40,0,6
75713,2,2362,2464,-102,0,487,0,6
75714,3,2520,2241,279,0,106,0,6
75715,1,2446,2449,-3,0,320,0,6
75716,2,2541,2582,-41,0,268,0,6
75717,2,2252,2442,-190,0,353,1,6
75718,1,2414,2409,5,0,40,1,6
75719,1,2523,2251,272,0,200,0,6
75720,2,2564,2509,55,0,41,0,6
75721,1,2404,2373,31,0,200,0,6
75722,1,2356,2463,-107,0,7,0,6
75723,1,2586,2579,7,0,101,0,6
75724,1,2490,2477,13,0,41,0,6
75725,2,2306,2639,-333,0,344,0,6
75726,1,2628,2605,23,0,4,0,6
75727,1,2501,2565,-64,0,359,0,6
75728,1,2500,2415,85,0,106,0,6
75729,2,2563,2831,-268,0,411,0,6
75730,1,2548,2449,99,0,343,0,6
75731,2,2444,2541,-97,0,110,0,6
75732,1,2400,2300,100,0,310,0,6
75733,2,2216,2435,-219,0,288,1,6
75734,3,2616,2307,309,0,302,0,6
75735,3,2389,2422,-33,0,45,0,6
75736,1,2512,2412,100,0,337,0,6
75737,1,2413,2344,69,0,122,0,6
75738,2,2690,2540,150,0,302,0,6
75739,2,2310,2501,-191,0,27,0,6
75740,1,2519,2376,143,0,40,0,6
75741,1,2469,2514,-45,0,303,0,6
75742,1,2507,2594,-87,0,80,0,6
75743,3,2419,2453,-34,0,310,0,6
75744,2,2270,2416,-146,0,131,0,6
75745,1,2454,2543,-89,0,245,0,6
75746,2,2426,2484,-58,0,244,1,6
75747,1,2318,2460,-142,0,107,0,6
75748,2,2430,2379,51,0,100,0,6
75749,3,2420,2337,83,0,110,0,6
75750,3,2517,2434,83,0,203,0,6
75751,1,2457,2212,245,0,13,0,6
75752,2,2242,2454,-212,0,40,0,6
75753,2,2426,2409,17,0,380,0,6
75754,1,2509,2303,206,0,140,0,6
75755,3,2403,2358,45,0,2,0,6
75756,2,2364,2410,-46,0,331,1,6
75757,1,2443,2476,-33,0,115,1,6
75758,1,2566,2381,185,0,308,1,6
75759,1,2410,2362,48,0,302,1,8
75760,1,2420,2282,138,0,4,0,6
75761,2,2466,2684,-218,0,216,0,6
75762,1,2530,2289,241,0,46,0,6
75763,2,2440,2322,118,0,40,0,6
75764,2,2266,2433,-167,0,203,0,6
75765,3,2525,2390,135,0,296,0,6
75766,1,2315,2502,-187,0,301,0,6
75767,2,2339,2465,-126,0,140,0,6
75768,3,2425,2511,-86,0,36,0,6
75769,2,2408,2413,-5,0,101,0,6
75770,2,2351,2515,-164,0,301,0,6
75771,3,2424,2433,-9,0,46,0,6
75772,1,2561,2244,317,0,58,0,6
75773,1,2404,2333,71,0,123,0,6
75774,1,2395,2442,-47,0,247,0,6
75775,1,2417,2456,-39,0,216,1,6
75776,1,2489,2279,210,0,337,0,6
75777,2,2403,2320,83,0,83,0,6
75778,1,2483,2391,92,0,43,0,6
75779,3,2311,2527,-216,0,0,0,6
75780,3,2482,2250,232,0,40,0,6
75781,2,2404,2393,11,0,125,0,6
75782,2,2226,2582,-356,0,202,0,6
75783,1,2514,2562,-48,0,114,0,6
75784,1,2402,2461,-59,0,389,1,6
75785,1,2449,2262,187,0,311,1,6
75786,2,2556,2697,-141,0,246,0,6
75787,1,2647,2587,60,0,200,0,6
75788,2,2220,2569,-349,0,300,0,6
75789,2,2264,2425,-161,0,101,0,6
75790,2,2233,2452,-219,0,343,0,6
75791,1,2557,2353,204,0,107,0,6
75792,1,2539,2351,188,0,40,0,6
75793,3,2473,2507,-34,0,87,0,6
75794,2,2220,2485,-265,0,203,0,6
75795,2,2268,2472,-204,0,140,0,6
75796,1,2555,2360,195,0,0,0,6
75797,1,2509,2249,260,0,100,0,6
75798,2,2450,2277,173,0,41,0,6
75799,1,2541,2525,16,0,150,0,6
75800,1,2453,2275,178,0,226,0,6
75801,2,2436,2402,34,0,466,0,6
75802,2,2598,2426,172,0,122,0,6
75803,3,2219,2487,-268,0,428,0,6
75804,2,2469,2547,-78,0,279,0,6
75805,1,2553,2348,205,0,269,0,6
75806,1,2413,2375,38,0,131,0,6
75807,1,2363,2486,-123,0,110,0,6
75808,2,2336,2410,-74,0,0,1,6
75809,1,2486,2818,-332,0,263,0,6
75810,2,2212,2534,-322,0,106,0,6
75811,1,2482,2375,107,0,39,0,6
75812,2,2340,2503,-163,0,18,0,6
75813,1,2694,2522,172,0,302,0,6
75814,1,2527,2234,293,0,40,0,6
75815,2,2372,2569,-197,0,126,0,6
75816,3,2513,2418,95,0,211,0,6
75817,1,2492,2552,-60,0,300,0,6
75818,2,2211,2430,-219,0,255,0,6
75820,1,2468,2317,151,0,157,0,6
75821,2,2524,2563,-39,0,10,0,6
75822,3,2468,2521,-53,0,487,0,6
75823,1,2592,2445,147,0,200,1,6
75824,2,2256,2522,-266,0,251,0,6
75825,1,2357,2444,-87,0,34,0,6
75826,2,2289,2431,-142,0,241,0,6
75827,1,2558,2320,238,0,101,1,6
75828,1,2701,2692,9,0,113,0,6
75829,1,2533,2553,-20,0,307,0,6
75830,3,2287,2463,-176,0,52,0,6
75831,2,2238,2516,-278,0,131,0,6
75832,3,2258,2418,-160,0,7,0,6
75833,3,2353,2430,-77,0,45,0,6
75834,2,2266,2400,-134,0,219,0,8
75835,1,2378,2416,-38,0,365,1,6
75836,2,2348,2426,-78,0,45,0,6
75837,3,2329,2420,-91,0,4,0,6
75838,2,2472,2494,-22,0,120,0,6
75839,2,2290,2618,-328,0,123,0,6
75840,2,2447,2595,-148,0,115,0,6
75841,2,2238,2710,-472,0,126,0,6
75842,1,2607,2380,227,0,80,0,6
75843,2,2279,2545,-266,0,404,1,6
75844,1,2377,2617,-240,0,123,0,6
75845,1,2432,2283,149,0,455,0,6
75846,1,2489,2386,103,0,100,0,6
75847,2,2369,2451,-82,0,123,0,6
75848,1,2248,2424,-176,0,1,0,6
75849,1,2309,2426,-117,0,112,0,6
75850,2,2358,2490,-132,0,123,0,6
75851,2,2284,2441,-157,0,335,0,6
75852,3,2448,2266,182,0,302,0,6
75853,2,2483,2276,207,0,112,0,6
75854,2,2480,2293,187,0,327,0,6
75855,1,2474,2438,36,0,51,1,6
75856,2,2407,2266,141,0,200,0,6
75857,1,2833,2355,478,0,122,0,6
75858,1,2400,2353,47,0,48,0,6
75859,1,2502,2561,-59,0,40,0,6
75860,2,2424,2328,96,0,365,0,6
75862,1,2422,2330,92,0,142,0,6
75863,1,2308,2409,-101,0,463,1,6
75864,3,2348,2416,-68,0,204,0,6
75865,2,2294,2412,-118,0,45,0,6
75866,2,2234,2444,-210,0,0,0,6
75867,2,2368,2452,-84,0,302,0,6
75868,1,2223,2410,-187,0,45,0,6
75869,1,2502,2599,-97,0,241,0,6
75870,1,2520,2228,292,0,102,0,6
75871,1,2633,2414,219,0,400,0,6
75872,3,2407,2394,13,0,122,0,6
75873,1,2727,2578,149,0,101,1,6
75874,1,2442,2419,23,0,46,0,6
75875,3,2411,2363,48,0,101,0,6
75876,2,2448,2311,137,0,46,0,6
75877,1,2587,2352,235,0,106,0,6
75878,2,2646,2540,106,0,0,0,6
75879,1,2498,2520,-22,0,36,0,6
75880,3,2322,2498,-176,0,103,0,6
75881,1,2432,2370,62,0,460,1,6
75882,3,2576,2341,235,0,107,0,6
75883,3,2415,2206,209,0,138,0,6
75884,2,2435,2210,225,0,106,0,6
75885,3,2508,2329,179,0,101,0,6
75887,2,2419,2408,11,0,122,1,6
75888,2,2295,2423,-128,0,123,0,6
75889,2,2330,2422,-92,0,302,0,6
75890,1,2284,2478,-194,0,189,0,6
75891,2,2520,2701,-181,0,312,0,6
75892,2,2459,2421,38,0,133,0,6
75893,1,2474,2354,120,0,331,0,6
75894,2,2313,2442,-129,0,6,1,6
75895,1,2535,2224,311,0,300,0,6
75896,1,2413,2274,139,0,10,0,6
75897,3,2416,2420,-4,0,46,0,6
75898,1,2403,2576,-173,0,326,0,6
75899,1,2572,2514,58,0,33,0,6
75900,2,2388,2406,-18,0,138,0,6
75901,1,2558,2369,189,0,106,0,6
75902,3,2394,2581,-187,0,143,0,6
75903,2,2516,2322,194,0,4,0,6
75904,1,2652,2289,363,0,123,0,6
75905,2,2582,2505,77,0,4,0,6
75906,2,2558,2685,-127,0,331,0,6
75907,2,2564,2553,11,0,190,0,6
75908,2,2448,2484,-36,0,42,0,6
75909,1,2431,2343,88,0,112,0,6
75910,3,2413,2427,-14,0,61,0,6
75911,2,2217,2440,-223,0,0,0,6
75912,3,2429,2623,-194,0,8,0,6
75913,2,2510,2527,-17,0,211,0,6
75914,1,2437,2283,154,0,200,1,6
75915,1,2211,2456,-245,0,485,0,6
75916,1,2415,2519,-104,0,485,0,6
75917,2,2529,2472,57,0,120,0,6
75918,3,2511,2456,55,0,106,0,6
75919,1,2658,2430,228,0,242,1,6
75920,2,2487,2538,-51,0,202,0,6
75921,1,2457,2553,-96,0,310,0,6
75922,2,2403,2440,-37,0,103,0,6
75923,2,2271,2618,-347,0,123,0,6
75924,2,2397,2491,-94,0,57,1,6
75925,1,2554,2477,77,0,40,0,6
75926,1,2675,2509,166,0,230,0,6
75927,2,2228,2560,-332,0,344,0,6
75928,1,2620,2350,270,0,122,0,6
75929,1,2424,2340,84,0,241,0,6
75930,1,2541,2383,158,0,211,0,6
75931,1,2481,2451,30,0,10,0,6
75932,2,2375,2560,-185,0,306,0,6
75933,1,2339,2416,-77,0,102,0,6
75934,1,2422,2287,135,0,4,0,6
75935,2,2378,2419,-41,0,0,0,6
75936,2,2498,2356,142,0,330,0,6
75937,3,2435,2364,71,0,226,0,6
75938,2,2437,2589,-152,0,242,0,6
75939,3,2318,2487,-169,0,302,0,6
75940,1,2494,2385,109,0,201,0,6
75941,2,2305,2445,-140,0,81,1,6
75942,2,2404,2358,46,0,43,1,6
75943,3,2479,2417,62,0,245,0,6
75944,2,2307,2561,-254,0,13,0,6
75945,1,2599,2367,232,0,190,0,6
75946,2,2445,2523,-78,0,16,0,6
75947,1,2201,2444,-243,0,190,0,6
75948,1,2504,2393,111,0,211,0,6
75949,1,2321,2429,-108,0,153,0,8
75950,1,2286,2431,-145,0,48,0,6
75951,1,2415,2312,103,0,80,0,6
75952,1,2329,2564,-235,0,15,0,6
75953,3,2241,2416,-175,0,464,0,6
75954,1,2417,2424,-7,0,453,0,6
75955,2,2216,2432,-216,0,300,0,6
75956,1,2438,2285,153,0,200,1,6
75957,1,2548,2339,209,0,151,0,6
75958,3,2341,2472,-131,0,196,0,6
75959,2,2525,2518,7,0,308,0,6
75960,2,2470,2545,-75,0,101,1,6
75961,2,2466,2365,101,0,310,0,6
75962,2,2620,2389,231,0,132,0,6
75963,2,2389,2630,-241,0,398,0,6
75964,1,2433,2424,9,0,15,0,6
75965,1,2449,2496,-47,0,338,1,6
75966,2,2297,2404,-107,0,200,0,6
75967,1,2387,2574,-187,0,30,0,6
75968,2,2421,2423,-2,0,58,0,6
75969,1,2433,2282,151,0,107,0,6
75970,3,2542,2516,26,0,312,0,6
75971,1,2493,2243,250,0,207,0,6
75972,2,2408,2244,164,0,45,0,6
75973,3,2546,2546,0,0,304,0,6
75974,3,2457,2289,168,0,4,0,6
75975,2,2494,2500,-6,0,1,1,6
75976,1,2258,2460,-202,0,484,0,6
75977,1,2472,2349,123,0,303,0,6
75978,2,2348,2559,-211,0,4,0,6
75979,1,2492,2350,142,0,256,0,6
75980,2,2304,2499,-195,0,200,0,6
75981,1,2435,2302,133,0,320,0,6
75982,2,2471,2516,-45,0,57,0,6
75983,2,2296,2422,-126,0,263,1,6
75984,2,2422,2361,61,0,45,1,6
75985,2,2592,2292,300,0,13,0,6
75986,3,2509,2463,46,0,210,0,6
75987,3,2358,2503,-145,0,240,0,6
75988,1,2279,2520,-241,0,302,0,6
75989,1,2475,2211,264,0,241,0,6
75990,2,2484,2472,12,0,212,0,6
75991,1,2402,2377,25,0,190,0,6
75992,2,2313,2455,-142,0,263,0,6
75993,1,2235,2489,-254,0,108,0,6
75994,1,2475,2259,216,0,50,0,6
75995,1,2697,2542,155,0,106,0,6
75996,1,2519,2517,2,0,302,0,6
75997,2,2575,2239,336,0,40,0,6
75998,2,2416,2245,171,0,110,0,6
75999,2,2493,2273,220,0,302,0,6
76000,1,2563,2338,225,0,122,0,6
76001,3,2555,2430,125,0,132,0,6
76002,2,2551,2465,86,0,49,0,6
76003,1,2433,2397,36,0,45,0,6
76004,1,2808,2547,261,0,46,0,6
76005,2,2415,2589,-174,0,202,0,6
76006,1,2507,2539,-32,0,111,0,6
76007,1,2570,2284,286,0,4,0,6
76008,3,2421,2521,-100,0,102,0,6
76009,2,2461,2419,42,0,100,0,6
76010,2,2536,2426,110,0,406,1,6
76011,1,2531,2447,84,0,400,0,6
76012,2,2455,2467,-12,0,56,1,6
76013,1,2497,2265,232,0,102,0,6
76014,2,2533,2436,97,0,337,0,6
76015,1,2520,2537,-17,0,307,0,6
76016,1,2609,2335,274,0,45,0,6
76017,2,2331,2701,-370,0,301,0,6
76018,2,2538,2507,31,0,106,0,6
76019,3,2435,2241,194,0,208,0,6
76020,1,2505,2653,-148,0,459,0,6
76021,1,2333,2469,-136,0,40,0,6
76022,2,2412,2274,138,0,241,1,6
76023,1,2706,2288,418,0,46,0,6
76024,2,2415,2495,-80,0,46,0,6
76025,1,2536,2440,96,0,41,0,6
76026,3,2515,2355,160,0,314,0,6
76027,1,2449,2345,104,0,13,0,6
76028,2,2422,2302,120,0,122,0,6
76029,1,2435,2337,98,0,128,0,6
76030,2,2329,2510,-181,0,129,0,6
76031,1,2274,2546,-272,0,330,0,6
76032,2,2213,2400,-187,0,134,0,6
76033,3,2689,2562,127,0,7,0,6
76034,3,2344,2465,-121,0,130,0,6
76035,1,2502,2554,-52,0,100,0,6
76036,2,2678,2706,-28,0,120,0,6
76037,2,2514,2517,-3,0,255,0,6
76038,1,2676,2576,100,0,210,0,6
76039,1,2433,2391,42,0,12,1,6
76040,1,2483,2338,145,0,463,0,6
76041,1,2613,2205,408,0,11,0,6
76042,2,2356,2428,-72,0,120,0,6
76043,1,2504,2355,149,0,109,0,6
76044,2,2609,2231,378,0,135,0,6
76045,2,2449,2478,-29,0,200,0,6
76046,2,2392,2518,-126,0,311,0,6
76047,2,2511,2352,159,0,101,0,6
76048,2,2445,2471,-26,0,41,0,6
76049,3,2496,2397,99,0,109,0,6
76050,2,2405,2478,-73,0,15,0,6
76051,1,2354,2450,-96,0,84,0,6
76052,2,2320,2563,-243,0,57,0,6
76053,3,2435,2440,-5,0,302,0,6
76054,2,2476,2834,-358,0,48,0,6
76055,1,2524,2441,83,0,200,0,6
76056,1,2455,2222,233,0,320,0,6
76057,1,2593,2448,145,0,122,1,6
76058,2,2201,2442,-241,0,310,1,6
76059,1,2524,2519,5,0,127,0,6
76060,1,2524,2330,194,0,378,0,6
76061,1,2422,2420,2,0,48,1,6
76062,2,2296,2557,-261,0,106,1,6
76063,1,2507,2514,-7,0,4,0,6
76064,2,2420,2208,212,0,83,0,6
76065,3,2431,2382,49,0,46,0,6
76066,1,2483,2330,153,0,300,1,6
76067,2,2384,2406,-22,0,0,1,6
76068,1,2461,2290,171,0,325,0,6
76069,2,2587,2508,79,0,302,0,6
76070,1,2394,2426,-32,0,25,0,6
76071,2,2456,2536,-80,0,43,0,6
76072,2,2370,2479,-109,0,415,1,6
76073,2,2558,2345,213,0,115,0,6
76074,2,2559,2582,-23,0,241,0,6
76075,2,2337,2475,-138,0,145,0,6
76076,2,2470,2450,20,0,200,0,6
76077,1,2260,2409,-149,0,307,1,6
76078,2,2477,2461,16,0,28,0,6
76079,2,2595,2602,-7,0,45,0,6
76080,1,2422,2247,175,0,48,0,6
76081,1,2495,2312,183,0,15,0,6
76082,2,2562,2639,-77,0,53,0,6
76083,1,2572,2811,-239,0,406,0,6
76084,1,2208,2556,-348,0,112,0,6
76085,1,2446,2413,33,0,46,0,6
76086,2,2414,2505,-91,0,241,0,6
76087,2,2513,2622,-109,0,5,0,6
76088,1,2548,2532,16,0,101,0,6
76089,1,2510,2231,279,0,11,0,6
76090,3,2702,2682,20,0,46,0,6
76091,2,2421,2378,43,0,218,0,8
76092,2,2523,2270,253,0,225,0,6
76093,2,2619,2508,111,0,331,0,6
76094,3,2558,2459,99,0,117,0,6
76095,1,2400,2384,16,0,331,1,6
76096,1,2265,2573,-308,0,140,0,6
76097,1,2250,2431,-181,0,47,0,6
76098,1,2435,2228,207,0,344,0,6
76099,2,2545,2687,-142,0,216,0,6
76100,2,2443,2437,6,0,203,0,6
76101,2,2250,2581,-331,0,0,0,6
76102,2,2401,2496,-95,0,45,0,6
76103,3,2536,2313,223,0,18,0,6
76104,3,2363,2474,-111,0,5,0,6
76105,2,2512,2575,-63,0,253,0,6
76106,1,2417,2379,38,0,154,0,6
76107,1,2528,2403,125,0,134,0,6
76108,1,2506,2416,90,0,106,0,6
76109,1,2419,2419,0,0,200,0,6
76110,2,2419,2467,-48,0,330,0,6
76111,2,2379,2417,-38,0,485,0,6
76112,2,2603,2593,10,0,333,0,6
76113,1,2428,2227,201,0,265,0,6
76114,1,2496,2206,290,0,205,0,6
76115,1,2418,2478,-60,0,320,0,6
76116,1,2418,2227,191,0,255,0,8
76117,2,2365,2708,-343,0,303,1,6
76118,1,2287,2495,-208,0,40,1,6
76119,1,2400,2295,105,0,300,0,6
76120,2,2330,2561,-231,0,100,0,6
76121,1,2426,2365,61,0,110,0,6
76122,2,2568,2235,333,0,106,0,6
76123,1,2409,2326,83,0,113,0,6
76124,1,2455,2273,182,0,255,0,6
76125,2,2415,2384,31,0,414,0,6
76126,1,2659,2244,415,0,177,0,6
76127,2,2321,2516,-195,0,36,0,6
76128,1,2540,2371,169,0,40,0,6
76129,1,2518,2368,150,0,80,0,6
76130,1,2448,2273,175,0,116,0,6
76131,2,2324,2423,-99,0,253,0,6
76132,2,2502,2389,113,0,45,0,6
76133,1,2508,2285,223,0,211,0,6
76134,2,2287,2513,-226,0,101,0,6
76135,2,2589,2730,-141,0,106,0,6
76136,1,2413,2215,198,0,133,0,6
76137,1,2550,2265,285,0,125,0,6
76138,1,2447,2386,61,0,153,0,6
76139,2,2246,2466,-220,0,330,0,6
76140,1,2412,2360,52,0,122,0,6
76141,3,2592,2520,72,0,3,0,6
76142,2,2601,2385,216,0,119,1,6
76143,1,2413,2611,-198,0,302,0,6
76144,1,2461,2600,-139,0,15,0,6
76145,2,2339,2533,-194,0,110,0,6
76146,1,2506,2426,80,0,40,1,6
76147,1,2494,2455,39,0,227,0,6
76148,1,2399,2421,-22,0,242,0,6
76150,1,2452,2235,217,0,302,0,6
76151,1,2437,2452,-15,0,33,0,6
76152,2,2461,2565,-104,0,40,0,6
76153,2,2547,2321,226,0,190,0,6
76154,2,2365,2543,-178,0,300,1,6
76155,1,2399,2577,-178,0,28,0,6
76156,2,2302,2462,-160,0,245,1,8
76157,2,2370,2416,-46,0,130,1,6
76158,2,2377,2510,-133,0,110,0,6
76159,1,2489,2577,-88,0,80,0,6
76160,3,2509,2515,-6,0,136,0,6
76161,2,2563,2580,-17,0,31,1,6
76162,2,2246,2473,-227,0,123,0,6
76163,1,2442,2329,113,0,45,0,6
76164,2,2308,2456,-148,0,200,0,6
76165,1,2458,2272,186,0,389,0,6
76166,2,2423,2318,105,0,145,0,6
76167,2,2254,2479,-225,0,45,0,6
76168,1,2294,2408,-114,0,48,0,6
76169,2,2246,2555,-309,0,306,1,6
76170,1,2472,2544,-72,0,262,0,6
76171,1,2450,2354,96,0,96,0,6
76172,2,2271,2487,-216,0,245,0,6
76173,2,2349,2498,-149,0,310,0,6
76174,3,2442,2268,174,0,140,0,6
76175,2,2403,2336,67,0,453,0,6
76176,2,2584,2551,33,0,137,0,6
76177,2,2411,2354,57,0,46,0,6
76178,2,2495,2549,-54,0,454,0,6
76179,2,2545,2514,31,0,42,0,6
76180,3,2546,2436,110,0,41,0,6
76181,2,2386,2469,-83,0,463,0,6
76182,3,2510,2414,96,0,10,0,6
76183,1,2410,2349,61,0,300,0,6
76184,2,2401,2285,116,0,113,0,6
76185,2,2479,2296,183,0,4,0,6
76186,2,2263,2471,-208,0,140,0,6
76187,2,2500,2532,-32,0,246,0,6
76188,2,2221,2572,-351,0,300,0,6
76189,1,2490,2434,56,0,476,0,6
76190,1,2481,2286,195,0,1,0,6
76191,1,2645,2696,-51,0,202,1,6
76192,1,2541,2513,28,0,246,0,6
76193,1,2559,2254,305,0,412,0,6
76194,2,2316,2486,-170,0,104,0,6
76195,3,2582,2268,314,0,310,0,6
76196,1,2471,2425,46,0,122,0,6
76197,1,2548,2660,-112,0,0,0,6
76198,3,2383,2509,-126,0,40,0,6
76199,1,2483,2374,109,0,212,0,6
76200,3,2363,2490,-127,0,8,0,6
76201,2,2239,2473,-234,0,4,0,6
76202,1,2457,2210,247,0,337,1,6
76203,3,2342,2568,-226,0,100,0,6
76204,2,2230,2412,-182,0,40,0,6
76205,1,2527,2350,177,0,41,0,6
76206,1,2449,2426,23,0,110,0,6
76207,1,2475,2404,71,0,40,0,6
76208,3,2835,2281,554,0,203,0,6
76209,3,2427,2418,9,0,150,0,6
76210,2,2435,2473,-38,0,244,0,6
76211,2,2269,2538,-269,0,16,0,6
76212,3,2277,2446,-169,0,150,0,6
76213,1,2486,2334,152,0,16,0,6
76214,3,2449,2419,30,0,427,0,6
76215,1,2326,2441,-115,0,255,0,6
76216,1,2513,2333,180,0,46,1,6
76217,1,2547,2546,1,0,140,0,6
76218,2,2282,2405,-123,0,27,0,6
76219,2,2460,2201,259,0,25,0,6
76220,1,2438,2329,109,0,302,0,6
76221,1,2476,2440,36,0,10,1,6
76222,1,2432,2391,41,0,337,0,6
76223,2,2477,2463,14,0,125,0,6
76224,1,2447,2339,108,0,110,0,6
76225,1,2424,2319,105,0,231,0,6
76226,2,2437,2528,-91,0,13,1,6
76227,1,2609,2363,246,0,344,0,6
76228,1,2802,2712,90,0,150,0,6
76229,1,2440,2211,229,0,40,0,6
76230,2,2440,2673,-233,0,107,0,6
76231,2,2282,2436,-154,0,120,0,6
76232,1,2578,2347,231,0,315,0,6
76233,3,2511,2540,-29,0,43,0,6
76234,1,2525,2509,16,0,302,0,6
76235,2,2509,2452,57,0,102,1,6
76236,1,2515,2410,105,0,301,0,6
76237,3,2330,2410,-80,0,463,0,6
76238,2,2314,2487,-173,0,0,0,6
76239,3,2326,2453,-127,0,120,0,6
76240,2,2341,2427,-86,0,100,0,6
76241,2,2369,2471,-102,0,386,0,6
76242,1,2416,2466,-50,0,200,0,6
76243,1,2284,2599,-315,0,153,0,6
76244,2,2566,2507,59,0,411,1,6
76245,1,2522,2572,-50,0,311,0,6
76246,2,2386,2499,-113,0,0,0,6
76247,2,2247,2450,-203,0,1,0,6
76248,1,2521,2475,46,0,45,0,6
76249,1,2580,2507,73,0,151,1,6
76250,2,2511,2554,-43,0,31,1,6
76251,2,2287,2447,-160,0,438,0,6
76252,1,2244,2412,-168,0,107,0,6
76253,1,2355,2557,-202,0,200,0,6
76254,2,2521,2268,253,0,203,0,6
76255,2,2298,2429,-131,0,131,0,6
76256,2,2288,2494,-206,0,302,0,6
76257,2,2300,2439,-139,0,300,0,6
76258,2,2489,2397,92,0,300,0,6
76259,3,2501,2488,13,0,10,0,6
76260,2,2546,2511,35,0,130,0,6
76261,1,2483,2419,64,0,312,1,6
76262,2,2360,2528,-168,0,80,0,6
76263,1,2434,2521,-87,0,111,0,6
76264,1,2632,2389,243,0,278,1,6
76265,1,2431,2367,64,0,100,0,6
76266,1,2248,2404,-156,0,140,0,6
76267,2,2313,2408,-95,0,305,0,6
76268,3,2308,2452,-144,0,125,0,6
76269,1,2395,2417,-22,0,110,0,6
76270,3,2411,2522,-111,0,20,0,6
76271,1,2401,2374,27,0,300,0,6
76272,1,2414,2440,-26,0,310,0,6
76273,3,2271,2430,-159,0,100,0,6
76274,1,2470,2346,124,0,139,0,6
76275,2,2525,2285,240,0,334,0,6
76276,1,2411,2263,148,0,103,0,6
76277,3,2582,2282,300,0,5,0,6
76278,2,2419,2529,-110,0,49,0,6
76279,1,2531,2352,179,0,300,0,6
76280,2,2454,2443,11,0,34,0,8
76281,3,2420,2348,72,0,176,0,8
76282,2,2519,2636,-117,0,106,0,6
76283,3,2284,2423,-139,0,48,0,6
76284,1,2418,2263,155,0,145,0,6
76285,3,2427,2356,71,0,5,0,6
76286,2,2306,2503,-197,0,101,0,6
76287,2,2361,2413,-52,0,46,0,6
76288,3,2356,2498,-142,0,302,0,6
76289,2,2369,2461,-92,0,302,0,6
76290,1,2269,2406,-137,0,302,0,6
76291,2,2459,2494,-35,0,492,1,6
76292,2,2511,2684,-173,0,45,0,6
76293,3,2344,2478,-134,0,200,0,6
76294,2,2284,2415,-131,0,40,0,6
76295,1,2256,2450,-194,0,116,0,6
76296,1,2469,2272,197,0,484,0,6
76297,3,2369,2406,-37,0,9,0,6
76298,2,2321,2508,-187,0,381,0,6
76299,2,2591,2547,44,0,263,0,6
76300,2,2360,2428,-68,0,122,0,6
76301,3,2451,2590,-139,0,153,0,6
76302,1,2292,2506,-214,0,110,0,6
76303,1,2279,2687,-408,0,110,0,6
76304,1,2513,2334,179,0,119,0,6
76305,1,2479,2382,97,0,121,0,6
76306,1,2484,2263,221,0,103,0,6
76307,2,2452,2458,-6,0,190,0,6
76308,2,2313,2459,-146,0,110,0,6
76309,1,2406,2553,-147,0,122,0,6
76310,1,2367,2432,-65,0,48,0,6
76311,2,2540,2373,167,0,46,0,6
76312,2,2200,2421,-221,0,206,0,8
76313,1,2710,2480,230,0,337,0,6
76314,1,2564,2326,238,0,83,0,6
76315,1,2682,2328,354,0,453,0,6
76316,2,2425,2702,-277,0,255,0,6
76317,2,2419,2336,83,0,40,0,6
76318,2,2300,2454,-154,0,4,0,6
76319,1,2508,2283,225,0,109,0,6
76320,1,2612,2341,271,0,133,0,6
76321,1,2445,2339,106,0,190,0,6
76322,1,2307,2451,-144,0,1,0,6
76323,1,2433,2282,151,0,200,0,6
76324,3,2380,2464,-84,0,11,0,6
76325,3,2564,2509,55,0,80,0,6
76326,2,2578,2399,179,0,398,1,6
76327,2,2422,2422,0,0,28,1,6
76328,2,2403,2377,26,0,310,1,6
76329,2,2271,2614,-343,0,211,0,6
76330,1,2289,2490,-201,0,253,0,6
76331,1,2523,2208,315,0,120,0,6
76332,2,2473,2479,-6,0,15,1,6
76333,1,2481,2304,177,0,80,0,6
76334,2,2251,2553,-302,0,10,0,6
76335,3,2297,2451,-154,0,107,0,6
76336,1,2296,2529,-233,0,48,1,6
76337,2,2294,2443,-149,0,317,1,6
76338,2,2566,2513,53,0,40,0,6
76339,1,2486,2337,149,0,230,0,6
76340,3,2414,2302,112,0,45,0,6
76341,2,2410,2470,-60,0,373,1,6
76342,3,2415,2402,13,0,70,0,6
76343,2,2231,2422,-191,0,453,0,6
76344,2,2428,2422,6,0,190,0,6
76345,1,2563,2372,191,0,245,0,6
76346,1,2515,2396,119,0,13,0,6
76347,2,2333,2420,-87,0,474,0,6
76348,2,2343,2439,-96,0,241,0,6
76349,1,2503,2272,231,0,247,0,6
76350,3,2544,2453,91,0,45,0,6
76351,1,2500,2334,166,0,15,0,6
76352,2,2444,2460,-16,0,43,0,6
76353,2,2286,2596,-310,0,303,0,6
76354,1,2358,2423,-65,0,151,0,6
76355,2,2203,2414,-211,0,20,0,6
76356,2,2247,2431,-184,0,433,0,6
76357,1,2380,2455,-75,0,41,0,6
76358,3,2536,2830,-294,0,453,0,6
76359,2,2439,2393,46,0,106,0,6
76360,2,2362,2476,-114,0,302,0,6
76361,3,2370,2489,-119,0,156,0,6
76362,1,2341,2401,-60,0,0,0,6
76363,2,2530,2509,21,0,40,0,6
76364,1,2298,2626,-328,0,42,0,6
76365,1,2511,2227,284,0,336,0,6
76366,2,2229,2420,-191,0,359,0,6
76367,1,2390,2486,-96,0,2,0,6
76368,2,2456,2464,-8,0,115,0,6
76369,2,2352,2462,-110,0,150,1,6
76370,1,2520,2530,-10,0,395,0,6
76371,3,2438,2546,-108,0,227,0,6
76372,1,2423,2320,103,0,46,0,6
76373,1,2589,2235,354,0,1,0,6
76374,2,2399,2612,-213,0,150,0,6
76375,1,2516,2461,55,0,405,0,6
76376,1,2556,2218,338,0,111,1,6
76377,2,2231,2517,-286,0,121,1,6
76378,2,2281,2540,-259,0,106,0,6
76379,2,2315,2457,-142,0,140,0,6
76380,1,2458,2277,181,0,190,0,6
76381,2,2472,2544,-72,0,254,0,6
76382,2,2402,2446,-44,0,337,0,6
76383,1,2285,2561,-276,0,45,0,6
76384,1,2251,2461,-210,0,300,0,6
76385,1,2481,2222,259,0,103,0,6
76386,1,2269,2416,-147,0,373,0,6
76387,1,2491,2368,123,0,125,0,6
76388,2,2442,2569,-127,0,304,0,6
76389,2,2501,2407,94,0,131,0,6
76390,1,2497,2345,152,0,343,0,6
76391,2,2214,2431,-217,0,50,0,6
76392,2,2264,2527,-263,0,413,0,6
76393,1,2806,2714,92,0,248,0,6
76394,1,2707,2549,158,0,241,0,6
76395,1,2411,2477,-66,0,244,0,6
76396,2,2401,2381,20,0,246,0,6
76397,2,2393,2538,-145,0,110,0,6
76398,3,2411,2339,72,0,410,0,6
76399,2,2383,2469,-86,0,152,0,6
76400,2,2519,2243,276,0,10,0,6
76401,1,2555,2422,133,0,0,0,6
76402,1,2653,2330,323,0,118,1,6
76403,1,2427,2421,6,0,151,0,6
76404,1,2607,2585,22,0,37,1,6
76405,1,2455,2411,44,0,302,1,6
76406,2,2316,2406,-90,0,127,0,6
76407,3,2433,2316,117,0,190,0,6
76408,3,2511,2618,-107,0,40,0,6
76409,2,2317,2484,-167,0,40,0,6
76410,1,2676,2360,316,0,173,0,6
76411,2,2286,2436,-150,0,84,0,6
76412,1,2285,2552,-267,0,200,0,6
76413,2,2487,2358,129,0,300,0,6
76414,3,2255,2491,-236,0,453,0,6
76415,1,2442,2309,133,0,150,0,6
76416,2,2347,2683,-336,0,236,0,6
76417,3,2412,2265,147,0,122,0,6
76418,2,2326,2592,-266,0,301,0,6
76419,1,2439,2449,-10,0,28,0,6
76420,1,2272,2400,-128,0,485,0,6
76421,1,2448,2570,-122,0,200,1,6
76422,2,2362,2526,-164,0,200,0,6
76423,1,2496,2444,52,0,35,0,6
76424,1,2536,2303,233,0,394,1,6
76425,2,2361,2486,-125,0,4,0,6
76426,1,2435,2490,-55,0,130,0,6
76427,1,2503,2585,-82,0,253,0,6
76428,2,2278,2516,-238,0,145,0,6
76429,2,2651,2447,204,0,125,0,6
76430,1,2681,2223,458,0,200,0,6
76431,2,2285,2447,-162,4,424,0,13
76432,2,2370,2454,-84,0,57,0,6
76433,1,2488,2330,158,0,45,0,6
76434,1,2540,2549,-9,0,256,0,6
76435,2,2579,2301,278,0,4,0,6
76436,1,2324,2446,-122,0,40,0,6
76437,1,2406,2566,-160,0,140,0,6
76438,1,2586,2519,67,0,7,0,6
76439,3,2568,2353,215,0,339,0,6
76440,3,2394,2557,-163,0,301,0,6
76441,1,2375,2442,-67,0,145,0,6
76442,2,2352,2526,-174,0,0,0,6
76443,3,2470,2219,251,0,45,0,6
76444,2,2275,2471,-196,0,106,0,6
76445,1,2627,2399,228,0,426,1,6
76446,2,2469,2434,35,0,426,0,6
76447,2,2554,2481,73,0,148,0,6
76448,2,2588,2554,34,0,28,0,6
76449,2,2210,2409,-199,0,194,0,6
76450,2,2533,2504,29,0,200,0,6
76451,2,2408,2400,8,0,153,0,6
76452,1,2587,2454,133,0,300,1,6
76453,3,2433,2501,-68,0,7,0,6
76454,3,2342,2614,-272,0,320,0,6
76455,1,2461,2437,24,0,330,0,6
76456,1,2402,2265,137,0,113,0,6
76457,2,2224,2510,-286,0,200,0,6
76458,2,2263,2443,-180,0,13,0,6
76459,2,2372,2433,-61,0,147,1,6
76460,1,2515,2585,-70,0,200,0,6
76461,2,2555,2645,-90,0,110,0,6
76462,1,2553,2711,-158,0,246,1,6
76463,1,2533,2244,289,0,25,0,6
76464,1,2565,2503,62,0,122,1,6
76465,3,2454,2555,-101,0,36,0,6
76467,1,2405,2291,114,0,100,1,6
76468,1,2423,2262,161,0,253,0,6
76469,2,2287,2425,-138,0,302,1,6
76470,1,2443,2474,-31,0,151,0,6
76471,2,2319,2435,-116,0,45,0,6
76472,3,2203,2417,-214,0,107,0,6
76473,3,2465,2364,101,0,202,0,6
76474,1,2470,2210,260,0,40,0,6
76475,1,2485,2374,111,0,80,0,6
76476,1,2616,2221,395,0,41,0,6
76477,1,2480,2311,169,0,109,0,6
76478,1,2335,2476,-141,0,45,0,6
76479,2,2478,2339,139,0,130,0,6
76480,2,2429,2355,74,0,256,0,6
76481,1,2540,2402,138,0,132,0,6
76482,1,2351,2401,-50,0,300,0,6
76483,1,2459,2415,44,0,40,1,6
76484,1,2286,2495,-209,0,67,0,6
76485,1,2537,2512,25,0,211,0,6
76486,2,2276,2509,-233,0,420,0,6
76487,2,2279,2415,-136,0,80,0,6
76488,2,2499,2480,19,0,45,0,6
76489,3,2284,2454,-170,0,312,0,6
76490,3,2519,2506,13,0,101,0,6
76491,2,2404,2227,177,0,0,0,6
76492,2,2448,2558,-110,0,45,0,6
76493,1,2421,2493,-72,0,463,0,6
76494,1,2511,2506,5,0,57,0,6
76495,2,2487,2413,74,0,1,0,6
76496,1,2490,2314,176,0,255,0,6
76497,2,2581,2373,208,0,40,0,6
76498,2,2404,2275,129,0,107,1,6
76499,1,2503,2257,246,0,123,0,6
76500,2,2474,2530,-56,0,45,0,6
76501,3,2594,2252,342,0,207,0,6
76502,1,2504,2396,108,0,145,0,6
76503,1,2355,2428,-73,0,57,0,6
76504,1,2544,2546,-2,0,46,0,6
76505,1,2534,2472,62,0,331,0,6
76506,2,2204,2415,-211,0,106,0,6
76507,1,2557,2301,256,0,205,0,6
76508,2,2497,2577,-80,0,4,0,6
76509,3,2339,2488,-149,0,45,0,6
76510,1,2573,2209,364,0,15,0,6
76511,1,2494,2558,-64,0,206,0,6
76512,3,2361,2559,-198,0,100,0,6
76513,2,2545,2810,-265,0,60,0,6
76514,2,2519,2464,55,0,133,0,6
76515,1,2402,2396,6,0,225,1,6
76516,1,2707,2643,64,0,487,0,6
76517,2,2507,2405,102,0,120,0,6
76518,2,2391,2501,-110,0,80,0,6
76519,3,2350,2441,-91,0,308,0,6
76520,2,2276,2449,-173,0,310,0,6
76521,1,2515,2348,167,0,4,0,6
76522,1,2570,2449,121,0,30,0,6
76523,2,2497,2524,-27,0,41,0,6
76524,1,2432,2271,161,0,107,0,8
76525,2,2204,2439,-235,0,106,1,6
76526,1,2212,2451,-239,0,134,0,6
76527,2,2273,2493,-220,0,240,0,6
76528,1,2542,2408,134,0,263,0,6
76529,3,2519,2570,-51,0,338,0,6
76530,3,2438,2460,-22,0,345,0,6
76531,1,2421,2447,-26,0,106,0,6
76532,1,2464,2290,174,0,253,0,6
76533,1,2586,2326,260,0,89,0,6
76534,1,2470,2450,20,0,200,0,6
76535,3,2310,2439,-129,0,257,0,6
76536,1,2428,2298,130,0,101,0,6
76537,1,2373,2422,-49,0,487,0,6
76538,1,2392,2519,-127,0,41,1,6
76539,1,2610,2439,171,0,133,0,6
76540,2,2465,2294,171,0,301,0,6
76541,2,2227,2566,-339,0,107,1,6
76542,1,2358,2559,-201,0,344,0,6
76543,1,2677,2472,205,0,245,0,6
76545,2,2488,2492,-4,0,1,0,6
76546,2,2582,2501,81,0,244,0,6
76547,1,2443,2415,28,0,58,1,6
76548,1,2445,2382,63,0,20,0,6
76549,1,2445,2309,136,0,4,0,6
76550,1,2487,2449,38,0,57,0,6
76551,2,2350,2463,-113,0,107,0,6
76552,1,2383,2436,-53,0,48,0,6
76553,1,2551,2305,246,0,332,0,6
76554,1,2590,2227,363,0,300,1,6
76555,2,2404,2283,121,0,409,0,6
76556,1,2441,2323,118,0,207,0,6
76557,2,2677,2223,454,0,5,0,6
76558,2,2284,2635,-351,0,302,0,6
76559,3,2455,2386,69,0,70,0,6
76560,1,2490,2245,245,0,107,0,6
76561,2,2514,2358,156,0,108,0,6
76562,2,2412,2295,117,0,45,0,6
76563,1,2515,2425,90,0,301,0,6
76564,1,2343,2590,-247,0,211,0,6
76565,1,2486,2506,-20,0,128,0,6
76566,1,2541,2560,-19,0,229,0,6
76567,2,2399,2510,-111,0,80,0,6
76568,1,2426,2305,121,0,131,0,6
76569,1,2383,2416,-33,0,167,0,6
76570,2,2277,2471,-194,0,404,0,6
76571,1,2446,2520,-74,0,48,0,6
76572,1,2432,2291,141,0,125,0,6
76573,1,2384,2416,-32,0,37,0,6
76574,2,2439,2479,-40,0,205,0,6
76575,1,2545,2484,61,0,45,1,6
76576,1,2524,2526,-2,0,40,0,6
76577,1,2202,2444,-242,0,156,0,6
76578,2,2254,2463,-209,0,43,0,6
76579,1,2336,2532,-196,0,432,0,6
76580,2,2562,2525,37,0,306,0,6
76581,2,2207,2455,-248,0,40,0,6
76582,1,2548,2440,108,0,41,0,6
76583,1,2614,2427,187,0,409,0,6
76584,1,2429,2297,132,0,241,0,6
76585,2,2463,2350,113,0,432,0,6
76586,2,2441,2441,0,0,373,0,6
76587,2,2415,2542,-127,0,352,0,6
76588,2,2412,2513,-101,0,45,0,6
76589,2,2399,2529,-130,0,101,0,6
76590,1,2555,2313,242,0,400,0,6
76591,2,2543,2397,146,0,118,0,6
76592,2,2368,2405,-37,0,124,0,6
76593,1,2475,2381,94,0,4,0,6
76594,1,2230,2705,-475,0,123,0,6
76595,1,2479,2343,136,0,29,0,6
76596,3,2540,2578,-38,0,250,0,6
76597,2,2239,2506,-267,0,140,0,6
76598,3,2573,2278,295,0,344,0,6
76599,2,2439,2512,-73,0,57,0,6
76600,1,2417,2236,181,0,296,0,6
76601,1,2419,2483,-64,0,484,1,6
76602,2,2220,2534,-314,0,40,0,6
76603,1,2381,2493,-112,0,463,0,6
76604,1,2476,2410,66,0,400,0,6
76605,2,2438,2346,92,0,302,0,6
76606,2,2308,2491,-183,0,140,0,6
76607,1,2638,2540,98,0,112,0,6
76608,1,2826,2543,283,0,205,0,6
76609,3,2441,2578,-137,0,217,0,6
76610,2,2813,2715,98,0,248,0,6
76611,3,2515,2349,166,0,101,0,6
76612,1,2510,2640,-130,0,106,0,6
76613,1,2434,2263,171,0,267,0,6
76614,1,2486,2527,-41,0,335,0,6
76615,1,2466,2301,165,0,200,0,6
76616,2,2257,2417,-160,0,236,0,6
76617,2,2434,2226,208,0,151,0,6
76618,3,2445,2358,87,0,45,0,6
76619,1,2511,2224,287,0,11,1,6
76620,1,2282,2472,-190,0,104,1,6
76622,2,2329,2513,-184,0,436,0,6
76623,1,2455,2461,-6,0,152,0,6
76624,1,2616,2332,284,0,101,0,6
76625,1,2463,2239,224,0,461,0,6
76626,2,2418,2563,-145,0,190,0,6
76627,1,2356,2444,-88,0,46,0,6
76628,1,2562,2382,180,0,220,0,6
76629,1,2418,2276,142,0,462,0,6
76630,1,2557,2330,227,0,122,0,6
76631,2,2317,2499,-182,0,338,0,6
76632,1,2434,2431,3,0,7,0,6
76633,3,2430,2272,158,0,112,0,8
76634,1,2444,2499,-55,0,198,0,6
76635,2,2406,2510,-104,0,45,0,6
76636,2,2420,2680,-260,0,335,0,6
76637,3,2480,2270,210,0,1,0,6
76638,2,2418,2507,-89,0,255,1,6
76639,1,2649,2469,180,0,1,0,6
76640,2,2300,2549,-249,0,48,0,6
76641,2,2477,2530,-53,0,49,0,6
76642,3,2316,2430,-114,0,141,0,6
76643,2,2362,2452,-90,0,201,0,6
76644,1,2436,2282,154,0,104,0,6
76645,1,2569,2519,50,0,314,0,6
76646,1,2506,2520,-14,0,6,0,6
76647,2,2266,2410,-144,0,27,0,6
76648,1,2423,2376,47,0,11,0,6
76649,1,2357,2445,-88,0,211,0,6
76650,2,2492,2337,155,0,112,0,6
76651,1,2685,2511,174,0,255,0,6
76652,1,2234,2400,-166,0,18,0,6
76653,1,2256,2426,-170,0,242,1,6
76654,1,2500,2508,-8,0,243,0,6
76655,2,2343,2594,-251,0,130,1,6
76656,1,2378,2524,-146,0,0,0,6
76657,1,2266,2449,-183,0,45,1,6
76658,3,2462,2534,-72,0,414,0,6
76659,2,2284,2529,-245,0,61,0,6
76660,2,2613,2610,3,0,133,0,6
76661,1,2538,2374,164,0,45,0,6
76662,1,2415,2236,179,0,40,0,8
76663,1,2304,2470,-166,0,150,0,6
76664,2,2302,2415,-113,0,131,0,6
76665,2,2217,2457,-240,0,0,0,6
76666,1,2335,2404,-69,0,43,0,6
76667,1,2404,2335,69,0,124,0,6
76668,2,2484,2434,50,0,45,0,6
76669,1,2380,2492,-112,0,0,0,6
76670,2,2405,2323,82,0,45,0,6
76671,1,2479,2250,229,0,101,0,6
76672,2,2291,2687,-396,0,106,0,6
76673,1,2411,2404,7,0,122,0,6
76674,1,2536,2318,218,0,404,0,6
76675,1,2496,2642,-146,0,107,0,6
76676,2,2395,2465,-70,0,101,0,6
76677,1,2446,2535,-89,0,41,0,6
76678,1,2704,2352,352,0,40,0,6
76679,3,2581,2423,158,0,60,0,6
76680,2,2574,2469,105,0,15,0,6
76681,3,2483,2513,-30,0,104,0,6
76682,2,2378,2517,-139,0,255,0,6
76683,3,2428,2255,173,0,354,0,6
76684,2,2513,2277,236,0,386,0,6
76685,1,2368,2518,-150,0,133,1,6
76686,3,2425,2545,-120,0,145,0,6
76688,1,2396,2559,-163,0,337,1,6
76689,3,2542,2486,56,0,218,0,6
76690,2,2405,2491,-86,0,106,0,6
76691,3,2464,2450,14,0,4,0,6
76692,1,2561,2587,-26,0,132,0,6
76693,2,2613,2390,223,0,190,0,6
76694,3,2410,2436,-26,0,120,0,6
76695,3,2423,2229,194,0,255,0,6
76696,3,2435,2202,233,0,40,0,6
76698,2,2440,2210,230,0,112,0,6
76699,1,2466,2200,266,0,12,0,6
76700,1,2347,2466,-119,0,45,0,6
76701,2,2294,2413,-119,0,45,0,6
76702,2,2447,2636,-189,0,113,0,6
76703,2,2559,2542,17,0,244,0,6
76704,2,2435,2500,-65,0,40,0,6
76705,1,2412,2492,-80,0,46,0,6
76706,1,2243,2505,-262,0,88,0,6
76707,2,2410,2404,6,0,40,0,6
76708,3,2431,2383,48,0,43,0,6
76709,1,2506,2392,114,0,306,0,6
76710,2,2327,2548,-221,0,115,0,6
76711,2,2404,2424,-20,0,190,0,6
76712,3,2520,2366,154,0,200,0,6
76713,3,2448,2330,118,0,55,0,6
76714,2,2397,2457,-60,0,302,0,6
76715,1,2492,2450,42,0,11,0,6
76716,1,2274,2404,-130,4,245,0,13
76717,1,2282,2450,-168,0,40,0,6
76718,1,2703,2324,379,0,106,1,6
76719,2,2232,2418,-186,0,455,1,6
76720,2,2551,2491,60,0,101,1,6
76721,2,2530,2591,-61,0,45,1,6
76722,2,2533,2464,69,0,57,0,6
76723,1,2410,2310,100,0,7,0,6
76724,2,2395,2557,-162,0,200,0,6
76725,1,2483,2324,159,0,1,0,6
76726,2,2551,2498,53,0,113,0,6
76727,1,2439,2390,49,0,337,0,6
76728,1,2582,2364,218,0,41,0,6
76729,2,2282,2655,-373,0,48,0,6
76730,1,2560,2556,4,0,200,0,6
76731,2,2216,2630,-414,0,248,0,6
76732,1,2468,2556,-88,0,201,0,6
76733,3,2467,2531,-64,0,306,0,6
76734,1,2520,2531,-11,0,330,0,6
76735,2,2408,2436,-28,0,225,0,6
76736,1,2389,2487,-98,0,277,1,6
76737,2,2410,2277,133,0,11,0,6
76738,1,2598,2215,383,0,102,0,6
76739,1,2459,2284,175,0,301,0,6
76740,1,2558,2510,48,0,310,0,6
76741,2,2388,2414,-26,0,45,0,6
76742,1,2743,2331,412,0,107,0,6
76743,2,2283,2416,-133,0,122,0,6
76745,1,2353,2514,-161,0,196,0,6
76746,3,2566,2442,124,0,145,0,6
76747,1,2520,2517,3,0,80,1,6
76748,1,2551,2500,51,0,0,0,6
76749,1,2285,2521,-236,0,49,0,6
76750,1,2474,2484,-10,0,125,0,6
76751,1,2378,2543,-165,0,27,0,6
76752,1,2455,2390,65,0,225,0,6
76753,1,2420,2234,186,0,170,0,6
76754,2,2372,2409,-37,0,184,0,6
76755,3,2592,2379,213,0,1,0,6
76756,2,2513,2391,122,0,106,0,6
76757,3,2326,2453,-127,0,303,0,6
76758,1,2570,2541,29,0,120,0,6
76759,1,2536,2251,285,0,40,0,6
76760,1,2241,2494,-253,0,334,0,6
76761,1,2407,2281,126,0,487,0,6
76762,1,2543,2469,74,0,125,0,6
76763,2,2529,2444,85,0,337,0,6
76765,2,2424,2429,-5,0,57,0,6
76766,1,2428,2565,-137,0,415,0,6
76767,2,2370,2466,-96,0,7,0,6
76768,3,2486,2538,-52,0,253,0,6
76769,1,2514,2513,1,0,101,0,6
76770,1,2574,2323,251,0,61,0,6
76771,2,2271,2406,-135,0,255,0,6
76772,1,2459,2319,140,0,43,0,6
76773,3,2306,2453,-147,0,101,0,6
76774,1,2528,2405,123,0,40,0,6
76775,1,2705,2536,169,0,43,0,6
76776,1,2477,2356,121,0,40,0,6
76777,1,2413,2311,102,0,320,0,6
76778,3,2634,2805,-171,0,202,0,6
76779,1,2727,2504,223,0,240,0,6
76780,2,2432,2430,2,0,200,1,6
76781,3,2381,2422,-41,0,152,0,6
76782,2,2503,2547,-44,0,45,0,6
76783,2,2342,2534,-192,0,106,0,6
76784,1,2514,2228,286,0,211,0,6
76785,1,2452,2204,248,0,138,0,6
76786,1,2317,2454,-137,0,128,1,6
76787,3,2358,2423,-65,0,112,0,6
76788,2,2396,2455,-59,0,311,0,6
76789,2,2488,2290,198,0,409,0,6
76790,3,2567,2547,20,0,320,0,6
76791,2,2231,2415,-184,0,1,0,6
76792,1,2247,2420,-173,0,0,0,6
76793,1,2652,2828,-176,0,1,1,6
76794,2,2466,2516,-50,0,48,0,6
76795,2,2541,2677,-136,0,409,0,6
76796,2,2326,2522,-196,0,52,0,6
76797,1,2429,2283,146,0,4,0,6
76798,1,2519,2484,35,0,211,0,6
76799,1,2480,2260,220,0,8,0,6
76800,2,2596,2377,219,0,85,0,6
76801,1,2421,2351,70,0,40,0,6
76802,1,2429,2448,-19,0,13,0,6
76803,2,2214,2422,-208,0,16,1,6
76804,1,2462,2221,241,0,103,0,6
76805,3,2525,2526,-1,0,40,0,6
76806,2,2290,2575,-285,0,115,0,6
76807,1,2417,2372,45,0,13,0,8
76808,1,2577,2541,36,0,140,0,6
76809,3,2306,2431,-125,0,345,0,6
76810,3,2296,2414,-118,0,241,0,6
76811,2,2227,2410,-183,0,122,0,6
76812,2,2425,2599,-174,0,242,0,6
76813,1,2549,2479,70,0,45,0,6
76814,2,2552,2498,54,0,241,0,6
76815,1,2234,2532,-298,0,9,1,6
76816,3,2666,2564,102,0,5,0,6
76817,2,2329,2515,-186,0,15,0,6
76818,1,2430,2353,77,0,56,0,6
76819,1,2418,2461,-43,0,13,1,6
76820,1,2343,2444,-101,0,5,0,6
76821,2,2450,2399,51,0,247,0,6
76822,2,2521,2682,-161,0,49,0,6
76823,1,2535,2538,-3,0,112,1,6
76824,1,2362,2468,-106,0,338,0,6
76825,1,2576,2389,187,0,110,0,6
76826,1,2446,2299,147,0,107,0,6
76827,2,2479,2590,-111,0,112,0,6
76828,2,2256,2524,-268,0,122,0,6
76829,2,2270,2498,-228,0,335,0,6
76830,1,2318,2437,-119,0,4,0,6
76831,2,2480,2499,-19,0,194,1,6
76832,1,2428,2282,146,0,4,0,6
76833,3,2347,2442,-95,0,106,0,6
76834,1,2442,2239,203,0,4,0,6
76835,2,2430,2335,95,0,5,1,6
76836,2,2442,2542,-100,0,54,0,6
76837,1,2483,2306,177,0,242,0,6
76838,2,2416,2538,-122,0,302,0,6
76839,2,2247,2567,-320,0,443,0,6
76840,2,2249,2465,-216,0,100,0,6
76841,3,2405,2356,49,0,247,0,6
76842,1,2565,2481,84,0,315,0,6
76843,3,2511,2228,283,0,40,0,6
76844,1,2631,2454,177,0,378,0,6
76845,1,2375,2534,-159,0,0,0,6
76846,1,2383,2435,-52,0,0,0,6
76847,3,2445,2475,-30,0,354,0,6
76848,2,2439,2335,104,0,147,0,6
76849,2,2456,2362,94,0,300,1,6
76850,1,2484,2529,-45,0,122,0,6
76851,2,2309,2424,-115,0,133,0,6
76852,2,2280,2618,-338,0,43,0,6
76853,1,2467,2318,149,0,149,0,6
76854,2,2353,2441,-88,0,106,0,6
76855,3,2465,2265,200,0,0,0,6
76856,2,2306,2560,-254,0,22,0,6
76857,2,2437,2307,130,0,216,0,6
76858,2,2260,2449,-189,0,122,0,6
76859,1,2514,2540,-26,0,250,0,6
76860,2,2440,2449,-9,0,302,0,6
76861,1,2549,2468,81,0,1,0,6
76862,2,2530,2475,55,0,236,0,6
76863,1,2495,2422,73,0,118,0,6
76864,2,2359,2590,-231,0,242,0,6
76865,2,2561,2410,151,0,40,1,6
76866,1,2438,2229,209,0,122,0,6
76867,2,2404,2392,12,0,70,0,6
76868,2,2289,2438,-149,0,265,0,6
76869,3,2468,2369,99,0,13,0,6
76870,3,2552,2506,46,0,248,0,6
76871,2,2398,2552,-154,0,111,0,6
76872,3,2350,2449,-99,0,303,0,8
76873,1,2238,2418,-180,0,1,0,8
76874,1,2414,2329,85,0,140,0,6
76875,3,2618,2553,65,0,241,0,6
76876,2,2401,2548,-147,0,301,0,6
76877,1,2563,2425,138,0,454,0,6
76878,2,2330,2594,-264,0,300,1,6
76879,2,2346,2506,-160,0,115,1,6
76880,2,2330,2475,-145,0,291,0,6
76881,1,2432,2402,30,0,145,0,6
76882,1,2432,2212,220,0,145,0,6
76883,1,2444,2556,-112,0,100,1,6
76884,1,2418,2484,-66,0,145,0,6
76885,1,2270,2506,-236,0,40,1,6
76886,2,2223,2520,-297,0,132,0,6
76887,1,2311,2434,-123,0,213,0,6
76888,1,2516,2339,177,0,122,0,6
76889,1,2514,2518,-4,0,277,1,6
76890,3,2451,2341,110,0,302,0,6
76891,2,2686,2568,118,0,307,0,6
76892,1,2292,2516,-224,0,380,0,6
76893,2,2362,2410,-48,0,244,1,6
76894,2,2542,2564,-22,0,154,1,6
76895,2,2253,2484,-231,0,156,0,6
76896,2,2200,2456,-256,0,102,0,6
76897,3,2338,2483,-145,0,278,0,6
76898,1,2435,2362,73,0,208,0,6
76899,2,2287,2438,-151,0,200,0,6
76900,2,2467,2518,-51,0,253,0,6
76901,1,2447,2208,239,0,153,0,6
76902,1,2676,2401,275,0,42,1,6
76903,2,2502,2688,-186,0,142,0,6
76904,3,2532,2506,26,0,46,0,6
76905,2,2508,2425,83,0,8,0,6
76906,1,2527,2554,-27,0,45,0,6
76907,1,2414,2408,6,0,4,0,6
76908,2,2579,2617,-38,0,5,1,6
76909,3,2632,2512,120,0,4,0,6
76910,1,2282,2401,-119,0,207,0,6
76911,1,2704,2351,353,0,265,0,6
76912,1,2496,2604,-108,0,152,0,6
76913,1,2366,2413,-47,0,130,0,6
76914,2,2256,2569,-313,0,302,0,6
76915,1,2323,2434,-111,0,0,0,6
76916,2,2568,2283,285,0,245,0,6
76917,1,2450,2463,-13,0,246,0,6
76918,2,2410,2459,-49,0,57,0,6
76919,1,2504,2444,60,0,120,0,6
76920,2,2246,2592,-346,0,242,0,6
76921,1,2566,2617,-51,0,253,0,6
76922,1,2639,2664,-25,0,113,0,6
76923,1,2424,2356,68,0,225,0,6
76924,2,2294,2431,-137,0,208,0,6
76925,1,2518,2373,145,0,11,0,6
76926,3,2471,2496,-25,0,90,0,6
76927,1,2242,2432,-190,0,483,0,6
76928,1,2526,2252,274,0,49,0,6
76929,3,2578,2458,120,0,334,0,6
76930,2,2269,2575,-306,0,43,0,6
76931,2,2321,2520,-199,0,130,0,6
76932,1,2508,2486,22,0,10,1,6
76933,1,2538,2414,124,0,306,1,6
76934,1,2685,2403,282,0,106,0,6
76935,2,2367,2441,-74,0,217,0,6
76936,1,2416,2335,81,0,315,0,6
76937,1,2463,2355,108,0,56,0,6
76938,1,2282,2470,-188,0,140,1,6
76939,2,2285,2431,-146,0,48,0,6
76940,1,2430,2418,12,0,228,0,6
76941,3,2513,2426,87,0,10,0,6
76942,1,2477,2312,165,0,106,0,6
76943,2,2436,2534,-98,0,302,0,6
76944,3,2445,2497,-52,0,114,0,6
76945,2,2498,2418,80,0,200,0,6
76946,1,2552,2265,287,0,41,0,6
76947,2,2418,2361,57,0,4,0,6
76948,1,2343,2518,-175,0,8,0,6
76949,3,2493,2371,122,0,245,0,6
76950,1,2420,2352,68,0,152,0,6
76951,1,2481,2383,98,0,40,0,6
76952,1,2419,2397,22,0,188,0,6
76953,1,2295,2405,-110,0,13,1,6
76954,2,2334,2401,-67,0,107,0,6
76955,1,2730,2637,93,0,487,0,6
76956,2,2572,2803,-231,0,337,0,6
76957,2,2455,2272,183,0,263,1,6
76958,1,2503,2298,205,0,327,0,6
76959,1,2419,2314,105,0,34,0,6
76960,1,2361,2589,-228,0,152,0,6
76961,3,2402,2439,-37,0,48,0,6
76962,1,2478,2306,172,0,454,0,6
76963,1,2361,2419,-58,0,152,0,6
76964,2,2480,2584,-104,0,241,0,6
76965,1,2450,2387,63,0,140,0,6
76966,3,2689,2419,270,0,460,0,6
76967,2,2288,2424,-136,0,45,0,6
76968,1,2454,2450,4,0,303,0,6
76969,1,2438,2207,231,0,125,0,6
76970,1,2523,2215,308,0,40,0,6
76971,2,2324,2490,-166,0,106,0,6
76972,1,2452,2282,170,0,65,0,6
76973,1,2531,2293,238,0,483,0,6
76974,2,2441,2480,-39,0,256,0,6
76975,3,2532,2485,47,0,140,0,6
76976,2,2378,2708,-330,0,45,0,6
76977,1,2587,2482,105,0,40,0,6
76978,1,2429,2279,150,0,210,0,6
76979,2,2201,2435,-234,0,404,0,6
76980,1,2449,2401,48,0,466,0,6
76981,1,2410,2503,-93,0,128,0,6
76982,2,2435,2597,-162,0,180,0,6
76983,1,2545,2525,20,0,102,0,6
76984,2,2252,2554,-302,0,380,0,6
76985,1,2476,2227,249,0,118,0,6
76986,2,2368,2546,-178,0,47,0,6
76987,1,2556,2455,101,0,46,0,6
76988,1,2525,2371,154,0,406,0,6
76989,1,2434,2444,-10,0,302,0,6
76990,1,2526,2231,295,0,45,0,6
76991,3,2485,2383,102,0,100,0,6
76992,2,2232,2449,-217,0,426,0,6
76993,3,2525,2225,300,0,300,0,6
76994,1,2411,2321,90,0,122,0,6
76995,2,2551,2577,-26,0,210,0,6
76996,3,2404,2255,149,0,43,0,6
76997,2,2436,2427,9,0,122,0,8
76998,1,2487,2311,176,0,404,0,6
76999,1,2555,2251,304,0,242,0,6
77000,2,2486,2305,181,0,300,0,6
77001,2,2370,2494,-124,0,380,0,6
77002,2,2744,2428,316,0,168,0,6
77003,2,2398,2532,-134,0,123,0,6
77004,1,2521,2398,123,0,40,0,6
77005,2,2464,2211,253,0,326,0,6
77006,2,2256,2553,-297,0,40,0,6
77007,1,2602,2245,357,0,122,0,6
77008,1,2325,2422,-97,0,136,0,6
77009,2,2350,2435,-85,0,103,0,6
77010,1,2425,2349,76,0,106,0,6
77011,1,2579,2705,-126,0,123,0,6
77012,1,2553,2402,151,0,314,1,6
77013,1,2436,2554,-118,0,248,0,6
77014,1,2536,2582,-46,0,250,0,6
77015,1,2425,2232,193,0,101,0,6
77016,2,2526,2505,21,0,308,0,6
77017,1,2507,2224,283,0,45,0,6
77018,2,2547,2403,144,0,109,0,6
77019,1,2616,2655,-39,0,327,1,6
77020,1,2342,2405,-63,0,398,0,6
77021,1,2283,2434,-151,0,49,0,6
77022,3,2443,2432,11,0,200,0,6
77023,1,2325,2445,-120,0,22,0,6
77024,1,2404,2313,91,0,40,0,6
77025,1,2325,2562,-237,0,0,0,6
77026,1,2710,2343,367,0,49,0,6
77027,2,2509,2344,165,0,310,1,6
77028,1,2346,2524,-178,0,101,0,6
77029,3,2482,2447,35,0,106,0,6
77030,3,2534,2333,201,0,53,0,6
77031,2,2206,2406,-200,0,40,1,6
77032,1,2600,2288,312,0,117,0,6
77033,2,2340,2432,-92,0,400,1,6
77034,2,2471,2327,144,0,184,0,6
77035,1,2402,2381,21,0,58,1,6
77036,1,2507,2275,232,0,261,0,6
77037,2,2325,2497,-172,0,106,0,6
77038,3,2392,2408,-16,0,45,0,6
77039,2,2445,2819,-374,0,45,1,6
77040,2,2397,2660,-263,0,40,0,6
77041,2,2518,2232,286,0,140,0,6
77042,1,2401,2326,75,0,80,0,6
77043,2,2318,2514,-196,0,115,0,6
77044,1,2523,2522,1,0,145,0,6
77045,1,2497,2481,16,0,4,1,6
77046,2,2514,2500,14,0,110,0,6
77047,2,2418,2397,21,0,107,0,6
77048,2,2247,2428,-181,0,59,0,6
77049,2,2309,2567,-258,0,123,0,6
77050,2,2387,2445,-58,0,56,0,6
77051,1,2418,2342,76,0,40,0,6
77052,2,2622,2711,-89,0,45,0,6
77053,3,2548,2553,-5,0,200,0,6
77054,2,2278,2569,-291,0,80,0,6
77055,1,2533,2574,-41,0,45,0,6
77056,1,2476,2327,149,0,460,0,6
77057,3,2303,2413,-110,0,405,0,6
77058,1,2571,2467,104,0,60,0,6
77059,1,2471,2263,208,0,108,0,6
77060,1,2546,2400,146,0,140,0,6
77061,2,2425,2380,45,0,4,0,6
77062,2,2309,2485,-176,0,302,0,6
77063,2,2250,2480,-230,0,484,0,6
77064,1,2447,2410,37,0,302,0,6
77065,3,2532,2560,-28,0,311,0,6
77066,1,2541,2542,-1,0,178,0,6
77067,2,2335,2472,-137,0,100,0,8
77068,2,2510,2434,76,0,121,0,6
77069,1,2425,2283,142,0,53,0,6
77070,2,2457,2456,1,0,1,1,6
77071,1,2413,2411,2,0,418,1,6
77072,1,2486,2275,211,0,240,0,6
77073,2,2507,2381,126,0,263,1,6
77074,1,2508,2244,264,0,107,0,6
77075,2,2656,2460,196,0,132,0,6
77076,2,2295,2630,-335,0,0,1,6
77077,2,2512,2593,-81,0,225,0,6
77078,3,2552,2250,302,0,106,0,6
77079,2,2372,2430,-58,0,113,0,6
77080,2,2548,2528,20,0,101,0,6
77081,2,2573,2293,280,0,90,1,6
77082,1,2553,2398,155,0,310,0,6
77083,1,2607,2633,-26,0,241,0,6
77084,2,2556,2554,2,0,345,0,6
77085,2,2440,2429,11,0,4,0,6
77086,1,2537,2427,110,0,30,0,6
77087,1,2543,2348,195,0,211,1,6
77088,1,2401,2633,-232,0,152,0,6
77089,2,2689,2737,-48,0,253,0,6
77090,2,2217,2454,-237,0,123,0,6
77091,2,2407,2351,56,0,389,1,6
77092,1,2524,2348,176,0,333,0,6
77093,1,2379,2424,-45,0,45,0,6
77094,2,2429,2404,25,0,5,0,6
77095,1,2483,2275,208,0,57,1,6
77096,2,2491,2359,132,0,153,0,6
77097,2,2210,2435,-225,0,257,0,6
77098,1,2325,2412,-87,0,5,0,6
77099,2,2254,2411,-157,0,31,0,6
77100,2,2454,2300,154,0,443,0,6
77101,2,2287,2555,-268,0,40,0,6
77102,2,2432,2396,36,0,153,0,6
77103,2,2478,2332,146,0,301,0,6
77104,1,2501,2310,191,0,8,0,6
77105,1,2538,2440,98,0,394,0,6
77106,2,2487,2572,-85,0,126,0,6
77107,2,2611,2526,85,0,331,0,6
77108,2,2511,2479,32,0,310,0,6
77109,1,2299,2438,-139,0,400,0,6
77110,3,2426,2449,-23,0,313,0,6
77111,1,2663,2460,203,0,0,0,6
77112,2,2431,2551,-120,0,211,0,6
77113,1,2506,2444,62,0,312,0,6
77114,2,2412,2410,2,0,45,0,6
77115,1,2620,2231,389,0,21,0,6
77116,1,2533,2333,200,0,61,0,6
77117,3,2332,2423,-91,0,132,0,6
77118,1,2364,2466,-102,0,40,1,6
77119,1,2565,2678,-113,0,337,0,6
77120,3,2805,2575,230,0,255,0,6
77121,2,2299,2577,-278,0,115,0,6
77122,1,2658,2436,222,0,4,0,6
77123,1,2645,2484,161,0,203,0,6
77124,3,2385,2557,-172,0,0,0,6
77125,1,2338,2528,-190,0,0,0,6
77126,1,2567,2381,186,0,4,0,6
77127,1,2471,2539,-68,0,307,0,6
77128,2,2423,2567,-144,0,300,0,6
77129,1,2495,2504,-9,0,246,0,6
77130,2,2422,2440,-18,0,46,0,6
77131,1,2301,2432,-131,0,302,0,6
77132,1,2223,2462,-239,0,50,1,6
77133,1,2365,2441,-76,0,224,0,6
77134,2,2538,2475,63,0,206,0,6
77135,2,2464,2405,59,0,48,0,6
77136,2,2280,2433,-153,0,101,1,6
77137,2,2233,2435,-202,0,427,0,6
77138,2,2457,2525,-68,0,303,0,6
77139,1,2512,2665,-153,0,455,0,6
77140,2,2307,2425,-118,0,120,0,6
77141,3,2460,2634,-174,0,225,0,6
77142,2,2342,2554,-212,0,102,0,6
77143,1,2598,2452,146,0,445,0,6
77144,1,2548,2508,40,0,0,0,6
77146,3,2310,2458,-148,0,63,0,6
77147,2,2496,2445,51,0,464,0,6
77148,3,2446,2246,200,0,201,0,6
77149,2,2341,2547,-206,0,9,0,6
77150,3,2503,2286,217,0,46,0,6
77151,1,2347,2451,-104,0,415,0,6
77152,2,2535,2424,111,0,145,1,6
77153,1,2348,2558,-210,0,21,0,6
77154,1,2448,2244,204,0,0,0,6
77155,2,2280,2481,-201,0,40,0,6
77156,1,2559,2698,-139,0,45,1,6
77157,2,2533,2587,-54,0,80,0,6
77158,2,2436,2426,10,0,112,0,6
77159,1,2403,2242,161,0,122,0,6
77160,2,2435,2367,68,0,15,0,6
77161,2,2265,2438,-173,0,303,1,6
77162,2,2511,2435,76,0,270,0,6
77163,1,2470,2297,173,0,436,0,6
77164,2,2400,2452,-52,0,409,0,6
77165,1,2470,2262,208,0,211,0,6
77166,2,2426,2416,10,0,426,0,6
77167,2,2330,2503,-173,0,101,0,6
77168,1,2342,2501,-159,0,115,0,6
77169,2,2355,2499,-144,0,300,0,6
77170,1,2534,2394,140,0,43,0,6
77171,1,2596,2293,303,0,177,0,6
77172,1,2691,2542,149,0,241,0,6
77173,2,2451,2377,74,0,190,0,6
77174,2,2422,2333,89,0,127,1,6
77175,1,2576,2536,40,0,341,0,6
77176,2,2218,2443,-225,0,250,0,6
77177,1,2362,2456,-94,0,45,1,6
77178,2,2405,2355,50,0,122,1,6
77179,1,2423,2276,147,0,200,0,6
77180,2,2378,2441,-63,0,112,0,6
77181,1,2556,2271,285,0,325,0,6
77182,2,2379,2419,-40,0,406,0,6
77183,1,2423,2277,146,0,133,0,6
77184,1,2437,2333,104,0,335,0,6
77185,2,2431,2549,-118,0,414,0,6
77186,1,2519,2336,183,0,110,0,6
77187,1,2486,2289,197,0,334,0,6
77188,1,2466,2313,153,0,180,0,6
77189,1,2624,2547,77,0,123,0,6
77190,1,2428,2536,-108,0,202,0,6
77191,2,2298,2410,-112,0,106,1,6
77192,1,2577,2553,24,0,100,0,6
77193,2,2207,2444,-237,0,122,0,6
77194,1,2439,2502,-63,0,245,0,6
77195,1,2509,2483,26,0,231,0,6
77196,2,2324,2509,-185,0,4,0,6
77197,1,2317,2411,-94,0,243,0,6
77198,2,2477,2351,126,0,44,0,6
77199,2,2345,2478,-133,0,106,1,6
77200,3,2467,2493,-26,0,311,0,6
77201,2,2236,2592,-356,0,317,0,6
77202,1,2515,2345,170,0,405,0,6
77203,1,2421,2458,-37,0,122,1,6
77204,2,2233,2437,-204,0,130,1,6
77205,3,2542,2456,86,0,44,0,6
77206,2,2475,2545,-70,0,1,0,6
77207,3,2468,2312,156,0,123,0,6
77208,1,2424,2414,10,0,45,0,6
77209,1,2485,2436,49,0,56,0,6
77210,1,2400,2491,-91,0,40,0,6
77211,1,2304,2474,-170,0,202,0,6
77212,2,2447,2324,123,0,315,1,6
77213,2,2464,2442,22,0,302,0,6
77214,2,2403,2345,58,0,260,0,6
77215,1,2553,2316,237,0,122,0,6
77216,1,2435,2334,101,0,104,0,6
77217,2,2286,2434,-148,0,40,0,6
77218,1,2222,2431,-209,0,1,0,6
77219,2,2349,2494,-145,0,118,1,6
77220,3,2477,2509,-32,0,112,0,6
77221,2,2335,2425,-90,0,201,0,6
77222,1,2313,2531,-218,0,100,0,6
77223,1,2254,2426,-172,0,20,1,6
77224,3,2715,2548,167,0,49,0,6
77225,3,2403,2501,-98,0,88,0,6
77226,2,2498,2618,-120,0,4,0,6
77227,2,2387,2506,-119,0,141,0,6
77228,2,2451,2311,140,0,311,0,6
77229,2,2366,2505,-139,0,110,1,6
77230,1,2503,2422,81,0,244,1,6
77231,1,2245,2429,-184,0,302,0,6
77232,1,2476,2318,158,0,306,0,8
77233,1,2412,2278,134,0,41,0,6
77234,1,2501,2336,165,0,42,0,6
77235,2,2504,2530,-26,0,469,0,6
77236,1,2528,2367,161,0,45,0,6
77237,1,2821,2436,385,0,205,0,6
77238,2,2327,2444,-117,0,301,0,6
77239,1,2394,2426,-32,0,121,1,6
77240,2,2557,2529,28,0,110,1,6
77241,2,2280,2417,-137,0,57,0,6
77242,2,2438,2496,-58,0,7,0,6
77243,3,2263,2409,-146,0,200,0,6
77244,1,2558,2287,271,0,302,0,6
77245,1,2726,2201,525,0,7,1,6
77246,3,2394,2423,-29,0,1,0,6
77247,1,2468,2556,-88,0,303,0,6
77248,3,2570,2538,32,0,40,0,6
77249,1,2435,2266,169,0,107,0,6
77250,1,2498,2243,255,0,469,0,6
77251,2,2492,2379,113,0,306,0,6
77252,2,2249,2428,-179,0,133,0,6
77253,2,2392,2557,-165,0,5,0,6
77254,2,2354,2528,-174,0,44,1,6
77255,1,2254,2516,-262,0,140,0,6
77256,2,2405,2267,138,0,6,0,6
77257,2,2564,2287,277,0,200,0,6
77258,1,2517,2322,195,0,28,0,6
77259,3,2379,2802,-423,0,123,0,6
77260,1,2579,2200,379,0,218,0,6
77261,1,2438,2463,-25,0,400,0,6
77262,2,2449,2361,88,0,300,0,6
77263,2,2208,2440,-232,0,462,0,6
77264,1,2361,2482,-121,0,201,0,6
77265,1,2522,2429,93,0,106,0,6
77266,2,2377,2524,-147,0,310,0,6
77267,1,2469,2352,117,0,432,0,6
77268,1,2454,2354,100,0,487,0,6
77269,1,2516,2427,89,0,200,0,6
77270,2,2447,2451,-4,0,218,0,6
77271,1,2517,2457,60,0,211,0,6
77272,1,2532,2340,192,0,301,0,6
77273,1,2315,2420,-105,0,120,0,6
77274,2,2402,2298,104,0,306,0,6
77275,1,2523,2478,45,0,7,0,6
77276,1,2322,2470,-148,0,255,0,6
77277,1,2436,2602,-166,0,320,0,6
77278,1,2503,2360,143,0,310,0,6
77279,2,2315,2621,-306,0,310,0,6
77280,2,2511,2587,-76,0,96,1,6
77281,1,2439,2671,-232,0,40,0,6
77282,1,2556,2520,36,0,43,0,6
77283,1,2441,2548,-107,0,100,0,6
77284,1,2520,2378,142,0,45,0,6
77285,1,2582,2462,120,0,190,0,6
77286,2,2308,2425,-117,0,122,0,6
77287,2,2430,2389,41,0,300,0,8
77288,2,2499,2463,36,0,101,1,6
77289,2,2273,2485,-212,0,202,0,6
77290,1,2453,2455,-2,0,394,0,6
77291,3,2443,2457,-14,0,135,0,6
77292,1,2744,2452,292,0,331,0,6
77293,2,2449,2679,-230,0,41,0,6
77294,1,2662,2533,129,0,234,0,6
77295,2,2282,2407,-125,0,302,1,6
77296,1,2429,2303,126,0,122,0,6
77297,2,2433,2433,0,0,101,0,8
77298,1,2480,2330,150,0,202,0,6
77299,3,2430,2527,-97,0,4,0,6
77300,2,2604,2648,-44,0,13,0,6
77301,1,2533,2307,226,0,409,0,6
77302,1,2352,2442,-90,0,123,0,6
77303,1,2413,2427,-14,0,1,1,6
77304,3,2295,2463,-168,0,213,0,6
77305,1,2414,2413,1,0,248,0,6
77306,1,2337,2508,-171,0,200,0,6
77307,2,2452,2378,74,0,89,0,6
77308,3,2283,2734,-451,0,150,0,6
77309,3,2621,2330,291,0,221,0,6
77310,1,2463,2248,215,0,100,0,6
77311,1,2324,2494,-170,0,213,0,6
77312,1,2448,2310,138,0,123,0,6
77313,3,2363,2628,-265,0,57,0,6
77314,1,2542,2532,10,0,200,0,6
77315,2,2508,2577,-69,0,4,0,6
77316,2,2217,2542,-325,0,41,1,6
77317,3,2490,2495,-5,0,138,0,6
77318,3,2456,2502,-46,0,41,0,6
77319,1,2494,2294,200,0,44,0,6
77320,1,2436,2446,-10,0,386,0,6
77321,2,2506,2560,-54,0,211,0,6
77322,1,2496,2285,211,0,223,0,6
77323,2,2508,2542,-34,0,246,0,6
77324,1,2232,2509,-277,0,120,1,6
77325,2,2460,2505,-45,0,338,0,6
77326,2,2298,2575,-277,0,113,0,6
77327,3,2466,2327,139,4,373,0,13
77328,2,2401,2452,-51,0,292,1,6
77329,2,2253,2570,-317,0,344,0,6
77330,2,2307,2438,-131,0,62,0,6
77331,1,2694,2419,275,0,100,0,6
77332,1,2438,2401,37,0,400,1,6
77333,1,2528,2385,143,0,456,0,6
77334,1,2592,2520,72,0,284,0,6
77335,2,2657,2580,77,0,0,0,6
77336,1,2423,2482,-59,0,484,0,6
77337,2,2513,2520,-7,0,21,0,6
77338,1,2444,2430,14,0,394,0,6
77339,1,2685,2280,405,0,10,0,6
77340,1,2555,2536,19,0,122,1,6
77341,2,2222,2550,-328,0,100,0,6
77342,1,2553,2427,126,0,195,1,6
77344,1,2546,2281,265,0,374,0,6
77345,1,2395,2583,-188,0,211,0,6
77346,1,2412,2531,-119,0,331,0,6
77347,2,2569,2474,95,0,345,0,6
77348,1,2481,2370,111,0,454,0,6
77349,2,2324,2408,-84,0,45,0,6
77350,2,2285,2424,-139,0,46,1,6
77351,1,2481,2333,148,0,132,1,6
77352,1,2386,2538,-152,0,45,1,6
77353,1,2485,2598,-113,0,310,1,6
77354,2,2291,2593,-302,0,248,0,6
77355,1,2480,2212,268,0,41,1,6
77356,1,2488,2284,204,0,112,0,6
77357,1,2557,2306,251,0,41,0,6
77358,3,2400,2222,178,0,200,0,6
77359,1,2407,2298,109,0,210,1,6
77360,1,2524,2397,127,0,152,0,6
77361,1,2275,2423,-148,0,49,0,6
77362,2,2506,2471,35,0,40,0,6
77363,1,2550,2532,18,0,130,0,6
77364,1,2282,2453,-171,0,45,0,6
77365,2,2444,2320,124,0,261,0,6
77366,1,2407,2420,-13,0,104,0,6
77367,3,2418,2432,-14,0,330,0,6
77368,1,2482,2465,17,0,132,0,6
77369,2,2498,2661,-163,0,115,0,6
77370,3,2403,2523,-120,0,201,0,6
77371,2,2373,2512,-139,0,30,0,6
77372,2,2588,2434,154,0,28,0,6
77373,3,2412,2476,-64,0,106,0,6
77374,1,2631,2613,18,0,10,1,6
77375,1,2457,2523,-66,0,264,0,6
77376,1,2457,2333,124,0,112,0,6
77377,2,2456,2246,210,0,217,0,6
77378,3,2384,2522,-138,0,120,0,6
77379,2,2224,2421,-197,0,230,1,8
77380,1,2335,2486,-151,4,129,0,13
77381,2,2482,2729,-247,0,4,0,6
77382,2,2538,2465,73,0,43,0,6
77383,2,2528,2570,-42,0,148,0,6
77384,2,2443,2348,95,0,41,1,6
77385,1,2432,2535,-103,0,131,0,6
77386,2,2484,2384,100,0,112,1,6
77387,1,2797,2407,390,0,190,0,6
77388,2,2287,2446,-159,0,128,0,6
77389,3,2353,2407,-54,0,110,0,6
77390,1,2368,2502,-134,0,110,0,6
77391,2,2458,2412,46,0,176,0,6
77392,3,2442,2586,-144,0,123,0,6
77393,1,2490,2362,128,0,453,0,6
77394,2,2451,2390,61,0,6,1,6
77395,1,2412,2374,38,0,126,0,6
77396,1,2428,2295,133,0,140,0,6
77397,3,2421,2604,-183,0,352,0,6
77398,1,2414,2413,1,0,248,0,6
77399,3,2690,2747,-57,0,244,0,6
77400,2,2451,2567,-116,0,40,0,6
77401,3,2572,2470,102,0,460,0,6
77402,2,2313,2426,-113,0,85,0,6
77403,2,2313,2445,-132,0,256,0,6
77404,1,2482,2362,120,0,30,0,6
77405,1,2451,2459,-8,0,0,0,6
77406,1,2338,2558,-220,0,303,0,6
77408,1,2450,2546,-96,0,13,0,6
77409,2,2442,2293,149,0,41,1,6
77410,3,2440,2314,126,0,140,0,6
77411,1,2509,2361,148,0,106,0,6
77412,1,2362,2477,-115,0,0,0,6
77413,1,2631,2250,381,0,5,0,6
77414,2,2299,2475,-176,0,354,0,6
77415,1,2501,2421,80,0,151,0,6
77416,1,2433,2296,137,0,8,0,6
77417,2,2358,2577,-219,0,18,0,6
77418,2,2292,2443,-151,0,241,0,6
77419,2,2432,2372,60,0,156,0,6
77420,2,2406,2548,-142,0,111,0,6
77421,2,2414,2369,45,0,226,0,6
77422,1,2444,2342,102,0,302,0,6
77423,2,2526,2798,-272,0,120,0,6
77424,2,2220,2406,-186,0,1,1,6
77425,1,2506,2225,281,0,162,0,6
77426,1,2395,2424,-29,0,200,0,6
77427,1,2510,2400,110,0,119,0,6
77428,3,2571,2372,199,0,345,0,6
77429,2,2311,2401,-90,0,16,0,6
77430,1,2516,2531,-15,0,36,0,6
77431,1,2501,2267,234,0,250,0,6
77432,2,2405,2280,125,0,454,0,6
77433,2,2576,2372,204,0,1,1,6
77434,1,2438,2579,-141,0,115,0,6
77435,1,2263,2524,-261,0,226,0,6
77436,1,2387,2495,-108,0,127,0,6
77437,1,2372,2490,-118,0,4,0,6
77438,1,2403,2391,12,0,200,1,6
77439,1,2411,2478,-67,0,278,0,6
77440,2,2368,2413,-45,0,119,0,6
77441,1,2447,2241,206,0,490,0,6
77442,3,2457,2253,204,0,150,0,6
77443,3,2539,2515,24,0,100,0,6
77444,2,2346,2418,-72,0,476,0,6
77445,1,2551,2309,242,0,25,0,6
77446,2,2424,2403,21,0,247,0,6
77447,1,2574,2556,18,0,109,0,6
77448,1,2456,2269,187,0,192,0,6
77449,2,2434,2684,-250,0,20,0,6
77450,1,2627,2623,4,0,143,0,6
77451,2,2385,2433,-48,0,388,0,6
77452,3,2502,2374,128,0,123,0,6
77453,1,2259,2419,-160,0,48,0,6
77454,2,2550,2404,146,0,123,0,6
77455,2,2363,2713,-350,0,464,0,6
77456,2,2248,2500,-252,0,80,0,6
77457,2,2445,2507,-62,0,341,1,6
77458,2,2640,2460,180,0,490,0,6
77459,3,2406,2422,-16,0,227,0,8
77460,1,2314,2406,-92,0,264,1,6
77461,2,2459,2528,-69,0,7,0,6
77462,2,2380,2457,-77,0,1,0,6
77463,1,2371,2443,-72,0,57,0,6
77464,2,2431,2336,95,0,462,0,6
77465,1,2360,2415,-55,0,5,0,6
77466,2,2303,2508,-205,0,46,0,6
77467,1,2449,2359,90,0,319,0,6
77468,2,2403,2452,-49,0,112,1,6
77469,2,2516,2822,-306,0,49,0,6
77470,2,2535,2571,-36,0,112,0,6
77471,2,2447,2596,-149,0,80,0,6
77472,3,2486,2448,38,0,29,0,6
77473,2,2277,2412,-135,0,46,0,6
77474,1,2601,2505,96,0,40,0,6
77475,3,2322,2490,-168,0,40,0,6
77476,3,2442,2340,102,0,250,0,6
77477,2,2509,2303,206,0,200,0,6
77478,2,2321,2548,-227,0,42,0,6
77479,1,2435,2431,4,0,201,0,6
77480,2,2544,2426,118,0,16,1,6
77481,2,2335,2445,-110,0,398,0,6
77482,1,2594,2510,84,0,267,0,6
77483,2,2427,2363,64,0,331,0,6
77484,1,2455,2320,135,0,330,1,6
77485,1,2446,2278,168,0,205,0,6
77486,1,2358,2485,-127,0,207,0,6
77487,2,2226,2446,-220,0,106,0,6
77488,1,2311,2522,-211,0,330,0,6
77489,2,2528,2486,42,0,41,0,6
77490,2,2549,2439,110,0,375,0,6
77491,3,2595,2446,149,0,214,0,6
77492,2,2475,2207,268,0,49,1,6
77493,2,2442,2333,109,0,1,1,6
77494,1,2503,2417,86,0,241,1,6
77495,2,2519,2360,159,0,405,0,6
77496,3,2347,2442,-95,0,35,0,6
77497,2,2548,2507,41,0,277,1,6
77498,1,2527,2552,-25,0,107,0,6
77499,3,2600,2665,-65,0,337,0,6
77500,2,2451,2403,48,0,46,0,6
77501,1,2335,2400,-65,0,108,0,6
77502,2,2440,2560,-120,0,6,0,6
77503,2,2276,2427,-151,0,57,0,6
77504,1,2452,2231,221,0,40,0,6
77505,2,2444,2599,-155,0,113,0,6
77506,3,2653,2664,-11,0,113,0,6
77507,3,2515,2449,66,0,205,0,6
77508,2,2429,2495,-66,0,255,0,6
77509,1,2584,2606,-22,0,255,0,6
77510,3,2501,2368,133,0,61,0,6
77511,2,2442,2287,155,0,167,0,6
77512,2,2393,2418,-25,0,29,0,6
77513,2,2237,2446,-209,0,106,1,6
77514,2,2410,2362,48,0,122,0,6
77515,1,2310,2416,-106,0,416,0,6
77516,2,2242,2408,-166,0,15,0,6
77517,2,2515,2695,-180,0,84,0,6
77518,1,2472,2341,131,0,301,0,6
77519,2,2575,2394,181,0,46,0,6
77520,2,2530,2528,2,0,244,0,6
77521,1,2473,2531,-58,0,461,0,6
77522,1,2323,2523,-200,0,154,0,6
77523,2,2206,2625,-419,0,15,0,6
77524,1,2418,2324,94,0,459,0,6
77525,2,2296,2527,-231,0,302,1,6
77526,2,2565,2331,234,0,41,0,6
77527,1,2289,2501,-212,0,112,0,6
77528,3,2436,2500,-64,0,40,0,6
77529,1,2580,2617,-37,0,156,0,6
77530,2,2352,2447,-95,0,121,0,6
77531,2,2461,2437,24,0,170,0,6
77532,1,2504,2424,80,0,115,0,6
77533,1,2418,2377,41,0,45,1,6
77534,1,2550,2290,260,0,246,0,6
77535,2,2445,2333,112,0,46,0,6
77536,2,2440,2308,132,0,132,0,6
77537,2,2402,2370,32,0,130,0,6
77538,1,2434,2226,208,0,113,0,6
77539,1,2225,2415,-190,0,245,1,6
77540,2,2447,2396,51,0,106,1,6
77541,1,2287,2411,-124,0,37,0,6
77542,2,2541,2342,199,0,483,0,6
77543,2,2405,2256,149,0,115,0,6
77544,2,2322,2437,-115,0,190,0,6
77545,2,2401,2443,-42,0,45,0,6
77546,2,2576,2650,-74,0,49,0,6
77547,1,2587,2746,-159,0,246,1,6
77548,1,2427,2369,58,0,394,0,6
77549,2,2507,2550,-43,0,46,0,6
77550,3,2380,2536,-156,0,331,0,6
77551,3,2311,2491,-180,0,120,0,6
77552,2,2333,2453,-120,0,40,0,6
77553,3,2484,2504,-20,0,120,0,6
77554,3,2478,2345,133,0,267,0,6
77555,2,2334,2696,-362,0,123,0,6
77556,2,2306,2432,-126,0,127,0,6
77557,2,2524,2432,92,0,2,0,6
77558,3,2800,2691,109,0,4,0,6
77559,2,2546,2824,-278,0,112,0,6
77560,2,2689,2514,175,0,45,0,6
77561,3,2373,2524,-151,0,337,0,6
77562,3,2470,2256,214,0,121,0,6
77563,1,2473,2375,98,0,40,0,6
77564,1,2449,2303,146,0,106,0,6
77565,2,2402,2454,-52,0,49,1,6
77566,3,2483,2376,107,0,315,0,6
77567,1,2289,2454,-165,0,4,0,6
77568,2,2263,2436,-173,0,13,1,6
77569,3,2412,2355,57,0,40,0,6
77570,2,2299,2480,-181,0,57,0,6
77571,2,2514,2714,-200,0,248,0,6
77572,2,2525,2476,49,0,46,0,6
77573,3,2413,2280,133,0,8,0,6
77574,3,2338,2417,-79,0,100,0,6
77575,3,2537,2532,5,0,111,0,6
77576,1,2537,2430,107,0,89,0,6
77577,2,2476,2572,-96,0,241,1,6
77578,1,2408,2419,-11,0,104,0,6
77579,1,2461,2332,129,4,343,0,13
77580,2,2211,2409,-198,0,201,0,6
77581,2,2613,2582,31,0,4,0,6
77582,2,2403,2419,-16,0,453,1,6
77583,1,2499,2527,-28,0,4,0,6
77584,3,2387,2534,-147,0,34,0,6
77585,1,2457,2470,-13,0,6,0,6
77586,1,2549,2352,197,0,8,1,6
77587,3,2488,2454,34,0,113,0,6
77588,3,2425,2440,-15,0,242,0,6
77589,2,2404,2227,177,0,8,0,6
77590,3,2233,2499,-266,0,112,0,6
77591,1,2500,2463,37,0,143,0,6
77592,2,2591,2538,53,0,345,0,6
77593,1,2370,2491,-121,0,380,0,6
77594,3,2418,2245,173,0,153,0,6
77595,1,2317,2443,-126,0,300,0,6
77596,2,2248,2500,-252,0,126,0,6
77597,2,2502,2492,10,0,200,0,6
77598,3,2522,2567,-45,0,300,0,6
77599,3,2403,2263,140,0,40,0,6
77600,2,2403,2355,48,0,123,0,6
77601,2,2423,2557,-134,0,175,0,6
77602,2,2260,2505,-245,0,311,0,6
77603,1,2417,2321,96,0,201,1,6
77604,2,2525,2522,3,0,215,1,6
77605,1,2408,2278,130,0,7,1,6
77606,2,2275,2552,-277,0,218,1,6
77607,3,2484,2437,47,0,150,0,6
77608,2,2411,2561,-150,0,330,0,6
77609,2,2249,2654,-405,0,344,0,6
77610,1,2452,2278,174,0,49,0,6
77611,2,2273,2499,-226,0,123,1,6
77612,1,2624,2271,353,0,43,0,6
77613,3,2413,2534,-121,0,10,0,6
77614,3,2338,2543,-205,0,292,0,6
77615,3,2525,2355,170,0,104,0,6
77616,2,2280,2432,-152,0,253,0,6
77617,2,2438,2264,174,0,5,0,6
77618,2,2405,2457,-52,0,207,0,6
77619,1,2420,2214,206,0,359,0,6
77621,1,2449,2386,63,0,241,1,6
77622,2,2427,2287,140,0,213,0,6
77623,2,2314,2441,-127,0,153,1,6
77624,1,2608,2698,-90,0,112,1,6
77625,2,2269,2432,-163,0,248,0,6
77626,3,2412,2412,0,0,7,0,6
77627,1,2562,2512,50,0,40,0,6
77628,2,2421,2489,-68,0,301,0,6
77629,1,2414,2414,0,0,246,0,6
77630,3,2617,2632,-15,0,311,0,6
77632,1,2416,2362,54,0,316,0,6
77633,2,2397,2445,-48,0,140,0,6
77634,2,2423,2314,109,0,200,1,6
77635,3,2469,2511,-42,0,120,0,6
77636,3,2409,2569,-160,0,101,0,6
77637,1,2512,2524,-12,0,132,0,6
77638,2,2420,2448,-28,0,1,0,6
77639,1,2244,2421,-177,0,256,0,6
77640,1,2368,2436,-68,0,123,0,6
77641,1,2328,2438,-110,0,122,0,6
77642,1,2550,2487,63,0,31,0,6
77643,1,2521,2376,145,0,132,0,6
77644,1,2440,2425,15,0,253,0,6
77645,2,2565,2463,102,0,307,0,6
77646,1,2409,2317,92,0,106,1,6
77647,1,2317,2471,-154,0,0,0,6
77648,2,2455,2672,-217,0,398,0,6
77649,1,2460,2423,37,0,410,0,6
77650,1,2408,2419,-11,0,105,0,6
77651,1,2435,2298,137,0,107,0,6
77652,2,2569,2616,-47,0,13,1,6
77653,1,2432,2407,25,0,132,1,6
77654,1,2379,2416,-37,0,300,1,6
77655,1,2348,2402,-54,0,190,0,6
77656,2,2528,2520,8,0,36,0,6
77657,1,2402,2484,-82,0,302,0,6
77658,1,2483,2397,86,0,331,1,6
77659,2,2545,2584,-39,0,106,1,6
77660,1,2610,2425,185,0,45,0,6
77661,1,2426,2440,-14,0,310,0,6
77662,1,2607,2586,21,0,4,0,6
77663,1,2420,2446,-26,0,242,0,6
77664,3,2481,2674,-193,0,245,0,6
77665,2,2460,2412,48,0,211,0,6
77666,1,2414,2419,-5,0,41,0,6
77667,3,2567,2369,198,0,330,0,6
77668,2,2367,2412,-45,0,5,0,6
77669,1,2554,2307,247,0,211,0,6
77670,1,2446,2274,172,0,8,0,6
77671,1,2288,2464,-176,0,46,0,6
77672,1,2490,2371,119,0,250,0,6
77673,2,2403,2590,-187,0,22,0,6
77674,1,2601,2613,-12,0,200,0,6
77675,2,2335,2463,-128,0,120,0,6
77676,1,2305,2418,-113,0,277,0,8
77677,1,2406,2450,-44,0,104,0,6
77678,1,2508,2327,181,0,315,0,6
77679,1,2691,2518,173,0,133,0,6
77680,1,2445,2380,65,0,148,0,6
77681,2,2425,2510,-85,0,150,0,6
77682,2,2414,2414,0,0,107,0,6
77683,1,2470,2541,-71,0,110,0,6
77684,2,2417,2518,-101,0,301,1,6
77685,1,2415,2294,121,0,42,0,6
77686,2,2467,2332,135,0,40,0,6
77687,2,2494,2415,79,0,80,0,6
77689,1,2557,2435,122,0,485,0,6
77690,2,2439,2426,13,0,295,0,6
77691,2,2418,2323,95,0,4,0,6
77692,2,2445,2455,-10,0,297,0,6
77693,1,2632,2618,14,0,448,0,6
77694,1,2561,2404,157,0,0,1,6
77695,2,2422,2613,-191,0,353,0,6
77696,1,2418,2327,91,0,45,1,6
77697,1,2287,2454,-167,0,200,0,6
77698,3,2266,2417,-151,0,132,0,6
77699,2,2482,2555,-73,0,245,1,6
77700,1,2671,2434,237,0,35,1,6
77701,1,2526,2522,4,0,215,0,6
77702,2,2372,2457,-85,0,405,0,6
77703,1,2564,2420,144,0,310,0,6
77704,3,2381,2483,-102,0,80,0,6
77705,2,2484,2515,-31,0,101,0,6
77706,2,2417,2382,35,0,112,0,6
77707,2,2420,2408,12,0,100,0,6
77708,1,2616,2419,197,0,301,0,6
77709,2,2367,2411,-44,0,45,0,6
77710,2,2354,2557,-203,0,46,0,6
77711,1,2393,2488,-95,0,302,0,6
77712,2,2376,2539,-163,0,245,0,6
77713,3,2589,2607,-18,0,102,0,6
77714,1,2441,2332,109,0,0,0,6
77715,2,2505,2407,98,0,472,0,6
77716,2,2393,2437,-44,0,302,0,6
77717,1,2593,2400,193,0,181,0,6
77718,3,2525,2434,91,0,152,0,6
77719,1,2468,2345,123,0,104,0,6
77720,1,2425,2265,160,0,245,0,6
77721,1,2492,2396,96,0,36,1,6
77722,1,2516,2531,-15,0,14,0,6
77723,2,2419,2366,53,0,373,0,6
77724,2,2375,2449,-74,0,123,0,6
77725,1,2439,2349,90,0,4,0,6
77726,1,2514,2402,112,0,463,1,6
77727,1,2390,2452,-62,0,110,0,6
77728,2,2262,2428,-166,0,217,0,6
77729,1,2534,2428,106,0,42,0,6
77730,2,2414,2414,0,0,121,0,6
77731,3,2445,2522,-77,0,7,0,6
77732,2,2416,2619,-203,0,353,1,6
77733,1,2431,2413,18,0,237,0,6
77734,2,2454,2416,38,0,388,0,6
77735,3,2454,2305,149,0,28,0,6
77736,1,2426,2285,141,0,125,0,6
77737,2,2372,2459,-87,0,122,0,6
77738,2,2400,2356,44,0,462,0,6
77739,1,2422,2557,-135,0,120,1,6
77740,2,2487,2415,72,0,330,0,6
77741,1,2543,2416,127,0,5,0,6
77742,2,2612,2615,-3,0,335,0,6
77743,1,2520,2410,110,0,244,1,6
77744,1,2461,2454,7,0,404,0,6
77745,1,2367,2441,-74,0,344,0,6
77746,1,2510,2303,207,0,268,0,6
77747,1,2525,2323,202,0,301,0,6
77748,2,2232,2523,-291,0,36,1,6
77749,1,2389,2410,-21,0,56,1,6
77750,1,2420,2473,-53,0,45,0,6
77751,1,2410,2259,151,0,202,0,8
77752,1,2401,2271,130,0,310,0,6
77753,1,2404,2353,51,0,255,0,6
77754,1,2423,2250,173,0,46,0,6
77755,2,2414,2323,91,0,485,1,6
77756,1,2322,2445,-123,0,420,0,6
77757,2,2316,2445,-129,0,40,0,6
77758,1,2431,2258,173,0,245,0,6
77759,1,2674,2476,198,0,491,0,6
77760,2,2291,2413,-122,0,374,0,6
77761,2,2420,2408,12,0,40,0,6
77762,1,2431,2480,-49,0,111,0,6
77763,2,2436,2523,-87,0,331,0,6
77764,1,2525,2522,3,0,215,0,6
77765,1,2423,2448,-25,0,7,0,6
77766,2,2322,2406,-84,0,242,0,8
77767,2,2694,2638,56,0,121,0,6
77768,3,2400,2477,-77,0,487,0,6
77769,2,2471,2606,-135,0,46,0,6
77770,1,2308,2438,-130,0,45,1,6
77771,1,2389,2443,-54,0,343,0,6
77772,1,2290,2409,-119,0,49,1,6
77773,2,2442,2380,62,0,131,0,6
77774,1,2596,2590,6,0,106,0,6
77775,2,2414,2414,0,0,320,0,6
77776,2,2454,2496,-42,0,216,0,6
77777,1,2397,2403,-6,0,190,0,6
77778,1,2460,2408,52,0,29,1,6
77779,3,2539,2560,-21,0,245,0,6
77780,2,2518,2478,40,0,57,0,6
77781,1,2438,2330,108,0,15,0,6
77782,1,2424,2267,157,0,54,0,6
77783,1,2420,2408,12,0,0,0,6
77784,2,2300,2422,-122,0,6,0,6
77785,1,2456,2397,59,0,402,1,6
77786,1,2494,2440,54,0,426,0,6
77787,1,2426,2366,60,0,43,1,6
77788,2,2432,2235,197,0,395,0,6
77789,1,2538,2547,-9,0,245,0,6
77790,1,2449,2379,70,0,202,0,6
77791,2,2435,2373,62,0,380,1,6
77792,1,2387,2464,-77,0,140,0,6
77793,1,2778,2697,81,0,386,0,6
77794,2,2481,2374,107,0,331,0,6
77795,2,2620,2645,-25,0,308,0,6
77796,2,2417,2340,77,0,100,0,6
77797,2,2517,2531,-14,0,14,0,6
77798,3,2255,2434,-179,0,209,0,6
77799,1,2363,2467,-104,0,354,0,6
77800,3,2370,2498,-128,0,394,0,6
77801,2,2474,2438,36,0,35,0,6
77802,1,2524,2430,94,0,200,0,6
77803,1,2797,2607,190,0,404,0,6
77804,3,2414,2428,-14,0,485,0,6
77805,1,2549,2417,132,0,330,1,6
77806,2,2412,2242,170,0,40,0,6
77807,1,2406,2389,17,0,0,0,6
77808,2,2476,2479,-3,0,190,1,6
77809,2,2528,2431,97,0,192,0,6
77810,1,2401,2404,-3,0,484,1,6
77811,1,2399,2513,-114,0,46,0,6
77812,1,2392,2528,-136,0,300,0,6
77813,2,2687,2599,88,0,130,0,6
77814,1,2449,2326,123,0,185,0,6
77815,2,2271,2575,-304,2,140,0,24
77816,2,2223,2555,-332,0,100,0,6
77817,2,2383,2451,-68,0,45,0,6
77819,1,2429,2379,50,0,374,0,6
77820,2,2514,2474,40,0,463,0,6
77821,2,2566,2528,38,0,161,0,6
77822,1,2407,2473,-66,0,52,0,6
77823,2,2307,2410,-103,0,184,1,8
77824,1,2457,2394,63,0,45,0,6
77825,2,2677,2687,-10,0,88,0,6
77826,1,2442,2338,104,0,15,0,6
77827,2,2453,2372,81,0,144,0,6
77828,1,2584,2602,-18,0,302,1,6
77829,1,2426,2382,44,0,1,0,6
77830,1,2431,2325,106,0,211,1,6
77831,2,2693,2783,-90,0,250,0,6
77832,2,2521,2512,9,0,405,1,6
77833,1,2651,2614,37,0,45,0,6
77834,1,2541,2478,63,0,106,0,6
77835,1,2544,2378,166,0,170,0,6
77836,2,2409,2436,-27,0,211,0,6
77837,2,2410,2242,168,0,102,1,8
77838,2,2437,2394,43,0,15,0,6
77839,1,2267,2401,-134,0,302,1,6
77840,2,2377,2431,-54,0,404,0,6
77841,3,2397,2480,-83,0,311,0,6
77843,1,2408,2239,169,0,418,0,6
77844,2,2323,2431,-108,0,101,0,6
77845,1,2450,2324,126,0,127,0,6
77846,1,2621,2680,-59,0,247,0,6
77847,1,2556,2377,179,0,130,0,6
77848,2,2537,2511,26,0,215,1,6
77849,2,2307,2449,-142,0,200,0,6
77850,1,2451,2465,-14,0,250,1,6
77851,1,2689,2604,85,0,133,0,6
77852,3,2471,2327,144,4,36,0,11
77853,2,2347,2410,-63,0,0,0,6
77854,1,2376,2424,-48,0,41,0,6
77855,2,2434,2403,31,0,5,0,6
77856,2,2435,2461,-26,0,202,0,6
77857,1,2560,2540,20,0,337,0,6
77858,2,2341,2428,-87,0,11,0,6
77859,2,2462,2671,-209,0,123,0,6
77860,2,2412,2471,-59,0,216,0,6
77861,1,2693,2559,134,0,161,0,6
77862,1,2392,2468,-76,0,246,1,6
77863,1,2535,2414,121,0,170,0,6
77864,2,2473,2444,29,0,200,0,6
77865,1,2432,2258,174,0,168,0,6
77866,1,2470,2224,246,0,46,1,6
77868,2,2359,2420,-61,0,112,0,6
77869,2,2399,2407,-8,0,414,0,6
77870,2,2552,2564,-12,0,306,0,6
77871,2,2283,2404,-121,0,106,0,6
77872,1,2338,2505,-167,0,120,1,6
77873,1,2520,2218,302,0,301,0,6
77874,3,2407,2424,-17,0,0,0,6
77875,1,2527,2400,127,0,106,0,6
77876,2,2461,2361,100,0,44,0,6
77877,2,2389,2507,-118,0,34,1,6
77878,1,2399,2447,-48,0,455,0,6
77879,2,2466,2378,88,0,241,0,6
77880,3,2599,2693,-94,0,335,0,6
77881,2,2674,2787,-113,0,278,0,6
77882,2,2436,2439,-3,0,260,0,6
77883,2,2240,2406,-166,0,80,0,6
77884,1,2452,2416,36,0,311,0,8
77885,3,2446,2427,19,0,43,0,6
77886,1,2414,2333,81,0,485,0,6
77887,2,2596,2590,6,0,0,1,6
77888,1,2435,2375,60,0,1,0,6
77889,3,2319,2463,-144,0,41,0,6
77890,2,2203,2492,-289,0,40,0,6
77891,2,2321,2446,-125,0,46,0,6
77892,1,2480,2320,160,0,101,0,6
77893,1,2372,2515,-143,0,385,1,6
77894,1,2283,2436,-153,0,200,0,6
77895,2,2227,2560,-333,0,100,0,6
77896,1,2462,2319,143,0,248,0,6
77897,2,2609,2590,19,0,30,0,6
77898,1,2454,2327,127,0,40,0,6
77899,1,2409,2374,35,0,40,0,6
77900,2,2369,2402,-33,0,455,1,6
77901,2,2475,2376,99,0,151,0,6
77902,1,2432,2440,-8,0,415,0,6
77903,3,2246,2420,-174,0,117,0,6
77904,2,2414,2342,72,0,0,1,6
77905,2,2517,2531,-14,0,14,0,6
77906,1,2560,2408,152,0,180,0,6
77907,1,2443,2496,-53,0,4,0,6
77908,1,2428,2397,31,0,5,0,6
77909,3,2478,2400,78,0,4,0,6
77910,1,2656,2697,-41,0,83,1,6
77911,2,2534,2551,-17,0,140,0,6
77912,2,2375,2539,-164,0,135,0,6
77913,2,2410,2409,1,0,350,1,6
77914,1,2453,2211,242,0,106,1,8
77915,1,2399,2528,-129,0,134,0,6
77916,1,2433,2449,-16,0,45,1,6
77917,2,2461,2466,-5,0,10,1,6
77918,1,2328,2419,-91,0,4,1,6
77919,1,2460,2417,43,0,106,0,6
77920,1,2275,2477,-202,0,302,0,6
77921,1,2791,2670,121,0,381,0,6
77922,1,2544,2460,84,0,14,1,6
77923,2,2380,2458,-78,0,55,0,6
77924,1,2454,2320,134,0,218,0,6
77925,2,2414,2279,135,0,263,0,8
77926,2,2239,2434,-195,0,340,0,6
77927,1,2450,2318,132,0,113,0,6
77928,1,2408,2216,192,0,405,0,6
77929,3,2396,2407,-11,0,41,0,6
77930,1,2507,2531,-24,0,132,0,6
77931,2,2413,2444,-31,0,487,0,6
77932,1,2511,2356,155,0,404,0,6
77933,2,2427,2610,-183,0,75,0,6
77934,1,2692,2601,91,0,187,0,6
77935,1,2482,2465,17,0,147,1,6
77936,1,2453,2430,23,0,140,0,6
77937,2,2287,2414,-127,0,115,0,6
77938,2,2529,2518,11,0,168,0,6
77939,3,2441,2251,190,0,105,0,8
77940,3,2472,2430,42,0,201,0,6
77941,2,2386,2459,-73,0,45,1,6
77942,1,2596,2590,6,0,113,0,6
77943,1,2536,2512,24,0,215,0,6
77944,1,2285,2438,-153,0,303,0,6
77945,1,2434,2273,161,0,469,0,6
77946,2,2435,2456,-21,0,163,1,6
77947,1,2494,2280,214,0,310,0,6
77948,1,2332,2405,-73,0,8,1,6
77949,2,2422,2266,156,0,404,0,8
77950,1,2461,2321,140,0,250,0,6
77951,2,2556,2685,-129,0,331,0,6
77952,2,2338,2561,-223,0,122,0,6
77953,1,2468,2460,8,0,211,0,6
77954,2,2552,2380,172,0,190,0,6
77955,1,2441,2413,28,0,277,0,6
77956,2,2430,2409,21,0,487,1,6
77957,2,2260,2415,-155,0,326,0,6
77958,2,2349,2408,-59,0,1,0,6
77959,3,2462,2375,87,0,45,0,6
77960,2,2404,2542,-138,0,101,0,6
77961,2,2407,2371,36,0,211,1,6
77962,2,2446,2507,-61,0,7,1,6
77963,1,2690,2563,127,0,112,0,6
77964,1,2387,2435,-48,0,45,0,6
77965,1,2428,2367,61,0,4,0,6
77966,2,2355,2474,-119,0,201,0,6
77967,2,2404,2567,-163,0,309,1,6
77968,2,2417,2396,21,0,303,0,6
77969,2,2375,2438,-63,0,200,1,6
77970,1,2443,2316,127,0,132,0,6
77971,1,2520,2454,66,0,335,1,6
77972,1,2471,2455,16,0,248,0,6
77973,1,2523,2542,-19,0,163,0,6
77974,2,2628,2666,-38,0,247,0,6
77975,1,2439,2366,73,0,140,0,6
77976,3,2597,2696,-99,0,203,0,6
77977,2,2460,2407,53,0,400,1,6
77978,3,2314,2454,-140,0,40,0,6
77979,3,2455,2548,-93,0,247,0,6
77980,1,2473,2417,56,0,263,0,8
77981,1,2488,2458,30,0,371,0,6
77982,1,2515,2392,123,0,3,1,6
77983,2,2450,2445,5,0,312,0,6
77984,2,2483,2547,-64,0,56,0,6
77985,3,2477,2397,80,0,207,0,6
77986,2,2450,2388,62,0,11,0,6
77987,2,2344,2408,-64,0,143,0,6
77988,1,2458,2248,210,0,365,1,8
77989,1,2296,2425,-129,0,40,1,6
77990,1,2424,2284,140,0,0,1,6
77991,3,2449,2295,154,0,109,0,6
77992,1,2419,2359,60,0,200,0,6
77993,1,2478,2408,70,0,132,0,6
77994,1,2290,2405,-115,0,311,0,6
77995,2,2403,2477,-74,0,373,1,6
77996,2,2214,2497,-283,0,17,0,6
77997,2,2407,2207,200,0,0,1,6
77998,2,2271,2411,-140,0,4,0,6
77999,1,2524,2426,98,0,110,0,6
78000,2,2523,2513,10,0,213,0,6
78001,1,2412,2388,24,0,360,0,6
78002,1,2658,2553,105,0,0,0,6
78003,2,2689,2795,-106,0,45,0,6
78004,2,2585,2602,-17,0,107,0,6
78005,3,2458,2427,31,0,107,0,6
78006,3,2209,2455,-246,0,242,0,8
78007,1,2461,2374,87,0,83,0,6
78009,2,2377,2476,-99,0,331,0,6
78010,2,2497,2339,158,0,484,0,6
78011,2,2430,2430,0,0,301,0,6
78012,2,2437,2444,-7,0,54,0,6
78013,2,2399,2694,-295,0,4,0,6
78014,2,2430,2470,-40,0,190,0,6
78015,2,2441,2368,73,0,253,0,6
78016,2,2425,2320,105,0,4,1,6
78017,1,2333,2424,-91,0,202,1,6
78018,3,2546,2571,-25,0,101,0,6
78019,2,2412,2344,68,0,101,1,6
78020,2,2301,2464,-163,0,36,0,6
78021,1,2489,2538,-49,0,380,0,6
78022,1,2401,2460,-59,0,107,0,6
78023,2,2378,2671,-293,0,250,0,6
78024,2,2401,2365,36,0,211,1,6
78025,2,2288,2433,-145,0,133,0,6
78026,2,2323,2583,-260,2,145,1,24
78027,1,2493,2547,-54,0,258,1,6
78028,2,2270,2406,-136,0,194,0,8
78029,2,2341,2482,-141,0,45,0,6
78030,2,2312,2447,-135,0,484,0,6
78031,1,2559,2457,102,0,338,1,6
78032,2,2442,2403,39,0,404,0,6
78033,2,2662,2565,97,0,301,1,6
78034,1,2450,2525,-75,0,124,0,6
78035,2,2413,2580,-167,0,107,1,6
78037,2,2312,2444,-132,0,260,0,6
78038,1,2408,2251,157,0,172,1,6
78039,2,2696,2473,223,0,240,1,6
78040,2,2389,2411,-22,0,130,1,6
78041,1,2451,2316,135,0,205,1,6
78042,2,2465,2398,67,0,43,0,6
78043,2,2512,2380,132,0,46,1,6
78044,2,2353,2446,-93,0,302,0,6
78045,3,2460,2443,17,0,313,0,6
78046,1,2799,2685,114,0,337,0,6
78047,2,2607,2579,28,0,1,0,6
78048,2,2400,2397,3,0,311,0,6
78049,1,2440,2367,73,0,43,0,6
78050,3,2217,2529,-312,0,131,0,6
78051,1,2422,2401,21,0,67,0,6
78052,2,2415,2519,-104,0,411,0,6
78053,1,2428,2401,27,0,0,1,6
78054,1,2450,2280,170,0,101,0,6
78055,2,2383,2437,-54,0,487,0,6
78056,3,2548,2662,-114,0,115,0,6
78057,2,2443,2486,-43,0,463,0,6
78058,2,2411,2467,-56,0,303,0,6
78059,2,2453,2407,46,0,341,1,6
78060,1,2436,2424,12,0,255,0,6
78061,3,2375,2434,-59,0,196,0,6
78062,1,2467,2288,179,0,20,0,6
78063,1,2349,2450,-101,0,302,0,6
78064,2,2401,2489,-88,0,302,1,6
78065,3,2570,2574,-4,0,45,0,6
78066,1,2536,2546,-10,0,101,0,6
78067,2,2409,2412,-3,0,224,0,6
78068,1,2517,2220,297,4,295,0,13
78069,3,2556,2623,-67,0,152,0,6
78070,2,2465,2483,-18,0,387,0,6
78071,1,2376,2492,-116,0,123,0,6
78072,1,2406,2245,161,0,462,0,6
78073,2,2450,2308,142,0,132,0,6
78074,2,2533,2477,56,0,345,0,6
78075,1,2417,2304,113,0,40,0,6
78076,1,2493,2360,133,0,212,1,6
78077,2,2340,2436,-96,0,122,0,6
78078,2,2224,2424,-200,0,237,1,6
78079,1,2410,2445,-35,0,302,0,6
78080,2,2673,2529,144,0,130,0,6
78081,2,2217,2519,-302,4,278,0,13
78082,1,2362,2486,-124,0,394,1,6
78083,1,2453,2540,-87,0,247,0,6
78084,1,2441,2412,29,0,4,0,6
78085,3,2603,2500,103,0,490,0,6
78086,1,2356,2478,-122,0,335,0,8
78087,1,2682,2584,98,0,241,1,6
78088,1,2518,2457,61,0,335,0,6
78089,1,2452,2212,240,0,108,0,8
78090,2,2403,2417,-14,0,40,1,6
78091,1,2372,2455,-83,0,49,1,6
78092,1,2277,2408,-131,0,302,0,6
78093,1,2451,2482,-31,0,311,0,6
78094,2,2285,2470,-185,0,394,0,6
78095,2,2491,2459,32,0,140,0,6
78096,2,2313,2417,-104,0,48,0,6
78097,1,2531,2425,106,0,200,0,6
78098,2,2622,2574,48,0,455,1,6
78099,2,2570,2687,-117,0,80,0,6
78100,1,2443,2317,126,0,45,0,6
78101,1,2681,2557,124,0,300,0,6
78102,2,2441,2378,63,0,14,0,6
78103,2,2241,2410,-169,0,345,0,6
78104,1,2431,2504,-73,0,101,1,6
78105,1,2410,2248,162,0,101,0,8
78106,3,2279,2411,-132,0,334,0,6
78107,1,2459,2415,44,0,484,0,6
78108,1,2452,2523,-71,0,124,1,6
78109,1,2443,2384,59,0,464,1,6
78110,1,2573,2438,135,0,7,0,6
78111,1,2407,2279,128,0,107,0,8
78112,1,2465,2441,24,0,45,0,6
78113,1,2540,2388,152,0,244,1,6
78114,2,2241,2418,-177,0,350,0,6
78115,1,2440,2285,155,0,315,0,6
78116,1,2396,2411,-15,0,40,0,6
78117,1,2427,2307,120,0,335,1,6
78118,1,2523,2222,301,0,200,0,6
78119,3,2525,2519,6,0,134,0,6
78120,2,2401,2208,193,0,474,1,8
78121,2,2396,2432,-36,0,380,0,6
78122,2,2335,2438,-103,0,10,0,6
78123,1,2433,2376,57,0,245,0,6
78124,2,2311,2493,-182,0,8,1,6
78125,1,2461,2491,-30,0,365,0,8
78126,3,2420,2404,16,0,201,0,6
78127,2,2210,2454,-244,0,300,0,8
78128,2,2316,2442,-126,0,484,0,6
78129,1,2435,2416,19,0,4,1,6
78130,2,2537,2542,-5,0,125,0,6
78131,1,2327,2404,-77,0,130,0,6
78132,2,2533,2685,-152,0,14,1,6
78133,2,2401,2385,16,0,300,0,6
78134,2,2418,2428,-10,0,46,1,6
78135,1,2450,2409,41,0,115,0,6
78136,1,2478,2588,-110,0,176,0,6
78137,2,2484,2447,37,0,112,0,6
78138,2,2357,2497,-140,0,1,1,6
78139,2,2450,2360,90,0,207,0,6
78140,1,2336,2492,-156,0,157,0,8
78141,1,2502,2602,-100,0,112,0,6
78142,2,2313,2415,-102,0,310,1,6
78143,2,2579,2686,-107,0,0,1,6
78144,1,2400,2433,-33,0,100,0,6
78145,1,2490,2360,130,0,100,0,6
78146,3,2360,2444,-84,0,40,0,6
78147,3,2397,2404,-7,0,49,0,6
78148,3,2476,2457,19,0,144,0,6
78149,1,2448,2379,69,0,331,0,6
78150,1,2472,2406,66,0,260,0,6
78151,1,2514,2540,-26,0,114,1,6
78152,2,2436,2566,-130,0,101,0,6
78153,2,2360,2426,-66,0,234,0,6
78154,1,2241,2403,-162,0,130,1,6
78155,1,2413,2238,175,0,37,0,6
78156,2,2435,2470,-35,0,140,0,6
78157,1,2421,2307,114,0,41,1,6
78158,2,2477,2529,-52,0,15,0,6
78159,2,2407,2365,42,0,242,0,6
78160,2,2352,2497,-145,0,45,0,6
78161,1,2457,2391,66,0,45,0,6
78162,1,2457,2516,-59,0,40,1,6
78163,2,2464,2339,125,0,484,0,6
78164,1,2544,2438,106,0,261,0,6
78165,1,2385,2448,-63,0,112,0,6
78166,2,2448,2476,-28,0,55,0,6
78167,2,2371,2438,-67,0,196,0,6
78168,1,2436,2388,48,0,48,0,6
78169,1,2471,2430,41,0,131,1,6
78170,1,2494,2323,171,0,107,0,6
78171,3,2391,2612,-221,0,41,0,6
78172,2,2404,2420,-16,0,224,1,6
78173,1,2421,2443,-22,0,131,0,6
78174,2,2444,2486,-42,0,45,0,6
78175,2,2446,2313,133,0,132,0,6
78176,1,2580,2547,33,0,101,0,6
78177,1,2470,2294,176,0,152,0,6
78179,1,2405,2490,-85,0,409,0,6
78180,1,2519,2393,126,0,300,0,6
78181,1,2525,2431,94,0,120,0,6
78182,1,2220,2402,-182,0,106,0,6
78183,2,2383,2535,-152,0,302,0,6
78184,1,2410,2432,-22,0,15,1,6
78185,2,2245,2428,-183,0,382,0,6
78186,2,2747,2550,197,0,15,0,6
78187,1,2488,2457,31,0,253,0,6
78188,1,2480,2325,155,0,300,0,6
78189,3,2456,2208,248,0,108,0,8
78190,2,2311,2440,-129,0,45,0,6
78191,1,2594,2509,85,0,64,1,6
78192,1,2459,2530,-71,0,268,1,6
78193,1,2383,2441,-58,0,15,1,6
78194,2,2374,2453,-79,0,49,0,6
78195,2,2575,2688,-113,0,13,1,6
78196,2,2244,2413,-169,0,300,1,8
78197,2,2409,2334,75,0,122,0,6
78198,3,2356,2410,-54,0,7,0,6
78199,1,2477,2560,-83,0,242,0,6
78200,1,2524,2460,64,0,404,0,6
78201,1,2404,2228,176,0,4,1,6
78202,1,2412,2397,15,0,58,0,6
78203,2,2542,2585,-43,0,154,0,6
78204,1,2404,2475,-71,0,210,0,6
78205,3,2276,2411,-135,0,301,0,8
78206,2,2321,2439,-118,0,484,0,6
78207,2,2386,2462,-76,0,428,0,6
78208,1,2394,2570,-176,0,302,1,6
78209,3,2534,2520,14,0,300,0,6
78210,2,2282,2453,-171,0,302,0,6
78211,2,2431,2381,50,0,151,0,6
78212,2,2425,2338,87,0,485,0,6
78213,3,2436,2308,128,0,44,0,8
78214,2,2473,2497,-24,0,308,1,6
78215,2,2407,2379,28,0,56,0,6
78216,2,2288,2423,-135,0,344,0,6
78217,2,2360,2472,-112,0,0,0,6
78218,1,2427,2548,-121,0,0,1,6
78219,2,2330,2442,-112,0,101,0,6
78220,1,2458,2475,-17,0,43,0,6
78221,1,2451,2439,12,0,470,1,6
78222,2,2437,2428,9,0,41,1,6
78223,1,2491,2481,10,0,140,1,6
78224,2,2306,2443,-137,0,387,1,6
78225,2,2287,2452,-165,0,253,0,6
78226,1,2442,2352,90,0,1,0,6
78227,1,2428,2399,29,0,202,1,6
78228,2,2442,2391,51,0,16,0,6
78229,1,2402,2270,132,0,250,0,6
78230,2,2298,2476,-178,0,107,1,6
78231,2,2457,2308,149,0,55,1,6
78232,2,2491,2412,79,0,104,1,6
78233,2,2596,2803,-207,0,267,0,6
78234,1,2444,2308,136,0,4,0,6
78235,1,2425,2459,-34,0,131,0,6
78236,2,2559,2738,-179,0,120,0,6
78237,1,2433,2450,-17,0,40,0,6
78238,2,2257,2435,-178,0,40,0,6
78239,2,2203,2529,-326,0,10,0,6
78240,1,2230,2427,-197,0,110,0,6
78241,2,2412,2526,-114,0,343,1,6
78242,2,2416,2364,52,0,406,0,6
78243,2,2456,2469,-13,0,1,1,6
78244,1,2466,2382,84,0,135,0,6
78245,3,2498,2215,283,0,310,0,6
78246,2,2408,2416,-8,0,200,0,6
78247,2,2462,2353,109,0,248,1,8
78248,2,2505,2599,-94,0,0,0,6
78249,2,2426,2434,-8,0,119,1,6
78250,1,2501,2494,7,0,404,0,6
78251,2,2449,2456,-7,0,7,0,6
78252,2,2553,2484,69,0,315,0,6
78253,1,2571,2532,39,0,27,1,6
78254,1,2439,2406,33,0,300,0,6
78255,2,2590,2537,53,0,125,0,6
78256,1,2464,2407,57,0,192,0,6
78257,2,2225,2400,-175,0,220,0,6
78258,1,2442,2317,125,0,132,1,6
78259,1,2489,2468,21,0,202,0,6
78260,2,2339,2464,-125,0,45,1,6
78261,2,2401,2453,-52,0,12,0,6
78262,1,2469,2394,75,0,414,1,8
78263,2,2480,2476,4,0,300,0,6
78264,3,2211,2453,-242,0,215,0,8
78265,2,2692,2476,216,0,45,0,6
78266,1,2590,2562,28,0,6,0,6
78267,3,2382,2427,-45,0,46,0,6
78268,2,2460,2503,-43,0,130,0,6
78269,2,2418,2309,109,0,460,1,6
78270,1,2520,2431,89,0,120,0,6
78271,2,2394,2435,-41,0,255,1,6
78272,3,2304,2448,-144,0,45,0,6
78273,1,2741,2556,185,0,41,0,6
78274,2,2337,2409,-72,0,332,1,6
78275,1,2455,2279,176,0,314,0,6
78276,1,2540,2497,43,0,200,0,6
78277,1,2475,2416,59,0,300,1,6
78278,2,2512,2455,57,0,122,1,6
78279,2,2446,2471,-25,0,144,1,6
78280,1,2806,2594,212,0,0,0,6
78281,1,2479,2377,102,0,151,0,6
78282,2,2202,2487,-285,0,381,0,8
78283,2,2462,2357,105,0,255,0,6
78284,2,2435,2378,57,0,30,0,6
78285,2,2603,2501,102,0,64,0,6
78286,1,2487,2526,-39,0,301,0,6
78287,3,2547,2534,13,0,108,0,6
78288,1,2278,2507,-229,0,128,1,6
78289,2,2494,2458,36,0,101,0,6
78290,2,2425,2401,24,0,427,0,6
78291,2,2438,2254,184,0,133,0,6
78292,1,2421,2564,-143,0,21,0,6
78293,1,2305,2401,-96,0,334,1,6
78294,2,2365,2443,-78,0,45,0,6
78295,2,2557,2508,49,0,309,0,6
78296,2,2233,2521,-288,4,375,0,13
78297,2,2271,2431,-160,0,125,0,6
78298,1,2449,2545,-96,0,14,0,6
78299,2,2418,2513,-95,0,306,0,6
78300,2,2217,2408,-191,0,106,1,6
78301,1,2530,2301,229,0,268,1,6
78302,2,2531,2397,134,0,140,0,6
78303,2,2373,2483,-110,0,324,0,6
78304,3,2351,2494,-143,0,306,0,6
78305,1,2492,2317,175,0,110,1,6
78306,1,2451,2380,71,0,45,1,6
78307,1,2402,2469,-67,0,41,0,6
78308,1,2503,2527,-24,0,398,0,6
78309,2,2358,2440,-82,0,112,1,6
78310,3,2416,2421,-5,0,153,0,6
78311,1,2404,2222,182,0,486,1,6
78312,1,2409,2273,136,0,107,1,8
78313,1,2313,2446,-133,0,3,0,6
78314,2,2622,2627,-5,0,492,1,6
78315,1,2491,2546,-55,0,190,0,6
78316,1,2458,2462,-4,0,319,0,6
78317,3,2553,2744,-191,0,120,0,6
78318,2,2520,2496,24,0,345,0,6
78319,1,2289,2458,-169,0,46,0,6
78320,1,2576,2353,223,0,7,0,6
78321,1,2275,2429,-154,0,200,0,6
78322,1,2445,2378,67,0,5,0,6
78323,2,2426,2383,43,0,352,0,6
78324,2,2544,2529,15,0,154,1,6
78325,1,2482,2419,63,0,246,1,6
78326,1,2609,2427,182,0,126,0,6
78327,1,2368,2410,-42,0,330,0,6
78328,2,2444,2407,37,0,250,0,6
78329,2,2347,2420,-73,0,25,0,6
78330,1,2450,2215,235,0,108,0,8
78331,1,2480,2538,-58,0,300,0,6
78332,2,2475,2456,19,0,302,0,6
78333,1,2442,2389,53,0,201,0,6
78334,2,2277,2454,-177,0,405,0,6
78335,3,2385,2428,-43,0,7,0,6
78336,1,2508,2596,-88,0,112,0,6
78337,2,2448,2430,18,0,4,1,6
78338,1,2445,2455,-10,0,464,0,6
78339,1,2455,2308,147,0,200,1,8
78341,1,2398,2467,-69,0,242,1,6
78342,1,2462,2409,53,0,110,0,6
78343,2,2401,2556,-155,0,107,0,6
78344,2,2369,2435,-66,0,41,0,6
78345,2,2476,2441,35,0,125,1,6
78346,2,2462,2567,-105,0,123,0,6
78347,1,2254,2425,-171,4,245,0,13
78348,3,2414,2338,76,0,201,0,6
78349,2,2419,2484,-65,0,15,1,6
78350,1,2546,2401,145,0,85,0,6
78351,2,2534,2600,-66,0,106,0,6
78352,1,2514,2331,183,0,300,0,6
78353,1,2443,2531,-88,0,398,0,6
78354,1,2487,2487,0,0,140,0,6
78355,1,2450,2463,-13,0,386,1,6
78356,2,2602,2550,52,0,308,0,6
78357,1,2495,2402,93,0,176,0,6
78358,1,2494,2317,177,0,110,0,6
78359,1,2314,2486,-172,0,338,0,6
78360,1,2468,2311,157,0,400,0,6
78361,1,2405,2209,196,0,401,0,6
78362,2,2411,2244,167,0,84,0,6
78363,1,2517,2299,218,0,212,0,6
78364,2,2227,2532,-305,0,37,0,6
78365,1,2492,2205,287,0,52,0,6
78366,1,2589,2515,74,0,64,0,6
78367,1,2636,2581,55,0,345,0,6
78368,1,2421,2416,5,0,196,0,6
78369,1,2741,2556,185,0,241,0,6
78370,2,2392,2475,-83,0,1,1,8
78371,2,2276,2609,-333,0,302,0,6
78372,1,2421,2284,137,0,49,0,6
78373,2,2444,2389,55,0,300,0,6
78374,2,2219,2407,-188,0,0,0,6
78375,2,2212,2452,-240,0,208,0,8
78376,1,2456,2450,6,0,469,0,6
78377,2,2521,2538,-17,0,164,0,6
78378,2,2439,2497,-58,0,45,1,6
78379,1,2357,2406,-49,0,101,0,6
78380,1,2424,2400,24,0,57,0,6
78381,2,2365,2477,-112,0,85,0,6
78382,2,2447,2392,55,0,7,0,6
78383,3,2447,2428,19,0,385,0,6
78384,1,2477,2311,166,0,49,0,6
78385,2,2442,2550,-108,0,301,0,6
78386,2,2604,2529,75,0,70,0,6
78387,2,2436,2584,-148,0,28,1,6
78388,1,2322,2442,-120,0,487,1,6
78389,2,2508,2543,-35,0,134,1,6
78390,1,2559,2398,161,0,128,0,6
78391,3,2449,2481,-32,0,140,0,6
78392,2,2499,2360,139,0,136,0,6
78393,2,2539,2498,41,0,150,0,6
78394,2,2398,2517,-119,0,308,0,6
78395,2,2404,2229,175,0,7,0,6
78397,1,2611,2274,337,0,315,0,6
78398,1,2454,2493,-39,0,107,0,6
78399,1,2454,2210,244,0,4,0,8
78400,2,2511,2593,-82,0,300,0,6
78401,1,2366,2404,-38,0,403,0,6
78402,1,2381,2465,-84,0,106,0,6
78403,1,2505,2514,-9,0,15,0,6
78404,3,2557,2419,138,0,330,0,6
78405,1,2414,2486,-72,0,354,0,6
78406,3,2302,2561,-259,0,193,0,6
78407,2,2457,2595,-138,0,310,1,6
78408,1,2438,2352,86,0,1,1,6
78409,2,2460,2440,20,0,100,0,6
78411,1,2524,2447,77,0,150,0,6
78412,3,2435,2318,117,0,112,0,6
78413,1,2633,2644,-11,0,202,0,6
78414,1,2479,2490,-11,0,414,0,8
78415,1,2410,2216,194,0,486,0,6
78416,1,2451,2471,-20,0,31,1,6
78417,3,2396,2404,-8,0,21,0,6
78418,2,2411,2238,173,0,122,0,6
78419,3,2438,2491,-53,0,48,0,6
78420,1,2411,2368,43,0,136,0,6
78421,2,2537,2597,-60,0,106,0,6
78422,1,2488,2488,0,0,48,0,6
78423,1,2451,2229,222,0,1,0,6
78424,1,2427,2487,-60,0,241,1,6
78425,2,2306,2413,-107,0,0,0,6
78426,2,2543,2553,-10,0,241,0,6
78427,1,2425,2258,167,0,140,0,6
78428,2,2598,2506,92,0,64,0,6
78429,2,2296,2408,-112,0,65,1,6
78430,2,2200,2405,-205,0,29,1,6
78431,1,2534,2270,264,0,256,1,6
78432,3,2285,2458,-173,0,41,0,8
78433,2,2516,2554,-38,0,136,0,6
78434,2,2295,2460,-165,0,43,0,6
78435,1,2577,2642,-65,0,196,0,6
78436,2,2434,2415,19,0,46,0,6
78437,1,2428,2462,-34,0,11,0,6
78438,2,2481,2429,52,0,45,0,6
78439,3,2380,2450,-70,0,202,0,6
78440,2,2434,2330,104,0,4,0,6
78441,2,2279,2454,-175,0,101,1,6
78442,1,2550,2521,29,0,308,0,6
78443,2,2639,2639,0,0,485,0,6
78444,1,2410,2454,-44,0,260,1,6
78445,2,2273,2613,-340,0,302,0,6
78446,2,2438,2550,-112,0,301,0,6
78447,3,2385,2453,-68,0,250,0,6
78448,1,2599,2587,12,0,0,0,6
78449,1,2685,2502,183,0,442,0,6
78450,1,2555,2494,61,0,45,0,6
78451,2,2208,2457,-249,0,211,0,8
78452,2,2474,2542,-68,0,45,0,6
78453,1,2559,2469,90,0,4,0,6
78454,1,2562,2511,51,0,130,0,6
78455,1,2578,2435,143,0,8,0,6
78456,1,2385,2443,-58,0,122,1,6
78457,1,2416,2295,121,4,302,0,13
78458,2,2529,2458,71,0,255,0,6
78459,2,2440,2471,-31,0,5,0,6
78460,1,2615,2271,344,0,343,0,6
78461,1,2426,2321,105,0,45,0,6
78462,2,2634,2583,51,0,180,0,6
78463,1,2446,2465,-19,0,40,1,6
78464,1,2484,2207,277,0,266,0,8
78465,2,2348,2456,-108,0,291,0,6
78466,3,2509,2490,19,0,394,0,6
78467,1,2404,2439,-35,0,113,0,6
78468,1,2504,2533,-29,0,241,0,6
78469,2,2456,2432,24,0,202,0,6
78470,2,2559,2538,21,0,120,0,6
78471,2,2508,2514,-6,0,37,0,6
78472,1,2419,2421,-2,0,246,1,6
78473,1,2434,2428,6,0,335,0,6
78474,2,2364,2480,-116,0,7,0,6
78475,1,2532,2554,-22,0,80,1,6
78476,1,2463,2457,6,0,301,0,6
78477,2,2401,2396,5,0,11,0,6
78478,1,2602,2489,113,0,56,0,6
78479,2,2514,2591,-77,0,442,0,6
78480,3,2312,2480,-168,0,241,0,6
78481,1,2427,2289,138,0,69,0,6
78482,2,2645,2633,12,0,150,0,6
78483,1,2481,2433,48,0,426,0,6
78484,2,2410,2352,58,0,277,1,6
78485,2,2220,2525,-305,0,10,0,6
78486,1,2563,2432,131,0,5,0,6
78487,2,2506,2522,-16,0,161,0,6
78488,2,2322,2616,-294,0,300,1,6
78489,2,2449,2427,22,0,45,0,6
78490,1,2583,2465,118,0,14,0,6
78491,1,2419,2327,92,0,4,0,6
78492,2,2606,2555,51,0,58,1,6
78493,2,2448,2417,31,0,107,0,6
78494,2,2452,2567,-115,0,41,1,6
78495,1,2244,2401,-157,0,29,0,6
78496,2,2370,2438,-68,0,49,0,6
78497,2,2429,2567,-138,0,40,0,6
78498,1,2470,2380,90,0,45,1,6
78499,3,2355,2414,-59,0,0,0,8
78500,2,2595,2509,86,0,490,0,6
78501,2,2270,2616,-346,0,302,0,6
78502,2,2229,2430,-201,0,130,1,6
78503,1,2458,2364,94,0,1,0,6
78504,2,2590,2627,-37,0,265,1,6
78505,1,2544,2553,-9,0,215,1,6
78506,2,2460,2393,67,0,313,0,6
78507,3,2436,2392,44,0,245,0,6
78508,1,2423,2440,-17,0,118,1,6
78509,1,2415,2496,-81,0,240,0,6
78510,1,2421,2351,70,0,113,0,6
78511,2,2421,2310,111,0,0,0,6
78512,1,2491,2441,50,0,101,1,6
78513,3,2456,2287,169,0,101,0,8
78514,2,2527,2510,17,0,303,0,6
78515,2,2486,2486,0,0,16,0,8
78516,2,2499,2688,-189,0,404,0,6
78517,3,2535,2561,-26,0,132,0,6
78518,1,2451,2469,-18,0,31,0,6
78519,2,2450,2445,5,0,106,0,6
78520,2,2377,2428,-51,0,0,0,6
78521,3,2528,2396,132,0,140,0,6
78522,1,2481,2385,96,0,453,0,6
78523,1,2426,2438,-12,0,394,1,6
78524,2,2639,2639,0,0,167,0,6
78525,1,2461,2335,126,0,332,1,6
78526,1,2618,2268,350,0,311,0,6
78527,2,2402,2434,-32,0,115,0,6
78528,1,2477,2453,24,0,250,0,6
78529,3,2354,2446,-92,0,100,0,6
78530,1,2404,2262,142,0,130,0,8
78531,1,2548,2538,10,0,60,0,6
78532,1,2443,2365,78,0,205,0,6
78533,3,2443,2462,-19,0,130,0,6
78534,1,2461,2345,116,0,469,0,6
78535,1,2461,2587,-126,0,103,1,6
78536,3,2571,2559,12,0,7,0,6
78537,2,2425,2612,-187,0,45,1,6
78538,1,2562,2600,-38,0,106,1,6
78539,1,2595,2571,24,0,107,0,6
78540,2,2358,2433,-75,0,45,0,6
78541,2,2448,2474,-26,0,16,1,6
78542,1,2202,2481,-279,0,381,0,8
78543,2,2433,2226,207,0,474,0,6
78544,1,2484,2431,53,0,107,0,6
78545,1,2512,2375,137,0,45,0,6
78546,1,2522,2502,20,0,301,0,6
78547,2,2275,2404,-129,0,337,1,6
78548,1,2452,2308,144,0,40,0,6
78549,1,2437,2509,-72,0,305,0,6
78550,3,2496,2628,-132,0,150,0,6
78551,1,2318,2415,-97,0,248,1,6
78552,3,2393,2436,-43,0,122,0,6
78553,2,2403,2324,79,0,116,0,8
78554,1,2547,2550,-3,0,36,0,6
78555,1,2400,2361,39,0,49,1,6
78556,2,2463,2434,29,0,45,1,6
78557,1,2560,2420,140,0,212,0,6
78558,1,2439,2397,42,0,197,0,6
78559,1,2425,2423,2,0,130,1,6
78560,3,2455,2420,35,4,250,0,13
78561,2,2203,2434,-231,0,1,0,6
78562,1,2485,2516,-31,0,61,1,6
78563,2,2381,2411,-30,0,405,1,6
78564,2,2451,2444,7,0,226,0,6
78565,2,2457,2462,-5,0,458,1,6
78566,2,2448,2526,-78,0,302,1,6
78567,1,2453,2272,181,0,131,1,8
78568,2,2483,2440,43,0,250,0,6
78569,2,2582,2535,47,0,123,0,6
78570,1,2489,2354,135,0,472,0,6
78571,2,2235,2424,-189,0,101,0,6
78572,1,2403,2443,-40,0,455,0,6
78573,1,2432,2554,-122,0,15,0,6
78574,2,2227,2476,-249,4,483,0,13
78575,1,2532,2571,-39,0,106,0,6
78576,2,2444,2560,-116,0,0,0,6
78577,2,2593,2568,25,0,4,1,6
78578,2,2516,2521,-5,0,288,0,6
78579,1,2429,2271,158,0,153,0,6
78580,1,2255,2463,-208,0,40,1,6
78581,3,2372,2516,-144,0,327,0,6
78582,2,2566,2601,-35,0,0,0,6
78583,1,2496,2310,186,0,5,0,6
78584,1,2422,2432,-10,0,300,1,6
78585,1,2435,2394,41,0,245,0,6
78586,2,2288,2443,-155,0,277,0,6
78587,2,2338,2479,-141,0,15,1,6
78588,2,2331,2483,-152,0,488,1,6
78589,2,2334,2615,-281,0,245,1,6
78590,2,2544,2553,-9,0,210,0,6
78591,1,2464,2498,-34,0,453,0,6
78592,1,2408,2304,104,0,100,0,6
78593,2,2564,2566,-2,0,194,0,6
78594,1,2546,2457,89,0,56,0,6
78595,2,2433,2413,20,0,46,1,6
78596,1,2440,2437,3,0,20,0,6
78597,1,2488,2376,112,0,147,0,6
78598,2,2357,2444,-87,0,485,0,6
78599,1,2356,2405,-49,0,50,0,6
78600,1,2418,2324,94,0,2,0,0
78601,2,2451,2451,0,0,255,0,6
78602,1,2510,2450,60,0,242,0,6
78603,2,2324,2491,-167,0,126,0,6
78604,2,2497,2529,-32,0,12,0,6
78605,2,2287,2402,-115,0,319,0,8
78606,1,2441,2445,-4,0,0,0,6
78607,2,2228,2596,-368,2,52,0,24
78608,2,2426,2511,-85,0,45,1,6
78609,2,2477,2375,102,0,205,1,6
78610,1,2427,2232,195,0,474,1,6
78611,1,2350,2447,-97,0,315,1,6
78612,1,2530,2452,78,0,122,0,6
78613,2,2408,2259,149,0,43,0,6
78614,2,2243,2443,-200,0,277,0,6
78615,3,2419,2459,-40,0,4,0,6
78616,3,2542,2551,-9,0,193,0,6
78617,1,2402,2209,193,0,10,0,6
78618,2,2353,2432,-79,0,201,0,6
78619,1,2465,2430,35,0,48,1,6
78620,1,2574,2587,-13,0,40,0,6
78621,1,2426,2428,-2,0,380,0,6
78622,2,2385,2577,-192,0,107,1,6
78623,1,2362,2513,-151,0,324,1,6
78624,2,2353,2446,-93,0,33,0,6
78625,1,2492,2511,-19,0,100,0,6
78626,1,2389,2440,-51,0,101,0,6
78627,2,2483,2335,148,0,83,0,6
78628,2,2558,2539,19,0,300,0,6
78629,2,2386,2418,-32,0,134,0,6
78630,1,2378,2402,-24,0,128,1,6
78631,2,2311,2412,-101,0,108,0,6
78632,1,2378,2486,-108,0,110,0,6
78633,2,2374,2431,-57,0,210,0,6
78634,2,2447,2464,-17,0,398,0,6
78635,1,2307,2499,-192,0,123,0,6
78636,2,2420,2309,111,0,333,0,6
78637,1,2535,2558,-23,0,122,1,6
78638,2,2458,2446,12,0,201,0,6
78639,1,2284,2407,-123,0,45,0,8
78640,1,2428,2495,-67,0,211,0,6
78641,1,2564,2572,-8,0,80,1,6
78642,2,2526,2511,15,0,7,0,6
78643,1,2454,2445,9,0,1,0,6
78644,2,2487,2431,56,0,8,0,6
78645,1,2580,2550,30,0,401,0,6
78646,2,2457,2445,12,0,216,0,6
78647,2,2447,2515,-68,0,414,0,6
78648,2,2289,2456,-167,0,154,0,8
78649,1,2416,2539,-123,0,122,0,6
78650,3,2618,2338,280,0,274,0,6
78651,2,2256,2434,-178,0,246,0,6
78652,2,2403,2461,-58,0,45,0,6
78653,1,2451,2466,-15,0,13,0,6
78654,1,2452,2414,38,0,15,0,6
78655,1,2509,2744,-235,0,6,0,6
78656,2,2348,2498,-150,0,1,0,6
78657,2,2505,2480,25,0,10,0,6
78658,2,2430,2295,135,0,45,0,6
78659,2,2440,2475,-35,0,16,1,6
78660,2,2393,2558,-165,0,207,0,6
78661,1,2580,2531,49,0,45,0,6
78662,2,2354,2405,-51,0,53,0,6
78663,2,2437,2236,201,0,263,0,6
78664,1,2520,2443,77,0,345,1,6
78665,2,2550,2581,-31,0,40,0,6
78666,1,2469,2394,75,0,311,1,8
78667,2,2470,2469,1,0,325,0,6
78668,1,2423,2432,-9,0,40,1,6
78669,1,2391,2438,-47,0,100,0,6
78671,2,2423,2380,43,0,4,0,6
78672,3,2468,2417,51,4,46,0,0
78673,3,2392,2410,-18,0,45,0,8
78674,1,2449,2271,178,0,4,0,6
78675,1,2369,2400,-31,0,128,0,6
78676,2,2545,2552,-7,0,129,1,6
78677,1,2475,2442,33,0,45,0,6
78678,1,2419,2316,103,0,123,0,6
78679,1,2271,2421,-150,4,300,0,13
78680,1,2633,2542,91,0,143,0,6
78681,2,2422,2491,-69,0,45,1,6
78682,1,2539,2505,34,0,301,0,6
78683,2,2432,2457,-25,0,140,0,6
78684,1,2541,2370,171,0,170,0,6
78685,1,2552,2395,157,0,128,1,6
78686,2,2433,2460,-27,0,101,0,6
78687,1,2410,2293,117,0,22,0,6
78688,3,2516,2363,153,0,415,0,6
78689,3,2383,2422,-39,0,405,0,6
78690,1,2575,2425,150,0,125,0,6
78691,2,2587,2545,42,0,80,0,6
78692,2,2436,2428,8,0,45,1,6
78693,2,2413,2243,170,0,48,1,6
78694,1,2570,2593,-23,0,332,1,6
78695,1,2566,2435,131,0,14,0,6
78696,1,2466,2387,79,0,311,0,6
78697,1,2426,2345,81,0,101,0,6
78698,1,2432,2462,-30,0,216,0,6
78699,1,2376,2431,-55,0,202,1,6
78700,3,2465,2428,37,0,1,0,6
78701,1,2464,2347,117,0,375,0,6
78702,1,2641,2544,97,0,130,0,6
78703,1,2476,2413,63,4,40,0,13
78704,1,2468,2367,101,0,177,0,6
78705,1,2735,2518,217,0,286,0,6
78706,2,2438,2524,-86,0,46,0,6
78707,1,2585,2585,0,0,335,0,6
78708,2,2330,2492,-162,0,240,0,6
78709,2,2484,2452,32,0,107,0,6
78710,1,2435,2364,71,0,16,0,6
78711,1,2426,2428,-2,0,380,0,6
78712,3,2369,2417,-48,0,389,0,6
78713,1,2410,2259,151,0,405,0,8
78714,2,2579,2398,181,0,123,0,6
78715,1,2471,2465,6,0,311,0,6
78716,2,2475,2395,80,0,255,1,6
78717,2,2427,2366,61,0,40,1,6
78718,1,2517,2520,-3,0,278,0,6
78719,2,2558,2539,19,0,1,0,6
78720,2,2500,2544,-44,0,45,1,6
78721,2,2392,2446,-54,0,4,0,6
78722,2,2580,2470,110,0,13,0,6
78723,1,2480,2311,169,0,8,0,6
78724,1,2602,2317,285,2,254,0,24
78725,1,2495,2438,57,0,8,0,6
78726,1,2392,2556,-164,0,474,1,6
78727,2,2243,2414,-171,0,16,0,6
78728,1,2470,2340,130,0,114,0,6
78729,1,2423,2483,-60,0,487,0,6
78730,1,2422,2211,211,0,310,0,6
78731,1,2456,2638,-182,0,140,0,6
78732,2,2458,2438,20,0,455,0,6
78733,1,2552,2383,169,0,50,0,6
78735,1,2310,2434,-124,0,15,0,6
78736,1,2580,2499,81,0,56,0,6
78737,2,2432,2570,-138,0,194,0,6
78738,1,2418,2254,164,0,210,0,6
78739,2,2451,2404,47,0,0,1,6
78740,2,2392,2413,-21,0,45,0,8
78741,2,2529,2434,95,0,101,0,6
78742,1,2526,2645,-119,0,40,0,6
78743,2,2226,2424,-198,0,244,0,6
78744,1,2429,2464,-35,0,101,1,6
78745,2,2417,2275,142,0,253,0,6
78746,1,2473,2407,66,0,300,0,6
78747,2,2360,2439,-79,0,302,0,6
78748,1,2571,2591,-20,0,101,1,6
78749,2,2245,2615,-370,0,345,0,6
78750,3,2337,2478,-141,0,45,0,6
78752,1,2444,2452,-8,0,107,0,6
78753,3,2416,2330,86,0,7,0,6
78754,2,2333,2402,-69,0,121,0,6
78755,3,2363,2476,-113,0,347,0,6
78756,2,2218,2413,-195,0,296,0,8
78757,3,2201,2425,-224,0,45,0,6
78758,1,2311,2429,-118,0,371,0,6
78759,1,2474,2391,83,0,109,0,6
78760,2,2545,2552,-7,0,129,1,6
78761,3,2417,2295,122,0,22,0,6
78762,1,2432,2360,72,0,311,0,6
78763,1,2549,2495,54,0,301,0,6
78764,1,2428,2323,105,0,300,0,6
78765,2,2423,2468,-45,0,46,0,6
78766,2,2417,2468,-51,0,45,1,6
78768,1,2547,2478,69,0,110,0,6
78769,2,2428,2402,26,0,177,0,6
78770,3,2574,2446,128,0,462,0,6
78771,1,2495,2585,-90,0,106,1,6
78772,2,2409,2381,28,0,4,0,6
78773,2,2426,2380,46,0,485,0,6
78774,1,2445,2371,74,0,130,0,6
78775,1,2638,2555,83,0,83,0,6
78776,2,2444,2456,-12,0,30,0,6
78777,2,2373,2534,-161,0,56,0,6
78778,2,2429,2362,67,0,202,0,6
78779,2,2253,2421,-168,0,318,1,6
78780,2,2411,2445,-34,0,4,0,6
78781,2,2465,2418,47,0,15,0,6
78782,1,2390,2473,-83,0,301,0,6
78783,2,2441,2521,-80,0,43,0,6
78784,1,2283,2420,-137,0,101,0,6
78785,2,2435,2403,32,0,284,0,6
78786,1,2318,2421,-103,0,353,0,6
78787,2,2367,2475,-108,0,352,0,6
78788,2,2458,2435,23,0,1,0,6
78789,2,2474,2552,-78,0,45,0,6
78790,2,2476,2339,137,0,40,0,6
78791,3,2516,2571,-55,0,4,0,6
78792,3,2421,2213,208,0,1,0,6
78793,1,2491,2554,-63,0,45,0,6
78794,2,2476,2430,46,0,4,0,6
78795,1,2357,2415,-58,0,16,0,6
78796,1,2412,2365,47,0,57,1,6
78797,2,2558,2540,18,0,2,0,6
78798,1,2452,2482,-30,0,213,0,6
78799,2,2349,2501,-152,0,121,0,6
78800,1,2435,2379,56,0,7,0,6
78801,3,2267,2421,-154,0,302,0,6
78802,2,2526,2437,89,0,301,0,6
78803,1,2449,2572,-123,0,83,1,6
78804,1,2491,2361,130,0,101,1,6
78805,1,2551,2642,-91,0,400,0,6
78806,1,2297,2473,-176,0,1,0,6
78807,2,2408,2310,98,4,49,0,13
78808,1,2414,2257,157,0,57,0,6
78809,1,2408,2438,-30,0,337,0,6
78810,2,2578,2502,76,0,378,1,6
78811,1,2357,2407,-50,0,190,1,6
78812,1,2438,2377,61,0,30,0,6
78813,1,2479,2422,57,0,456,0,6
78814,1,2486,2364,122,0,190,0,6
78815,1,2441,2290,151,0,170,0,6
78816,2,2496,2413,83,0,107,0,6
78817,2,2424,2458,-34,0,40,0,6
78819,2,2450,2414,36,0,110,0,6
78820,1,2541,2397,144,0,39,1,6
78821,2,2386,2570,-184,0,140,1,6
78822,2,2223,2419,-196,0,45,1,6
78823,2,2424,2250,174,0,305,1,6
78824,1,2547,2497,50,0,301,1,6
78825,3,2517,2476,41,0,4,0,6
78826,1,2415,2414,1,0,8,0,6
78827,1,2557,2469,88,0,215,0,6
78828,2,2468,2577,-109,0,469,0,6
78829,2,2423,2458,-35,0,260,0,6
78830,1,2504,2546,-42,0,163,0,6
78831,1,2360,2417,-57,0,41,1,6
78832,2,2347,2450,-103,0,40,1,6
78833,1,2273,2420,-147,0,115,0,6
78834,2,2376,2537,-161,0,484,1,6
78835,3,2502,2444,58,0,107,0,6
78836,1,2377,2464,-87,0,469,1,6
78837,3,2419,2414,5,0,57,0,6
78838,1,2660,2635,25,0,45,0,6
78839,2,2424,2273,151,0,140,0,5
78840,2,2389,2561,-172,0,170,1,6
78841,2,2464,2419,45,0,110,1,6
78842,1,2469,2291,178,0,4,0,6
78843,1,2564,2484,80,0,14,1,6
78844,2,2417,2409,8,0,255,0,6
78845,3,2269,2445,-176,0,302,0,6
78846,2,2341,2437,-96,0,147,0,6
78847,1,2509,2571,-62,0,264,1,6
78848,3,2400,2485,-85,0,16,0,6
78849,2,2450,2443,7,0,119,0,6
78850,1,2477,2517,-40,0,115,0,6
78851,1,2420,2444,-24,0,190,0,6
78852,2,2251,2467,-216,4,100,0,0
78853,2,2292,2410,-118,0,100,0,6
78854,2,2464,2495,-31,0,133,1,6
78855,2,2394,2564,-170,0,301,0,6
78856,1,2573,2544,29,0,10,0,6
78857,2,2464,2329,135,0,107,0,6
78858,1,2400,2277,123,0,454,0,6
78859,1,2421,2214,207,0,315,0,6
78860,2,2493,2552,-59,0,45,1,6
78861,1,2310,2400,-90,0,45,0,6
78862,2,2319,2443,-124,0,365,1,6
78863,2,2393,2622,-229,0,12,0,6
78864,1,2401,2213,188,0,335,0,6
78865,2,2438,2426,12,0,112,1,6
78866,1,2367,2437,-70,0,95,0,6
78867,3,2325,2459,-134,0,8,0,6
78868,2,2360,2419,-59,0,11,1,6
78869,2,2492,2361,131,0,305,0,6
78870,2,2258,2416,-158,0,318,1,6
78871,1,2320,2456,-136,0,46,0,6
78872,1,2539,2510,29,0,245,0,6
78873,1,2454,2425,29,0,0,0,6
78874,1,2442,2325,117,0,134,1,6
78875,2,2402,2284,118,0,30,0,6
78876,1,2484,2362,122,0,485,1,6
78877,2,2445,2503,-58,0,201,0,6
78878,1,2401,2304,97,0,36,1,6
78879,2,2483,2581,-98,0,120,0,6
78881,3,2303,2401,-98,0,250,0,6
78882,1,2408,2472,-64,0,205,0,6
78883,2,2426,2457,-31,0,40,0,6
78884,2,2390,2412,-22,0,109,0,6
78885,1,2469,2567,-98,0,300,1,6
78886,2,2579,2666,-87,0,10,0,6
78887,2,2430,2374,56,0,176,0,6
78888,2,2405,2300,105,0,190,0,6
78889,3,2448,2283,165,0,152,0,6
78890,1,2564,2516,48,0,432,0,6
78891,2,2540,2569,-29,0,123,1,6
78892,2,2273,2404,-131,0,46,0,6
78893,1,2479,2350,129,0,340,1,6
78894,3,2390,2449,-59,0,11,0,6
78895,1,2416,2239,177,0,4,0,8
78897,1,2441,2420,21,0,15,0,6
78898,1,2463,2351,112,0,106,0,6
78899,1,2446,2355,91,0,228,0,6
78900,2,2450,2370,80,0,4,0,6
78901,1,2414,2297,117,0,18,0,6
78902,1,2411,2272,139,0,310,0,6
78903,3,2387,2484,-97,0,341,0,6
78904,1,2439,2374,65,0,4,0,6
78905,2,2234,2410,-176,0,112,0,6
78906,1,2624,2391,233,0,45,0,6
78907,1,2457,2384,73,0,331,0,6
78908,2,2410,2508,-98,0,40,0,6
78910,1,2401,2234,167,4,49,0,13
78911,1,2617,2440,177,0,101,1,6
78912,2,2429,2826,-397,0,380,1,6
78913,2,2764,2799,-35,0,426,0,6
78914,2,2369,2426,-57,0,36,0,6
78915,2,2291,2419,-128,0,221,0,8
78916,3,2330,2446,-116,0,140,0,6
78917,1,2511,2569,-58,0,270,0,6
78918,2,2423,2285,138,0,335,0,6
78919,2,2351,2450,-99,0,4,0,6
78920,2,2505,2545,-40,0,4,0,6
78921,2,2407,2269,138,0,102,0,6
78922,3,2501,2406,95,0,101,0,6
78923,2,2463,2421,42,0,11,1,6
78924,1,2422,2406,16,0,196,1,6
78925,1,2447,2446,1,0,148,0,6
78926,2,2383,2417,-34,0,218,0,6
78927,2,2574,2385,189,0,28,0,6
78928,1,2512,2446,66,0,190,0,6
78929,1,2549,2358,191,0,15,0,6
78930,3,2380,2488,-108,0,57,0,6
78931,1,2419,2255,164,0,305,0,6
78932,1,2540,2434,106,0,100,0,6
78933,1,2465,2415,50,0,113,0,6
78934,2,2560,2387,173,0,130,1,6
78935,1,2432,2432,0,0,190,0,6
78936,2,2448,2391,57,0,464,0,6
78937,1,2441,2452,-11,0,4,0,6
78939,1,2376,2483,-107,0,330,0,6
78940,1,2416,2318,98,0,133,0,5
78941,2,2458,2537,-79,0,203,0,6
78942,1,2364,2441,-77,0,119,0,6
78943,1,2535,2564,-29,0,184,0,6
78944,2,2422,2414,8,0,113,0,6
78945,2,2312,2483,-171,0,45,0,6
78946,2,2414,2406,8,0,45,0,6
78947,1,2462,2405,57,0,375,0,6
78948,1,2405,2264,141,4,302,0,13
78949,1,2428,2218,210,0,1,0,6
78950,1,2432,2269,163,0,0,0,6
78951,2,2388,2566,-178,0,107,0,6
78952,1,2563,2518,45,0,469,0,6
78953,1,2489,2556,-67,0,45,0,6
78954,2,2419,2401,18,0,487,0,6
78955,1,2486,2444,42,0,7,0,6
78956,1,2435,2460,-25,0,41,0,6
78957,1,2416,2347,69,0,106,0,6
78958,1,2558,2500,58,0,46,0,6
78959,1,2402,2236,166,0,308,0,6
78960,1,2437,2544,-107,0,303,0,6
78961,1,2427,2456,-29,0,40,1,6
78962,3,2431,2490,-59,0,268,0,6
78963,2,2314,2420,-106,0,1,0,6
78964,1,2486,2339,147,0,110,0,6
78965,2,2267,2408,-141,0,469,0,6
78966,1,2309,2486,-177,0,106,0,6
78967,1,2423,2427,-4,0,153,1,6
78968,1,2396,2552,-156,0,4,1,6
78969,1,2442,2517,-75,0,200,0,6
78970,1,2400,2382,18,0,301,1,6
78971,3,2453,2441,12,0,0,0,6
78972,2,2252,2422,-170,0,300,0,6
78973,3,2476,2620,-144,0,41,0,6
78974,1,2269,2447,-178,0,343,1,6
78975,2,2360,2827,-467,0,114,0,6
78976,1,2403,2273,130,0,106,0,6
78977,2,2408,2420,-12,0,11,0,6
78978,1,2495,2525,-30,0,6,0,6
78979,1,2430,2537,-107,0,43,0,6
78980,3,2439,2491,-52,0,250,0,6
78981,2,2364,2426,-62,0,180,0,6
78982,2,2478,2541,-63,0,437,0,6
78983,1,2549,2496,53,0,328,1,6
78984,1,2265,2462,-197,0,40,1,6
78985,1,2420,2279,141,0,453,0,6
78986,1,2416,2401,15,0,150,0,6
78987,2,2401,2367,34,0,65,0,6
78988,2,2299,2405,-106,0,40,0,6
78989,1,2445,2569,-124,0,107,0,6
78990,1,2513,2568,-55,0,106,0,6
78991,1,2430,2301,129,0,1,0,6
78992,1,2413,2386,27,0,410,1,6
78993,2,2410,2470,-60,0,140,0,6
78994,1,2499,2385,114,0,202,0,6
78995,1,2411,2388,23,0,411,0,6
78996,1,2304,2401,-97,0,202,0,6
78997,2,2400,2364,36,0,308,1,6
78998,2,2412,2398,14,0,58,1,6
78999,2,2450,2433,17,0,110,0,6
79000,3,2400,2467,-67,0,485,0,6
79001,1,2478,2314,164,0,8,0,0
79002,1,2489,2478,11,0,300,0,6
79003,1,2618,2452,166,0,101,0,6
79004,2,2417,2334,83,0,40,0,6
79005,2,2270,2407,-137,0,4,0,6
79006,1,2404,2547,-143,0,17,1,6
79007,2,2422,2426,-4,0,219,0,6
79008,2,2490,2440,50,0,7,0,6
79009,2,2402,2291,111,0,14,0,6
79010,1,2383,2441,-58,0,385,1,6
79011,3,2424,2412,12,0,4,0,6
79012,1,2828,2381,447,0,14,0,6
79013,1,2377,2400,-23,0,426,0,6
79014,1,2561,2520,41,0,50,0,6
79015,2,2395,2529,-134,0,133,0,6
79016,1,2400,2269,131,0,10,0,6
79017,2,2519,2502,17,0,114,1,6
79018,2,2381,2473,-92,0,106,0,6
79019,2,2425,2379,46,0,40,1,6
79020,2,2491,2554,-63,0,40,0,6
79021,1,2431,2359,72,0,263,0,6
79022,1,2544,2424,120,0,110,0,6
79023,1,2515,2566,-51,0,106,1,6
79024,1,2585,2437,148,0,100,1,6
79025,2,2311,2482,-171,0,402,0,0
79026,1,2388,2511,-123,0,408,1,6
79027,1,2442,2523,-81,0,3,0,6
79028,1,2469,2404,65,0,404,1,6
79029,1,2829,2545,284,0,13,0,6
79030,1,2546,2429,117,0,109,0,6
79031,2,2328,2436,-108,0,120,0,6
79032,1,2444,2338,106,0,4,0,6
79033,3,2273,2410,-137,0,48,0,6
79034,2,2356,2561,-205,0,45,0,6
79035,1,2439,2444,-5,0,45,1,6
79036,1,2400,2315,85,0,61,0,6
79037,2,2404,2406,-2,0,227,0,6
79038,1,2411,2266,145,0,150,0,6
79039,1,2472,2391,81,0,302,1,6
79040,2,2495,2383,112,0,45,0,6
79041,1,2438,2334,104,0,6,0,6
79042,1,2392,2432,-40,0,343,1,6
79043,2,2453,2416,37,0,0,0,6
79044,2,2475,2405,70,0,110,1,6
79045,1,2525,2212,313,4,265,0,13
79046,1,2369,2446,-77,0,101,1,6
79047,2,2425,2483,-58,0,265,0,6
79048,2,2533,2550,-17,0,140,1,6
79049,1,2540,2412,128,0,190,0,6
79050,2,2377,2503,-126,0,485,1,6
79051,2,2434,2396,38,0,16,1,6
79052,2,2485,2308,177,0,8,0,0
79053,2,2423,2294,129,0,242,0,6
79054,1,2284,2412,-128,0,7,1,8
79055,1,2513,2621,-108,0,241,0,6
79056,1,2564,2446,118,0,4,0,6
79057,2,2380,2831,-451,0,110,0,6
79058,1,2560,2521,39,0,426,0,6
79059,2,2355,2436,-81,0,156,0,6
79060,2,2420,2548,-128,0,40,0,6
79061,2,2263,2414,-151,0,5,0,6
79063,1,2434,2588,-154,0,301,1,6
79064,3,2408,2543,-135,0,115,0,6
79065,2,2443,2420,23,0,108,0,6
79066,2,2412,2285,127,0,104,1,6
79067,2,2488,2474,14,0,8,0,6
79068,2,2438,2445,-7,0,113,0,6
79069,2,2276,2447,-171,0,40,1,6
79070,2,2345,2503,-158,0,45,0,6
79071,1,2330,2443,-113,0,123,0,6
79072,2,2415,2423,-8,0,190,0,6
79073,1,2408,2318,90,0,40,0,6
79075,1,2416,2247,169,0,107,1,6
79076,1,2425,2263,162,0,52,1,6
79077,1,2541,2410,131,0,133,1,6
79078,1,2313,2424,-111,0,15,0,6
79079,2,2319,2403,-84,0,45,0,6
79080,2,2555,2477,78,0,331,1,6
79081,2,2439,2376,63,0,203,0,6
79082,1,2516,2450,66,0,101,0,6
79083,1,2355,2401,-46,0,348,1,6
79084,2,2527,2616,-89,0,190,0,6
79085,1,2516,2565,-49,0,106,0,6
79086,2,2559,2551,8,0,26,0,6
79087,2,2442,2232,210,0,43,0,6
79088,1,2507,2337,170,0,469,0,6
79089,2,2278,2408,-130,4,287,0,13
79090,1,2418,2259,159,0,58,0,6
79091,1,2444,2412,32,0,101,0,6
79092,1,2614,2374,240,0,211,0,6
79093,3,2478,2428,50,0,386,0,6
79094,2,2412,2468,-56,0,140,0,6
79095,1,2410,2212,198,0,202,1,6
79096,2,2317,2454,-137,0,34,0,6
79097,2,2229,2567,-338,0,112,0,6
79098,2,2428,2488,-60,0,106,1,6
79099,1,2507,2523,-16,0,6,0,6
79100,2,2426,2423,3,0,101,0,6
79101,2,2451,2433,18,0,44,0,6
79102,3,2383,2433,-50,0,241,0,6
79103,2,2440,2350,90,0,263,1,6
79104,1,2419,2482,-63,0,245,0,6
79105,1,2422,2272,150,0,133,0,6
79106,1,2580,2442,138,0,100,0,6
79107,2,2401,2480,-79,0,345,0,6
79108,1,2439,2445,-6,0,113,0,6
79109,1,2429,2450,-21,0,106,1,6
79110,1,2407,2315,92,0,13,0,6
79111,1,2390,2400,-10,0,331,0,6
79112,1,2556,2395,161,0,45,0,6
79113,1,2491,2421,70,0,0,1,6
79114,3,2407,2545,-138,0,4,0,6
79115,3,2691,2548,143,0,125,0,6
79116,2,2410,2422,-12,0,45,0,6
79117,1,2507,2445,62,0,241,1,6
79118,1,2407,2384,23,0,41,0,6
79119,2,2237,2404,-167,0,245,0,8
79120,2,2484,2371,113,0,455,0,6
79121,1,2311,2412,-101,0,49,0,6
79122,1,2557,2558,-1,0,106,1,6
79123,1,2456,2426,30,0,338,0,6
79124,1,2247,2434,-187,0,0,0,6
79125,2,2467,2441,26,0,154,0,6
79126,1,2337,2417,-80,0,373,1,6
79127,1,2477,2327,150,0,306,0,6
79128,1,2417,2331,86,0,122,0,6
79129,3,2445,2520,-75,0,45,0,6
79130,2,2432,2384,48,0,203,0,6
79131,1,2429,2384,45,0,30,0,6
79132,2,2241,2402,-161,0,45,0,6
79133,2,2393,2517,-124,0,220,0,6
79134,1,2473,2407,66,0,34,0,6
79135,2,2264,2435,-171,0,414,0,6
79136,1,2425,2296,129,0,143,1,6
79137,2,2690,2584,106,0,455,0,6
79138,2,2423,2420,3,0,115,0,6
79139,1,2493,2484,9,0,300,0,6
79140,1,2408,2260,148,0,132,1,8
79141,1,2543,2409,134,0,190,0,6
79142,2,2520,2689,-169,0,113,0,6
79143,2,2326,2435,-109,0,218,0,6
79144,2,2444,2303,141,0,0,0,6
79145,1,2378,2412,-34,0,26,0,6
79146,2,2521,2378,143,0,119,0,6
79147,1,2416,2495,-79,0,100,0,6
79148,2,2550,2476,74,0,331,1,6
79149,1,2424,2279,145,0,207,0,6
79150,1,2400,2265,135,0,12,1,6
79151,1,2404,2318,86,0,0,1,6
79152,1,2358,2433,-75,0,190,0,6
79153,1,2279,2400,-121,0,13,0,6
79154,1,2391,2425,-34,0,143,0,6
79156,2,2553,2434,119,0,377,0,6
79157,2,2379,2420,-41,0,405,0,6
79158,1,2379,2478,-99,0,211,0,6
79159,1,2412,2268,144,4,359,0,13
79160,1,2402,2243,159,0,20,0,6
79161,1,2403,2380,23,0,204,0,6
79162,1,2479,2431,48,0,331,0,6
79163,1,2540,2316,224,0,45,0,0
79164,2,2426,2418,8,0,409,0,6
79165,2,2468,2547,-79,0,112,1,6
79166,1,2410,2402,8,0,7,0,6
79167,1,2563,2561,2,0,140,0,6
79168,1,2347,2435,-88,0,4,0,6
79169,2,2617,2678,-61,0,247,0,6
79170,1,2423,2419,4,0,114,0,6
79171,2,2363,2436,-73,0,100,0,6
79172,1,2439,2510,-71,0,80,0,6
79173,1,2513,2461,52,0,106,0,6
79174,2,2419,2397,22,0,200,1,6
79175,2,2479,2591,-112,0,120,1,6
79176,1,2335,2406,-71,0,45,0,6
79177,2,2385,2405,-20,0,125,0,6
79178,2,2519,2446,73,0,110,1,6
79179,1,2427,2204,223,0,8,0,6
79180,2,2300,2468,-168,0,85,0,6
79181,1,2556,2426,130,0,41,1,6
79182,2,2396,2438,-42,0,46,0,6
79183,1,2450,2543,-93,0,180,1,6
79184,1,2484,2480,4,0,40,0,6
79185,3,2343,2409,-66,0,16,0,6
79186,2,2442,2545,-103,0,21,0,6
79187,1,2426,2365,61,0,226,0,6
79188,2,2438,2510,-72,0,211,0,6
79189,1,2483,2374,109,0,50,0,6
79190,3,2460,2513,-53,0,110,0,6
79191,2,2417,2832,-415,0,110,0,6
79192,2,2454,2313,141,0,88,0,6
79193,1,2422,2242,180,0,1,0,6
79194,1,2344,2429,-85,0,202,0,6
79195,2,2257,2411,-154,0,0,0,8
79196,1,2240,2488,-248,0,40,0,6
79197,2,2334,2564,-230,0,394,0,6
79198,2,2443,2404,39,0,140,0,6
79199,1,2441,2311,130,0,0,0,6
79200,1,2685,2569,116,0,301,0,6
79201,2,2502,2523,-21,0,41,0,6
79202,1,2360,2431,-71,0,180,0,6
79203,2,2235,2429,-194,0,302,0,6
79204,2,2513,2518,-5,0,6,0,6
79205,1,2456,2469,-13,0,210,0,6
79206,1,2424,2420,4,0,163,0,6
79207,2,2471,2391,80,0,260,0,6
79208,3,2490,2446,44,0,310,0,6
79209,1,2425,2475,-50,0,106,0,6
79210,1,2411,2379,32,0,41,0,6
79211,1,2551,2429,122,0,107,0,6
79212,3,2471,2271,200,0,3,0,6
79213,2,2286,2414,-128,0,32,1,8
79214,2,2438,2370,68,0,464,0,6
79215,3,2536,2549,-13,0,310,0,6
79216,1,2457,2331,126,0,386,0,6
79217,3,2408,2428,-20,0,152,0,6
79218,2,2311,2400,-89,0,44,0,6
79219,1,2466,2352,114,0,44,0,6
79220,1,2463,2379,84,0,4,0,6
79221,1,2427,2376,51,0,395,0,6
79222,1,2422,2315,107,0,101,0,6
79223,1,2468,2257,211,0,152,0,6
79224,1,2432,2274,158,0,302,0,6
79225,2,2417,2833,-416,0,260,0,6
79226,2,2397,2410,-13,0,315,0,6
79227,3,2421,2257,164,0,136,0,5
79228,2,2398,2446,-48,0,200,1,6
79229,1,2507,2489,18,0,6,0,6
79230,1,2403,2487,-84,0,110,1,6
79231,1,2512,2352,160,0,128,0,6
79232,2,2347,2418,-71,0,45,0,6
79233,2,2425,2555,-130,0,113,0,6
79234,3,2464,2301,163,0,4,0,6
79235,2,2595,2612,-17,0,101,0,6
79236,1,2428,2436,-8,0,250,0,6
79237,2,2416,2307,109,0,10,1,6
79238,2,2332,2400,-68,0,60,0,6
79239,1,2445,2298,147,0,0,1,6
79240,2,2468,2475,-7,0,484,1,6
79241,2,2565,2692,-127,0,253,0,6
79242,1,2294,2432,-138,0,218,0,6
79243,1,2834,2330,504,0,122,1,6
79244,1,2422,2378,44,0,132,0,6
79245,1,2415,2417,-2,0,318,0,6
79246,1,2445,2429,16,0,46,1,6
79247,1,2432,2273,159,0,318,0,6
79248,1,2292,2427,-135,4,211,0,8
79249,2,2389,2471,-82,0,200,0,6
79250,2,2379,2470,-91,0,485,1,6
79251,2,2283,2427,-144,0,100,0,6
79252,1,2413,2409,4,0,152,0,6
79253,1,2321,2437,-116,0,333,0,6
79254,2,2424,2367,57,0,263,1,6
79255,1,2618,2590,28,0,150,0,6
79256,1,2432,2301,131,0,145,0,6
79257,1,2396,2549,-153,0,300,1,6
79258,2,2405,2306,99,0,45,0,6
79259,2,2467,2536,-69,0,4,1,6
79260,1,2424,2302,122,0,156,0,6
79261,2,2377,2416,-39,0,312,1,6
79262,2,2484,2512,-28,0,359,0,6
79263,1,2308,2410,-102,0,311,0,6
79264,1,2377,2480,-103,0,311,0,6
79265,2,2538,2555,-17,0,147,1,6
79266,2,2426,2430,-4,0,250,1,6
79267,1,2559,2421,138,0,107,1,6
79268,2,2405,2308,97,0,260,0,6
79269,1,2298,2428,-130,0,218,0,6
79270,1,2835,2365,470,0,15,0,6
79271,2,2545,2698,-153,0,256,0,6
79272,1,2404,2258,146,0,337,1,6
79273,1,2463,2410,53,0,40,0,6
79274,3,2481,2541,-60,0,123,0,6
79275,2,2419,2547,-128,0,250,0,6
79276,1,2403,2448,-45,0,100,0,6
79277,1,2317,2435,-118,0,441,0,6
79278,1,2336,2403,-67,0,404,0,6
79279,2,2348,2516,-168,0,121,0,6
79280,2,2420,2499,-79,0,324,1,6
79281,2,2403,2279,124,0,0,0,6
79282,1,2411,2296,115,0,48,0,6
79283,1,2418,2287,131,0,339,1,8
79284,2,2518,2478,40,0,6,0,6
79285,1,2461,2408,53,0,22,0,6
79286,1,2423,2272,151,0,464,0,8
79287,2,2421,2424,-3,0,331,0,6
79288,1,2430,2388,42,0,115,0,6
79289,2,2541,2404,137,0,469,0,6
79290,1,2561,2559,2,0,45,1,6
79291,1,2354,2437,-83,0,160,0,6
79292,2,2273,2476,-203,0,85,0,6
79293,1,2432,2390,42,0,135,0,6
79294,2,2380,2467,-87,0,106,0,6
79295,1,2585,2434,151,0,100,0,6
79296,2,2375,2431,-56,0,310,0,6
79297,2,2421,2473,-52,0,112,0,6
79298,1,2372,2462,-90,0,409,0,6
79299,2,2402,2415,-13,0,325,0,6
79300,2,2335,2474,-139,0,125,1,6
79301,2,2445,2369,76,0,4,0,6
79302,3,2439,2316,123,0,302,0,6
79303,2,2297,2836,-539,0,112,0,6
79304,3,2584,2551,33,0,267,0,6
79305,2,2374,2417,-43,0,190,0,6
79306,2,2241,2403,-162,0,200,0,6
79307,1,2403,2316,87,0,122,1,6
79308,1,2442,2410,32,0,0,0,6
79309,3,2416,2289,127,4,302,0,13
79310,2,2427,2305,122,0,311,0,6
79311,2,2551,2584,-33,0,63,0,6
79312,2,2468,2517,-49,0,331,0,6
79313,1,2418,2503,-85,0,101,1,6
79314,3,2560,2623,-63,0,46,0,6
79315,2,2388,2415,-27,0,317,0,6
79316,2,2540,2562,-22,0,400,1,6
79317,2,2408,2427,-19,0,218,0,6
79318,2,2431,2588,-157,0,40,1,6
79319,2,2385,2464,-79,0,45,1,6
79320,1,2519,2345,174,0,128,0,6
79321,1,2269,2427,-158,0,202,0,8
79322,1,2533,2432,101,0,58,0,6
79323,1,2836,2419,417,0,112,0,6
79324,2,2248,2404,-156,0,107,0,8
79325,1,2421,2416,5,0,112,0,6
79326,2,2234,2479,-245,0,80,0,6
79327,2,2268,2415,-147,0,15,0,6
79328,1,2430,2428,2,0,196,0,6
79329,2,2354,2434,-80,0,0,1,6
79330,2,2305,2433,-128,0,4,0,6
79331,2,2420,2412,8,0,45,0,6
79332,3,2436,2325,111,0,3,0,6
79333,2,2340,2437,-97,0,311,0,6
79334,2,2478,2455,23,0,46,1,6
79335,1,2407,2322,85,0,45,1,6
79336,2,2357,2837,-480,0,48,0,6
79337,1,2295,2438,-143,0,492,0,6
79338,2,2379,2446,-67,0,380,1,6
79339,1,2589,2546,43,0,1,0,6
79340,2,2292,2434,-142,0,454,0,6
79341,1,2420,2329,91,0,403,1,6
79342,2,2405,2447,-42,0,100,0,6
79343,2,2419,2265,154,0,150,0,6
79344,2,2394,2463,-69,0,10,0,6
79345,2,2423,2369,54,0,255,1,6
79346,3,2422,2336,86,0,123,0,8
79347,2,2496,2522,-26,0,202,0,6
79348,1,2420,2425,-5,0,49,0,6
79349,3,2406,2327,79,0,225,0,8
79350,1,2622,2567,55,0,150,1,6
79351,1,2561,2407,154,0,300,0,6
79352,1,2592,2427,165,0,100,0,6
79353,2,2478,2331,147,0,474,1,6
79354,1,2483,2336,147,0,3,0,6
79355,1,2537,2535,2,0,378,1,6
79356,2,2400,2435,-35,0,46,0,6
79357,1,2568,2472,96,0,136,0,6
79358,2,2410,2426,-16,0,324,0,6
79359,2,2433,2402,31,0,133,0,6
79360,1,2555,2468,87,0,45,1,6
79361,2,2342,2522,-180,0,315,0,6
79362,1,2527,2491,36,0,101,0,6
79363,1,2838,2438,400,0,100,0,6
79364,1,2415,2381,34,0,302,0,6
79365,1,2379,2413,-34,0,211,0,6
79366,2,2420,2419,1,4,211,0,13
79367,2,2424,2595,-171,0,301,0,6
79368,3,2298,2437,-139,0,8,0,6
79369,1,2472,2468,4,0,46,0,6
79370,1,2462,2572,-110,0,110,0,6
79371,1,2466,2395,71,0,4,1,6
79372,1,2451,2390,61,0,464,0,6
79373,2,2273,2411,-138,0,40,1,6
79374,1,2299,2424,-125,0,405,0,6
79375,2,2419,2426,-7,0,207,0,6
79376,1,2288,2405,-117,0,242,0,8
79377,1,2570,2627,-57,0,300,0,6
79378,2,2432,2405,27,0,130,0,6
79379,2,2402,2418,-16,0,172,0,6
79380,2,2404,2562,-158,0,131,0,6
79381,1,2469,2529,-60,0,123,1,6
79382,1,2420,2553,-133,0,302,1,6
79383,1,2423,2396,27,0,300,0,6
79384,3,2430,2332,98,0,105,0,6
79385,2,2559,2543,16,0,106,1,6
79386,1,2375,2416,-41,0,120,0,6
79387,1,2598,2421,177,0,100,0,6
79388,1,2485,2533,-48,0,202,0,6
79389,2,2394,2478,-84,0,112,1,6
79390,2,2461,2423,38,0,41,0,6
79391,2,2399,2460,-61,0,153,0,6
79392,1,2414,2442,-28,0,210,1,6
79393,2,2340,2470,-130,0,125,0,6
79394,2,2385,2471,-86,0,10,0,6
79395,1,2311,2437,-126,0,100,0,6
79396,1,2488,2235,253,0,2,1,6
79397,2,2376,2455,-79,0,398,0,6
79398,2,2252,2409,-157,0,62,0,6
79399,2,2501,2501,0,0,194,0,6
79400,2,2331,2413,-82,0,48,1,6
79401,2,2308,2422,-114,0,55,0,6
79402,1,2405,2405,0,0,39,0,6
79403,2,2285,2421,-136,0,242,0,8
79404,2,2391,2429,-38,0,198,0,6
79405,1,2387,2465,-78,0,437,0,6
79406,1,2436,2405,31,0,386,0,6
79407,1,2468,2323,145,0,206,0,6
79408,1,2510,2431,79,0,45,0,6
79409,1,2411,2426,-15,0,302,0,6
79410,1,2416,2378,38,0,15,0,6
79411,2,2620,2565,55,0,112,1,6
79412,1,2415,2500,-85,0,150,1,6
79413,2,2423,2372,51,0,308,0,6
79414,2,2296,2414,-118,4,279,0,13
79415,2,2292,2471,-179,0,123,0,6
79416,1,2435,2475,-40,0,211,1,6
79417,1,2522,2476,46,0,338,0,6
79418,1,2244,2490,-246,0,86,0,6
79419,1,2316,2428,-112,0,318,0,6
79420,1,2412,2292,120,0,456,0,6
79421,1,2549,2553,-4,0,335,0,6
79422,2,2394,2599,-205,0,45,0,6
79423,1,2620,2534,86,0,4,0,6
79424,1,2526,2492,34,0,100,1,6
79425,1,2381,2511,-130,0,245,1,6
79426,1,2839,2352,487,0,205,0,6
79427,1,2452,2420,32,0,0,0,6
79428,2,2274,2482,-208,0,192,0,6
79429,2,2418,2267,151,0,20,0,6
79430,3,2378,2416,-38,0,245,0,6
79431,2,2309,2509,-200,0,123,0,6
79432,1,2435,2454,-19,0,250,1,6
79433,1,2434,2386,48,0,300,0,6
79434,3,2340,2400,-60,0,112,0,6
79435,3,2482,2417,65,0,106,0,6
79436,1,2410,2382,28,0,255,1,6
79437,1,2481,2334,147,0,2,1,6
79438,2,2292,2422,-130,0,150,1,6
79439,3,2441,2441,0,0,142,0,6
79440,2,2420,2417,3,0,1,0,6
79441,1,2602,2255,347,0,15,0,6
79442,2,2527,2493,34,0,345,1,6
79443,2,2259,2515,-256,0,110,0,6
79444,2,2422,2236,186,0,102,1,6
79445,1,2571,2469,102,0,211,0,6
79446,2,2295,2473,-178,0,474,1,6
79447,2,2381,2439,-58,0,198,0,6
79448,1,2323,2422,-99,0,315,0,6
79449,2,2244,2430,-186,0,100,0,6
79450,2,2235,2410,-175,0,124,0,6
79451,2,2547,2555,-8,0,106,1,6
79452,3,2424,2337,87,0,141,0,8
79453,2,2415,2403,12,0,140,0,6
79454,2,2243,2420,-177,0,200,0,6
79455,3,2497,2402,95,0,145,0,6
79456,2,2441,2403,38,0,140,0,6
79457,1,2426,2215,211,0,201,0,6
79458,1,2370,2409,-39,0,41,0,6
79459,1,2393,2425,-32,0,45,0,6
79460,1,2546,2483,63,0,151,0,6
79461,2,2487,2314,173,0,102,0,6
79462,2,2415,2379,36,0,308,1,6
79463,2,2481,2435,46,0,330,0,6
79464,2,2418,2411,7,0,0,0,6
79465,1,2503,2471,32,0,167,0,6
79466,1,2505,2373,132,0,224,0,6
79467,1,2550,2614,-64,0,101,0,6
79468,1,2517,2281,236,0,300,0,6
79469,2,2333,2485,-152,0,80,0,6
79470,1,2473,2442,31,0,300,1,6
79471,1,2512,2307,205,0,302,0,6
79472,1,2441,2409,32,0,454,0,6
79473,2,2465,2457,8,0,100,1,6
79474,3,2414,2386,28,4,218,0,13
79475,2,2433,2355,78,0,1,0,6
79476,1,2310,2469,-159,0,132,0,6
79477,2,2306,2484,-178,0,250,0,6
79478,1,2245,2413,-168,0,213,1,6
79479,2,2415,2230,185,0,45,0,6
79480,2,2444,2376,68,0,302,0,6
79481,1,2496,2414,82,0,241,1,6
79482,1,2521,2552,-31,0,43,0,6
79483,1,2410,2423,-13,0,207,0,6
79484,3,2488,2279,209,0,202,0,6
79485,2,2419,2391,28,0,40,1,6
79486,1,2499,2509,-10,0,190,0,6
79487,3,2413,2514,-101,0,412,0,6
79488,1,2403,2266,137,0,0,0,6
79489,2,2415,2331,84,0,100,1,6
79490,3,2380,2686,-306,0,242,0,8
79491,2,2225,2418,-193,4,40,0,13
79492,2,2385,2409,-24,0,245,0,6
79493,1,2238,2409,-171,0,455,1,6
79494,1,2475,2372,103,0,302,1,6
79495,2,2261,2415,-154,0,142,1,6
79496,1,2203,2513,-310,0,153,1,6
79497,2,2372,2441,-69,0,1,0,6
79498,3,2485,2557,-72,0,385,0,6
79499,2,2371,2552,-181,0,300,0,6
79500,3,2258,2474,-216,0,120,0,6
79501,1,2417,2298,119,0,113,0,6
79502,1,2383,2437,-54,0,198,0,6
79503,1,2436,2480,-44,0,265,0,6
79504,1,2428,2253,175,0,45,0,6
79505,2,2418,2404,14,0,48,0,6
79506,2,2416,2447,-31,0,250,0,6
79507,1,2400,2319,81,0,45,0,6
79508,2,2410,2500,-90,0,151,1,6
79509,2,2290,2423,-133,0,310,0,8
79510,2,2386,2459,-73,0,133,0,6
79511,2,2303,2521,-218,0,200,0,6
79512,2,2463,2407,56,0,0,0,6
79513,1,2405,2253,152,0,102,1,6
79514,1,2412,2441,-29,0,43,1,6
79515,3,2524,2471,53,0,154,0,6
79517,2,2245,2484,-239,0,85,0,6
79518,2,2410,2463,-53,0,210,0,6
79519,1,2503,2479,24,0,139,0,6
79520,2,2604,2401,203,0,311,0,6
79521,1,2528,2511,17,0,309,0,6
79522,1,2398,2467,-69,0,40,0,6
79523,1,2452,2411,41,0,302,0,6
79524,2,2264,2400,-136,0,345,1,6
79525,1,2430,2390,40,0,243,0,6
79526,1,2486,2248,238,0,201,0,6
79527,3,2546,2576,-30,0,46,0,6
79528,3,2404,2407,-3,0,45,0,6
79529,1,2556,2486,70,0,138,0,6
79530,2,2503,2217,286,0,343,1,6
79531,1,2463,2443,20,0,200,0,6
79532,1,2405,2437,-32,0,113,0,6
79533,1,2385,2435,-50,0,198,0,6
79534,2,2411,2310,101,0,108,1,6
79535,1,2454,2352,102,0,125,0,6
79536,1,2488,2457,31,0,40,1,6
79537,2,2409,2338,71,0,300,0,6
79538,1,2250,2408,-158,0,474,0,6
79539,1,2402,2393,9,0,477,1,6
79540,1,2486,2263,223,0,43,0,6
79541,2,2206,2523,-317,0,6,0,6
79542,2,2505,2406,99,0,101,0,6
79543,2,2357,2418,-61,0,311,0,6
79544,2,2561,2523,38,0,157,1,6
79545,1,2291,2402,-111,0,262,0,6
79546,2,2324,2596,-272,0,0,0,6
79547,1,2410,2260,150,0,46,0,6
79548,3,2239,2490,-251,0,215,0,6
79549,1,2271,2420,-149,0,142,0,6
79550,1,2682,2291,391,0,4,0,8
79551,3,2473,2508,-35,0,277,0,6
79552,1,2413,2497,-84,0,130,0,6
79553,2,2252,2407,-155,0,104,0,6
79554,1,2473,2435,38,0,121,0,6
79555,2,2350,2598,-248,0,214,1,6
79556,1,2505,2411,94,0,107,0,6
79557,1,2489,2494,-5,0,150,0,6
79558,1,2564,2533,31,0,151,1,6
79559,2,2575,2546,29,0,201,0,6
79560,1,2461,2406,55,0,4,0,6
79561,2,2438,2469,-31,0,211,0,6
79562,1,2204,2434,-230,0,112,0,8
79563,2,2473,2253,220,0,6,0,6
79564,2,2400,2258,142,0,102,1,6
79565,1,2525,2203,322,0,45,0,6
79566,1,2467,2478,-11,0,80,0,6
79567,1,2452,2494,-42,0,0,1,6
79568,1,2429,2423,6,0,218,0,6
79569,1,2529,2616,-87,0,121,1,6
79570,3,2490,2420,70,0,141,0,6
79571,2,2302,2488,-186,0,120,1,6
79572,2,2323,2406,-83,0,0,0,6
79573,2,2297,2683,-386,0,5,0,8
79574,1,2526,2495,31,0,45,0,6
79575,1,2374,2515,-141,0,380,0,6
79576,1,2620,2607,13,0,394,0,6
79577,2,2428,2394,34,0,145,0,6
79578,2,2329,2418,-89,0,220,0,5
79579,1,2466,2479,-13,0,4,0,6
79580,1,2407,2510,-103,0,101,0,6
79581,1,2600,2265,335,0,15,0,6
79582,2,2411,2401,10,0,4,1,6
79583,1,2577,2554,23,0,301,1,6
79584,2,2417,2391,26,0,40,0,6
79585,1,2435,2437,-2,0,210,0,6
79586,1,2288,2416,-128,0,110,0,6
79587,2,2393,2474,-81,0,463,1,6
79588,3,2411,2570,-159,0,4,0,6
79589,2,2375,2492,-117,0,112,0,6
79590,1,2609,2472,137,0,4,0,6
79591,1,2473,2537,-64,0,302,0,6
79592,2,2411,2412,-1,0,45,0,6
79593,1,2473,2298,175,0,121,0,6
79594,1,2497,2355,142,0,153,1,6
79595,2,2397,2473,-76,0,210,0,6
79596,1,2458,2458,0,0,0,0,6
79597,2,2492,2264,228,0,43,0,6
79598,1,2401,2404,-3,0,42,1,6
79599,1,2464,2265,199,0,218,0,6
79600,2,2611,2602,9,0,406,1,6
79601,2,2502,2414,88,0,107,0,6
79602,2,2432,2400,32,0,150,0,6
79603,1,2448,2369,79,0,315,0,6
79604,2,2476,2353,123,0,122,0,6
79605,2,2530,2393,137,0,244,0,6
79606,1,2423,2480,-57,0,302,1,6
79607,2,2407,2405,2,0,288,0,6
79608,2,2359,2468,-109,0,201,0,6
79609,2,2406,2483,-77,0,303,0,6
79610,2,2248,2422,-174,0,15,0,6
79611,2,2274,2533,-259,0,210,0,6
79612,1,2549,2441,108,0,152,1,6
79613,2,2479,2413,66,0,8,0,6
79614,1,2408,2407,1,0,315,0,6
79615,2,2415,2285,130,0,107,0,6
79616,2,2368,2437,-69,0,203,0,6
79617,1,2384,2422,-38,0,56,1,5
79618,2,2522,2392,130,0,200,0,6
79619,1,2603,2270,333,0,326,0,6
79620,1,2422,2495,-73,0,101,0,6
79621,2,2266,2400,-134,0,148,1,6
79622,1,2477,2355,122,0,211,0,6
79623,1,2416,2272,144,0,20,0,6
79624,2,2328,2414,-86,0,0,0,6
79625,1,2406,2426,-20,0,230,1,6
79626,1,2407,2468,-61,0,101,1,6
79627,1,2409,2248,161,0,110,0,6
79628,1,2424,2245,179,0,115,0,8
79629,1,2472,2360,112,0,6,0,6
79630,2,2535,2329,206,0,45,0,6
79631,3,2420,2355,65,0,48,0,6
79632,1,2442,2472,-30,0,466,1,6
79633,1,2322,2464,-142,0,40,0,6
79634,2,2235,2487,-252,0,46,0,6
79635,2,2307,2402,-95,0,101,0,6
79636,3,2296,2402,-106,0,262,0,6
79637,1,2605,2514,91,0,404,0,6
79638,1,2342,2407,-65,0,28,0,6
79639,1,2685,2293,392,0,40,0,8
79640,1,2608,2580,28,0,247,0,6
79641,3,2418,2605,-187,0,46,0,6
79642,3,2488,2429,59,0,107,0,6
79643,2,2482,2437,45,0,123,0,6
79644,1,2473,2553,-80,0,49,1,6
79645,1,2496,2350,146,0,302,0,6
79646,2,2249,2425,-176,0,45,0,6
79647,1,2401,2510,-109,0,150,1,6
79648,2,2248,2415,-167,0,48,0,6
79649,1,2428,2260,168,0,101,0,6
79650,2,2268,2494,-226,0,245,0,6
79651,1,2444,2610,-166,0,107,0,6
79652,2,2476,2476,0,0,4,0,6
79653,2,2602,2328,274,0,13,0,6
79654,1,2400,2300,100,0,241,1,6
79655,1,2491,2419,72,0,373,0,6
79656,2,2412,2414,-2,0,234,0,6
79657,1,2456,2461,-5,0,0,1,6
79658,2,2291,2401,-110,0,41,0,8
79659,3,2362,2421,-59,0,310,0,6
79660,1,2225,2400,-175,0,201,0,6
79661,1,2406,2527,-121,0,14,0,6
79662,1,2448,2419,29,0,311,0,6
79663,2,2575,2613,-38,0,101,0,6
79664,1,2471,2275,196,0,197,1,6
79665,1,2400,2404,-4,4,40,0,11
79666,3,2398,2403,-5,0,46,0,6
79667,1,2430,2487,-57,0,101,0,6
79668,2,2357,2467,-110,0,10,0,6
79669,2,2271,2496,-225,0,200,0,6
79670,1,2461,2480,-19,0,112,0,6
79671,1,2618,2570,48,0,246,0,6
79673,1,2481,2436,45,0,109,0,6
79674,1,2549,2450,99,0,242,0,6
79675,1,2482,2301,181,0,17,0,6
79676,1,2390,2503,-113,0,395,0,6
79677,2,2309,2496,-187,0,46,1,6
79678,1,2415,2260,155,0,48,1,6
79679,2,2453,2420,33,0,331,0,6
79680,3,2287,2404,-117,0,485,0,6
79681,1,2414,2260,154,0,8,0,6
79682,2,2308,2519,-211,0,200,1,6
79683,2,2414,2322,92,0,302,0,6
79684,2,2456,2482,-26,0,117,0,6
79685,1,2555,2368,187,0,4,0,6
79686,1,2490,2304,186,0,145,0,6
79687,2,2431,2486,-55,0,101,0,6
79688,1,2405,2319,86,0,80,1,6
79689,3,2474,2467,7,0,46,0,6
79690,1,2434,2308,126,0,487,0,6
79691,1,2468,2333,135,0,455,1,6
79692,1,2382,2485,-103,0,5,1,6
79693,1,2499,2272,227,0,25,0,6
79694,1,2298,2438,-140,0,257,0,6
79695,1,2411,2250,161,0,40,1,6
79696,2,2299,2417,-118,0,453,0,6
79697,1,2435,2316,119,0,125,0,6
79698,2,2340,2471,-131,0,454,0,6
79699,2,2495,2420,75,0,106,0,6
79700,3,2404,2593,-189,0,45,0,6
79701,2,2409,2407,2,0,200,0,6
79702,1,2403,2342,61,0,40,0,6
79703,1,2404,2269,135,0,131,0,6
79704,1,2491,2427,64,0,107,0,6
79705,2,2426,2553,-127,0,196,0,6
79706,2,2247,2418,-171,0,226,0,6
79707,1,2499,2475,24,0,302,0,6
79708,1,2313,2402,-89,0,5,0,6
79709,1,2557,2422,135,0,264,0,6
79710,3,2522,2347,175,0,40,0,6
79711,1,2431,2388,43,0,40,0,6
79712,3,2488,2487,1,0,260,0,6
79713,1,2351,2456,-105,0,45,1,6
79714,1,2427,2353,74,0,453,0,6
79715,2,2419,2560,-141,0,196,0,6
79716,3,2422,2496,-74,0,101,0,6
79717,2,2493,2477,16,0,100,0,6
79718,2,2347,2472,-125,0,45,0,6
79719,2,2324,2467,-143,0,123,0,6
79720,1,2254,2414,-160,0,315,0,6
79721,1,2438,2474,-36,0,330,0,6
79722,1,2469,2421,48,0,106,0,6
79723,2,2295,2504,-209,0,409,0,6
79724,2,2411,2331,80,0,8,0,6
79725,2,2483,2394,89,0,108,0,6
79726,2,2488,2437,51,0,101,0,6
79727,2,2455,2407,48,0,153,0,6
79728,2,2564,2415,149,0,242,0,6
79729,1,2462,2447,15,0,411,0,6
79730,2,2413,2319,94,0,300,0,6
79731,3,2436,2403,33,0,140,0,6
79732,2,2453,2275,178,0,468,1,6
79733,1,2494,2423,71,0,107,1,6
79734,1,2458,2317,141,4,16,1,8
79735,2,2309,2488,-179,0,157,0,6
79736,2,2256,2422,-166,0,122,0,6
79737,1,2503,2234,269,0,150,0,6
79738,2,2220,2439,-219,0,338,0,6
79739,3,2507,2351,156,0,41,0,6
79740,2,2253,2590,-337,0,0,0,6
79741,1,2487,2431,56,0,300,0,6
79742,1,2410,2404,6,0,49,0,6
79743,1,2403,2468,-65,0,113,0,6
79744,2,2349,2436,-87,0,200,0,6
79745,1,2491,2444,47,0,190,1,6
79746,1,2474,2288,186,0,136,1,6
79747,2,2416,2519,-103,0,14,0,6
79748,1,2592,2263,329,0,9,0,6
79749,2,2471,2403,68,0,448,1,6
79750,2,2389,2448,-59,0,5,0,6
79751,2,2236,2408,-172,0,150,0,6
79752,1,2476,2344,132,0,455,0,6
79753,2,2341,2439,-98,0,102,0,8
79754,1,2476,2481,-5,0,12,0,6
79755,2,2423,2556,-133,0,196,0,6
79756,2,2290,2406,-116,0,3,0,6
79757,1,2425,2354,71,0,403,0,6
79758,1,2251,2505,-254,0,46,1,6
79759,2,2413,2441,-28,0,296,0,6
79760,2,2410,2382,28,0,80,0,6
79761,3,2409,2415,-6,0,302,0,6
79762,1,2419,2499,-80,0,101,0,6
79763,2,2350,2445,-95,0,216,0,6
79764,1,2520,2260,260,0,301,1,6
79765,1,2276,2440,-164,0,253,0,6
79766,1,2418,2542,-124,0,45,1,6
79767,3,2315,2412,-97,0,100,0,6
79768,2,2453,2449,4,0,269,0,6
79769,1,2524,2271,253,0,45,0,6
79770,3,2492,2426,66,0,107,0,6
79771,1,2261,2415,-154,0,315,1,6
79772,2,2461,2438,23,0,461,1,6
79773,1,2567,2410,157,0,181,0,6
79774,2,2560,2420,140,0,242,0,6
79775,2,2403,2409,-6,0,114,0,6
79776,2,2492,2496,-4,0,45,0,6
79777,2,2426,2439,-13,0,4,0,6
79778,2,2345,2449,-104,0,216,0,6
79779,2,2285,2506,-221,0,409,0,6
79780,1,2594,2338,256,0,9,0,6
79781,2,2475,2571,-96,0,107,0,6
79782,1,2360,2464,-104,0,1,0,6
79783,1,2407,2482,-75,0,164,1,6
79784,2,2428,2552,-124,0,196,0,6
79785,2,2340,2480,-140,0,39,0,6
79786,2,2430,2546,-116,0,387,0,6
79787,1,2452,2345,107,0,211,0,6
79788,2,2414,2335,79,0,302,0,6
79789,2,2328,2502,-174,0,130,1,6
79790,2,2408,2487,-79,0,260,0,6
79791,1,2447,2317,130,0,453,1,6
79792,1,2294,2440,-146,0,206,1,6
79793,1,2496,2328,168,0,106,0,6
79794,2,2294,2403,-109,0,202,1,6
79795,2,2623,2707,-84,0,112,1,6
79796,1,2455,2447,8,0,15,1,6
79797,2,2443,2308,135,0,106,0,8
79798,3,2269,2526,-257,0,110,0,6
79799,3,2509,2411,98,0,480,0,6
79800,2,2403,2491,-88,0,300,0,6
79801,1,2246,2407,-161,0,0,0,6
79802,1,2444,2456,-12,0,14,1,6
79803,2,2257,2431,-174,0,4,1,6
79804,2,2256,2479,-223,0,192,0,6
79805,3,2405,2340,65,0,241,0,6
79806,2,2455,2471,-16,0,359,1,6
79807,1,2575,2625,-50,0,42,0,6
79808,2,2556,2424,132,0,242,0,6
79809,3,2407,2400,7,0,49,0,6
79810,1,2475,2298,177,0,8,0,6
79811,1,2414,2446,-32,0,242,1,6
79812,2,2445,2388,57,0,46,1,6
79813,2,2501,2426,75,0,100,0,6
79814,1,2549,2408,141,0,209,0,6
79815,1,2495,2383,112,0,259,1,6
79816,1,2550,2426,124,0,110,1,6
79817,2,2483,2336,147,0,344,0,6
79818,2,2505,2491,14,0,260,1,6
79819,3,2318,2431,-113,0,373,0,6
79820,2,2404,2552,-148,0,300,0,6
79821,1,2401,2294,107,0,121,0,6
79822,2,2618,2581,37,0,487,0,6
79823,2,2432,2314,118,0,250,0,6
79824,2,2482,2429,53,0,141,1,6
79825,3,2412,2501,-89,0,5,0,6
79826,1,2413,2230,183,0,115,0,6
79827,1,2450,2478,-28,0,46,1,6
79828,2,2265,2518,-253,0,310,1,6
79829,2,2233,2507,-274,0,106,1,6
79830,1,2321,2425,-104,0,469,1,6
79831,2,2389,2442,-53,0,202,0,6
79832,2,2346,2434,-88,0,80,1,6
79833,2,2432,2548,-116,0,196,0,6
79834,2,2450,2450,0,0,415,0,6
79835,1,2468,2298,170,0,40,0,6
79836,2,2440,2450,-10,0,300,0,6
79837,2,2379,2499,-120,0,101,0,6
79838,2,2438,2325,113,0,4,0,6
79839,3,2404,2222,182,0,40,0,6
79840,2,2422,2554,-132,0,302,0,6
79841,1,2556,2401,155,0,194,0,6
79842,2,2552,2428,124,0,210,0,6
79843,2,2345,2476,-131,0,38,0,6
79844,1,2436,2246,190,0,50,0,8
79845,1,2367,2499,-132,0,1,1,6
79846,1,2558,2418,140,0,110,1,6
79847,1,2416,2294,122,0,132,0,6
79848,2,2258,2499,-241,0,230,1,6
79849,1,2612,2619,-7,0,408,0,6
79850,2,2397,2559,-162,0,352,0,6
79851,1,2509,2325,184,0,302,0,6
79852,1,2497,2444,53,0,45,0,6
79853,1,2472,2385,87,0,46,0,6
79854,1,2436,2243,193,0,15,0,6
79855,2,2447,2418,29,0,210,1,6
79856,1,2471,2503,-32,0,302,0,6
79857,1,2411,2438,-27,0,211,0,6
79858,2,2436,2544,-108,0,196,0,6
79859,1,2562,2394,168,0,190,0,6
79860,2,2407,2455,-48,0,112,0,6
79861,2,2391,2566,-175,0,352,0,6
79862,2,2373,2431,-58,0,46,1,6
79863,1,2348,2435,-87,0,3,1,6
79864,1,2403,2477,-74,0,49,1,6
79865,3,2524,2477,47,0,45,0,6
79866,2,2460,2402,58,0,455,0,6
79867,2,2431,2417,14,0,17,0,6
79868,1,2492,2362,130,0,220,0,6
79869,2,2415,2561,-146,0,351,0,6
79870,3,2502,2439,63,0,48,0,6
79871,1,2410,2444,-34,0,110,0,6
79872,1,2548,2432,116,0,242,0,6
79873,1,2420,2300,120,4,255,0,13
79874,1,2268,2512,-244,0,150,0,6
79875,1,2440,2275,165,0,13,0,6
79876,3,2613,2567,46,0,140,0,6
79877,2,2497,2477,20,0,107,0,6
79878,2,2316,2501,-185,0,373,0,6
79879,2,2435,2457,-22,0,122,0,6
79880,3,2428,2552,-124,0,192,0,6
79881,2,2323,2807,-484,0,197,0,8
79882,2,2424,2420,4,0,300,0,6
79883,2,2521,2296,225,0,40,0,6
79884,2,2329,2436,-107,0,300,0,6
79885,2,2565,2411,154,0,110,1,6
79886,2,2470,2384,86,0,455,0,6
79887,2,2495,2408,87,0,200,0,6
79888,2,2454,2457,-3,0,344,0,6
79889,1,2503,2405,98,0,40,0,6
79890,2,2474,2594,-120,0,120,0,6
79891,1,2292,2460,-168,0,112,0,6
79892,1,2491,2410,81,0,145,1,6
79893,2,2512,2433,79,0,45,0,6
79894,1,2477,2295,182,0,135,0,6
79895,1,2523,2327,196,0,300,1,6
79896,1,2504,2347,157,0,107,0,6
79897,2,2296,2417,-121,4,211,0,13
79898,2,2388,2412,-24,0,43,0,6
79899,2,2440,2416,24,0,457,0,6
79900,2,2405,2488,-83,0,157,1,6
79901,1,2463,2448,15,0,118,0,6
79902,1,2456,2463,-7,0,162,1,6
79903,1,2299,2441,-142,0,300,0,6
79904,1,2550,2430,120,0,242,0,6
79905,1,2385,2426,-41,0,331,0,6
79906,1,2418,2319,99,0,113,0,6
79907,1,2407,2335,72,0,301,0,6
79908,1,2420,2557,-137,0,388,1,6
79909,2,2481,2507,-26,0,194,0,6
79910,1,2418,2414,4,0,304,0,6
79911,1,2484,2308,176,0,403,0,6
79912,2,2299,2434,-135,0,31,1,6
79913,2,2598,2465,133,0,154,0,6
79914,2,2496,2468,28,0,110,0,6
79915,2,2439,2449,-10,0,7,0,6
79916,1,2418,2383,35,0,253,0,6
79917,1,2452,2399,53,0,454,0,6
79918,3,2454,2547,-93,0,102,0,6
79919,1,2426,2554,-128,0,196,0,6
79920,3,2444,2526,-82,0,13,0,6
79921,2,2440,2535,-95,0,40,0,6
79922,1,2493,2408,85,0,277,0,6
79923,2,2316,2408,-92,0,100,0,6
79924,1,2434,2295,139,0,353,1,6
79925,3,2344,2497,-153,0,8,0,6
79926,1,2433,2443,-10,0,53,0,6
79927,1,2453,2401,52,0,188,0,6
79929,3,2309,2404,-95,0,48,0,6
79930,3,2525,2272,253,0,40,0,6
79931,1,2457,2361,96,0,8,1,6
79932,2,2445,2310,135,0,14,0,6
79933,3,2402,2320,82,0,4,0,6
79934,1,2438,2462,-24,0,121,0,6
79935,1,2549,2428,121,0,152,1,6
79936,1,2404,2487,-83,0,107,1,6
79937,1,2547,2434,113,0,242,0,6
79938,2,2483,2590,-107,0,101,0,6
79939,1,2437,2387,50,0,46,0,6
79940,1,2466,2404,62,0,278,0,6
79941,2,2474,2489,-15,0,117,0,6
79942,2,2277,2456,-179,0,120,0,6
79943,1,2343,2434,-91,0,110,0,5
79944,2,2266,2427,-161,0,202,0,6
79945,1,2512,2301,211,0,301,0,6
79946,1,2412,2423,-11,0,415,1,6
79947,1,2437,2456,-19,0,123,0,6
79948,2,2429,2509,-80,0,110,0,6
79949,3,2405,2363,42,0,40,0,6
79950,1,2369,2444,-75,0,170,0,6
79951,3,2497,2494,3,0,200,0,6
79952,2,2520,2438,82,0,369,0,6
79953,2,2442,2312,130,0,40,0,6
79954,1,2458,2439,19,0,42,0,6
79955,2,2396,2470,-74,0,210,1,6
79956,1,2419,2386,33,0,450,0,6
79957,2,2376,2422,-46,0,48,1,6
79958,3,2485,2403,82,0,190,0,6
79959,1,2424,2553,-129,0,387,1,6
79960,2,2430,2551,-121,0,196,0,6
79961,1,2427,2325,102,0,110,0,6
79962,2,2459,2461,-2,0,122,0,6
79963,1,2594,2474,120,0,1,1,6
79964,1,2545,2495,50,0,373,0,6
79965,1,2471,2442,29,0,103,1,6
79966,1,2437,2260,177,0,241,0,6
79967,1,2459,2298,161,0,141,0,6
79968,1,2514,2306,208,0,4,0,6
79969,2,2298,2508,-210,0,122,1,6
79970,1,2436,2565,-129,0,300,1,6
79971,2,2467,2443,24,0,4,1,6
79972,1,2434,2281,153,0,374,0,6
79973,1,2450,2463,-13,0,250,0,6
79974,2,2391,2405,-14,0,338,0,6
79975,2,2475,2417,58,0,434,0,6
79976,2,2475,2497,-22,0,6,0,6
79977,2,2554,2426,128,0,104,0,6
79978,2,2490,2550,-60,0,105,0,6
79979,1,2469,2391,78,0,167,1,6
79980,2,2397,2432,-35,0,106,0,6
79981,2,2356,2433,-77,0,115,0,6
79982,2,2385,2509,-124,0,101,0,6
79983,1,2360,2437,-77,0,106,1,6
79984,2,2381,2424,-43,0,91,1,6
79985,2,2427,2330,97,0,42,0,6
79986,2,2483,2432,51,0,112,1,6
79987,3,2430,2305,125,0,277,0,6
79988,1,2421,2339,82,0,205,0,6
79989,1,2423,2474,-51,0,45,0,6
79990,2,2297,2437,-140,0,122,1,6
79991,1,2448,2278,170,0,201,0,6
79992,2,2441,2263,178,0,200,0,6
79993,2,2312,2470,-158,0,200,0,6
79994,2,2503,2466,37,0,154,0,6
79995,2,2370,2525,-155,0,416,0,6
79996,1,2555,2485,70,0,15,0,6
79997,1,2419,2277,142,0,1,0,6
79998,1,2408,2468,-60,0,106,0,6
79999,2,2434,2547,-113,0,196,0,6
80000,1,2462,2456,6,0,152,0,6
80001,1,2557,2443,114,0,45,0,6
80002,1,2511,2295,216,0,1,1,6
80003,3,2437,2449,-12,0,53,0,6
80004,1,2466,2439,27,0,112,0,6
80005,1,2473,2363,110,0,4,0,6
80006,2,2291,2420,-129,0,218,0,6
80007,2,2475,2461,14,0,103,0,6
80008,1,2387,2473,-86,0,213,0,6
80009,1,2551,2430,121,0,242,1,6
80010,1,2382,2432,-50,0,172,1,6
80011,1,2440,2561,-121,0,80,0,6
80012,2,2397,2496,-99,0,302,0,6
80013,3,2354,2414,-60,0,140,0,6
80014,1,2467,2426,41,0,45,0,6
80015,2,2507,2471,36,0,150,0,6
80016,1,2421,2287,134,0,102,0,6
80017,2,2202,2420,-218,0,11,0,5
80018,2,2481,2560,-79,0,105,0,6
80019,1,2421,2300,121,0,398,0,8
80020,2,2441,2477,-36,0,311,0,6
80021,2,2462,2453,9,0,96,0,6
80022,1,2514,2341,173,0,4,0,6
80023,2,2411,2287,124,0,229,0,6
80024,1,2467,2342,125,0,7,0,6
80025,2,2379,2436,-57,0,43,0,6
80026,1,2542,2511,31,0,45,0,6
80027,1,2337,2482,-145,0,472,0,6
80029,1,2479,2501,-22,0,123,0,6
80030,1,2437,2322,115,0,487,0,6
80031,2,2239,2412,-173,0,43,0,6
80032,2,2450,2468,-18,0,196,0,6
80033,1,2293,2513,-220,0,100,0,6
80034,1,2449,2441,8,0,338,1,6
80035,2,2553,2401,152,0,300,0,6
80036,1,2478,2293,185,0,143,0,6
80037,2,2424,2469,-45,0,150,0,6
80038,1,2453,2286,167,0,101,0,6
80039,1,2426,2555,-129,0,193,0,6
80040,2,2564,2476,88,0,371,1,6
80041,2,2400,2376,24,0,310,0,6
80042,2,2266,2425,-159,0,38,0,6
80043,2,2289,2426,-137,0,40,1,6
80044,1,2456,2420,36,0,311,0,6
80045,2,2409,2471,-62,0,176,0,6
80046,1,2428,2276,152,0,218,0,6
80047,2,2260,2421,-161,0,4,0,6
80048,2,2394,2525,-131,0,277,1,6
80049,2,2441,2334,107,0,311,0,6
80050,3,2413,2473,-60,0,45,0,6
80051,1,2374,2484,-110,0,308,0,6
80052,2,2243,2403,-160,4,200,0,13
80053,1,2330,2419,-89,0,469,0,6
80054,2,2495,2397,98,0,121,0,6
80055,3,2547,2434,113,0,242,0,6
80056,2,2459,2506,-47,0,353,1,6
80057,1,2329,2428,-99,0,4,0,6
80058,2,2481,2326,155,0,107,0,6
80059,2,2200,2509,-309,0,409,0,6
80060,2,2473,2445,28,0,191,0,6
80062,1,2504,2302,202,0,1,0,6
80063,2,2421,2336,85,0,170,0,6
80064,1,2474,2436,38,0,135,0,6
80065,1,2462,2390,72,0,0,1,6
80066,2,2220,2429,-209,0,10,0,6
80067,1,2529,2420,109,0,352,0,6
80068,2,2411,2383,28,0,240,0,6
80069,1,2415,2461,-46,0,106,1,6
80070,1,2412,2476,-64,0,45,1,6
80071,1,2358,2490,-132,0,142,0,6
80072,1,2406,2455,-49,0,304,0,6
80073,2,2343,2414,-71,0,4,0,6
80074,1,2452,2405,47,0,151,1,6
80075,1,2476,2382,94,0,200,1,6
80076,2,2424,2472,-48,0,101,0,6
80077,1,2487,2433,54,0,42,0,6
80078,1,2257,2414,-157,0,43,0,6
80079,2,2367,2404,-37,0,140,0,6
80080,2,2436,2545,-109,0,192,0,6
80081,1,2421,2418,3,0,112,0,6
80082,2,2511,2454,57,0,4,0,6
80083,2,2451,2467,-16,0,196,1,6
80084,1,2364,2456,-92,0,255,1,6
80085,2,2299,2507,-208,0,106,0,6
80086,2,2389,2403,-14,0,212,0,6
80087,2,2288,2433,-145,0,40,0,6
80088,2,2420,2431,-11,0,43,1,6
80089,2,2295,2438,-143,0,253,1,6
80090,1,2745,2269,476,0,330,0,6
80091,1,2407,2256,151,4,0,0,13
80092,1,2425,2265,160,0,221,1,5
80093,2,2626,2684,-58,0,400,1,6
80094,2,2469,2397,72,0,455,1,6
80095,2,2416,2418,-2,0,202,1,6
80096,3,2386,2455,-69,0,106,0,6
80097,2,2404,2512,-108,0,34,0,6
80098,2,2428,2336,92,0,4,0,6
80099,2,2448,2492,-44,0,302,0,6
80100,1,2418,2416,2,0,241,0,6
80101,2,2413,2480,-67,0,20,1,6
80102,1,2400,2458,-58,0,242,1,6
80103,1,2409,2242,167,0,1,0,6
80104,1,2477,2205,272,0,40,0,6
80105,2,2419,2358,61,0,310,0,6
80106,1,2461,2505,-44,0,360,0,6
80107,3,2402,2357,45,0,65,0,6
80108,1,2549,2432,117,0,242,0,6
80109,3,2746,2427,319,0,461,0,6
80110,2,2424,2352,72,0,45,0,6
80111,2,2473,2446,27,0,152,1,6
80112,1,2541,2492,49,0,330,1,6
80113,2,2436,2415,21,0,17,0,6
80114,2,2402,2314,88,0,302,0,6
80115,3,2412,2497,-85,0,302,0,6
80116,1,2436,2289,147,0,380,1,6
80117,2,2218,2475,-257,0,127,0,6
80119,1,2409,2293,116,0,115,0,6
80120,2,2411,2424,-13,0,127,0,6
80121,2,2406,2479,-73,0,40,0,6
80122,1,2516,2245,271,0,7,0,6
80123,2,2408,2390,18,0,40,0,6
80124,2,2688,2621,67,0,45,0,6
80125,2,2232,2401,-169,0,31,0,6
80126,2,2349,2471,-122,0,427,0,6
80127,1,2628,2467,161,0,395,1,6
80128,2,2454,2417,37,0,485,1,6
80129,2,2243,2412,-169,0,106,1,6
80130,2,2485,2408,77,0,111,0,6
80131,2,2428,2553,-125,0,192,0,6
80132,2,2477,2250,227,0,121,0,6
80133,1,2414,2337,77,0,150,1,6
80134,2,2430,2405,25,0,301,1,6
80135,1,2518,2216,302,0,4,0,6
80136,1,2410,2243,167,0,101,0,6
80137,1,2431,2742,-311,0,187,0,6
80138,2,2430,2387,43,0,354,0,6
80139,2,2421,2377,44,0,42,1,6
80140,1,2414,2350,64,0,310,0,6
80141,2,2496,2449,47,0,244,0,6
80142,2,2428,2340,88,0,215,0,8
80143,1,2452,2404,48,0,135,0,6
80144,1,2732,2441,291,0,112,0,6
80145,3,2362,2467,-105,0,12,0,6
80146,1,2415,2478,-63,0,9,1,6
80147,2,2422,2264,158,0,15,0,6
80148,1,2478,2213,265,0,225,0,6
80149,1,2270,2413,-143,0,4,0,6
80150,3,2365,2401,-36,0,140,0,6
80151,1,2333,2419,-86,0,43,0,6
80152,2,2430,2411,19,4,242,0,13
80153,1,2557,2424,133,0,242,0,6
80154,2,2416,2443,-27,0,46,1,6
80155,2,2464,2631,-167,0,58,0,6
80156,1,2424,2362,62,0,45,1,6
80157,2,2447,2568,-121,0,447,0,6
80158,2,2209,2480,-271,0,43,0,6
80159,2,2411,2413,-2,0,200,0,6
80160,2,2308,2490,-182,0,302,0,6
80161,1,2213,2468,-255,0,45,0,6
80162,2,2354,2456,-102,0,264,0,6
80163,1,2423,2200,223,0,128,1,6
80164,3,2423,2382,41,0,45,0,6
80165,1,2425,2371,54,0,107,0,5
80166,2,2300,2521,-221,0,30,0,6
80167,2,2350,2444,-94,0,41,0,6
80168,2,2345,2414,-69,0,310,0,6
80169,1,2513,2482,31,0,48,0,6
80171,1,2449,2287,162,0,40,1,6
80172,2,2572,2439,133,0,491,0,6
80173,1,2405,2485,-80,0,101,0,6
80174,2,2421,2561,-140,0,196,0,6
80175,2,2524,2369,155,0,372,0,6
80176,2,2340,2414,-74,0,310,1,6
80177,1,2393,2465,-72,0,151,1,6
80178,3,2345,2459,-114,0,130,0,6
80180,1,2457,2406,51,0,115,0,6
80181,1,2419,2406,13,0,241,0,6
80182,2,2448,2410,38,0,47,0,6
80183,3,2487,2296,191,0,190,0,8
80184,1,2564,2417,147,0,104,0,6
80185,1,2493,2391,102,0,264,0,6
80186,2,2361,2429,-68,0,210,0,6
80187,1,2219,2418,-199,0,201,0,6
80188,1,2460,2353,107,0,122,1,6
80189,2,2273,2418,-145,4,112,0,13
80190,2,2356,2423,-67,0,107,0,6
80191,1,2473,2310,163,0,219,0,6
80192,1,2478,2401,77,0,45,0,6
80193,1,2401,2419,-18,0,11,1,6
80194,3,2247,2402,-155,0,123,0,6
80195,1,2400,2424,-24,0,200,0,6
80196,1,2478,2431,47,0,415,0,6
80197,1,2457,2223,234,0,106,0,6
80198,2,2366,2412,-46,0,138,0,6
80199,1,2418,2448,-30,0,461,0,6
80200,2,2423,2471,-48,0,9,1,6
80201,2,2564,2497,67,0,306,1,6
80202,2,2342,2417,-75,0,40,0,6
80203,2,2221,2516,-295,0,116,0,6
80204,2,2284,2453,-169,0,30,1,6
80205,2,2464,2632,-168,0,57,0,6
80206,2,2458,2442,16,0,110,0,6
80207,1,2433,2349,84,0,102,0,6
80208,1,2517,2309,208,0,39,0,6
80209,1,2417,2219,198,0,106,0,6
80210,1,2360,2483,-123,0,4,0,6
80211,1,2428,2351,77,0,45,0,6
80212,2,2424,2275,149,0,404,0,6
80213,2,2447,2442,5,0,106,0,6
80214,1,2383,2425,-42,0,43,0,6
80215,2,2418,2406,12,0,291,0,6
80216,2,2400,2478,-78,0,154,0,6
80217,1,2417,2483,-66,0,40,1,6
80218,3,2392,2425,-33,0,43,0,6
80219,2,2340,2407,-67,0,377,0,6
80220,1,2421,2418,3,0,42,0,6
80221,1,2438,2421,17,0,150,0,6
80222,1,2452,2389,63,0,200,0,6
80223,2,2448,2413,35,0,311,1,6
80224,2,2476,2330,146,0,111,0,6
80225,2,2504,2635,-131,0,115,1,6
80226,2,2290,2597,-307,4,220,0,13
80227,2,2210,2461,-251,0,42,0,6
80228,1,2521,2558,-37,0,2,1,6
80229,1,2604,2283,321,4,223,0,13
80230,2,2423,2475,-52,0,48,0,6
80231,2,2413,2412,1,0,462,0,6
80232,2,2277,2609,-332,4,308,0,13
80233,2,2292,2443,-151,0,201,0,6
80234,1,2416,2450,-34,0,45,0,6
80235,2,2202,2520,-318,0,113,0,6
80236,2,2347,2432,-85,0,107,0,6
80237,1,2484,2244,240,0,278,0,8
80238,2,2338,2468,-130,0,308,0,6
80239,2,2279,2416,-137,0,300,1,6
80240,2,2267,2424,-157,0,4,0,6
80241,2,2476,2400,76,0,40,1,6
80242,1,2283,2464,-181,0,251,1,6
80243,3,2614,2272,342,4,220,0,13
80244,1,2422,2269,153,4,327,0,13
80245,2,2441,2426,15,0,112,0,6
80246,1,2472,2334,138,0,110,1,6
80247,1,2412,2412,0,0,200,0,6
80248,2,2329,2457,-128,0,310,0,6
80249,1,2463,2299,164,0,121,0,6
80250,1,2418,2442,-24,0,4,0,6
80251,1,2407,2384,23,0,453,0,6
80252,2,2343,2500,-157,0,121,0,6
80253,3,2436,2362,74,0,106,0,6
80254,1,2364,2411,-47,0,101,0,6
80255,1,2480,2298,182,0,1,1,6
80256,2,2639,2542,97,0,398,0,6
80257,1,2407,2353,54,0,45,0,6
80258,1,2469,2211,258,0,40,0,6
80259,2,2240,2522,-282,0,115,0,6
80260,2,2419,2539,-120,0,150,1,6
80261,2,2371,2427,-56,0,10,1,6
80262,2,2551,2518,33,0,315,0,6
80263,2,2475,2527,-52,0,13,1,6
80264,2,2430,2410,20,0,110,0,6
80265,1,2550,2632,-82,0,110,0,6
80266,2,2427,2471,-44,0,101,1,6
80267,1,2447,2434,13,0,45,1,6
80268,1,2456,2371,85,0,112,1,6
80269,2,2331,2475,-144,0,22,0,6
80270,1,2504,2378,126,0,490,0,6
80271,2,2396,2467,-71,0,108,0,6
80272,3,2242,2487,-245,0,269,0,8
80273,1,2543,2432,111,0,346,1,6
80274,1,2424,2249,175,0,145,0,6
80275,2,2336,2407,-71,0,11,1,6
80276,2,2436,2436,0,0,461,0,6
80277,1,2370,2483,-113,0,110,0,6
80278,1,2503,2377,126,0,121,0,6
80279,1,2524,2259,265,0,4,0,6
80280,1,2557,2461,96,0,7,0,6
80281,1,2391,2412,-21,0,134,0,6
80282,1,2379,2430,-51,0,89,1,6
80283,3,2381,2466,-85,0,100,0,6
80284,2,2625,2557,68,0,398,1,6
80285,2,2479,2327,152,0,110,0,6
80286,2,2524,2532,-8,0,302,1,6
80287,1,2526,2311,215,0,4,0,6
80288,3,2439,2432,7,0,40,0,6
80289,3,2354,2507,-153,0,113,0,6
80290,3,2269,2412,-143,0,0,0,6
80291,2,2417,2424,-7,0,110,0,6
80292,2,2340,2475,-135,0,106,1,6
80293,1,2381,2406,-25,0,42,0,6
80294,1,2377,2508,-131,0,453,1,6
80295,1,2483,2245,238,0,103,0,8
80296,1,2460,2432,28,0,202,0,6
80297,1,2473,2528,-55,0,408,0,6
80298,3,2298,2436,-138,0,0,0,6
80299,1,2430,2329,101,0,0,0,6
80300,2,2266,2427,-161,0,49,0,6
80301,2,2388,2435,-47,0,107,0,6
80302,2,2335,2471,-136,0,41,1,6
80303,1,2476,2410,66,0,40,1,6
80304,1,2238,2403,-165,0,112,0,6
80305,1,2271,2422,-151,0,4,0,6
80306,3,2456,2441,15,0,112,0,6
80307,1,2430,2434,-4,0,40,0,6
80308,1,2479,2208,271,0,4,1,6
80309,3,2564,2618,-54,0,110,0,6
80310,2,2400,2400,0,0,455,0,6
80311,2,2386,2440,-54,0,57,0,6
80312,2,2377,2465,-88,0,45,0,6
80313,1,2427,2431,-4,0,241,0,6
80314,1,2431,2376,55,0,45,0,6
80315,2,2432,2470,-38,0,405,1,6
80316,1,2505,2519,-14,0,101,1,6
80317,1,2538,2405,133,0,3,0,6
80318,1,2480,2248,232,0,133,0,6
80319,2,2429,2467,-38,0,200,0,6
80321,2,2201,2481,-280,0,4,0,6
80322,1,2481,2374,107,0,140,1,6
80323,1,2474,2332,142,0,110,1,6
80324,2,2440,2438,2,0,300,0,6
80325,1,2406,2382,24,0,469,1,6
80326,1,2442,2436,6,0,112,0,6
80327,2,2486,2456,30,0,120,0,6
80328,1,2411,2273,138,0,385,0,6
80329,1,2617,2433,184,0,478,1,6
80330,2,2445,2425,20,0,241,0,6
80331,1,2483,2414,69,0,40,0,6
80332,3,2402,2435,-33,0,112,0,6
80333,2,2439,2325,114,0,330,1,6
80334,2,2398,2431,-33,0,4,0,6
80335,2,2542,2302,240,0,40,0,6
80336,1,2470,2292,178,0,213,0,6
80337,3,2565,2513,52,0,101,0,6
80338,2,2389,2511,-122,0,9,1,6
80339,2,2476,2427,49,0,147,1,6
80340,2,2415,2541,-126,0,331,1,6
80341,2,2328,2478,-150,0,308,1,6
80342,2,2404,2488,-84,0,40,0,6
80343,3,2410,2284,126,0,112,0,6
80344,1,2444,2435,9,0,0,1,6
80345,1,2781,2615,166,0,20,0,6
80346,2,2430,2422,8,0,49,1,6
80347,2,2431,2439,-8,0,200,0,6
80348,2,2300,2434,-134,0,46,0,6
80349,1,2412,2397,15,0,394,0,6
80350,2,2330,2404,-74,0,11,0,6
80351,2,2462,2476,-14,0,154,1,6
80352,2,2447,2485,-38,0,146,0,6
80353,2,2473,2430,43,0,380,1,6
80354,2,2514,2437,77,0,40,0,6
80355,2,2435,2402,33,0,42,1,6
80356,3,2473,2355,118,0,122,0,6
80357,2,2438,2620,-182,0,113,0,6
80358,1,2391,2417,-26,0,466,1,6
80359,2,2515,2414,101,0,140,1,6
80360,2,2401,2489,-88,0,100,0,6
80361,3,2481,2325,156,0,110,0,6
80362,3,2612,2785,-173,0,353,0,6
80363,2,2371,2533,-162,0,302,0,6
80364,1,2434,2469,-35,0,46,0,6
80365,1,2490,2442,48,0,460,0,6
80366,1,2507,2564,-57,0,302,1,6
80367,1,2444,2429,15,0,408,0,6
80368,1,2445,2425,20,0,241,0,6
80369,1,2424,2440,-16,0,302,1,6
80370,1,2457,2290,167,0,141,1,6
80371,2,2466,2471,-5,0,380,0,6
80372,2,2297,2400,-103,0,108,0,6
80373,1,2369,2414,-45,0,302,0,8
80374,1,2495,2408,87,0,453,1,6
80375,1,2493,2397,96,0,0,0,6
80376,2,2463,2440,23,0,206,1,6
80377,2,2397,2429,-32,0,386,0,6
80378,2,2409,2411,-2,0,41,0,6
80379,2,2430,2437,-7,0,112,0,6
80380,1,2508,2381,127,0,200,0,6
80381,2,2782,2615,167,0,18,0,6
80382,1,2327,2479,-152,0,117,0,6
80383,1,2436,2409,27,0,127,1,6
80384,2,2420,2450,-30,0,201,0,6
80385,2,2358,2405,-47,0,177,0,6
80386,2,2470,2349,121,0,335,1,6
80387,1,2434,2273,161,0,8,0,6
80388,1,2497,2338,159,0,0,0,6
80389,2,2423,2477,-54,0,248,0,6
80390,2,2449,2443,6,0,453,0,6
80391,1,2430,2460,-30,0,312,1,6
80392,2,2320,2536,-216,0,300,0,6
80393,1,2471,2336,135,0,110,0,6
80394,2,2353,2461,-108,0,216,1,6
80395,1,2557,2629,-72,0,215,0,6
80396,1,2404,2457,-53,0,406,0,6
80397,2,2373,2511,-138,0,130,1,6
80398,1,2446,2457,-11,0,46,0,6
80399,2,2501,2377,124,0,0,0,6
80400,2,2378,2485,-107,0,120,0,6
80401,2,2624,2774,-150,0,113,0,6
80402,2,2428,2361,67,0,131,1,6
80403,2,2280,2403,-123,0,216,0,6
80404,1,2456,2292,164,0,102,0,6
80405,1,2451,2452,-1,0,202,1,6
80406,1,2386,2465,-79,0,96,1,6
80407,2,2443,2350,93,0,267,0,6
80408,1,2449,2482,-33,0,264,1,6
80409,2,2373,2417,-44,0,45,0,6
80410,1,2332,2475,-143,0,123,1,6
80411,1,2500,2437,63,0,110,1,6
80412,1,2454,2370,84,0,107,1,6
80413,2,2515,2564,-49,0,270,1,6
80414,1,2777,2620,157,0,278,1,6
80415,2,2423,2338,85,0,253,0,6
80416,1,2447,2336,111,0,394,0,6
80417,2,2458,2598,-140,0,421,1,6
80418,1,2407,2236,171,0,331,0,8
80419,1,2446,2457,-11,0,22,0,6
80420,3,2434,2393,41,0,46,0,6
80421,1,2817,2600,217,0,7,0,6
80422,1,2467,2340,127,0,110,0,6
80423,1,2468,2417,51,0,42,0,6
80424,2,2317,2463,-146,0,44,1,6
80425,1,2362,2510,-148,0,35,0,6
80426,2,2455,2459,-4,0,101,0,6
80427,1,2432,2364,68,0,40,1,6
80428,2,2415,2314,101,0,240,0,6
80429,1,2597,2569,28,0,338,1,6
80430,1,2394,2462,-68,0,414,1,6
80431,1,2433,2278,155,0,305,0,6
80432,2,2393,2502,-109,0,9,0,6
80433,2,2336,2471,-135,0,22,1,6
80434,2,2454,2407,47,0,468,0,6
80435,1,2429,2421,8,0,300,1,6
80436,3,2451,2452,-1,0,147,0,6
80437,1,2288,2421,-133,0,2,1,6
80438,2,2252,2410,-158,0,288,1,8
80439,1,2436,2288,148,0,6,0,6
80440,1,2310,2437,-127,0,302,1,6
80441,1,2412,2472,-60,0,45,0,6
80442,1,2371,2435,-64,0,40,0,6
80443,2,2506,2369,137,0,243,0,6
80444,1,2355,2407,-52,0,3,1,6
80445,2,2464,2450,14,0,112,0,6
80446,2,2382,2437,-55,0,455,0,6
80447,1,2448,2295,153,0,52,0,6
80448,3,2564,2602,-38,0,228,0,6
80449,2,2307,2415,-108,0,115,0,6
80450,1,2474,2333,141,0,110,1,6
80451,3,2453,2309,144,0,302,0,6
80452,1,2344,2410,-66,0,201,0,6
80453,2,2257,2403,-146,0,0,0,8
80454,2,2363,2451,-88,0,202,0,6
80455,2,2452,2451,1,0,1,1,6
80456,3,2456,2458,-2,0,101,0,6
80457,2,2346,2404,-58,0,106,1,6
80458,1,2406,2254,152,0,145,0,8
80459,2,2364,2429,-65,0,130,0,6
80460,2,2516,2547,-31,0,245,0,6
80461,2,2377,2440,-63,0,64,1,6
80462,2,2424,2442,-18,0,46,1,6
80463,2,2418,2419,-1,0,112,1,6
80464,2,2419,2466,-47,0,45,0,6
80465,2,2329,2478,-149,0,117,1,6
80466,2,2368,2456,-88,0,40,0,6
80467,2,2329,2435,-106,0,50,1,6
80468,2,2458,2456,2,0,112,0,6
80469,1,2433,2283,150,0,106,0,6
80470,1,2455,2294,161,0,34,0,6
80471,1,2457,2447,10,0,181,1,6
80472,1,2401,2422,-21,0,176,0,6
80473,1,2565,2511,54,0,143,0,6
80474,1,2309,2481,-172,0,247,0,6
80475,2,2447,2473,-26,0,405,0,6
80476,3,2326,2412,-86,0,107,0,6
80477,2,2374,2437,-63,0,9,0,6
80478,2,2482,2425,57,0,310,1,6
80479,1,2444,2414,30,0,4,0,6
80480,1,2570,2602,-32,0,228,1,6
80481,3,2453,2416,37,0,152,0,6
80482,1,2506,2404,102,0,151,0,6
80483,1,2601,2704,-103,0,0,0,6
80484,2,2341,2462,-121,0,102,0,6
80485,2,2442,2609,-167,0,41,1,6
80486,3,2630,2697,-67,0,265,0,6
80487,1,2442,2390,52,0,113,1,6
80488,1,2466,2328,138,0,157,0,6
80489,1,2410,2378,32,0,112,1,6
80490,2,2517,2552,-35,0,213,0,6
80491,1,2582,2371,211,0,12,1,6
80492,2,2429,2286,143,0,246,0,6
80493,2,2432,2282,150,0,116,0,6
80494,2,2312,2475,-163,0,345,1,6
80495,2,2409,2450,-41,0,301,0,6
80496,2,2327,2459,-132,0,123,1,6
80497,2,2452,2510,-58,0,141,0,6
80498,2,2259,2416,-157,0,0,0,5
80499,1,2695,2632,63,0,190,0,6
80500,2,2612,2596,16,0,13,0,6
80501,1,2455,2417,38,0,178,0,6
80502,2,2367,2439,-72,0,200,0,6
80503,1,2315,2449,-134,0,466,0,6
80504,1,2324,2470,-146,0,102,0,6
80505,1,2447,2353,94,0,255,0,6
80506,2,2424,2334,90,0,50,0,6
80507,2,2576,2511,65,0,226,0,6
80508,1,2539,2416,123,0,45,0,6
80509,1,2451,2278,173,0,107,1,6
80510,2,2294,2421,-127,0,100,0,6
80511,2,2455,2404,51,0,4,1,6
80512,3,2290,2419,-129,0,4,0,5
80513,2,2445,2447,-2,0,121,0,6
80514,1,2623,2700,-77,0,246,0,6
80515,1,2368,2585,-217,0,435,0,6
80516,1,2412,2543,-131,0,101,0,6
80517,1,2462,2332,130,0,101,0,6
80518,1,2518,2569,-51,0,300,0,6
80519,2,2251,2433,-182,0,234,0,6
80520,1,2414,2333,81,0,306,0,8
80521,2,2443,2374,69,0,461,0,6
80522,1,2606,2558,48,0,123,1,6
80523,1,2466,2352,114,0,241,0,6
80524,2,2436,2368,68,0,325,0,6
80525,1,2460,2349,111,0,263,0,6
80526,2,2545,2524,21,0,46,0,6
80527,2,2265,2401,-136,0,331,0,6
80528,1,2418,2451,-33,0,300,0,6
80529,1,2407,2326,81,0,245,1,6
80530,2,2424,2291,133,0,8,0,6
80531,2,2430,2391,39,0,409,0,6
80532,3,2602,2585,17,0,156,0,6
80533,1,2693,2636,57,0,194,0,6
80534,3,2355,2437,-82,0,201,0,6
80535,2,2420,2432,-12,0,142,1,6
80536,1,2331,2453,-122,0,300,0,6
80537,2,2531,2611,-80,0,107,1,6
80538,1,2563,2525,38,0,227,0,6
80539,1,2366,2466,-100,0,45,1,6
80540,3,2356,2432,-76,0,300,0,6
80541,2,2346,2418,-72,0,115,0,6
80542,1,2448,2576,-128,0,15,0,6
80543,2,2568,2553,15,0,145,0,6
80544,2,2262,2410,-148,0,40,0,6
80545,1,2465,2381,84,0,4,1,6
80546,1,2585,2499,86,0,30,0,6
80547,1,2411,2367,44,0,190,0,6
80548,2,2423,2299,124,0,400,0,6
80549,2,2435,2357,78,0,46,0,6
80550,1,2445,2259,186,0,1,0,6
80551,1,2413,2212,201,4,404,0,8
80552,1,2458,2390,68,0,194,0,6
80553,2,2332,2431,-99,0,131,0,6
80554,1,2298,2417,-119,0,242,0,6
80555,1,2247,2410,-163,0,48,1,6
80556,3,2325,2606,-281,0,10,0,6
80557,1,2422,2360,62,0,483,0,6
80558,2,2264,2431,-167,0,132,1,6
80559,2,2345,2470,-125,0,4,0,6
80560,2,2526,2562,-36,0,225,0,6
80561,2,2559,2601,-42,0,249,1,6
80562,2,2439,2526,-87,0,101,0,6
80563,2,2378,2463,-85,0,103,1,6
80564,1,2416,2428,-12,0,112,1,6
80565,1,2473,2329,144,0,156,1,6
80566,1,2256,2416,-160,0,319,0,6
80567,1,2448,2283,165,0,1,0,6
80568,1,2495,2502,-7,0,469,0,6
80569,2,2354,2518,-164,0,120,0,6
80570,2,2374,2531,-157,0,101,0,6
80571,2,2356,2427,-71,0,113,0,6
80572,2,2430,2435,-5,0,307,1,6
80573,1,2409,2391,18,0,4,0,6
80574,2,2302,2435,-133,0,310,0,6
80575,1,2452,2373,79,0,200,0,6
80577,1,2589,2439,150,0,12,1,6
80578,1,2468,2522,-54,0,118,1,6
80579,2,2345,2477,-132,0,121,1,6
80580,1,2445,2325,120,0,46,0,6
80581,1,2540,2344,196,0,143,0,6
80582,3,2422,2422,0,0,46,0,6
80583,2,2520,2941,-421,0,130,0,6
80584,2,2535,2368,167,0,101,1,6
80585,3,2568,2386,182,0,8,0,6
80586,2,2496,2432,64,0,112,0,6
80587,2,2607,2659,-52,0,311,0,6
80588,2,2251,2408,-157,0,9,0,6
80589,2,2424,2441,-17,0,40,1,6
80590,2,2456,2336,120,0,102,0,6
80591,1,2439,2305,134,0,9,1,6
80592,2,2433,2282,151,4,16,0,13
80593,2,2403,2435,-32,0,310,0,6
80594,3,2664,2602,62,0,327,0,6
80595,1,2515,2449,66,0,30,0,6
80596,1,2566,2603,-37,0,215,0,6
80597,1,2481,2474,7,0,410,0,6
80598,2,2285,2402,-117,0,110,1,6
80599,2,2446,2422,24,0,110,1,6
80600,1,2953,2518,435,0,250,0,6
80601,2,2422,2526,-104,0,101,1,6
80602,2,2278,2486,-208,0,4,0,6
80603,1,2369,2469,-100,0,131,0,6
80604,1,2260,2415,-155,0,116,0,6
80605,2,2312,2442,-130,0,300,0,6
80606,2,2440,2449,-9,0,302,1,6
80607,1,2370,2473,-103,0,302,1,6
80608,1,2389,2565,-176,0,102,1,6
80609,2,2405,2288,117,0,240,0,6
80610,1,2406,2342,64,0,46,0,6
80611,1,2597,2573,24,0,300,1,6
80612,1,2574,2446,128,0,226,0,6
80614,1,2531,2343,188,0,211,0,6
80615,2,2429,2440,-11,0,40,0,6
80616,2,2371,2540,-169,0,278,0,6
80617,2,2264,2467,-203,0,121,0,6
80618,2,2377,2404,-27,0,45,0,6
80619,2,2243,2415,-172,4,253,0,13
80620,2,2446,2489,-43,0,37,1,6
80621,2,2461,2377,84,0,195,1,6
80622,1,2289,2466,-177,0,303,1,6
80623,2,2320,2468,-148,4,45,0,11
80624,2,2435,2536,-101,0,40,0,6
80625,2,2341,2454,-113,0,101,1,6
80626,2,2386,2411,-25,0,300,0,6
80627,2,2557,2398,159,0,195,0,6
80628,2,2306,2443,-137,0,331,0,6
80629,2,2385,2461,-76,0,380,0,6
80630,1,2603,2593,10,0,156,0,6
80631,3,2663,2567,96,0,338,0,6
80632,1,2413,2257,156,0,337,0,6
80633,1,2407,2269,138,0,8,0,6
80634,1,2423,2453,-30,0,46,0,6
80635,1,2416,2305,111,0,302,0,6
80636,1,2734,2614,120,0,106,0,6
80637,2,2315,2409,-94,0,0,0,6
80638,1,2494,2297,197,0,40,0,6
80639,1,2384,2454,-70,0,278,1,6
80640,2,2380,2429,-49,0,485,1,6
80641,1,2738,2587,151,0,122,0,6
80642,1,2282,2458,-176,0,135,1,6
80643,2,2302,2466,-164,0,248,0,6
80644,2,2436,2414,22,0,107,0,6
80645,1,2422,2261,161,4,10,0,13
80646,3,2458,2383,75,0,134,0,6
80647,1,2413,2311,102,0,241,1,6
80648,2,2406,2549,-143,0,102,0,6
80649,1,2584,2569,15,0,28,1,6
80650,1,2602,2741,-139,0,45,0,6
80651,2,2377,2410,-33,0,242,0,6
80652,2,2497,2616,-119,0,10,0,6
80653,2,2286,2558,-272,0,154,0,6
80654,2,2420,2404,16,0,207,0,6
80655,1,2667,2661,6,0,110,1,6
80656,1,2448,2391,57,0,195,0,6
80657,1,2434,2391,43,0,388,0,6
80658,2,2340,2457,-117,0,1,0,6
80659,1,2449,2356,93,0,102,1,6
80660,2,2524,2521,3,0,327,0,6
80661,1,2431,2286,145,0,108,1,6
80662,2,2447,2578,-131,0,5,1,6
80663,2,2386,2439,-53,0,45,0,6
80664,3,2506,2543,-37,0,101,0,6
80665,2,2411,2303,108,0,380,0,6
80666,1,2452,2399,53,0,102,0,6
80667,2,2291,2493,-202,0,57,1,6
80668,2,2399,2465,-66,0,202,0,6
80669,2,2339,2418,-79,0,245,1,6
80670,1,2415,2372,43,0,4,0,6
80671,1,2734,2610,124,0,202,0,6
80672,3,2560,2352,208,0,302,0,6
80673,1,2435,2411,24,0,31,0,6
80674,1,2564,2543,21,0,125,0,6
80675,1,2444,2376,68,0,96,0,6
80676,1,2462,2307,155,0,35,0,6
80677,2,2576,2673,-97,0,101,0,6
80678,1,2461,2336,125,0,102,0,6
80679,2,2457,2495,-38,0,189,0,6
80680,1,2655,2542,113,0,330,0,6
80681,1,2470,2395,75,0,463,1,6
80682,1,2402,2286,116,0,133,0,6
80683,3,2367,2421,-54,0,100,0,6
80684,1,2364,2446,-82,0,3,0,6
80685,2,2606,2737,-131,0,45,0,6
80686,1,2496,2482,14,0,21,0,6
80687,1,2311,2400,-89,0,113,1,6
80688,3,2492,2469,23,0,260,0,6
80689,2,2537,2509,28,0,107,1,6
80690,1,2404,2383,21,0,400,1,6
80691,1,2384,2433,-49,0,131,0,6
80692,3,2677,2572,105,0,248,0,6
80693,1,2501,2452,49,0,102,1,6
80694,2,2454,2394,60,0,312,0,6
80695,1,2455,2287,168,0,20,0,6
80696,2,2373,2426,-53,0,106,0,6
80697,2,2569,2603,-34,0,215,0,6
80698,1,2540,2449,91,0,0,1,6
80699,1,2342,2466,-124,0,0,1,6
80700,1,2278,2435,-157,0,190,0,6
80701,1,2443,2340,103,0,102,1,6
80702,1,2431,2506,-75,0,45,0,6
80703,2,2794,2609,185,0,45,1,6
80705,1,2357,2409,-52,0,193,0,6
80706,1,2314,2422,-108,0,400,1,6
80707,1,2598,2457,141,0,123,0,6
80708,1,2470,2466,4,0,46,1,6
80709,2,2251,2443,-192,0,357,0,6
80710,2,2608,2564,44,0,300,0,6
80711,1,2458,2390,68,0,10,0,6
80712,2,2284,2428,-144,0,131,0,6
80713,1,2403,2368,35,0,326,0,6
80714,3,2430,2441,-11,0,131,0,6
80715,2,2499,2438,61,0,122,1,6
80716,2,2416,2333,83,0,5,0,6
80717,2,2337,2412,-75,0,22,0,6
80718,1,2386,2463,-77,0,112,0,6
80719,2,2289,2419,-130,0,100,0,6
80721,2,2444,2436,8,0,302,1,6
80722,1,2491,2544,-53,0,107,0,6
80723,2,2618,2786,-168,0,5,0,6
80724,1,2325,2448,-123,0,122,1,6
80725,2,2460,2406,54,0,320,0,6
80726,1,2570,2601,-31,0,211,0,6
80727,3,2446,2419,27,0,145,0,6
80728,2,2456,2393,63,0,10,0,6
80729,3,2400,2602,-202,0,302,0,6
80730,3,2363,2402,-39,0,106,0,6
80731,1,2439,2322,117,0,254,0,6
80732,2,2461,2375,86,0,130,0,6
80733,1,2431,2368,63,0,380,0,6
80734,2,2445,2493,-48,0,210,0,6
80735,1,2548,2418,130,0,323,1,6
80736,1,2491,2389,102,0,48,0,6
80737,3,2321,2474,-153,0,200,0,6
80738,2,2384,2419,-35,0,406,0,6
80739,1,2789,2614,175,0,341,0,6
80740,1,2599,2502,97,0,101,0,6
80741,1,2289,2438,-149,0,132,0,6
80742,1,2442,2392,50,0,485,0,6
80743,2,2354,2401,-47,0,247,0,6
80744,1,2595,2577,18,0,302,0,6
80745,2,2318,2424,-106,0,13,0,6
80746,2,2440,2505,-65,0,156,1,6
80747,2,2426,2341,85,0,106,0,6
80748,1,2400,2449,-49,0,112,0,6
80749,2,2283,2406,-123,0,207,0,6
80750,1,2544,2456,88,0,427,1,6
80751,1,2538,2454,84,0,9,0,6
80752,2,2611,2792,-181,0,4,0,6
80753,2,2358,2495,-137,0,2,0,6
80754,2,2415,2603,-188,0,190,1,6
80755,2,2406,2436,-30,0,134,0,6
80756,1,2603,2495,108,0,466,0,6
80757,2,2424,2350,74,0,101,0,8
80758,1,2452,2241,211,0,121,1,6
80759,1,2585,2457,128,0,260,0,6
80760,2,2443,2386,57,0,153,1,6
80761,1,2477,2364,113,0,326,0,6
80762,1,2447,2314,133,0,411,0,6
80763,2,2413,2453,-40,0,259,0,6
80764,1,2498,2450,48,0,300,0,6
80765,2,2571,2601,-30,0,123,1,6
80767,1,2554,2489,65,0,120,0,6
80768,2,2310,2418,-108,0,395,0,6
80769,1,2406,2358,48,0,333,1,6
80770,3,2446,2300,146,0,152,0,6
80771,1,2449,2361,88,0,140,0,6
80772,1,2449,2361,88,0,300,0,6
80773,2,2547,2607,-60,0,130,0,6
80774,2,2795,2608,187,0,484,1,6
80775,1,2356,2498,-142,0,455,1,6
80776,2,2606,2589,17,0,115,0,6
80777,2,2416,2390,26,0,115,1,6
80778,1,2424,2366,58,0,202,0,6
80779,3,2423,2377,46,0,203,0,6
80780,1,2440,2453,-13,0,106,1,6
80781,1,2474,2374,100,0,297,0,6
80782,1,2356,2424,-68,0,4,0,6
80783,1,2424,2306,118,0,251,0,6
80784,2,2559,2537,22,0,107,0,6
80785,2,2503,2420,83,0,113,0,6
80786,2,2337,2445,-108,0,302,0,6
80787,2,2367,2415,-48,0,331,0,6
80788,2,2479,2463,16,0,106,0,6
80789,1,2373,2441,-68,0,315,0,6
80790,2,2374,2481,-107,0,147,0,6
80791,2,2415,2453,-38,0,308,0,6
80792,1,2441,2315,126,0,310,1,6
80793,1,2454,2373,81,0,7,0,6
80794,3,2470,2388,82,0,395,0,6
80795,1,2566,2531,35,0,125,1,6
80796,2,2606,2647,-41,0,300,0,6
80797,2,2617,2787,-170,0,4,0,6
80798,2,2359,2544,-185,0,107,0,6
80799,2,2434,2595,-161,0,9,1,6
80800,1,2396,2409,-13,0,205,0,6
80801,2,2447,2299,148,0,253,0,6
80802,1,2451,2446,5,0,10,0,6
80803,1,2553,2372,181,0,200,0,6
80804,2,2409,2378,31,0,4,0,6
80805,1,2590,2534,56,0,35,1,6
80806,1,2365,2450,-85,0,15,0,6
80807,2,2274,2438,-164,4,41,0,13
80808,3,2351,2410,-59,0,278,0,6
80809,1,2370,2478,-108,0,122,0,6
80810,1,2547,2470,77,0,49,0,6
80811,1,2790,2614,176,0,341,0,6
80812,1,2351,2437,-86,0,132,1,6
80813,1,2360,2411,-51,0,250,0,6
80814,2,2450,2428,22,0,484,0,6
80815,2,2469,2458,11,0,409,0,6
80816,1,2427,2303,124,0,46,0,6
80817,1,2612,2557,55,0,405,0,6
80818,2,2362,2515,-153,0,394,0,6
80819,2,2361,2408,-47,0,190,0,6
80820,2,2652,2601,51,0,202,0,6
80821,2,2472,2556,-84,0,40,0,6
80822,2,2369,2445,-76,0,300,1,6
80823,2,2471,2378,93,0,200,0,6
80824,1,2512,2378,134,0,45,0,6
80825,2,2436,2485,-49,0,144,0,6
80826,3,2466,2403,63,0,4,0,6
80827,1,2551,2571,-20,0,302,0,6
80828,1,2440,2300,140,0,243,0,6
80829,1,2526,2518,8,0,143,0,6
80830,1,2299,2439,-140,0,453,1,6
80831,1,2599,2431,168,0,115,1,6
80832,2,2443,2431,12,0,102,1,6
80833,1,2552,2543,9,0,254,1,6
80834,1,2443,2414,29,0,485,0,6
80835,2,2428,2251,177,0,230,1,6
80836,1,2611,2793,-182,0,4,1,6
80837,2,2434,2374,60,0,122,0,6
80838,1,2529,2617,-88,0,122,0,6
80839,1,2409,2355,54,0,58,0,6
80840,2,2355,2464,-109,0,135,0,6
80841,1,2468,2385,83,0,400,0,6
80842,2,2365,2423,-58,0,80,0,6
80843,2,2608,2645,-37,0,335,1,6
80844,2,2296,2401,-105,0,107,1,6
80845,2,2406,2444,-38,0,130,0,6
80846,1,2317,2405,-88,0,122,0,6
80847,2,2565,2560,5,0,106,0,6
80848,2,2449,2466,-17,0,469,0,6
80849,1,2464,2295,169,0,14,1,6
80850,3,2420,2623,-203,0,45,0,6
80851,1,2404,2268,136,0,7,0,6
80852,1,2444,2468,-24,0,301,1,6
80853,1,2441,2414,27,0,4,0,6
80854,2,2234,2666,-432,2,302,0,18
80855,1,2449,2386,63,0,152,0,6
80856,2,2513,2482,31,0,114,1,6
80857,1,2364,2532,-168,0,45,0,6
80858,1,2389,2449,-60,0,103,0,6
80859,1,2463,2378,85,0,455,0,6
80860,1,2600,2536,64,0,267,0,6
80861,3,2484,2610,-126,0,133,0,6
80862,3,2227,2417,-190,0,1,0,6
80863,2,2408,2362,46,0,427,0,6
80864,1,2428,2365,63,0,31,0,6
80865,1,2431,2385,46,0,200,0,6
80866,2,2341,2437,-96,0,107,1,6
80867,3,2437,2444,-7,0,304,0,6
80868,1,2375,2427,-52,0,107,1,6
80869,1,2419,2382,37,0,142,0,6
80870,1,2650,2603,47,0,202,1,6
80871,1,2785,2619,166,0,341,0,6
80872,2,2566,2473,93,0,247,0,6
80873,3,2506,2560,-54,0,269,0,6
80874,2,2436,2423,13,0,130,0,6
80875,1,2408,2384,24,0,0,0,6
80876,1,2467,2454,13,0,1,0,6
80877,2,2405,2490,-85,0,16,0,6
80878,2,2442,2467,-25,0,405,0,6
80879,2,2559,2381,178,0,247,0,6
80880,1,2423,2278,145,0,45,1,6
80881,1,2462,2307,155,0,278,0,6
80882,1,2400,2413,-13,0,190,0,6
80883,3,2538,2506,32,0,140,0,6
80884,1,2441,2303,138,0,190,0,6
80885,1,2422,2382,40,0,141,1,6
80886,1,2616,2788,-172,0,90,1,6
80887,1,2404,2437,-33,0,196,1,6
80888,2,2659,2438,221,0,365,0,6
80889,1,2488,2393,95,0,124,0,6
80890,2,2414,2287,127,0,0,0,6
80891,1,2431,2437,-6,0,103,1,6
80892,2,2204,2402,-198,4,107,0,18
80893,2,2296,2473,-177,0,405,1,6
80894,1,2598,2550,48,0,300,0,6
80895,3,2347,2431,-84,0,200,0,6
80896,1,2364,2473,-109,0,394,0,6
80897,1,2490,2506,-16,0,122,0,6
80898,2,2608,2559,49,0,398,0,6
80899,2,2424,2516,-92,0,241,0,6
80900,3,2433,2366,67,0,250,0,6
80901,2,2445,2493,-48,0,225,0,6
80902,2,2304,2465,-161,0,45,0,6
80903,1,2486,2466,20,0,245,0,6
80904,2,2500,2496,4,0,200,0,6
80905,1,2457,2651,-194,0,448,0,6
80906,1,2507,2406,101,0,151,0,6
80907,2,2333,2473,-140,0,260,1,6
80908,1,2545,2603,-58,0,7,0,6
80909,1,2261,2401,-140,0,253,1,6
80910,1,2420,2361,59,0,110,0,6
80911,1,2780,2625,155,0,341,0,6
80912,1,2369,2461,-92,0,4,0,6
80913,2,2557,2549,8,0,46,0,6
80914,1,2420,2431,-11,0,6,0,6
80915,3,2403,2436,-33,0,40,0,6
80916,1,2389,2406,-17,0,102,0,6
80917,2,2601,2466,135,0,40,0,6
80918,1,2494,2312,182,0,315,1,6
80919,2,2343,2424,-81,0,181,0,6
80920,1,2431,2372,59,0,255,1,6
80921,1,2439,2303,136,0,4,1,6
80922,2,2410,2440,-30,0,310,0,6
80923,1,2409,2348,61,0,4,1,6
80924,2,2338,2498,-160,0,453,0,6
80925,1,2565,2517,48,0,102,1,6
80926,1,2469,2492,-23,0,200,1,6
80927,1,2300,2400,-100,0,401,1,6
80928,3,2453,2549,-96,0,212,0,6
80929,2,2416,2350,66,0,45,0,6
80930,2,2474,2450,24,0,113,0,6
80931,1,2551,2555,-4,0,401,0,6
80932,3,2458,2432,26,0,380,0,6
80933,2,2371,2416,-45,0,2,0,6
80934,1,2444,2427,17,0,113,0,6
80935,1,2511,2395,116,0,245,1,6
80936,2,2416,2343,73,0,13,0,8
80937,1,2319,2429,-110,0,46,0,6
80938,1,2327,2403,-76,0,205,1,6
80939,1,2405,2296,109,4,130,0,8
80940,2,2337,2436,-99,0,123,0,6
80941,2,2621,2783,-162,0,46,1,6
80942,2,2303,2425,-122,0,307,1,6
80943,2,2409,2329,80,0,241,0,6
80944,3,2443,2375,68,0,133,0,6
80945,1,2413,2302,111,0,50,1,6
80946,1,2223,2531,-308,0,317,0,8
80947,1,2427,2436,-9,0,151,1,6
80948,1,2405,2445,-40,0,310,0,6
80949,2,2402,2502,-100,0,210,0,6
80950,1,2406,2311,95,0,131,1,6
80951,1,2386,2458,-72,0,132,0,6
80952,2,2549,2557,-8,0,110,0,6
80953,2,2483,2501,-18,0,241,0,6
80954,1,2596,2642,-46,0,46,0,6
80955,2,2407,2388,19,0,111,1,6
80956,2,2547,2454,93,0,317,0,6
80957,1,2409,2278,131,0,307,0,6
80958,3,2343,2472,-129,0,21,0,6
80959,1,2512,2421,91,0,325,0,6
80960,1,2524,2496,28,0,110,0,6
80961,2,2655,2570,85,0,255,0,6
80962,2,2362,2475,-113,0,45,0,6
80963,2,2457,2462,-5,0,207,0,6
80964,2,2542,2455,87,0,190,1,6
80965,2,2458,2451,7,0,20,0,6
80966,2,2401,2409,-8,0,140,0,6
80967,2,2352,2528,-176,0,311,1,8
80968,2,2376,2476,-100,0,380,1,6
80969,2,2346,2515,-169,0,140,0,6
80970,2,2462,2540,-78,0,218,0,6
80971,1,2786,2618,168,0,107,0,6
80972,1,2388,2443,-55,0,135,0,6
80973,2,2429,2377,52,0,315,0,6
80974,2,2392,2451,-59,0,121,0,6
80975,1,2450,2345,105,0,456,1,6
80976,2,2473,2451,22,0,241,0,6
80977,1,2375,2413,-38,0,310,0,6
80978,1,2506,2398,108,0,415,0,6
80979,1,2475,2401,74,0,218,0,6
80980,2,2563,2430,133,0,411,0,6
80981,1,2544,2577,-33,0,21,0,6
80982,1,2439,2472,-33,0,200,0,6
80983,1,2636,2411,225,0,477,0,6
80984,2,2303,2479,-176,0,45,0,6
80985,2,2423,2323,100,0,33,0,6
80986,2,2384,2411,-27,0,469,0,6
80987,2,2396,2537,-141,0,45,0,6
80988,1,2457,2462,-5,0,380,0,6
80989,2,2522,2535,-13,0,45,1,6
80990,1,2408,2255,153,0,108,1,6
80991,1,2551,2603,-52,0,200,0,6
80992,1,2458,2402,56,0,477,1,6
80993,1,2518,2486,32,0,200,0,6
80994,2,2298,2438,-140,0,47,0,6
80995,2,2349,2408,-59,0,0,1,6
80996,1,2456,2555,-99,0,112,0,6
80997,2,2394,2510,-116,0,267,1,6
80998,3,2437,2394,43,0,151,0,6
81000,2,2415,2275,140,0,4,0,6
81001,2,2571,2550,21,0,101,0,6
81002,2,2482,2300,182,0,278,0,6
81003,1,2387,2404,-17,0,4,1,6
81004,1,2444,2501,-57,0,406,0,6
81005,1,2291,2407,-116,0,101,0,6
81006,1,2421,2370,51,0,487,0,6
81007,1,2473,2382,91,0,313,1,6
81008,2,2556,2565,-9,0,27,0,6
81009,2,2472,2606,-134,0,4,1,6
81010,1,2415,2328,87,0,127,0,6
81011,3,2391,2463,-72,0,6,0,6
81012,1,2392,2428,-36,0,300,1,6
81013,2,2340,2490,-150,0,211,1,6
81014,1,2589,2393,196,0,190,0,6
81015,1,2387,2440,-53,0,101,0,6
81016,1,2401,2301,100,0,106,0,6
81017,2,2409,2638,-229,0,331,0,6
81018,1,2416,2379,37,0,414,0,6
81019,1,2481,2541,-60,0,145,1,6
81020,2,2433,2377,56,0,1,0,6
81021,2,2401,2411,-10,0,106,0,6
81022,1,2400,2278,122,0,343,0,8
81023,2,2596,2557,39,0,106,1,6
81024,1,2474,2393,81,0,297,0,6
81025,2,2462,2393,69,0,241,0,6
81026,2,2514,2390,124,0,134,1,6
81027,1,2430,2334,96,0,338,0,6
81028,2,2459,2543,-84,0,218,0,6
81029,1,2641,2407,234,0,474,0,6
81030,1,2548,2373,175,0,5,1,6
81031,2,2448,2309,139,0,245,0,6
81032,2,2424,2436,-12,0,307,0,6
81033,2,2410,2241,169,0,226,0,8
81034,2,2390,2594,-204,0,180,0,6
81035,2,2286,2420,-134,0,143,0,6
81036,1,2417,2395,22,0,140,0,6
81037,2,2366,2427,-61,0,101,1,6
81038,2,2390,2406,-16,0,414,1,6
81039,2,2452,2431,21,0,11,1,6
81040,2,2332,2477,-145,0,43,1,6
81041,2,2422,2377,45,0,310,1,6
81042,1,2519,2336,183,0,45,0,6
81043,2,2374,2416,-42,0,469,0,6
81044,1,2365,2449,-84,0,13,0,6
81045,1,2259,2404,-145,0,257,1,8
81046,1,2455,2437,18,0,20,0,6
81047,1,2400,2463,-63,0,277,0,6
81048,2,2487,2468,19,0,241,0,6
81049,1,2534,2462,72,0,190,0,6
81050,2,2441,2382,59,0,252,1,6
81051,2,2389,2478,-89,0,122,0,6
81052,2,2317,2440,-123,0,45,1,6
81053,2,2564,2590,-26,0,200,0,6
81054,1,2388,2422,-34,0,106,0,6
81055,3,2741,2609,132,0,201,0,6
81056,2,2492,2375,117,0,304,1,6
81057,2,2314,2434,-120,0,337,1,6
81058,2,2332,2542,-210,0,211,0,6
81059,1,2370,2404,-34,0,311,0,6
81060,2,2548,2454,94,0,318,0,6
81061,1,2571,2544,27,0,228,0,6
81062,2,2398,2507,-109,0,241,0,6
81063,2,2458,2539,-81,0,277,0,6
81065,1,2321,2496,-175,0,127,0,6
81066,1,2423,2259,164,0,47,0,6
81067,2,2389,2470,-81,0,195,1,6
81068,1,2385,2551,-166,0,325,0,6
81069,2,2464,2446,18,0,0,0,6
81070,2,2415,2403,12,0,402,0,6
81071,1,2543,2454,89,0,250,0,6
81072,2,2595,2559,36,0,43,1,6
81073,2,2522,2442,80,0,426,0,8
81074,2,2329,2481,-152,0,43,1,6
81075,2,2253,2402,-149,0,227,1,8
81076,2,2238,2512,-274,0,302,0,8
81077,1,2482,2327,155,0,291,0,6
81078,1,2496,2543,-47,0,5,1,6
81079,2,2535,2325,210,0,101,0,6
81080,1,2511,2394,117,0,122,0,6
81081,2,2385,2417,-32,0,202,0,6
81082,1,2514,2369,145,0,45,0,6
81083,2,2538,2576,-38,0,270,0,6
81084,2,2297,2421,-124,0,113,0,6
81085,2,2491,2404,87,0,45,0,6
81086,1,2444,2313,131,0,229,0,6
81087,2,2612,2739,-127,0,3,0,6
81088,2,2449,2548,-99,0,142,0,6
81089,2,2561,2329,232,0,456,1,6
81090,1,2430,2437,-7,0,115,0,6
81091,1,2474,2481,-7,0,4,0,6
81092,1,2461,2437,24,0,110,0,6
81093,3,2643,2605,38,0,154,0,6
81094,1,2368,2409,-41,0,133,0,6
81095,1,2472,2378,94,0,300,0,6
81096,1,2404,2456,-52,0,255,0,6
81097,1,2431,2487,-56,0,40,1,6
81098,2,2346,2486,-140,0,0,0,6
81099,2,2565,2589,-24,0,200,0,6
81100,1,2360,2408,-48,4,140,0,13
81101,3,2474,2378,96,0,106,0,6
81102,3,2460,2526,-66,0,45,0,6
81103,2,2399,2426,-27,0,485,0,6
81104,2,2608,2628,-20,0,3,0,6
81105,1,2473,2593,-120,0,123,0,6
81106,1,2438,2380,58,0,18,0,6
81107,2,2390,2515,-125,0,241,0,6
81108,1,2552,2390,162,0,181,0,6
81109,1,2563,2569,-6,4,106,1,13
81110,2,2384,2559,-175,0,0,0,6
81111,1,2470,2299,171,4,49,0,0
81112,2,2477,2380,97,0,300,0,6
81113,2,2581,2532,49,0,227,1,6
81114,2,2536,2503,33,0,5,0,6
81115,1,2365,2411,-46,0,426,1,6
81116,1,2390,2449,-59,0,156,1,6
81117,1,2438,2374,64,0,211,0,6
81118,1,2461,2302,159,0,241,0,6
81119,1,2309,2403,-94,0,9,0,6
81120,2,2293,2515,-222,0,255,1,8
81121,2,2480,2560,-80,0,4,1,6
81122,1,2501,2445,56,0,123,0,6
81124,1,2476,2489,-13,0,302,0,6
81125,3,2431,2387,44,0,463,0,6
81126,2,2339,2502,-163,0,211,0,6
81127,2,2606,2781,-175,0,111,0,6
81128,2,2422,2393,29,0,335,1,6
81129,3,2452,2643,-191,0,11,0,6
81130,1,2405,2248,157,0,226,0,8
81131,2,2637,2603,34,0,101,0,6
81132,2,2519,2387,132,0,134,1,6
81133,1,2416,2330,86,0,202,1,6
81134,2,2298,2464,-166,0,301,0,6
81135,2,2478,2366,112,0,373,0,6
81136,1,2425,2293,132,0,45,0,6
81137,1,2506,2414,92,0,242,1,6
81138,2,2440,2506,-66,0,129,0,6
81139,2,2480,2397,83,0,102,1,6
81140,2,2461,2410,51,0,241,0,6
81141,2,2405,2387,18,0,355,1,6
81142,1,2372,2480,-108,0,58,1,6
81143,1,2395,2457,-62,0,140,1,6
81144,1,2586,2481,105,0,468,0,6
81145,2,2540,2575,-35,0,269,0,6
81146,2,2509,2404,105,0,5,0,6
81147,1,2530,2438,92,0,8,1,6
81148,1,2525,2450,75,0,263,0,6
81149,1,2388,2540,-152,0,202,0,6
81150,1,2369,2443,-74,0,113,0,6
81151,2,2244,2408,-164,0,373,0,8
81152,2,2417,2359,58,0,106,0,8
81153,1,2376,2504,-128,0,400,0,6
81154,2,2431,2317,114,0,429,1,6
81155,1,2564,2476,88,0,107,1,6
81156,1,2609,2627,-18,0,5,0,6
81157,1,2556,2594,-38,0,207,0,6
81158,2,2483,2482,1,0,265,0,6
81159,3,2707,2678,29,0,176,0,6
81160,2,2399,2415,-16,0,122,1,6
81161,2,2307,2421,-114,0,335,0,6
81162,2,2339,2402,-63,0,115,1,6
81163,1,2522,2336,186,0,455,0,6
81164,1,2580,2517,63,0,101,0,6
81165,1,2640,2455,185,0,107,0,6
81166,1,2433,2454,-21,0,20,0,6
81167,1,2516,2379,137,0,405,0,6
81168,1,2420,2398,22,0,151,1,6
81169,1,2784,2607,177,0,476,0,6
81170,1,2412,2239,173,0,226,0,8
81171,2,2424,2448,-24,0,245,0,6
81172,1,2497,2394,103,0,426,0,6
81173,2,2410,2400,10,0,196,0,6
81174,1,2481,2259,222,0,375,0,6
81175,1,2448,2421,27,0,152,0,6
81176,2,2616,2615,1,0,200,0,6
81177,3,2574,2585,-11,0,13,0,6
81178,1,2476,2447,29,0,265,0,6
81179,3,2327,2404,-77,0,312,0,6
81180,1,2439,2512,-73,0,8,1,6
81181,2,2442,2383,59,0,247,0,6
81182,1,2518,2406,112,0,105,0,8
81183,2,2478,2376,102,0,192,0,6
81184,3,2459,2502,-43,0,459,0,6
81185,3,2373,2417,-44,0,107,0,6
81186,2,2376,2404,-28,0,125,1,6
81187,1,2374,2470,-96,0,152,0,6
81188,3,2488,2423,65,0,7,0,6
81190,2,2587,2562,25,0,45,1,6
81191,1,2396,2452,-56,0,107,1,6
81192,1,2590,2569,21,0,40,0,6
81193,2,2421,2411,10,0,454,0,6
81194,2,2389,2494,-105,0,40,0,6
81195,2,2678,2699,-21,0,246,1,6
81196,3,2591,2787,-196,0,112,0,6
81197,2,2724,2603,121,0,341,1,6
81198,1,2235,2415,-180,0,227,0,8
81199,1,2522,2233,289,0,116,0,8
81200,1,2498,2326,172,0,6,1,6
81201,2,2404,2426,-22,0,106,0,6
81202,1,2500,2464,36,0,140,0,6
81203,1,2483,2427,56,0,103,0,6
81204,1,2495,2344,151,0,102,0,6
81205,1,2209,2470,-261,0,134,0,6
81206,2,2400,2416,-16,0,487,0,6
81207,2,2445,2529,-84,0,479,0,6
81208,1,2454,2377,77,0,302,0,6
81209,2,2532,2524,8,0,426,0,6
81210,2,2390,2501,-111,0,101,1,6
81211,2,2273,2427,-154,0,253,1,6
81212,1,2417,2598,-181,0,106,0,6
81213,1,2406,2403,3,0,302,0,6
81214,3,2621,2607,14,0,121,0,6
81215,1,2506,2409,97,0,302,0,6
81216,2,2424,2487,-63,0,310,0,6
81217,2,2409,2371,38,0,300,0,6
81218,2,2301,2400,-99,4,345,0,13
81219,1,2532,2293,239,0,89,0,8
81220,2,2322,2422,-100,0,307,1,6
81221,2,2501,2459,42,0,4,0,6
81222,2,2569,2581,-12,0,207,0,6
81223,3,2585,2643,-58,0,106,0,6
81224,2,2398,2489,-91,0,101,0,6
81225,2,2563,2376,187,0,120,0,6
81226,1,2326,2461,-135,0,45,0,6
81227,2,2784,2606,178,0,477,0,6
81228,1,2416,2343,73,0,106,0,6
81229,1,2431,2378,53,0,110,0,6
81230,1,2403,2328,75,0,40,0,6
81231,1,2589,2510,79,0,301,0,6
81232,1,2673,2775,-102,0,246,0,6
81233,2,2248,2405,-157,0,10,0,6
81234,1,2481,2355,126,0,258,1,6
81235,1,2607,2620,-13,0,101,0,6
81237,2,2468,2495,-27,0,107,0,6
81238,1,2483,2334,149,0,331,0,6
81239,1,2442,2379,63,2,238,1,25
81240,3,2553,2436,117,0,106,0,6
81241,1,2532,2527,5,0,211,0,6
81242,2,2222,2452,-230,0,4,0,6
81243,1,2587,2595,-8,0,40,0,6
81244,2,2459,2523,-64,0,414,0,6
81245,1,2615,2617,-2,0,41,0,6
81246,2,2408,2353,55,0,8,0,6
81247,1,2453,2466,-13,0,241,0,6
81248,1,2495,2217,278,0,46,0,6
81249,2,2505,2386,119,0,426,0,6
81250,2,2425,2450,-25,0,101,0,6
81251,2,2405,2525,-120,0,406,0,6
81252,2,2407,2247,160,0,101,1,8
81253,2,2393,2500,-107,0,302,1,6
81254,1,2377,2403,-26,0,123,0,6
81255,2,2256,2433,-177,0,31,0,6
81256,1,2452,2476,-24,0,58,0,6
81257,2,2397,2420,-23,0,112,0,6
81259,1,2426,2443,-17,0,162,0,6
81260,1,2521,2540,-19,0,426,0,6
81261,1,2402,2293,109,0,84,1,6
81262,2,2642,2586,56,0,330,1,6
81263,1,2421,2379,42,0,307,1,6
81264,2,2646,2776,-130,0,218,0,6
81265,1,2529,2401,128,0,337,0,6
81266,2,2277,2426,-149,0,162,1,6
81267,3,2364,2534,-170,0,265,0,8
81268,1,2505,2334,171,0,46,0,6
81269,2,2500,2461,39,0,8,1,6
81270,2,2491,2459,32,0,8,0,6
81271,2,2394,2497,-103,0,101,0,6
81272,2,2323,2407,-84,0,332,0,6
81273,1,2421,2381,40,0,111,0,6
81274,2,2424,2436,-12,0,125,0,6
81275,2,2478,2495,-17,0,16,0,6
81276,2,2436,2339,97,0,386,1,6
81277,2,2299,2438,-139,0,106,0,6
81278,3,2397,2532,-135,0,45,0,6
81279,1,2608,2620,-12,0,101,0,6
81280,2,2435,2316,119,0,463,0,6
81281,2,2488,2590,-102,0,388,1,6
81282,1,2293,2459,-166,0,4,0,6
81283,1,2414,2363,51,0,107,0,6
81284,1,2780,2630,150,0,151,0,6
81285,1,2253,2404,-151,0,190,1,6
81286,1,2420,2425,-5,0,113,0,6
81287,2,2574,2604,-30,0,4,0,6
81288,1,2421,2485,-64,0,315,1,6
81289,1,2466,2343,123,0,192,1,6
81290,1,2265,2428,-163,0,201,0,6
81291,2,2532,2527,5,0,46,0,6
81292,2,2592,2635,-43,0,106,1,6
81293,2,2680,2715,-35,0,46,1,6
81294,1,2400,2294,106,0,101,0,6
81295,1,2419,2439,-20,0,110,0,6
81296,1,2400,2239,161,0,190,0,6
81297,1,2470,2555,-85,0,106,0,6
81298,2,2374,2438,-64,0,303,0,6
81299,3,2426,2509,-83,0,315,0,6
81300,2,2454,2487,-33,0,414,0,6
81301,2,2467,2220,247,0,311,1,6
81302,2,2331,2413,-82,0,45,0,6
81303,1,2401,2402,-1,0,123,0,6
81304,2,2501,2390,111,0,426,0,6
81305,1,2441,2323,118,0,115,0,6
81306,1,2502,2473,29,0,103,0,6
81307,2,2433,2458,-25,0,300,0,6
81308,1,2441,2396,45,0,200,1,6
81309,2,2399,2548,-149,0,40,0,6
81310,1,2469,2494,-25,0,108,1,6
81311,2,2363,2427,-64,0,278,1,6
81312,1,2492,2449,43,0,70,0,6
81313,1,2541,2477,64,0,202,0,6
81314,1,2393,2415,-22,0,143,0,6
81315,2,2615,2617,-2,0,3,0,6
81316,2,2533,2524,9,0,386,0,6
81317,2,2616,2783,-167,0,113,0,6
81318,3,2346,2504,-158,0,110,0,6
81319,1,2432,2388,44,0,217,0,6
81320,3,2599,2419,180,0,0,0,6
81321,2,2351,2468,-117,0,4,1,6
81322,1,2365,2428,-63,0,214,0,6
81323,2,2436,2426,10,0,469,0,6
81324,2,2398,2494,-96,0,101,0,6
81325,1,2340,2443,-103,0,0,1,6
81326,1,2721,2675,46,0,40,1,6
81327,2,2290,2404,-114,0,300,0,6
81328,1,2464,2428,36,0,380,0,6
81329,2,2371,2470,-99,0,130,1,6
81330,1,2520,2484,36,0,300,0,6
81331,1,2507,2392,115,0,45,0,6
81332,1,2462,2360,102,0,196,0,6
81333,1,2640,2587,53,0,302,0,6
81334,2,2478,2516,-38,0,4,0,6
81335,1,2551,2383,168,0,102,0,6
81336,1,2529,2396,133,0,192,0,6
81337,3,2333,2641,-308,0,320,0,8
81338,3,2432,2358,74,0,420,0,6
81339,2,2389,2413,-24,0,112,1,6
81340,2,2417,2338,79,0,177,0,6
81341,2,2486,2277,209,4,225,0,23
81343,1,2445,2321,124,0,301,1,6
81344,3,2436,2554,-118,0,106,0,6
81345,2,2466,2451,15,0,4,1,6
81346,1,2447,2527,-80,0,200,0,6
81347,1,2505,2444,61,0,100,1,6
81348,1,2637,2350,287,0,253,0,8
81349,1,2787,2603,184,0,151,0,6
81350,3,2400,2303,97,0,120,0,6
81351,1,2625,2609,16,0,104,1,6
81352,2,2472,2439,33,0,200,0,6
81353,3,2529,2479,50,0,315,0,6
81354,2,2430,2437,-7,0,207,0,6
81355,1,2551,2476,75,0,41,0,6
81356,2,2408,2286,122,0,101,0,6
81357,1,2648,2597,51,0,106,0,6
81358,1,2428,2445,-17,0,461,0,6
81359,2,2422,2423,-1,0,381,1,6
81360,1,2472,2556,-84,0,107,0,6
81361,2,2374,2443,-69,0,341,1,6
81362,1,2498,2393,105,0,426,0,6
81363,2,2424,2402,22,0,56,0,6
81364,2,2380,2412,-32,0,152,1,6
81365,3,2670,2726,-56,0,0,0,6
81366,3,2550,2583,-33,0,247,0,6
81367,2,2474,2366,108,0,270,0,6
81368,2,2389,2502,-113,0,101,0,6
81369,2,2294,2400,-106,0,242,0,6
81370,2,2383,2404,-21,0,345,1,6
81371,2,2432,2473,-41,0,280,0,6
81372,1,2421,2533,-112,0,122,0,6
81373,1,2400,2275,125,0,307,0,6
81374,2,2259,2425,-166,0,2,1,6
81375,3,2392,2521,-129,0,321,0,6
81376,2,2592,2653,-61,0,302,0,6
81377,2,2520,2454,66,0,40,1,6
81378,1,2309,2407,-98,0,4,0,6
81379,1,2549,2605,-56,0,302,0,6
81380,2,2479,2460,19,0,16,0,6
81381,1,2422,2376,46,0,339,0,6
81382,1,2419,2228,191,0,7,1,6
81383,2,2355,2457,-102,0,315,0,6
81384,2,2502,2348,154,0,389,0,6
81385,2,2592,2790,-198,0,133,0,6
81387,3,2447,2398,49,0,301,0,6
81388,1,2304,2434,-130,0,187,1,6
81389,2,2480,2529,-49,0,432,0,6
81390,3,2438,2606,-168,0,211,0,6
81391,2,2658,2587,71,0,106,0,6
81392,3,2307,2408,-101,0,225,0,6
81393,1,2466,2388,78,0,4,0,6
81394,1,2564,2473,91,0,108,0,6
81395,1,2556,2418,138,0,46,0,6
81396,1,2429,2416,13,0,302,0,6
81397,2,2599,2449,150,0,133,0,6
81398,3,2725,2671,54,0,4,0,6
81399,3,2506,2385,121,0,426,0,6
81400,1,2466,2374,92,0,104,1,6
81401,1,2411,2378,33,0,201,0,6
81402,1,2582,2550,32,0,125,0,6
81403,2,2239,2596,-357,0,141,0,8
81404,2,2421,2434,-13,0,36,0,6
81405,3,2439,2402,37,0,414,0,6
81406,2,2461,2478,-17,0,302,0,6
81408,2,2428,2259,169,4,104,1,13
81409,1,2594,2394,200,0,359,0,6
81410,1,2400,2391,9,0,200,0,6
81411,2,2461,2513,-52,0,200,0,6
81412,2,2415,2422,-7,0,354,1,6
81413,2,2399,2446,-47,0,443,0,6
81414,1,2481,2591,-110,0,324,0,6
81415,2,2402,2378,24,0,122,0,6
81416,3,2311,2475,-164,0,119,0,6
81417,3,2356,2534,-178,0,332,0,6
81418,2,2285,2457,-172,0,130,0,6
81419,1,2394,2430,-36,0,13,1,6
81420,3,2310,2494,-184,0,112,0,6
81421,1,2603,2440,163,0,122,0,6
81422,2,2358,2416,-58,0,300,1,6
81423,2,2374,2471,-97,0,129,1,6
81424,1,2419,2418,1,0,345,0,6
81425,2,2387,2504,-117,0,101,0,6
81426,2,2385,2426,-41,0,45,0,6
81427,2,2362,2510,-148,0,132,0,6
81428,1,2440,2469,-29,0,41,0,6
81429,1,2454,2417,37,0,40,0,6
81430,2,2672,2724,-52,0,0,1,6
81431,1,2427,2348,79,0,352,0,6
81432,2,2468,2394,74,0,337,0,6
81433,3,2343,2639,-296,0,466,0,8
81434,2,2556,2569,-13,0,140,0,6
81435,1,2459,2557,-98,0,241,0,6
81436,1,2583,2391,192,0,211,0,6
81437,1,2545,2587,-42,0,245,1,6
81438,2,2370,2471,-101,0,45,0,6
81439,2,2518,2456,62,0,40,0,6
81440,2,2508,2384,124,0,426,0,6
81441,2,2401,2484,-83,0,315,0,6
81442,2,2370,2456,-86,0,143,1,6
81443,1,2550,2466,84,0,46,1,6
81444,2,2437,2607,-170,0,162,0,6
81445,1,2531,2425,106,0,106,0,6
81446,2,2359,2413,-54,0,347,0,6
81447,1,2428,2266,162,0,4,1,6
81448,1,2473,2313,160,0,313,0,6
81449,2,2485,2439,46,0,104,0,6
81450,1,2458,2409,49,0,0,0,6
81451,1,2610,2434,176,0,194,0,6
81452,2,2279,2431,-152,0,211,0,6
81453,1,2462,2446,16,0,1,0,6
81454,2,2286,2597,-311,0,45,0,8
81455,2,2434,2475,-41,0,46,0,6
81456,1,2384,2429,-45,0,320,1,6
81457,1,2460,2510,-50,0,80,1,6
81458,1,2547,2378,169,0,44,1,6
81459,1,2307,2463,-156,0,457,0,6
81460,2,2354,2431,-77,0,354,0,6
81461,3,2412,2459,-47,0,487,0,6
81462,2,2401,2388,13,0,3,0,6
81463,1,2513,2500,13,0,154,0,6
81464,2,2651,2586,65,0,190,0,6
81465,2,2475,2551,-76,0,200,0,6
81466,2,2372,2400,-28,0,11,1,6
81467,3,2397,2421,-24,0,11,0,6
81468,2,2463,2512,-49,0,200,0,6
81469,1,2461,2312,149,0,210,1,6
81470,1,2371,2403,-32,0,118,1,6
81471,2,2581,2552,29,0,101,1,6
81472,2,2422,2313,109,0,42,1,6
81473,2,2418,2366,52,0,487,1,6
81474,3,2487,2594,-107,0,122,0,6
81475,1,2391,2501,-110,0,101,0,6
81476,1,2535,2471,64,0,331,0,6
81477,2,2386,2519,-133,0,300,1,6
81478,3,2418,2289,129,0,45,0,6
81480,2,2265,2400,-135,0,200,1,8
81481,2,2442,2555,-113,0,212,0,6
81482,2,2480,2365,115,0,46,1,6
81483,1,2391,2411,-20,0,45,0,6
81484,2,2360,2432,-72,0,45,0,6
81485,1,2375,2551,-176,0,469,0,6
81486,2,2436,2349,87,0,130,1,6
81487,2,2423,2314,109,0,11,1,6
81488,2,2458,2390,68,0,303,0,6
81489,2,2412,2455,-43,0,484,1,6
81490,1,2441,2468,-27,0,40,0,6
81491,2,2510,2431,79,0,190,0,6
81492,1,2477,2287,190,4,125,0,23
81493,2,2443,2470,-27,0,130,0,6
81494,1,2427,2310,117,0,178,0,6
81495,1,2593,2404,189,0,242,0,6
81496,2,2517,2458,59,0,0,0,6
81497,2,2357,2478,-121,0,46,0,6
81498,1,2556,2559,-3,0,211,0,6
81499,2,2405,2445,-40,0,100,0,6
81500,1,2438,2429,9,0,347,0,6
81501,1,2335,2488,-153,4,315,0,0
81502,2,2534,2397,137,0,8,0,6
81503,1,2435,2275,160,0,469,1,6
81504,2,2488,2452,36,0,4,0,6
81505,1,2397,2540,-143,0,432,1,6
81506,1,2558,2575,-17,0,245,1,6
81507,1,2636,2358,278,0,278,0,8
81508,1,2464,2510,-46,0,200,1,6
81509,1,2431,2411,20,0,345,1,6
81510,1,2592,2466,126,0,254,0,6
81511,2,2394,2473,-79,0,65,0,6
81512,1,2372,2404,-32,0,265,0,6
81513,2,2306,2431,-125,0,178,0,6
81514,1,2599,2423,176,0,473,0,8
81515,2,2444,2219,225,0,310,0,6
81516,2,2489,2509,-20,0,101,0,6
81517,2,2569,2573,-4,0,101,0,6
81518,1,2501,2446,55,0,130,0,6
81519,2,2508,2384,124,0,70,0,6
81520,1,2347,2527,-180,0,25,1,6
81521,2,2454,2561,-107,0,211,0,6
81522,1,2415,2370,45,0,242,1,6
81523,1,2444,2429,15,0,306,0,6
81524,2,2403,2395,8,0,341,0,6
81525,1,2462,2447,15,0,110,0,6
81526,1,2343,2437,-94,0,10,0,6
81527,2,2476,2322,154,0,292,0,6
81528,3,2381,2408,-27,0,110,0,6
81529,1,2596,2438,158,0,128,0,6
81530,2,2323,2439,-116,0,10,1,6
81531,1,2438,2503,-65,0,162,1,6
81532,2,2441,2467,-26,0,40,0,6
81533,2,2396,2417,-21,0,1,1,6
81534,1,2407,2450,-43,0,40,0,6
81535,1,2401,2495,-94,0,375,0,6
81536,1,2565,2464,101,0,16,0,6
81537,1,2482,2519,-37,0,132,0,6
81538,1,2439,2310,129,0,227,0,6
81539,2,2316,2435,-119,0,121,0,6
81540,1,2296,2432,-136,0,200,0,6
81541,1,2527,2354,173,0,8,0,6
81542,2,2428,2414,14,0,113,0,6
81543,1,2481,2441,40,0,106,1,6
81544,1,2264,2440,-176,0,127,0,6
81545,1,2436,2273,163,0,288,0,6
81546,1,2579,2563,16,0,115,1,6
81547,2,2424,2450,-26,0,247,1,6
81548,1,2429,2514,-85,0,7,1,6
81549,2,2488,2443,45,0,8,1,6
81550,2,2379,2555,-176,0,106,0,6
81551,1,2504,2471,33,0,1,0,6
81552,1,2272,2438,-166,0,211,1,6
81553,2,2347,2532,-185,0,37,1,6
81554,2,2389,2421,-32,0,108,0,6
81555,1,2481,2405,76,0,8,0,6
81556,2,2526,2330,196,0,48,1,6
81557,1,2564,2525,39,0,145,1,6
81558,2,2476,2596,-120,0,132,0,6
81559,1,2435,2389,46,0,212,0,6
81560,1,2460,2477,-17,0,245,1,6
81561,2,2468,2336,132,0,104,1,6
81562,2,2437,2599,-162,0,151,0,6
81563,1,2408,2345,63,0,310,0,6
81564,2,2392,2459,-67,0,260,0,6
81565,1,2406,2319,87,0,178,1,8
81566,1,2318,2488,-170,0,140,0,6
81567,2,2570,2486,84,0,102,0,6
81568,3,2502,2435,67,0,6,0,6
81569,3,2401,2558,-157,0,380,0,6
81570,3,2426,2384,42,0,43,0,6
81571,2,2496,2436,60,0,112,1,6
81572,2,2445,2530,-85,0,112,0,6
81573,1,2439,2294,145,0,132,0,6
81574,2,2483,2485,-2,0,106,0,6
81575,2,2513,2347,166,0,133,0,6
81576,2,2429,2422,7,0,107,0,6
81577,2,2427,2265,162,0,387,1,8
81578,1,2420,2401,19,0,333,0,6
81579,1,2645,2563,82,0,202,0,6
81580,2,2351,2638,-287,0,40,0,8
81581,1,2426,2493,-67,0,466,0,6
81582,1,2499,2354,145,0,311,0,6
81583,2,2420,2459,-39,0,107,0,8
81584,1,2587,2460,127,0,131,0,6
81585,1,2455,2418,37,0,90,0,6
81586,2,2466,2509,-43,0,200,0,6
81587,1,2460,2507,-47,0,11,0,6
81588,1,2384,2407,-23,0,57,0,6
81589,1,2449,2313,136,0,242,0,6
81590,2,2482,2535,-53,0,8,0,6
81591,1,2273,2440,-167,0,35,1,6
81592,3,2436,2534,-98,0,8,0,6
81593,2,2440,2442,-2,0,406,0,6
81594,1,2465,2345,120,4,344,0,0
81595,1,2441,2520,-79,0,4,0,6
81596,2,2734,2569,165,0,101,1,6
81597,1,2471,2374,97,0,43,0,6
81598,2,2254,2579,-325,4,112,0,13
81599,2,2466,2292,174,0,205,0,6
81600,1,2600,2440,160,0,123,0,6
81601,1,2514,2461,53,0,1,0,6
81602,2,2464,2472,-8,0,310,0,6
81603,1,2413,2460,-47,0,45,0,6
81604,2,2387,2434,-47,0,211,0,6
81605,1,2556,2403,153,0,415,1,6
81606,2,2384,2425,-41,0,380,0,6
81607,2,2297,2458,-161,0,40,0,8
81608,2,2211,2480,-269,4,463,0,23
81609,2,2488,2447,41,0,130,0,6
81610,3,2287,2490,-203,0,409,0,8
81611,1,2486,2336,150,0,394,0,6
81612,1,2345,2428,-83,0,48,0,6
81613,2,2302,2420,-118,4,122,1,13
81614,1,2401,2316,85,0,15,0,6
81615,1,2423,2425,-2,0,114,1,6
81616,3,2300,2458,-158,0,487,0,6
81617,1,2478,2458,20,0,150,0,6
81618,1,2436,2478,-42,0,202,1,6
81619,2,2443,2489,-46,0,45,0,6
81620,1,2391,2453,-62,0,300,0,6
81621,2,2377,2433,-56,0,218,0,6
81622,3,2533,2438,95,0,4,0,6
81623,1,2486,2413,73,0,4,1,6
81624,2,2424,2502,-78,0,131,0,6
81625,1,2526,2333,193,0,45,1,6
81626,1,2585,2429,156,0,343,0,6
81627,1,2494,2438,56,0,300,0,6
81628,2,2476,2558,-82,0,411,1,6
81629,3,2378,2480,-102,0,140,0,6
81630,2,2540,2370,170,0,45,0,6
81631,1,2409,2513,-104,0,145,0,6
81632,1,2450,2275,175,0,101,0,6
81633,2,2501,2488,13,0,40,0,6
81634,2,2297,2408,-111,0,470,0,6
81635,3,2447,2314,133,0,127,0,6
81636,1,2350,2410,-60,0,156,0,8
81637,2,2437,2597,-160,0,162,1,6
81638,2,2340,2415,-75,0,302,0,6
81639,3,2341,2476,-135,4,347,0,0
81640,2,2433,2499,-66,0,40,0,6
81641,2,2384,2421,-37,0,335,0,6
81642,2,2477,2603,-126,0,7,0,6
81643,1,2431,2439,-8,0,429,0,6
81644,2,2456,2519,-63,0,200,0,6
81645,1,2534,2578,-44,0,101,0,6
81646,2,2322,2504,-182,0,132,0,6
81647,2,2454,2377,77,0,119,0,6
81648,2,2448,2454,-6,0,4,0,6
81649,2,2415,2602,-187,0,0,0,8
81650,2,2462,2418,44,0,253,1,8
81651,1,2430,2466,-36,0,211,0,6
81652,2,2424,2256,168,0,40,1,6
81653,1,2467,2484,-17,0,458,0,6
81654,3,2456,2376,80,0,107,0,6
81655,2,2419,2268,151,0,405,0,6
81656,2,2331,2489,-158,0,100,0,6
81657,1,2405,2367,38,0,332,0,6
81658,3,2464,2284,180,0,153,0,8
81659,1,2506,2698,-192,0,277,0,6
81660,1,2489,2510,-21,0,385,0,6
81661,2,2416,2532,-116,0,200,0,6
81662,3,2362,2481,-119,0,61,0,6
81663,2,2531,2691,-160,0,4,0,6
81664,2,2379,2454,-75,0,331,0,6
81665,1,2471,2479,-8,0,143,0,6
81666,1,2294,2471,-177,0,45,1,6
81667,1,2562,2519,43,0,245,0,6
81668,1,2438,2397,41,0,466,0,6
81669,1,2603,2491,112,0,45,0,6
81670,1,2409,2473,-64,0,247,1,6
81671,3,2330,2515,-185,0,145,0,6
81672,1,2440,2362,78,0,5,0,6
81673,2,2532,2725,-193,0,45,0,6
81674,1,2460,2437,23,0,112,0,6
81675,2,2458,2374,84,0,200,0,6
81676,1,2429,2429,0,0,45,0,6
81677,1,2559,2495,64,0,101,0,6
81678,1,2571,2541,30,0,100,1,6
81679,2,2446,2384,62,0,110,0,6
81680,2,2378,2445,-67,0,411,0,6
81681,2,2358,2410,-52,0,45,0,6
81682,1,2487,2567,-80,0,4,0,6
81683,1,2443,2302,141,0,13,0,6
81684,1,2473,2477,-4,0,335,0,6
81685,3,2640,2344,296,0,20,0,8
81686,1,2504,2401,103,0,243,0,6
81687,1,2433,2383,50,0,117,0,6
81688,1,2479,2342,137,0,265,0,6
81689,3,2358,2488,-130,0,5,0,8
81690,3,2464,2529,-65,0,50,0,6
81691,3,2431,2465,-34,0,202,0,6
81692,2,2536,2480,56,0,241,0,6
81693,1,2415,2353,62,0,338,0,6
81694,1,2695,2528,167,0,115,1,6
81695,2,2426,2413,13,0,122,0,6
81696,1,2321,2419,-98,0,114,0,6
81697,1,2327,2437,-110,0,190,0,6
81698,2,2522,2492,30,0,45,1,6
81699,1,2450,2357,93,0,113,0,6
81700,3,2330,2458,-128,0,245,0,6
81701,2,2412,2272,140,0,363,0,6
81702,1,2348,2507,-159,0,14,0,6
81703,2,2313,2444,-131,0,126,0,6
81704,3,2410,2351,59,0,44,0,6
81705,1,2362,2463,-101,0,61,1,6
81706,3,2560,2473,87,0,103,0,6
81707,3,2453,2397,56,0,245,0,6
81708,2,2318,2420,-102,0,108,0,6
81709,2,2392,2415,-23,0,300,0,6
81710,2,2443,2388,55,0,463,0,6
81711,1,2489,2467,22,0,300,0,6
81712,1,2512,2423,89,0,45,0,6
81713,2,2434,2400,34,0,45,1,6
81714,1,2490,2350,140,0,302,0,6
81715,1,2376,2412,-36,0,300,0,8
81716,2,2535,2577,-42,0,8,0,6
81717,2,2440,2382,58,0,200,1,6
81718,3,2487,2530,-43,0,40,0,6
81719,2,2274,2462,-188,0,191,0,8
81720,2,2448,2222,226,4,243,0,13
81721,1,2397,2508,-111,0,210,0,6
81722,1,2471,2373,98,0,101,1,6
81723,2,2423,2516,-93,0,49,0,6
81724,2,2345,2421,-76,0,15,1,6
81725,2,2332,2421,-89,0,130,0,6
81726,1,2455,2378,77,0,131,0,6
81727,1,2430,2366,64,0,466,0,6
81728,2,2422,2379,43,0,326,1,6
81729,1,2425,2296,129,0,201,1,8
81730,1,2464,2453,11,0,245,1,6
81731,3,2363,2400,-37,0,386,0,6
81732,2,2479,2490,-11,0,128,0,6
81733,2,2484,2528,-44,0,103,0,6
81734,2,2353,2474,-121,0,40,0,6
81735,2,2525,2698,-173,0,4,1,6
81736,1,2424,2498,-74,0,34,0,6
81737,3,2486,2360,126,0,267,0,8
81738,1,2456,2482,-26,0,461,0,6
81739,2,2298,2409,-111,0,190,0,6
81740,2,2354,2440,-86,0,171,0,6
81741,1,2273,2412,-139,0,112,0,6
81742,2,2232,2439,-207,4,122,1,13
81743,1,2347,2428,-81,0,316,0,6
81744,1,2521,2461,60,0,267,0,6
81745,1,2511,2387,124,0,50,0,6
81746,1,2421,2372,49,0,140,0,6
81747,2,2473,2495,-22,0,45,0,6
81748,3,2494,2405,89,0,310,0,6
81749,2,2582,2530,52,0,100,1,6
81750,1,2555,2394,161,0,255,0,6
81751,2,2454,2341,113,0,255,1,6
81752,2,2319,2495,-176,0,45,0,6
81753,1,2406,2428,-22,0,380,0,6
81754,2,2397,2482,-85,0,45,1,6
81755,1,2494,2558,-64,0,46,0,6
81756,2,2425,2389,36,0,201,1,6
81757,1,2478,2460,18,0,85,0,6
81758,2,2492,2427,65,0,0,0,6
81759,1,2488,2353,135,0,45,0,6
81760,2,2339,2474,-135,0,241,1,6
81761,1,2533,2479,54,0,345,0,6
81762,1,2347,2431,-84,0,132,0,6
81763,1,2307,2462,-155,0,45,1,6
81764,2,2431,2434,-3,0,143,0,6
81765,1,2474,2476,-2,0,212,0,6
81766,1,2325,2416,-91,0,203,0,6
81767,1,2400,2369,31,0,70,1,6
81768,1,2499,2328,171,0,155,0,6
81769,2,2358,2636,-278,0,90,0,8
81770,3,2421,2429,-8,0,133,0,6
81771,1,2437,2281,156,0,190,0,6
81772,1,2451,2328,123,0,226,0,6
81773,2,2552,2470,82,0,28,0,6
81774,2,2372,2522,-150,0,110,0,6
81775,2,2401,2459,-58,0,5,0,6
81776,2,2413,2405,8,0,197,0,6
81777,2,2391,2558,-167,0,112,1,6
81778,1,2496,2526,-30,0,335,0,6
81779,2,2447,2463,-16,0,132,1,6
81780,1,2447,2306,141,4,215,0,13
81781,1,2305,2465,-160,0,121,0,6
81782,2,2367,2438,-71,0,57,0,6
81783,1,2422,2413,9,0,123,0,6
81784,2,2455,2301,154,0,200,0,6
81785,2,2320,2411,-91,0,140,0,6
81786,1,2476,2515,-39,0,426,1,6
81787,1,2525,2502,23,0,211,0,6
81788,1,2571,2459,112,0,43,0,6
81789,1,2406,2467,-61,0,102,1,6
81790,1,2426,2401,25,0,488,0,6
81792,2,2384,2432,-48,0,224,0,6
81793,1,2498,2345,153,0,310,1,6
81794,1,2425,2350,75,0,200,0,6
81795,1,2434,2364,70,0,80,1,6
81796,2,2465,2382,83,0,112,0,8
81797,1,2529,2359,170,0,40,0,6
81798,1,2348,2457,-109,0,138,1,6
81799,2,2537,2575,-38,0,0,0,6
81800,1,2416,2316,100,0,85,0,6
81801,2,2424,2491,-67,0,54,0,6
81802,1,2474,2538,-64,0,142,1,6
81803,2,2292,2457,-165,0,187,0,6
81804,1,2419,2396,23,0,122,0,6
81805,2,2370,2429,-59,0,227,1,8
81806,2,2487,2520,-33,0,288,1,6
81807,1,2472,2360,112,0,241,0,6
81808,1,2404,2281,123,0,112,0,6
81809,2,2454,2356,98,0,5,0,6
81810,2,2484,2369,115,0,30,1,6
81811,2,2525,2506,19,0,4,0,6
81812,1,2470,2485,-15,0,100,0,6
81813,1,2490,2429,61,0,130,1,6
81814,1,2478,2325,153,0,4,0,6
81815,2,2320,2406,-86,0,45,0,8
81816,2,2298,2424,-126,0,337,0,6
81817,3,2481,2404,77,0,131,0,6
81818,1,2496,2477,19,0,45,0,6
81819,1,2420,2335,85,0,380,1,6
81820,2,2464,2575,-111,0,213,1,6
81821,1,2580,2532,48,0,100,1,6
81822,1,2363,2423,-60,0,45,0,6
81823,1,2562,2388,174,0,45,0,6
81824,2,2506,2604,-98,0,200,0,6
81825,2,2294,2442,-148,0,123,0,6
81826,3,2447,2442,5,0,228,0,6
81827,2,2407,2428,-21,0,40,1,6
81828,1,2496,2443,53,0,300,0,6
81829,2,2245,2419,-174,0,41,0,6
81830,1,2455,2545,-90,0,41,0,6
81831,2,2294,2605,-311,0,123,0,8
81832,1,2508,2482,26,0,310,0,6
81833,2,2277,2430,-153,0,225,0,6
81834,1,2546,2360,186,0,156,0,6
81835,2,2457,2437,20,0,7,0,6
81837,1,2479,2379,100,0,0,0,6
81838,2,2691,2611,80,0,130,0,6
81839,1,2423,2356,67,0,301,0,6
81840,1,2461,2413,48,0,246,0,6
81841,2,2379,2401,-22,0,321,0,6
81842,2,2561,2650,-89,0,378,1,6
81843,1,2446,2289,157,0,13,0,6
81844,2,2512,2514,-2,0,106,0,6
81845,2,2531,2504,27,0,344,1,6
81846,3,2428,2296,132,0,113,0,6
81847,2,2441,2432,9,0,330,0,6
81848,2,2370,2425,-55,0,300,0,6
81849,2,2476,2589,-113,0,13,0,6
81850,2,2334,2411,-77,0,46,1,8
81851,1,2385,2565,-180,0,112,0,6
81852,3,2304,2483,-179,0,45,0,6
81853,1,2292,2458,-166,0,123,1,8
81854,1,2450,2308,142,0,30,0,6
81855,2,2472,2502,-30,0,106,0,6
81856,1,2350,2424,-74,0,140,1,6
81857,2,2477,2514,-37,0,335,0,6
81858,2,2424,2427,-3,0,241,0,6
81859,1,2405,2502,-97,0,463,0,6
81860,1,2423,2318,105,0,400,1,6
81861,1,2607,2392,215,0,234,0,6
81862,1,2482,2393,89,0,241,1,6
81863,2,2446,2378,68,0,140,1,6
81864,1,2331,2433,-102,0,7,1,6
81865,1,2493,2501,-8,0,55,0,6
81866,1,2465,2375,90,0,41,0,6
81867,2,2439,2472,-33,0,105,1,6
81868,2,2430,2446,-16,0,247,1,6
81869,2,2451,2442,9,0,8,0,6
81870,2,2608,2623,-15,0,2,0,6
81871,2,2408,2466,-58,0,107,0,6
81872,2,2443,2591,-148,0,101,0,6
81873,1,2510,2433,77,0,110,0,6
81874,2,2481,2408,73,0,426,0,6
81875,3,2302,2424,-122,4,64,0,13
81876,1,2442,2304,138,4,120,1,13
81877,2,2315,2473,-158,0,200,0,6
81878,1,2502,2438,64,0,115,0,6
81879,2,2393,2504,-111,0,188,0,6
81880,1,2406,2315,91,0,300,0,6
81881,3,2638,2352,286,0,45,0,8
81882,2,2380,2556,-176,0,0,0,6
81883,2,2654,2532,122,0,107,1,6
81884,1,2400,2268,132,0,402,0,6
81885,2,2460,2594,-134,0,81,1,6
81886,1,2467,2460,7,0,245,0,6
81887,2,2481,2370,111,0,0,0,6
81888,2,2471,2403,68,0,0,0,6
81889,2,2435,2403,32,0,310,0,6
81890,2,2429,2515,-86,0,226,0,6
81891,1,2375,2453,-78,0,470,1,6
81892,2,2670,2527,143,0,130,0,6
81893,3,2519,2472,47,0,310,0,6
81894,1,2537,2477,60,0,200,0,6
81895,2,2495,2440,55,0,109,0,6
81896,2,2418,2304,114,0,128,1,6
81897,2,2433,2609,-176,0,324,0,6
81898,2,2402,2445,-43,0,311,0,6
81899,2,2434,2433,1,0,196,1,6
81900,2,2495,2499,-4,0,45,0,6
81901,2,2390,2560,-170,0,106,0,6
81902,1,2404,2233,171,0,310,0,6
81903,1,2417,2251,166,0,56,0,6
81904,1,2426,2339,87,0,49,1,6
81905,1,2413,2477,-64,0,40,1,6
81906,3,2607,2455,152,0,43,0,8
81907,1,2314,2607,-293,0,140,0,6
81908,1,2453,2462,-9,0,140,0,6
81909,2,2495,2390,105,0,140,0,6
81910,1,2323,2490,-167,0,140,0,6
81911,1,2505,2425,80,0,331,1,6
81912,2,2419,2519,-100,0,344,0,6
81913,1,2393,2563,-170,0,41,1,6
81914,1,2370,2421,-51,0,110,0,6
81915,3,2320,2456,-136,0,245,0,6
81916,2,2410,2464,-54,0,100,0,6
81917,3,2389,2433,-44,0,45,0,6
81918,1,2415,2450,-35,0,241,0,8
81919,2,2368,2610,-242,0,1,0,6
81920,2,2617,2612,5,0,150,0,6
81921,1,2450,2412,38,0,7,0,6
81922,2,2647,2593,54,0,200,0,6
81923,1,2430,2284,146,0,374,0,6
81924,2,2345,2470,-125,0,250,0,6
81925,1,2472,2472,0,0,200,0,6
81926,1,2601,2542,59,0,21,0,6
81927,3,2481,2473,8,0,45,0,6
81928,1,2286,2446,-160,0,107,1,6
81929,1,2473,2518,-45,0,454,0,6
81930,1,2415,2474,-59,0,250,0,6
81931,1,2407,2365,42,0,40,0,6
81932,1,2534,2610,-76,0,311,0,6
81933,2,2523,2377,146,0,245,0,6
81934,1,2594,2618,-24,0,126,0,6
81935,2,2291,2415,-124,0,130,1,8
81936,2,2446,2488,-42,0,110,0,6
81937,3,2383,2460,-77,0,457,0,6
81938,1,2497,2337,160,0,409,0,6
81939,1,2563,2402,161,0,426,0,6
81940,2,2265,2403,-138,0,461,0,6
81941,2,2312,2433,-121,0,142,0,6
81942,1,2401,2362,39,0,436,0,6
81943,1,2439,2261,178,0,4,0,6
81944,1,2469,2405,64,0,246,1,6
81945,3,2358,2471,-113,0,105,0,6
81946,2,2431,2351,80,0,312,0,6
81947,3,2421,2271,150,0,395,0,6
81948,2,2466,2478,-12,0,206,0,6
81949,3,2415,2343,72,0,145,0,6
81950,3,2599,2640,-41,0,45,0,6
81951,1,2437,2365,72,0,331,0,6
81952,2,2270,2406,-136,0,34,0,6
81953,1,2420,2509,-89,0,101,0,6
81954,1,2555,2387,168,0,130,0,6
81955,1,2479,2279,200,4,116,0,13
81956,1,2407,2309,98,0,46,0,6
81957,1,2308,2410,-102,0,110,1,6
81958,1,2612,2420,192,0,157,1,6
81959,1,2563,2541,22,0,130,1,6
81960,2,2302,2409,-107,0,330,1,6
81961,2,2415,2455,-40,0,300,0,6
81962,1,2605,2521,84,0,106,0,8
81963,2,2611,2600,11,0,108,0,6
81964,2,2324,2412,-88,0,111,1,6
81965,2,2269,2412,-143,0,302,0,6
81966,1,2528,2370,158,0,45,0,6
81967,1,2441,2473,-32,0,46,0,6
81968,1,2481,2337,144,0,45,0,6
81969,1,2460,2452,8,0,4,0,6
81970,2,2438,2360,78,0,13,1,6
81972,1,2449,2305,144,0,147,1,6
81973,1,2410,2446,-36,0,4,0,6
81974,3,2432,2414,18,0,453,0,6
81975,2,2406,2294,112,0,330,0,6
81976,1,2639,2600,39,0,207,0,6
81977,2,2598,2566,32,0,106,1,6
81978,1,2443,2353,90,0,130,0,8
81979,3,2579,2558,21,0,140,0,6
81980,2,2419,2504,-85,0,264,0,6
81981,1,2375,2485,-110,0,140,0,6
81982,2,2442,2417,25,0,7,0,6
81983,1,2615,2384,231,0,267,0,6
81984,3,2415,2341,74,0,300,0,6
81985,2,2392,2501,-109,0,4,0,6
81986,2,2467,2333,134,0,0,0,6
81987,2,2466,2455,11,0,4,0,6
81988,2,2448,2502,-54,0,101,0,6
81989,2,2428,2386,42,0,474,0,6
81990,2,2361,2442,-81,0,45,0,6
81991,2,2290,2413,-123,0,311,0,6
81992,2,2294,2446,-152,4,42,0,13
81993,2,2454,2553,-99,0,115,1,6
81994,1,2616,2553,63,0,413,0,6
81995,2,2248,2417,-169,0,40,0,6
81996,1,2500,2468,32,0,405,1,6
81997,2,2356,2415,-59,0,11,0,6
81998,1,2407,2243,164,0,7,0,6
81999,2,2484,2519,-35,0,112,0,6
82000,3,2411,2334,77,0,300,0,6
82001,2,2488,2315,173,0,141,0,6
82002,1,2419,2273,146,0,119,0,8
82003,2,2358,2431,-73,0,49,0,6
82004,2,2422,2338,84,4,277,0,13
82005,1,2446,2357,89,0,0,0,6
82007,1,2457,2389,68,0,241,1,6
82008,1,2372,2451,-79,0,48,0,6
82009,1,2524,2512,12,0,487,0,6
82010,1,2405,2415,-10,0,126,0,6
82011,1,2513,2388,125,0,270,0,6
82012,1,2595,2645,-50,0,45,0,6
82013,1,2509,2354,155,0,123,0,6
82014,2,2572,2386,186,0,426,0,6
82015,1,2393,2421,-28,0,13,1,6
82016,1,2514,2440,74,0,141,0,6
82017,1,2432,2262,170,0,453,0,6
82018,1,2507,2443,64,0,306,0,6
82019,1,2477,2302,175,0,300,0,6
82020,2,2423,2438,-15,0,310,0,6
82021,2,2558,2479,79,0,131,1,6
82022,1,2436,2457,-21,0,4,0,6
82023,2,2436,2502,-66,0,326,0,6
82024,2,2353,2459,-106,0,4,0,6
82025,1,2448,2325,123,0,200,0,8
82026,1,2597,2424,173,0,107,0,6
82027,2,2405,2306,99,0,0,0,6
82028,1,2381,2591,-210,0,100,1,6
82029,2,2279,2416,-137,0,253,0,6
82030,1,2341,2420,-79,0,41,0,6
82031,1,2512,2621,-109,0,432,0,6
82032,2,2463,2547,-84,0,373,0,6
82033,2,2367,2529,-162,0,302,0,6
82034,2,2413,2370,43,0,380,0,6
82035,1,2332,2420,-88,0,130,1,6
82036,1,2245,2409,-164,0,132,0,6
82037,1,2343,2437,-94,0,4,0,8
82038,2,2403,2481,-78,0,45,1,6
82039,2,2638,2602,36,0,200,0,6
82040,1,2419,2386,33,0,20,0,6
82041,1,2437,2401,36,0,130,0,6
82042,1,2324,2480,-156,0,107,1,6
82043,1,2743,2605,138,0,122,0,6
82044,1,2524,2479,45,0,46,0,6
82045,1,2419,2365,54,0,306,0,8
82046,1,2421,2299,122,0,13,1,6
82047,2,2395,2600,-205,0,40,1,6
82048,3,2352,2451,-99,0,41,0,6
82049,1,2564,2418,146,0,433,1,6
82050,2,2373,2416,-43,0,46,1,6
82051,1,2384,2517,-133,0,45,0,6
82052,1,2454,2471,-17,0,46,0,6
82053,1,2410,2462,-52,0,4,1,6
82055,2,2532,2506,26,0,45,1,6
82056,1,2506,2529,-23,0,30,1,6
82057,3,2535,2459,76,0,315,0,6
82058,2,2348,2413,-65,0,100,0,6
82059,1,2337,2442,-105,0,190,0,6
82060,3,2465,2332,133,0,45,0,6
82061,2,2465,2512,-47,0,9,0,6
82062,2,2460,2447,13,0,48,0,6
82063,1,2415,2399,16,0,474,1,6
82064,1,2551,2649,-98,0,250,0,6
82065,2,2537,2487,50,0,131,0,6
82066,2,2431,2327,104,0,35,1,6
82067,3,2315,2401,-86,0,7,0,6
82068,1,2430,2593,-163,0,202,0,6
82069,3,2385,2540,-155,0,4,0,6
82070,2,2281,2463,-182,0,317,1,6
82071,2,2322,2454,-132,0,129,0,6
82072,1,2459,2367,92,0,0,0,6
82073,1,2339,2420,-81,0,107,0,6
82074,1,2422,2400,22,0,142,0,8
82075,2,2519,2330,189,0,373,0,6
82076,2,2569,2731,-162,0,13,0,6
82077,2,2413,2253,160,0,489,0,6
82078,2,2416,2399,17,0,302,0,6
82079,2,2485,2460,25,0,45,0,6
82080,1,2390,2616,-226,0,255,0,6
82081,2,2608,2632,-24,0,45,0,6
82082,2,2448,2583,-135,0,13,0,6
82083,2,2360,2529,-169,0,21,0,6
82084,2,2276,2449,-173,4,15,1,13
82085,1,2399,2407,-8,0,270,0,6
82086,1,2332,2474,-142,0,280,0,6
82088,3,2564,2567,-3,0,106,0,6
82089,2,2454,2463,-9,0,45,0,6
82090,2,2332,2449,-117,0,142,0,6
82091,1,2509,2392,117,0,319,0,6
82092,1,2445,2354,91,0,331,0,6
82093,2,2425,2559,-134,0,332,0,6
82094,1,2421,2449,-28,0,380,1,6
82095,2,2353,2405,-52,0,310,0,6
82096,1,2482,2533,-51,0,104,1,6
82097,1,2394,2421,-27,0,4,0,6
82098,1,2460,2439,21,0,5,0,6
82099,2,2537,2531,6,0,45,0,6
82100,1,2523,2479,44,0,53,0,6
82101,1,2386,2424,-38,0,10,1,6
82102,1,2519,2335,184,0,39,0,6
82103,3,2403,2357,46,4,302,0,10
82104,2,2375,2453,-78,0,344,0,6
82105,2,2414,2493,-79,0,341,0,6
82106,1,2435,2385,50,0,13,0,6
82107,1,2361,2428,-67,0,153,0,8
82108,1,2466,2332,134,0,46,0,6
82109,1,2349,2411,-62,0,45,1,6
82110,2,2531,2493,38,0,45,0,6
82111,1,2734,2566,168,0,112,0,6
82112,2,2274,2441,-167,0,46,0,6
82113,2,2466,2339,127,0,45,1,6
82114,1,2637,2603,34,0,121,1,6
82115,2,2546,2398,148,0,130,0,6
82116,1,2525,2318,207,0,45,0,6
82117,1,2617,2536,81,0,144,0,6
82118,3,2458,2512,-54,0,45,0,6
82119,2,2405,2466,-61,0,253,0,6
82120,2,2394,2409,-15,0,11,1,8
82121,2,2355,2533,-178,0,113,0,6
82122,1,2380,2410,-30,0,111,0,6
82123,3,2410,2440,-30,0,151,0,6
82124,3,2259,2405,-146,0,113,0,6
82125,2,2443,2522,-79,0,113,0,6
82126,1,2607,2339,268,0,123,1,6
82127,2,2351,2510,-159,0,296,0,6
82128,2,2586,2567,19,0,1,0,6
82129,2,2512,2469,43,0,100,1,6
82130,1,2415,2400,15,0,475,0,6
82131,1,2633,2564,69,0,106,0,6
82132,2,2402,2562,-160,0,4,1,6
82133,2,2362,2453,-91,0,380,0,6
82134,2,2474,2500,-26,0,45,1,6
82135,2,2345,2421,-76,0,380,0,6
82136,1,2528,2525,3,0,53,0,6
82137,2,2388,2513,-125,0,130,1,6
82138,1,2410,2368,42,0,485,0,6
82139,1,2260,2418,-158,0,162,1,6
82140,2,2297,2453,-156,0,106,0,6
82141,1,2482,2328,154,0,382,0,6
82142,3,2471,2488,-17,0,4,0,6
82143,1,2602,2626,-24,0,110,0,6
82144,3,2451,2293,158,0,46,0,6
82145,1,2447,2391,56,0,343,0,6
82146,1,2413,2405,8,0,222,0,6
82147,2,2426,2332,94,0,110,1,6
82148,1,2341,2449,-108,0,9,0,6
82149,2,2412,2532,-120,0,78,0,6
82150,1,2592,2598,-6,0,313,0,6
82151,1,2427,2307,120,0,50,0,6
82152,1,2385,2456,-71,0,45,1,6
82153,1,2404,2405,-1,0,46,0,6
82154,1,2457,2461,-4,0,6,0,6
82155,1,2527,2431,96,0,5,0,6
82156,3,2287,2421,-134,0,382,0,8
82157,1,2536,2408,128,0,178,0,6
82158,2,2561,2524,37,0,203,1,6
82159,2,2297,2401,-104,0,1,0,6
82160,2,2278,2415,-137,0,130,0,6
82161,1,2271,2411,-140,0,44,0,6
82162,2,2573,2580,-7,0,463,1,6
82163,2,2534,2505,29,0,335,0,6
82164,1,2609,2410,199,0,131,1,6
82165,2,2394,2420,-26,0,13,0,6
82166,2,2566,2622,-56,0,190,1,6
82167,2,2475,2467,8,0,0,1,6
82168,2,2403,2437,-34,0,110,1,6
82169,2,2418,2447,-29,0,398,0,6
82170,1,2456,2410,46,0,302,0,6
82171,1,2608,2642,-34,0,380,0,6
82172,2,2519,2399,120,0,45,0,6
82173,1,2387,2516,-129,0,204,0,6
82174,2,2423,2511,-88,0,125,0,6
82175,1,2505,2459,46,0,50,1,6
82176,2,2295,2469,-174,0,143,1,6
82177,1,2517,2384,133,0,247,0,6
82178,2,2303,2431,-128,0,202,0,6
82179,1,2505,2488,17,0,247,0,6
82180,1,2285,2459,-174,0,405,1,6
82181,1,2471,2442,29,0,46,0,6
82182,1,2592,2642,-50,0,300,0,6
82183,1,2349,2402,-53,0,15,0,6
82184,1,2466,2349,117,0,330,0,6
82185,1,2404,2325,79,0,141,0,6
82186,1,2414,2367,47,0,343,0,8
82187,2,2462,2598,-136,0,374,1,6
82188,2,2320,2428,-108,0,1,0,6
82189,2,2410,2308,102,0,46,0,6
82190,2,2426,2389,37,0,474,0,6
82191,2,2480,2383,97,0,140,0,6
82192,2,2417,2539,-122,0,123,1,6
82193,1,2292,2465,-173,0,1,0,6
82194,3,2614,2531,83,0,326,0,6
82195,1,2299,2457,-158,0,381,0,6
82196,1,2400,2419,-19,0,277,0,6
82197,1,2531,2555,-24,0,241,0,6
82198,2,2525,2522,3,0,371,1,6
82199,1,2568,2508,60,0,106,0,6
82200,2,2511,2528,-17,0,46,0,6
82201,2,2586,2511,75,0,0,1,6
82202,1,2396,2419,-23,0,4,0,6
82203,1,2483,2407,76,0,107,0,6
82204,2,2404,2540,-136,0,79,0,6
82205,1,2512,2660,-148,0,45,0,6
82206,1,2458,2389,69,0,140,0,8
82207,1,2448,2561,-113,0,301,0,6
82208,2,2627,2612,15,0,272,0,6
82209,2,2264,2415,-151,0,16,0,6
82210,2,2437,2318,119,0,426,0,6
82211,3,2419,2308,111,0,241,0,8
82212,2,2470,2636,-166,0,0,0,6
82213,2,2415,2476,-61,0,310,0,6
82214,1,2353,2435,-82,0,201,0,6
82215,1,2473,2347,126,0,46,0,6
82216,1,2470,2472,-2,0,4,0,6
82217,3,2296,2403,-107,0,193,0,6
82218,1,2454,2554,-100,0,394,1,6
82219,1,2388,2456,-68,0,110,0,6
82220,1,2405,2345,60,0,15,0,6
82221,1,2472,2510,-38,0,41,0,6
82222,1,2497,2442,55,0,310,0,6
82223,1,2366,2424,-58,0,245,0,6
82224,1,2513,2365,148,0,15,0,6
82225,3,2415,2244,171,4,135,0,13
82226,1,2450,2360,90,0,4,0,6
82227,1,2635,2598,37,0,202,0,6
82228,1,2391,2402,-11,0,315,0,6
82229,2,2410,2236,174,0,4,1,6
82230,2,2256,2409,-153,0,141,1,6
82231,3,2515,2418,97,0,45,0,6
82232,2,2392,2528,-136,0,45,1,6
82233,2,2262,2419,-157,0,300,0,8
82234,1,2487,2481,6,0,15,0,6
82235,2,2410,2395,15,0,485,0,6
82236,1,2418,2462,-44,0,123,0,6
82237,1,2543,2401,142,0,178,0,6
82238,3,2532,2380,152,0,4,0,6
82239,2,2261,2417,-156,0,131,0,6
82240,2,2487,2499,-12,0,162,1,6
82241,3,2343,2476,-133,0,141,0,6
82242,1,2612,2514,98,0,414,0,6
82243,3,2403,2478,-75,0,54,0,6
82244,1,2549,2537,12,0,0,0,6
82245,1,2263,2439,-176,0,225,1,6
82246,1,2515,2421,94,0,338,0,6
82247,2,2262,2429,-167,0,53,0,6
82248,2,2533,2505,28,0,484,0,6
82249,1,2407,2424,-17,0,101,1,6
82250,3,2621,2615,6,0,278,0,6
82251,1,2459,2395,64,0,0,0,6
82252,1,2467,2383,84,0,131,0,6
82253,3,2329,2437,-108,0,313,0,6
82254,2,2413,2402,11,0,474,0,6
82255,1,2397,2547,-150,0,79,1,6
82256,2,2652,2602,50,0,198,0,6
82257,1,2466,2360,106,0,0,0,6
82258,1,2639,2579,60,0,100,0,6
82259,1,2593,2641,-48,0,300,0,6
82260,2,2413,2528,-115,0,222,0,6
82261,2,2546,2419,127,0,250,1,6
82262,2,2346,2520,-174,0,107,1,6
82263,2,2361,2542,-181,0,341,0,6
82264,1,2321,2458,-137,0,125,0,6
82265,1,2409,2339,70,4,28,0,13
82266,1,2417,2365,52,0,101,1,8
82267,1,2436,2381,55,0,107,0,6
82268,1,2413,2401,12,0,103,1,6
82269,2,2368,2411,-43,0,80,0,6
82270,3,2275,2409,-134,4,106,0,10
82271,1,2345,2412,-67,0,123,0,6
82272,1,2603,2588,15,0,156,0,6
82273,2,2401,2405,-4,0,147,0,6
82274,2,2378,2474,-96,0,315,0,6
82275,1,2475,2521,-46,0,8,1,6
82276,3,2512,2527,-15,0,200,0,6
82277,1,2354,2471,-117,0,106,1,6
82278,1,2367,2401,-34,0,115,0,6
82279,2,2410,2340,70,0,485,0,6
82280,1,2404,2477,-73,0,122,0,6
82281,1,2461,2554,-93,0,46,0,6
82282,1,2432,2404,28,0,56,0,6
82283,2,2280,2445,-165,0,45,0,6
82284,1,2309,2453,-144,4,47,0,13
82285,2,2401,2482,-81,0,134,0,6
82286,1,2504,2530,-26,0,315,1,6
82287,1,2534,2621,-87,0,325,0,6
82288,2,2604,2644,-40,0,153,0,6
82289,2,2474,2464,10,0,142,0,6
82290,2,2345,2418,-73,0,101,0,6
82291,2,2634,2600,34,0,202,1,6
82292,2,2532,2492,40,0,215,0,6
82293,3,2425,2316,109,0,30,0,6
82294,2,2574,2638,-64,0,0,0,6
82295,2,2359,2417,-58,0,173,0,6
82296,1,2314,2435,-121,0,194,0,6
82297,2,2466,2646,-180,0,9,0,6
82298,1,2411,2241,170,0,74,0,6
82299,2,2271,2416,-145,0,5,1,6
82300,1,2352,2410,-58,0,149,0,6
82301,1,2608,2494,114,0,466,0,6
82302,1,2470,2409,61,0,464,0,6
82303,1,2427,2518,-91,0,426,0,6
82304,1,2438,2331,107,0,122,0,6
82305,2,2432,2413,19,0,484,0,6
82306,1,2532,2287,245,0,49,0,6
82307,1,2547,2609,-62,0,130,0,6
82308,1,2292,2402,-110,0,310,0,6
82309,1,2450,2310,140,0,1,1,6
82310,2,2539,2405,134,0,178,0,6
82311,2,2399,2410,-11,0,463,0,6
82312,2,2405,2419,-14,0,59,0,6
82313,3,2416,2363,53,0,2,0,6
82314,2,2561,2615,-54,0,7,0,6
82315,2,2420,2601,-181,0,150,0,6
82316,2,2486,2323,163,0,52,0,6
82317,1,2479,2396,83,0,48,0,6
82318,1,2486,2501,-15,0,104,0,6
82319,2,2527,2512,15,0,80,0,6
82320,1,2480,2415,65,0,241,0,6
82321,1,2482,2400,82,0,4,0,6
82323,1,2425,2388,37,0,241,0,6
82324,3,2649,2463,186,0,292,0,6
82325,2,2585,2554,31,0,107,1,6
82326,2,2470,2332,138,0,45,0,6
82327,1,2451,2339,112,0,128,0,6
82328,2,2326,2431,-105,0,130,0,6
82329,1,2423,2316,107,0,8,0,6
82330,1,2541,2470,71,0,405,0,6
82331,2,2649,2464,185,0,106,0,6
82333,2,2643,2570,73,0,10,0,6
82334,1,2614,2616,-2,0,108,1,6
82335,1,2524,2426,98,0,46,0,6
82336,3,2419,2486,-67,0,265,0,6
82337,3,2468,2525,-57,0,202,0,6
82338,2,2490,2434,56,0,268,0,6
82339,2,2442,2393,49,0,159,0,6
82340,1,2606,2628,-22,0,300,0,6
82341,2,2620,2605,15,0,156,0,6
82342,1,2417,2402,15,0,243,0,6
82343,1,2344,2406,-62,0,400,0,6
82344,2,2322,2402,-80,0,110,0,6
82345,1,2330,2403,-73,0,0,0,6
82346,2,2308,2404,-96,0,1,0,6
82347,1,2406,2400,6,0,108,0,6
82348,3,2435,2322,113,0,302,0,6
82349,1,2510,2556,-46,0,110,0,6
82350,2,2361,2438,-77,0,153,0,6
82351,2,2577,2636,-59,0,0,0,6
82352,1,2537,2359,178,0,110,0,6
82353,2,2501,2400,101,0,121,1,6
82354,1,2289,2421,-132,0,123,0,6
82355,2,2364,2436,-72,0,40,0,6
82356,1,2558,2472,86,0,483,1,6
82357,3,2404,2543,-139,0,131,0,6
82358,1,2483,2456,27,0,46,0,6
82359,2,2582,2556,26,0,103,0,6
82360,1,2462,2354,108,0,45,0,6
82361,1,2608,2674,-66,0,150,0,6
82362,2,2331,2477,-146,0,100,0,6
82363,2,2294,2422,-128,0,40,0,6
82364,1,2414,2492,-78,0,80,0,6
82365,1,2495,2528,-33,0,15,0,6
82366,1,2492,2444,48,0,127,0,6
82367,1,2396,2422,-26,0,272,0,6
82368,2,2465,2546,-81,0,15,0,6
82369,1,2427,2408,19,0,300,1,6
82370,2,2391,2468,-77,0,255,1,6
82371,1,2425,2250,175,0,200,0,6
82372,1,2386,2475,-89,0,250,1,6
82373,1,2485,2559,-74,0,4,1,6
82374,2,2466,2420,46,0,483,0,6
82375,1,2641,2572,69,0,41,1,6
82376,1,2340,2442,-102,0,140,1,6
82377,1,2612,2578,34,0,57,1,6
82378,1,2417,2602,-185,0,4,1,6
82379,1,2444,2443,1,0,4,0,6
82380,1,2229,2400,-171,0,317,0,6
82381,1,2622,2612,10,0,202,0,6
82382,1,2413,2531,-118,0,79,0,6
82383,2,2445,2411,34,0,352,0,6
82384,1,2462,2304,158,0,40,0,6
82385,1,2484,2497,-13,0,8,0,6
82386,1,2422,2513,-91,0,331,0,6
82387,1,2525,2560,-35,0,46,0,6
82388,1,2524,2469,55,0,215,1,6
82389,1,2466,2393,73,0,42,0,6
82390,2,2210,2413,-203,4,125,0,13
82391,2,2427,2466,-39,0,140,0,6
82392,2,2562,2561,1,0,457,1,6
82393,1,2611,2459,152,0,246,1,6
82394,2,2440,2360,80,0,112,0,6
82395,2,2403,2461,-58,0,100,0,6
82396,2,2418,2368,50,0,102,0,6
82397,3,2307,2406,-99,0,46,0,6
82398,1,2465,2317,148,0,382,0,6
82399,3,2400,2361,39,0,312,0,6
82400,1,2335,2420,-85,0,81,0,6
82401,2,2428,2550,-122,0,113,0,6
82402,2,2362,2432,-70,0,67,0,6
82403,1,2437,2389,48,0,106,0,6
82404,2,2607,2627,-20,0,300,1,6
82405,1,2452,2309,143,0,454,0,6
82406,2,2289,2438,-149,0,490,0,6
82407,1,2485,2516,-31,0,2,0,6
82408,1,2512,2421,91,0,302,0,6
82409,2,2233,2424,-191,0,81,0,6
82410,1,2481,2328,153,0,323,1,6
82411,2,2311,2603,-292,0,1,0,6
82412,1,2403,2432,-29,0,331,0,6
82413,1,2465,2399,66,0,39,0,6
82414,1,2579,2562,17,0,459,1,6
82415,1,2330,2455,-125,0,405,0,6
82416,2,2614,2667,-53,0,190,1,6
82417,1,2407,2466,-59,0,40,1,6
82418,2,2471,2387,84,0,115,0,6
82419,1,2416,2403,13,0,242,0,6
82420,3,2554,2551,3,0,253,0,6
82421,2,2250,2450,-200,0,140,0,6
82422,3,2489,2492,-3,0,253,0,6
82423,1,2553,2567,-14,0,10,0,6
82424,2,2491,2490,1,0,106,0,6
82425,3,2522,2620,-98,0,7,0,6
82426,1,2337,2424,-87,0,140,0,6
82427,1,2424,2314,110,0,48,0,6
82428,1,2554,2532,22,0,107,0,6
82429,1,2411,2426,-15,0,241,0,6
82430,1,2417,2388,29,0,122,1,6
82431,1,2427,2345,82,0,103,0,6
82432,1,2483,2293,190,0,453,1,6
82433,1,2325,2503,-178,0,30,1,6
82434,2,2406,2260,146,0,0,0,6
82435,1,2367,2428,-61,0,242,0,6
82436,2,2449,2456,-7,0,4,1,6
82437,1,2524,2421,103,0,178,0,6
82438,3,2397,2422,-25,0,272,0,6
82439,1,2541,2407,134,0,45,0,6
82440,2,2310,2469,-159,0,103,0,6
82441,2,2411,2327,84,0,104,0,6
82442,1,2409,2439,-30,0,41,0,6
82443,2,2585,2584,1,0,211,0,6
82444,2,2356,2426,-70,0,101,0,6
82445,2,2456,2387,69,0,101,0,6
82446,1,2405,2384,21,0,106,0,6
82447,1,2531,2346,185,0,4,1,8
82448,3,2472,2371,101,0,45,0,6
82449,1,2413,2342,71,0,5,0,6
82450,1,2417,2486,-69,0,130,0,6
82451,2,2633,2602,31,0,202,0,6
82452,1,2491,2517,-26,0,3,0,6
82453,2,2417,2358,59,0,308,0,6
82454,3,2416,2415,1,4,132,0,13
82455,1,2431,2370,61,0,112,0,6
82456,1,2594,2561,33,0,246,1,6
82457,2,2422,2495,-73,0,302,0,6
82458,1,2404,2498,-94,0,42,0,6
82459,1,2283,2401,-118,4,409,0,8
82460,1,2437,2261,176,0,45,0,6
82461,2,2441,2459,-18,0,40,0,6
82462,2,2369,2477,-108,0,30,1,6
82463,1,2523,2504,19,0,8,0,6
82464,2,2557,2388,169,0,311,1,6
82465,2,2423,2333,90,0,13,0,8
82466,1,2672,2492,180,0,15,0,6
82467,1,2324,2484,-160,0,40,1,6
82468,1,2715,2609,106,0,188,0,6
82469,2,2439,2489,-50,0,272,0,6
82470,3,2415,2345,70,0,16,0,6
82471,2,2512,2430,82,0,351,0,6
82472,2,2291,2486,-195,0,143,1,6
82473,2,2561,2559,2,0,1,1,6
82474,3,2499,2529,-30,0,110,0,6
82475,2,2490,2411,79,0,2,0,6
82476,1,2411,2394,17,0,466,0,6
82477,2,2347,2422,-75,0,352,0,6
82478,1,2556,2545,11,0,440,0,6
82479,3,2585,2470,115,0,5,0,6
82480,3,2420,2358,62,0,106,0,6
82481,1,2494,2333,161,0,311,0,6
82482,2,2307,2405,-98,0,194,0,6
82483,1,2378,2410,-32,0,315,0,6
82484,2,2489,2501,-12,0,7,0,6
82485,1,2590,2580,10,0,335,0,6
82486,2,2383,2435,-52,0,302,0,6
82487,1,2362,2400,-38,4,200,1,13
82488,1,2465,2326,139,0,8,0,6
82489,1,2437,2417,20,0,245,0,6
82490,1,2605,2620,-15,0,250,0,6
82491,3,2436,2599,-163,0,41,0,6
82492,1,2426,2258,168,0,57,0,6
82493,2,2362,2554,-192,0,21,0,6
82494,2,2282,2455,-173,0,432,0,6
82495,2,2341,2430,-89,0,156,0,6
82496,1,2479,2436,43,0,101,0,6
82497,2,2322,2461,-139,0,41,0,6
82498,1,2429,2368,61,0,311,0,6
82499,2,2337,2417,-80,0,54,0,6
82500,3,2500,2502,-2,0,5,0,6
82501,2,2453,2347,106,0,426,1,6
82502,2,2293,2430,-137,0,153,0,6
82503,1,2403,2387,16,0,110,0,6
82504,2,2400,2411,-11,0,117,1,6
82505,1,2634,2429,205,0,4,0,6
82506,1,2539,2320,219,0,205,1,6
82507,1,2409,2433,-24,0,272,0,6
82508,2,2418,2484,-66,0,130,0,6
82509,3,2421,2365,56,0,474,0,6
82510,2,2557,2549,8,0,150,0,6
82511,1,2403,2429,-26,0,222,0,6
82512,1,2488,2302,186,0,453,0,6
82513,2,2417,2528,-111,0,70,0,6
82514,1,2730,2719,11,0,453,0,6
82515,2,2363,2414,-51,0,147,0,6
82516,2,2476,2333,143,0,302,1,6
82517,2,2397,2435,-38,0,483,0,6
82518,3,2336,2416,-80,0,190,0,6
82519,1,2354,2404,-50,0,344,1,6
82520,2,2540,2562,-22,0,405,0,6
82521,1,2583,2520,63,0,374,0,6
82522,2,2472,2313,159,0,45,0,6
82523,1,2446,2499,-53,0,228,0,6
82524,1,2404,2385,19,0,106,0,6
82525,2,2505,2348,157,0,300,0,6
82526,2,2412,2442,-30,0,270,0,6
82527,2,2565,2556,9,0,100,0,6
82528,1,2528,2553,-25,0,4,0,6
82529,3,2229,2488,-259,4,404,0,13
82530,2,2465,2361,104,0,310,0,6
82531,1,2458,2279,179,0,203,0,6
82532,2,2336,2457,-121,0,288,1,6
82533,2,2443,2424,19,0,200,0,6
82534,1,2447,2334,113,0,123,0,6
82535,2,2614,2611,3,0,107,0,6
82536,2,2453,2469,-16,0,40,0,6
82537,1,2484,2441,43,0,5,0,6
82538,2,2474,2438,36,0,10,1,6
82539,2,2436,2596,-160,0,41,0,6
82540,1,2488,2315,173,0,255,0,6
82542,1,2244,2415,-171,0,300,0,8
82543,2,2440,2484,-44,0,2,0,6
82545,2,2320,2407,-87,0,44,0,6
82546,1,2440,2392,48,0,207,1,6
82547,3,2405,2388,17,0,127,0,6
82548,1,2351,2467,-116,0,210,0,6
82549,1,2437,2312,125,0,253,0,6
82550,1,2388,2430,-42,0,200,1,6
82551,2,2283,2419,-136,0,10,0,6
82552,2,2532,2413,119,0,178,1,6
82553,2,2484,2555,-71,0,120,0,6
82554,1,2318,2451,-133,0,211,0,6
82555,2,2481,2489,-8,0,43,0,6
82556,2,2256,2419,-163,0,45,0,6
82557,1,2499,2500,-1,0,484,0,6
82558,2,2426,2415,11,0,140,0,6
82559,1,2419,2300,119,0,378,0,6
82560,2,2415,2261,154,0,120,1,6
82561,3,2534,2464,70,0,54,0,6
82562,2,2434,2443,-9,0,112,1,6
82563,3,2713,2741,-28,0,111,0,6
82564,3,2488,2414,74,0,3,0,6
82565,1,2417,2310,107,0,4,0,6
82566,2,2461,2541,-80,0,46,1,6
82567,1,2523,2489,34,0,300,0,6
82568,1,2491,2559,-68,0,343,1,6
82569,1,2436,2402,34,0,70,0,6
82570,2,2433,2535,-102,0,302,0,6
82571,2,2324,2419,-95,0,13,0,6
82572,1,2390,2458,-68,0,41,0,6
82573,2,2420,2423,-3,0,310,0,6
82574,2,2379,2454,-75,0,404,0,6
82575,1,2423,2409,14,0,476,0,6
82576,1,2532,2559,-27,0,241,0,6
82577,1,2489,2435,54,0,101,0,6
82579,2,2445,2467,-22,0,306,0,6
82580,2,2474,2441,33,0,7,1,6
82581,2,2497,2534,-37,0,381,0,6
82582,2,2426,2637,-211,0,40,0,6
82583,2,2484,2588,-104,0,7,0,6
82584,3,2447,2342,105,0,80,0,6
82585,2,2352,2420,-68,0,338,0,6
82586,1,2608,2617,-9,0,484,0,6
82587,1,2255,2447,-192,0,46,0,6
82588,1,2424,2250,174,0,0,0,6
82589,2,2574,2563,11,0,115,1,6
82590,2,2387,2445,-58,0,483,0,6
82591,2,2559,2375,184,0,311,0,6
82592,2,2391,2404,-13,0,122,0,6
82593,2,2383,2476,-93,0,10,0,6
82594,2,2421,2395,26,0,110,1,6
82595,2,2342,2422,-80,0,10,0,6
82596,2,2495,2454,41,0,385,1,6
82597,3,2464,2377,87,0,110,0,6
82598,3,2421,2524,-103,0,78,0,6
82599,2,2449,2494,-45,0,301,0,6
82600,1,2465,2388,77,0,45,0,6
82601,2,2431,2494,-63,0,130,0,6
82602,1,2505,2551,-46,0,15,1,6
82603,1,2346,2428,-82,0,290,0,8
82604,2,2421,2338,83,0,39,0,6
82605,3,2415,2487,-72,0,4,0,6
82606,1,2397,2483,-86,0,40,0,6
82607,2,2546,2457,89,0,205,0,6
82608,1,2437,2272,165,0,140,0,6
82609,1,2428,2339,89,0,378,0,6
82610,1,2595,2539,56,0,11,0,6
82611,1,2544,2498,46,0,58,0,6
82612,1,2423,2493,-70,0,398,0,6
82613,1,2459,2382,77,0,303,0,6
82614,3,2553,2538,15,0,0,0,6
82615,2,2473,2485,-12,0,45,1,6
82616,2,2264,2414,-150,0,302,1,6
82617,1,2446,2520,-74,0,80,1,6
82618,2,2560,2438,122,0,474,0,6
82620,2,2592,2429,163,0,7,1,6
82621,2,2410,2476,-66,0,101,0,6
82622,2,2406,2347,59,0,245,0,8
82623,2,2472,2468,4,0,127,0,6
82624,2,2378,2463,-85,0,64,0,6
82625,3,2448,2322,126,0,15,0,6
82626,2,2493,2555,-62,0,343,0,6
82627,3,2345,2400,-55,0,110,0,6
82628,1,2291,2461,-170,0,200,0,6
82629,2,2469,2529,-60,0,40,1,6
82630,2,2253,2404,-151,0,106,0,6
82631,2,2428,2492,-64,0,75,0,6
82633,1,2480,2374,106,0,301,1,6
82634,1,2569,2568,1,0,14,0,6
82635,1,2464,2539,-75,0,340,1,6
82636,1,2796,2617,179,0,218,0,6
82637,1,2438,2300,138,4,190,0,13
82638,2,2384,2415,-31,0,4,0,6
82639,1,2461,2550,-89,0,13,0,6
82640,2,2489,2538,-49,0,253,1,6
82641,1,2540,2447,93,0,49,0,6
82642,2,2565,2489,76,0,58,0,6
82643,1,2534,2486,48,0,4,0,6
82644,2,2345,2414,-69,0,102,0,6
82645,1,2373,2450,-77,0,310,0,6
82646,2,2446,2553,-107,0,10,0,6
82647,2,2454,2344,110,0,307,0,6
82648,1,2383,2420,-37,0,194,0,6
82649,2,2433,2379,54,0,411,0,6
82650,2,2361,2408,-47,0,300,1,6
82651,1,2366,2467,-101,0,61,0,6
82652,1,2382,2427,-45,0,107,0,6
82653,1,2331,2401,-70,0,300,0,6
82654,2,2270,2447,-177,0,133,0,6
82655,2,2401,2418,-17,0,111,1,6
82656,2,2368,2486,-118,0,148,0,6
82657,2,2374,2453,-79,0,46,0,6
82658,1,2523,2422,101,0,177,0,6
82659,2,2253,2525,-272,0,140,1,6
82660,2,2531,2513,18,0,160,1,6
82661,2,2426,2427,-1,0,0,0,6
82663,1,2474,2481,-7,0,4,0,6
82664,1,2547,2437,110,0,43,0,6
82665,1,2536,2533,3,0,404,0,6
82666,2,2551,2371,180,0,43,1,6
82667,1,2562,2575,-13,0,113,0,6
82668,2,2457,2370,87,0,300,0,6
82669,3,2399,2465,-66,0,15,0,6
82670,1,2534,2426,108,0,300,1,6
82671,2,2437,2260,177,0,15,0,6
82672,1,2421,2338,83,0,118,0,8
82673,2,2381,2401,-20,0,339,1,6
82674,3,2513,2501,12,0,404,0,6
82675,1,2467,2366,101,0,258,0,6
82676,2,2413,2448,-35,0,132,0,6
82677,1,2532,2537,-5,0,110,1,6
82678,1,2403,2342,61,0,352,0,6
82679,1,2381,2471,-90,0,200,0,6
82680,2,2331,2409,-78,0,46,1,6
82681,1,2546,2443,103,0,315,1,6
82682,1,2496,2424,72,0,40,0,6
82683,2,2496,2551,-55,0,344,0,6
82684,1,2493,2359,134,0,123,0,6
82685,1,2420,2380,40,0,300,0,6
82686,1,2269,2468,-199,0,43,0,6
82687,1,2551,2450,101,0,400,1,6
82688,1,2621,2799,-178,0,352,0,6
82689,1,2579,2468,111,0,1,0,6
82690,1,2333,2425,-92,0,335,0,8
82691,1,2557,2442,115,0,1,0,6
82692,1,2543,2541,2,0,40,0,6
82693,1,2484,2346,138,0,203,1,6
82694,2,2351,2538,-187,0,46,1,6
82695,2,2460,2454,6,0,132,1,6
82696,1,2414,2262,152,0,200,0,6
82697,3,2580,2577,3,0,120,0,6
82698,2,2249,2400,-151,0,255,0,8
82699,1,2577,2397,180,0,311,0,6
82700,1,2408,2369,39,0,15,0,6
82701,1,2421,2269,152,0,210,0,6
82702,1,2475,2480,-5,0,3,1,6
82703,1,2407,2513,-106,0,103,0,6
82704,1,2388,2451,-63,0,130,1,6
82705,2,2478,2561,-83,0,101,1,6
82706,1,2600,2580,20,0,176,0,6
82707,3,2443,2404,39,0,315,0,6
82708,1,2560,2491,69,0,59,0,6
82709,3,2418,2527,-109,0,405,0,6
82710,2,2322,2480,-158,0,48,0,6
82711,1,2539,2568,-29,0,311,1,6
82712,2,2433,2538,-105,0,40,0,6
82713,2,2278,2422,-144,0,302,0,6
82714,3,2375,2425,-50,0,326,0,6
82715,1,2336,2404,-68,0,123,0,6
82716,2,2429,2340,89,0,46,0,6
82717,1,2423,2542,-119,0,80,1,6
82718,1,2433,2408,25,0,312,0,6
82719,1,2414,2337,77,0,126,0,6
82720,1,2275,2432,-157,0,302,0,6
82721,1,2350,2401,-51,0,301,1,6
82722,1,2439,2358,81,0,60,0,6
82723,2,2427,2338,89,0,15,0,6
82724,2,2347,2400,-53,0,111,0,6
82725,2,2308,2400,-92,0,111,0,6
82726,2,2349,2496,-147,0,337,0,6
82727,2,2419,2340,79,0,453,0,6
82728,2,2536,2462,74,0,302,0,6
82729,1,2414,2259,155,0,82,1,6
82730,2,2321,2411,-90,0,245,0,8
82731,2,2303,2446,-143,0,46,1,6
82732,1,2396,2441,-45,0,207,0,6
82733,1,2418,2254,164,0,130,0,6
82734,2,2434,2358,76,0,244,0,6
82735,1,2494,2338,156,0,211,0,6
82736,2,2541,2555,-14,0,250,0,6
82737,1,2460,2454,6,0,106,0,6
82738,1,2407,2348,59,0,110,0,6
82739,2,2382,2490,-108,0,305,0,6
82740,1,2542,2429,113,0,44,0,6
82741,2,2333,2464,-131,0,140,1,6
82742,2,2605,2493,112,0,201,1,6
82743,1,2483,2506,-23,0,80,1,6
82744,2,2486,2569,-83,0,347,0,6
82745,2,2474,2481,-7,0,0,1,6
82746,2,2528,2605,-77,0,101,0,6
82747,1,2418,2341,77,0,345,0,8
82748,1,2444,2383,61,0,1,0,6
82749,2,2404,2419,-15,0,7,0,6
82750,2,2364,2443,-79,0,40,0,6
82751,3,2528,2565,-37,0,106,0,6
82752,1,2424,2419,5,0,113,0,6
82753,1,2459,2344,115,0,302,0,6
82754,2,2332,2426,-94,0,6,0,6
82755,1,2377,2481,-104,0,106,0,6
82756,1,2424,2443,-19,0,131,0,6
82757,2,2414,2403,11,0,200,0,6
82758,1,2343,2501,-158,0,394,0,6
82759,1,2562,2546,16,0,132,0,6
82760,1,2548,2469,79,0,347,0,6
82761,1,2425,2376,49,0,201,0,6
82762,1,2529,2427,102,0,200,0,6
82764,2,2316,2418,-102,0,331,0,6
82765,1,2343,2471,-128,0,0,0,6
82767,2,2500,2346,154,0,124,0,6
82768,2,2420,2426,-6,0,9,0,6
82769,2,2499,2510,-11,0,205,1,6
82770,1,2273,2431,-158,0,302,1,6
82771,1,2578,2482,96,0,308,0,6
82772,1,2415,2316,99,0,120,1,8
82773,2,2345,2500,-155,0,301,0,6
82774,1,2474,2449,25,0,110,1,6
82775,2,2450,2350,100,0,45,1,6
82776,1,2365,2535,-170,0,107,1,6
82777,1,2409,2463,-54,0,335,1,6
82778,1,2424,2289,135,0,110,1,6
82779,2,2546,2392,154,0,46,0,6
82780,1,2298,2415,-117,0,106,0,6
82781,2,2287,2408,-121,0,335,0,6
82782,1,2487,2468,19,0,1,1,6
82783,1,2460,2473,-13,0,205,0,6
82784,1,2610,2433,177,0,453,0,6
82785,1,2379,2401,-22,0,112,0,6
82786,2,2524,2569,-45,0,115,0,6
82787,1,2253,2423,-170,0,4,0,6
82788,1,2378,2501,-123,0,107,1,6
82789,2,2371,2430,-59,0,320,1,6
82790,2,2395,2422,-27,0,301,0,6
82791,2,2425,2533,-108,0,40,0,6
82792,2,2564,2528,36,0,426,0,6
82793,1,2520,2500,20,0,4,1,6
82794,1,2456,2400,56,0,13,0,6
82795,2,2560,2489,71,0,411,0,6
82796,2,2470,2329,141,0,302,1,6
82797,2,2399,2455,-56,0,7,1,6
82798,2,2352,2521,-169,0,200,0,6
82799,1,2494,2387,107,0,133,0,6
82800,2,2405,2447,-42,0,40,1,6
82801,1,2525,2420,105,0,178,0,6
82802,2,2409,2482,-73,4,123,0,23
82803,2,2465,2553,-88,0,302,0,6
82804,2,2430,2414,16,0,50,0,6
82805,2,2478,2585,-107,0,30,0,6
82806,1,2315,2405,-90,0,194,0,8
82807,2,2567,2416,151,0,46,0,6
82808,1,2359,2463,-104,0,40,0,6
82809,2,2400,2538,-138,0,200,0,6
82810,1,2434,2351,83,0,6,0,6
82811,1,2691,2497,194,0,330,0,6
82812,1,2568,2525,43,0,145,0,6
82813,2,2297,2455,-158,0,1,0,6
82814,1,2527,2442,85,0,311,1,6
82815,1,2503,2345,158,0,20,1,6
82816,1,2432,2270,162,0,241,0,6
82817,2,2430,2613,-183,0,121,1,6
82818,2,2484,2519,-35,0,88,0,6
82819,2,2400,2304,96,0,108,0,8
82820,1,2422,2337,85,0,40,0,6
82821,1,2437,2449,-12,0,125,0,6
82822,1,2286,2530,-244,0,121,0,6
82823,2,2527,2500,27,0,101,1,6
82824,1,2412,2442,-30,0,242,0,6
82825,1,2229,2407,-178,0,7,0,6
82826,1,2430,2298,132,0,41,0,6
82827,1,2442,2466,-24,0,101,0,6
82828,2,2540,2574,-34,0,115,1,6
82829,1,2457,2358,99,0,303,0,6
82830,2,2524,2403,121,0,487,0,6
82831,1,2285,2423,-138,0,288,0,8
82832,1,2535,2558,-23,0,81,0,6
82833,1,2409,2293,116,4,153,0,13
82834,1,2419,2498,-79,0,409,0,6
82835,2,2463,2573,-110,0,354,1,6
82836,2,2436,2260,176,0,45,0,6
82837,2,2306,2401,-95,0,202,0,6
82838,2,2312,2478,-166,0,203,0,6
82839,2,2424,2537,-113,0,40,0,6
82840,2,2313,2427,-114,0,110,1,6
82841,2,2232,2481,-249,4,337,0,13
82843,1,2400,2201,199,0,120,0,6
82844,2,2456,2434,22,0,101,1,6
82845,2,2386,2418,-32,0,254,0,6
82846,2,2416,2529,-113,0,315,0,6
82847,1,2433,2357,76,0,373,1,6
82848,2,2353,2452,-99,0,10,0,6
82849,1,2542,2421,121,0,49,0,6
82850,1,2557,2461,96,0,12,1,6
82851,3,2563,2616,-53,0,132,0,6
82852,1,2312,2419,-107,0,245,0,8
82853,1,2518,2530,-12,0,106,0,6
82854,2,2424,2346,78,0,335,0,6
82855,1,2494,2558,-64,0,404,0,6
82856,2,2479,2482,-3,0,457,0,6
82857,2,2378,2400,-22,0,45,1,6
82858,1,2503,2393,110,0,44,0,8
82859,1,2524,2379,145,0,202,0,6
82860,1,2400,2282,118,0,27,0,6
82861,1,2401,2379,22,0,255,0,6
82862,1,2507,2414,93,0,337,1,6
82863,1,2404,2224,180,0,302,0,6
82864,1,2411,2517,-106,0,206,0,6
82865,1,2438,2543,-105,0,330,0,6
82866,1,2373,2406,-33,0,112,0,6
82867,1,2337,2406,-69,0,45,0,6
82868,2,2518,2386,132,0,300,0,6
82869,1,2420,2338,82,0,330,0,6
82870,1,2541,2460,81,0,307,0,6
82871,1,2577,2459,118,0,127,1,6
82872,1,2415,2521,-106,0,46,0,6
82873,1,2494,2693,-199,0,341,0,6
82874,1,2482,2448,34,0,128,0,6
82875,1,2436,2426,10,0,247,0,6
82876,1,2552,2541,11,0,0,0,6
82877,2,2283,2601,-318,4,285,0,8
82878,1,2462,2422,40,0,48,1,6
82879,1,2408,2340,68,0,302,0,6
82880,1,2380,2618,-238,0,128,0,6
82881,2,2427,2528,-101,0,241,0,6
82882,1,2431,2450,-19,0,40,0,6
82883,1,2441,2417,24,0,201,0,6
82884,1,2418,2353,65,0,300,0,6
82885,1,2419,2255,164,0,152,0,6
82886,1,2491,2272,219,0,210,0,6
82887,1,2364,2401,-37,0,218,0,6
82888,1,2461,2438,23,0,40,0,6
82889,1,2263,2434,-171,0,4,0,6
82890,2,2215,2413,-198,4,150,0,13
82891,1,2449,2318,131,0,84,0,6
82892,2,2209,2406,-197,0,8,0,6
82893,1,2533,2412,121,0,178,0,6
82894,1,2367,2424,-57,0,46,0,6
82895,1,2531,2381,150,0,464,1,6
82896,1,2438,2278,160,0,132,0,6
82897,2,2348,2427,-79,0,0,0,6
82898,1,2514,2354,160,0,110,0,6
82899,2,2550,2535,15,0,403,0,6
82900,1,2345,2473,-128,0,34,1,6
82901,1,2560,2479,81,0,123,0,6
82902,2,2319,2423,-104,0,148,0,6
82903,1,2415,2276,139,0,331,0,8
82904,2,2579,2566,13,0,15,0,6
82905,2,2441,2501,-60,0,105,0,6
82906,2,2410,2462,-52,0,140,0,6
82907,1,2342,2442,-100,4,140,0,13
82908,2,2467,2600,-133,0,120,0,6
82909,2,2343,2455,-112,0,40,0,6
82910,2,2541,2490,51,0,44,0,6
82911,2,2443,2487,-44,0,121,0,6
82912,1,2447,2306,141,0,140,0,6
82913,1,2445,2406,39,0,366,1,6
82914,3,2278,2422,-144,0,101,0,6
82915,1,2292,2425,-133,0,1,1,6
82916,1,2416,2310,106,0,36,0,6
82917,1,2503,2342,161,0,1,0,6
82918,1,2411,2289,122,0,414,0,6
82919,1,2467,2405,62,0,242,0,6
82920,1,2456,2446,10,0,101,0,6
82921,2,2355,2416,-61,4,152,0,13
82922,1,2474,2464,10,0,474,0,6
82923,2,2339,2441,-102,0,106,1,6
82924,2,2241,2411,-170,0,460,0,6
82925,2,2427,2366,61,0,302,1,6
82926,2,2563,2593,-30,0,13,0,6
82927,1,2415,2273,142,0,0,0,6
82928,2,2405,2543,-138,0,427,1,6
82929,1,2423,2274,149,0,45,0,6
82930,2,2609,2541,68,0,124,0,6
82931,2,2389,2444,-55,0,106,0,6
82932,1,2405,2433,-28,0,48,0,6
82933,1,2453,2349,104,0,101,1,6
82934,2,2506,2380,126,0,31,1,6
82935,1,2270,2494,-224,0,124,0,6
82936,2,2348,2461,-113,0,409,0,6
82937,3,2421,2488,-67,0,41,0,6
82938,1,2319,2415,-96,0,108,0,6
82939,1,2308,2400,-92,0,200,0,8
82940,2,2517,2480,37,0,142,0,6
82941,2,2458,2467,-9,0,107,1,6
82942,1,2440,2534,-94,0,130,1,6
82943,1,2393,2461,-68,0,302,0,6
82944,1,2230,2523,-293,0,122,0,6
82945,2,2408,2537,-129,0,79,0,6
82946,2,2620,2453,167,0,375,0,6
82947,2,2339,2509,-170,0,128,0,6
82948,2,2434,2437,-3,0,49,0,6
82949,2,2278,2402,-124,0,57,0,6
82950,2,2241,2514,-273,0,46,1,6
82951,2,2419,2326,93,0,41,1,8
82952,2,2492,2438,54,0,128,1,6
82953,1,2496,2534,-38,0,132,0,6
82954,1,2423,2470,-47,0,122,1,6
82955,2,2533,2359,174,0,45,0,6
82956,1,2459,2349,110,0,100,0,6
82957,3,2464,2494,-30,0,315,0,6
82958,2,2351,2503,-152,0,233,1,6
82959,1,2470,2332,138,0,125,0,6
82960,1,2466,2459,7,0,325,0,6
82961,1,2472,2528,-56,0,132,0,6
82962,1,2373,2463,-90,0,10,1,6
82963,1,2401,2450,-49,0,233,0,6
82964,1,2536,2515,21,0,45,1,6
82965,1,2467,2417,50,0,122,0,6
82966,2,2345,2408,-63,0,4,0,6
82967,2,2445,2340,105,0,302,0,6
82968,1,2425,2349,76,0,469,0,6
82969,2,2271,2420,-149,0,80,0,6
82970,2,2297,2427,-130,0,316,1,6
82971,1,2326,2420,-94,0,102,1,6
82972,2,2400,2472,-72,0,143,1,6
82973,2,2646,2675,-29,0,295,1,6
82974,1,2418,2450,-32,0,192,0,6
82975,1,2454,2318,136,0,107,0,6
82976,1,2265,2403,-138,0,426,0,6
82977,1,2547,2456,91,0,330,0,6
82978,1,2515,2375,140,0,45,0,6
82979,2,2427,2338,89,0,335,0,6
82980,2,2373,2427,-54,0,207,0,6
82981,1,2498,2444,54,0,31,0,6
82982,1,2602,2384,218,0,227,0,6
82983,2,2412,2354,58,0,59,1,6
82984,1,2428,2345,83,0,49,0,6
82985,2,2457,2511,-54,0,227,0,6
82986,2,2442,2333,109,0,470,0,6
82987,1,2484,2221,263,4,404,0,13
82988,1,2463,2379,84,0,13,1,6
82989,1,2404,2372,32,0,200,0,6
82990,1,2548,2573,-25,0,115,0,6
82991,2,2397,2488,-91,0,143,0,6
82992,1,2332,2464,-132,0,211,0,6
82993,1,2611,2430,181,0,11,0,6
82994,1,2340,2448,-108,0,320,0,6
82995,1,2406,2315,91,0,303,0,6
82996,1,2364,2420,-56,0,300,0,6
82997,1,2541,2404,137,0,178,0,6
82998,1,2464,2430,34,0,0,0,6
82999,2,2472,2522,-50,0,47,0,6
83000,3,2353,2444,-91,0,300,0,6
83001,2,2423,2263,160,0,335,1,6
83002,2,2345,2430,-85,0,202,0,6
83003,1,2516,2216,300,0,411,1,6
83004,1,2485,2479,6,0,49,0,6
83005,1,2552,2525,27,0,103,0,6
83006,1,2437,2411,26,0,302,0,6
83007,1,2496,2397,99,0,353,0,6
83008,2,2413,2373,40,0,381,0,6
83009,1,2372,2462,-90,0,43,1,6
83010,2,2372,2453,-81,0,9,0,6
83011,1,2444,2353,91,0,127,0,6
83012,2,2231,2416,-185,4,4,0,13
83013,1,2516,2439,77,0,195,0,6
83014,2,2485,2279,206,0,210,0,6
83015,1,2456,2419,37,0,331,1,6
83016,1,2367,2461,-94,0,5,1,6
83017,1,2471,2307,164,0,84,0,6
83018,2,2451,2279,172,0,10,1,6
83019,2,2413,2334,79,0,120,0,6
83020,1,2476,2458,18,0,101,0,6
83021,2,2486,2422,64,0,202,0,6
83022,1,2452,2641,-189,0,483,0,6
83023,2,2401,2544,-143,0,79,0,6
83024,1,2347,2442,-95,0,300,0,6
83025,2,2349,2411,-62,0,220,1,8
83026,1,2554,2605,-51,0,245,0,6
83027,1,2401,2269,132,0,110,0,6
83028,1,2451,2294,157,0,112,0,6
83029,3,2410,2414,-4,0,130,0,6
83031,1,2373,2407,-34,0,50,0,6
83032,2,2268,2474,-206,0,46,0,6
83033,1,2433,2267,166,0,48,1,6
83034,1,2384,2449,-65,0,16,0,6
83035,2,2566,2427,139,0,130,1,6
83036,2,2416,2289,127,0,485,0,8
83037,2,2309,2409,-100,0,101,0,6
83038,1,2665,2614,51,0,107,0,6
83039,2,2478,2396,82,0,300,0,6
83040,3,2527,2527,0,0,50,0,6
83041,2,2360,2435,-75,0,15,0,6
83042,1,2402,2316,86,0,163,0,6
83043,3,2413,2424,-11,0,150,0,6
83044,1,2453,2341,112,0,100,1,6
83045,2,2276,2442,-166,0,122,0,6
83046,2,2441,2482,-41,0,0,0,6
83047,1,2473,2491,-18,0,201,1,6
83048,2,2280,2454,-174,0,217,0,6
83049,2,2442,2355,87,0,400,1,6
83050,2,2469,2340,129,0,4,1,6
83051,2,2535,2474,61,0,110,0,6
83052,2,2465,2438,27,0,487,0,6
83053,1,2676,2583,93,0,49,0,6
83054,3,2487,2420,67,0,295,0,6
83055,2,2559,2567,-8,0,113,0,6
83056,1,2548,2397,151,0,178,0,6
83057,2,2609,2508,101,0,332,0,6
83058,1,2396,2410,-14,0,57,0,6
83059,1,2400,2375,25,0,40,0,6
83060,1,2670,2520,150,0,440,0,6
83061,2,2464,2435,29,0,455,1,6
83062,3,2345,2414,-69,0,112,0,6
83063,1,2356,2432,-76,0,15,0,6
83064,1,2632,2461,171,0,131,0,6
83065,3,2310,2407,-97,0,110,0,6
83066,2,2363,2438,-75,0,122,0,6
83067,2,2341,2406,-65,0,102,0,6
83068,1,2599,2440,159,0,152,1,6
83069,1,2442,2344,98,0,133,0,6
83070,1,2424,2401,23,0,206,0,6
83071,3,2260,2434,-174,0,46,0,6
83072,2,2461,2354,107,0,315,0,6
83073,2,2517,2673,-156,0,130,0,6
83074,1,2356,2436,-80,0,201,0,6
83075,1,2407,2270,137,0,343,0,8
83077,2,2678,2561,117,0,6,0,6
83078,2,2395,2471,-76,0,18,0,6
83079,1,2413,2380,33,0,200,0,6
83080,2,2345,2410,-65,0,122,0,6
83081,1,2522,2527,-5,0,301,0,6
83082,2,2393,2436,-43,0,109,0,6
83083,1,2544,2602,-58,0,40,0,6
83084,1,2377,2459,-82,0,359,0,6
83085,2,2407,2413,-6,0,107,1,6
83086,2,2407,2340,67,0,143,0,6
83087,1,2403,2596,-193,0,241,0,6
83088,2,2328,2597,-269,0,107,0,6
83089,1,2400,2264,136,0,301,0,6
83090,1,2551,2558,-7,0,44,0,6
83091,1,2415,2236,179,0,59,0,6
83092,3,2458,2342,116,0,130,0,6
83093,1,2436,2457,-21,0,307,0,6
83094,2,2375,2473,-98,0,107,0,6
83095,2,2319,2406,-87,0,155,1,6
83096,2,2414,2472,-58,0,69,0,6
83097,3,2343,2485,-142,0,190,0,6
83098,2,2481,2529,-48,0,348,1,6
83099,2,2435,2301,134,0,330,0,6
83100,1,2552,2557,-5,0,175,0,6
83101,1,2677,2513,164,0,440,0,6
83102,2,2458,2636,-178,0,49,1,6
83103,1,2441,2412,29,0,311,0,6
83104,1,2573,2596,-23,0,4,0,6
83105,1,2425,2363,62,0,302,0,6
83106,3,2387,2452,-65,0,190,0,6
83107,2,2404,2486,-82,0,191,0,6
83108,2,2568,2670,-102,0,100,1,6
83109,1,2411,2336,75,0,120,0,6
83110,1,2436,2439,-3,0,46,0,6
83111,1,2551,2558,-7,0,54,1,6
83112,1,2429,2388,41,0,463,1,6
83113,2,2348,2475,-127,0,115,0,6
83114,2,2450,2434,16,0,335,1,6
83115,2,2521,2455,66,0,44,0,6
83116,1,2405,2312,93,0,152,1,6
83117,2,2551,2394,157,0,178,0,6
83118,2,2419,2388,31,0,483,0,6
83119,2,2501,2346,155,0,45,1,6
83120,2,2400,2288,112,0,58,0,6
83121,2,2410,2461,-51,0,311,1,6
83122,1,2462,2366,96,0,426,0,6
83123,1,2587,2451,136,0,307,0,6
83124,2,2404,2443,-39,0,211,1,6
83125,2,2434,2442,-8,0,466,0,6
83126,2,2393,2418,-25,0,331,1,6
83127,1,2599,2326,273,0,102,0,6
83128,2,2457,2411,46,0,343,0,6
83129,2,2407,2369,38,0,211,0,6
83130,1,2428,2404,24,0,58,0,6
83131,1,2478,2230,248,0,244,0,6
83132,1,2422,2282,140,0,108,0,8
83133,2,2510,2680,-170,0,130,1,6
83134,2,2446,2500,-54,0,58,0,6
83135,1,2260,2400,-140,0,106,0,6
83136,1,2514,2341,173,0,45,0,6
83137,2,2435,2483,-48,0,106,1,6
83138,2,2347,2432,-85,0,61,0,6
83139,2,2476,2547,-71,0,4,0,6
83140,2,2331,2410,-79,0,193,0,6
83141,1,2477,2490,-13,0,122,0,6
83142,2,2571,2614,-43,0,278,0,6
83143,3,2462,2376,86,0,115,0,6
83144,1,2409,2421,-12,0,309,0,6
83145,2,2434,2314,120,0,204,0,6
83146,2,2591,2529,62,0,390,1,6
83147,1,2447,2401,46,0,106,0,6
83148,2,2455,2639,-184,0,469,0,6
83149,1,2622,2453,169,0,485,0,6
83150,2,2302,2479,-177,0,115,0,6
83151,1,2579,2590,-11,0,229,0,6
83152,1,2358,2430,-72,0,15,0,6
83153,1,2675,2564,111,0,132,0,6
83154,1,2456,2376,80,0,106,0,6
83155,2,2426,2433,-7,0,1,0,6
83156,2,2332,2416,-84,0,102,0,6
83157,1,2558,2501,57,0,13,0,6
83158,2,2419,2358,61,4,107,0,13
83160,1,2552,2557,-5,0,175,0,6
83161,1,2422,2278,144,0,45,0,6
83162,1,2303,2408,-105,0,302,0,8
83163,1,2390,2412,-22,0,45,0,6
83164,3,2517,2377,140,0,300,0,6
83165,2,2448,2397,51,0,60,1,6
83166,2,2383,2484,-101,0,130,0,6
83167,1,2472,2362,110,0,43,0,6
83168,1,2450,2626,-176,0,120,0,6
83169,1,2584,2585,-1,0,111,0,6
83170,2,2371,2448,-77,0,127,0,6
83171,1,2418,2450,-32,0,201,0,6
83172,2,2444,2492,-48,0,300,0,6
83173,1,2446,2442,4,0,10,0,6
83174,2,2226,2434,-208,4,409,0,13
83175,1,2388,2509,-121,0,140,0,6
83176,2,2507,2354,153,0,135,1,6
83177,2,2415,2317,98,0,302,1,6
83178,1,2496,2563,-67,0,101,0,6
83179,1,2421,2424,-3,4,113,1,13
83180,1,2337,2461,-124,0,4,0,6
83181,2,2680,2608,72,0,300,0,6
83182,2,2430,2415,15,0,130,0,6
83183,1,2430,2553,-123,0,229,0,6
83184,2,2423,2365,58,0,43,0,6
83185,2,2484,2452,32,0,101,0,6
83186,1,2323,2482,-159,0,140,0,6
83187,1,2383,2460,-77,0,218,0,6
83188,1,2549,2452,97,0,40,1,6
83189,1,2402,2543,-141,0,152,0,6
83190,1,2406,2299,107,0,448,0,6
83191,1,2345,2527,-182,0,302,0,6
83192,3,2436,2423,13,0,331,0,6
83193,2,2560,2584,-24,0,241,0,6
83194,2,2420,2452,-32,0,1,0,6
83195,2,2536,2544,-8,0,101,0,6
83196,1,2453,2439,14,0,115,0,6
83197,1,2445,2434,11,0,102,0,6
83198,1,2306,2454,-148,0,390,0,8
83199,2,2397,2507,-110,0,130,1,6
83200,2,2346,2430,-84,0,45,1,6
83202,1,2305,2426,-121,0,1,1,6
83203,2,2420,2375,45,0,107,1,6
83204,2,2327,2503,-176,0,105,0,6
83205,2,2415,2341,74,0,241,0,6
83206,1,2488,2379,109,0,140,0,6
83207,1,2558,2592,-34,0,110,1,6
83208,2,2358,2476,-118,0,306,0,6
83209,1,2327,2413,-86,0,403,0,6
83210,2,2469,2511,-42,0,28,0,6
83211,1,2662,2617,45,0,368,0,6
83212,1,2426,2389,37,0,202,0,6
83213,3,2434,2520,-86,0,385,0,6
83214,2,2519,2458,61,0,0,0,6
83215,2,2602,2605,-3,0,162,0,6
83216,1,2441,2424,17,0,302,1,6
83217,2,2353,2402,-49,0,41,1,6
83218,2,2350,2495,-145,0,22,0,6
83219,2,2479,2521,-42,0,388,0,6
83220,3,2436,2343,93,0,330,0,6
83221,2,2453,2411,42,0,49,1,6
83222,1,2590,2421,169,0,131,0,6
83223,3,2497,2424,73,0,302,0,6
83224,3,2470,2476,-6,0,30,0,6
83225,2,2375,2439,-64,0,201,1,6
83226,2,2478,2415,63,0,202,0,6
83227,1,2459,2408,51,0,101,0,6
83228,2,2453,2445,8,0,128,0,6
83229,1,2372,2417,-45,0,15,0,6
83230,2,2321,2473,-152,0,295,0,6
83231,2,2325,2413,-88,0,347,0,6
83232,1,2242,2413,-171,4,190,0,13
83233,2,2434,2556,-122,0,240,0,6
83234,1,2501,2428,73,0,411,0,6
83235,2,2436,2580,-144,0,331,0,6
83236,1,2367,2480,-113,0,142,0,6
83237,1,2449,2305,144,0,253,0,6
83238,3,2401,2291,110,0,331,0,8
83239,2,2593,2555,38,0,130,0,6
83240,1,2545,2438,107,0,7,0,6
83241,2,2418,2499,-81,0,424,0,6
83242,1,2465,2554,-89,0,102,0,6
83243,2,2295,2460,-165,0,295,1,6
83244,1,2384,2414,-30,0,45,1,6
83245,2,2261,2439,-178,0,46,0,6
83246,2,2375,2492,-117,0,133,0,6
83247,1,2413,2292,121,0,4,0,8
83248,1,2522,2612,-90,0,227,0,6
83250,1,2444,2358,86,0,108,0,6
83251,2,2334,2416,-82,0,373,0,6
83252,3,2550,2611,-61,0,460,0,6
83253,2,2324,2445,-121,0,175,0,6
83254,1,2506,2435,71,0,311,1,6
83255,2,2496,2371,125,0,463,1,6
83256,1,2596,2589,7,0,241,0,6
83257,2,2586,2564,22,0,1,0,6
83258,1,2535,2410,125,0,178,0,6
83259,2,2440,2352,88,0,40,0,6
83260,2,2331,2410,-79,0,21,0,6
83261,3,2436,2378,58,0,31,0,6
83262,2,2615,2683,-68,0,45,0,6
83263,3,2373,2435,-62,0,300,0,6
83264,1,2348,2462,-114,0,106,1,6
83265,1,2403,2370,33,0,48,0,6
83266,2,2463,2419,44,0,133,1,6
83267,1,2446,2314,132,0,10,0,8
83268,2,2505,2529,-24,0,405,1,6
83269,2,2402,2422,-20,0,10,0,6
83270,2,2471,2588,-117,0,119,1,6
83271,2,2347,2496,-149,0,314,0,6
83272,2,2472,2425,47,0,351,0,6
83273,1,2418,2294,124,0,40,0,6
83274,1,2476,2318,158,0,457,0,6
83275,1,2553,2474,79,0,311,1,6
83276,2,2451,2584,-133,0,140,0,6
83277,1,2426,2322,104,0,200,1,6
83278,2,2397,2546,-149,0,10,0,6
83279,3,2421,2392,29,0,400,0,6
83280,1,2430,2361,69,0,231,0,6
83281,3,2422,2395,27,0,414,0,6
83282,3,2392,2447,-55,0,435,0,6
83283,2,2327,2420,-93,0,101,0,6
83284,2,2410,2370,40,0,302,0,6
83285,1,2414,2472,-58,0,112,1,6
83286,3,2389,2447,-58,0,156,0,6
83287,1,2477,2431,46,0,43,0,6
83288,2,2586,2562,24,0,130,0,6
83289,1,2407,2394,13,0,227,1,6
83290,1,2464,2479,-15,0,454,0,6
83291,1,2405,2273,132,4,145,0,13
83292,2,2653,2747,-94,0,381,1,6
83293,1,2506,2392,114,0,57,0,6
83294,1,2379,2488,-109,0,132,0,6
83295,3,2407,2423,-16,0,144,0,6
83296,2,2290,2429,-139,0,1,0,6
83297,1,2688,2610,78,0,4,0,6
83298,2,2610,2580,30,0,110,0,6
83299,2,2438,2309,129,0,405,1,6
83300,2,2437,2430,7,0,151,0,6
83301,1,2424,2498,-74,0,463,0,6
83302,1,2365,2452,-87,0,1,1,6
83303,2,2584,2570,14,0,120,1,6
83304,1,2448,2329,119,0,301,0,6
83305,1,2434,2321,113,0,40,0,6
83306,2,2447,2345,102,0,40,0,6
83307,2,2258,2403,-145,0,302,0,6
83308,2,2315,2480,-165,0,295,0,6
83309,2,2466,2602,-136,0,347,0,6
83310,1,2417,2381,36,0,15,0,6
83311,1,2373,2430,-57,0,0,1,6
83312,3,2422,2320,102,0,401,0,6
83313,2,2268,2406,-138,0,141,1,6
83314,1,2429,2338,91,0,215,0,6
83315,1,2482,2447,35,0,326,0,6
83316,2,2455,2356,99,0,101,0,6
83318,3,2415,2340,75,0,373,0,6
83319,1,2339,2428,-89,0,211,0,6
83320,2,2432,2477,-45,0,106,1,6
83321,2,2602,2551,51,0,150,1,6
83322,2,2435,2420,15,0,150,1,6
83323,1,2277,2417,-140,0,200,0,8
83324,2,2424,2468,-44,0,46,1,6
83325,2,2430,2280,150,0,107,1,6
83326,1,2586,2408,178,0,301,0,6
83327,1,2604,2500,104,0,101,1,6
83328,1,2436,2456,-20,0,256,0,6
83329,1,2474,2470,4,0,255,1,6
83330,1,2470,2384,86,0,343,0,6
83331,2,2407,2539,-132,0,315,0,6
83332,3,2685,2467,218,0,470,0,6
83333,1,2545,2452,93,0,2,0,6
83334,1,2423,2343,80,0,484,0,6
83335,2,2393,2589,-196,0,110,0,6
83336,1,2292,2422,-130,0,241,1,6
83337,1,2466,2421,45,0,200,0,6
83338,1,2403,2346,57,0,45,0,6
83339,1,2345,2434,-89,0,123,0,6
83340,2,2662,2568,94,0,120,0,6
83341,2,2751,2647,104,0,277,0,6
83342,1,2432,2386,46,0,463,0,6
83343,1,2378,2413,-35,0,102,1,6
83344,2,2606,2692,-86,0,50,1,6
83345,1,2425,2415,10,0,140,1,6
83346,1,2523,2534,-11,0,43,0,6
83347,1,2448,2357,91,0,7,0,6
83348,1,2606,2462,144,0,101,0,6
83349,1,2426,2294,132,0,10,0,6
83350,1,2328,2510,-182,0,46,0,6
83351,2,2483,2516,-33,0,398,0,6
83352,1,2481,2541,-60,0,101,0,6
83353,2,2448,2348,100,0,106,1,6
83354,1,2404,2254,150,0,301,0,6
83355,1,2341,2445,-104,0,45,0,6
83356,1,2396,2404,-8,0,49,0,6
83357,2,2423,2380,43,0,122,0,6
83358,1,2477,2260,217,0,115,0,6
83359,2,2372,2440,-68,0,5,1,6
83360,2,2407,2576,-169,0,132,0,6
83361,1,2402,2274,128,0,178,0,6
83362,2,2438,2326,112,0,46,0,6
83363,3,2482,2317,165,0,211,0,6
83364,1,2543,2403,140,0,178,0,6
83365,1,2427,2450,-23,0,246,0,6
83366,2,2402,2442,-40,0,4,0,6
83367,1,2398,2407,-9,0,43,0,6
83368,2,2552,2527,25,0,241,0,6
83369,1,2578,2473,105,0,17,1,6
83370,2,2295,2446,-151,0,335,0,6
83371,1,2557,2595,-38,0,14,0,6
83372,3,2411,2443,-32,0,4,0,6
83373,1,2408,2302,106,4,101,0,13
83374,3,2550,2479,71,0,3,0,6
83375,1,2496,2592,-96,0,46,0,6
83376,2,2427,2402,25,0,44,1,6
83377,1,2431,2608,-177,0,109,0,6
83378,1,2592,2380,212,0,106,1,6
83379,2,2431,2474,-43,0,306,0,6
83380,1,2504,2339,165,0,45,1,6
83381,1,2478,2335,143,0,62,0,6
83382,1,2381,2434,-53,0,145,0,6
83383,1,2521,2431,90,0,310,0,6
83384,1,2415,2333,82,0,15,0,6
83385,2,2386,2427,-41,0,115,0,6
83386,1,2276,2422,-146,0,41,1,6
83387,2,2575,2655,-80,0,398,0,6
83388,2,2439,2471,-32,0,110,0,6
83389,1,2409,2305,104,0,241,0,6
83390,2,2489,2376,113,0,31,0,6
83391,2,2262,2534,-272,0,302,0,6
83392,1,2405,2264,141,0,310,0,6
83393,1,2407,2385,22,0,120,1,6
83394,2,2287,2409,-122,0,3,0,8
83395,1,2427,2319,108,0,10,0,6
83396,1,2278,2425,-147,0,123,0,6
83397,1,2414,2305,109,0,462,1,6
83398,1,2697,2602,95,0,305,0,6
83399,2,2529,2609,-80,0,112,0,6
83400,2,2237,2403,-166,0,3,0,6
83401,1,2441,2459,-18,0,101,0,6
83403,1,2417,2313,104,0,121,1,6
83404,2,2534,2433,101,0,242,0,6
83406,1,2446,2256,190,0,150,0,6
83407,1,2479,2388,91,0,300,0,6
83408,2,2278,2424,-146,0,200,0,6
83409,1,2380,2421,-41,0,80,0,6
83410,1,2503,2363,140,0,302,0,6
83411,2,2319,2444,-125,0,196,0,6
83412,2,2447,2406,41,0,192,1,6
83413,1,2427,2241,186,4,135,0,13
83414,1,2424,2548,-124,0,102,0,6
83415,2,2480,2589,-109,0,107,0,6
83416,1,2660,2571,89,0,345,0,6
83417,1,2484,2334,150,0,312,0,6
83418,2,2384,2484,-100,0,106,1,6
83419,1,2427,2469,-42,0,46,0,6
83420,2,2597,2701,-104,0,440,0,6
83421,1,2419,2360,59,0,6,1,6
83422,2,2426,2507,-81,0,302,0,6
83423,1,2329,2434,-105,0,310,0,6
83424,1,2399,2547,-148,0,79,1,6
83425,2,2565,2476,89,0,112,0,6
83426,1,2453,2447,6,0,40,1,6
83427,1,2408,2300,108,0,300,1,6
83428,1,2432,2281,151,0,122,0,6
83429,3,2452,2582,-130,0,55,0,6
83430,2,2375,2402,-27,0,404,1,6
83431,2,2419,2389,30,0,134,0,6
83432,2,2268,2444,-176,0,156,0,6
83433,2,2369,2595,-226,0,4,0,6
83434,1,2537,2260,277,0,101,0,6
83435,2,2345,2487,-142,0,41,0,6
83436,1,2614,2524,90,0,140,0,6
83437,2,2404,2405,-1,0,302,0,6
83438,2,2382,2507,-125,0,100,0,6
83439,1,2442,2511,-69,0,312,0,6
83440,1,2336,2422,-86,0,114,0,6
83441,2,2296,2430,-134,0,48,1,6
83442,2,2501,2418,83,0,53,0,6
83443,1,2315,2432,-117,0,0,1,6
83444,2,2385,2481,-96,0,46,0,6
83445,1,2443,2253,190,0,102,0,6
83446,1,2441,2526,-85,0,101,0,6
83447,2,2586,2344,242,0,15,1,6
83448,2,2435,2549,-114,0,409,0,6
83449,1,2428,2275,153,0,101,0,6
83450,1,2593,2237,356,0,120,1,6
83451,1,2476,2503,-27,0,216,1,6
83452,2,2407,2577,-170,0,2,0,6
83453,1,2400,2315,85,0,45,0,6
83454,2,2393,2407,-14,0,17,0,6
83455,1,2546,2533,13,0,241,0,6
83456,2,2295,2415,-120,0,150,0,6
83457,1,2448,2336,112,0,345,0,6
83458,1,2409,2271,138,0,432,0,6
83459,1,2705,2593,112,0,13,0,6
83460,1,2404,2317,87,0,0,0,6
83461,3,2559,2352,207,0,18,0,6
83462,1,2424,2307,117,0,80,1,6
83463,1,2414,2398,16,0,110,1,6
83464,1,2250,2448,-198,0,4,0,6
83465,2,2412,2504,-92,0,315,0,6
83466,1,2435,2440,-5,0,122,0,6
83467,2,2567,2664,-97,0,245,1,6
83468,1,2435,2343,92,0,190,0,6
83469,1,2470,2515,-45,0,50,1,6
83470,3,2556,2432,124,0,41,0,6
83471,1,2596,2679,-83,0,45,0,6
83472,1,2488,2380,108,0,45,0,6
83473,2,2512,2378,134,0,40,0,6
83474,2,2292,2426,-134,0,310,0,6
83475,2,2254,2481,-227,0,45,0,6
83476,2,2407,2327,80,0,485,0,6
83477,1,2483,2464,19,0,102,0,6
83478,1,2413,2222,191,0,412,0,8
83479,1,2336,2412,-76,0,44,0,6
83480,1,2587,2462,125,0,394,1,6
83481,2,2271,2431,-160,0,200,0,6
83482,1,2446,2288,158,0,202,0,6
83483,1,2430,2441,-11,0,106,0,6
83484,3,2580,2400,180,0,218,0,6
83485,1,2527,2551,-24,0,41,0,6
83486,1,2311,2404,-93,0,113,0,6
83487,2,2509,2395,114,0,302,0,6
83488,3,2352,2408,-56,0,302,0,6
83489,1,2412,2411,1,0,157,0,6
83490,2,2383,2519,-136,0,101,0,6
83491,1,2672,2603,69,0,206,0,6
83492,1,2438,2355,83,0,106,0,6
83493,1,2359,2459,-100,0,10,0,6
83494,1,2520,2528,-8,0,138,0,6
83495,1,2398,2418,-20,0,382,0,6
83496,2,2386,2458,-72,0,43,1,6
83497,1,2459,2339,120,0,153,0,6
83498,2,2332,2497,-165,0,206,0,6
83499,1,2595,2238,357,0,102,1,6
83500,2,2589,2709,-120,0,45,0,6
83501,3,2483,2341,142,0,110,0,6
83502,2,2367,2545,-178,0,36,1,6
83503,1,2405,2332,73,0,300,0,6
83504,2,2485,2471,14,0,48,0,6
83505,1,2431,2494,-63,0,120,0,6
83506,1,2503,2556,-53,0,41,0,6
83507,1,2386,2406,-20,0,201,0,6
83508,2,2412,2402,10,0,101,1,6
83509,2,2268,2449,-181,0,132,1,6
83510,2,2314,2409,-95,0,303,1,6
83511,1,2303,2428,-125,0,143,0,6
83512,2,2522,2492,30,0,106,1,6
83513,2,2534,2416,118,0,136,1,8
83514,2,2391,2488,-97,0,241,0,6
83515,1,2418,2319,99,0,190,0,6
83516,1,2298,2413,-115,4,302,0,13
83517,2,2668,2563,105,0,13,0,6
83518,2,2405,2436,-31,0,315,0,6
83519,1,2627,2572,55,0,250,1,6
83520,1,2459,2435,24,0,194,0,6
83521,2,2494,2387,107,0,300,1,6
83522,1,2348,2424,-76,0,45,0,6
83523,3,2598,2676,-78,0,335,0,6
83524,2,2424,2343,81,0,18,0,6
83525,2,2379,2554,-175,0,153,1,6
83526,2,2489,2451,38,0,0,1,6
83527,1,2509,2577,-68,0,45,1,6
83528,2,2387,2546,-159,0,106,0,6
83529,2,2351,2522,-171,0,0,0,6
83530,1,2407,2501,-94,0,315,0,6
83531,2,2328,2596,-268,0,107,0,6
83532,2,2247,2424,-177,0,245,0,6
83533,2,2403,2549,-146,0,4,0,6
83534,1,2335,2463,-128,0,456,0,6
83535,2,2452,2310,142,0,372,1,6
83536,2,2292,2452,-160,0,123,0,6
83537,1,2421,2404,17,0,132,1,6
83538,1,2500,2526,-26,0,143,0,6
83539,1,2410,2376,34,0,106,0,6
83540,1,2417,2360,57,0,41,0,6
83541,1,2373,2420,-47,0,107,0,6
83542,2,2288,2432,-144,0,122,1,6
83543,2,2354,2577,-223,0,453,0,6
83544,1,2441,2351,90,0,106,0,6
83545,1,2615,2667,-52,0,123,0,6
83546,1,2488,2442,46,0,311,0,6
83547,2,2420,2311,109,0,80,0,6
83548,1,2429,2464,-35,0,184,0,6
83549,2,2477,2479,-2,0,100,0,6
83550,2,2383,2406,-23,0,1,1,6
83551,2,2386,2430,-44,4,176,0,13
83552,1,2570,2661,-91,0,386,0,6
83553,1,2408,2380,28,0,112,0,6
83554,2,2350,2498,-148,0,40,0,6
83555,1,2452,2407,45,0,153,0,6
83556,1,2601,2382,219,0,1,1,6
83557,2,2441,2381,60,0,225,1,6
83558,2,2548,2597,-49,0,113,0,6
83559,2,2412,2434,-22,0,10,0,6
83560,1,2451,2281,170,0,335,0,6
83561,2,2619,2585,34,0,428,0,6
83562,2,2276,2412,-136,0,16,0,8
83563,2,2436,2412,24,0,110,0,6
83564,1,2506,2520,-14,0,100,0,6
83565,3,2549,2448,101,0,123,0,6
83567,1,2494,2394,100,0,302,0,6
83568,1,2536,2353,183,0,100,1,6
83569,2,2371,2414,-43,0,304,1,6
83570,1,2325,2422,-97,0,147,1,6
83571,1,2356,2541,-185,0,330,1,6
83572,1,2549,2384,165,0,8,0,6
83573,3,2417,2328,89,0,15,0,6
83574,2,2571,2516,55,0,47,0,6
83575,1,2455,2343,112,0,106,0,6
83576,1,2610,2524,86,0,15,0,6
83577,2,2458,2598,-140,0,41,1,6
83578,1,2257,2424,-167,0,131,1,6
83579,1,2412,2308,104,0,372,0,6
83580,2,2362,2484,-122,0,0,0,8
83581,1,2451,2376,75,0,35,1,6
83582,2,2525,2553,-28,0,107,0,6
83583,2,2359,2409,-50,0,45,0,6
83584,2,2310,2455,-145,0,0,1,6
83585,1,2399,2481,-82,0,17,0,6
83586,1,2417,2287,130,0,45,1,6
83587,3,2481,2300,181,4,265,0,13
83588,1,2577,2613,-36,0,327,0,6
83589,1,2416,2283,133,0,45,0,6
83590,2,2347,2429,-82,4,140,0,13
83591,2,2423,2527,-104,0,7,0,8
83592,2,2296,2413,-117,0,485,0,6
83593,2,2433,2450,-17,0,8,0,6
83595,1,2657,2660,-3,0,33,0,6
83596,1,2434,2493,-59,0,0,0,6
83597,2,2418,2209,209,0,46,0,6
83598,1,2537,2482,55,0,110,0,6
83599,1,2476,2397,79,0,190,0,6
83600,1,2622,2547,75,0,111,0,6
83601,1,2418,2220,198,0,119,1,6
83602,2,2458,2436,22,0,194,0,6
83603,2,2435,2347,88,0,253,1,6
83604,2,2325,2462,-137,0,106,0,8
83605,2,2334,2412,-78,0,102,0,6
83606,2,2435,2285,150,0,101,0,6
83607,1,2457,2435,22,0,448,1,6
83608,1,2390,2543,-153,0,40,1,6
83609,2,2402,2253,149,0,8,0,6
83610,1,2339,2459,-120,0,481,0,6
83611,1,2512,2626,-114,0,132,1,6
83612,1,2580,2426,154,0,411,0,6
83613,1,2570,2379,191,0,300,1,6
83614,2,2388,2479,-91,0,13,1,8
83615,2,2396,2428,-32,0,40,1,6
83616,1,2520,2483,37,0,190,0,6
83617,1,2491,2351,140,0,128,0,6
83618,2,2601,2674,-73,0,4,0,6
83619,1,2518,2514,4,0,123,0,6
83620,1,2415,2333,82,0,19,0,6
83621,1,2466,2439,27,0,101,1,8
83622,1,2416,2355,61,0,113,0,8
83623,2,2330,2452,-122,0,1,0,6
83624,1,2236,2413,-177,0,54,0,6
83625,1,2482,2420,62,0,300,0,6
83626,3,2520,2483,37,0,45,0,6
83627,1,2474,2296,178,0,394,1,6
83628,2,2449,2616,-167,0,483,0,6
83629,1,2456,2406,50,0,30,0,6
83630,1,2370,2525,-155,0,232,0,6
83631,2,2607,2584,23,0,302,0,6
83632,1,2459,2372,87,0,67,1,6
83633,1,2431,2380,51,0,241,1,6
83634,3,2429,2410,19,0,315,0,6
83635,2,2486,2445,41,0,40,0,6
83636,1,2654,2665,-11,0,461,0,6
83637,1,2442,2452,-10,0,184,0,6
83638,3,2343,2416,-73,0,107,0,6
83639,2,2452,2346,106,0,153,1,6
83640,2,2369,2470,-101,0,130,1,8
83641,1,2415,2273,142,0,4,0,6
83642,1,2487,2478,9,0,301,0,6
83643,1,2359,2410,-51,0,300,0,6
83644,1,2328,2419,-91,0,147,0,6
83645,2,2478,2503,-25,0,120,0,6
83646,1,2496,2429,67,0,46,0,6
83647,2,2311,2519,-208,0,278,0,6
83648,2,2385,2416,-31,0,15,1,6
83649,2,2415,2543,-128,0,145,1,6
83650,1,2375,2428,-53,0,40,0,6
83651,2,2558,2632,-74,0,260,0,6
83652,3,2350,2428,-78,0,302,0,6
83653,1,2439,2449,-10,0,123,0,6
83654,1,2462,2526,-64,0,385,0,6
83655,2,2351,2446,-95,0,6,0,6
83656,2,2429,2421,8,0,130,0,6
83657,2,2329,2407,-78,0,325,1,6
83658,2,2447,2573,-126,0,306,1,6
83659,1,2374,2416,-42,0,380,1,6
83660,1,2304,2417,-113,0,202,0,6
83661,1,2433,2519,-86,0,4,0,6
83662,2,2667,2740,-73,0,119,1,6
83663,1,2581,2456,125,0,200,0,6
83664,2,2472,2493,-21,0,30,0,6
83665,1,2419,2257,162,0,4,0,8
83666,1,2563,2610,-47,0,338,0,6
83667,2,2477,2354,123,0,4,1,6
83668,1,2403,2376,27,0,302,1,6
83669,1,2522,2350,172,0,461,0,6
83670,1,2445,2313,132,0,4,0,6
83671,1,2558,2446,112,0,28,1,6
83672,2,2362,2520,-158,0,215,0,6
83673,3,2550,2517,33,0,41,0,6
83674,1,2461,2379,82,0,16,0,6
83675,1,2620,2478,142,0,17,0,6
83676,2,2508,2401,107,0,4,0,6
83677,1,2362,2422,-60,0,106,1,6
83678,2,2338,2418,-80,0,1,0,6
83679,2,2352,2531,-179,0,267,0,8
83680,2,2590,2601,-11,0,245,0,6
83681,2,2336,2442,-106,0,487,1,6
83682,1,2423,2443,-20,0,414,1,6
83683,1,2412,2336,76,0,35,0,6
83684,1,2483,2463,20,0,122,0,6
83685,1,2426,2309,117,0,102,1,6
83686,2,2446,2443,3,0,241,0,6
83687,2,2427,2306,121,0,251,1,6
83688,2,2348,2495,-147,0,111,0,6
83689,2,2452,2585,-133,0,300,0,6
83690,2,2283,2423,-140,0,405,1,6
83691,1,2509,2472,37,0,112,0,6
83692,1,2498,2467,31,0,300,0,6
83693,3,2412,2390,22,0,4,0,6
83694,1,2454,2480,-26,0,415,1,6
83695,3,2512,2451,61,0,45,0,6
83696,2,2433,2471,-38,0,40,0,8
83697,1,2418,2440,-22,0,315,1,6
83698,3,2367,2513,-146,0,246,0,6
83699,2,2340,2484,-144,0,110,1,8
83700,1,2551,2446,105,0,330,1,6
83701,1,2500,2543,-43,0,41,0,6
83702,1,2423,2424,-1,0,0,0,6
83703,2,2422,2380,42,0,36,0,6
83704,2,2603,2523,80,0,31,0,6
83705,2,2424,2570,-146,0,157,0,6
83706,1,2474,2412,62,0,455,1,6
83707,3,2328,2462,-134,0,10,0,6
83708,2,2591,2624,-33,0,143,0,6
83709,2,2405,2480,-75,0,140,0,6
83710,1,2315,2417,-102,0,300,0,6
83711,2,2304,2469,-165,0,127,0,6
83712,1,2606,2584,22,0,412,1,6
83713,2,2432,2414,18,0,107,0,6
83714,2,2454,2465,-11,0,40,0,6
83715,2,2241,2405,-164,0,122,0,6
83716,2,2749,2663,86,0,4,0,6
83717,1,2408,2238,170,0,0,0,6
83718,2,2523,2497,26,0,242,0,6
83719,1,2409,2437,-28,0,30,0,6
83720,2,2403,2609,-206,0,140,0,8
83721,1,2418,2429,-11,0,200,1,6
83722,1,2636,2547,89,0,176,0,6
83723,2,2264,2443,-179,0,386,0,6
83724,3,2359,2487,-128,0,454,0,8
83725,1,2562,2577,-15,0,110,1,6
83726,2,2302,2469,-167,0,200,1,6
83727,3,2403,2375,28,0,241,0,6
83728,2,2602,2442,160,0,440,1,6
83729,2,2412,2549,-137,0,10,0,6
83730,1,2602,2489,113,0,130,1,6
83731,2,2458,2361,97,0,57,1,6
83732,1,2518,2366,152,0,202,0,6
83733,2,2331,2511,-180,0,241,0,6
83734,1,2657,2713,-56,0,4,0,6
83735,2,2519,2389,130,0,206,0,6
83736,1,2401,2323,78,0,106,0,6
83737,2,2670,2736,-66,0,112,1,6
83738,2,2463,2440,23,0,15,0,6
83739,2,2281,2429,-148,0,335,0,6
83740,3,2398,2471,-73,0,40,0,6
83741,2,2452,2425,27,0,45,0,6
83742,2,2331,2479,-148,4,453,0,13
83743,1,2462,2503,-41,0,112,0,6
83744,2,2477,2428,49,0,478,0,8
83745,1,2305,2430,-125,0,0,0,6
83746,3,2427,2367,60,0,127,0,6
83747,1,2514,2449,65,0,118,0,6
83748,2,2449,2389,60,0,108,0,6
83749,2,2426,2412,14,0,36,0,6
83750,2,2574,2760,-186,0,352,1,6
83751,1,2370,2517,-147,0,140,1,6
83752,1,2506,2415,91,0,4,0,6
83753,1,2401,2234,167,0,120,0,6
83754,1,2453,2425,28,0,190,0,6
83755,1,2397,2434,-37,0,115,0,6
83756,2,2409,2322,87,0,485,0,6
83757,2,2344,2485,-141,0,240,0,6
83758,2,2391,2596,-205,0,122,0,6
83759,1,2420,2327,93,0,190,0,6
83760,1,2492,2427,65,0,311,0,6
83761,1,2513,2232,281,0,200,0,6
83762,1,2446,2264,182,0,490,0,6
83763,2,2304,2500,-196,0,132,1,6
83764,2,2443,2469,-26,0,21,0,6
83765,1,2415,2378,37,0,200,0,6
83766,2,2231,2406,-175,0,100,0,6
83767,2,2327,2420,-93,0,460,0,6
83768,2,2487,2489,-2,0,122,0,8
83769,3,2440,2413,27,0,140,0,8
83770,1,2403,2404,-1,0,301,0,8
83771,3,2532,2528,4,0,121,0,8
83772,1,2510,2511,-1,0,309,0,8
83773,1,2508,2500,8,0,374,0,8
83774,3,2619,2607,12,0,335,0,8
83775,1,2410,2405,5,0,455,0,8
83776,3,2574,2558,16,0,37,0,8
83777,3,2540,2535,5,0,241,0,8
83778,1,2521,2426,95,0,246,0,6
83779,1,2534,2349,185,0,337,0,8
83780,2,2553,2584,-31,0,9,0,6
83781,2,2410,2309,101,0,4,0,6
83782,2,2467,2486,-19,0,115,0,6
83783,1,2423,2313,110,0,102,1,6
83784,1,2579,2612,-33,0,245,0,6
83785,2,2424,2504,-80,0,80,0,6
83786,3,2438,2433,5,0,107,0,8
83787,1,2522,2579,-57,0,338,0,8
83788,2,2460,2446,14,0,315,0,6
83789,2,2442,2514,-72,0,46,0,6
83790,1,2409,2261,148,0,52,0,6
83791,1,2428,2328,100,0,15,0,6
83792,2,2405,2417,-12,0,383,0,6
83793,2,2576,2568,8,0,0,0,6
83794,1,2470,2317,153,0,30,0,6
83795,2,2419,2331,88,0,112,0,6
83796,1,2571,2450,121,0,300,0,6
83797,2,2541,2400,141,0,3,1,6
83798,1,2446,2457,-11,0,115,0,6
83799,3,2535,2618,-83,0,455,0,8
83800,2,2559,2438,121,0,337,0,8
83801,3,2433,2532,-99,0,45,0,8
83802,1,2528,2539,-11,0,255,0,8
83803,2,2401,2332,69,0,80,0,6
83804,2,2418,2257,161,0,4,0,6
83805,1,2485,2519,-34,0,221,1,6
83806,2,2357,2416,-59,0,110,1,6
83807,2,2292,2420,-128,0,103,0,6
83808,2,2343,2449,-106,0,426,1,6
83809,2,2308,2401,-93,0,15,0,8
83810,2,2511,2489,22,0,268,0,6
83811,1,2487,2612,-125,0,140,1,8
83812,2,2230,2404,-174,0,226,0,6
83813,1,2423,2282,141,0,130,0,6
83814,1,2497,2468,29,0,45,0,6
83815,2,2444,2497,-53,0,45,0,6
83816,2,2745,2665,80,0,40,1,6
83817,2,2228,2408,-180,0,300,0,6
83818,1,2431,2480,-49,0,255,0,6
83819,1,2707,2564,143,0,46,0,6
83820,3,2367,2442,-75,0,250,0,6
83821,1,2485,2361,124,0,289,1,8
83822,2,2574,2570,4,0,28,1,6
83823,2,2411,2512,-101,0,30,0,6
83824,1,2599,2492,107,0,462,0,6
83825,3,2388,2426,-38,0,122,0,6
83826,1,2495,2440,55,0,205,0,8
83827,2,2470,2514,-44,0,112,0,8
83828,2,2516,2331,185,0,165,0,6
83829,2,2235,2411,-176,0,4,0,6
83830,2,2443,2287,156,0,150,1,6
83831,1,2445,2507,-62,0,101,0,6
83832,1,2763,2694,69,0,106,0,6
83833,1,2571,2376,195,0,491,0,6
83834,1,2407,2227,180,0,121,0,6
83835,1,2331,2409,-78,0,331,0,8
83836,2,2321,2425,-104,0,241,0,6
83837,2,2283,2405,-122,4,80,1,13
83838,2,2508,2420,88,0,172,0,6
83839,1,2509,2432,77,0,200,1,6
83840,2,2324,2403,-79,0,131,1,6
83841,2,2575,2378,197,0,45,0,6
83842,1,2375,2403,-28,0,45,0,6
83843,3,2448,2341,107,0,4,0,6
83844,1,2399,2547,-148,0,211,0,6
83845,3,2473,2561,-88,0,8,0,6
83846,1,2589,2548,41,0,4,0,6
83847,1,2362,2412,-50,0,311,0,6
83848,1,2440,2306,134,0,122,1,6
83849,2,2446,2534,-88,0,242,1,6
83850,1,2474,2341,133,0,288,0,6
83852,1,2324,2412,-88,0,133,1,6
83853,1,2432,2413,19,0,11,0,6
83854,3,2438,2603,-165,0,305,0,6
83855,2,2396,2500,-104,0,101,0,6
83856,1,2309,2427,-118,0,0,0,6
83857,3,2222,2536,-314,0,46,0,8
83858,1,2572,2294,278,0,123,0,8
83859,2,2338,2597,-259,0,331,0,8
83860,1,2488,2452,36,0,143,0,6
83861,2,2605,2585,20,0,343,1,6
83862,2,2224,2410,-186,0,112,0,6
83863,3,2359,2543,-184,0,102,0,6
83864,2,2463,2502,-39,0,300,1,6
83865,1,2496,2505,-9,0,180,1,6
83866,1,2235,2410,-175,0,107,0,6
83867,2,2421,2256,165,0,311,0,6
83868,2,2272,2424,-152,0,315,0,6
83869,2,2435,2348,87,0,0,0,8
83870,2,2219,2405,-186,0,302,0,8
83871,2,2503,2533,-30,0,7,0,6
83872,1,2424,2340,84,0,107,0,6
83873,2,2320,2400,-80,0,46,1,6
83874,1,2690,2768,-78,0,255,0,6
83875,3,2408,2491,-83,0,130,0,6
83876,2,2491,2438,53,0,115,0,6
83877,1,2401,2501,-100,0,415,0,6
83878,3,2538,2475,63,0,200,0,6
83879,1,2600,2601,-1,0,40,1,6
83880,2,2448,2551,-103,0,110,0,6
83881,3,2581,2576,5,0,115,0,6
83882,1,2388,2451,-63,0,300,0,6
83883,1,2456,2394,62,0,190,0,6
83884,2,2408,2537,-129,0,255,0,8
83885,2,2536,2411,125,0,112,0,6
83886,1,2435,2216,219,0,144,0,8
83887,2,2254,2551,-297,0,103,1,8
83888,3,2427,2501,-74,0,80,0,6
83889,3,2336,2493,-157,0,143,0,6
83890,2,2388,2566,-178,0,306,0,6
83891,1,2517,2389,128,0,313,0,6
83892,2,2461,2538,-77,0,102,0,6
83893,2,2429,2441,-12,0,4,0,6
83894,2,2712,2981,-269,0,143,0,6
83895,3,2398,2459,-61,0,132,0,6
83896,1,2475,2341,134,0,151,1,8
83897,1,2307,2406,-99,0,203,0,6
83898,2,2432,2514,-82,0,43,0,6
83899,2,2540,2452,88,0,4,0,6
83900,1,2423,2336,87,0,0,0,6
83901,1,2453,2225,228,0,330,0,6
83902,2,2287,2428,-141,0,0,0,6
83903,2,2372,2429,-57,0,17,0,6
83904,1,2374,2429,-55,0,306,1,6
83905,2,2405,2321,84,0,40,1,6
83906,2,2239,2504,-265,0,0,1,6
83907,2,2500,2428,72,0,190,0,6
83908,3,2412,2259,153,0,55,0,6
83909,2,2505,2493,12,0,102,0,6
83910,2,2444,2369,75,0,13,1,6
83911,2,2413,2460,-47,0,190,0,6
83912,2,2562,2511,51,0,129,0,6
83913,2,2413,2538,-125,0,265,0,6
83914,1,2555,2442,113,0,200,0,6
83915,1,2419,2317,102,0,102,1,6
83916,3,2504,2555,-51,0,302,0,6
83917,3,2385,2428,-43,0,122,0,6
83918,1,2401,2243,158,0,302,0,6
83919,1,2444,2362,82,0,335,0,6
83920,2,2425,2331,94,0,398,0,6
83921,2,2489,2548,-59,0,133,0,8
83922,1,2292,2574,-282,0,5,0,8
83923,2,2415,2473,-58,0,103,0,6
83924,2,2560,2524,36,0,45,0,6
83925,3,2592,2599,-7,0,245,0,6
83926,3,2423,2259,164,0,15,0,6
83927,1,2501,2440,61,0,43,0,6
83928,3,2490,2439,51,0,201,0,6
83929,3,2387,2508,-121,0,118,0,6
83930,3,2761,2697,64,0,411,0,6
83931,3,2492,2409,83,0,463,0,6
83932,1,2337,2478,-141,0,123,0,6
83933,1,2604,2399,205,0,40,0,8
83934,2,2426,2454,-28,0,10,0,6
83935,1,2500,2444,56,0,154,0,6
83936,1,2641,2641,0,0,245,0,6
83937,1,2382,2569,-187,0,101,0,6
83938,2,2411,2439,-28,0,110,1,6
83939,1,2533,2385,148,0,15,0,6
83940,1,2456,2255,201,0,80,1,6
83941,1,2576,2581,-5,0,331,0,6
83942,1,2504,2459,45,0,107,0,6
83943,2,2539,2382,157,0,241,1,6
83944,1,2439,2457,-18,0,241,1,6
83945,2,2458,2479,-21,0,269,0,6
83946,1,2413,2237,176,0,200,0,6
83947,1,2501,2606,-105,0,302,0,6
83948,1,2595,2579,16,0,1,0,6
83949,1,2543,2537,6,0,2,0,6
83950,3,2574,2372,202,0,13,0,8
83951,2,2418,2522,-104,0,394,0,6
83952,1,2475,2339,136,0,338,0,6
83953,2,2305,2449,-144,0,124,0,6
83954,2,2458,2399,59,0,229,0,6
83955,1,2983,2709,274,0,225,0,6
83956,3,2376,2400,-24,0,16,0,6
83957,1,2407,2300,107,0,8,0,6
83958,2,2732,2760,-28,0,15,0,6
83959,2,2438,2508,-70,0,269,0,6
83960,1,2478,2426,52,0,10,1,6
83961,2,2295,2405,-110,0,46,0,6
83962,2,2405,2276,129,0,8,0,6
83963,1,2541,2351,190,0,334,1,8
83964,1,2542,2410,132,0,382,0,6
83965,2,2422,2381,41,0,101,0,6
83966,2,2234,2451,-217,0,301,0,6
83967,2,2350,2402,-52,0,4,0,6
83968,3,2354,2400,-46,0,111,0,6
83969,2,2404,2530,-126,0,5,0,8
83970,3,2455,2565,-110,0,207,0,8
83971,1,2499,2505,-6,0,101,0,6
83972,2,2449,2556,-107,0,107,0,6
83973,1,2422,2526,-104,0,210,0,6
83974,3,2385,2499,-114,0,202,0,6
83975,2,2313,2423,-110,0,0,1,6
83976,2,2417,2359,58,0,200,1,6
83977,3,2553,2485,68,0,124,0,8
83978,1,2437,2410,27,0,38,1,6
83979,1,2554,2510,44,0,45,0,6
83980,2,2427,2437,-10,0,107,0,6
83981,1,2599,2592,7,0,343,0,6
83982,1,2554,2454,100,0,107,0,6
83983,2,2559,2501,58,0,151,0,6
83984,2,2392,2401,-9,0,335,1,6
83985,3,2511,2476,35,0,302,0,6
83986,2,2250,2404,-154,0,223,0,8
83987,2,2302,2586,-284,0,373,0,8
83988,2,2267,2427,-160,0,432,0,6
83989,2,2431,2397,34,0,473,1,6
83990,2,2400,2434,-34,0,7,0,6
83991,1,2532,2489,43,0,102,0,6
83992,1,2410,2491,-81,0,218,0,6
83993,2,2410,2459,-49,0,40,0,6
83994,2,2535,2521,14,0,254,0,8
83995,2,2409,2314,95,0,156,0,6
83996,1,2437,2273,164,0,359,0,6
83997,2,2574,2601,-27,0,4,0,6
83998,2,2333,2452,-119,0,121,0,6
83999,1,2511,2435,76,0,40,0,6
84000,2,2319,2409,-90,0,123,0,6
84001,1,2484,2571,-87,0,122,0,8
84002,2,2606,2585,21,0,150,0,6
84003,2,2322,2494,-172,0,226,1,6
84004,3,2435,2435,0,0,340,0,6
84005,1,2576,2582,-6,0,103,0,6
84006,2,2338,2607,-269,0,432,0,8
84007,1,2599,2390,209,0,40,0,6
84008,1,2426,2415,11,0,483,0,6
84009,1,2573,2647,-74,0,154,0,6
84010,2,2473,2363,110,0,106,0,6
84011,1,2492,2410,82,0,45,0,6
84012,2,2354,2402,-48,0,317,1,6
84013,2,2635,2620,15,0,190,0,6
84014,1,2451,2325,126,0,7,0,6
84015,2,2406,2451,-45,0,132,0,6
84016,1,2400,2362,38,0,34,0,6
84017,1,2458,2354,104,0,37,1,6
84018,2,2416,2401,15,0,40,0,8
84019,1,2533,2522,11,0,455,0,8
84020,2,2484,2388,96,0,0,0,8
84021,2,2512,2353,159,0,127,0,6
84022,1,2430,2342,88,0,469,0,6
84023,1,2376,2463,-87,0,9,1,6
84024,2,2295,2414,-119,0,46,0,6
84025,3,2419,2297,122,4,335,0,13
84026,2,2434,2525,-91,0,20,0,6
84027,1,2407,2345,62,0,386,0,6
84028,1,2517,2432,85,0,112,0,6
84029,1,2483,2417,66,0,463,1,6
84030,2,2505,2527,-22,0,242,1,6
84031,1,2335,2406,-71,0,241,0,6
84032,2,2390,2531,-141,0,45,1,6
84034,1,2505,2559,-54,0,230,0,6
84035,2,2586,2605,-19,0,327,1,6
84036,1,2499,2483,16,0,40,0,6
84037,1,2406,2546,-140,0,248,0,6
84038,2,2434,2263,171,0,40,0,6
84039,3,2489,2441,48,0,81,0,6
84040,1,2397,2443,-46,0,315,0,6
84041,2,2405,2339,66,0,140,1,6
84042,2,2692,2560,132,0,107,1,6
84043,3,2600,2492,108,0,124,0,8
84044,1,2421,2515,-94,0,80,0,6
84045,2,2497,2387,110,0,112,0,6
84046,3,2486,2552,-66,0,115,0,8
84047,1,2564,2218,346,0,20,0,8
84048,3,2226,2470,-244,0,415,0,6
84049,1,2409,2341,68,0,57,0,6
84050,2,2450,2435,15,0,176,0,6
84051,2,2459,2433,26,0,46,0,6
84052,3,2534,2531,3,0,40,0,8
84053,2,2511,2516,-5,0,151,0,6
84054,1,2478,2342,136,0,338,0,6
84055,1,2406,2431,-25,0,200,0,6
84056,1,2435,2506,-71,0,255,0,6
84057,2,2443,2316,127,0,45,0,8
84058,3,2456,2425,31,0,202,0,6
84059,1,2606,2602,4,0,303,0,6
84060,1,2531,2430,101,0,41,0,8
84061,2,2507,2493,14,0,171,0,8
84062,1,2563,2304,259,0,101,1,8
84063,2,2424,2405,19,0,38,0,6
84064,1,2388,2406,-18,0,31,0,6
84066,2,2223,2508,-285,0,0,1,6
84067,2,2253,2600,-347,0,463,0,6
84068,1,2294,2402,-108,0,302,0,6
84069,1,2544,2383,161,0,484,0,8
84071,1,2241,2491,-250,0,310,0,6
84072,3,2289,2524,-235,0,101,0,8
84073,3,2528,2596,-68,0,404,0,6
84074,3,2640,2580,60,0,101,0,6
84075,1,2508,2334,174,0,414,1,6
84076,3,2434,2372,62,0,409,0,6
84077,2,2235,2407,-172,0,133,1,6
84078,2,2458,2497,-39,0,253,0,6
84079,3,2406,2408,-2,0,4,0,6
84080,2,2626,2629,-3,0,260,0,6
84081,2,2552,2455,97,0,15,0,6
84082,2,2412,2488,-76,0,331,0,6
84083,1,2340,2412,-72,0,90,1,6
84084,2,2478,2418,60,0,35,1,6
84085,3,2588,2599,-11,0,110,0,8
84086,1,2606,2503,103,0,0,1,6
84087,2,2414,2508,-94,0,103,0,6
84088,1,2504,2338,166,0,145,0,6
84089,1,2273,2410,-137,0,115,1,6
84090,2,2441,2444,-3,0,487,0,6
84092,3,2358,2426,-68,0,150,0,8
84093,1,2508,2505,3,0,101,0,6
84094,2,2425,2452,-27,0,10,0,6
84095,3,2530,2353,177,0,159,0,6
84096,2,2610,2581,29,0,343,0,6
84097,1,2445,2464,-19,0,143,1,6
84098,1,2497,2383,114,0,1,0,6
84099,1,2551,2487,64,0,448,0,8
84100,2,2425,2416,9,0,454,0,6
84101,1,2422,2374,48,0,144,1,6
84102,1,2499,2412,87,0,244,1,8
84103,1,2395,2490,-95,0,202,1,6
84104,2,2453,2414,39,0,39,0,6
84105,1,2364,2403,-39,0,118,0,6
84106,1,2565,2284,281,0,101,0,8
84107,2,2217,2457,-240,0,381,0,8
84109,2,2439,2568,-129,0,54,1,6
84110,2,2596,2684,-88,0,88,0,6
84111,2,2426,2522,-96,0,211,0,6
84112,1,2402,2228,174,0,130,0,6
84113,2,2400,2394,6,0,311,0,6
84114,1,2591,2612,-21,0,107,0,6
84115,1,2496,2228,268,0,8,0,8
84116,2,2296,2400,-104,0,12,0,6
84117,3,2408,2547,-139,0,255,0,8
84118,2,2326,2418,-92,0,125,0,6
84119,2,2237,2482,-245,0,4,1,6
84120,2,2433,2277,156,0,330,0,6
84121,2,2411,2375,36,0,15,1,6
84122,2,2426,2296,130,0,414,0,6
84123,2,2310,2456,-146,0,101,1,6
84124,1,2484,2482,2,0,228,0,6
84125,1,2450,2440,10,0,134,0,6
84126,2,2538,2534,4,0,425,0,6
84127,2,2442,2350,92,0,123,1,6
84128,1,2324,2410,-86,0,130,1,6
84129,2,2513,2537,-24,0,201,0,6
84130,1,2397,2523,-126,0,117,0,6
84131,1,2241,2470,-229,0,50,0,6
84132,1,2539,2566,-27,0,122,0,8
84133,1,2581,2639,-58,0,154,0,6
84134,1,2432,2489,-57,0,140,0,6
84135,1,2609,2477,132,0,442,0,8
84136,2,2389,2472,-83,0,40,0,6
84137,1,2621,2493,128,0,178,0,6
84138,1,2321,2426,-105,0,131,0,6
84139,2,2421,2454,-33,0,140,0,6
84140,2,2606,2597,9,0,151,1,6
84141,2,2395,2512,-117,0,80,0,6
84142,1,2458,2420,38,0,295,1,6
84143,1,2360,2449,-89,0,405,1,6
84144,1,2467,2462,5,0,40,0,6
84145,3,2535,2498,37,0,373,0,8
84146,1,2540,2536,4,0,461,0,8
84147,2,2364,2512,-148,0,171,0,6
84148,3,2422,2322,100,0,461,0,6
84149,2,2425,2345,80,0,140,1,6
84150,2,2450,2436,14,0,176,0,6
84151,2,2375,2471,-96,0,102,0,6
84152,2,2395,2425,-30,0,416,1,6
84153,2,2587,2604,-17,0,300,1,6
84154,2,2516,2546,-30,0,44,0,8
84155,1,2405,2347,58,0,385,0,6
84156,2,2568,2592,-24,0,13,0,6
84157,2,2502,2610,-108,0,132,0,6
84158,2,2379,2428,-49,0,455,0,6
84159,1,2689,2498,191,0,190,1,6
84160,1,2507,2437,70,0,113,0,6
84161,1,2599,2409,190,0,201,0,8
84162,2,2410,2256,154,0,352,0,8
84163,1,2404,2281,123,0,200,1,6
84164,2,2417,2422,-5,0,40,0,6
84165,2,2499,2349,150,0,40,1,6
84166,2,2499,2503,-4,0,13,0,6
84167,2,2235,2409,-174,4,196,0,13
84168,2,2420,2458,-38,0,122,0,6
84169,3,2291,2402,-111,0,483,0,6
84170,1,2567,2588,-21,0,106,1,8
84171,2,2517,2356,161,0,200,0,8
84172,1,2385,2453,-68,0,301,0,6
84173,2,2515,2563,-48,0,107,0,6
84174,1,2418,2482,-64,0,414,0,6
84175,2,2396,2545,-149,0,9,0,8
84176,2,2442,2453,-11,0,1,0,6
84177,1,2433,2264,169,0,57,1,6
84178,1,2404,2292,112,0,100,0,6
84179,1,2483,2402,81,0,106,0,6
84181,1,2386,2406,-20,0,45,0,6
84182,2,2222,2484,-262,0,315,0,6
84183,1,2414,2434,-20,0,100,0,6
84184,2,2481,2421,60,0,406,0,6
84185,1,2553,2338,215,0,176,0,8
84186,2,2405,2234,171,0,140,1,6
84187,1,2383,2425,-42,0,5,0,8
84188,1,2414,2230,184,0,343,0,6
84189,1,2475,2435,40,0,13,1,6
84190,2,2427,2351,76,0,40,0,6
84191,1,2522,2294,228,0,152,0,8
84192,1,2571,2507,64,0,37,0,6
84193,1,2986,2706,280,0,54,0,6
84194,2,2410,2411,-1,0,117,0,8
84195,1,2342,2410,-68,0,90,1,6
84196,1,2528,2421,107,0,112,0,6
84197,1,2545,2335,210,0,201,0,8
84198,2,2433,2374,59,0,46,0,6
84199,2,2459,2489,-30,0,301,0,6
84200,1,2461,2430,31,0,260,1,6
84201,2,2218,2459,-241,0,375,0,6
84202,2,2357,2439,-82,0,344,0,6
84203,1,2309,2405,-96,0,0,0,6
84204,2,2588,2625,-37,0,154,1,6
84205,1,2515,2405,110,0,121,0,6
84206,2,2442,2632,-190,0,45,0,6
84207,3,2499,2602,-103,0,244,0,8
84208,1,2460,2416,44,0,307,0,6
84209,2,2301,2403,-102,0,133,0,6
84210,2,2452,2542,-90,0,102,0,6
84211,1,2406,2300,106,0,107,0,6
84212,1,2568,2635,-67,0,13,0,6
84213,1,2558,2509,49,0,101,0,6
84214,2,2329,2488,-159,0,240,0,6
84215,1,2411,2465,-54,0,104,0,6
84216,2,2329,2473,-144,0,140,0,6
84217,2,2499,2444,55,0,142,1,6
84218,1,2477,2456,21,0,337,0,6
84219,1,2489,2546,-57,0,335,0,6
84220,2,2271,2402,-131,0,156,1,8
84221,2,2324,2421,-97,0,125,1,6
84222,2,2344,2403,-59,0,135,0,6
84223,1,2421,2316,105,0,6,1,6
84224,1,2408,2351,57,0,278,1,6
84225,3,2487,2530,-43,0,256,0,6
84226,2,2480,2453,27,0,7,1,6
84227,2,2463,2415,48,0,112,1,6
84228,2,2352,2415,-63,0,483,0,6
84229,3,2600,2560,40,0,123,0,8
84230,3,2352,2420,-68,0,132,0,6
84231,2,2503,2576,-73,0,241,0,6
84232,1,2415,2455,-40,0,11,0,6
84233,1,2466,2463,3,0,45,0,6
84235,1,2451,2332,119,0,241,0,8
84236,2,2279,2408,-129,0,203,0,6
84237,2,2603,2612,-9,0,101,0,6
84238,1,2495,2443,52,0,244,0,6
84239,2,2240,2418,-178,0,411,1,6
84240,1,2501,2347,154,0,13,1,6
84241,1,2509,2454,55,0,365,0,8
84242,2,2435,2491,-56,0,302,0,6
84243,2,2403,2303,100,4,201,0,13
84244,2,2513,2596,-83,0,190,1,6
84245,2,2400,2519,-119,0,170,0,6
84246,1,2548,2392,156,0,30,0,8
84247,2,2418,2575,-157,0,41,0,6
84248,2,2307,2470,-163,4,111,1,13
84249,1,2540,2533,7,0,105,1,6
84250,2,2343,2548,-205,0,158,0,8
84251,2,2332,2524,-192,0,30,0,8
84252,1,2296,2414,-118,0,220,1,6
84253,1,2297,2488,-191,0,264,0,6
84254,2,2407,2312,95,0,485,1,6
84255,2,2260,2444,-184,0,202,1,8
84257,1,2408,2413,-5,0,456,0,8
84258,2,2492,2574,-82,0,145,0,8
84259,1,2635,2480,155,0,105,0,6
84260,1,2439,2425,14,0,300,0,6
84261,1,2356,2477,-121,0,140,0,6
84262,1,2403,2349,54,0,112,0,6
84263,2,2354,2504,-150,0,404,1,6
84264,1,2349,2437,-88,0,43,1,6
84265,1,2428,2325,103,0,161,1,6
84266,1,2437,2417,20,0,1,0,6
84267,1,2615,2458,157,0,0,0,6
84268,1,2415,2385,30,0,389,0,6
84269,1,2365,2432,-67,0,45,0,8
84270,2,2420,2483,-63,0,205,1,6
84271,1,2285,2403,-118,0,45,1,6
84272,2,2628,2744,-116,0,156,0,6
84273,1,2630,2476,154,0,133,0,6
84274,2,2283,2400,-117,0,45,0,6
84275,2,2458,2454,4,0,47,1,6
84276,1,2400,2214,186,0,151,0,6
84277,1,2583,2501,82,0,106,0,8
84278,2,2354,2530,-176,0,5,0,8
84279,2,2451,2496,-45,0,190,0,6
84280,3,2523,2551,-28,0,414,0,6
84281,1,2437,2407,30,0,218,0,8
84282,2,2427,2396,31,0,412,0,6
84283,2,2498,2377,121,0,207,1,6
84284,2,2579,2408,171,0,206,0,8
84285,2,2534,2488,46,0,43,0,8
84286,2,2498,2292,206,0,123,0,8
84287,2,2329,2510,-181,0,475,0,8
84288,1,2451,2284,167,0,110,0,6
84289,2,2427,2425,2,0,4,0,6
84290,1,2418,2341,77,0,138,1,8
84291,2,2347,2413,-66,0,45,0,6
84292,2,2422,2347,75,0,140,0,6
84293,1,2529,2488,41,0,210,0,6
84294,1,2425,2339,86,0,6,1,6
84295,1,2704,2988,-284,0,101,0,6
84296,1,2355,2413,-58,0,133,0,6
84297,2,2422,2457,-35,0,43,0,6
84298,1,2423,2284,139,0,131,0,6
84299,1,2502,2446,56,0,464,1,6
84300,1,2474,2322,152,0,241,0,6
84301,1,2476,2504,-28,0,56,0,6
84302,2,2450,2210,240,0,131,0,8
84303,1,2551,2298,253,0,101,0,8
84304,3,2457,2446,11,0,177,0,6
84305,1,2381,2401,-20,0,300,0,6
84306,2,2367,2510,-143,0,45,0,6
84307,1,2438,2355,83,0,101,0,6
84308,2,2620,2500,120,0,106,0,6
84309,3,2540,2475,65,0,320,0,6
84310,2,2509,2456,53,0,8,0,6
84311,1,2533,2535,-2,0,81,1,6
84312,3,2600,2553,47,0,455,0,6
84313,2,2240,2412,-172,0,40,0,6
84314,1,2276,2454,-178,0,48,0,6
84315,2,2419,2421,-2,0,414,0,6
84316,1,2516,2444,72,0,478,0,6
84317,3,2327,2455,-128,0,241,0,8
84318,1,2344,2408,-64,0,4,0,6
84319,1,2578,2563,15,0,30,0,6
84320,1,2546,2387,159,0,129,0,6
84321,1,2370,2465,-95,0,123,0,6
84322,2,2508,2351,157,0,121,0,6
84323,2,2360,2478,-118,0,2,0,6
84324,1,2496,2504,-8,0,48,0,6
84325,1,2249,2400,-151,0,255,0,6
84326,2,2480,2305,175,0,199,0,6
84327,2,2639,2615,24,0,130,0,6
84328,1,2469,2508,-39,0,45,1,6
84329,1,2400,2423,-23,0,344,0,6
84330,2,2494,2516,-22,0,260,0,8
84331,2,2415,2351,64,0,300,0,6
84332,2,2516,2390,126,0,153,1,6
84333,2,2275,2418,-143,0,455,0,6
84334,2,2477,2508,-31,0,16,1,6
84335,2,2483,2539,-56,0,101,0,6
84336,1,2335,2489,-154,0,178,0,6
84337,1,2415,2306,109,0,300,0,6
84338,1,2496,2527,-31,0,101,0,8
84339,1,2416,2587,-171,0,211,0,8
84340,2,2472,2633,-161,0,302,0,6
84341,2,2581,2443,138,0,344,0,6
84342,2,2413,2335,78,4,153,0,13
84343,2,2440,2524,-84,0,45,0,6
84344,3,2300,2561,-261,0,40,0,6
84345,3,2421,2457,-36,0,4,0,6
84346,1,2553,2571,-18,0,102,0,8
84347,1,2401,2351,50,0,386,0,6
84348,3,2282,2433,-151,0,122,0,6
84349,2,2389,2552,-163,0,15,0,8
84350,1,2444,2427,17,0,80,1,6
84351,1,2402,2421,-19,0,107,0,6
84352,1,2265,2438,-173,0,51,0,6
84353,2,2402,2613,-211,0,122,1,8
84354,1,2434,2600,-166,0,190,0,6
84355,2,2498,2483,15,0,10,0,6
84356,1,2460,2321,139,0,56,0,6
84357,1,2524,2528,-4,0,301,0,8
84358,1,2405,2490,-85,0,217,1,8
84359,1,2422,2318,104,0,4,1,6
84360,1,2354,2412,-58,0,483,0,6
84361,3,2431,2502,-71,0,13,0,6
84362,1,2561,2600,-39,0,30,0,8
84363,2,2358,2491,-133,0,55,0,6
84364,1,2462,2417,45,0,107,0,6
84365,1,2636,2469,167,0,133,0,6
84366,1,2609,2624,-15,0,300,0,6
84367,1,2455,2286,169,0,150,0,6
84368,2,2366,2435,-69,0,190,0,6
84369,1,2427,2368,59,0,205,0,6
84370,1,2320,2418,-98,0,424,1,6
84371,1,2404,2382,22,0,311,1,6
84372,1,2546,2442,104,0,100,0,6
84373,1,2513,2421,92,0,164,0,6
84374,2,2358,2453,-95,0,296,1,6
84375,1,2406,2363,43,0,41,1,6
84376,1,2528,2435,93,0,474,0,6
84377,2,2441,2506,-65,0,4,1,6
84378,2,2476,2509,-33,0,201,0,6
84379,2,2297,2498,-201,0,204,0,6
84380,1,2521,2427,94,0,49,1,8
84381,1,2551,2617,-66,0,57,0,6
84382,2,2529,2363,166,0,311,0,6
84383,1,2525,2421,104,0,488,0,6
84384,2,2457,2457,0,0,168,0,6
84385,2,2557,2327,230,0,48,1,6
84386,3,2372,2490,-118,0,43,0,8
84387,2,2473,2215,258,0,138,0,8
84388,2,2557,2584,-27,0,4,0,6
84389,2,2450,2494,-44,0,106,1,6
84390,2,2326,2500,-174,0,404,1,6
84391,2,2525,2377,148,0,377,0,6
84392,1,2522,2221,301,0,373,0,8
84393,2,2532,2559,-27,0,365,1,8
84394,2,2296,2565,-269,0,140,0,8
84395,1,2580,2421,159,0,278,0,6
84396,1,2403,2296,107,0,152,0,6
84397,2,2446,2312,134,0,300,1,6
84398,1,2573,2412,161,0,375,0,6
84399,2,2481,2398,83,0,110,0,6
84400,2,2320,2430,-110,0,205,0,6
84401,2,2346,2406,-60,0,90,0,6
84402,2,2618,2633,-15,0,150,0,6
84403,2,2471,2591,-120,0,194,0,6
84404,1,2435,2241,194,0,130,0,8
84405,1,2497,2359,138,0,123,1,6
84406,1,2494,2354,140,0,192,0,6
84408,2,2409,2314,95,0,310,0,6
84409,1,2448,2280,168,0,331,0,6
84410,1,2513,2408,105,0,269,0,6
84411,1,2978,2717,261,0,441,0,6
84412,1,2490,2441,49,0,374,0,8
84413,1,2521,2472,49,0,40,0,6
84414,1,2440,2427,13,0,4,0,6
84415,1,2423,2288,135,0,263,0,8
84416,1,2532,2502,30,0,338,0,6
84417,1,2571,2359,212,0,112,0,6
84418,1,2412,2467,-55,0,3,1,6
84419,1,2363,2417,-54,4,344,0,13
84420,2,2318,2432,-114,0,151,0,6
84421,1,2509,2211,298,0,127,0,6
84422,2,2372,2521,-149,0,103,0,6
84423,1,2567,2579,-12,0,108,0,8
84424,3,2594,2425,169,0,1,0,8
84425,3,2466,2640,-174,0,312,0,6
84426,3,2422,2449,-27,0,302,0,6
84427,2,2402,2361,41,0,150,0,6
84428,1,2517,2431,86,0,115,0,6
84429,2,2335,2453,-118,0,107,0,8
84430,1,2515,2471,44,0,325,0,6
84431,1,2314,2492,-178,0,0,0,6
84432,1,2517,2489,28,0,288,0,6
84433,1,2569,2558,11,0,139,0,6
84434,2,2322,2431,-109,0,4,1,6
84436,1,2467,2357,110,0,28,1,6
84437,1,2411,2234,177,0,206,0,6
84438,1,2539,2526,13,0,190,1,6
84439,3,2321,2417,-96,0,10,0,8
84440,2,2297,2542,-245,0,150,0,8
84441,3,2554,2576,-22,0,241,0,6
84442,2,2498,2416,82,0,131,0,6
84443,1,2493,2450,43,0,122,0,6
84444,1,2422,2245,177,0,0,1,6
84445,2,2351,2439,-88,0,314,0,6
84446,2,2438,2471,-33,0,1,0,6
84447,3,2341,2524,-183,0,118,0,8
84448,1,2219,2525,-306,0,36,0,8
84449,2,2383,2411,-28,0,123,0,6
84450,3,2498,2550,-52,0,154,0,6
84451,1,2492,2385,107,0,31,0,6
84452,2,2445,2421,24,0,122,1,6
84453,2,2224,2407,-183,0,268,0,6
84454,1,2547,2457,90,0,315,0,6
84455,2,2432,2503,-71,0,127,0,6
84456,1,2484,2322,162,0,10,1,6
84457,1,2358,2445,-87,0,122,0,6
84458,1,2499,2551,-52,0,45,0,6
84459,1,2453,2382,71,0,335,0,6
84460,1,2511,2437,74,0,58,1,6
84461,2,2596,2584,12,0,4,0,6
84462,1,2447,2291,156,0,101,1,6
84463,3,2457,2386,71,0,8,0,8
84464,2,2521,2495,26,0,453,0,8
84465,2,2408,2451,-43,0,45,0,6
84466,1,2398,2447,-49,0,343,1,6
84467,2,2589,2552,37,0,30,0,6
84468,1,2501,2638,-137,0,120,0,6
84469,3,2336,2510,-174,0,117,0,6
84470,1,2355,2491,-136,0,333,1,6
84471,2,2400,2502,-102,0,112,1,6
84472,1,2411,2342,69,0,385,0,6
84473,1,2409,2550,-141,0,200,0,6
84474,2,2568,2592,-24,0,56,0,8
84475,2,2399,2404,-5,0,244,0,8
84476,2,2616,2400,216,0,85,0,8
84477,2,2342,2474,-132,0,45,0,6
84478,1,2417,2467,-50,0,310,0,6
84479,1,2595,2466,129,0,453,0,6
84480,2,2427,2497,-70,0,45,0,8
84481,1,2501,2320,181,0,6,0,6
84482,2,2424,2439,-15,0,469,0,6
84483,1,2338,2429,-91,0,151,1,6
84484,3,2337,2416,-79,0,334,0,6
84485,1,2436,2314,122,0,39,0,6
84486,1,2229,2555,-326,0,455,0,8
84487,3,2573,2525,48,0,106,0,8
84488,1,2434,2446,-12,0,352,0,6
84489,2,2599,2538,61,0,49,0,6
84490,1,2637,2468,169,0,133,0,6
84491,2,2573,2565,8,0,150,0,8
84492,3,2714,2980,-266,0,143,0,6
84493,2,2461,2368,93,0,110,0,6
84494,3,2460,2419,41,0,31,0,6
84495,1,2414,2354,60,0,131,0,6
84496,2,2392,2517,-125,0,45,1,6
84497,3,2299,2414,-115,0,218,0,8
84498,2,2576,2612,-36,0,0,0,6
84499,2,2449,2422,27,0,337,0,6
84500,2,2405,2411,-6,0,463,0,6
84501,2,2417,2414,3,0,335,0,6
84502,1,2477,2331,146,0,106,0,8
84503,2,2427,2346,81,0,210,1,6
84504,1,2508,2376,132,0,140,1,6
84505,2,2328,2446,-118,0,46,0,6
84506,2,2394,2426,-32,0,122,0,8
84507,1,2435,2301,134,0,101,0,6
84508,1,2453,2279,174,0,485,1,6
84509,1,2523,2349,174,0,133,0,6
84510,1,2521,2558,-37,0,64,0,6
84511,2,2479,2292,187,0,264,0,6
84512,1,2252,2409,-157,0,122,0,6
84513,1,2425,2498,-73,0,0,0,6
84514,2,2242,2445,-203,0,1,1,6
84515,2,2400,2317,83,0,256,0,6
84516,1,2456,2430,26,0,175,0,6
84517,2,2296,2562,-266,0,153,0,8
84518,2,2344,2508,-164,0,5,0,8
84519,2,2502,2516,-14,0,101,0,8
84520,2,2597,2423,174,0,1,0,8
84521,2,2463,2403,60,0,101,0,6
84522,1,2427,2379,48,0,110,0,6
84523,1,2319,2487,-168,0,0,0,6
84524,2,2310,2429,-119,0,118,0,6
84525,1,2440,2346,94,0,313,1,6
84526,2,2630,2510,120,0,101,0,6
84527,2,2544,2438,106,0,311,0,6
84528,1,2590,2505,85,0,106,0,6
84529,3,2515,2348,167,0,44,0,8
84530,2,2277,2428,-151,0,115,0,6
84531,1,2281,2411,-130,0,45,0,6
84532,2,2261,2403,-142,0,300,0,6
84533,2,2563,2581,-18,0,331,0,6
84534,1,2542,2429,113,0,241,0,6
84535,1,2364,2481,-117,0,308,0,8
84536,1,2570,2545,25,0,121,0,8
84537,2,2432,2516,-84,0,1,0,6
84538,2,2412,2420,-8,0,357,1,6
84539,1,2412,2571,-159,0,241,0,6
84540,2,2567,2572,-5,0,46,0,8
84541,1,2526,2513,13,0,306,0,8
84542,1,2387,2508,-121,0,118,0,6
84543,1,2483,2365,118,0,106,0,6
84544,1,2304,2433,-129,0,100,1,6
84545,1,2432,2269,163,0,142,0,8
84546,2,2461,2363,98,0,133,0,6
84547,2,2217,2466,-249,0,373,0,6
84548,2,2377,2526,-149,0,224,1,6
84549,2,2618,2592,26,0,150,0,6
84550,1,2545,2462,83,0,487,0,6
84551,1,2535,2205,330,0,46,0,8
84552,3,2377,2507,-130,0,344,0,8
84553,2,2322,2454,-132,0,20,0,6
84554,2,2402,2402,0,0,57,0,6
84555,1,2422,2345,77,0,128,0,6
84556,1,2419,2460,-41,0,1,1,6
84557,2,2428,2496,-68,0,240,0,6
84558,2,2418,2605,-187,0,140,0,6
84559,2,2428,2443,-15,0,101,0,6
84560,1,2425,2338,87,0,16,0,6
84561,3,2406,2318,88,4,201,0,13
84562,3,2451,2365,86,0,113,0,6
84563,2,2246,2533,-287,0,398,0,8
84564,1,2303,2412,-109,0,218,0,8
84565,1,2537,2432,105,0,46,0,6
84566,2,2445,2374,71,0,15,1,6
84567,1,2594,2387,207,0,415,1,6
84568,2,2299,2483,-184,0,190,0,8
84569,1,2423,2355,68,0,4,0,8
84570,2,2372,2604,-232,0,107,1,6
84571,1,2539,2294,245,0,335,0,8
84572,2,2505,2431,74,0,373,0,8
84573,2,2565,2576,-11,0,15,0,8
84574,1,2501,2594,-93,0,271,0,6
84575,1,2439,2594,-155,0,112,0,6
84576,2,2587,2557,30,0,115,0,6
84577,2,2427,2420,7,0,40,0,6
84578,2,2353,2456,-103,0,41,0,6
84579,1,2541,2518,23,0,101,0,6
84580,1,2522,2379,143,0,152,0,8
84581,2,2405,2607,-202,0,58,1,8
84582,3,2441,2440,1,0,62,0,6
84583,2,2433,2297,136,0,152,0,6
84584,2,2456,2306,150,0,484,0,6
84585,2,2473,2589,-116,0,260,0,8
84586,2,2431,2371,60,0,301,0,8
84587,1,2479,2327,152,0,10,1,6
84588,2,2398,2408,-10,0,330,0,6
84589,2,2313,2478,-165,0,45,0,6
84590,1,2417,2513,-96,0,247,0,8
84591,1,2609,2583,26,0,4,1,6
84592,1,2444,2260,184,0,300,1,6
84593,2,2456,2527,-71,0,153,0,6
84595,2,2976,2719,257,0,484,0,6
84596,1,2328,2406,-78,0,241,1,6
84597,2,2448,2432,16,0,40,0,6
84598,2,2426,2415,11,0,131,0,6
84599,2,2552,2518,34,0,373,0,6
84600,2,2381,2449,-68,0,123,0,6
84601,3,2458,2549,-91,0,415,0,6
84602,2,2563,2511,52,0,7,0,6
84603,1,2371,2416,-45,0,307,0,6
84604,1,2258,2410,-152,4,110,0,13
84605,2,2362,2444,-82,0,122,0,6
84606,1,2499,2256,243,4,50,0,11
84607,1,2447,2427,20,0,4,1,6
84608,1,2497,2578,-81,0,122,1,8
84609,1,2520,2428,92,0,335,1,6
84610,1,2599,2487,112,0,46,1,6
84611,1,2587,2508,79,0,140,0,6
84612,1,2310,2407,-97,0,33,0,6
84613,1,2438,2404,34,0,180,0,8
84614,1,2460,2349,111,0,123,0,6
84615,2,2453,2395,58,0,133,1,6
84616,1,2404,2294,110,0,40,0,6
84617,2,2340,2426,-86,0,130,0,6
84618,1,2503,2562,-59,0,404,0,8
84619,1,2513,2541,-28,0,120,0,6
84620,1,2421,2450,-29,0,49,0,6
84621,1,2271,2414,-143,0,200,0,6
84622,1,2375,2469,-94,0,70,0,8
84623,1,2401,2394,7,0,373,0,8
84624,2,2593,2525,68,0,0,1,8
84625,1,2262,2420,-158,0,4,0,6
84626,1,2453,2426,27,0,0,0,6
84627,2,2417,2549,-132,0,481,1,6
84629,2,2301,2435,-134,0,5,0,8
84630,1,2324,2459,-135,0,217,1,6
84632,1,2426,2374,52,0,112,0,6
84633,1,2348,2503,-155,0,40,0,6
84634,3,2521,2424,97,0,207,0,6
84635,2,2318,2414,-96,0,343,0,6
84636,1,2420,2388,32,0,200,0,8
84637,2,2351,2529,-178,0,297,1,6
84638,2,2544,2371,173,0,246,0,8
84639,1,2449,2438,11,0,313,1,6
84640,1,2518,2357,161,0,106,0,6
84641,1,2345,2434,-89,0,202,0,6
84642,1,2466,2409,57,0,106,0,6
84643,3,2487,2341,146,0,44,0,8
84644,1,2631,2612,19,0,4,1,6
84645,3,2564,2581,-17,0,331,0,6
84646,1,2482,2522,-40,0,195,0,6
84647,1,2581,2425,156,0,201,0,8
84648,1,2420,2406,14,0,140,0,6
84649,2,2425,2316,109,0,1,1,6
84650,2,2444,2451,-7,0,130,0,6
84651,1,2532,2447,85,0,320,1,6
84652,3,2439,2340,99,0,190,0,8
84653,2,2425,2310,115,0,109,0,6
84654,1,2531,2235,296,0,107,1,6
84656,3,2577,2615,-38,0,34,0,6
84657,2,2452,2556,-104,0,55,0,6
84658,1,2351,2420,-69,0,45,0,6
84659,1,2324,2482,-158,0,0,0,6
84660,3,2421,2439,-18,0,80,0,6
84661,2,2247,2447,-200,0,310,1,6
84662,2,2371,2404,-33,0,245,0,6
84663,1,2384,2425,-41,0,45,1,6
84664,2,2464,2404,60,0,101,0,6
84665,3,2486,2296,190,0,197,0,8
84666,2,2389,2400,-11,0,45,1,6
84667,2,2420,2536,-116,0,106,1,8
84668,2,2341,2443,-102,0,33,1,8
84669,1,2644,2521,123,0,156,1,6
84670,2,2420,2459,-39,0,2,0,6
84671,1,2481,2314,167,0,122,1,6
84672,1,2469,2209,260,0,106,0,6
84673,2,2524,2546,-22,0,190,1,6
84674,1,2504,2316,188,0,106,0,8
84675,2,2354,2422,-68,0,200,1,6
84676,2,2437,2278,159,4,277,0,13
84677,1,2486,2539,-53,0,300,1,6
84678,2,2402,2377,25,0,30,0,6
84679,1,2418,2314,104,0,107,0,6
84680,1,2400,2227,173,0,22,0,6
84681,2,2431,2336,95,0,352,0,6
84682,2,2504,2483,21,0,250,0,6
84683,2,2424,2525,-101,0,1,1,6
84684,2,2731,2967,-236,0,170,0,6
84685,1,2444,2282,162,0,10,0,6
84686,1,2399,2401,-2,0,150,0,6
84687,3,2332,2448,-116,0,256,0,6
84688,2,2263,2461,-198,0,46,1,6
84689,1,2555,2555,0,0,200,1,6
84690,3,2400,2392,8,0,310,0,6
84691,2,2306,2402,-96,0,241,0,8
84692,1,2535,2597,-62,0,85,0,6
84693,2,2515,2361,154,0,241,1,6
84694,3,2580,2564,16,0,115,0,6
84695,2,2546,2591,-45,0,226,1,6
84696,2,2542,2553,-11,0,81,0,8
84697,1,2237,2493,-256,0,4,1,6
84698,1,2358,2413,-55,0,45,0,6
84699,1,2553,2574,-21,0,344,0,6
84700,1,2413,2441,-28,0,110,0,6
84701,1,2403,2239,164,0,246,0,6
84702,3,2532,2571,-39,0,131,0,8
84703,2,2333,2417,-84,0,5,0,6
84704,1,2613,2455,158,0,302,1,6
84705,2,2280,2427,-147,0,210,1,8
84706,2,2296,2437,-141,0,101,0,6
84707,1,2485,2407,78,0,253,0,8
84708,3,2413,2531,-118,0,460,0,8
84709,1,2306,2444,-138,0,50,1,6
84710,1,2469,2366,103,0,340,1,6
84711,3,2317,2406,-89,0,487,0,6
84712,2,2578,2519,59,0,13,1,6
84713,2,2454,2399,55,0,330,0,6
84714,1,2474,2332,142,0,10,1,6
84715,1,2271,2400,-129,0,15,0,6
84716,2,2289,2412,-123,0,0,0,6
84717,1,2532,2356,176,0,101,0,6
84718,1,2586,2507,79,0,1,0,8
84719,1,2510,2379,131,0,333,0,8
84720,2,2560,2600,-40,0,0,0,6
84721,1,2447,2637,-190,0,4,0,6
84722,1,2331,2401,-70,0,1,1,6
84723,1,2410,2271,139,0,131,0,8
84724,2,2400,2349,51,0,84,0,6
84725,1,2464,2457,7,0,131,0,6
84726,1,2606,2621,-15,0,132,0,6
84727,1,2411,2516,-105,0,46,1,6
84728,3,2461,2421,40,0,123,0,6
84729,1,2548,2459,89,0,190,0,6
84730,2,2310,2422,-112,0,343,0,6
84731,1,2570,2311,259,0,125,0,8
84732,3,2476,2387,89,0,400,0,8
84733,1,2520,2352,168,0,469,0,6
84734,1,2374,2426,-52,0,107,0,6
84735,2,2311,2443,-132,0,143,1,6
84736,1,2342,2408,-66,0,455,1,6
84737,1,2541,2415,126,0,481,0,8
84738,1,2530,2420,110,0,46,0,8
84739,1,2535,2403,132,0,100,0,8
84740,2,2447,2474,-27,0,112,0,8
84741,2,2437,2536,-99,0,331,0,6
84742,1,2419,2391,28,0,15,0,6
84743,1,2397,2511,-114,0,132,0,6
84744,1,2551,2519,32,0,112,0,6
84745,1,2485,2680,-195,0,100,0,6
84746,2,2427,2423,4,0,0,0,6
84748,3,2530,2494,36,0,245,0,6
84749,3,2299,2483,-184,0,190,0,8
84750,1,2585,2489,96,0,201,0,8
84751,1,2445,2440,5,0,16,1,6
84752,2,2426,2437,-11,0,120,0,8
84753,1,2491,2223,268,0,315,0,6
84754,3,2311,2402,-91,0,45,0,6
84755,1,2553,2387,166,0,127,1,6
84756,2,2444,2426,18,0,100,0,6
84757,2,2489,2466,23,0,110,1,6
84758,1,2580,2493,87,0,131,0,6
84759,2,2223,2471,-248,0,140,0,6
84760,1,2564,2580,-16,0,331,0,6
84761,2,2416,2573,-157,0,45,0,8
84762,2,2545,2561,-16,0,411,0,6
84763,2,2438,2426,12,0,45,1,6
84764,1,2529,2420,109,0,84,0,6
84765,3,2530,2541,-11,0,120,0,6
84766,2,2381,2510,-129,0,394,0,6
84767,1,2541,2498,43,0,124,0,6
84768,2,2341,2465,-124,0,40,0,6
84769,2,2559,2534,25,0,461,0,8
84770,1,2357,2406,-49,0,211,1,6
84771,2,2590,2596,-6,0,337,0,6
84772,1,2400,2367,33,0,110,0,6
84773,3,2401,2334,67,0,100,0,6
84774,1,2507,2573,-66,0,141,1,6
84775,2,2405,2433,-28,0,140,0,6
84776,2,2400,2344,56,0,270,0,6
84777,2,2418,2317,101,0,1,0,6
84778,3,2416,2397,19,0,246,0,8
84779,2,2458,2540,-82,0,299,1,6
84780,1,2514,2556,-42,0,194,0,6
84781,1,2258,2404,-146,4,83,0,13
84782,2,2326,2420,-94,0,106,0,6
84783,3,2375,2442,-67,0,45,0,8
84784,3,2480,2503,-23,0,455,0,8
84785,3,2507,2590,-83,0,260,0,8
84786,1,2476,2385,91,0,1,0,6
84787,3,2421,2388,33,0,0,0,6
84788,1,2300,2429,-129,0,130,1,6
84789,3,2422,2341,81,0,130,0,6
84790,1,2969,2728,241,0,112,0,6
84791,1,2329,2478,-149,0,0,0,6
84792,3,2434,2416,18,0,277,0,6
84793,3,2502,2576,-74,0,201,0,8
84794,1,2452,2423,29,0,130,0,6
84795,1,2470,2559,-89,0,337,0,6
84796,3,2568,2518,50,0,9,0,6
84797,1,2555,2448,107,0,125,0,6
84798,1,2500,2444,56,0,31,0,6
84799,1,2451,2278,173,0,127,0,6
84800,2,2472,2571,-99,0,107,0,6
84801,3,2584,2526,58,0,101,0,6
84802,1,2383,2489,-106,0,386,0,6
84803,2,2393,2419,-26,0,277,0,6
84804,2,2426,2427,-1,0,45,0,6
84806,2,2362,2406,-44,0,455,0,6
84807,2,2588,2421,167,0,145,0,6
84808,2,2566,2612,-46,0,101,1,6
84809,1,2464,2265,199,0,337,0,6
84810,1,2405,2377,28,0,253,0,6
84811,2,2409,2422,-13,0,400,0,6
84812,1,2615,2628,-13,0,255,1,6
84813,2,2381,2439,-58,0,106,0,6
84814,2,2432,2438,-6,0,4,1,6
84815,2,2355,2423,-68,0,147,0,6
84816,2,2313,2431,-118,0,208,0,8
84817,3,2402,2315,87,0,65,0,6
84818,2,2351,2400,-49,0,147,0,6
84819,1,2514,2481,33,0,40,1,6
84820,2,2395,2483,-88,0,0,1,6
84821,3,2504,2431,73,0,132,0,6
84822,1,2671,2615,56,0,120,0,6
84823,1,2473,2410,63,0,107,0,6
84824,1,2368,2409,-41,0,332,0,6
84825,1,2226,2434,-208,0,1,1,6
84826,1,2552,2477,75,0,40,0,6
84827,2,2448,2541,-93,0,13,1,6
84828,1,2418,2304,114,0,310,0,6
84829,1,2416,2533,-117,0,4,1,6
84830,1,2457,2287,170,0,110,0,6
84831,2,2217,2466,-249,0,50,0,6
84832,2,2372,2411,-39,0,463,0,6
84833,1,2470,2337,133,0,10,1,6
84834,1,2424,2420,4,0,13,0,6
84835,2,2400,2398,2,0,354,0,6
84836,2,2281,2405,-124,0,106,0,6
84837,2,2483,2514,-31,0,388,0,6
84838,1,2428,2364,64,0,130,0,6
84839,2,2401,2256,145,0,0,1,6
84840,3,2428,2351,77,0,200,0,6
84841,1,2433,2473,-40,0,50,0,6
84842,1,2318,2400,-82,0,485,0,6
84844,1,2567,2444,123,0,330,0,6
84845,3,2519,2576,-57,0,241,0,6
84846,1,2334,2420,-86,0,455,0,6
84847,1,2550,2520,30,0,258,1,6
84848,2,2267,2443,-176,0,152,0,8
84849,1,2442,2609,-167,0,140,0,6
84850,2,2676,2531,145,0,201,0,6
84851,1,2544,2391,153,0,133,1,6
84852,2,2594,2449,145,0,4,0,6
84853,1,2362,2444,-82,0,120,0,6
84854,2,2433,2422,11,0,30,1,6
84855,1,2415,2429,-14,0,0,0,6
84856,2,2349,2424,-75,0,459,0,6
84857,2,2527,2602,-75,0,271,0,6
84858,3,2468,2466,2,0,45,0,6
84859,1,2404,2477,-73,0,112,0,6
84860,3,2517,2379,138,0,140,0,6
84861,3,2402,2352,50,0,345,0,6
84862,2,2446,2318,128,0,343,1,6
84863,1,2428,2404,24,0,101,0,6
84864,1,2301,2411,-110,0,81,0,6
84865,1,2469,2418,51,0,260,1,6
84866,1,2424,2579,-155,0,270,0,6
84867,3,2210,2404,-194,4,359,0,8
84868,2,2213,2557,-344,0,145,0,6
84869,1,2552,2375,177,0,211,1,6
84870,1,2473,2237,236,0,107,1,6
84871,1,2405,2333,72,0,270,0,6
84872,1,2477,2422,55,0,301,0,6
84873,1,2440,2343,97,0,226,0,6
84874,1,2416,2434,-18,0,7,0,6
84875,1,2725,2972,-247,0,315,1,6
84876,1,2466,2382,84,0,190,0,6
84877,1,2617,2561,56,0,103,0,6
84878,1,2469,2241,228,0,40,0,6
84879,2,2393,2571,-178,0,142,0,6
84880,2,2477,2409,68,0,277,0,6
84881,2,2366,2520,-154,0,142,0,6
84882,3,2443,2376,67,0,250,0,6
84883,1,2405,2351,54,0,17,0,6
84884,2,2575,2585,-10,0,28,0,6
84885,3,2698,2688,10,0,7,0,6
84886,2,2345,2460,-115,0,300,1,6
84887,1,2488,2305,183,0,110,0,6
84888,3,2519,2478,41,0,315,0,6
84889,2,2435,2345,90,0,7,0,8
84890,1,2350,2478,-128,0,10,1,6
84891,1,2416,2367,49,0,253,0,6
84892,2,2472,2556,-84,0,463,0,6
84893,1,2476,2467,9,0,1,0,6
84894,2,2333,2473,-140,0,0,1,6
84895,2,2344,2495,-151,0,15,0,6
84896,1,2525,2423,102,0,241,1,6
84897,3,2326,2444,-118,0,40,0,6
84898,1,2599,2546,53,0,45,0,6
84899,1,2426,2247,179,0,125,0,6
84900,2,2507,2460,47,0,209,1,6
84901,2,2654,2668,-14,0,45,0,6
84902,2,2404,2282,122,0,15,0,6
84903,1,2417,2432,-15,0,485,0,6
84904,2,2437,2520,-83,0,369,0,6
84906,2,2340,2555,-215,0,153,0,6
84907,2,2426,2536,-110,0,58,0,6
84908,1,2321,2423,-102,0,130,0,6
84909,1,2515,2469,46,0,200,0,6
84910,2,2515,2555,-40,0,184,1,6
84911,1,2321,2400,-79,0,254,0,6
84912,2,2402,2362,40,0,254,0,6
84913,1,2581,2440,141,0,122,0,6
84914,1,2503,2393,110,0,253,1,6
84915,3,2432,2523,-91,0,268,0,6
84916,1,2413,2278,135,0,123,0,6
84917,3,2419,2381,38,0,302,0,6
84918,2,2556,2622,-66,0,101,1,6
84919,1,2359,2404,-45,0,109,0,6
84920,2,2571,2385,186,0,110,0,6
84921,2,2306,2432,-126,0,3,0,6
84922,1,2496,2380,116,0,132,1,6
84923,3,2339,2446,-107,0,466,0,6
84924,1,2446,2308,138,0,190,0,8
84925,2,2469,2315,154,0,40,0,6
84926,1,2569,2396,173,0,110,0,6
84927,1,2591,2571,20,0,406,0,6
84928,1,2475,2232,243,0,112,0,6
84929,2,2436,2339,97,0,373,1,6
84930,2,2540,2568,-28,0,312,1,6
84931,3,2500,2422,78,0,48,0,6
84932,2,2416,2470,-54,0,100,0,6
84933,1,2280,2428,-148,0,331,1,6
84934,2,2522,2562,-40,0,224,1,6
84935,2,2283,2421,-138,0,110,0,6
84936,2,2393,2574,-181,0,123,0,6
84937,1,2388,2471,-83,0,40,0,6
84938,2,2601,2439,162,0,150,0,6
84939,2,2288,2674,-386,0,112,0,8
84940,1,2337,2491,-154,0,140,0,6
84941,2,2417,2476,-59,0,123,1,6
84942,3,2688,2698,-10,0,40,0,6
84943,2,2409,2539,-130,0,410,1,6
84944,1,2444,2362,82,0,190,1,6
84945,2,2410,2332,78,0,331,0,6
84946,2,2367,2400,-33,0,250,0,6
84947,1,2409,2235,174,0,107,1,6
84948,1,2212,2475,-263,0,25,0,6
84949,2,2414,2377,37,0,45,0,6
84950,1,2541,2520,21,0,307,0,6
84951,2,2290,2406,-116,0,140,0,6
84952,1,2461,2464,-3,0,337,0,6
84953,1,2489,2478,11,0,50,0,6
84954,1,2429,2400,29,0,103,0,6
84955,2,2674,2649,25,0,110,0,6
84956,2,2561,2468,93,0,60,0,6
84957,1,2963,2737,226,0,453,1,6
84958,2,2386,2548,-162,0,278,0,6
84959,3,2489,2482,7,0,211,0,6
84960,3,2416,2328,88,0,345,0,6
84961,1,2436,2430,6,0,107,0,6
84962,1,2488,2244,244,0,122,1,6
84963,1,2431,2464,-33,0,240,0,6
84964,1,2432,2358,74,0,90,1,6
84965,2,2419,2529,-110,0,4,0,6
84966,2,2605,2621,-16,0,4,0,6
84967,3,2345,2403,-58,0,100,0,6
84968,2,2452,2501,-49,0,4,0,6
84969,1,2397,2429,-32,0,248,1,6
84970,2,2359,2400,-41,0,130,1,6
84971,1,2444,2341,103,0,290,0,6
84972,1,2368,2420,-52,0,255,1,8
84973,2,2253,2427,-174,0,202,0,6
84974,2,2433,2424,9,0,114,0,6
84975,1,2423,2306,117,0,1,0,6
84976,3,2536,2559,-23,0,411,0,6
84977,1,2414,2254,160,0,213,0,6
84978,2,2390,2410,-20,0,140,0,6
84979,1,2368,2534,-166,0,394,0,6
84980,3,2462,2384,78,0,11,0,6
84981,1,2400,2428,-28,0,300,0,6
84982,2,2470,2556,-86,0,9,1,6
84983,1,2464,2436,28,0,455,0,6
84984,2,2220,2407,-187,0,8,0,8
84985,1,2389,2442,-53,0,102,1,6
84986,1,2395,2584,-189,0,57,0,6
84987,1,2558,2358,200,0,211,0,6
84988,2,2627,2552,75,0,100,0,6
84989,1,2676,2357,319,0,330,0,8
84990,1,2515,2518,-3,0,102,0,6
84991,2,2356,2412,-56,0,100,0,6
84992,1,2546,2458,88,0,52,0,6
84993,2,2483,2386,97,0,135,0,6
84994,2,2270,2593,-323,0,40,0,6
84995,2,2315,2428,-113,0,202,1,8
84996,2,2434,2254,180,0,190,0,6
84997,3,2493,2447,46,0,250,0,6
84998,2,2477,2350,127,0,11,0,6
84999,1,2475,2412,63,0,277,0,6
85000,2,2284,2405,-121,0,414,0,6
85001,1,2452,2241,211,0,40,1,6
85002,1,2443,2403,40,0,140,0,6
85003,3,2339,2403,-64,0,10,0,6
85004,1,2513,2524,-11,0,125,0,6
85005,2,2383,2535,-152,0,123,1,6
85006,1,2698,2689,9,0,250,0,6
85007,3,2222,2467,-245,0,11,0,6
85008,2,2466,2233,233,0,111,0,6
85009,2,2567,2415,152,0,145,0,6
85010,3,2486,2566,-80,0,50,0,6
85011,3,2363,2402,-39,0,265,0,6
85013,1,2506,2415,91,0,180,0,6
85014,1,2655,2668,-13,0,45,0,6
85015,1,2475,2554,-79,0,353,0,6
85016,1,2521,2340,181,0,398,0,6
85017,3,2402,2507,-105,0,108,0,6
85018,2,2438,2449,-11,0,110,1,6
85019,2,2353,2539,-186,0,1,0,6
85020,1,2559,2485,74,0,106,1,6
85021,3,2469,2599,-130,0,30,0,6
85022,2,2298,2414,-116,0,130,0,6
85023,2,2330,2458,-128,0,300,1,6
85024,2,2362,2433,-71,0,250,0,6
85025,2,2461,2333,128,0,300,0,6
85026,1,2533,2415,118,0,360,0,6
85027,2,2427,2384,43,0,418,1,6
85028,2,2482,2489,-7,0,106,0,6
85029,2,2257,2449,-192,0,150,0,8
85030,2,2531,2596,-65,0,270,0,6
85031,2,2281,2490,-209,0,100,0,6
85032,2,2298,2469,-171,0,200,1,6
85033,1,2302,2427,-125,0,45,1,6
85034,3,2406,2437,-31,0,45,0,6
85035,1,2429,2313,116,4,103,0,13
85036,1,2576,2461,115,0,122,0,6
85037,1,2377,2401,-24,0,321,0,6
85038,2,2259,2434,-175,0,127,0,6
85039,1,2402,2259,143,0,0,0,6
85040,1,2405,2368,37,0,415,0,6
85041,1,2421,2417,4,0,394,0,6
85042,1,2546,2466,80,0,270,0,6
85043,1,2360,2403,-43,0,48,0,6
85044,2,2523,2297,226,0,254,0,6
85045,2,2497,2682,-185,0,335,0,6
85046,1,2430,2259,171,0,404,0,6
85047,2,2734,2965,-231,0,486,0,6
85048,1,2518,2543,-25,0,203,0,6
85049,2,2426,2403,23,0,131,0,6
85050,2,2523,2616,-93,0,112,1,6
85051,1,2564,2488,76,0,143,0,6
85052,3,2683,2703,-20,0,40,0,6
85053,2,2499,2692,-193,0,4,0,6
85054,2,2542,2447,95,0,4,0,6
85055,3,2436,2380,56,0,18,0,6
85056,2,2475,2513,-38,0,107,1,6
85057,3,2454,2551,-97,0,69,0,6
85058,1,2462,2202,260,0,346,0,6
85059,2,2350,2521,-171,0,15,0,6
85060,3,2417,2351,66,0,8,0,6
85061,2,2485,2401,84,0,405,0,6
85062,2,2448,2492,-44,0,80,0,6
85063,2,2290,2413,-123,0,20,0,6
85064,1,2502,2215,287,4,118,0,8
85065,2,2401,2409,-8,0,302,0,6
85066,1,2662,2661,1,0,110,0,6
85067,2,2431,2498,-67,0,45,0,6
85068,2,2401,2408,-7,0,127,0,6
85069,1,2356,2678,-322,0,344,0,8
85070,1,2495,2453,42,0,123,0,6
85071,1,2467,2363,104,0,41,0,6
85072,1,2501,2241,260,0,214,0,6
85073,1,2466,2439,27,0,306,0,6
85074,1,2524,2400,124,0,101,0,6
85075,1,2547,2482,65,0,140,0,6
85076,1,2519,2347,172,0,44,0,6
85077,2,2402,2391,11,0,141,0,6
85078,1,2418,2314,104,0,406,0,6
85079,2,2411,2537,-126,0,1,1,6
85080,2,2596,2597,-1,0,8,0,6
85081,1,2458,2298,160,0,123,0,6
85082,2,2462,2471,-9,0,102,0,6
85083,1,2473,2239,234,4,108,0,0
85084,1,2493,2455,38,0,101,0,6
85085,1,2535,2510,25,0,4,1,6
85086,2,2300,2409,-109,4,48,0,13
85087,1,2407,2479,-72,0,100,0,6
85088,2,2569,2559,10,0,157,0,6
85089,1,2437,2401,36,0,220,0,6
85090,2,2430,2428,2,0,122,0,6
85091,1,2563,2573,-10,0,113,0,6
85092,2,2355,2560,-205,0,1,0,6
85093,1,2415,2375,40,0,344,0,6
85094,1,2594,2321,273,0,124,0,6
85095,1,2438,2389,49,0,199,0,6
85096,2,2234,2405,-171,0,4,0,6
85097,1,2416,2466,-50,0,107,0,6
85098,3,2421,2353,68,0,0,0,6
85099,1,2278,2423,-145,0,110,0,6
85100,3,2464,2233,231,0,107,0,6
85101,1,2390,2420,-30,0,45,1,6
85102,2,2404,2419,-15,0,120,0,6
85103,3,2460,2346,114,0,141,0,6
85104,1,2565,2570,-5,0,110,0,6
85105,3,2473,2312,161,0,10,0,6
85106,1,2536,2524,12,0,120,0,6
85107,3,2436,2383,53,0,15,0,6
85108,3,2505,2404,101,0,222,0,6
85109,2,2461,2468,-7,0,35,1,6
85110,2,2577,2410,167,0,40,0,6
85111,1,2418,2229,189,0,0,0,6
85112,1,2448,2308,140,0,112,0,6
85113,1,2360,2404,-44,0,133,0,6
85114,1,2427,2496,-69,0,457,0,6
85115,1,2411,2311,100,0,151,0,6
85116,3,2508,2655,-147,0,112,0,6
85117,1,2403,2383,20,0,241,1,6
85118,1,2456,2356,100,0,6,0,6
85119,1,2549,2434,115,0,306,0,6
85120,2,2359,2457,-98,0,126,0,6
85121,1,2299,2465,-166,0,125,0,6
85122,2,2349,2470,-121,0,25,0,6
85123,2,2470,2475,-5,0,20,0,6
85125,3,2478,2435,43,0,41,0,6
85126,1,2504,2426,78,0,48,0,6
85127,2,2478,2551,-73,0,320,0,6
85128,2,2620,2546,74,0,40,1,6
85129,1,2510,2319,191,0,123,0,6
85130,2,2620,2590,30,0,140,0,6
85131,2,2505,2306,199,0,152,0,6
85132,2,2414,2603,-189,0,106,0,6
85133,3,2457,2296,161,0,158,0,6
85134,2,2567,2565,2,0,15,0,6
85135,2,2528,2605,-77,0,243,0,6
85136,1,2391,2444,-53,0,100,1,6
85137,1,2563,2569,-6,0,110,0,6
85138,2,2577,2552,25,0,13,0,6
85139,1,2968,2731,237,0,110,0,6
85140,2,2415,2359,56,0,99,0,6
85141,1,2541,2500,41,0,473,0,6
85142,2,2455,2546,-91,0,45,1,6
85143,1,2429,2286,143,0,136,1,6
85144,2,2477,2457,20,0,22,0,6
85145,1,2482,2432,50,0,385,0,6
85146,1,2396,2474,-78,0,406,1,6
85147,2,2460,2423,37,0,123,0,6
85148,3,2406,2294,112,0,453,0,6
85149,2,2422,2510,-88,0,43,0,6
85150,1,2685,2494,191,0,470,0,6
85151,1,2408,2270,138,0,201,0,6
85152,2,2672,2563,109,0,14,0,6
85153,1,2316,2425,-109,0,172,1,6
85155,1,2505,2540,-35,0,112,0,6
85156,3,2379,2443,-64,0,102,0,6
85157,2,2430,2569,-139,0,140,0,6
85158,1,2377,2416,-39,0,10,0,6
85159,2,2277,2420,-143,0,200,0,6
85160,3,2370,2436,-66,0,17,0,6
85161,1,2336,2451,-115,0,138,0,6
85162,2,2517,2404,113,0,254,0,6
85163,2,2352,2416,-64,0,102,0,6
85164,2,2457,2613,-156,0,108,0,6
85165,2,2384,2408,-24,0,317,0,6
85166,1,2571,2562,9,0,111,1,6
85167,2,2399,2400,-1,0,140,0,6
85168,1,2304,2452,-148,0,244,0,6
85169,2,2369,2427,-58,0,484,1,6
85170,1,2398,2519,-121,0,198,0,6
85171,1,2449,2386,63,0,102,0,6
85172,1,2440,2316,124,0,100,0,6
85173,1,2474,2455,19,0,46,0,6
85174,1,2489,2434,55,0,7,0,6
85175,2,2420,2444,-24,0,40,0,6
85176,1,2516,2418,98,0,459,0,6
85177,1,2439,2356,83,0,17,1,6
85178,1,2300,2452,-152,0,373,1,8
85179,1,2511,2518,-7,0,105,1,6
85180,1,2606,2653,-47,0,311,0,6
85181,1,2461,2355,106,0,10,0,6
85182,1,2563,2551,12,0,132,0,6
85183,3,2563,2352,211,0,211,0,6
85184,1,2465,2411,54,0,455,1,6
85185,1,2556,2473,83,0,60,1,6
85186,2,2436,2569,-133,0,120,0,6
85187,2,2431,2442,-11,0,127,0,6
85188,2,2597,2469,128,0,132,0,6
85189,1,2504,2509,-5,0,101,0,6
85190,2,2614,2614,0,0,406,0,6
85192,2,2413,2521,-108,0,16,0,6
85193,1,2457,2406,51,0,205,0,6
85194,2,2571,2523,48,0,154,1,6
85195,2,2374,2487,-113,0,106,0,6
85196,1,2449,2332,117,0,255,0,6
85197,1,2471,2289,182,0,28,0,6
85198,2,2546,2479,67,0,56,0,6
85199,1,2427,2495,-68,0,106,1,6
85200,1,2728,2970,-242,0,127,0,6
85201,2,2463,2275,188,0,132,0,6
85202,2,2384,2572,-188,0,48,0,6
85203,1,2444,2427,17,0,133,0,6
85204,2,2327,2472,-145,0,229,0,6
85205,1,2331,2402,-71,4,110,0,13
85206,2,2413,2511,-98,0,400,0,6
85207,2,2414,2378,36,0,474,0,6
85208,1,2454,2292,162,0,469,0,6
85209,1,2465,2336,129,0,459,0,6
85210,1,2397,2444,-47,0,40,1,6
85211,1,2409,2363,46,0,110,0,6
85212,2,2511,2450,61,0,100,0,6
85213,1,2467,2386,81,0,204,0,6
85214,1,2437,2403,34,0,101,0,6
85215,1,2647,2613,34,0,45,1,6
85216,2,2418,2377,41,0,22,0,6
85217,3,2571,2534,37,0,115,0,6
85218,1,2308,2423,-115,0,200,0,6
85219,1,2343,2510,-167,0,241,0,6
85220,2,2524,2526,-2,0,492,0,6
85221,2,2393,2441,-48,0,348,0,6
85222,2,2241,2413,-172,0,295,1,6
85223,1,2545,2569,-24,0,110,0,6
85224,2,2589,2608,-19,0,8,0,6
85225,2,2312,2403,-91,0,4,0,6
85226,3,2400,2322,78,0,4,0,6
85227,1,2520,2491,29,0,45,0,6
85228,2,2251,2408,-157,0,180,1,6
85229,1,2595,2620,-25,0,101,0,6
85230,1,2354,2415,-61,0,338,1,6
85231,1,2512,2462,50,0,46,0,6
85232,1,2505,2516,-11,0,141,0,6
85233,1,2449,2343,106,0,43,1,6
85234,2,2429,2494,-65,0,460,0,6
85235,2,2431,2369,62,0,192,0,6
85236,1,2460,2347,113,0,48,0,6
85237,2,2524,2556,-32,0,311,0,6
85238,1,2573,2454,119,0,205,0,6
85239,1,2378,2460,-82,0,45,1,6
85240,3,2349,2474,-125,0,201,0,6
85241,1,2454,2470,-16,0,202,1,6
85242,2,2412,2504,-92,0,43,0,6
85243,2,2469,2561,-92,0,152,0,6
85244,2,2406,2438,-32,0,110,0,6
85245,2,2613,2586,27,0,43,1,6
85246,1,2570,2664,-94,0,5,1,6
85247,1,2565,2460,105,0,128,0,6
85248,1,2411,2420,-9,0,308,1,6
85249,2,2582,2553,29,0,100,0,6
85250,1,2407,2380,27,0,341,1,6
85251,1,2530,2540,-10,0,132,1,6
85252,1,2575,2576,-1,0,406,0,6
85253,2,2486,2434,52,0,48,0,6
85254,1,2380,2472,-92,0,333,0,6
85255,1,2418,2421,-3,0,306,0,6
85256,1,2427,2409,18,0,176,0,6
85257,1,2409,2388,21,0,30,0,6
85258,3,2522,2344,178,0,300,0,6
85259,2,2355,2560,-205,0,62,0,6
85260,2,2437,2315,122,0,140,1,6
85261,2,2516,2425,91,0,289,1,6
85262,1,2532,2499,33,0,4,1,6
85263,1,2291,2477,-186,0,40,1,8
85264,2,2614,2577,37,0,140,0,6
85265,2,2385,2471,-86,0,394,0,6
85266,1,2408,2307,101,0,360,1,6
85267,1,2508,2298,210,0,268,0,6
85268,3,2444,2336,108,0,135,0,8
85269,1,2607,2652,-45,0,1,0,6
85270,2,2341,2419,-78,0,120,0,6
85271,2,2238,2425,-187,0,154,0,6
85272,2,2574,2535,39,0,115,0,6
85273,2,2325,2487,-162,0,111,0,6
85274,1,2517,2605,-88,0,49,1,6
85275,2,2278,2422,-144,0,110,1,6
85276,3,2407,2284,123,0,122,0,6
85277,1,2961,2739,222,0,100,0,6
85278,1,2563,2552,11,0,106,0,6
85279,1,2457,2462,-5,0,182,1,6
85280,1,2446,2443,3,0,414,0,6
85281,1,2511,2569,-58,0,112,0,6
85282,2,2354,2409,-55,0,130,0,6
85283,2,2334,2406,-72,0,0,0,6
85284,2,2408,2284,124,0,486,0,6
85285,2,2383,2414,-31,0,143,1,6
85286,2,2475,2351,124,0,107,0,6
85287,2,2502,2616,-114,0,302,0,6
85288,1,2596,2283,313,0,127,0,6
85289,1,2419,2248,171,0,0,0,6
85290,2,2519,2392,127,0,50,0,6
85291,2,2343,2465,-122,0,107,0,6
85292,1,2464,2433,31,0,39,0,6
85293,1,2401,2446,-45,0,100,0,6
85294,1,2465,2390,75,0,201,0,6
85295,2,2411,2460,-49,0,200,0,6
85296,1,2565,2465,100,0,426,1,6
85297,3,2486,2351,135,0,436,0,6
85298,1,2592,2607,-15,0,45,0,6
85299,3,2646,2614,32,0,45,0,6
85300,2,2416,2424,-8,0,130,0,6
85301,1,2252,2403,-151,0,133,1,6
85302,2,2518,2322,196,0,190,0,6
85303,3,2511,2393,118,0,152,0,6
85304,1,2581,2419,162,0,338,0,6
85305,3,2586,2536,50,0,7,0,6
85306,2,2412,2248,164,0,114,0,6
85307,1,2534,2480,54,0,302,1,6
85308,2,2410,2541,-131,0,113,0,6
85309,2,2346,2520,-174,0,46,1,6
85310,2,2408,2380,28,0,49,0,6
85311,1,2303,2412,-109,0,337,1,6
85312,2,2381,2468,-87,0,57,0,6
85313,2,2607,2568,39,0,247,0,6
85314,1,2241,2526,-285,0,354,0,6
85315,3,2409,2571,-162,0,45,0,6
85316,2,2432,2508,-76,0,400,1,6
85317,2,2446,2583,-137,0,45,0,6
85318,2,2598,2569,29,0,110,1,6
85319,2,2664,2524,140,0,102,0,6
85320,1,2453,2373,80,0,4,1,6
85321,2,2323,2400,-77,0,277,1,6
85322,1,2494,2406,88,0,4,1,6
85323,2,2292,2454,-162,0,405,1,6
85324,1,2657,2578,79,0,14,0,6
85325,1,2427,2282,145,0,15,1,6
85326,1,2545,2569,-24,0,7,0,6
85327,2,2406,2469,-63,0,202,0,6
85328,1,2313,2453,-140,0,122,0,6
85329,1,2490,2346,144,0,242,1,6
85330,2,2405,2451,-46,0,11,1,6
85331,1,2402,2265,137,0,1,0,6
85332,1,2286,2443,-157,0,107,0,6
85333,2,2384,2469,-85,0,433,0,6
85334,1,2527,2468,59,0,485,0,6
85335,1,2618,2603,15,0,201,0,6
85336,1,2495,2517,-22,0,121,0,6
85337,2,2321,2448,-127,0,45,0,6
85338,3,2450,2562,-112,0,113,0,6
85339,2,2736,2963,-227,0,253,0,6
85340,2,2563,2688,-125,0,292,1,6
85341,1,2295,2406,-111,0,250,0,6
85342,1,2597,2624,-27,0,3,0,6
85343,3,2221,2421,-200,0,122,0,8
85344,1,2456,2498,-42,0,315,1,6
85345,1,2410,2261,149,0,0,0,6
85346,1,2428,2429,-1,0,4,0,6
85347,3,2448,2420,28,0,46,0,6
85348,1,2561,2601,-40,0,409,0,6
85349,1,2410,2415,-5,0,122,0,6
85350,2,2509,2448,61,0,242,0,6
85351,3,2331,2512,-181,0,81,0,6
85352,1,2313,2471,-158,0,20,1,6
85353,1,2439,2407,32,0,127,1,6
85354,3,2601,2598,3,0,43,0,6
85355,1,2387,2431,-44,0,394,1,6
85356,1,2458,2537,-79,0,103,0,6
85357,3,2461,2569,-108,0,4,0,6
85358,1,2419,2498,-79,0,16,0,6
85359,1,2349,2473,-124,0,218,0,6
85360,2,2403,2320,83,0,245,0,6
85361,2,2463,2534,-71,0,45,1,6
85362,1,2402,2475,-73,0,241,0,6
85363,1,2555,2537,18,0,354,0,6
85364,1,2614,2645,-31,0,1,0,6
85365,1,2342,2452,-110,0,11,0,6
85366,2,2561,2538,23,0,154,1,6
85367,3,2502,2296,206,0,281,0,6
85368,1,2415,2339,76,0,243,1,6
85369,1,2326,2408,-82,0,192,0,6
85370,2,2426,2466,-40,0,331,0,6
85371,2,2400,2370,30,0,352,0,6
85372,2,2475,2539,-64,0,48,1,6
85373,3,2391,2443,-52,0,375,0,8
85374,1,2469,2340,129,0,48,0,6
85375,1,2523,2343,180,0,45,0,6
85376,2,2511,2587,-76,0,140,0,6
85377,3,2417,2442,-25,0,81,0,6
85378,1,2335,2427,-92,0,330,1,6
85379,2,2423,2438,-15,0,307,0,6
85380,1,2474,2412,62,0,11,1,6
85381,1,2449,2402,47,0,122,0,6
85382,3,2311,2401,-90,0,40,0,6
85383,3,2563,2575,-12,0,110,0,6
85384,2,2402,2294,108,0,302,0,6
85385,2,2551,2657,-106,0,8,1,6
85386,2,2405,2319,86,0,485,0,6
85387,2,2457,2474,-17,0,440,0,6
85388,3,2571,2430,141,0,4,0,6
85389,2,2290,2434,-144,0,40,0,6
85390,3,2446,2434,12,0,45,0,6
85391,2,2337,2503,-166,0,205,0,6
85392,3,2574,2577,-3,0,151,0,6
85393,1,2471,2455,16,0,302,1,6
85394,1,2329,2444,-115,0,216,1,6
85395,3,2380,2413,-33,0,176,0,6
85396,1,2584,2595,-11,0,411,0,6
85397,1,2330,2499,-169,0,112,0,6
85398,1,2530,2349,181,0,1,0,6
85399,2,2391,2400,-9,0,43,0,6
85400,2,2501,2434,67,0,221,0,6
85401,1,2966,2733,233,0,110,0,6
85402,2,2418,2586,-168,0,107,0,6
85403,1,2509,2409,100,0,107,0,6
85404,1,2425,2334,91,0,190,1,6
85405,3,2495,2235,260,0,200,0,6
85406,2,2639,2621,18,0,41,1,6
85407,1,2443,2531,-88,0,302,0,6
85408,1,2402,2445,-43,0,132,0,6
85409,2,2418,2401,17,0,13,1,6
85410,1,2553,2492,61,0,315,0,6
85411,2,2617,2603,14,0,101,1,6
85412,2,2433,2458,-25,0,140,0,6
85413,2,2465,2462,3,0,218,0,6
85414,3,2416,2426,-10,0,0,0,6
85415,2,2454,2388,66,0,106,1,6
85416,2,2567,2462,105,0,487,1,6
85417,3,2510,2499,11,0,107,0,6
85418,1,2505,2370,135,0,339,0,6
85419,1,2463,2462,1,0,302,0,6
85420,2,2573,2661,-88,0,255,0,6
85421,1,2412,2366,46,0,46,0,6
85422,2,2301,2426,-125,0,245,1,6
85423,2,2278,2406,-128,0,100,1,6
85424,1,2511,2491,20,0,268,0,6
85425,1,2464,2323,141,0,352,0,6
85426,2,2398,2452,-54,0,315,1,6
85427,1,2494,2545,-51,0,122,0,6
85428,2,2262,2592,-330,0,335,0,6
85429,2,2545,2555,-10,0,300,0,6
85430,1,2540,2458,82,0,106,0,6
85431,1,2434,2263,171,0,190,1,6
85432,1,2580,2577,3,0,194,0,6
85433,2,2350,2410,-60,0,245,0,6
85434,1,2349,2416,-67,0,305,1,6
85435,2,2543,2470,73,0,56,1,6
85436,1,2456,2526,-70,0,46,0,6
85437,1,2414,2377,37,0,81,0,6
85438,1,2479,2452,27,0,255,1,6
85439,2,2358,2457,-99,0,113,0,6
85440,1,2350,2415,-65,0,100,0,6
85441,1,2564,2550,14,0,65,0,6
85442,2,2467,2478,-11,0,8,0,6
85443,2,2591,2561,30,0,110,0,6
85444,1,2575,2469,106,0,190,0,6
85445,1,2406,2385,21,0,214,0,6
85446,2,2547,2459,88,0,5,0,6
85447,1,2418,2326,92,0,45,1,6
85448,1,2489,2407,82,0,300,0,6
85449,1,2437,2316,121,0,300,0,6
85450,2,2447,2411,36,0,313,1,6
85451,2,2353,2484,-131,0,45,0,6
85452,1,2334,2420,-86,0,278,1,6
85453,1,2438,2409,29,0,127,0,6
85454,2,2487,2477,10,0,302,0,6
85456,1,2452,2267,185,0,107,0,6
85457,1,2441,2533,-92,0,128,0,6
85458,3,2500,2511,-11,0,101,0,6
85459,2,2359,2510,-151,0,46,0,8
85460,1,2539,2590,-51,0,10,0,6
85461,2,2524,2501,23,0,132,0,6
85462,2,2450,2383,67,0,101,0,6
85463,1,2442,2298,144,0,266,0,8
85464,1,2691,2559,132,0,438,0,6
85465,1,2627,2633,-6,0,123,0,6
85466,2,2330,2416,-86,0,40,1,6
85467,1,2430,2356,74,0,28,0,6
85468,1,2470,2560,-90,0,172,0,6
85469,1,2454,2324,130,0,353,0,6
85470,1,2486,2517,-31,0,5,0,6
85471,2,2609,2612,-3,0,0,0,6
85472,2,2516,2344,172,0,111,0,6
85473,2,2463,2393,70,0,15,0,6
85474,2,2335,2421,-86,0,14,1,6
85475,2,2334,2468,-134,0,58,1,6
85476,3,2336,2473,-137,0,202,0,6
85477,2,2324,2593,-269,0,3,0,6
85478,1,2447,2266,181,0,250,0,6
85479,1,2402,2404,-2,0,70,0,6
85480,2,2433,2434,-1,0,53,0,6
85481,1,2443,2263,180,0,9,0,6
85482,1,2436,2288,148,0,4,0,6
85483,1,2457,2583,-126,0,181,0,6
85484,2,2381,2526,-145,0,128,1,6
85485,1,2511,2346,165,0,152,0,6
85486,2,2445,2277,168,0,147,0,8
85487,1,2589,2585,4,0,140,1,6
85488,1,2440,2400,40,0,107,0,6
85489,3,2532,2493,39,0,302,0,6
85490,2,2731,2968,-237,0,102,0,6
85491,1,2458,2289,169,0,300,1,6
85492,2,2317,2458,-141,0,113,0,6
85493,2,2403,2519,-116,0,41,0,6
85494,1,2430,2299,131,0,226,0,6
85495,1,2568,2560,8,0,9,0,6
85496,1,2260,2411,-151,0,132,0,6
85497,3,2477,2536,-59,0,0,0,6
85498,1,2666,2569,97,0,5,0,6
85499,3,2446,2484,-38,0,50,0,6
85500,1,2466,2540,-74,0,115,0,6
85501,1,2579,2478,101,0,113,0,6
85502,2,2409,2296,113,0,122,1,6
85503,1,2481,2465,16,0,43,0,6
85504,2,2403,2441,-38,0,200,0,6
85505,2,2545,2446,99,0,226,0,6
85506,1,2410,2385,25,0,1,1,6
85507,2,2449,2511,-62,0,184,1,6
85508,2,2450,2394,56,0,203,1,6
85509,1,2577,2545,32,0,278,0,6
85510,1,2380,2411,-31,0,10,0,6
85511,1,2462,2439,23,0,112,0,6
85512,1,2492,2484,8,0,5,0,6
85513,2,2249,2419,-170,0,110,0,6
85514,1,2617,2604,13,0,262,1,6
85515,2,2584,2385,199,0,315,0,6
85516,2,2569,2400,169,0,15,0,6
85517,2,2322,2422,-100,0,134,0,6
85518,1,2555,2573,-18,0,115,0,6
85519,1,2483,2538,-55,0,46,0,6
85520,1,2627,2567,60,0,300,0,6
85521,1,2518,2461,57,0,244,0,6
85522,2,2461,2507,-46,0,15,0,6
85523,1,2391,2508,-117,0,395,0,6
85524,3,2500,2405,95,0,151,0,6
85525,1,2413,2343,70,0,398,1,6
85526,2,2288,2440,-152,0,25,0,6
85527,1,2418,2398,20,0,331,1,6
85528,1,2444,2463,-19,0,111,1,6
85529,2,2275,2595,-320,0,241,1,6
85530,1,2460,2283,177,0,487,0,6
85531,2,2285,2465,-180,0,310,0,6
85532,2,2447,2327,120,0,374,1,6
85533,3,2412,2442,-30,0,40,0,6
85534,2,2453,2326,127,0,192,0,6
85535,1,2343,2417,-74,0,269,0,6
85536,2,2222,2408,-186,0,19,0,6
85537,2,2469,2322,147,0,210,0,6
85538,1,2573,2563,10,0,442,0,6
85539,2,2276,2425,-149,0,40,0,6
85540,2,2461,2331,130,0,112,0,6
85541,1,2280,2433,-153,0,40,1,6
85542,2,2394,2403,-9,0,40,0,6
85543,2,2434,2465,-31,0,300,0,6
85544,2,2515,2287,228,0,0,1,6
85545,2,2434,2532,-98,0,18,0,6
85546,2,2470,2392,78,0,307,0,6
85547,1,2341,2463,-122,0,8,0,6
85548,3,2515,2487,28,0,101,0,6
85549,2,2403,2286,117,0,343,0,6
85550,1,2532,2574,-42,0,267,0,6
85551,1,2403,2394,9,0,36,0,6
85552,2,2506,2632,-126,0,110,0,6
85553,1,2529,2448,81,0,312,0,6
85554,1,2575,2445,130,0,300,1,6
85555,2,2429,2533,-104,0,345,1,6
85556,2,2459,2583,-124,0,412,0,6
85557,2,2446,2299,147,0,300,1,6
85558,3,2500,2406,94,0,151,0,6
85559,2,2399,2467,-68,0,40,0,6
85560,2,2474,2540,-66,0,330,0,6
85561,2,2404,2398,6,0,210,0,6
85562,2,2536,2478,58,0,56,0,6
85563,1,2498,2447,51,0,4,0,6
85564,3,2376,2498,-122,0,490,0,6
85566,1,2468,2470,-2,0,101,0,6
85567,2,2400,2443,-43,0,325,0,6
85568,1,2478,2361,117,0,39,0,6
85569,1,2484,2429,55,0,300,0,6
85570,2,2256,2425,-169,0,115,0,6
85571,1,2405,2288,117,0,460,0,6
85572,2,2443,2523,-80,0,6,0,6
85573,1,2456,2364,92,0,306,1,6
85574,2,2400,2500,-100,0,440,0,6
85575,3,2456,2365,91,0,41,0,6
85576,2,2402,2445,-43,0,0,0,6
85577,2,2422,2285,137,0,101,0,6
85578,2,2428,2357,71,0,122,0,6
85579,2,2534,2546,-12,0,4,1,6
85580,2,2292,2426,-134,0,45,1,6
85581,1,2561,2539,22,0,128,0,6
85582,3,2598,2623,-25,0,3,0,6
85583,2,2390,2490,-100,0,260,0,6
85584,1,2473,2350,123,0,409,0,6
85585,2,2404,2446,-42,0,255,0,6
85586,1,2330,2499,-169,0,2,1,6
85587,1,2531,2513,18,0,102,0,6
85588,2,2463,2529,-66,0,321,0,6
85589,3,2440,2441,-1,0,34,0,6
85590,1,2503,2482,21,0,207,0,6
85591,1,2357,2410,-53,0,11,1,6
85592,2,2343,2410,-67,0,5,0,6
85593,1,2399,2449,-50,0,306,1,6
85594,1,2597,2595,2,0,101,0,6
85595,3,2565,2670,-105,0,255,0,6
85596,1,2416,2366,50,0,300,0,6
85597,1,2448,2461,-13,0,325,0,6
85598,1,2427,2456,-29,0,404,1,6
85599,2,2545,2615,-70,0,46,0,6
85600,1,2363,2407,-44,0,120,0,6
85601,2,2384,2415,-31,0,100,0,6
85602,1,2354,2400,-46,0,193,0,6
85603,1,2556,2446,110,0,267,0,6
85604,3,2414,2506,-92,0,77,0,6
85605,2,2444,2578,-134,0,106,0,6
85606,2,2437,2450,-13,0,132,1,6
85607,2,2338,2453,-115,0,20,0,6
85608,3,2557,2500,57,0,125,0,6
85609,2,2409,2439,-30,0,130,0,6
85610,1,2485,2472,13,0,394,0,6
85611,2,2528,2395,133,0,132,0,6
85612,2,2386,2421,-35,0,41,0,6
85613,2,2423,2380,43,0,330,0,6
85614,1,2429,2277,152,0,40,0,6
85615,3,2280,2437,-157,0,123,0,8
85616,1,2387,2421,-34,0,315,0,6
85617,1,2464,2474,-10,0,245,0,6
85618,2,2353,2487,-134,0,116,1,6
85619,1,2294,2442,-148,0,244,1,6
85620,1,2515,2346,169,0,154,0,6
85621,1,2413,2560,-147,0,40,1,6
85622,2,2400,2398,2,0,128,0,6
85623,3,2424,2438,-14,0,300,0,6
85624,2,2425,2503,-78,0,45,1,6
85625,2,2415,2213,202,4,28,0,13
85626,1,2521,2587,-66,0,45,0,6
85627,1,2622,2599,23,0,107,0,6
85628,1,2485,2529,-44,0,302,0,6
85629,1,2448,2394,54,0,107,0,6
85630,2,2418,2403,15,0,40,0,6
85631,2,2405,2520,-115,0,156,0,6
85632,2,2298,2454,-156,0,245,0,6
85633,1,2315,2477,-162,0,210,0,6
85634,3,2552,2528,24,0,102,0,6
85635,1,2426,2399,27,0,4,0,6
85636,1,2474,2509,-35,0,160,0,6
85637,3,2422,2417,5,0,115,0,6
85638,1,2444,2397,47,0,6,1,6
85639,2,2451,2338,113,0,210,0,6
85640,1,2426,2295,131,0,115,1,6
85641,2,2508,2494,14,0,302,0,6
85642,2,2458,2460,-2,0,40,1,6
85643,2,2375,2408,-33,0,108,0,6
85644,1,2351,2404,-53,0,300,0,6
85645,1,2442,2560,-118,0,123,0,6
85646,2,2264,2430,-166,0,250,1,6
85647,2,2534,2490,44,0,311,0,6
85648,1,2589,2566,23,0,112,1,6
85649,2,2467,2405,62,0,247,0,6
85650,2,2251,2508,-257,4,255,0,8
85651,2,2284,2456,-172,0,150,1,8
85652,1,2454,2457,-3,0,345,1,6
85653,2,2259,2438,-179,0,202,0,6
85654,2,2215,2497,-282,0,300,0,6
85655,2,2274,2432,-158,0,336,0,6
85656,1,2441,2457,-16,0,110,0,6
85657,2,2309,2428,-119,0,242,1,6
85658,2,2470,2424,46,0,112,0,6
85659,2,2534,2559,-25,0,241,0,6
85660,1,2503,2518,-15,0,3,0,6
85661,1,2628,2470,158,0,119,0,6
85662,2,2455,2468,-13,0,211,0,6
85663,1,2582,2450,132,0,463,0,6
85664,1,2460,2337,123,0,247,1,6
85665,2,2401,2412,-11,0,302,0,6
85666,1,2531,2429,102,0,143,0,6
85667,2,2469,2322,147,0,459,0,6
85668,2,2472,2389,83,0,458,0,6
85669,1,2561,2453,108,0,320,0,6
85670,2,2282,2417,-135,0,200,0,6
85671,3,2443,2363,80,0,184,0,6
85672,3,2394,2403,-9,0,374,0,6
85673,2,2461,2346,115,0,13,0,6
85674,1,2470,2347,123,0,310,0,6
85675,2,2386,2450,-64,0,45,0,6
85676,1,2491,2471,20,0,48,1,6
85677,3,2344,2526,-182,0,101,0,6
85678,3,2226,2433,-207,0,250,0,6
85679,1,2418,2421,-3,0,142,1,6
85680,2,2421,2272,149,0,48,0,6
85681,1,2297,2409,-112,0,130,0,6
85682,1,2668,2566,102,0,8,0,6
85683,1,2412,2528,-116,0,107,0,6
85684,3,2441,2379,62,0,300,0,6
85685,2,2503,2481,22,0,484,0,6
85686,2,2455,2507,-52,0,315,0,6
85687,2,2434,2294,140,0,331,0,6
85688,2,2523,2492,31,0,56,1,6
85689,1,2524,2580,-56,0,115,1,6
85690,2,2425,2535,-110,0,211,0,6
85691,2,2455,2512,-57,0,380,0,6
85692,3,2500,2509,-9,0,81,0,6
85693,3,2441,2364,77,0,40,0,6
85694,3,2432,2394,38,0,4,0,6
85695,1,2394,2449,-55,0,123,1,6
85696,1,2447,2586,-139,0,106,0,6
85697,1,2435,2270,165,0,41,0,6
85698,2,2453,2431,22,0,11,0,6
85699,2,2292,2442,-150,0,300,0,6
85700,1,2413,2317,96,0,1,0,6
85701,1,2466,2452,14,0,28,0,6
85702,3,2392,2430,-38,0,112,0,6
85703,3,2594,2557,37,0,247,0,6
85704,2,2497,2527,-30,0,308,0,6
85705,1,2567,2528,39,0,140,0,6
85706,2,2354,2491,-137,0,2,0,6
85707,1,2397,2403,-6,0,202,0,6
85708,1,2466,2631,-165,0,313,0,6
85709,2,2365,2425,-60,0,16,0,6
85710,1,2552,2450,102,0,245,0,6
85711,1,2501,2648,-147,0,244,1,6
85712,2,2201,2479,-278,0,201,0,6
85713,1,2433,2561,-128,0,302,0,6
85714,3,2361,2433,-72,0,404,0,6
85715,1,2405,2249,156,4,330,0,13
85716,2,2267,2439,-172,0,40,0,6
85717,1,2460,2447,13,0,335,0,6
85718,1,2443,2464,-21,0,394,0,6
85719,2,2414,2339,75,0,101,0,6
85720,1,2418,2326,92,0,8,0,6
85721,1,2431,2464,-33,0,300,1,6
85722,2,2274,2440,-166,0,153,0,6
85723,1,2429,2537,-108,0,5,0,6
85724,1,2640,2598,42,0,216,1,6
85725,1,2403,2367,36,0,470,1,6
85726,1,2315,2409,-94,0,129,0,6
85727,2,2465,2589,-124,0,463,1,6
85728,2,2541,2292,249,0,45,1,6
85729,2,2565,2579,-14,0,57,1,6
85730,2,2402,2401,1,0,414,1,6
85731,1,2559,2517,42,0,45,0,6
85732,2,2250,2481,-231,0,90,0,6
85733,1,2695,2553,142,0,201,0,6
85734,1,2374,2419,-45,0,22,0,8
85735,3,2367,2411,-44,0,22,0,8
85736,3,2412,2452,-40,0,104,0,8
85737,2,2399,2449,-50,0,7,0,6
85738,1,2545,2365,180,0,45,0,6
85739,1,2509,2521,-12,0,2,0,6
85740,3,2447,2472,-25,0,226,0,6
85741,2,2327,2437,-110,0,301,0,8
85742,1,2440,2420,20,0,40,0,6
85743,2,2441,2500,-59,0,249,1,6
85744,2,2433,2343,90,0,122,0,8
85745,1,2426,2450,-24,0,325,0,6
85746,1,2442,2264,178,0,167,0,6
85747,2,2492,2424,68,0,320,0,6
85748,1,2459,2286,173,0,101,0,8
85749,2,2579,2594,-15,0,101,0,6
85750,1,2487,2497,-10,0,181,0,6
85751,2,2437,2485,-48,0,45,0,6
85752,3,2557,2529,28,0,211,0,6
85753,1,2562,2672,-110,0,253,0,6
85754,1,2452,2224,228,0,315,0,8
85755,2,2415,2437,-22,0,41,0,6
85756,1,2350,2496,-146,0,3,0,6
85757,2,2440,2531,-91,0,156,0,6
85758,1,2380,2447,-67,0,40,0,6
85759,1,2406,2255,151,0,313,0,6
85760,2,2442,2264,178,0,41,0,6
85761,1,2573,2578,-5,0,106,0,6
85762,1,2455,2354,101,0,4,0,6
85763,1,2446,2512,-66,0,119,0,6
85764,1,2498,2516,-18,0,314,0,6
85765,2,2429,2431,-2,0,241,0,6
85766,2,2223,2432,-209,0,10,0,6
85767,3,2442,2394,48,0,5,0,6
85768,2,2493,2499,-6,0,45,1,8
85769,3,2514,2248,266,4,130,0,8
85770,1,2410,2392,18,0,306,0,8
85771,1,2401,2458,-57,0,200,0,6
85772,1,2429,2360,69,0,6,1,6
85773,3,2510,2449,61,0,4,0,6
85774,1,2573,2523,50,0,229,1,6
85775,1,2423,2399,24,0,32,0,8
85776,1,2414,2237,177,0,101,0,6
85777,1,2401,2402,-1,0,459,0,6
85778,1,2623,2475,148,0,119,0,6
85779,1,2599,2574,25,0,107,0,6
85780,1,2533,2353,180,0,330,0,6
85781,2,2421,2299,122,0,246,1,6
85782,1,2606,2394,212,0,241,0,6
85783,2,2441,2325,116,0,122,0,8
85784,2,2553,2639,-86,0,245,0,6
85785,1,2474,2465,9,0,102,0,6
85786,1,2478,2302,176,0,250,1,8
85787,3,2442,2334,108,0,138,0,6
85788,1,2458,2280,178,0,466,0,6
85789,1,2512,2407,105,0,210,0,6
85790,1,2451,2535,-84,0,130,1,6
85791,2,2409,2560,-151,0,330,0,6
85792,3,2446,2556,-110,0,123,0,6
85793,2,2569,2605,-36,0,101,1,6
85794,2,2358,2488,-130,0,45,1,6
85795,2,2505,2442,63,0,4,0,6
85796,2,2268,2461,-193,0,106,1,6
85797,1,2593,2645,-52,0,152,0,6
85798,3,2238,2428,-190,0,46,0,8
85799,2,2434,2403,31,0,485,0,6
85800,1,2516,2409,107,0,138,1,6
85801,2,2306,2413,-107,0,40,0,6
85802,2,2381,2441,-60,0,205,1,6
85803,1,2572,2579,-7,0,426,0,6
85804,1,2515,2387,128,0,40,1,6
85805,2,2321,2458,-137,0,10,1,6
85806,1,2429,2247,182,0,302,1,6
85808,1,2585,2404,181,0,4,0,6
85809,2,2273,2433,-160,0,336,1,6
85810,3,2454,2205,249,0,43,0,8
85811,3,2406,2453,-47,0,334,0,6
85812,2,2248,2486,-238,0,40,0,6
85813,3,2357,2432,-75,0,202,0,6
85814,1,2491,2493,-2,0,123,0,6
85815,1,2444,2277,167,0,1,0,6
85816,1,2430,2433,-3,0,62,0,6
85817,3,2254,2407,-153,0,228,0,6
85818,1,2488,2485,3,0,40,0,6
85819,3,2471,2447,24,0,45,0,6
85820,1,2510,2504,6,0,8,0,6
85821,2,2344,2445,-101,0,9,0,6
85822,2,2261,2445,-184,0,331,0,6
85823,2,2439,2352,87,0,7,0,6
85824,2,2414,2444,-30,0,46,0,6
85825,1,2557,2536,21,0,143,0,6
85826,1,2471,2626,-155,0,313,0,6
85827,1,2665,2570,95,0,4,0,6
85828,1,2500,2215,285,0,57,0,6
85829,1,2437,2462,-25,0,130,0,6
85830,1,2299,2442,-143,0,4,0,6
85831,1,2462,2282,180,0,248,0,8
85832,1,2353,2401,-48,0,380,0,6
85833,2,2432,2437,-5,0,10,0,6
85834,1,2358,2454,-96,0,2,1,6
85835,1,2315,2434,-119,0,300,0,8
85836,2,2322,2459,-137,0,149,0,6
85837,2,2450,2528,-78,0,41,1,6
85838,2,2355,2434,-79,0,16,0,6
85839,2,2388,2419,-31,0,107,0,6
85840,2,2401,2509,-108,0,100,0,6
85841,2,2292,2435,-143,0,331,0,6
85842,1,2489,2432,57,0,338,0,6
85843,1,2426,2287,139,0,43,1,6
85844,2,2291,2449,-158,0,200,0,6
85845,1,2518,2578,-60,0,8,1,6
85846,1,2413,2227,186,0,102,0,6
85847,2,2530,2406,124,0,330,0,6
85848,3,2530,2562,-32,0,338,0,6
85849,1,2443,2284,159,0,302,0,6
85850,1,2397,2400,-3,0,251,0,6
85851,3,2320,2443,-123,0,10,0,6
85852,1,2322,2426,-104,0,13,0,6
85853,3,2410,2282,128,0,140,0,6
85854,1,2452,2473,-21,0,310,1,6
85855,2,2639,2599,40,0,107,0,6
85856,1,2405,2256,149,0,85,0,6
85857,2,2452,2549,-97,0,115,0,6
85858,2,2458,2297,161,0,100,0,6
85859,2,2528,2419,109,0,140,0,6
85860,2,2449,2409,40,0,100,1,6
85861,1,2351,2438,-87,0,224,0,6
85862,1,2449,2464,-15,0,4,1,6
85863,1,2488,2499,-11,0,111,1,6
85864,2,2304,2407,-103,0,130,0,6
85865,2,2610,2564,46,0,301,0,6
85866,3,2409,2254,155,0,311,0,8
85867,2,2345,2520,-175,0,45,1,6
85868,3,2494,2405,89,0,48,0,6
85869,3,2593,2601,-8,0,45,0,6
85870,1,2274,2427,-153,0,405,0,6
85871,1,2479,2436,43,0,320,0,6
85872,2,2446,2461,-15,0,11,0,6
85873,2,2519,2585,-66,0,45,0,6
85874,3,2383,2448,-65,0,300,0,6
85875,1,2437,2269,168,0,142,0,6
85876,1,2507,2699,-192,0,335,0,6
85877,2,2578,2530,48,0,67,1,6
85878,1,2618,2479,139,0,115,0,6
85879,1,2292,2440,-148,0,46,0,6
85880,2,2467,2448,19,0,102,0,6
85881,1,2609,2331,278,0,107,0,6
85882,1,2491,2392,99,0,107,0,6
85883,2,2498,2516,-18,0,4,1,6
85884,1,2497,2405,92,0,435,0,6
85885,2,2439,2351,88,0,6,0,6
85886,1,2448,2258,190,0,65,0,6
85887,2,2441,2374,67,0,14,0,6
85888,2,2430,2570,-140,0,200,1,6
85889,1,2432,2330,102,0,9,0,6
85890,1,2554,2447,107,0,266,1,6
85891,3,2447,2324,123,0,5,0,6
85892,2,2301,2418,-117,0,132,0,8
85893,1,2501,2365,136,0,4,0,6
85894,1,2417,2455,-38,0,0,0,6
85895,2,2435,2300,135,0,43,1,6
85896,1,2564,2473,91,0,302,1,6
85897,1,2266,2440,-174,0,336,0,6
85898,1,2432,2257,175,0,483,0,6
85899,1,2417,2383,34,0,109,0,6
85900,1,2443,2514,-71,0,130,0,6
85901,2,2398,2408,-10,0,3,1,6
85902,1,2501,2446,55,0,435,0,6
85903,1,2446,2409,37,0,114,0,6
85904,2,2453,2520,-67,0,300,0,6
85905,1,2530,2362,168,0,40,0,6
85906,3,2378,2427,-49,0,15,0,6
85907,1,2419,2263,156,0,335,0,6
85908,1,2279,2406,-127,0,120,0,6
85909,3,2553,2450,103,0,217,0,6
85911,1,2601,2593,8,0,215,0,6
85912,2,2441,2525,-84,0,6,0,6
85913,2,2571,2523,48,0,127,0,6
85914,1,2482,2303,179,0,202,1,8
85915,1,2611,2311,300,0,302,0,0
85916,1,2467,2643,-176,0,106,1,6
85917,2,2362,2432,-70,0,46,0,8
85918,2,2425,2208,217,0,41,1,8
85919,2,2355,2445,-90,0,103,1,6
85920,3,2438,2288,150,0,2,0,6
85921,2,2458,2484,-26,0,310,1,6
85922,3,2566,2669,-103,0,120,0,6
85923,2,2417,2440,-23,0,133,1,6
85924,1,2448,2415,33,0,40,0,6
85925,3,2606,2633,-27,0,34,0,6
85926,1,2222,2416,-194,0,492,0,6
85927,1,2525,2448,77,0,277,0,6
85928,2,2361,2516,-155,0,122,0,6
85929,2,2476,2622,-146,0,41,0,6
85930,1,2493,2411,82,0,4,0,6
85931,2,2494,2493,1,0,101,0,6
85932,2,2713,2666,47,0,190,0,6
85933,3,2454,2461,-7,0,311,0,6
85934,2,2455,2450,5,0,5,0,6
85935,2,2406,2431,-25,0,326,1,6
85936,1,2348,2446,-98,0,46,0,6
85937,1,2514,2352,162,0,45,1,6
85938,1,2590,2506,84,0,414,1,6
85939,2,2441,2572,-131,0,106,0,6
85940,1,2446,2385,61,0,210,1,6
85941,1,2483,2451,32,0,57,0,6
85942,2,2358,2434,-76,0,88,1,6
85943,3,2416,2285,131,0,302,0,6
85944,2,2522,2493,29,0,56,0,6
85945,2,2413,2366,47,0,492,1,6
85946,1,2443,2360,83,0,115,0,6
85947,1,2536,2530,6,0,125,0,6
85948,2,2359,2534,-175,0,3,0,6
85949,2,2251,2435,-184,0,17,1,6
85950,2,2422,2415,7,0,200,0,6
85951,1,2529,2487,42,0,5,0,6
85953,2,2255,2451,-196,0,153,0,6
85954,3,2280,2439,-159,0,45,0,8
85955,1,2453,2319,134,0,404,0,6
85956,1,2432,2229,203,0,28,0,6
85957,1,2574,2605,-31,0,100,0,6
85958,2,2384,2432,-48,0,13,0,8
85959,2,2497,2456,41,0,5,0,6
85960,3,2448,2398,50,0,192,0,6
85961,2,2538,2375,163,0,40,1,6
85962,1,2475,2410,65,0,210,0,6
85963,1,2407,2278,129,0,49,0,6
85964,1,2263,2448,-185,0,106,0,6
85965,2,2316,2423,-107,0,100,0,6
85966,2,2436,2210,226,0,241,1,8
85967,1,2376,2458,-82,0,40,0,6
85968,3,2469,2437,32,0,45,0,6
85969,2,2505,2575,-70,0,40,0,6
85970,1,2674,2706,-32,0,190,0,6
85971,2,2308,2452,-144,0,41,0,6
85972,2,2451,2336,115,0,40,1,6
85973,2,2310,2613,-303,0,311,0,0
85974,2,2424,2393,31,0,41,0,6
85975,3,2400,2386,14,0,4,0,6
85976,3,2439,2568,-129,0,161,0,6
85977,2,2428,2331,97,0,103,0,6
85978,1,2559,2411,148,0,115,0,6
85979,2,2632,2588,44,0,216,1,6
85980,2,2403,2453,-50,0,202,0,6
85981,2,2218,2413,-195,0,257,0,8
85982,2,2410,2417,-7,0,45,0,6
85983,1,2635,2472,163,0,311,0,6
85984,2,2376,2551,-175,0,117,0,6
85985,2,2293,2452,-159,0,202,1,6
85986,2,2456,2421,35,0,15,0,6
85987,2,2392,2436,-44,0,148,0,6
85988,1,2503,2351,152,0,253,0,6
85989,1,2429,2496,-67,0,140,0,6
85990,2,2499,2476,23,0,48,0,6
85991,2,2449,2464,-15,0,53,1,6
85992,2,2501,2594,-93,0,58,1,6
85993,1,2420,2349,71,0,0,1,6
85994,2,2489,2437,52,0,300,0,8
85995,2,2416,2201,215,0,314,0,8
85996,2,2599,2477,122,0,12,1,6
85997,2,2388,2440,-52,0,211,1,6
85998,2,2462,2454,8,0,101,1,6
85999,2,2437,2524,-87,0,40,0,6
86000,1,2401,2449,-48,0,343,1,6
86001,2,2446,2488,-42,0,123,1,6
86002,1,2580,2457,123,0,257,0,6
86003,1,2615,2308,307,0,125,0,0
86004,1,2411,2357,54,0,330,1,6
86005,1,2355,2402,-47,0,403,0,6
86006,2,2401,2488,-87,0,301,0,6
86007,1,2458,2508,-50,0,380,0,6
86008,3,2417,2507,-90,0,113,0,8
86009,1,2454,2252,202,0,187,0,6
86010,1,2446,2412,34,0,278,1,6
86011,1,2520,2364,156,0,15,0,6
86012,1,2499,2515,-16,0,122,0,6
86013,2,2400,2315,85,0,335,1,6
86014,3,2472,2215,257,4,310,0,13
86015,1,2438,2354,84,0,14,1,6
86016,1,2555,2373,182,0,154,0,6
86017,2,2436,2386,50,0,302,0,6
86018,3,2482,2535,-53,0,281,0,6
86019,3,2432,2381,51,0,39,0,6
86020,1,2562,2542,20,0,131,0,6
86021,1,2422,2314,108,0,335,0,6
86022,2,2216,2442,-226,0,103,0,8
86023,2,2363,2515,-152,0,394,0,8
86024,1,2408,2234,174,0,200,0,6
86025,1,2356,2460,-104,0,2,1,6
86026,2,2432,2567,-135,0,453,0,6
86027,1,2318,2452,-134,0,40,0,6
86028,1,2539,2442,97,0,267,0,6
86029,2,2400,2444,-44,0,122,0,6
86030,1,2399,2422,-23,0,2,0,6
86031,1,2638,2695,-57,0,81,1,6
86032,1,2438,2493,-55,0,310,0,6
86033,2,2405,2480,-75,0,41,0,6
86034,1,2386,2431,-45,0,100,0,6
86035,1,2250,2457,-207,0,420,0,6
86036,1,2435,2424,11,0,337,0,6
86037,1,2382,2416,-34,0,21,0,8
86038,3,2311,2509,-198,0,426,0,6
86039,1,2469,2506,-37,0,326,0,6
86040,1,2246,2438,-192,0,112,0,6
86041,2,2439,2407,32,0,302,0,6
86042,2,2426,2380,46,0,200,0,6
86043,2,2261,2427,-166,0,107,0,8
86044,2,2460,2466,-6,0,405,1,6
86045,1,2359,2450,-91,0,135,0,6
86046,2,2444,2626,-182,0,123,1,6
86047,1,2350,2562,-212,0,113,0,6
86048,1,2599,2700,-101,0,45,0,6
86049,2,2432,2436,-4,0,4,0,6
86050,3,2408,2334,74,0,343,0,6
86051,2,2222,2400,-178,0,140,0,6
86052,2,2415,2632,-217,0,194,0,6
86053,2,2469,2465,4,0,347,1,6
86054,2,2250,2403,-153,0,120,0,6
86055,1,2454,2315,139,0,81,1,6
86056,3,2257,2437,-180,0,47,0,6
86057,2,2306,2616,-310,0,92,0,0
86058,1,2403,2479,-76,0,337,0,8
86059,2,2310,2426,-116,0,121,0,6
86060,2,2604,2584,20,0,300,0,6
86061,1,2591,2443,148,0,345,1,6
86062,2,2218,2435,-217,0,140,0,6
86063,1,2400,2407,-7,0,217,0,6
86064,2,2427,2336,91,0,125,0,6
86065,2,2484,2414,70,0,210,0,6
86066,2,2221,2402,-181,0,200,0,8
86067,2,2444,2369,75,0,406,0,6
86068,1,2510,2505,5,0,38,1,6
86069,2,2556,2335,221,0,207,0,8
86070,2,2316,2403,-87,0,132,0,6
86071,1,2441,2455,-14,0,204,0,6
86072,1,2409,2310,99,0,4,0,6
86073,1,2529,2483,46,0,45,0,6
86074,2,2204,2445,-241,0,0,0,8
86075,2,2440,2273,167,0,110,0,6
86076,1,2453,2363,90,0,331,0,6
86077,1,2486,2424,62,0,48,0,6
86078,1,2589,2444,145,0,4,0,6
86079,2,2572,2478,94,0,250,0,6
86080,1,2349,2431,-82,0,16,0,6
86081,2,2462,2429,33,0,295,1,6
86082,3,2558,2344,214,0,42,0,6
86083,1,2590,2431,159,0,110,0,6
86084,2,2331,2407,-76,0,400,0,6
86085,2,2422,2298,124,0,12,0,6
86086,2,2242,2418,-176,0,260,0,8
86087,3,2505,2314,191,0,315,0,8
86088,1,2530,2455,75,0,200,0,6
86089,1,2383,2412,-29,0,327,1,6
86090,1,2449,2330,119,0,190,0,6
86091,1,2416,2405,11,0,143,1,6
86092,2,2598,2606,-8,0,301,0,6
86093,2,2407,2393,14,0,41,0,6
86094,1,2688,2693,-5,0,148,0,6
86095,2,2447,2465,-18,0,124,1,6
86096,1,2306,2413,-107,0,203,0,6
86097,2,2443,2387,56,0,406,0,6
86098,2,2363,2431,-68,0,411,0,8
86099,2,2500,2441,59,0,208,0,6
86100,1,2635,2205,430,0,101,1,6
86101,1,2618,2304,314,0,408,0,0
86102,2,2454,2456,-2,0,107,1,6
86103,2,2441,2568,-127,0,327,0,6
86104,1,2409,2315,94,0,180,0,8
86105,1,2389,2445,-56,0,17,0,8
86106,2,2478,2592,-114,0,107,0,6
86107,3,2340,2457,-117,0,404,0,6
86108,2,2565,2436,129,0,0,0,6
86109,1,2359,2457,-98,0,3,1,6
86110,2,2386,2428,-42,0,45,1,6
86111,2,2456,2593,-137,0,143,1,6
86112,2,2437,2336,101,0,341,0,6
86113,1,2421,2276,145,0,327,1,6
86114,2,2358,2523,-165,0,190,0,6
86115,2,2306,2414,-108,0,352,1,6
86116,2,2463,2366,97,0,50,0,6
86117,1,2394,2517,-123,0,41,1,6
86118,2,2471,2401,70,0,74,0,6
86119,1,2428,2427,1,0,483,1,6
86120,3,2448,2594,-146,0,328,0,6
86121,2,2515,2493,22,0,80,0,6
86122,2,2500,2515,-15,0,200,0,6
86123,2,2434,2440,-6,0,343,1,6
86124,1,2447,2271,176,0,345,0,8
86125,1,2536,2386,150,0,106,0,6
86126,2,2437,2366,71,0,13,1,6
86127,2,2502,2410,92,0,43,0,6
86128,1,2448,2258,190,0,187,0,6
86129,1,2469,2291,178,0,9,1,6
86130,1,2305,2402,-97,0,190,0,6
86131,3,2606,2314,292,0,100,0,6
86132,1,2419,2418,1,0,311,0,6
86133,1,2409,2353,56,0,300,0,8
86134,3,2534,2612,-78,0,130,0,6
86135,2,2376,2553,-177,0,7,1,6
86136,1,2557,2592,-35,0,46,0,6
86137,2,2450,2536,-86,0,102,0,6
86138,1,2444,2505,-61,0,200,0,6
86139,3,2648,2610,38,0,131,0,6
86140,1,2419,2291,128,0,40,0,6
86141,2,2453,2596,-143,0,247,0,6
86142,2,2485,2562,-77,0,242,1,6
86143,3,2439,2317,122,0,104,0,8
86144,1,2472,2410,62,0,311,0,8
86145,2,2435,2455,-20,0,394,0,6
86146,2,2443,2458,-15,0,388,0,6
86147,2,2491,2357,134,0,47,1,6
86148,2,2406,2314,92,0,120,1,6
86149,1,2465,2506,-41,0,46,0,6
86150,2,2531,2555,-24,0,122,0,6
86151,1,2592,2480,112,0,307,0,6
86152,1,2543,2427,116,0,200,1,6
86153,1,2293,2420,-127,0,302,0,6
86154,1,2322,2421,-99,0,45,0,8
86155,1,2597,2437,160,0,190,0,6
86156,2,2372,2456,-84,0,101,0,6
86157,1,2430,2289,141,0,485,0,6
86158,2,2309,2422,-113,0,245,0,6
86159,2,2400,2461,-61,0,3,0,6
86160,2,2414,2338,76,0,142,0,8
86161,3,2203,2539,-336,0,200,0,8
86162,2,2450,2366,84,0,331,0,6
86163,2,2388,2436,-48,0,310,0,6
86164,1,2462,2449,13,0,55,0,6
86165,2,2256,2451,-195,0,347,0,6
86166,1,2586,2563,23,0,107,0,6
86167,1,2520,2254,266,0,398,0,8
86168,2,2336,2461,-125,0,101,0,6
86169,2,2464,2539,-75,0,190,1,6
86170,1,2437,2443,-6,0,44,1,6
86171,1,2441,2383,58,0,344,0,6
86172,2,2451,2509,-58,0,223,0,6
86173,2,2500,2332,168,0,153,0,6
86174,1,2412,2425,-13,0,49,0,6
86175,2,2397,2464,-67,0,215,0,6
86176,2,2534,2558,-24,0,330,0,6
86177,2,2445,2462,-17,0,5,1,6
86178,2,2299,2420,-121,0,101,0,6
86179,1,2315,2447,-132,0,13,0,6
86180,2,2433,2392,41,0,464,1,6
86181,1,2419,2302,117,0,14,0,6
86182,1,2261,2425,-164,0,200,1,6
86183,1,2329,2450,-121,0,344,0,8
86184,1,2521,2494,27,0,56,1,6
86185,1,2367,2468,-101,4,43,0,13
86186,3,2441,2510,-69,0,107,0,6
86187,1,2399,2450,-51,0,200,0,6
86188,1,2571,2591,-20,0,101,0,6
86189,1,2342,2489,-147,0,83,0,6
86190,1,2495,2402,93,0,315,0,6
86191,2,2466,2395,71,0,142,1,6
86192,2,2417,2312,105,0,118,1,6
86193,2,2318,2443,-125,0,1,0,6
86194,1,2369,2408,-39,0,241,0,6
86195,1,2288,2428,-140,0,125,0,6
86196,3,2303,2620,-317,0,323,0,0
86197,2,2636,2284,352,0,410,0,6
86198,2,2610,2687,-77,0,415,0,6
86199,1,2602,2428,174,0,57,0,6
86200,1,2413,2431,-18,0,0,1,6
86201,2,2479,2373,106,0,200,0,6
86202,2,2611,2648,-37,0,45,1,6
86203,2,2433,2413,20,0,101,1,6
86204,2,2315,2406,-91,0,345,0,8
86205,3,2426,2465,-39,0,110,0,6
86206,2,2426,2346,80,0,4,1,6
86207,3,2381,2424,-43,0,27,0,6
86208,1,2420,2315,105,0,1,0,6
86209,2,2480,2580,-100,0,112,0,6
86210,2,2359,2437,-78,0,45,0,6
86211,2,2380,2547,-167,0,140,1,6
86212,1,2443,2468,-25,0,311,0,6
86213,2,2430,2568,-138,0,453,0,6
86214,2,2312,2438,-126,0,205,1,6
86215,1,2419,2483,-64,0,312,1,6
86216,1,2412,2400,12,0,5,0,6
86217,1,2418,2319,99,0,462,0,6
86218,1,2300,2603,-303,0,40,1,6
86219,3,2426,2477,-51,0,131,0,6
86220,1,2455,2393,62,0,406,0,6
86221,1,2424,2355,69,0,253,1,6
86222,2,2347,2441,-94,0,20,0,6
86223,2,2600,2523,77,0,121,0,6
86224,1,2550,2451,99,0,463,0,6
86225,2,2340,2491,-151,0,242,1,6
86226,1,2527,2556,-29,0,61,0,6
86227,1,2315,2625,-310,0,120,0,6
86228,2,2469,2443,26,0,415,0,6
86229,1,2439,2401,38,0,206,0,6
86230,2,2440,2274,166,0,288,1,8
86231,1,2265,2416,-151,0,258,0,6
86232,2,2446,2434,12,0,331,1,6
86233,2,2401,2392,9,0,57,0,6
86234,2,2459,2437,22,0,301,0,6
86235,1,2544,2514,30,0,311,0,6
86236,2,2434,2499,-65,0,355,1,6
86237,1,2447,2440,7,0,41,1,6
86238,2,2509,2442,67,0,45,0,6
86239,3,2426,2381,45,0,10,0,6
86240,1,2471,2348,123,0,41,0,6
86241,2,2398,2481,-83,0,80,0,6
86242,2,2417,2428,-11,0,0,0,6
86243,2,2298,2422,-124,0,352,1,6
86244,2,2442,2270,172,0,265,0,6
86245,2,2445,2361,84,0,110,1,6
86246,2,2417,2443,-26,0,204,1,6
86248,1,2489,2526,-37,0,4,1,6
86249,2,2444,2271,173,0,143,0,6
86250,2,2293,2403,-110,0,202,0,6
86251,2,2420,2308,112,0,338,1,6
86252,3,2410,2523,-113,0,406,0,8
86253,2,2550,2533,17,0,190,0,6
86254,1,2431,2270,161,0,144,0,6
86255,1,2497,2461,36,0,310,0,6
86256,1,2218,2428,-210,0,108,0,8
86257,1,2443,2459,-16,0,196,1,6
86258,2,2389,2425,-36,0,101,0,6
86259,1,2605,2585,20,0,335,0,6
86260,2,2653,2606,47,0,45,1,6
86261,1,2553,2453,100,0,242,0,6
86262,2,2317,2427,-110,0,127,0,6
86263,2,2226,2408,-182,0,80,1,8
86264,1,2432,2203,229,0,205,0,8
86265,2,2464,2449,15,0,241,0,6
86266,1,2476,2476,0,0,278,0,6
86267,2,2425,2345,80,0,13,0,6
86268,2,2568,2507,61,0,248,0,6
86269,2,2400,2310,90,0,150,1,6
86270,2,2397,2461,-64,0,150,0,6
86271,3,2408,2476,-68,0,314,0,6
86272,1,2408,2290,118,0,40,0,6
86273,2,2426,2426,0,0,454,0,6
86274,2,2333,2419,-86,0,326,0,6
86275,1,2344,2407,-63,0,40,0,6
86276,2,2692,2554,138,0,211,1,6
86277,1,2429,2350,79,0,113,0,6
86278,1,2495,2337,158,0,153,0,6
86279,2,2471,2446,25,0,191,0,6
86280,2,2463,2282,181,0,331,1,6
86281,1,2409,2330,79,0,151,1,6
86282,1,2360,2404,-44,0,187,1,6
86283,1,2449,2458,-9,0,140,1,6
86284,2,2398,2426,-28,0,301,0,6
86285,1,2462,2455,7,0,9,0,6
86286,2,2382,2485,-103,0,80,0,6
86287,2,2394,2529,-135,0,300,1,6
86288,1,2396,2436,-40,0,40,0,6
86289,1,2443,2311,132,0,70,0,8
86290,1,2351,2405,-54,0,41,0,8
86291,3,2441,2550,-109,0,152,0,6
86292,2,2454,2429,25,0,4,0,6
86293,1,2449,2411,38,0,200,1,6
86294,1,2311,2424,-113,0,100,0,6
86295,1,2504,2382,122,0,331,0,6
86296,2,2438,2249,189,0,45,0,6
86297,1,2509,2440,69,0,312,0,6
86298,2,2432,2434,-2,0,484,0,6
86299,2,2530,2694,-164,0,112,0,6
86300,2,2443,2610,-167,0,41,0,6
86301,2,2328,2494,-166,0,120,0,6
86302,2,2580,2558,22,0,301,0,6
86303,2,2502,2464,38,0,81,0,6
86304,2,2449,2534,-85,0,249,1,6
86305,2,2453,2549,-96,0,0,0,6
86306,1,2426,2295,131,0,14,0,6
86307,3,2449,2456,-7,0,247,0,6
86308,1,2520,2495,25,0,45,1,6
86309,3,2352,2418,-66,0,147,0,6
86310,1,2364,2412,-48,0,10,0,6
86311,2,2425,2392,33,0,258,0,6
86312,2,2431,2297,134,0,101,0,6
86313,3,2563,2496,67,0,54,0,6
86314,1,2430,2432,-2,0,42,0,6
86315,2,2435,2233,202,0,122,1,8
86316,2,2453,2449,4,0,216,1,6
86317,3,2448,2384,64,0,15,0,6
86318,2,2336,2450,-114,0,344,0,6
86319,1,2424,2302,122,0,302,0,6
86320,2,2436,2512,-76,0,310,0,6
86321,2,2268,2419,-151,0,107,0,8
86322,2,2450,2467,-17,0,302,0,6
86323,2,2532,2392,140,0,121,1,6
86324,1,2616,2307,309,0,17,0,0
86325,2,2401,2409,-8,0,7,1,6
86326,2,2539,2544,-5,0,45,0,6
86327,1,2513,2576,-63,0,19,0,6
86328,1,2521,2432,89,0,302,0,8
86329,1,2378,2475,-97,0,3,0,6
86330,1,2304,2429,-125,0,172,1,6
86331,2,2513,2442,71,0,326,0,6
86332,1,2318,2436,-118,0,304,0,6
86333,1,2312,2616,-304,0,122,0,6
86334,1,2441,2400,41,0,100,0,6
86335,1,2310,2401,-91,0,1,0,6
86336,2,2498,2466,32,0,150,1,6
86337,2,2301,2447,-146,0,302,0,8
86338,2,2475,2464,11,0,331,0,6
86339,2,2454,2454,0,0,204,0,6
86340,2,2267,2423,-156,0,4,0,6
86341,1,2456,2323,133,0,61,0,6
86342,2,2431,2393,38,0,464,0,6
86343,1,2562,2449,113,0,394,1,6
86344,1,2517,2431,86,0,30,0,6
86345,1,2371,2406,-35,0,125,1,6
86346,1,2305,2617,-312,0,57,0,0
86347,2,2455,2429,26,0,380,0,6
86348,1,2564,2472,92,0,242,0,6
86349,2,2440,2385,55,0,122,0,6
86350,2,2426,2558,-132,0,58,0,6
86351,1,2440,2460,-20,0,300,0,6
86352,2,2233,2406,-173,0,400,1,6
86353,2,2406,2378,28,0,0,1,6
86354,2,2697,2684,13,0,148,1,6
86355,3,2473,2444,29,0,483,0,6
86356,2,2398,2454,-56,0,212,1,6
86357,3,2410,2242,168,0,43,0,8
86358,3,2364,2482,-118,0,229,0,6
86359,1,2553,2574,-21,0,4,0,6
86360,1,2399,2494,-95,0,301,0,8
86361,1,2678,2448,230,0,43,0,6
86362,2,2385,2447,-62,0,245,0,6
86363,1,2490,2525,-35,0,4,1,6
86364,2,2472,2444,28,0,242,1,6
86365,2,2593,2562,31,0,2,0,6
86366,2,2430,2422,8,0,45,0,6
86367,2,2568,2520,48,0,338,0,6
86368,2,2346,2414,-68,0,277,0,6
86369,1,2406,2235,171,0,46,0,6
86370,1,2449,2562,-113,0,265,0,6
86371,2,2412,2435,-23,0,336,1,6
86372,2,2314,2465,-151,0,241,1,6
86373,2,2437,2506,-69,0,150,1,6
86374,2,2379,2419,-40,0,490,1,6
86375,2,2387,2560,-173,0,192,0,6
86376,1,2498,2532,-34,0,315,0,6
86377,1,2785,2568,217,0,101,0,6
86378,3,2425,2446,-21,0,345,0,6
86379,1,2373,2419,-46,0,54,1,6
86380,2,2426,2400,26,0,200,0,6
86381,3,2436,2240,196,0,43,0,6
86382,1,2392,2428,-36,0,139,0,6
86383,2,2468,2491,-23,0,46,1,6
86384,3,2321,2415,-94,0,28,0,6
86385,2,2427,2522,-95,0,310,0,6
86386,2,2377,2421,-44,0,45,0,6
86387,2,2369,2427,-58,0,40,1,6
86388,2,2417,2319,98,0,1,0,6
86389,1,2436,2449,-13,0,101,0,6
86390,2,2446,2669,-223,0,101,0,6
86391,2,2427,2527,-100,0,106,0,8
86392,2,2453,2386,67,0,200,0,6
86393,3,2358,2434,-76,0,453,0,6
86394,2,2429,2311,118,0,46,0,6
86395,1,2376,2460,-84,0,200,1,6
86396,2,2309,2426,-117,0,113,0,8
86397,2,2364,2433,-69,0,45,0,6
86398,1,2451,2380,71,0,112,0,6
86399,2,2402,2308,94,0,252,1,6
86400,1,2472,2492,-20,0,326,0,6
86401,1,2398,2414,-16,0,16,0,6
86402,2,2451,2380,71,0,190,1,6
86403,1,2426,2341,85,0,241,0,6
86404,1,2681,2566,115,0,211,0,6
86405,2,2325,2412,-87,0,122,1,6
86406,3,2417,2353,64,0,253,0,6
86407,2,2352,2400,-48,0,414,1,6
86408,1,2608,2315,293,0,2,0,0
86409,1,2446,2452,-6,0,409,1,6
86410,3,2310,2414,-104,0,301,0,8
86411,1,2455,2445,10,0,51,0,6
86412,2,2568,2527,41,0,253,0,6
86413,2,2455,2502,-47,0,126,0,6
86414,2,2450,2305,145,0,314,1,8
86415,1,2411,2382,29,0,101,0,8
86416,1,2430,2297,133,0,122,0,8
86417,1,2460,2316,144,0,30,0,6
86419,1,2691,2790,-99,0,278,1,6
86420,1,2563,2384,179,0,314,0,6
86421,2,2426,2308,118,0,101,0,6
86422,2,2218,2408,-190,0,300,1,8
86423,2,2565,2788,-223,0,133,0,6
86424,2,2408,2404,4,0,320,0,6
86425,2,2459,2300,159,0,315,0,6
86426,1,2436,2393,43,0,258,0,6
86427,2,2555,2442,113,0,380,0,6
86429,1,2438,2428,10,0,122,0,6
86430,1,2690,2457,233,0,8,0,6
86431,2,2413,2425,-12,0,28,0,6
86432,2,2392,2446,-54,0,2,0,6
86433,1,2424,2386,38,0,122,0,6
86434,2,2345,2424,-79,0,120,0,6
86435,1,2336,2420,-84,0,289,0,6
86436,1,2606,2422,184,0,400,0,6
86437,2,2490,2451,39,0,300,0,6
86438,2,2562,2526,36,0,228,1,6
86439,1,2431,2406,25,0,200,0,6
86440,2,2443,2461,-18,0,142,0,6
86441,2,2432,2201,231,0,117,0,6
86442,2,2422,2398,24,0,43,0,6
86443,1,2441,2446,-5,0,254,0,6
86444,2,2416,2338,78,0,332,0,6
86445,1,2390,2466,-76,0,45,0,6
86446,2,2527,2613,-86,0,106,0,6
86447,3,2359,2425,-66,0,302,0,6
86448,2,2407,2391,16,0,41,0,6
86449,2,2463,2645,-182,0,302,1,6
86450,1,2504,2400,104,0,307,0,6
86451,2,2386,2400,-14,0,45,0,6
86452,1,2423,2598,-175,0,405,0,6
86453,1,2360,2456,-96,0,167,0,6
86454,2,2216,2417,-201,0,220,0,8
86455,2,2313,2610,-297,0,43,0,0
86456,2,2438,2403,35,0,353,1,8
86457,1,2387,2430,-43,0,241,1,6
86458,1,2453,2313,140,0,44,0,6
86459,1,2327,2419,-92,0,335,1,6
86460,1,2486,2562,-76,0,113,0,6
86461,2,2388,2453,-65,0,2,0,6
86462,2,2562,2685,-123,0,418,0,6
86463,1,2304,2409,-105,0,201,0,6
86464,1,2790,2563,227,0,96,0,6
86465,1,2476,2507,-31,0,167,0,6
86466,3,2472,2497,-25,0,113,0,6
86467,1,2406,2284,122,0,110,0,6
86468,2,2413,2497,-84,0,107,0,6
86469,1,2410,2343,67,0,331,1,6
86470,1,2550,2381,169,0,241,0,6
86471,2,2381,2443,-62,0,484,0,6
86472,1,2446,2278,168,0,284,0,6
86473,1,2419,2380,39,0,10,0,6
86475,1,2381,2566,-185,0,192,0,6
86476,1,2409,2353,56,0,464,0,6
86477,2,2335,2416,-81,0,4,0,6
86478,1,2439,2467,-28,0,311,1,6
86479,1,2480,2421,59,0,296,0,6
86480,2,2412,2447,-35,0,196,1,6
86481,2,2472,2428,44,0,330,0,6
86482,2,2220,2434,-214,0,110,0,8
86483,1,2409,2294,115,0,45,0,8
86484,2,2330,2699,-369,0,1,0,6
86485,2,2209,2437,-228,0,0,0,6
86486,2,2345,2410,-65,0,100,0,6
86487,2,2418,2441,-23,0,4,0,6
86488,2,2489,2450,39,0,45,0,6
86489,1,2400,2414,-14,0,40,0,6
86490,1,2225,2443,-218,0,57,0,8
86491,2,2539,2547,-8,0,302,1,6
86492,1,2568,2450,118,0,386,0,6
86493,2,2449,2388,61,0,112,0,6
86494,1,2354,2416,-62,0,147,0,6
86495,1,2424,2480,-56,0,4,0,6
86496,3,2253,2414,-161,0,8,0,6
86498,1,2423,2236,187,0,210,0,8
86499,2,2281,2410,-129,0,41,1,6
86500,2,2449,2440,9,0,270,0,6
86501,1,2401,2404,-3,0,301,0,6
86502,1,2689,2558,131,0,106,0,6
86503,1,2384,2401,-17,0,60,0,6
86504,2,2408,2423,-15,0,48,0,6
86505,1,2457,2459,-2,0,195,0,6
86506,1,2497,2519,-22,0,314,0,6
86507,2,2454,2522,-68,0,218,0,6
86508,1,2457,2397,60,0,300,0,6
86509,1,2324,2493,-169,0,399,0,6
86510,2,2366,2609,-243,0,45,0,6
86511,2,2266,2419,-153,0,4,1,6
86512,2,2391,2424,-33,0,118,0,6
86513,2,2458,2555,-97,0,345,0,6
86514,3,2648,2460,188,0,312,0,6
86515,2,2560,2793,-233,0,145,1,6
86516,2,2343,2423,-80,0,107,0,6
86517,2,2527,2555,-28,0,398,0,6
86518,2,2590,2537,53,0,315,0,6
86519,1,2529,2383,146,0,200,0,6
86520,1,2482,2457,25,0,4,0,6
86521,2,2420,2436,-16,0,112,0,8
86522,2,2364,2412,-48,0,107,0,6
86523,2,2692,2618,74,0,106,1,6
86524,2,2428,2334,94,0,4,0,6
86525,1,2315,2441,-126,0,147,1,6
86526,1,2557,2390,167,0,347,0,6
86527,2,2485,2533,-48,0,267,0,6
86528,3,2361,2413,-52,0,1,0,6
86529,1,2456,2461,-5,0,89,0,6
86530,2,2261,2441,-180,0,49,1,6
86531,1,2448,2274,174,0,122,0,6
86532,1,2501,2482,19,0,348,0,6
86533,1,2466,2438,28,0,205,0,6
86534,1,2473,2442,31,0,189,1,6
86535,2,2411,2426,-15,0,332,0,8
86536,2,2258,2438,-180,0,177,0,6
86537,1,2387,2561,-174,0,197,0,6
86538,2,2243,2423,-180,0,49,1,6
86539,1,2685,2446,239,0,0,1,6
86540,1,2461,2415,46,0,6,1,6
86541,1,2497,2404,93,0,213,0,6
86542,1,2553,2526,27,0,218,0,6
86543,1,2559,2451,108,0,128,0,6
86544,1,2424,2330,94,0,36,0,6
86545,2,2555,2692,-137,0,394,0,6
86546,2,2415,2341,74,0,1,0,6
86547,2,2420,2338,82,0,210,0,6
86548,1,2485,2332,153,0,206,1,6
86549,2,2406,2444,-38,0,301,0,6
86550,2,2359,2508,-149,0,28,1,6
86551,2,2473,2446,27,0,125,1,6
86552,2,2428,2540,-112,0,60,0,6
86553,1,2406,2461,-55,0,43,1,6
86555,2,2409,2361,48,0,253,0,6
86556,1,2451,2488,-37,0,126,0,6
86557,1,2501,2463,38,0,300,1,6
86558,1,2422,2350,72,0,400,0,6
86559,2,2513,2503,10,0,45,0,6
86560,1,2478,2451,27,0,199,0,6
86561,1,2420,2440,-20,0,218,1,6
86562,1,2441,2208,233,0,49,1,6
86563,2,2265,2409,-144,0,50,0,6
86564,2,2427,2400,27,0,46,0,6
86565,2,2607,2473,134,0,123,0,6
86566,1,2552,2395,157,0,315,0,6
86567,2,2453,2388,65,0,250,0,6
86568,1,2417,2467,-50,0,462,0,6
86569,2,2612,2318,294,0,41,0,6
86570,3,2422,2289,133,0,302,0,6
86571,1,2380,2533,-153,0,2,0,6
86572,1,2465,2435,30,0,123,0,6
86573,3,2435,2215,220,0,57,0,6
86574,3,2410,2431,-21,0,43,0,8
86575,2,2395,2553,-158,0,335,0,6
86576,1,2443,2319,124,0,100,0,6
86577,2,2473,2538,-65,0,1,0,6
86578,1,2414,2249,165,0,7,0,6
86579,1,2427,2365,62,0,135,0,6
86580,3,2413,2376,37,0,135,0,8
86581,2,2346,2522,-176,0,207,1,6
86582,1,2432,2290,142,0,4,0,8
86583,1,2544,2561,-17,0,7,0,6
86584,1,2556,2392,164,0,313,1,6
86585,1,2359,2461,-102,0,215,1,6
86586,2,2464,2392,72,0,15,0,6
86587,3,2429,2386,43,0,30,0,6
86588,2,2454,2252,202,0,112,1,6
86589,1,2434,2350,84,0,40,0,8
86590,2,2447,2412,35,0,402,1,6
86591,1,2417,2410,7,0,338,0,6
86592,2,2558,2583,-25,0,112,0,6
86593,1,2795,2645,150,0,106,0,6
86594,1,2389,2463,-74,0,302,1,6
86595,2,2348,2413,-65,0,1,0,6
86596,1,2474,2407,67,0,246,0,6
86597,3,2293,2449,-156,0,29,0,6
86598,2,2433,2428,5,0,404,0,6
86599,3,2442,2413,29,0,107,0,8
86600,1,2578,2366,212,0,115,0,6
86601,2,2304,2447,-143,0,102,0,6
86602,2,2297,2457,-160,0,245,0,6
86603,2,2362,2480,-118,0,220,0,6
86604,1,2551,2563,-12,0,343,0,6
86605,1,2532,2379,153,0,107,0,6
86606,1,2418,2342,76,0,225,0,6
86607,1,2525,2388,137,0,4,0,6
86608,3,2544,2372,172,0,150,0,6
86609,2,2413,2446,-33,0,154,0,6
86610,1,2482,2458,24,0,4,0,6
86611,1,2517,2591,-74,0,143,1,6
86612,3,2443,2483,-40,0,142,0,6
86613,1,2407,2293,114,0,395,0,6
86614,2,2542,2469,73,0,41,0,6
86615,2,2423,2688,-265,0,373,0,6
86616,2,2397,2426,-29,0,106,1,6
86617,2,2392,2556,-164,0,192,0,6
86618,1,2502,2384,118,0,4,0,6
86619,2,2431,2410,21,0,300,0,8
86620,2,2329,2420,-91,0,359,0,6
86621,2,2452,2467,-15,0,330,1,6
86622,2,2642,2799,-157,0,57,0,6
86623,3,2336,2423,-87,0,302,0,6
86624,1,2400,2466,-66,0,112,1,6
86625,2,2482,2599,-117,0,310,0,6
86626,1,2413,2454,-41,0,45,1,6
86627,1,2329,2488,-159,0,107,0,6
86628,1,2430,2471,-41,0,45,0,6
86629,2,2435,2281,154,0,25,0,6
86630,3,2413,2382,31,0,338,0,6
86631,2,2430,2391,39,0,112,0,6
86632,2,2360,2432,-72,0,334,1,6
86633,2,2509,2507,2,0,302,1,6
86634,1,2458,2452,6,0,160,0,6
86635,2,2323,2451,-128,0,115,0,6
86636,1,2447,2506,-59,0,0,0,6
86637,2,2600,2557,43,0,4,0,6
86638,1,2557,2504,53,0,151,0,6
86639,1,2246,2417,-171,0,331,0,6
86640,1,2434,2325,109,0,140,0,6
86641,2,2424,2426,-2,0,302,0,6
86642,2,2408,2359,49,0,1,1,6
86643,1,2453,2517,-64,0,409,0,6
86644,2,2306,2465,-159,0,474,0,8
86645,1,2451,2287,164,0,101,1,6
86646,2,2452,2487,-35,0,126,0,6
86647,1,2559,2348,211,0,128,0,6
86648,2,2467,2525,-58,0,53,0,6
86649,1,2691,2560,131,0,335,0,6
86650,1,2445,2421,24,0,326,0,6
86651,3,2431,2506,-75,0,46,0,6
86652,2,2452,2589,-137,0,421,1,6
86653,2,2532,2535,-3,0,46,1,6
86654,3,2450,2446,4,0,406,0,6
86655,1,2429,2358,71,0,11,0,6
86656,1,2506,2454,52,0,312,0,6
86657,1,2476,2536,-60,0,360,1,6
86658,1,2386,2439,-53,0,4,0,6
86659,2,2231,2446,-215,0,136,0,6
86660,2,2380,2462,-82,0,2,0,6
86661,3,2412,2281,131,0,117,0,8
86662,2,2555,2553,2,0,101,0,6
86663,1,2456,2376,80,0,41,1,6
86664,1,2441,2434,7,0,120,0,6
86665,1,2428,2486,-58,0,49,0,6
86666,1,2366,2545,-179,0,152,1,6
86667,3,2368,2402,-34,0,254,0,6
86668,1,2332,2455,-123,0,469,0,6
86669,2,2433,2377,56,4,130,0,13
86670,1,2438,2320,118,0,202,0,6
86671,1,2639,2558,81,0,387,1,6
86672,1,2406,2252,154,0,121,0,6
86673,2,2541,2472,69,0,140,1,6
86674,1,2423,2266,157,0,40,0,6
86675,1,2542,2483,59,0,46,0,6
86676,1,2449,2444,5,0,270,0,6
86677,2,2305,2412,-107,0,157,0,6
86679,1,2411,2389,22,0,398,0,6
86680,2,2584,2524,60,0,120,0,6
86681,2,2532,2529,3,0,13,0,6
86682,1,2418,2362,56,0,453,1,6
86683,1,2512,2330,182,0,317,0,6
86684,1,2409,2254,155,0,242,0,6
86685,2,2492,2447,45,0,4,0,6
86687,1,2564,2520,44,0,420,0,6
86688,2,2499,2437,62,0,310,0,6
86689,1,2259,2421,-162,4,315,1,13
86690,1,2505,2370,135,0,114,0,6
86691,1,2493,2350,143,0,311,0,6
86692,2,2391,2455,-64,0,380,0,6
86693,2,2531,2609,-78,0,483,1,6
86694,3,2504,2460,44,0,345,0,6
86695,1,2603,2478,125,0,277,1,6
86696,2,2464,2437,27,0,130,0,6
86697,1,2368,2450,-82,0,4,0,6
86698,1,2559,2481,78,0,415,0,6
86699,2,2534,2696,-162,0,40,0,6
86700,2,2294,2409,-115,0,414,1,8
86701,1,2389,2530,-141,0,45,0,6
86702,1,2462,2353,109,0,310,0,6
86703,1,2417,2319,98,0,15,0,6
86704,2,2459,2695,-236,0,27,0,6
86705,1,2447,2343,104,0,277,0,6
86706,3,2556,2509,47,0,406,0,6
86707,1,2480,2337,143,0,113,0,6
86708,1,2472,2446,26,0,240,0,6
86709,2,2408,2364,44,0,8,0,6
86711,2,2428,2521,-93,0,200,1,6
86712,1,2432,2592,-160,0,490,0,6
86713,2,2431,2321,110,0,123,0,8
86714,2,2356,2402,-46,0,58,0,6
86715,1,2484,2493,-9,0,151,0,6
86716,2,2444,2449,-5,0,300,0,6
86717,2,2471,2580,-109,0,304,0,6
86718,1,2407,2386,21,0,152,0,6
86719,2,2376,2511,-135,0,3,0,6
86720,2,2421,2356,65,0,106,0,8
86721,2,2401,2572,-171,0,107,0,6
86722,1,2425,2482,-57,0,202,0,6
86723,1,2454,2486,-32,0,126,0,6
86724,1,2262,2503,-241,0,126,0,6
86725,1,2481,2291,190,0,434,0,6
86726,1,2513,2503,10,0,39,0,6
86727,1,2461,2461,0,0,106,0,6
86728,3,2298,2403,-105,4,41,0,13
86729,2,2229,2434,-205,0,40,1,6
86730,1,2366,2455,-89,0,301,0,6
86731,1,2464,2526,-62,0,108,0,6
86732,1,2287,2469,-182,0,120,1,8
86733,1,2541,2356,185,0,200,1,6
86734,2,2374,2419,-45,0,100,0,6
86735,2,2432,2434,-2,0,4,0,6
86736,1,2558,2549,9,0,247,1,6
86737,2,2457,2339,118,0,377,0,8
86739,2,2405,2429,-24,0,123,0,6
86740,2,2251,2412,-161,0,436,0,6
86741,2,2460,2385,75,0,40,0,6
86742,1,2447,2328,119,0,1,1,6
86743,1,2439,2432,7,0,113,0,6
86744,1,2499,2698,-199,0,102,0,6
86745,1,2416,2467,-51,0,462,0,6
86746,2,2438,2424,14,0,190,1,6
86747,2,2416,2324,92,0,343,1,6
86748,1,2409,2265,144,0,335,0,8
86749,2,2433,2592,-159,0,28,0,6
86750,2,2443,2458,-15,0,300,0,6
86751,1,2535,2490,45,0,302,0,6
86752,2,2271,2449,-178,0,300,0,6
86753,2,2256,2405,-149,0,123,1,6
86754,2,2441,2451,-10,0,40,0,6
86755,1,2457,2456,1,0,15,0,6
86756,1,2690,2433,257,0,201,1,6
86757,2,2433,2368,65,0,36,1,6
86758,1,2529,2483,46,0,302,0,6
86759,2,2338,2406,-68,0,140,0,6
86760,1,2455,2313,142,0,110,0,6
86761,1,2480,2460,20,0,45,0,6
86762,1,2409,2350,59,0,315,0,6
86763,1,2537,2547,-10,0,113,0,6
86764,1,2428,2349,79,0,4,0,8
86765,2,2345,2561,-216,0,152,0,6
86766,2,2401,2215,186,0,307,0,6
86767,2,2345,2453,-108,0,0,0,6
86768,2,2377,2447,-70,0,15,0,6
86769,3,2242,2416,-174,0,202,0,8
86770,2,2281,2416,-135,0,101,0,6
86771,2,2515,2569,-54,0,106,0,6
86772,1,2321,2425,-104,0,41,0,6
86773,3,2497,2372,125,0,95,0,6
86774,1,2578,2514,64,0,440,0,6
86775,1,2440,2388,52,0,302,0,6
86776,1,2415,2248,167,0,11,0,6
86777,2,2505,2535,-30,0,45,0,6
86778,1,2406,2445,-39,0,277,1,6
86779,1,2402,2272,130,0,229,1,6
86780,3,2522,2563,-41,0,315,0,6
86781,1,2349,2466,-117,0,101,0,6
86782,1,2476,2460,16,0,193,0,6
86783,2,2401,2303,98,0,1,0,6
86784,1,2343,2434,-91,0,300,0,6
86785,2,2328,2441,-113,0,327,0,6
86786,2,2208,2584,-376,0,211,0,6
86787,2,2334,2484,-150,0,0,1,6
86788,2,2244,2535,-291,0,112,0,6
86789,1,2474,2607,-133,0,310,0,6
86790,2,2498,2518,-20,0,200,1,6
86791,2,2530,2699,-169,0,302,0,6
86792,1,2409,2351,58,0,46,0,6
86793,1,2455,2457,-2,0,380,0,6
86794,2,2510,2555,-45,0,342,0,6
86795,2,2457,2377,80,0,57,1,6
86796,2,2614,2348,266,0,248,1,6
86797,2,2456,2436,20,0,101,0,6
86798,2,2478,2534,-56,0,1,0,6
86800,2,2520,2564,-44,0,108,0,6
86801,1,2515,2640,-125,0,84,0,6
86802,2,2340,2420,-80,0,130,0,6
86803,1,2391,2457,-66,0,200,1,6
86804,2,2576,2397,179,0,110,1,6
86805,2,2455,2485,-30,0,111,0,6
86806,1,2401,2332,69,0,12,0,6
86807,2,2233,2484,-251,0,300,0,6
86808,1,2340,2420,-80,0,13,0,6
86809,3,2423,2424,-1,0,4,0,6
86810,2,2431,2277,154,0,189,0,6
86811,3,2412,2347,65,0,122,0,6
86812,2,2361,2445,-84,0,207,0,6
86813,2,2315,2442,-127,0,141,0,8
86814,2,2382,2414,-32,0,101,0,6
86815,1,2407,2351,56,0,137,0,6
86816,1,2402,2368,34,0,13,0,6
86817,2,2527,2597,-70,0,46,0,6
86818,1,2460,2294,166,0,300,0,6
86819,1,2467,2461,6,0,112,0,6
86820,2,2374,2495,-121,0,3,0,6
86821,2,2494,2394,100,0,40,0,6
86822,1,2448,2306,142,0,130,0,6
86823,1,2433,2422,11,0,247,0,6
86824,2,2327,2484,-157,4,263,0,16
86825,1,2394,2454,-60,0,122,0,6
86826,3,2343,2404,-61,0,410,0,8
86827,2,2544,2470,74,0,249,0,6
86828,1,2688,2508,180,0,110,0,6
86829,1,2445,2376,69,0,14,0,6
86830,2,2299,2426,-127,0,241,0,6
86831,2,2401,2414,-13,0,5,0,6
86832,1,2445,2245,200,0,113,0,6
86833,2,2310,2424,-114,0,145,0,6
86834,2,2447,2434,13,0,122,0,6
86835,2,2426,2320,106,0,400,0,6
86836,1,2549,2362,187,0,270,0,6
86837,2,2420,2380,40,0,10,0,6
86838,2,2540,2543,-3,0,338,0,6
86839,1,2553,2381,172,0,200,1,6
86840,1,2500,2369,131,0,45,0,6
86841,2,2464,2437,27,0,23,0,6
86842,1,2388,2402,-14,0,325,0,6
86843,1,2375,2427,-52,0,102,1,6
86844,1,2400,2430,-30,0,256,0,6
86845,1,2449,2281,168,0,211,0,6
86846,1,2334,2409,-75,0,150,0,6
86847,2,2403,2247,156,0,57,1,6
86848,1,2336,2408,-72,0,221,1,6
86849,1,2574,2510,64,0,400,1,6
86851,1,2412,2401,11,0,245,0,6
86852,3,2423,2586,-163,0,49,0,6
86853,2,2430,2692,-262,0,224,0,6
86854,2,2319,2471,-152,0,141,0,6
86855,3,2478,2423,55,0,432,0,6
86856,1,2540,2424,116,0,226,1,6
86857,3,2519,2325,194,0,48,0,6
86858,2,2415,2345,70,0,200,0,8
86859,3,2428,2415,13,0,113,0,6
86860,1,2384,2527,-143,0,8,0,6
86861,2,2252,2450,-198,0,150,0,6
86862,3,2510,2515,-5,0,432,0,6
86863,1,2569,2543,26,0,354,0,6
86864,2,2553,2738,-185,0,190,1,6
86865,3,2499,2370,129,0,330,0,6
86866,1,2456,2301,155,0,132,0,6
86867,2,2452,2478,-26,0,260,0,6
86868,1,2523,2432,91,0,331,0,6
86869,2,2301,2413,-112,0,8,0,6
86870,2,2461,2563,-102,0,300,0,6
86871,1,2560,2537,23,0,308,1,6
86872,3,2256,2451,-195,0,302,0,6
86873,1,2527,2202,325,0,13,0,6
86874,1,2451,2301,150,0,144,0,6
86875,2,2424,2423,1,0,300,1,6
86876,2,2396,2482,-86,0,18,0,6
86877,3,2454,2477,-23,0,302,0,6
86878,1,2455,2424,31,0,40,0,6
86879,2,2378,2430,-52,0,244,0,6
86880,1,2596,2397,199,0,4,0,6
86881,2,2438,2387,51,0,130,0,6
86882,1,2525,2424,101,0,330,0,6
86883,1,2604,2348,256,0,248,0,6
86884,2,2484,2597,-113,0,231,0,6
86885,1,2564,2342,222,0,278,1,6
86886,1,2691,2524,167,0,39,0,6
86887,1,2396,2417,-21,0,221,1,6
86888,1,2453,2320,133,0,1,0,6
86889,2,2506,2363,143,0,490,1,6
86890,2,2439,2232,207,0,260,0,8
86891,1,2552,2417,135,0,289,0,6
86892,2,2400,2567,-167,0,241,0,6
86893,3,2328,2421,-93,0,224,0,6
86894,1,2406,2417,-11,0,255,0,6
86895,1,2424,2438,-14,0,345,0,6
86896,1,2406,2460,-54,0,45,0,6
86897,2,2344,2414,-70,0,113,0,6
86898,2,2216,2486,-270,0,177,0,6
86899,2,2298,2406,-108,0,331,0,6
86900,1,2332,2408,-76,0,418,0,8
86901,2,2234,2529,-295,0,153,0,6
86902,1,2534,2450,84,0,96,0,6
86903,1,2325,2425,-100,0,113,0,6
86904,2,2440,2432,8,0,30,1,6
86905,1,2538,2221,317,0,41,1,6
86906,2,2349,2430,-81,0,107,0,6
86907,2,2402,2353,49,0,6,0,6
86908,2,2487,2343,144,0,345,0,6
86909,1,2450,2398,52,0,52,0,6
86910,1,2420,2397,23,0,248,0,6
86911,1,2695,2428,267,0,200,0,6
86912,1,2333,2419,-86,0,1,0,6
86913,1,2452,2412,40,0,214,0,6
86914,2,2218,2453,-235,0,45,0,6
86915,2,2341,2410,-69,0,110,0,6
86916,2,2387,2414,-27,0,438,0,6
86917,2,2330,2478,-148,0,440,1,6
86918,3,2357,2424,-67,0,300,0,6
86919,2,2373,2497,-124,0,3,0,6
86920,1,2584,2564,20,0,10,0,6
86921,2,2521,2695,-174,0,50,1,6
86922,2,2285,2464,-179,0,40,1,6
86923,1,2477,2432,45,0,200,0,6
86924,2,2443,2539,-96,0,111,0,6
86925,1,2423,2275,148,0,46,0,6
86926,2,2351,2607,-256,0,100,0,6
86927,2,2238,2479,-241,0,201,1,6
86928,1,2413,2362,51,0,121,0,6
86929,2,2420,2470,-50,0,190,0,6
86930,3,2529,2555,-26,0,409,0,6
86931,1,2539,2527,12,0,483,0,6
86932,1,2556,2415,141,0,110,0,6
86933,2,2460,2401,59,0,154,0,6
86934,2,2405,2307,98,0,0,0,6
86935,1,2488,2387,101,0,57,0,6
86936,1,2417,2254,163,0,44,0,6
86937,2,2334,2504,-170,0,241,1,6
86938,2,2447,2404,43,0,115,0,6
86939,2,2483,2421,62,0,108,0,6
86940,2,2460,2443,17,0,302,1,6
86941,3,2544,2463,81,0,226,0,6
86942,3,2457,2424,33,0,415,0,6
86943,1,2519,2228,291,0,41,0,6
86944,1,2444,2501,-57,0,300,0,6
86945,2,2515,2549,-34,0,338,0,6
86946,1,2522,2318,204,0,50,1,6
86947,1,2361,2449,-88,0,300,0,6
86948,1,2392,2426,-34,0,102,1,6
86949,1,2411,2268,143,0,106,0,6
86950,2,2574,2369,205,0,94,0,6
86951,2,2413,2223,190,0,31,1,6
86952,1,2393,2455,-62,0,200,0,6
86953,1,2412,2345,67,0,0,1,6
86954,3,2454,2397,57,0,331,0,6
86955,2,2632,2515,117,0,0,0,6
86956,2,2570,2566,4,0,13,0,6
86957,2,2233,2596,-363,0,485,0,6
86958,1,2599,2532,67,0,9,0,6
86959,2,2486,2394,92,0,154,0,6
86960,1,2584,2627,-43,0,211,0,6
86961,2,2419,2392,27,0,300,0,6
86962,3,2327,2432,-105,0,205,0,6
86963,2,2401,2305,96,0,253,0,8
86964,1,2445,2308,137,0,40,0,6
86965,1,2601,2480,121,0,203,0,6
86966,1,2260,2404,-144,0,0,0,6
86967,1,2539,2505,34,0,411,0,6
86968,1,2415,2336,79,0,130,0,6
86969,2,2299,2477,-178,0,338,0,6
86970,2,2493,2477,16,0,249,0,6
86971,1,2451,2285,166,0,40,0,8
86972,2,2263,2447,-184,0,153,1,6
86973,1,2206,2426,-220,0,300,0,6
86974,2,2521,2318,203,0,61,1,6
86975,1,2432,2410,22,0,226,0,6
86976,2,2262,2400,-138,0,49,0,6
86977,2,2434,2498,-64,0,20,1,6
86978,3,2414,2238,176,0,302,0,8
86979,1,2373,2400,-27,0,178,0,6
86980,1,2420,2330,90,0,16,0,6
86981,1,2432,2457,-25,0,103,0,6
86982,2,2456,2382,74,0,466,1,6
86983,2,2226,2501,-275,0,106,0,6
86985,3,2380,2430,-50,0,45,0,6
86986,2,2371,2544,-173,0,111,1,6
86987,1,2413,2343,70,4,46,1,13
86988,3,2511,2275,236,0,312,0,6
86989,1,2420,2370,50,0,352,1,6
86990,2,2251,2407,-156,0,200,0,6
86991,2,2439,2453,-14,0,453,1,6
86992,2,2300,2443,-143,0,487,1,6
86993,1,2453,2510,-57,0,103,0,6
86994,2,2407,2429,-22,0,256,0,6
86995,2,2235,2540,-305,0,13,0,6
86996,1,2448,2278,170,0,312,0,6
86997,2,2419,2381,38,0,36,1,6
86998,2,2251,2440,-189,0,135,0,6
86999,1,2493,2346,147,0,40,0,6
87000,2,2307,2442,-135,0,397,0,6
87001,2,2554,2530,24,0,123,0,6
87002,2,2427,2477,-50,0,241,1,6
87003,1,2560,2527,33,0,130,0,6
87004,2,2442,2597,-155,0,155,0,6
87005,1,2399,2565,-166,0,122,0,6
87006,3,2521,2346,175,0,40,0,6
87007,2,2314,2479,-165,0,436,0,6
87008,1,2566,2373,193,0,110,0,6
87009,3,2427,2485,-58,0,147,0,6
87010,1,2401,2446,-45,0,212,1,6
87011,1,2698,2517,181,0,45,0,6
87012,2,2417,2322,95,0,302,0,6
87013,2,2426,2697,-271,0,224,0,6
87014,2,2378,2559,-181,0,3,0,6
87015,1,2340,2434,-94,0,241,1,6
87016,2,2220,2430,-210,0,295,0,8
87017,1,2334,2422,-88,0,123,0,6
87018,2,2551,2621,-70,0,106,0,6
87019,2,2450,2543,-93,0,103,0,6
87020,1,2355,2419,-64,0,102,0,6
87021,1,2620,2590,30,0,301,0,6
87022,1,2463,2247,216,0,300,1,6
87023,3,2458,2264,194,0,1,0,6
87024,1,2494,2450,44,0,335,0,6
87025,1,2500,2351,149,0,48,0,6
87026,1,2476,2605,-129,0,268,0,6
87027,1,2449,2453,-4,0,424,0,6
87028,2,2238,2531,-293,0,301,0,6
87029,3,2398,2413,-15,0,100,0,6
87030,2,2288,2415,-127,0,102,0,8
87031,1,2252,2414,-162,0,112,0,6
87032,1,2456,2366,90,0,492,0,6
87033,2,2475,2489,-14,0,477,0,6
87034,3,2415,2428,-13,0,202,0,6
87035,2,2396,2449,-53,0,0,0,6
87036,2,2282,2449,-167,0,120,0,6
87037,2,2471,2329,142,0,171,0,6
87038,3,2316,2471,-155,0,213,0,6
87039,1,2424,2314,110,0,4,0,6
87040,2,2498,2481,17,0,440,1,6
87041,1,2338,2417,-79,0,1,0,6
87042,1,2430,2338,92,0,104,0,6
87043,2,2252,2430,-178,0,277,0,6
87044,2,2281,2487,-206,0,45,0,6
87045,1,2415,2296,119,0,415,0,6
87046,1,2414,2529,-115,0,202,1,6
87047,2,2227,2505,-278,0,200,0,6
87048,2,2364,2504,-140,0,374,1,6
87049,1,2483,2503,-20,0,108,0,6
87050,2,2429,2451,-22,0,335,0,6
87051,2,2429,2438,-9,0,250,1,6
87052,2,2348,2504,-156,0,330,0,6
87053,1,2410,2248,162,0,145,0,6
87054,2,2405,2398,7,0,43,1,6
87055,1,2473,2223,250,0,0,0,6
87056,2,2279,2482,-203,0,210,1,6
87057,3,2443,2371,72,0,142,0,6
87058,1,2526,2237,289,0,101,0,6
87059,2,2446,2559,-113,0,4,0,6
87060,2,2353,2525,-172,0,437,0,6
87061,2,2482,2482,0,0,193,0,6
87062,1,2503,2332,171,0,387,0,6
87063,2,2382,2400,-18,0,50,0,6
87064,1,2547,2455,92,0,406,0,6
87065,2,2396,2536,-140,0,45,1,6
87066,1,2514,2702,-188,0,307,0,6
87067,2,2365,2499,-134,0,311,0,6
87068,3,2452,2340,112,0,311,0,6
87069,1,2531,2448,83,0,121,0,6
87070,2,2365,2425,-60,0,101,0,6
87071,2,2313,2496,-183,0,135,1,6
87072,2,2333,2459,-126,0,10,0,6
87073,2,2638,2672,-34,0,245,0,6
87074,1,2272,2446,-174,0,152,0,6
87075,1,2593,2499,94,0,45,0,6
87076,1,2451,2346,105,0,106,0,6
87077,2,2427,2507,-80,0,107,0,6
87078,1,2422,2454,-32,0,310,0,8
87079,1,2424,2363,61,0,22,0,6
87080,2,2211,2533,-322,0,120,0,6
87081,1,2541,2259,282,0,49,0,6
87082,1,2457,2315,142,0,101,0,6
87083,3,2699,2424,275,0,440,0,6
87084,1,2482,2422,60,0,4,0,6
87085,2,2240,2601,-361,0,1,0,6
87086,1,2522,2378,144,0,221,1,6
87087,1,2562,2447,115,0,120,1,6
87088,1,2445,2304,141,0,110,0,6
87089,2,2454,2369,85,0,337,1,6
87090,2,2510,2548,-38,0,398,0,6
87091,1,2448,2416,32,0,56,0,6
87092,2,2627,2375,252,0,40,0,6
87093,1,2448,2290,158,0,127,0,6
87094,1,2490,2519,-29,0,16,1,6
87095,1,2524,2391,133,0,295,0,6
87096,2,2413,2362,51,0,110,0,6
87097,1,2326,2401,-75,0,100,0,6
87098,3,2547,2561,-14,0,150,0,6
87099,3,2446,2461,-15,0,218,0,6
87100,2,2610,2475,135,0,1,1,6
87101,1,2597,2484,113,0,276,0,6
87102,2,2511,2412,99,0,40,0,6
87103,3,2264,2451,-187,0,331,0,6
87104,2,2513,2222,291,0,335,1,6
87105,1,2557,2398,159,0,315,0,6
87106,2,2477,2406,71,0,137,0,6
87107,2,2624,2458,166,0,210,0,6
87108,1,2675,2632,43,0,200,0,6
87109,2,2328,2506,-178,0,101,0,6
87110,1,2281,2452,-171,0,2,1,6
87111,2,2428,2350,78,0,335,1,6
87112,1,2430,2279,151,0,44,1,6
87113,2,2406,2292,114,0,246,0,6
87114,1,2492,2311,181,0,470,0,6
87115,1,2677,2569,108,0,152,0,6
87116,1,2411,2446,-35,0,48,0,8
87117,2,2401,2244,157,0,145,1,6
87118,2,2410,2524,-114,0,336,0,6
87119,3,2494,2449,45,0,58,0,6
87120,1,2447,2551,-104,0,21,0,6
87121,2,2384,2614,-230,0,2,0,6
87122,1,2347,2485,-138,0,202,1,6
87123,2,2410,2349,61,0,0,0,6
87124,1,2310,2424,-114,0,152,1,6
87125,1,2444,2442,2,0,190,0,6
87126,1,2497,2563,-66,0,47,1,6
87127,1,2484,2428,56,0,45,0,6
87128,1,2489,2565,-76,0,130,0,6
87129,1,2405,2295,110,0,343,1,6
87130,2,2442,2408,34,0,200,0,6
87131,1,2526,2476,50,0,277,1,6
87132,2,2399,2480,-81,0,426,1,6
87133,2,2349,2528,-179,0,437,0,6
87134,3,2626,2681,-55,0,101,0,6
87135,1,2523,2457,66,0,56,0,6
87136,1,2458,2250,208,0,178,1,6
87137,2,2396,2501,-105,0,245,0,6
87138,1,2435,2273,162,0,218,1,8
87139,1,2491,2352,139,0,16,0,6
87140,3,2540,2388,152,0,50,0,6
87141,1,2386,2406,-20,0,102,1,6
87142,2,2428,2487,-59,0,48,0,6
87143,2,2419,2305,114,0,192,0,8
87144,2,2460,2365,95,0,101,0,6
87145,1,2447,2324,123,0,70,1,6
87146,2,2434,2253,181,0,353,0,6
87147,1,2433,2249,184,0,30,1,6
87148,1,2480,2601,-121,0,359,0,6
87149,2,2264,2436,-172,0,409,0,6
87151,1,2462,2450,12,0,203,0,6
87152,1,2360,2403,-43,0,1,0,6
87153,1,2449,2414,35,0,203,1,6
87154,1,2385,2459,-74,0,7,0,6
87155,1,2428,2415,13,0,112,0,6
87156,2,2368,2499,-131,0,127,0,6
87157,2,2293,2435,-142,0,251,0,6
87158,1,2471,2396,75,0,107,0,6
87159,2,2488,2450,38,0,226,1,6
87160,2,2591,2554,37,0,20,0,6
87161,1,2437,2566,-129,0,4,0,6
87162,1,2477,2340,137,0,15,0,8
87163,2,2344,2602,-258,0,109,1,6
87164,2,2483,2394,89,0,463,0,6
87165,1,2572,2391,181,0,335,0,6
87166,2,2513,2514,-1,0,46,1,6
87167,2,2496,2504,-8,0,4,0,6
87168,2,2220,2504,-284,0,4,0,6
87169,1,2349,2495,-146,0,102,1,6
87170,1,2482,2470,12,0,105,0,6
87171,1,2539,2347,192,0,474,0,6
87172,2,2439,2522,-83,0,123,0,6
87173,3,2388,2422,-34,0,310,0,6
87174,3,2410,2433,-23,0,113,0,6
87175,1,2413,2495,-82,0,123,0,6
87176,1,2668,2547,121,0,201,0,6
87177,1,2455,2395,60,0,133,0,6
87178,2,2356,2446,-90,0,45,0,6
87179,1,2499,2344,155,0,152,0,8
87180,3,2333,2460,-127,0,343,0,6
87181,2,2434,2260,174,0,100,1,8
87182,1,2517,2761,-244,0,28,1,6
87183,1,2494,2584,-90,0,313,0,6
87184,2,2314,2537,-223,0,66,0,6
87185,3,2479,2528,-49,0,415,0,6
87186,3,2618,2382,236,0,40,0,6
87187,3,2509,2325,184,0,20,0,6
87188,1,2433,2357,76,0,400,0,6
87189,2,2431,2466,-35,0,7,0,6
87190,1,2502,2453,49,0,210,1,6
87191,1,2309,2444,-135,0,56,1,6
87192,2,2496,2528,-32,0,108,1,6
87193,1,2450,2453,-3,0,102,1,6
87194,1,2560,2504,56,0,15,0,6
87195,2,2451,2557,-106,0,200,0,6
87196,1,2452,2243,209,0,466,0,6
87197,2,2285,2468,-183,0,122,0,6
87198,1,2449,2226,223,0,43,0,6
87199,3,2423,2491,-68,0,109,0,6
87200,2,2358,2409,-51,0,120,0,6
87201,1,2594,2488,106,0,123,0,6
87202,1,2477,2284,193,0,310,0,6
87203,2,2439,2465,-26,0,13,0,6
87204,1,2327,2416,-89,0,45,1,6
87205,2,2366,2550,-184,0,326,0,6
87206,1,2467,2288,179,0,245,1,6
87207,2,2402,2538,-136,0,90,1,6
87208,2,2504,2239,265,0,331,0,6
87209,1,2451,2317,134,0,110,0,6
87210,1,2505,2418,87,0,311,0,6
87211,1,2400,2421,-21,0,0,1,6
87212,1,2361,2476,-115,0,121,0,6
87213,1,2265,2401,-136,0,150,0,6
87214,1,2505,2226,279,0,337,0,6
87215,1,2423,2404,19,0,415,0,6
87216,1,2491,2396,95,0,302,0,6
87217,2,2555,2616,-61,0,8,0,6
87218,2,2390,2402,-12,0,113,0,6
87219,1,2484,2598,-114,0,247,0,6
87220,2,2331,2454,-123,0,301,0,6
87221,1,2409,2464,-55,0,122,0,6
87222,2,2331,2445,-114,0,123,0,6
87223,3,2363,2440,-77,0,5,0,8
87224,2,2464,2338,126,0,133,0,6
87225,1,2445,2391,54,0,50,0,6
87226,2,2241,2544,-303,0,115,1,6
87227,2,2313,2417,-104,0,200,0,8
87228,2,2307,2426,-119,0,46,0,6
87229,2,2433,2381,52,0,21,0,6
87230,2,2240,2604,-364,0,45,0,6
87231,2,2213,2454,-241,0,154,0,6
87232,3,2560,2575,-15,0,228,0,6
87233,1,2418,2258,160,4,302,0,13
87234,2,2402,2565,-163,0,121,0,6
87235,1,2471,2567,-96,0,123,1,6
87236,2,2433,2543,-110,0,104,0,6
87237,2,2385,2613,-228,0,2,0,6
87238,3,2491,2460,31,0,242,0,6
87239,1,2471,2509,-38,0,245,0,6
87240,1,2414,2202,212,0,48,0,6
87241,1,2509,2374,135,0,40,0,6
87242,1,2443,2507,-64,0,46,0,6
87243,1,2458,2313,145,0,90,0,6
87244,2,2452,2420,32,0,108,0,6
87245,2,2539,2537,2,0,290,0,6
87246,2,2246,2436,-190,0,256,0,6
87247,3,2561,2479,82,0,300,0,6
87248,2,2447,2395,52,0,132,1,6
87249,2,2261,2507,-246,0,123,1,6
87250,3,2585,2457,128,0,18,0,6
87251,1,2502,2385,117,0,4,0,6
87252,3,2526,2494,32,0,477,0,6
87253,1,2748,2528,220,0,315,0,6
87254,1,2282,2438,-156,0,46,0,6
87255,2,2404,2451,-47,0,331,0,6
87256,1,2417,2216,201,0,41,1,6
87257,2,2352,2427,-75,0,151,1,6
87258,1,2328,2507,-179,0,241,0,6
87259,1,2531,2371,160,0,488,0,6
87260,3,2431,2312,119,0,127,0,6
87261,1,2463,2471,-8,0,196,0,6
87262,2,2457,2347,110,0,43,1,6
87263,2,2616,2383,233,0,40,0,6
87264,1,2418,2367,51,0,140,0,6
87265,2,2499,2496,3,0,49,1,6
87266,1,2455,2425,30,0,338,0,6
87267,2,2283,2400,-117,0,466,0,6
87268,1,2357,2438,-81,0,122,1,8
87269,1,2645,2682,-37,0,140,0,6
87270,1,2345,2414,-69,0,167,1,6
87271,1,2480,2371,109,0,461,1,6
87272,1,2605,2383,222,0,13,0,6
87273,1,2436,2412,24,0,455,0,6
87274,2,2590,2491,99,0,106,0,6
87275,1,2412,2249,163,0,236,0,8
87276,1,2533,2565,-32,0,122,0,6
87277,2,2488,2491,-3,0,306,0,6
87278,2,2449,2447,2,0,15,0,6
87279,1,2439,2244,195,0,7,0,6
87280,1,2245,2429,-184,0,123,0,6
87281,1,2293,2434,-141,0,20,1,8
87282,2,2458,2456,2,0,106,1,6
87283,2,2428,2450,-22,0,151,0,6
87284,2,2409,2500,-91,0,15,1,6
87285,2,2450,2593,-143,0,410,0,6
87286,2,2226,2495,-269,0,45,0,6
87287,1,2433,2410,23,0,331,1,6
87288,1,2541,2363,178,0,50,0,6
87289,2,2415,2426,-11,0,21,0,6
87290,2,2376,2408,-32,0,46,0,6
87291,1,2468,2339,129,0,1,1,6
87292,1,2385,2438,-53,0,245,1,6
87293,2,2449,2378,71,0,4,0,6
87294,2,2213,2546,-333,0,331,0,6
87295,1,2503,2390,113,0,436,1,6
87296,2,2462,2447,15,0,300,1,6
87297,2,2393,2490,-97,0,112,1,6
87298,2,2449,2388,61,0,4,0,6
87299,2,2241,2442,-201,0,250,1,6
87300,2,2314,2460,-146,0,242,0,6
87301,2,2574,2429,145,0,338,0,6
87302,2,2401,2477,-76,0,4,0,6
87303,1,2404,2442,-38,0,106,1,6
87304,2,2560,2560,0,0,300,0,6
87305,3,2505,2498,7,0,46,0,6
87306,1,2527,2509,18,0,45,0,6
87307,1,2507,2480,27,0,147,0,6
87308,1,2347,2459,-112,0,4,1,6
87309,2,2481,2559,-78,0,100,0,6
87310,2,2478,2583,-105,0,112,1,6
87311,1,2344,2421,-77,0,202,0,6
87312,1,2482,2381,101,0,143,0,6
87313,2,2449,2388,61,0,335,1,6
87314,3,2453,2366,87,0,245,0,6
87315,1,2296,2443,-147,0,405,0,6
87316,2,2675,2651,24,0,189,0,6
87317,2,2392,2604,-212,0,2,0,6
87318,1,2621,2470,151,0,13,1,6
87319,2,2489,2424,65,0,4,1,6
87320,2,2221,2456,-235,0,252,1,6
87321,2,2315,2540,-225,0,66,0,6
87322,1,2752,2340,412,0,335,1,6
87323,2,2378,2506,-128,0,30,0,6
87324,2,2510,2608,-98,0,483,1,6
87325,2,2612,2446,166,0,190,0,6
87326,1,2420,2492,-72,0,300,0,6
87327,2,2401,2508,-107,0,385,1,6
87328,1,2438,2335,103,0,255,1,6
87329,1,2398,2440,-42,0,127,0,6
87330,1,2531,2409,122,0,140,0,6
87331,1,2569,2398,171,0,261,1,6
87332,1,2464,2360,104,0,205,0,6
87333,2,2465,2263,202,0,45,1,6
87334,2,2248,2469,-221,0,197,1,6
87335,1,2508,2209,299,0,373,0,6
87336,1,2430,2310,120,0,80,1,6
87337,1,2465,2422,43,0,7,0,6
87338,1,2322,2431,-109,0,139,0,6
87339,2,2337,2418,-81,0,263,0,6
87340,2,2263,2423,-160,0,45,1,6
87341,3,2421,2283,138,0,46,0,8
87342,1,2449,2429,20,0,52,0,6
87343,2,2442,2405,37,0,3,0,6
87344,2,2559,2540,19,0,460,0,6
87345,1,2413,2371,42,0,101,0,6
87346,1,2493,2497,-4,0,343,0,6
87347,1,2452,2429,23,0,167,1,6
87348,2,2403,2597,-194,0,151,0,6
87349,2,2348,2452,-104,0,254,0,6
87350,1,2671,2462,209,0,48,1,6
87351,2,2407,2506,-99,0,44,1,6
87352,3,2497,2443,54,0,333,0,6
87353,1,2394,2484,-90,0,200,1,6
87354,2,2375,2535,-160,0,306,0,6
87355,1,2519,2239,280,0,2,1,6
87356,1,2439,2274,165,0,142,0,8
87357,2,2379,2410,-31,0,302,0,6
87358,2,2432,2406,26,0,123,0,6
87359,2,2449,2297,152,0,380,0,6
87360,1,2494,2503,-9,0,463,0,6
87361,1,2463,2370,93,4,45,0,13
87362,3,2455,2553,-98,0,113,0,6
87363,3,2427,2356,71,0,300,0,6
87364,1,2268,2459,-191,0,227,1,6
87365,2,2459,2482,-23,0,251,0,6
87366,1,2547,2217,330,0,41,0,6
87367,2,2423,2526,-103,0,207,0,6
87368,3,2504,2510,-6,0,46,0,6
87369,1,2417,2354,63,0,398,0,6
87370,2,2389,2468,-79,0,2,0,6
87371,1,2385,2442,-57,0,190,1,6
87372,2,2326,2453,-127,0,302,0,6
87373,2,2291,2456,-165,0,202,0,6
87374,2,2250,2407,-157,0,4,0,6
87375,2,2333,2421,-88,4,8,0,13
87376,3,2566,2554,12,0,227,0,6
87377,1,2356,2434,-78,0,411,1,6
87378,1,2314,2426,-112,0,133,0,8
87379,3,2423,2304,119,0,140,0,6
87380,1,2678,2494,184,0,487,1,6
87381,1,2391,2404,-13,0,253,1,6
87382,2,2249,2496,-247,0,45,0,6
87383,1,2272,2444,-172,0,382,1,6
87384,2,2554,2527,27,0,310,0,6
87385,1,2564,2476,88,0,300,1,6
87386,2,2351,2438,-87,0,312,0,8
87387,1,2254,2401,-147,0,106,0,6
87388,1,2559,2600,-41,0,300,0,6
87389,1,2507,2399,108,0,347,0,6
87390,3,2393,2535,-142,0,61,0,6
87391,2,2448,2566,-118,0,250,0,6
87392,1,2420,2423,-3,0,201,0,6
87393,2,2293,2463,-170,0,101,1,6
87394,1,2472,2423,49,0,102,0,6
87395,1,2437,2412,25,0,43,0,6
87396,1,2486,2385,101,0,40,0,6
87397,1,2435,2410,25,0,484,0,6
87398,1,2347,2452,-105,0,255,1,6
87399,2,2657,2669,-12,0,241,0,6
87400,2,2374,2451,-77,0,458,0,6
87401,1,2460,2330,130,0,330,0,6
87402,1,2587,2474,113,0,398,1,6
87403,1,2370,2431,-61,0,5,1,8
87404,2,2376,2506,-130,0,140,0,6
87405,2,2384,2510,-126,0,106,0,6
87406,1,2612,2402,210,0,15,0,6
87407,1,2492,2439,53,0,124,0,6
87408,1,2415,2373,42,0,335,0,6
87409,1,2348,2441,-93,0,140,0,6
87410,1,2450,2218,232,0,203,1,6
87411,1,2644,2570,74,0,225,1,6
87412,1,2361,2493,-132,0,3,0,6
87413,1,2477,2336,141,0,205,0,6
87414,1,2400,2327,73,0,415,0,6
87415,2,2212,2456,-244,0,120,0,6
87416,2,2513,2355,158,0,404,1,6
87417,2,2501,2624,-123,0,40,0,6
87418,1,2457,2277,180,0,101,0,6
87419,1,2475,2466,9,0,210,0,6
87420,2,2387,2538,-151,0,113,0,6
87421,1,2402,2341,61,0,49,0,6
87422,1,2510,2427,83,0,253,0,6
87423,2,2306,2434,-128,0,101,0,6
87424,2,2417,2470,-53,0,114,1,6
87425,1,2393,2455,-62,0,194,0,6
87426,2,2287,2522,-235,0,50,0,6
87427,2,2403,2331,72,0,333,0,6
87428,1,2267,2419,-152,0,101,1,6
87429,2,2551,2499,52,0,5,0,6
87430,2,2349,2400,-51,0,40,1,6
87431,2,2353,2466,-113,0,241,0,8
87432,2,2431,2480,-49,0,320,1,6
87433,2,2491,2505,-14,0,454,1,6
87434,1,2510,2438,72,0,313,1,6
87435,1,2477,2239,238,0,307,0,6
87436,3,2372,2403,-31,0,121,0,6
87437,2,2418,2375,43,0,102,0,6
87438,1,2424,2296,128,0,241,0,6
87439,1,2485,2384,101,0,411,0,6
87440,3,2459,2674,-215,0,101,0,6
87441,1,2488,2369,119,0,240,0,6
87442,2,2205,2544,-339,0,0,0,6
87443,1,2498,2402,96,0,57,1,6
87444,2,2291,2442,-151,0,106,1,6
87445,2,2487,2375,112,0,107,0,6
87446,2,2456,2444,12,0,106,1,6
87447,2,2421,2383,38,0,18,0,6
87448,1,2594,2553,41,0,190,0,6
87449,2,2499,2370,129,0,331,1,6
87450,1,2435,2341,94,0,307,0,6
87451,2,2422,2426,-4,0,40,0,6
87452,2,2411,2435,-24,0,101,1,6
87453,2,2549,2314,235,0,352,0,6
87454,2,2565,2570,-5,0,300,0,6
87455,2,2423,2481,-58,0,242,0,6
87456,2,2255,2480,-225,0,210,0,6
87457,2,2506,2462,44,0,46,0,6
87458,3,2541,2545,-4,0,115,0,6
87459,2,2256,2404,-148,0,123,0,6
87460,2,2554,2566,-12,0,300,0,6
87461,1,2368,2420,-52,0,315,0,6
87462,1,2351,2443,-92,0,202,0,6
87463,1,2576,2376,200,0,56,0,6
87464,2,2675,2652,23,0,194,0,6
87465,1,2514,2237,277,0,46,0,6
87466,2,2307,2421,-114,0,420,0,6
87467,2,2395,2572,-177,0,122,0,6
87468,2,2397,2427,-30,0,190,0,6
87469,2,2262,2442,-180,0,123,0,6
87470,2,2428,2397,31,0,13,0,6
87471,1,2568,2560,8,0,46,0,6
87472,1,2490,2372,118,0,277,0,6
87473,2,2448,2460,-12,0,250,0,6
87474,2,2470,2591,-121,0,112,0,6
87475,2,2405,2441,-36,0,140,0,6
87476,2,2509,2373,136,0,43,1,6
87477,1,2468,2402,66,0,45,0,6
87478,1,2442,2481,-39,0,115,0,8
87479,2,2267,2437,-170,0,21,0,6
87480,1,2512,2378,134,0,184,0,6
87481,1,2472,2497,-25,0,55,0,6
87482,1,2492,2363,129,0,490,0,6
87483,2,2360,2444,-84,0,278,0,6
87484,2,2429,2344,85,0,33,0,6
87485,2,2615,2325,290,0,10,1,6
87486,1,2419,2486,-67,0,46,0,6
87487,1,2498,2500,-2,0,148,0,6
87488,2,2281,2478,-197,4,115,0,13
87489,2,2434,2355,79,0,201,0,6
87490,1,2671,2462,209,0,106,0,6
87491,2,2515,2457,58,0,190,0,6
87492,1,2545,2239,306,0,23,0,6
87493,2,2339,2419,-80,0,115,0,6
87494,2,2326,2440,-114,0,45,0,6
87495,1,2379,2489,-110,0,15,1,6
87496,1,2455,2464,-9,0,404,0,6
87497,2,2451,2227,224,0,43,1,6
87498,2,2580,2533,47,0,310,1,6
87499,1,2527,2209,318,0,338,0,6
87500,2,2374,2452,-78,0,0,1,6
87501,3,2417,2425,-8,0,110,0,6
87502,1,2426,2297,129,4,49,0,13
87503,2,2442,2412,30,0,448,0,6
87504,1,2562,2420,142,0,112,0,6
87505,2,2337,2492,-155,0,245,1,6
87506,2,2312,2419,-107,0,330,0,8
87507,1,2510,2358,152,0,314,0,6
87508,2,2554,2682,-128,0,150,0,6
87509,1,2516,2347,169,0,43,1,6
87510,1,2493,2321,172,0,106,1,8
87511,1,2605,2210,395,0,133,0,8
87512,1,2405,2365,40,0,0,0,6
87513,2,2302,2401,-99,0,151,1,6
87514,1,2504,2486,18,0,107,1,6
87515,2,2381,2515,-134,0,3,0,6
87516,2,2408,2419,-11,0,419,0,6
87517,1,2419,2429,-10,0,200,0,8
87518,2,2610,2533,77,0,13,0,6
87519,1,2433,2408,25,0,151,1,6
87520,1,2414,2375,39,0,414,0,6
87521,2,2283,2503,-220,0,466,0,6
87522,1,2363,2419,-56,0,4,0,6
87523,2,2270,2441,-171,0,120,0,6
87524,2,2352,2410,-58,0,144,0,6
87525,2,2316,2494,-178,0,205,0,6
87526,2,2685,2672,13,0,100,0,6
87527,2,2268,2402,-134,0,50,1,6
87528,1,2445,2356,89,0,0,0,6
87529,2,2482,2381,101,0,331,0,6
87530,1,2415,2427,-12,0,10,0,6
87531,1,2533,2628,-95,0,463,0,6
87532,1,2496,2374,122,0,45,0,6
87533,1,2450,2368,82,0,277,1,6
87534,2,2332,2432,-100,0,14,0,6
87535,2,2475,2412,63,0,4,0,6
87536,2,2571,2549,22,0,111,1,6
87537,2,2312,2435,-123,0,5,0,6
87538,1,2658,2669,-11,0,263,0,6
87539,1,2389,2404,-15,0,200,0,6
87540,3,2427,2259,168,0,131,0,6
87541,2,2491,2478,13,0,346,0,6
87542,1,2595,2467,128,0,398,1,6
87543,1,2541,2387,154,0,244,1,6
87544,1,2548,2545,3,0,112,0,6
87545,1,2424,2241,183,0,269,0,8
87546,2,2444,2381,63,0,106,1,6
87547,3,2519,2421,98,0,30,0,6
87548,1,2575,2392,183,0,245,0,6
87549,2,2283,2461,-178,0,202,1,6
87550,2,2460,2674,-214,0,101,0,6
87551,2,2474,2449,25,0,456,0,8
87552,3,2444,2421,23,0,395,0,6
87553,1,2226,2473,-247,0,45,1,6
87554,1,2244,2610,-366,0,46,1,8
87555,2,2370,2419,-49,0,311,1,6
87556,2,2432,2307,125,0,269,1,6
87557,2,2426,2480,-54,0,53,0,6
87558,1,2477,2374,103,0,441,0,6
87559,1,2424,2288,136,0,112,0,6
87560,1,2446,2400,46,0,40,1,6
87561,3,2360,2449,-89,0,3,0,6
87562,1,2386,2508,-122,0,43,1,6
87563,1,2622,2680,-58,0,320,0,6
87564,2,2289,2468,-179,4,204,0,13
87565,1,2480,2406,74,0,107,0,6
87566,2,2428,2479,-51,0,242,0,6
87567,2,2413,2426,-13,0,304,0,6
87568,2,2242,2413,-171,0,374,1,6
87569,1,2535,2287,248,0,49,0,6
87570,2,2290,2476,-186,4,100,0,0
87571,1,2484,2485,-1,0,483,1,6
87572,2,2359,2540,-181,0,140,0,6
87573,2,2330,2485,-155,0,460,0,8
87574,1,2415,2341,74,0,331,0,6
87575,2,2540,2574,-34,0,106,0,6
87576,2,2569,2495,74,0,463,0,6
87577,2,2231,2605,-374,0,15,0,6
87578,2,2395,2514,-119,0,218,0,6
87579,2,2377,2457,-80,0,2,0,6
87580,1,2621,2406,215,0,211,0,6
87581,3,2355,2452,-97,0,58,0,6
87582,2,2495,2348,147,0,122,1,6
87583,2,2212,2449,-237,0,102,1,6
87584,1,2679,2548,131,0,398,0,6
87585,1,2460,2427,33,0,16,0,8
87586,3,2245,2406,-161,0,4,0,6
87587,1,2484,2334,150,0,133,0,6
87588,1,2403,2296,107,0,255,1,6
87589,2,2475,2299,176,0,345,0,6
87590,2,2369,2436,-67,0,4,0,6
87591,3,2410,2445,-35,0,106,0,6
87592,1,2579,2535,44,0,5,0,6
87593,1,2539,2423,116,0,7,0,6
87594,2,2329,2519,-190,0,40,1,6
87595,1,2379,2505,-126,0,121,0,6
87596,1,2335,2463,-128,0,90,1,6
87597,1,2503,2223,280,0,337,0,6
87598,1,2424,2243,181,0,121,0,8
87599,1,2555,2565,-10,0,300,0,6
87600,1,2663,2664,-1,0,301,0,6
87601,2,2439,2368,71,0,4,0,6
87603,2,2403,2438,-35,0,265,1,6
87604,2,2381,2497,-116,0,45,0,6
87605,2,2379,2416,-37,0,110,1,6
87606,3,2560,2561,-1,0,111,0,6
87607,2,2405,2345,60,0,337,1,6
87608,1,2261,2529,-268,0,485,0,6
87609,1,2370,2419,-49,0,123,0,6
87610,3,2236,2401,-165,0,150,0,6
87611,2,2336,2481,-145,0,200,1,6
87612,2,2550,2678,-128,0,100,0,6
87613,1,2487,2323,164,0,191,0,6
87614,2,2443,2227,216,0,300,1,6
87615,1,2540,2517,23,0,34,0,6
87616,2,2403,2624,-221,0,113,0,6
87617,2,2398,2401,-3,0,134,0,6
87618,1,2480,2579,-99,0,249,0,6
87619,1,2422,2297,125,0,318,0,6
87620,2,2493,2454,39,0,105,0,6
87621,2,2316,2421,-105,0,122,1,8
87622,1,2352,2458,-106,0,122,0,6
87623,2,2307,2437,-130,0,189,1,6
87624,2,2275,2466,-191,0,210,1,6
87625,1,2516,2355,161,0,346,1,6
87626,1,2567,2265,302,0,440,0,6
87627,3,2554,2545,9,0,9,0,6
87628,1,2594,2450,144,0,400,0,6
87629,2,2340,2425,-85,0,302,0,8
87630,1,2443,2262,181,0,57,0,6
87631,1,2402,2407,-5,0,133,1,6
87632,3,2425,2417,8,0,201,0,6
87633,2,2392,2435,-43,0,405,0,6
87634,2,2579,2463,116,0,251,0,6
87635,1,2389,2578,-189,0,120,0,6
87636,1,2342,2485,-143,0,260,0,6
87637,1,2537,2245,292,0,11,1,6
87638,2,2471,2400,71,0,9,1,6
87639,3,2447,2377,70,0,101,0,6
87640,1,2501,2393,108,0,412,0,6
87641,2,2425,2491,-66,0,242,1,6
87642,3,2363,2424,-61,0,245,0,6
87643,2,2543,2501,42,0,8,0,6
87644,1,2456,2505,-49,0,140,1,6
87645,1,2421,2252,169,0,10,0,6
87646,2,2494,2402,92,0,434,0,6
87647,1,2440,2357,83,0,10,0,6
87648,2,2450,2403,47,0,101,0,6
87649,1,2636,2547,89,0,45,0,6
87650,1,2549,2214,335,0,37,1,6
87651,2,2401,2382,19,0,311,0,6
87652,2,2423,2262,161,0,41,0,8
87653,2,2375,2432,-57,0,150,0,6
87654,1,2572,2629,-57,0,415,0,6
87655,1,2461,2239,222,0,151,0,6
87656,3,2445,2299,146,4,112,0,13
87657,1,2427,2255,172,0,245,0,6
87658,2,2451,2488,-37,0,335,0,6
87659,2,2273,2401,-128,0,200,0,6
87660,2,2530,2584,-54,0,106,0,6
87661,3,2421,2485,-64,0,115,0,6
87662,1,2658,2669,-11,0,288,1,6
87663,1,2501,2342,159,0,40,0,6
87664,3,2498,2522,-24,0,40,0,6
87665,2,2418,2392,26,0,330,0,6
87666,2,2468,2461,7,0,5,0,6
87667,1,2626,2401,225,0,0,0,6
87668,2,2208,2407,-199,0,108,0,6
87669,3,2425,2419,6,0,205,0,6
87670,1,2463,2373,90,0,203,0,6
87671,2,2356,2446,-90,0,144,0,6
87672,1,2441,2274,167,0,43,0,6
87673,3,2561,2560,1,0,300,0,6
87674,1,2467,2331,136,0,117,0,6
87675,1,2519,2242,277,0,484,1,6
87676,2,2393,2462,-69,0,121,0,6
87677,2,2353,2498,-145,0,141,0,6
87678,2,2416,2354,62,0,201,0,6
87679,1,2599,2427,172,0,373,0,8
87680,1,2401,2408,-7,0,490,0,6
87681,1,2543,2356,187,0,474,0,6
87682,2,2461,2487,-26,0,136,0,6
87683,1,2451,2359,92,0,177,0,6
87684,1,2546,2545,1,0,18,0,6
87685,2,2469,2333,136,0,31,0,6
87686,2,2424,2484,-60,0,13,0,6
87687,2,2510,2412,98,0,45,0,6
87688,1,2446,2351,95,0,281,0,6
87689,1,2423,2355,68,0,45,0,6
87690,2,2446,2336,110,0,302,1,6
87691,1,2573,2546,27,0,241,0,6
87692,2,2446,2389,57,0,106,0,6
87693,1,2402,2285,117,0,113,0,6
87694,1,2410,2342,68,0,112,1,6
87695,2,2471,2713,-242,0,123,0,6
87696,3,2378,2424,-46,0,45,0,6
87697,1,2493,2502,-9,0,200,0,6
87698,2,2388,2449,-61,0,219,0,6
87699,1,2458,2495,-37,0,119,0,6
87700,2,2391,2590,-199,0,107,1,6
87701,2,2582,2464,118,0,466,0,6
87702,3,2627,2640,-13,0,110,0,6
87703,2,2365,2444,-79,0,112,0,6
87704,1,2507,2352,155,0,0,0,6
87705,3,2264,2608,-344,0,22,0,8
87706,2,2406,2336,70,0,111,0,6
87707,1,2578,2599,-21,0,485,1,6
87708,1,2401,2368,33,0,21,1,6
87709,1,2544,2622,-78,0,463,0,6
87710,2,2352,2402,-50,0,245,0,6
87711,2,2255,2424,-169,0,444,1,6
87712,3,2463,2388,75,0,7,0,6
87713,1,2495,2477,18,0,260,0,6
87714,1,2407,2444,-37,0,4,0,6
87715,2,2565,2629,-64,0,118,0,6
87716,2,2539,2416,123,0,170,0,6
87717,2,2398,2411,-13,0,260,1,6
87718,1,2502,2498,4,0,483,0,6
87719,1,2446,2433,13,0,205,0,6
87720,3,2452,2471,-19,0,45,0,6
87721,1,2456,2407,49,0,130,0,6
87722,2,2640,2551,89,0,300,0,6
87723,1,2467,2415,52,0,344,0,6
87724,2,2422,2281,141,0,176,0,8
87725,1,2409,2355,54,0,47,1,6
87726,1,2389,2444,-55,0,374,1,6
87727,1,2332,2462,-130,0,343,0,6
87728,1,2297,2436,-139,0,227,0,6
87729,1,2450,2289,161,0,10,0,8
87730,1,2467,2321,146,0,176,1,6
87731,2,2368,2467,-99,0,2,0,6
87732,2,2402,2539,-137,0,311,1,6
87733,2,2626,2501,125,0,211,0,6
87734,2,2496,2464,32,0,409,0,6
87735,2,2499,2561,-62,0,110,1,6
87736,1,2398,2460,-62,0,103,0,6
87737,3,2454,2348,106,0,404,0,6
87738,1,2438,2424,14,0,130,0,6
87739,2,2281,2406,-125,0,151,1,6
87740,3,2417,2425,-8,0,110,0,6
87741,1,2456,2294,162,0,110,1,6
87742,1,2810,2492,318,0,35,0,6
87743,1,2456,2414,42,0,301,0,6
87744,2,2471,2364,107,0,331,0,6
87745,2,2382,2451,-69,0,53,0,6
87746,2,2351,2409,-58,0,112,0,6
87747,1,2593,2340,253,0,1,0,6
87748,2,2230,2508,-278,0,4,0,6
87749,1,2492,2389,103,0,40,0,6
87750,1,2435,2337,98,0,40,0,6
87751,1,2328,2416,-88,0,245,0,6
87752,1,2569,2398,171,0,261,0,6
87753,3,2409,2506,-97,0,50,0,6
87754,2,2280,2540,-260,0,114,0,6
87755,1,2471,2220,251,4,45,0,13
87756,1,2415,2335,80,0,193,0,6
87757,1,2497,2325,172,0,454,0,6
87758,3,2347,2414,-67,0,112,0,6
87759,2,2407,2342,65,0,245,0,6
87760,1,2578,2551,27,0,154,1,6
87761,1,2488,2275,213,0,115,0,6
87762,2,2403,2236,167,0,200,0,6
87763,2,2383,2532,-149,0,341,0,6
87764,1,2449,2510,-61,0,20,0,6
87765,1,2393,2471,-78,0,310,0,6
87766,1,2502,2468,34,0,45,1,6
87767,3,2334,2443,-109,0,302,0,6
87768,2,2349,2438,-89,0,311,0,6
87769,1,2537,2423,114,0,4,1,6
87770,2,2322,2523,-201,0,106,0,6
87771,1,2406,2372,34,0,265,0,6
87772,2,2395,2573,-178,0,122,1,6
87773,2,2353,2546,-193,0,106,0,6
87774,1,2422,2306,116,0,100,1,6
87775,2,2440,2425,15,0,45,0,6
87776,1,2515,2585,-70,0,332,0,6
87777,2,2395,2500,-105,0,456,0,6
87778,1,2437,2419,18,0,302,1,6
87779,2,2356,2499,-143,0,37,0,6
87780,1,2509,2390,119,0,203,0,6
87781,1,2336,2435,-99,0,178,0,6
87782,2,2383,2451,-68,0,288,0,6
87783,2,2407,2303,104,0,10,0,6
87784,1,2559,2618,-59,0,12,0,6
87786,2,2428,2300,128,0,333,0,6
87787,1,2469,2356,113,0,39,0,6
87788,2,2410,2406,4,0,121,0,6
87789,1,2349,2524,-175,0,415,0,6
87790,2,2328,2430,-102,4,4,0,13
87791,1,2390,2526,-136,0,106,0,6
87792,1,2738,2590,148,0,150,1,6
87793,1,2455,2377,78,0,330,0,6
87794,1,2490,2461,29,0,447,0,6
87795,1,2542,2470,72,0,462,0,6
87796,1,2216,2452,-236,0,102,0,6
87797,1,2332,2439,-107,0,140,0,6
87798,2,2405,2593,-188,0,107,1,6
87799,1,2372,2464,-92,0,2,0,6
87800,1,2512,2402,110,0,37,1,6
87801,2,2421,2350,71,0,47,0,6
87802,2,2325,2403,-78,0,261,1,6
87803,2,2452,2522,-70,0,106,0,6
87804,2,2503,2422,81,0,218,0,6
87805,2,2296,2553,-257,0,0,0,6
87806,2,2578,2399,179,0,485,0,6
87807,1,2453,2491,-38,0,11,0,6
87808,1,2397,2406,-9,0,41,0,6
87809,1,2566,2443,123,0,45,1,6
87810,2,2460,2405,55,0,398,1,6
87811,2,2459,2494,-35,0,242,0,6
87812,3,2504,2376,128,0,112,0,6
87813,2,2291,2463,-172,0,4,0,6
87814,2,2443,2471,-28,0,190,1,6
87815,2,2634,2560,74,0,291,1,6
87816,2,2414,2334,80,0,112,0,6
87817,2,2605,2622,-17,0,311,0,6
87818,3,2200,2433,-233,0,201,0,6
87819,1,2409,2335,74,0,248,1,6
87820,3,2409,2402,7,0,130,0,6
87821,2,2518,2443,75,0,373,0,6
87822,3,2464,2372,92,0,121,0,6
87823,3,2398,2401,-3,0,121,0,6
87824,2,2547,2251,296,0,330,0,6
87825,3,2417,2393,24,0,110,0,6
87826,2,2466,2508,-42,0,241,1,6
87827,1,2461,2367,94,0,4,0,6
87828,2,2504,2381,123,0,33,1,6
87829,2,2560,2584,-24,0,101,0,6
87830,2,2415,2414,1,0,49,0,8
87831,3,2417,2499,-82,0,4,0,8
87832,1,2413,2546,-133,0,151,0,6
87833,1,2310,2420,-110,0,200,0,6
87834,1,2400,2344,56,0,41,0,6
87835,2,2425,2417,8,0,201,0,6
87836,3,2353,2461,-108,0,131,0,6
87837,1,2484,2459,25,0,103,0,6
87838,2,2404,2431,-27,0,100,0,6
87839,1,2350,2504,-154,0,142,0,6
87840,3,2443,2274,169,4,120,0,13
87841,2,2379,2498,-119,0,2,0,6
87842,3,2426,2541,-115,0,112,0,6
87843,1,2611,2565,46,0,302,0,6
87844,1,2576,2627,-51,0,110,0,6
87845,1,2402,2426,-24,0,3,0,6
87846,2,2460,2520,-60,0,131,0,6
87847,1,2472,2411,61,0,41,0,6
87848,2,2348,2455,-107,0,227,0,6
87849,1,2627,2741,-114,0,150,0,6
87850,3,2402,2378,24,0,15,0,6
87851,1,2549,2350,199,0,57,0,6
87852,2,2492,2454,38,0,3,0,6
87853,1,2596,2516,80,0,7,0,6
87854,2,2288,2513,-225,0,4,1,6
87855,2,2392,2410,-18,0,101,0,6
87856,1,2414,2341,73,0,302,0,6
87857,1,2272,2407,-135,0,150,1,6
87858,2,2371,2466,-95,0,389,0,6
87859,1,2436,2569,-133,0,267,0,6
87860,3,2293,2446,-153,0,46,0,6
87861,2,2538,2491,47,0,375,0,6
87862,2,2421,2386,35,0,135,0,6
87863,2,2464,2375,89,0,203,0,6
87864,1,2428,2344,84,0,100,0,6
87865,3,2344,2527,-183,0,40,0,6
87866,2,2325,2502,-177,0,301,1,6
87867,1,2400,2227,173,0,25,0,6
87868,1,2400,2240,160,0,140,0,6
87869,1,2453,2278,175,0,395,0,6
87870,2,2462,2570,-108,0,113,1,6
87871,2,2251,2412,-161,0,414,0,6
87872,2,2589,2554,35,0,245,0,6
87873,1,2331,2413,-82,0,201,1,6
87874,1,2461,2627,-166,0,123,0,6
87875,1,2511,2440,71,0,492,0,6
87876,3,2411,2601,-190,0,103,0,6
87877,2,2418,2328,90,0,110,1,8
87878,1,2402,2393,9,0,385,0,6
87879,2,2423,2409,14,0,300,0,6
87880,2,2402,2340,62,0,111,0,6
87881,1,2459,2402,57,0,265,1,6
87882,1,2431,2431,0,0,6,0,6
87883,2,2250,2434,-184,4,40,0,13
87884,1,2454,2318,136,0,85,0,6
87885,1,2310,2421,-111,0,211,0,6
87886,2,2490,2438,52,0,144,0,6
87887,1,2535,2464,71,0,132,0,6
87888,2,2605,2433,172,0,330,0,8
87889,2,2486,2456,30,0,3,0,6
87890,1,2515,2429,86,0,440,0,6
87891,1,2542,2561,-19,0,247,1,6
87892,2,2382,2507,-125,0,3,0,6
87893,2,2419,2310,109,0,455,0,6
87894,1,2438,2403,35,0,153,1,6
87895,1,2473,2378,95,0,20,0,6
87896,1,2524,2455,69,0,41,0,6
87897,2,2273,2428,-155,0,469,0,6
87898,1,2539,2458,81,0,4,0,6
87899,1,2314,2400,-86,0,107,0,6
87900,1,2432,2423,9,0,211,1,6
87901,1,2241,2419,-178,0,113,0,6
87902,2,2347,2552,-205,0,406,0,6
87903,1,2484,2419,65,0,113,0,6
87904,2,2239,2499,-260,0,45,0,8
87905,1,2420,2402,18,0,470,1,6
87906,1,2408,2378,30,0,490,1,6
87907,2,2275,2418,-143,0,301,0,8
87908,1,2487,2444,43,0,441,0,6
87909,3,2530,2491,39,0,403,0,6
87910,2,2301,2440,-139,4,406,0,13
87911,1,2414,2349,65,0,402,0,6
87912,1,2444,2361,83,0,40,0,6
87913,1,2619,2596,23,0,330,0,6
87914,2,2515,2469,46,0,207,0,6
87915,2,2403,2288,115,0,10,1,6
87916,2,2734,2665,69,0,122,0,6
87917,2,2354,2493,-139,0,345,0,6
87918,1,2470,2309,161,0,7,0,6
87919,1,2280,2408,-128,0,190,0,6
87920,1,2420,2286,134,0,210,0,8
87921,3,2561,2583,-22,0,125,0,6
87922,1,2413,2309,104,0,5,0,6
87923,1,2414,2415,-1,0,110,0,6
87924,2,2620,2527,93,0,102,0,6
87925,2,2400,2327,73,0,101,1,6
87926,2,2337,2457,-120,0,101,1,6
87927,1,2444,2483,-39,0,302,0,6
87928,2,2421,2272,149,0,302,0,8
87929,2,2462,2505,-43,0,216,0,6
87930,2,2453,2401,52,0,35,0,6
87931,1,2403,2349,54,0,331,1,6
87932,2,2401,2303,98,0,113,0,6
87933,2,2406,2485,-79,0,448,0,6
87934,2,2540,2516,24,0,243,0,6
87935,2,2393,2460,-67,0,132,0,6
87936,1,2430,2417,13,0,130,0,6
87937,2,2415,2408,7,0,4,0,6
87938,1,2435,2574,-139,0,221,0,6
87939,1,2463,2480,-17,0,120,0,6
87940,1,2448,2392,56,0,402,0,6
87941,2,2393,2477,-84,0,170,0,6
87942,2,2397,2464,-67,0,310,1,6
87943,1,2492,2519,-27,0,391,0,6
87944,1,2430,2419,11,0,312,0,6
87945,2,2431,2509,-78,0,241,0,6
87946,2,2379,2459,-80,0,2,0,6
87947,1,2430,2212,218,0,122,0,6
87948,2,2243,2424,-181,0,375,0,8
87949,1,2555,2548,7,0,10,0,6
87950,3,2381,2524,-143,0,394,0,6
87951,1,2476,2426,50,0,115,0,6
87952,2,2624,2457,167,0,453,0,6
87953,1,2311,2433,-122,0,58,1,6
87954,2,2314,2424,-110,0,45,1,6
87955,2,2474,2470,4,0,2,0,6
87956,1,2406,2338,68,0,40,0,6
87957,3,2415,2398,17,0,131,0,6
87958,2,2451,2450,1,0,140,0,6
87959,1,2543,2560,-17,0,247,0,6
87960,1,2412,2315,97,0,310,0,6
87961,1,2414,2333,81,0,83,1,6
87962,1,2407,2393,14,0,150,0,6
87963,1,2465,2392,73,0,9,0,6
87964,3,2582,2561,21,0,268,0,6
87965,2,2388,2453,-65,0,46,0,6
87966,2,2253,2413,-160,0,438,0,6
87967,1,2424,2428,-4,0,300,0,6
87968,1,2477,2451,26,0,144,0,6
87969,1,2373,2412,-39,0,43,0,6
87970,1,2510,2534,-24,0,157,0,6
87971,2,2426,2207,219,0,45,1,6
87972,1,2522,2453,69,0,15,0,6
87973,2,2427,2396,31,0,175,0,6
87974,3,2509,2510,-1,0,170,0,6
87975,1,2554,2344,210,0,325,0,6
87976,2,2281,2424,-143,0,45,0,8
87977,2,2566,2381,185,0,45,0,6
87978,2,2427,2437,-10,0,203,0,6
87979,3,2350,2403,-53,0,84,0,6
87980,2,2421,2412,9,0,46,1,6
87982,1,2456,2445,11,0,4,0,6
87983,2,2413,2416,-3,0,302,1,8
87985,2,2388,2460,-72,0,106,0,6
87986,1,2306,2428,-122,0,248,1,8
87987,2,2282,2413,-131,0,133,0,6
87988,1,2400,2341,59,0,40,0,6
87989,2,2509,2672,-163,0,145,0,6
87990,1,2305,2409,-104,0,455,1,6
87991,2,2447,2420,27,0,13,0,6
87992,2,2333,2411,-78,0,101,0,6
87993,1,2460,2374,86,0,93,0,6
87994,2,2425,2520,-95,0,202,0,6
87995,2,2408,2293,115,0,225,1,6
87996,3,2415,2381,34,0,46,0,6
87997,3,2481,2498,-17,0,146,0,6
87998,1,2404,2357,47,0,102,1,6
87999,1,2443,2541,-98,0,120,1,6
88000,2,2331,2597,-266,0,45,0,8
88001,1,2414,2409,5,0,3,0,6
88002,1,2458,2383,75,0,153,0,6
88003,2,2490,2379,111,0,106,0,6
88004,3,2371,2408,-37,0,10,0,6
88005,2,2598,2423,175,0,7,0,6
88006,1,2323,2447,-124,0,373,0,6
88007,2,2554,2549,5,0,335,0,6
88008,1,2418,2389,29,0,110,0,6
88009,2,2388,2461,-73,0,106,1,6
88010,2,2415,2529,-114,0,218,0,6
88011,2,2469,2399,70,0,4,1,6
88012,1,2465,2616,-151,0,120,0,6
88013,2,2421,2419,2,0,110,0,6
88014,1,2491,2314,177,0,42,1,6
88015,2,2436,2347,89,0,40,0,6
88016,2,2453,2468,-15,0,136,0,6
88017,2,2398,2516,-118,0,53,1,6
88018,1,2528,2420,108,0,121,0,6
88019,2,2464,2383,81,0,4,0,6
88020,2,2440,2462,-22,0,101,0,6
88021,1,2341,2557,-216,0,304,1,6
88022,2,2337,2465,-128,0,344,0,6
88023,1,2403,2420,-17,0,255,0,6
88024,3,2426,2380,46,0,485,0,6
88025,2,2361,2417,-56,0,387,0,6
88026,3,2411,2451,-40,0,130,0,6
88027,1,2405,2333,72,0,40,0,6
88028,2,2373,2576,-203,0,46,0,6
88029,1,2360,2481,-121,0,176,0,6
88030,1,2448,2527,-79,0,301,0,6
88031,2,2561,2582,-21,0,101,0,6
88032,1,2402,2295,107,0,134,1,8
88033,1,2269,2444,-175,4,127,0,13
88034,2,2278,2441,-163,0,102,0,6
88035,1,2417,2311,106,0,330,0,6
88036,2,2342,2400,-58,0,45,1,6
88037,1,2445,2482,-37,0,344,0,6
88038,1,2468,2212,256,4,133,0,8
88039,1,2427,2296,131,0,44,0,8
88040,1,2390,2509,-119,0,302,0,6
88041,2,2451,2502,-51,0,307,1,6
88042,2,2342,2557,-215,0,426,0,6
88043,2,2510,2506,4,0,398,1,6
88044,1,2442,2292,150,0,200,0,8
88045,1,2534,2613,-79,0,4,0,6
88046,1,2438,2251,187,4,49,0,13
88047,1,2406,2319,87,0,327,0,6
88048,2,2259,2424,-165,0,111,0,6
88049,2,2369,2525,-156,0,0,0,6
88050,1,2415,2329,86,0,248,0,6
88051,2,2343,2470,-127,4,310,1,0
88052,2,2555,2549,6,0,247,0,6
88053,2,2209,2474,-265,4,110,0,8
88054,2,2200,2410,-210,0,133,0,8
88055,2,2431,2400,31,0,28,1,6
88056,1,2608,2474,134,0,265,0,6
88057,2,2467,2434,33,0,46,0,6
88058,1,2532,2575,-43,0,140,0,6
88059,2,2370,2477,-107,0,3,0,6
88060,2,2290,2402,-112,0,303,0,6
88061,1,2408,2337,71,0,106,0,6
88062,1,2726,2498,228,0,405,0,6
88063,1,2426,2378,48,0,123,0,6
88064,3,2465,2383,82,0,0,0,6
88065,1,2432,2254,178,0,269,0,6
88066,2,2379,2509,-130,0,300,1,6
88067,2,2372,2413,-41,0,16,1,6
88068,1,2370,2448,-78,0,302,0,6
88069,1,2474,2457,17,0,2,0,6
88070,1,2587,2556,31,0,268,1,6
88071,1,2329,2409,-80,0,75,1,6
88072,2,2416,2399,17,0,20,0,6
88073,2,2315,2418,-103,0,45,0,6
88074,1,2520,2511,9,0,253,0,6
88075,3,2402,2405,-3,0,15,0,6
88076,1,2394,2469,-75,0,45,0,6
88077,1,2676,2450,226,0,205,0,6
88078,1,2422,2429,-7,0,45,0,6
88080,2,2413,2289,124,0,200,0,8
88081,1,2579,2370,209,0,345,0,6
88082,2,2421,2425,-4,0,122,1,8
88083,2,2420,2310,110,0,464,1,6
88084,2,2380,2538,-158,0,300,0,6
88085,1,2569,2416,153,0,338,0,6
88086,2,2228,2401,-173,0,40,1,6
88087,1,2616,2664,-48,0,123,1,6
88088,2,2332,2599,-267,0,49,0,8
88089,1,2548,2481,67,0,45,1,6
88090,1,2384,2423,-39,0,40,0,6
88091,2,2524,2421,103,0,440,1,6
88092,2,2325,2420,-95,0,201,1,6
88093,1,2488,2482,6,0,152,1,6
88094,1,2445,2421,24,0,133,0,6
88095,1,2438,2314,124,0,242,0,6
88096,2,2374,2481,-107,0,4,1,6
88097,2,2422,2247,175,0,153,0,8
88098,3,2361,2501,-140,0,338,0,6
88099,3,2391,2439,-48,0,134,0,6
88100,2,2476,2452,24,0,203,0,6
88101,3,2379,2456,-77,0,45,0,6
88102,2,2495,2568,-73,0,441,0,6
88103,1,2414,2314,100,0,200,0,8
88104,3,2450,2443,7,0,288,0,6
88105,2,2412,2312,100,0,110,0,6
88106,2,2411,2287,124,0,211,0,6
88107,3,2384,2464,-80,0,106,0,6
88108,1,2415,2318,97,0,303,0,6
88109,3,2470,2612,-142,0,111,0,6
88110,2,2417,2390,27,0,210,0,6
88111,1,2406,2372,34,0,201,0,6
88112,2,2554,2508,46,0,487,0,6
88113,1,2569,2398,171,0,1,0,6
88114,1,2474,2417,57,0,485,0,6
88115,2,2606,2541,65,0,107,0,6
88116,2,2369,2601,-232,0,463,0,8
88117,1,2425,2526,-101,0,21,0,6
88118,1,2407,2311,96,0,240,0,6
88119,1,2279,2447,-168,0,356,1,6
88120,2,2582,2560,22,0,140,0,6
88121,2,2467,2366,101,0,203,0,6
88122,2,2505,2412,93,0,302,1,6
88123,1,2435,2257,178,0,100,0,6
88124,1,2452,2479,-27,0,80,0,6
88125,2,2496,2455,41,0,432,0,6
88126,2,2441,2285,156,0,147,0,6
88128,1,2431,2290,141,4,130,0,13
88129,2,2551,2593,-42,0,101,0,6
88130,3,2358,2407,-49,0,319,0,8
88131,1,2462,2294,168,0,315,0,6
88132,1,2402,2401,1,0,36,1,6
88133,2,2471,2367,104,0,152,0,6
88134,2,2421,2386,35,0,487,0,6
88135,2,2388,2421,-33,0,1,1,6
88136,2,2258,2425,-167,0,111,0,6
88137,1,2430,2371,59,0,40,0,6
88138,1,2572,2549,23,0,406,0,6
88139,2,2542,2491,51,0,115,0,6
88140,1,2432,2365,67,0,40,0,6
88141,2,2458,2470,-12,0,1,0,6
88142,2,2367,2414,-47,0,130,0,8
88143,2,2416,2412,4,0,404,0,6
88144,1,2475,2339,136,0,15,0,6
88145,1,2463,2386,77,0,0,0,6
88146,1,2424,2321,103,0,248,0,6
88147,1,2482,2211,271,4,120,0,13
88148,2,2553,2523,30,0,300,0,6
88149,3,2367,2494,-127,0,46,0,6
88150,2,2335,2442,-107,0,146,1,6
88151,1,2499,2363,136,0,267,1,6
88152,2,2485,2370,115,0,0,1,6
88153,1,2386,2412,-26,0,22,0,6
88154,3,2343,2438,-95,0,354,0,6
88155,2,2534,2419,115,0,332,0,6
88156,2,2433,2410,23,0,106,0,6
88157,3,2610,2472,138,0,265,0,6
88158,3,2473,2458,15,0,2,0,6
88159,2,2310,2418,-108,0,248,0,8
88160,1,2319,2404,-85,0,442,1,6
88161,3,2598,2546,52,0,268,0,6
88162,1,2476,2452,24,0,205,0,6
88163,2,2254,2438,-184,0,125,0,6
88164,2,2548,2578,-30,0,454,0,6
88165,1,2465,2391,74,0,483,0,6
88166,2,2451,2444,7,0,105,0,6
88167,1,2464,2373,91,0,201,0,6
88168,3,2405,2396,9,0,331,0,6
88169,3,2518,2410,108,0,107,0,6
88170,2,2544,2574,-30,0,112,1,6
88171,2,2433,2405,28,0,35,0,6
88172,1,2315,2403,-88,0,257,0,6
88173,2,2420,2460,-40,0,45,0,6
88174,2,2372,2411,-39,0,44,1,6
88175,1,2534,2490,44,0,127,0,6
88176,2,2339,2412,-73,0,5,0,6
88177,2,2461,2295,166,0,242,0,6
88178,2,2428,2458,-30,0,342,0,6
88179,1,2417,2524,-107,0,5,0,6
88180,1,2729,2535,194,0,130,0,6
88181,1,2428,2255,173,0,45,0,6
88182,2,2392,2415,-23,0,311,1,6
88183,2,2396,2408,-12,0,70,1,6
88184,2,2497,2424,73,0,51,1,6
88185,2,2254,2410,-156,0,302,0,6
88186,2,2661,2519,142,0,404,1,6
88187,1,2316,2428,-112,0,201,0,6
88188,2,2389,2566,-177,0,140,0,6
88189,1,2292,2436,-144,0,4,0,6
88190,1,2458,2473,-15,0,80,0,6
88191,1,2478,2576,-98,0,61,0,6
88192,1,2418,2476,-58,0,82,0,6
88193,2,2474,2608,-134,0,120,0,6
88194,2,2618,2520,98,0,226,0,6
88195,1,2443,2435,8,0,268,0,6
88196,2,2441,2251,190,0,100,1,6
88197,2,2488,2462,26,0,101,1,6
88198,1,2378,2583,-205,0,143,1,6
88199,1,2547,2543,4,0,300,0,6
88200,1,2459,2392,67,0,190,1,6
88201,2,2437,2360,77,0,265,0,6
88202,1,2406,2374,32,0,192,0,6
88203,2,2572,2529,43,0,13,1,6
88204,3,2345,2461,-116,0,44,0,6
88205,1,2426,2312,114,0,373,0,6
88206,2,2369,2478,-109,0,3,0,6
88207,2,2547,2597,-50,0,300,0,6
88208,1,2481,2590,-109,0,337,0,6
88209,1,2252,2431,-179,0,111,1,6
88210,2,2447,2481,-34,0,343,0,6
88211,3,2331,2485,-154,0,42,0,6
88212,1,2532,2427,105,0,111,0,6
88213,2,2579,2539,40,0,142,0,6
88214,1,2389,2435,-46,0,200,0,6
88215,3,2474,2424,50,0,4,0,6
88216,2,2329,2470,-141,0,46,0,6
88217,3,2517,2395,122,0,112,0,6
88218,1,2412,2387,25,0,78,0,6
88219,2,2430,2445,-15,0,292,1,6
88220,1,2422,2246,176,0,250,1,8
88221,2,2471,2467,4,0,42,0,6
88222,2,2575,2539,36,0,4,1,6
88223,1,2611,2471,140,0,325,0,6
88224,1,2414,2356,58,0,410,1,6
88225,1,2465,2298,167,0,13,0,6
88226,2,2418,2470,-52,0,270,0,8
88227,2,2400,2416,-16,0,90,0,6
88228,1,2415,2504,-89,0,45,0,6
88229,2,2427,2361,66,0,46,1,6
88230,1,2421,2324,97,0,242,0,6
88231,1,2420,2387,33,0,120,1,6
88232,2,2527,2491,36,0,35,0,6
88233,1,2482,2431,51,0,0,0,6
88234,2,2365,2521,-156,0,3,0,6
88235,2,2377,2414,-37,0,4,0,6
88236,2,2622,2527,95,0,220,0,6
88237,2,2428,2404,24,0,404,0,6
88238,2,2369,2411,-42,0,22,1,6
88239,1,2604,2553,51,0,243,0,6
88240,3,2602,2542,60,0,260,0,6
88241,2,2470,2537,-67,0,109,0,6
88242,2,2419,2405,14,0,246,0,6
88243,2,2396,2550,-154,0,45,0,6
88244,2,2537,2615,-78,0,36,0,6
88245,1,2439,2423,16,0,228,0,6
88246,1,2536,2387,149,0,190,0,6
88247,2,2574,2388,186,0,50,0,6
88248,1,2332,2502,-170,0,454,0,6
88249,1,2460,2347,113,0,123,0,6
88250,1,2430,2295,135,0,4,0,6
88251,2,2569,2387,182,0,474,0,6
88252,2,2569,2486,83,0,140,0,6
88253,1,2428,2402,26,0,31,1,6
88254,1,2476,2497,-21,0,268,0,6
88255,2,2393,2473,-80,0,46,0,6
88256,3,2331,2428,-97,0,31,0,6
88257,1,2423,2260,163,0,43,0,6
88258,2,2345,2524,-179,0,302,0,6
88259,2,2619,2732,-113,0,335,0,6
88260,1,2473,2325,148,0,343,0,6
88261,1,2464,2423,41,0,46,0,6
88262,1,2535,2362,173,0,330,0,6
88263,1,2489,2417,72,0,404,0,6
88264,1,2415,2304,111,0,1,0,6
88265,2,2613,2573,40,0,115,0,6
88266,1,2456,2429,27,0,250,0,6
88267,2,2320,2425,-105,0,201,0,6
88268,1,2483,2413,70,0,426,0,6
88269,2,2334,2515,-181,0,200,0,6
88270,3,2465,2566,-101,0,4,0,6
88271,2,2473,2465,8,0,3,0,6
88272,1,2397,2540,-143,0,302,0,6
88273,2,2425,2426,-1,0,452,0,6
88274,1,2580,2383,197,0,45,0,6
88275,2,2393,2516,-123,0,464,0,6
88276,1,2545,2566,-21,0,140,0,6
88277,1,2418,2276,142,0,485,0,6
88278,2,2542,2467,75,0,267,0,6
88279,3,2497,2377,120,0,456,0,6
88280,2,2494,2364,130,0,200,0,6
88281,2,2393,2474,-81,0,492,0,6
88282,1,2548,2609,-61,0,300,0,6
88283,1,2538,2554,-16,0,70,0,6
88284,1,2352,2438,-86,0,102,1,6
88285,1,2469,2396,73,0,102,0,6
88286,2,2465,2422,43,0,101,1,6
88287,2,2323,2400,-77,0,142,1,8
88288,2,2382,2426,-44,0,40,0,6
88289,2,2360,2410,-50,0,45,0,6
88290,1,2579,2604,-25,0,201,0,6
88291,1,2487,2359,128,0,0,0,6
88292,1,2431,2375,56,0,300,1,6
88293,2,2367,2400,-33,0,335,1,6
88294,2,2257,2426,-169,0,111,1,6
88295,1,2493,2562,-69,0,61,0,6
88296,2,2456,2343,113,0,15,0,6
88297,3,2475,2413,62,0,152,0,8
88298,2,2423,2372,51,0,335,0,6
88299,1,2422,2387,35,0,488,0,6
88300,1,2502,2422,80,0,61,0,8
88301,1,2315,2473,-158,0,15,0,6
88302,1,2562,2543,19,0,331,1,6
88303,1,2503,2601,-98,0,162,0,6
88304,2,2429,2316,113,0,101,0,6
88305,1,2392,2419,-27,0,10,0,6
88306,2,2402,2386,16,0,261,0,6
88307,1,2416,2364,52,0,192,0,6
88308,2,2445,2432,13,0,140,0,6
88309,1,2417,2396,21,0,30,0,6
88310,1,2554,2339,215,0,100,0,6
88311,2,2404,2276,128,0,106,1,6
88312,1,2491,2482,9,0,490,0,6
88313,1,2411,2297,114,0,201,0,6
88314,1,2409,2360,49,0,123,0,8
88315,2,2350,2448,-98,0,113,0,6
88317,2,2381,2464,-83,0,195,0,6
88318,2,2487,2583,-96,0,487,1,6
88319,1,2408,2266,142,0,320,0,6
88320,2,2411,2451,-40,0,301,0,6
88321,1,2569,2477,92,0,120,1,6
88322,1,2413,2235,178,0,107,0,6
88323,1,2471,2467,4,0,136,0,6
88324,1,2466,2293,173,0,8,0,6
88325,1,2422,2544,-122,0,254,0,6
88326,1,2414,2434,-20,0,120,0,6
88327,2,2509,2532,-23,0,301,0,6
88328,1,2607,2586,21,0,110,0,6
88329,1,2548,2528,20,0,13,0,6
88330,2,2331,2438,-107,0,145,0,6
88331,1,2432,2419,13,0,335,0,6
88332,1,2278,2437,-159,0,113,0,6
88333,1,2629,2664,-35,0,196,0,6
88334,2,2490,2416,74,0,0,0,6
88335,2,2622,2551,71,0,101,0,6
88336,3,2409,2499,-90,0,152,0,8
88337,1,2405,2516,-111,0,4,0,6
88338,3,2424,2389,35,0,311,0,6
88339,2,2474,2555,-81,0,243,0,6
88340,2,2373,2556,-183,0,484,0,6
88341,1,2416,2251,165,0,40,0,6
88342,3,2486,2383,103,0,244,0,6
88343,2,2355,2535,-180,0,2,0,6
88344,2,2355,2495,-140,0,4,0,6
88345,2,2359,2414,-55,0,306,1,8
88346,1,2561,2461,100,0,352,0,6
88347,1,2290,2469,-179,0,40,0,6
88348,1,2430,2254,176,0,303,0,6
88349,1,2379,2436,-57,0,40,0,6
88350,2,2370,2427,-57,0,145,0,6
88351,1,2518,2376,142,0,224,0,6
88352,3,2418,2469,-51,0,341,0,6
88353,1,2594,2510,84,0,242,0,6
88354,1,2400,2243,157,0,13,0,6
88355,2,2465,2316,149,0,1,0,6
88356,1,2325,2474,-149,0,107,0,8
88357,1,2412,2380,32,0,301,0,6
88358,1,2379,2412,-33,0,4,0,6
88359,2,2359,2421,-62,0,16,0,6
88360,1,2414,2437,-23,0,452,0,6
88361,2,2581,2597,-16,0,300,0,6
88362,1,2405,2355,50,0,315,1,6
88363,2,2333,2438,-105,0,211,0,6
88364,2,2323,2506,-183,0,13,1,6
88365,1,2320,2538,-218,0,112,0,6
88366,1,2523,2553,-30,0,184,1,6
88367,2,2324,2422,-98,0,201,0,6
88368,1,2406,2459,-53,0,190,1,6
88369,1,2477,2497,-20,0,250,1,6
88370,2,2319,2425,-106,0,302,0,6
88371,1,2598,2537,61,0,133,0,6
88372,1,2373,2417,-44,0,61,0,6
88373,1,2398,2453,-55,0,11,0,6
88374,1,2538,2352,186,0,210,0,6
88375,2,2391,2423,-32,0,111,0,6
88376,2,2390,2567,-177,0,267,0,6
88377,2,2346,2460,-114,0,106,0,6
88378,2,2658,2635,23,0,150,1,6
88379,2,2396,2493,-97,0,130,1,6
88380,3,2456,2483,-27,0,138,0,6
88381,1,2415,2556,-141,0,386,0,6
88382,1,2448,2369,79,0,140,1,6
88383,1,2587,2459,128,0,255,0,6
88384,1,2461,2477,-16,0,3,0,6
88385,2,2537,2585,-48,0,110,1,6
88386,1,2426,2319,107,0,101,0,6
88387,2,2396,2428,-32,0,190,0,6
88388,2,2429,2292,137,0,300,1,6
88389,2,2405,2366,39,0,153,1,6
88390,2,2423,2484,-61,0,40,0,6
88391,1,2492,2429,63,0,132,0,6
88392,2,2559,2373,186,0,300,0,6
88393,2,2463,2440,23,0,234,0,6
88394,1,2485,2329,156,0,101,0,6
88395,1,2442,2327,115,0,145,0,6
88396,1,2560,2370,190,0,469,0,6
88397,1,2222,2417,-195,0,131,0,8
88398,1,2411,2252,159,0,180,0,6
88399,2,2382,2468,-86,0,464,0,6
88400,1,2498,2352,146,0,375,0,6
88401,1,2431,2419,12,0,132,1,6
88402,2,2442,2464,-22,0,142,0,6
88403,2,2555,2420,135,0,110,1,6
88404,2,2470,2504,-34,0,102,0,6
88405,1,2415,2293,122,0,337,1,6
88406,1,2441,2312,129,4,49,0,13
88407,2,2373,2521,-148,0,201,0,6
88408,2,2446,2488,-42,0,16,1,6
88409,2,2251,2433,-182,0,111,0,6
88410,1,2542,2450,92,0,120,0,6
88411,2,2442,2325,117,0,45,1,6
88412,2,2457,2615,-158,0,1,0,6
88413,3,2371,2457,-86,0,7,0,6
88414,1,2377,2430,-53,0,40,0,6
88415,1,2570,2386,184,0,485,1,6
88416,1,2401,2402,-1,0,58,1,6
88417,1,2315,2430,-115,0,210,1,6
88418,1,2349,2541,-192,0,2,0,6
88419,2,2455,2377,78,0,200,0,6
88420,1,2411,2565,-154,0,4,1,6
88421,1,2591,2483,108,0,253,0,6
88422,1,2471,2467,4,0,136,0,6
88423,1,2533,2413,120,0,190,0,6
88424,2,2420,2607,-187,0,321,0,6
88425,3,2354,2437,-83,0,10,0,6
88426,3,2428,2386,42,0,27,0,6
88427,1,2454,2342,112,0,277,0,6
88428,2,2547,2529,18,0,258,1,6
88429,2,2619,2453,166,0,330,0,6
88430,1,2641,2652,-11,0,167,1,6
88431,2,2263,2414,-151,0,311,0,6
88432,2,2452,2456,-4,0,292,1,6
88433,1,2483,2303,180,0,57,1,6
88434,1,2418,2256,162,0,122,1,8
88435,1,2498,2375,123,0,338,0,6
88436,2,2386,2551,-165,0,242,1,6
88437,1,2532,2451,81,0,40,0,6
88438,2,2466,2354,112,0,105,1,8
88439,1,2423,2364,59,0,45,1,6
88440,2,2611,2595,16,0,463,0,6
88441,3,2419,2573,-154,0,14,0,6
88442,2,2328,2421,-93,0,7,0,6
88443,3,2536,2537,-1,0,302,0,6
88444,2,2396,2448,-52,0,15,0,6
88445,1,2334,2420,-86,0,13,0,6
88446,1,2502,2595,-93,0,1,1,6
88447,3,2384,2496,-112,0,207,0,6
88448,2,2378,2488,-110,0,60,0,6
88449,1,2372,2418,-46,0,205,1,6
88450,1,2497,2420,77,0,152,0,8
88451,2,2462,2360,102,0,49,0,6
88452,3,2436,2248,188,0,43,0,6
88453,1,2423,2335,88,0,409,0,6
88454,1,2351,2445,-94,0,45,1,6
88455,1,2446,2457,-11,0,309,1,6
88456,2,2464,2360,104,0,123,0,6
88457,2,2286,2458,-172,0,140,0,6
88458,1,2433,2429,4,0,4,1,6
88459,1,2473,2338,135,0,250,0,6
88460,1,2468,2323,145,0,145,0,6
88461,2,2446,2610,-164,0,146,0,6
88462,2,2414,2432,-18,0,300,0,6
88463,1,2386,2427,-41,0,250,1,6
88464,1,2440,2273,167,0,469,0,6
88465,2,2352,2465,-113,0,220,0,6
88466,1,2493,2441,52,0,18,0,6
88467,1,2590,2558,32,0,101,1,6
88468,2,2407,2255,152,0,40,0,6
88469,1,2471,2417,54,0,130,0,6
88470,1,2533,2529,4,0,112,0,6
88471,1,2437,2425,12,0,139,1,6
88472,1,2436,2498,-62,0,15,0,6
88473,1,2462,2476,-14,0,305,1,6
88474,2,2415,2435,-20,0,31,0,6
88475,2,2369,2501,-132,0,426,0,6
88476,1,2426,2384,42,0,301,1,6
88477,2,2419,2379,40,0,113,0,8
88478,1,2464,2293,171,0,200,0,6
88479,1,2603,2455,148,0,380,0,6
88480,1,2435,2356,79,0,8,0,6
88481,1,2420,2357,63,0,141,0,6
88482,2,2646,2647,-1,0,120,0,6
88483,1,2393,2417,-24,0,131,0,6
88484,1,2453,2446,7,0,100,0,6
88485,1,2557,2420,137,0,375,0,6
88486,2,2535,2541,-6,0,184,0,6
88487,1,2305,2486,-181,0,127,0,6
88488,2,2383,2554,-171,0,242,1,6
88489,1,2512,2536,-24,0,192,1,6
88490,3,2456,2428,28,0,110,0,6
88491,1,2537,2374,163,0,212,0,6
88492,1,2447,2492,-45,0,142,1,6
88493,2,2454,2385,69,0,140,0,6
88494,2,2296,2548,-252,0,9,1,6
88495,2,2495,2525,-30,0,334,0,6
88496,1,2356,2428,-72,0,4,0,6
88497,2,2231,2496,-265,0,140,1,8
88498,2,2421,2379,42,0,15,0,6
88499,2,2321,2409,-88,0,4,0,6
88500,1,2440,2391,49,0,374,1,6
88501,2,2454,2571,-117,0,221,0,6
88502,3,2421,2498,-77,0,43,0,6
88503,1,2547,2530,17,0,13,0,6
88504,2,2602,2646,-44,0,200,0,6
88505,1,2371,2461,-90,0,46,1,6
88506,2,2251,2433,-182,0,111,0,6
88507,1,2319,2434,-115,0,113,0,6
88508,2,2588,2436,152,0,206,1,6
88509,1,2437,2409,28,0,48,0,6
88510,1,2451,2452,-1,0,120,0,6
88511,1,2485,2318,167,0,10,0,8
88512,1,2564,2548,16,0,46,0,6
88513,1,2557,2369,188,0,300,0,6
88514,1,2382,2438,-56,0,133,0,6
88515,1,2524,2539,-15,0,490,0,6
88516,1,2562,2520,42,0,27,1,6
88517,1,2404,2299,105,0,41,0,8
88518,2,2411,2402,9,0,31,0,6
88519,1,2614,2442,172,0,16,0,6
88520,1,2595,2655,-60,0,170,0,6
88521,1,2425,2421,4,0,119,0,6
88522,2,2422,2319,103,0,122,0,8
88523,2,2487,2299,188,0,45,0,6
88524,2,2491,2443,48,0,11,0,6
88525,1,2471,2358,113,0,331,0,6
88526,1,2462,2505,-43,0,132,0,6
88527,2,2546,2736,-190,0,131,0,6
88529,1,2315,2467,-152,0,40,1,6
88530,3,2575,2653,-78,0,310,0,6
88531,1,2379,2425,-46,0,207,0,6
88532,2,2530,2431,99,0,110,1,6
88533,2,2470,2468,2,0,136,0,6
88535,2,2327,2423,-96,0,438,0,6
88536,2,2392,2449,-57,0,39,1,6
88537,2,2452,2608,-156,0,320,0,6
88538,1,2386,2447,-61,0,30,1,6
88539,1,2445,2420,25,0,11,0,6
88540,1,2398,2540,-142,0,306,0,6
88541,1,2458,2278,180,0,200,0,8
88542,1,2371,2459,-88,0,80,0,6
88543,2,2411,2560,-149,0,140,0,6
88544,1,2436,2248,188,0,120,1,6
88545,2,2438,2343,95,0,218,0,6
88546,2,2465,2441,24,0,100,0,6
88547,2,2351,2462,-111,0,21,0,6
88548,2,2385,2413,-28,0,30,0,8
88549,3,2406,2327,79,0,145,0,6
88550,2,2400,2416,-16,0,138,0,6
88551,2,2266,2443,-177,0,15,0,6
88552,2,2414,2262,152,0,453,0,6
88553,3,2454,2306,148,0,57,0,6
88554,1,2354,2475,-121,0,3,0,6
88555,2,2477,2477,0,0,487,0,6
88556,2,2366,2422,-56,0,4,0,6
88557,3,2651,2597,54,0,141,0,6
88558,2,2390,2530,-140,0,195,0,6
88559,3,2533,2503,30,0,112,0,6
88560,1,2385,2403,-18,0,130,0,6
88561,2,2404,2358,46,0,101,0,6
88562,2,2530,2453,77,0,414,0,6
88563,1,2486,2323,163,0,121,0,6
88564,1,2416,2416,0,0,110,1,8
88566,1,2452,2374,78,0,228,0,6
88567,1,2415,2430,-15,0,35,1,6
88568,1,2446,2457,-11,0,150,0,6
88569,2,2378,2524,-146,0,405,1,6
88570,1,2420,2378,42,0,49,0,6
88571,1,2405,2280,125,0,310,1,6
88572,1,2468,2617,-149,0,190,0,6
88573,2,2576,2410,166,0,40,0,6
88574,1,2550,2293,257,0,111,1,6
88575,2,2580,2573,7,0,253,1,6
88576,2,2474,2465,9,0,288,0,6
88577,1,2433,2301,132,0,45,0,8
88578,2,2738,2542,196,0,215,0,6
88579,2,2648,2602,46,0,45,0,6
88580,1,2480,2410,70,0,200,0,8
88581,1,2498,2303,195,0,453,0,8
88582,1,2532,2499,33,0,132,0,6
88583,3,2366,2485,-119,0,101,0,6
88584,1,2612,2449,163,0,337,0,6
88585,1,2515,2370,145,0,44,0,6
88586,1,2467,2362,105,0,331,0,6
88587,1,2491,2481,10,0,435,0,6
88588,2,2432,2472,-40,0,49,0,6
88589,3,2303,2455,-152,0,253,0,6
88590,1,2382,2459,-77,0,0,1,6
88591,3,2414,2259,155,0,40,0,6
88592,2,2347,2406,-59,0,474,0,6
88593,1,2304,2428,-124,0,126,1,6
88594,1,2534,2523,11,0,53,0,6
88595,2,2438,2387,51,0,107,0,6
88596,2,2456,2293,163,0,107,1,6
88597,3,2445,2450,-5,0,1,0,6
88598,3,2598,2651,-53,0,1,0,6
88599,2,2428,2695,-267,0,246,0,6
88600,1,2466,2456,10,0,4,0,6
88601,2,2471,2468,3,0,136,0,6
88602,2,2315,2433,-118,0,268,0,8
88603,3,2518,2568,-50,0,254,0,6
88604,2,2553,2599,-46,0,140,0,6
88605,2,2361,2441,-80,0,113,1,6
88606,1,2446,2263,183,0,41,0,6
88607,1,2419,2398,21,0,130,0,6
88608,1,2427,2385,42,0,45,0,6
88610,2,2459,2584,-125,0,201,0,6
88611,3,2358,2471,-113,0,3,0,6
88612,1,2370,2475,-105,0,41,1,6
88613,1,2559,2316,243,0,108,0,6
88614,1,2451,2452,-1,0,50,0,6
88615,1,2504,2509,-5,0,8,1,6
88616,1,2362,2461,-99,0,41,0,8
88617,2,2252,2404,-152,0,337,0,6
88618,1,2350,2424,-74,0,120,1,6
88619,2,2306,2440,-134,0,14,0,6
88620,2,2431,2442,-11,0,464,0,8
88621,2,2399,2489,-90,0,142,0,6
88622,1,2564,2407,157,0,411,0,6
88623,1,2609,2642,-33,0,177,0,6
88624,1,2403,2270,133,0,300,0,6
88625,2,2425,2421,4,0,301,0,6
88626,1,2443,2374,69,0,1,0,6
88627,1,2528,2615,-87,0,106,0,6
88628,2,2445,2319,126,4,49,0,13
88629,3,2519,2393,126,0,301,0,6
88630,2,2460,2523,-63,0,115,0,6
88631,1,2481,2426,55,0,4,0,6
88632,2,2410,2343,67,0,45,0,6
88633,1,2432,2547,-115,0,45,0,6
88634,2,2409,2415,-6,0,15,0,8
88635,3,2303,2403,-100,0,48,0,6
88636,1,2341,2409,-68,0,335,1,6
88637,1,2451,2387,64,0,315,0,6
88638,3,2494,2475,19,0,415,0,6
88639,2,2423,2312,111,0,5,0,6
88640,1,2457,2574,-117,0,40,1,6
88641,1,2567,2385,182,0,415,1,6
88642,3,2470,2359,111,0,211,0,6
88643,2,2466,2483,-17,0,5,0,6
88644,1,2609,2519,90,0,125,0,6
88645,3,2368,2517,-149,0,216,0,6
88646,3,2540,2505,35,0,400,0,6
88647,2,2350,2454,-104,0,241,0,8
88648,3,2418,2389,29,0,241,0,6
88649,2,2474,2465,9,0,30,0,6
88650,1,2403,2496,-93,0,215,1,6
88651,2,2552,2422,130,0,135,0,6
88652,1,2477,2445,32,0,216,1,6
88653,2,2395,2450,-55,0,10,0,6
88654,1,2445,2321,124,0,241,1,6
88655,1,2452,2446,6,0,255,0,6
88656,2,2401,2360,41,0,331,0,6
88657,2,2293,2445,-152,0,40,0,6
88658,1,2385,2427,-42,0,381,0,6
88659,2,2303,2561,-258,0,123,0,6
88660,1,2410,2403,7,0,190,0,8
88661,1,2449,2292,157,0,469,0,6
88662,2,2515,2613,-98,0,201,0,6
88663,3,2404,2567,-163,0,224,0,6
88664,2,2405,2526,-121,0,18,1,6
88665,1,2427,2502,-75,0,107,1,6
88666,2,2330,2439,-109,0,113,0,6
88667,1,2604,2608,-4,0,172,0,6
88668,1,2472,2444,28,0,334,1,6
88669,1,2636,2615,21,0,45,0,6
88670,1,2535,2349,186,0,9,0,6
88671,1,2607,2548,59,0,406,1,6
88672,1,2398,2517,-119,0,27,0,6
88673,2,2275,2415,-140,0,46,0,6
88674,1,2425,2385,40,0,201,0,6
88675,2,2266,2407,-141,0,302,0,6
88676,2,2604,2576,28,0,110,1,6
88677,2,2429,2544,-115,0,7,0,6
88678,2,2513,2447,66,0,101,1,6
88679,1,2555,2455,100,0,426,0,6
88680,2,2269,2439,-170,4,122,0,13
88681,2,2421,2433,-12,0,469,0,6
88682,2,2528,2567,-39,0,40,0,6
88683,2,2486,2395,91,0,190,0,6
88684,1,2553,2485,68,0,210,1,6
88685,1,2370,2465,-95,0,312,0,6
88686,3,2476,2570,-94,0,236,0,6
88687,1,2321,2493,-172,0,10,0,6
88688,3,2421,2602,-181,0,464,0,6
88689,1,2403,2305,98,0,10,0,6
88690,1,2390,2455,-65,0,0,0,6
88691,1,2515,2371,144,0,110,0,6
88692,1,2539,2498,41,0,375,0,6
88693,2,2400,2250,150,0,4,0,6
88694,3,2514,2465,49,0,14,0,6
88695,1,2455,2426,29,0,127,0,6
88696,2,2280,2415,-135,0,226,0,6
88697,1,2460,2284,176,0,4,1,6
88698,1,2361,2468,-107,0,3,1,6
88699,2,2347,2538,-191,0,84,0,6
88700,1,2489,2363,126,0,36,0,6
88701,2,2391,2434,-43,0,110,0,6
88702,1,2650,2233,417,0,107,1,8
88703,2,2317,2449,-132,0,113,1,6
88704,1,2471,2468,3,0,136,0,6
88705,1,2297,2486,-189,0,48,0,6
88706,1,2492,2421,71,0,121,0,6
88707,1,2509,2458,51,0,301,0,6
88708,2,2405,2359,46,0,46,1,6
88709,1,2304,2404,-100,0,395,0,6
88710,2,2401,2440,-39,0,206,0,6
88711,1,2441,2482,-41,0,345,1,6
88712,1,2406,2394,12,0,15,0,6
88713,2,2253,2513,-260,0,453,0,6
88714,1,2701,2611,90,0,202,0,6
88715,1,2558,2378,180,0,268,1,6
88716,1,2617,2511,106,0,125,1,6
88717,2,2489,2477,12,0,310,0,6
88718,1,2407,2401,6,0,301,0,6
88719,1,2502,2572,-70,0,40,0,6
88720,2,2367,2519,-152,0,216,0,6
88721,2,2599,2613,-14,0,321,0,6
88723,3,2466,2258,208,0,115,0,6
88724,1,2458,2320,138,0,140,0,8
88725,3,2388,2465,-77,0,140,0,6
88726,1,2417,2303,114,0,200,0,5
88727,1,2453,2523,-70,0,110,1,6
88728,2,2563,2326,237,0,8,0,6
88729,3,2289,2452,-163,0,202,0,6
88730,2,2543,2582,-39,0,103,0,6
88731,2,2434,2576,-142,0,101,0,6
88732,1,2495,2412,83,0,120,0,6
88733,2,2598,2451,147,0,193,0,6
88734,1,2377,2437,-60,0,400,0,6
88736,3,2353,2423,-70,0,311,0,6
88737,3,2446,2514,-68,0,307,0,6
88738,2,2463,2214,249,0,130,0,6
88739,2,2569,2492,77,0,485,0,6
88740,2,2419,2381,38,0,133,0,6
88741,3,2485,2477,8,0,414,0,6
88742,1,2416,2351,65,0,4,0,6
88743,2,2605,2493,112,0,380,1,6
88744,2,2412,2263,149,0,11,0,6
88745,1,2515,2461,54,0,4,1,6
88746,3,2541,2344,197,0,9,0,6
88747,1,2463,2544,-81,0,30,0,6
88748,1,2483,2419,64,0,435,1,6
88749,1,2500,2397,103,0,241,0,6
88750,1,2448,2365,83,0,190,0,6
88751,2,2395,2453,-58,0,0,0,6
88752,2,2421,2697,-276,0,246,0,6
88753,1,2438,2548,-110,0,0,0,6
88754,2,2412,2340,72,0,271,1,6
88755,1,2402,2416,-14,0,243,0,6
88756,1,2462,2477,-15,0,1,1,6
88757,2,2416,2503,-87,0,190,0,8
88758,1,2565,2407,158,0,211,0,6
88759,2,2413,2403,10,0,4,0,6
88760,1,2332,2413,-81,0,106,0,6
88761,2,2619,2706,-87,0,45,0,6
88762,1,2565,2410,155,0,200,0,6
88763,1,2506,2459,47,0,426,1,6
88764,1,2422,2286,136,0,140,0,6
88765,1,2447,2251,196,4,143,0,13
88766,2,2257,2437,-180,4,20,0,13
88767,2,2447,2475,-28,0,345,0,6
88768,1,2507,2622,-115,0,101,0,6
88769,2,2224,2517,-293,0,130,0,6
88770,2,2444,2497,-53,0,250,0,6
88771,2,2412,2356,56,0,463,0,6
88772,2,2461,2369,92,0,214,0,6
88773,2,2579,2562,17,0,330,0,6
88774,1,2499,2391,108,0,336,0,6
88775,2,2319,2400,-81,0,6,0,6
88776,2,2427,2423,4,0,310,0,6
88777,1,2411,2504,-93,0,55,0,6
88778,2,2248,2410,-162,0,30,0,6
88779,3,2513,2447,66,0,301,0,6
88780,1,2456,2335,121,0,332,0,6
88781,1,2445,2322,123,4,245,1,13
88782,2,2451,2350,101,0,250,0,6
88783,1,2411,2257,154,0,1,0,6
88784,1,2439,2384,55,0,48,0,6
88785,1,2522,2431,91,0,200,1,6
88786,1,2554,2501,53,0,49,1,6
88787,1,2519,2398,121,0,5,0,6
88788,1,2423,2271,152,0,101,0,6
88789,2,2445,2485,-40,0,8,1,6
88790,3,2400,2218,182,0,43,0,8
88791,2,2347,2538,-191,0,200,0,6
88792,1,2299,2421,-122,0,448,1,5
88793,1,2477,2453,24,0,200,1,6
88794,2,2391,2537,-146,0,4,1,6
88795,2,2408,2471,-63,0,4,0,6
88796,2,2614,2514,100,0,125,1,6
88797,1,2375,2562,-187,0,307,0,6
88798,2,2314,2493,-179,0,200,0,6
88799,2,2403,2568,-165,0,101,0,6
88800,2,2488,2614,-126,0,321,1,6
88801,1,2463,2389,74,0,41,1,6
88802,3,2453,2419,34,0,132,0,6
88803,1,2710,2606,104,0,106,0,6
88804,3,2406,2407,-1,0,150,0,6
88805,1,2568,2376,192,0,331,0,6
88806,3,2573,2406,167,0,43,0,6
88807,2,2414,2328,86,0,205,0,6
88808,1,2503,2599,-96,0,140,0,6
88809,2,2301,2426,-125,0,47,0,6
88810,2,2296,2410,-114,0,410,1,6
88811,2,2232,2453,-221,0,267,0,6
88812,2,2455,2511,-56,0,211,0,6
88813,2,2568,2588,-20,0,156,0,6
88814,3,2308,2462,-154,0,41,0,8
88815,1,2456,2422,34,0,253,0,6
88816,1,2354,2520,-166,0,455,0,6
88817,2,2405,2439,-34,0,245,0,6
88818,2,2438,2422,16,0,107,1,6
88819,2,2481,2466,15,0,211,0,6
88820,2,2365,2545,-180,0,1,0,6
88821,2,2347,2443,-96,0,333,0,6
88822,1,2482,2295,187,4,101,0,13
88823,1,2512,2403,109,0,45,0,6
88824,1,2475,2391,84,0,4,0,6
88825,1,2522,2414,108,0,70,0,6
88826,1,2331,2421,-90,0,241,0,6
88827,2,2307,2448,-141,0,228,1,6
88828,2,2525,2571,-46,0,267,1,6
88829,2,2428,2446,-18,0,21,1,6
88830,1,2541,2344,197,0,12,0,6
88831,1,2541,2446,95,0,181,1,6
88832,1,2401,2408,-7,0,141,0,6
88833,1,2448,2571,-123,0,101,0,6
88834,1,2496,2311,185,0,0,0,6
88835,1,2421,2362,59,0,403,0,6
88836,1,2426,2391,35,0,7,0,6
88837,1,2203,2419,-216,0,101,0,6
88838,1,2401,2395,6,0,45,1,6
88839,2,2373,2526,-153,0,3,0,6
88840,1,2448,2343,105,0,250,0,6
88841,2,2379,2401,-22,0,409,1,6
88842,1,2699,2408,291,0,470,0,6
88843,1,2307,2439,-132,0,40,0,6
88844,1,2341,2544,-203,0,13,1,6
88845,1,2599,2444,155,0,113,0,6
88846,3,2426,2541,-115,0,1,0,6
88847,1,2496,2490,6,0,141,1,6
88848,1,2461,2419,42,0,110,0,6
88849,2,2402,2317,85,0,107,1,6
88850,2,2618,2563,55,0,40,0,6
88851,2,2522,2607,-85,0,132,1,6
88852,2,2220,2526,-306,0,373,0,6
88853,1,2410,2233,177,0,301,1,6
88854,1,2420,2448,-28,0,27,0,6
88855,2,2297,2407,-110,0,45,0,6
88856,2,2383,2553,-170,0,435,0,6
88857,1,2559,2321,238,0,14,1,6
88858,1,2273,2426,-153,0,335,0,6
88859,2,2548,2362,186,0,201,1,6
88860,1,2571,2400,171,0,205,0,6
88861,1,2418,2250,168,0,4,0,6
88862,1,2452,2442,10,0,352,0,6
88863,3,2334,2511,-177,4,43,0,13
88864,1,2352,2509,-157,0,106,0,6
88865,1,2516,2450,66,0,435,0,6
88866,2,2308,2499,-191,0,100,1,6
88867,2,2410,2302,108,0,106,0,6
88868,1,2530,2370,160,0,200,0,6
88869,1,2339,2480,-141,0,466,0,6
88870,1,2312,2413,-101,0,315,1,8
88871,2,2406,2372,34,0,253,1,6
88872,2,2384,2469,-85,0,140,0,6
88873,1,2516,2386,130,0,301,0,6
88874,2,2375,2563,-188,0,300,0,6
88875,1,2475,2611,-136,0,270,0,6
88876,2,2377,2407,-30,0,130,0,6
88877,1,2451,2423,28,0,250,0,6
88878,2,2582,2714,-132,0,7,0,6
88879,1,2339,2452,-113,0,270,0,6
88880,1,2511,2362,149,0,307,1,6
88881,3,2431,2374,57,0,5,0,6
88882,2,2442,2304,138,0,242,0,6
88883,3,2576,2385,191,0,313,0,6
88884,2,2390,2452,-62,0,301,1,6
88885,1,2275,2404,-129,0,335,0,6
88886,1,2428,2315,113,0,13,0,6
88887,2,2233,2410,-177,0,302,0,6
88888,1,2506,2406,100,0,120,0,6
88889,1,2520,2447,73,0,40,0,6
88890,2,2528,2458,70,0,404,0,6
88891,3,2444,2441,3,0,110,0,6
88892,1,2444,2374,70,0,211,0,6
88893,2,2407,2346,61,0,46,0,6
88894,2,2570,2606,-36,0,123,1,6
88895,2,2445,2460,-15,0,260,1,6
88896,2,2381,2466,-85,0,30,0,6
88897,2,2484,2502,-18,0,386,0,6
88898,1,2509,2428,81,0,4,0,6
88899,1,2459,2290,169,0,140,0,8
88900,2,2246,2422,-176,0,415,0,6
88901,2,2414,2399,15,0,10,0,6
88902,1,2611,2517,94,0,130,0,6
88903,2,2539,2438,101,0,375,1,6
88904,1,2502,2305,197,0,0,1,6
88905,2,2566,2520,46,0,306,0,6
88906,1,2401,2217,184,0,300,0,8
88907,1,2498,2396,102,0,4,0,6
88908,2,2574,2540,34,0,23,0,6
88909,1,2497,2422,75,0,280,0,6
88910,1,2372,2411,-39,0,343,1,6
88911,2,2366,2472,-106,0,3,0,6
88912,1,2442,2311,131,0,491,0,6
88913,1,2418,2350,68,0,138,1,6
88914,2,2424,2573,-149,0,245,0,6
88915,1,2456,2293,163,0,102,0,6
88916,2,2423,2458,-35,0,140,1,6
88917,2,2397,2575,-178,0,111,0,6
88918,2,2533,2603,-70,0,255,1,6
88919,1,2414,2383,31,0,15,0,6
88920,2,2436,2281,155,0,45,0,8
88921,2,2456,2520,-64,0,101,1,6
88922,3,2412,2391,21,0,300,0,6
88923,1,2414,2229,185,0,107,0,6
88924,1,2324,2545,-221,0,50,0,6
88925,2,2373,2561,-188,0,112,1,6
88926,3,2349,2405,-56,0,180,0,6
88927,2,2204,2561,-357,0,27,0,6
88928,2,2301,2402,-101,0,454,0,6
88929,2,2234,2408,-174,0,101,0,6
88930,1,2507,2479,28,0,40,0,6
88931,2,2527,2718,-191,0,193,0,6
88932,1,2513,2512,1,0,145,0,6
88933,1,2413,2347,66,0,245,1,6
88934,1,2369,2434,-65,0,43,0,6
88935,2,2380,2400,-20,0,415,1,6
88936,1,2439,2347,92,0,152,0,8
88937,1,2441,2444,-3,0,302,0,6
88938,1,2476,2362,114,0,13,0,6
88939,1,2457,2437,20,0,314,1,6
88940,2,2434,2276,158,0,138,0,6
88941,2,2443,2525,-82,0,301,0,6
88942,1,2487,2451,36,0,190,0,6
88943,1,2616,2565,51,0,40,1,6
88944,2,2502,2483,19,0,253,0,6
88945,2,2353,2560,-207,0,101,0,6
88946,2,2301,2440,-139,4,210,1,13
88947,2,2307,2413,-106,0,15,1,5
88948,3,2359,2515,-156,0,1,0,6
88949,2,2423,2475,-52,0,143,1,6
88950,1,2328,2463,-135,0,107,0,8
88951,1,2576,2652,-76,0,331,0,6
88952,1,2412,2426,-14,0,300,1,6
88953,1,2440,2419,21,0,264,0,6
88954,1,2465,2233,232,0,8,0,6
88955,1,2329,2406,-77,0,312,0,8
88956,3,2377,2449,-72,0,332,0,6
88957,1,2532,2420,112,0,96,0,6
88958,1,2319,2480,-161,0,487,1,6
88959,3,2427,2487,-60,0,245,0,6
88960,2,2406,2312,94,0,190,0,6
88961,1,2402,2489,-87,0,311,1,6
88962,2,2463,2492,-29,0,485,0,6
88963,1,2404,2295,109,0,311,1,6
88964,1,2411,2216,195,0,1,1,6
88965,2,2460,2359,101,0,203,1,6
88966,1,2608,2529,79,0,44,1,6
88967,3,2345,2422,-77,0,389,0,6
88968,2,2284,2423,-139,0,40,1,6
88969,1,2430,2445,-15,0,4,0,6
88970,1,2414,2470,-56,0,200,0,6
88971,2,2525,2451,74,0,107,1,6
88972,2,2438,2446,-8,0,110,0,6
88973,2,2474,2513,-39,0,0,0,6
88974,2,2293,2447,-154,0,151,0,6
88975,1,2473,2376,97,0,455,0,6
88976,1,2578,2394,184,0,415,1,6
88977,1,2438,2297,141,0,109,1,6
88978,1,2445,2493,-48,0,167,0,6
88979,2,2564,2379,185,0,15,0,6
88980,1,2721,2524,197,0,133,1,6
88981,3,2506,2519,-13,0,46,0,6
88982,2,2438,2563,-125,0,300,0,6
88983,1,2447,2436,11,0,151,1,6
88984,1,2214,2406,-192,0,101,0,8
88985,2,2234,2414,-180,0,101,0,6
88986,1,2247,2406,-159,0,277,0,8
88987,1,2560,2625,-65,0,247,0,6
88988,2,2417,2536,-119,0,312,0,6
88989,2,2408,2469,-61,0,410,0,6
88990,1,2405,2350,55,0,147,0,6
88991,1,2348,2425,-77,0,202,0,6
88992,1,2431,2509,-78,0,410,1,6
88993,3,2342,2477,-135,0,380,0,6
88994,1,2376,2410,-34,0,5,0,6
88995,1,2501,2458,43,0,100,1,6
88996,2,2354,2474,-120,0,145,1,6
88997,1,2240,2403,-163,0,454,0,6
88998,1,2428,2536,-108,0,190,0,6
88999,2,2372,2409,-37,0,106,0,6
89000,2,2472,2499,-27,0,242,1,6
89001,1,2421,2347,74,0,335,0,6
89002,1,2540,2413,127,0,267,0,6
89003,2,2501,2579,-78,0,244,0,6
89004,2,2613,2606,7,0,84,0,6
89005,1,2613,2567,46,0,487,0,6
89006,2,2442,2482,-40,0,292,0,6
89007,1,2428,2281,147,0,108,1,6
89008,1,2501,2366,135,0,200,0,6
89009,1,2302,2426,-124,0,377,1,6
89010,2,2231,2524,-293,0,4,0,6
89011,1,2452,2433,19,0,302,0,6
89012,1,2404,2300,104,0,8,1,6
89013,2,2566,2518,48,0,307,0,6
89014,2,2400,2284,116,0,4,0,6
89015,1,2513,2361,152,0,90,0,6
89016,1,2469,2434,35,0,40,0,6
89017,2,2229,2417,-188,0,101,0,6
89018,2,2529,2458,71,0,114,0,6
89019,1,2455,2296,159,0,248,0,8
89020,1,2241,2418,-177,0,123,0,6
89021,1,2427,2420,7,0,45,1,6
89022,1,2345,2415,-70,0,36,0,6
89023,2,2408,2458,-50,0,315,0,6
89024,2,2481,2290,191,0,200,0,6
89025,2,2524,2519,5,0,145,0,6
89026,1,2387,2406,-19,0,22,1,6
89027,1,2613,2607,6,0,302,0,6
89028,1,2422,2231,191,0,0,0,6
89029,1,2453,2367,86,0,201,1,6
89030,1,2450,2380,70,0,107,0,6
89031,2,2430,2581,-151,0,310,0,6
89032,2,2417,2556,-139,0,120,1,6
89033,1,2464,2323,141,0,101,0,6
89034,2,2474,2390,84,0,454,0,6
89035,2,2318,2440,-122,0,151,1,6
89036,2,2463,2364,99,0,310,0,6
89037,1,2438,2373,65,0,205,0,6
89038,3,2429,2452,-23,0,45,0,6
89039,1,2345,2475,-130,0,165,1,6
89040,1,2562,2622,-60,0,123,0,6
89041,1,2353,2425,-72,0,315,0,6
89042,1,2497,2437,60,0,143,0,6
89043,1,2414,2302,112,0,40,0,6
89044,1,2470,2421,49,0,45,0,6
89045,1,2560,2438,122,0,45,0,6
89046,2,2420,2230,190,0,0,0,6
89047,2,2342,2436,-94,0,25,0,6
89048,1,2611,2569,42,0,170,0,6
89049,1,2465,2524,-59,0,101,0,6
89050,3,2408,2453,-45,0,100,0,6
89051,1,2412,2368,44,0,110,0,6
89052,2,2505,2467,38,0,200,0,6
89053,3,2442,2436,6,0,134,0,6
89054,1,2437,2427,10,0,267,0,6
89055,1,2410,2344,66,0,113,0,6
89056,2,2398,2515,-117,0,4,0,6
89057,1,2487,2451,36,0,153,1,6
89058,2,2477,2309,168,0,353,0,6
89059,2,2458,2518,-60,0,46,0,6
89060,1,2379,2468,-89,0,405,1,6
89061,2,2410,2369,41,0,410,0,6
89062,1,2400,2331,69,0,300,0,8
89063,1,2619,2601,18,0,302,0,6
89064,3,2525,2521,4,0,132,0,6
89065,1,2559,2618,-59,0,301,0,6
89066,2,2399,2455,-56,0,310,0,6
89067,1,2595,2521,74,0,300,1,6
89068,1,2406,2393,13,0,102,1,6
89069,3,2371,2467,-96,0,127,0,6
89070,1,2409,2363,46,0,212,0,6
89071,1,2519,2479,40,0,302,0,6
89072,2,2394,2411,-17,0,32,0,6
89073,2,2544,2405,139,0,101,0,6
89074,1,2583,2427,156,0,455,0,6
89075,2,2250,2418,-168,0,200,0,6
89076,2,2413,2564,-151,0,101,0,6
89077,1,2363,2521,-158,0,7,0,6
89078,2,2434,2471,-37,0,405,0,6
89079,2,2362,2510,-148,0,3,0,6
89080,1,2505,2473,32,0,133,0,6
89081,1,2358,2516,-158,0,300,0,6
89082,3,2518,2587,-69,0,301,0,6
89083,2,2498,2475,23,0,248,0,6
89084,2,2467,2347,120,0,13,0,6
89085,2,2442,2306,136,0,400,1,6
89086,1,2448,2353,95,0,145,0,6
89087,1,2564,2619,-55,0,110,0,6
89088,2,2267,2431,-164,0,46,1,6
89089,2,2412,2440,-28,0,394,0,6
89090,1,2401,2415,-14,0,302,1,6
89091,2,2409,2388,21,0,40,0,6
89092,1,2452,2497,-45,0,46,1,6
89093,2,2477,2442,35,0,300,1,6
89094,2,2315,2469,-154,0,30,0,6
89095,1,2422,2345,77,0,324,1,6
89096,2,2513,2318,195,0,337,0,6
89097,3,2474,2389,85,0,143,0,6
89098,2,2356,2417,-61,0,101,1,6
89099,1,2355,2455,-100,0,5,0,8
89100,1,2371,2443,-72,0,4,1,6
89101,1,2645,2461,184,0,45,1,6
89102,1,2596,2422,174,0,300,0,6
89103,3,2523,2453,70,0,110,0,6
89104,1,2364,2436,-72,0,125,0,6
89105,1,2508,2366,142,0,202,1,6
89106,2,2446,2458,-12,0,242,1,6
89107,1,2466,2492,-26,0,315,0,6
89108,2,2519,2566,-47,0,301,1,6
89109,1,2540,2395,145,0,153,1,6
89110,2,2401,2340,61,0,271,1,6
89111,1,2414,2383,31,0,253,1,6
89112,1,2586,2564,22,0,371,0,6
89113,1,2421,2247,174,0,145,0,6
89114,2,2397,2446,-49,0,380,1,6
89115,2,2293,2412,-119,0,28,0,6
89116,1,2388,2492,-104,0,22,0,6
89117,1,2608,2570,38,0,45,0,6
89118,2,2468,2359,109,0,0,0,6
89119,3,2402,2327,75,0,335,0,6
89120,1,2600,2429,171,0,246,0,6
89121,2,2363,2452,-89,0,325,1,6
89122,1,2421,2239,182,0,0,0,6
89123,1,2349,2460,-111,0,165,1,6
89124,3,2371,2415,-44,0,180,0,6
89125,1,2507,2451,56,0,201,0,6
89126,2,2240,2473,-233,0,4,0,6
89127,1,2394,2403,-9,0,4,1,6
89128,2,2516,2588,-72,0,207,0,6
89129,3,2317,2404,-87,0,37,0,6
89130,1,2416,2289,127,0,111,0,6
89131,2,2366,2461,-95,0,2,0,6
89132,1,2567,2373,194,0,310,0,6
89133,1,2473,2311,162,0,454,0,6
89134,1,2422,2262,160,0,7,0,6
89135,2,2559,2481,78,0,247,0,6
89136,2,2366,2418,-52,0,112,0,6
89137,3,2477,2486,-9,0,300,0,6
89138,2,2314,2434,-120,0,53,0,6
89139,2,2558,2591,-33,0,103,0,6
89140,2,2459,2472,-13,0,141,0,6
89141,1,2415,2210,205,4,313,1,11
89142,1,2463,2512,-49,0,120,0,6
89143,3,2410,2648,-238,0,1,0,6
89144,1,2475,2520,-45,0,5,0,6
89145,1,2435,2267,168,0,20,1,6
89146,2,2504,2459,45,0,106,0,6
89147,1,2419,2485,-66,0,246,0,6
89148,1,2426,2603,-177,0,400,0,6
89149,2,2420,2395,25,0,110,1,6
89150,2,2454,2522,-68,0,44,0,6
89151,2,2436,2378,58,0,115,0,6
89152,1,2424,2246,178,0,210,1,6
89153,2,2426,2599,-173,0,22,0,6
89154,2,2565,2617,-52,0,106,1,6
89155,2,2360,2417,-57,0,101,0,6
89156,2,2425,2225,200,0,4,0,6
89157,1,2486,2491,-5,0,241,0,6
89158,3,2477,2453,24,0,491,0,6
89159,2,2299,2465,-166,0,214,1,6
89160,1,2401,2264,137,0,315,1,6
89161,1,2536,2408,128,0,181,0,6
89162,1,2362,2476,-114,0,2,0,6
89163,2,2513,2544,-31,0,260,1,6
89164,2,2438,2308,130,0,4,1,6
89165,2,2447,2290,157,0,133,0,8
89166,2,2382,2514,-132,0,101,0,6
89167,1,2451,2498,-47,0,242,0,6
89168,1,2444,2355,89,0,337,1,6
89169,1,2465,2357,108,0,404,0,6
89170,1,2340,2461,-121,0,101,1,6
89171,2,2571,2518,53,0,301,0,6
89172,1,2423,2244,179,0,31,0,6
89173,1,2397,2400,-3,0,162,0,6
89174,2,2385,2429,-44,0,46,0,6
89175,1,2400,2242,158,0,46,0,6
89176,2,2231,2482,-251,0,0,0,6
89177,2,2404,2540,-136,0,153,0,6
89178,1,2395,2414,-19,0,485,0,6
89179,1,2512,2391,121,0,424,0,6
89180,2,2511,2386,125,0,307,0,6
89181,2,2592,2570,22,0,101,0,6
89182,2,2488,2553,-65,0,7,1,6
89183,2,2463,2395,68,0,123,1,6
89184,1,2347,2413,-66,0,350,1,6
89185,3,2553,2596,-43,0,270,0,6
89186,2,2279,2448,-169,0,302,0,6
89187,1,2486,2478,8,0,242,1,6
89188,1,2645,2413,232,0,96,0,6
89189,2,2426,2449,-23,0,110,1,6
89190,1,2367,2438,-71,0,200,0,6
89191,2,2320,2469,-149,0,140,0,6
89192,1,2401,2455,-54,0,343,1,6
89193,1,2511,2594,-83,0,343,1,6
89194,2,2352,2415,-63,0,265,0,6
89195,1,2602,2625,-23,0,40,0,6
89196,2,2354,2414,-60,0,70,0,6
89197,2,2453,2477,-24,0,120,0,6
89198,2,2336,2492,-156,0,48,0,6
89199,2,2411,2432,-21,0,10,0,6
89200,2,2401,2514,-113,0,101,0,6
89201,2,2468,2370,98,0,95,0,6
89202,2,2294,2420,-126,0,45,0,8
89203,2,2241,2426,-185,0,110,0,6
89204,1,2341,2469,-128,0,106,0,6
89205,2,2468,2353,115,0,19,0,6
89206,2,2434,2380,54,0,115,0,6
89207,2,2461,2327,134,0,176,0,6
89208,1,2484,2202,282,0,278,0,6
89209,1,2361,2408,-47,0,115,0,6
89210,1,2515,2353,162,0,14,1,6
89211,1,2435,2457,-22,0,371,1,6
89212,2,2597,2560,37,0,485,0,6
89213,2,2376,2404,-28,0,120,0,6
89214,2,2316,2430,-114,0,4,1,6
89215,1,2453,2485,-32,0,241,0,6
89216,1,2564,2505,59,0,211,0,6
89217,2,2524,2549,-25,0,107,1,6
89218,1,2439,2584,-145,0,9,0,6
89219,1,2624,2531,93,0,453,0,6
89220,2,2492,2498,-6,0,190,1,6
89221,1,2431,2374,57,0,36,0,6
89222,2,2586,2569,17,0,241,0,6
89223,2,2576,2532,44,0,300,1,6
89224,1,2424,2286,138,0,218,1,8
89225,2,2322,2423,-101,0,315,1,6
89226,2,2483,2534,-51,0,8,1,6
89227,2,2368,2448,-80,0,406,0,6
89228,1,2482,2448,34,0,40,0,6
89229,2,2543,2401,142,0,181,0,6
89230,2,2386,2428,-42,0,455,0,6
89231,1,2353,2460,-107,0,40,0,6
89232,1,2477,2402,75,0,43,0,6
89233,1,2557,2453,104,0,132,0,6
89234,1,2429,2238,191,0,44,0,6
89235,1,2572,2261,311,0,311,0,6
89236,2,2461,2349,112,0,338,0,6
89237,1,2515,2411,104,0,80,0,6
89238,1,2418,2295,123,0,100,0,6
89239,2,2403,2426,-23,0,111,1,6
89240,2,2398,2409,-11,0,58,1,6
89241,1,2455,2420,35,0,300,0,6
89242,2,2406,2338,68,0,491,0,6
89243,2,2243,2430,-187,0,101,0,6
89244,1,2377,2462,-85,0,2,0,6
89245,1,2461,2352,109,0,7,0,6
89246,1,2620,2603,17,0,4,0,6
89247,1,2360,2405,-45,0,242,1,6
89248,1,2587,2518,69,0,45,1,6
89249,2,2486,2397,89,0,4,0,6
89250,2,2466,2608,-142,0,132,0,6
89251,2,2254,2489,-235,4,308,1,8
89252,1,2408,2448,-40,0,13,0,6
89253,2,2495,2570,-75,0,101,0,6
89254,2,2409,2539,-130,0,267,1,6
89255,1,2235,2432,-197,0,110,0,6
89256,2,2506,2343,163,0,150,0,6
89257,1,2259,2573,-314,0,40,0,6
89258,2,2567,2554,13,0,127,1,6
89259,1,2488,2431,57,0,212,1,6
89260,1,2479,2460,19,0,120,1,6
89261,2,2441,2580,-139,0,455,1,6
89262,1,2512,2338,174,0,190,0,6
89263,3,2434,2312,122,0,130,0,6
89264,1,2433,2381,52,0,115,0,6
89265,1,2234,2405,-171,0,0,0,6
89266,1,2242,2479,-237,0,43,0,6
89267,1,2555,2443,112,0,113,0,6
89268,1,2460,2519,-59,0,300,0,6
89269,1,2507,2415,92,0,265,0,6
89270,2,2486,2631,-145,0,190,0,6
89271,2,2433,2279,154,0,0,0,6
89272,2,2369,2419,-50,0,245,0,6
89273,2,2436,2361,75,0,14,0,6
89274,2,2463,2574,-111,0,101,0,6
89275,2,2403,2324,79,0,40,0,6
89276,1,2310,2430,-120,0,123,0,6
89277,2,2491,2318,173,0,122,0,6
89278,1,2575,2520,55,0,40,0,6
89279,2,2501,2478,23,0,244,0,6
89280,2,2455,2384,71,0,13,1,6
89281,2,2398,2453,-55,0,422,0,6
89282,3,2396,2519,-123,0,1,0,6
89283,2,2597,2626,-29,0,100,0,6
89284,2,2449,2481,-32,0,15,0,6
89285,2,2314,2473,-159,0,122,0,6
89286,1,2292,2422,-130,0,105,1,6
89287,2,2449,2454,-5,0,135,1,6
89288,2,2618,2612,6,0,46,0,6
89289,2,2335,2465,-130,0,487,0,6
89290,2,2334,2415,-81,0,58,0,6
89291,1,2513,2592,-79,0,414,0,6
89292,1,2409,2536,-127,0,190,0,6
89293,2,2431,2397,34,0,11,1,6
89294,2,2612,2515,97,0,57,0,6
89295,2,2417,2392,25,0,284,0,6
89296,1,2424,2244,180,0,310,0,6
89297,1,2542,2483,59,0,315,0,6
89298,1,2414,2358,56,0,150,0,6
89299,2,2348,2498,-150,0,227,0,6
89300,2,2492,2415,77,0,112,1,6
89301,1,2560,2561,-1,0,135,0,6
89302,1,2636,2570,66,0,441,0,6
89303,2,2314,2432,-118,0,5,0,6
89304,2,2439,2559,-120,0,132,0,6
89305,1,2517,2472,45,0,4,0,6
89306,1,2405,2584,-179,0,200,0,6
89307,1,2377,2438,-61,0,455,0,6
89308,1,2419,2288,131,0,103,0,6
89309,2,2512,2533,-21,0,201,1,6
89310,2,2350,2454,-104,0,101,0,6
89311,1,2561,2437,124,0,312,0,6
89312,1,2274,2428,-154,0,106,0,8
89313,2,2407,2428,-21,0,108,1,6
89314,1,2592,2326,266,0,150,0,6
89315,1,2427,2280,147,0,130,0,6
89316,1,2411,2467,-56,0,110,0,6
89317,2,2478,2515,-37,0,112,1,6
89318,2,2364,2446,-82,0,121,0,6
89319,2,2547,2495,52,0,400,1,6
89320,2,2405,2477,-72,0,41,0,6
89321,2,2485,2429,56,0,4,1,6
89322,1,2420,2263,157,0,41,0,6
89323,2,2241,2427,-186,0,100,0,6
89324,1,2342,2443,-101,0,141,1,6
89325,2,2391,2448,-57,0,2,0,6
89326,1,2415,2299,116,0,266,0,6
89327,2,2510,2517,-7,0,46,1,6
89328,1,2226,2431,-205,0,43,0,6
89329,1,2436,2310,126,0,121,0,6
89330,2,2457,2368,89,0,338,0,6
89331,2,2248,2467,-219,0,45,0,6
89332,2,2240,2522,-282,0,0,0,6
89333,2,2468,2331,137,0,10,0,6
89334,2,2443,2331,112,0,190,0,6
89335,1,2563,2435,128,0,113,0,6
89336,1,2476,2265,211,0,125,1,7
89337,2,2522,2529,-7,0,211,0,6
89338,1,2299,2459,-160,0,302,0,6
89339,2,2403,2425,-22,0,311,1,6
89340,2,2612,2643,-31,0,302,0,6
89341,1,2429,2379,50,0,45,0,6
89342,1,2411,2418,-7,0,139,1,6
89343,1,2469,2403,66,0,141,0,6
89344,2,2422,2486,-64,0,30,0,6
89345,1,2461,2378,83,0,0,0,6
89346,1,2431,2383,48,0,115,0,6
89347,2,2585,2538,47,0,300,0,6
89348,2,2273,2594,-321,0,4,0,6
89349,3,2324,2507,-183,0,54,0,6
89350,1,2432,2566,-134,0,0,0,6
89351,2,2535,2517,18,0,317,1,6
89352,2,2545,2381,164,0,404,0,6
89353,1,2339,2418,-79,0,1,1,6
89354,1,2434,2453,-19,0,40,1,6
89355,2,2414,2415,-1,0,140,1,6
89356,2,2480,2323,157,0,122,0,6
89357,1,2703,2478,225,0,267,0,6
89358,1,2528,2416,112,0,140,1,6
89359,1,2430,2238,192,0,57,1,6
89360,1,2482,2460,22,0,317,0,6
89361,1,2423,2392,31,0,487,1,6
89362,1,2458,2473,-15,0,245,0,6
89363,2,2399,2524,-125,0,374,0,6
89364,1,2548,2362,186,0,105,0,6
89365,2,2334,2436,-102,0,200,0,6
89366,2,2522,2343,179,0,405,0,6
89367,1,2502,2418,84,0,244,1,6
89368,1,2434,2349,85,0,455,0,6
89369,2,2440,2520,-80,0,20,0,6
89370,1,2490,2350,140,0,122,1,6
89371,1,2651,2607,44,0,40,1,6
89372,2,2374,2434,-60,0,200,0,6
89373,2,2400,2556,-156,0,434,0,6
89374,1,2482,2323,159,0,310,0,6
89375,3,2528,2240,288,0,8,0,6
89376,1,2362,2450,-88,0,247,0,6
89377,2,2451,2476,-25,0,310,0,6
89378,1,2339,2436,-97,0,16,1,6
89379,1,2596,2375,221,0,250,0,6
89380,1,2430,2398,32,0,55,0,6
89381,1,2559,2439,120,0,113,0,6
89383,3,2378,2436,-58,0,302,0,6
89384,1,2249,2433,-184,0,302,1,6
89385,1,2331,2472,-141,0,40,1,6
89386,2,2417,2465,-48,0,200,0,6
89387,1,2504,2316,188,0,301,0,6
89388,3,2534,2707,-173,0,247,0,6
89389,1,2361,2412,-51,0,3,1,6
89390,1,2464,2327,137,0,145,1,6
89391,3,2523,2529,-6,0,206,0,6
89392,1,2467,2451,16,0,175,1,6
89393,2,2447,2353,94,0,46,1,6
89394,1,2455,2488,-33,0,48,0,6
89395,1,2537,2440,97,0,269,0,6
89396,1,2425,2238,187,0,227,0,6
89397,2,2373,2514,-141,0,43,0,6
89398,2,2481,2446,35,0,4,1,6
89399,2,2436,2598,-162,0,27,1,6
89400,1,2427,2328,99,0,106,0,6
89401,1,2203,2551,-348,0,123,0,6
89402,2,2370,2428,-58,0,57,0,6
89403,1,2421,2543,-122,0,253,0,6
89404,2,2413,2494,-81,0,141,0,6
89405,1,2413,2532,-119,0,190,1,6
89406,1,2486,2419,67,0,332,0,6
89407,1,2373,2402,-29,0,426,0,6
89408,2,2441,2487,-46,0,275,0,6
89409,1,2400,2370,30,0,145,0,6
89410,1,2438,2346,92,0,40,0,6
89411,1,2429,2346,83,0,190,0,6
89412,2,2602,2658,-56,0,302,1,6
89413,1,2397,2463,-66,0,447,1,6
89414,2,2435,2397,38,0,460,1,6
89415,2,2270,2443,-173,0,277,1,6
89416,1,2494,2431,63,0,341,0,6
89417,1,2405,2368,37,0,227,1,6
89418,2,2435,2379,56,0,115,0,6
89419,2,2339,2418,-79,4,172,0,13
89420,2,2265,2428,-163,0,302,1,6
89421,2,2507,2470,37,0,213,0,6
89422,2,2436,2506,-70,0,206,0,6
89423,2,2424,2323,101,0,41,0,6
89424,1,2529,2523,6,0,426,0,6
89425,3,2518,2673,-155,0,101,0,6
89426,1,2524,2526,-2,0,406,1,6
89427,2,2492,2436,56,0,45,0,6
89428,1,2436,2468,-32,0,310,0,6
89429,1,2405,2206,199,4,200,0,11
89430,1,2432,2409,23,0,21,0,6
89431,2,2498,2472,26,0,255,1,6
89432,2,2461,2417,44,0,46,0,6
89433,2,2443,2485,-42,0,128,0,6
89434,1,2482,2360,122,0,4,0,6
89435,3,2253,2406,-153,0,131,0,6
89436,1,2452,2475,-23,0,310,0,6
89437,1,2410,2296,114,0,455,0,6
89438,2,2386,2428,-42,0,302,1,6
89440,2,2433,2389,44,0,487,0,6
89441,2,2342,2433,-91,0,484,0,6
89442,1,2498,2450,48,0,44,0,6
89443,2,2471,2429,42,0,218,0,6
89444,1,2379,2520,-141,0,310,0,6
89445,1,2406,2376,30,0,104,1,6
89446,2,2358,2476,-118,0,130,0,6
89447,2,2576,2501,75,0,101,0,6
89448,1,2517,2535,-18,0,206,1,6
89449,2,2664,2555,109,0,130,0,6
89450,1,2524,2420,104,0,140,0,6
89451,1,2363,2410,-47,0,3,1,6
89452,1,2427,2342,85,0,100,1,6
89453,1,2511,2431,80,0,119,0,6
89454,2,2446,2298,148,0,485,1,6
89455,2,2462,2442,20,0,245,0,6
89456,2,2424,2485,-61,0,10,0,6
89457,1,2356,2414,-58,0,244,0,6
89458,2,2235,2417,-182,0,110,1,6
89459,2,2204,2530,-326,4,278,0,13
89460,1,2341,2520,-179,0,405,1,6
89462,1,2416,2326,90,0,45,1,6
89463,3,2480,2399,81,0,8,0,6
89464,2,2427,2515,-88,0,0,0,6
89465,1,2403,2545,-142,0,382,0,6
89466,2,2438,2337,101,0,205,1,6
89467,2,2354,2492,-138,0,4,0,6
89468,1,2469,2404,65,0,8,0,6
89469,2,2438,2438,0,0,119,0,6
89470,2,2340,2491,-151,0,107,1,6
89471,1,2490,2416,74,0,45,0,6
89472,2,2413,2403,10,0,196,0,6
89473,2,2316,2443,-127,0,156,0,6
89474,1,2445,2427,18,0,153,0,6
89475,1,2434,2381,53,0,115,0,6
89476,1,2520,2422,98,0,100,0,6
89477,3,2443,2419,24,0,327,0,6
89478,1,2552,2366,186,0,398,0,6
89479,2,2443,2336,107,0,140,1,6
89480,1,2563,2464,99,0,247,1,6
89481,1,2404,2369,35,0,244,1,6
89482,1,2377,2434,-57,0,202,0,6
89483,2,2407,2503,-96,0,1,0,6
89484,3,2400,2387,13,0,8,0,6
89485,2,2416,2529,-113,0,153,1,6
89486,1,2535,2419,116,0,103,1,6
89487,1,2529,2524,5,0,491,0,6
89488,1,2403,2324,79,0,212,0,6
89489,1,2444,2432,12,0,419,0,6
89490,1,2541,2361,180,0,394,0,6
89491,1,2408,2408,0,0,343,0,6
89492,1,2407,2273,134,0,196,0,6
89493,1,2555,2402,153,0,80,0,6
89494,1,2363,2456,-93,0,101,1,6
89495,2,2400,2436,-36,0,4,0,6
89496,1,2376,2438,-62,0,302,0,6
89497,1,2420,2232,188,0,44,0,6
89498,2,2418,2524,-106,0,0,0,6
89499,1,2512,2414,98,0,112,0,6
89500,2,2682,2623,59,0,15,0,6
89501,2,2400,2479,-79,0,133,1,6
89502,1,2473,2496,-23,0,4,0,6
89503,2,2447,2351,96,0,400,0,6
89504,1,2399,2506,-107,0,101,0,6
89505,3,2345,2430,-85,0,5,0,6
89506,3,2409,2495,-86,0,275,0,6
89507,1,2507,2654,-147,0,14,0,6
89508,2,2316,2407,-91,0,4,0,6
89509,2,2338,2411,-73,0,1,0,6
89510,1,2235,2401,-166,0,37,0,6
89511,2,2410,2516,-106,0,0,0,6
89512,1,2530,2362,168,0,486,0,6
89513,2,2443,2449,-6,0,311,0,6
89515,1,2332,2414,-82,0,229,0,6
89516,2,2269,2421,-152,0,45,0,6
89517,2,2393,2483,-90,0,49,0,6
89518,2,2397,2420,-23,0,46,0,6
89519,2,2427,2336,91,0,153,0,6
89520,2,2420,2352,68,0,105,0,6
89521,1,2387,2423,-36,0,310,0,6
89522,2,2490,2402,88,0,345,0,6
89523,1,2412,2384,28,0,200,0,6
89524,2,2432,2383,49,0,115,1,6
89525,3,2518,2535,-17,0,409,0,6
89526,1,2364,2409,-45,0,3,1,6
89527,1,2520,2406,114,0,100,1,6
89528,1,2540,2460,80,0,255,1,6
89529,1,2441,2567,-126,0,15,1,6
89530,2,2416,2451,-35,0,2,1,6
89531,1,2490,2480,10,0,0,0,6
89532,3,2424,2379,45,0,242,0,6
89533,2,2400,2559,-159,0,7,0,6
89534,1,2449,2370,79,0,145,0,6
89535,1,2375,2407,-32,0,325,0,6
89536,2,2318,2487,-169,0,307,0,6
89537,2,2498,2435,63,0,107,1,6
89538,2,2602,2597,5,0,0,0,6
89539,1,2380,2401,-21,0,300,0,6
89540,2,2440,2312,128,0,400,1,6
89541,2,2484,2396,88,0,5,1,6
89542,2,2399,2544,-145,0,1,0,6
89543,2,2497,2493,4,0,46,0,6
89544,1,2629,2358,271,0,200,0,6
89545,1,2407,2438,-31,0,241,0,6
89546,2,2455,2443,12,0,335,0,6
89547,2,2429,2346,83,0,210,0,6
89548,1,2425,2261,164,0,31,0,6
89549,2,2266,2424,-158,0,45,0,6
89550,1,2400,2352,48,0,4,0,6
89551,1,2410,2592,-182,0,200,0,6
89552,1,2277,2483,-206,0,45,0,6
89553,1,2495,2449,46,0,386,0,6
89554,1,2674,2792,-118,0,132,0,6
89555,2,2403,2371,32,0,220,0,6
89556,1,2417,2474,-57,0,310,1,6
89557,3,2456,2545,-89,0,267,0,6
89558,1,2562,2396,166,0,80,0,6
89559,2,2445,2333,112,0,4,0,6
89560,1,2319,2418,-99,0,20,0,6
89561,2,2411,2325,86,0,106,1,6
89562,1,2559,2390,169,0,110,0,6
89563,2,2411,2333,78,0,170,1,6
89564,2,2400,2356,44,0,302,0,6
89565,1,2466,2379,87,0,487,0,6
89566,3,2456,2402,54,0,112,0,6
89567,1,2394,2425,-31,0,455,0,6
89568,1,2421,2428,-7,0,140,0,6
89569,2,2571,2604,-33,0,154,1,6
89570,2,2404,2390,14,0,45,0,6
89571,2,2366,2453,-87,0,101,0,6
89573,2,2444,2373,71,0,464,0,6
89574,2,2389,2471,-82,0,200,0,6
89575,3,2415,2440,-25,0,37,0,6
89576,1,2428,2392,36,0,484,1,6
89577,2,2490,2449,41,0,201,0,6
89578,2,2422,2533,-111,0,110,0,6
89579,2,2432,2562,-130,0,40,0,6
89580,2,2341,2437,-96,0,1,0,6
89581,1,2442,2449,-7,0,203,1,6
89582,1,2492,2432,60,0,51,1,6
89583,1,2476,2386,90,0,16,0,6
89584,1,2418,2413,5,0,225,0,6
89585,2,2355,2447,-92,0,102,0,6
89586,1,2527,2360,167,0,176,0,6
89587,1,2547,2474,73,0,457,0,6
89588,1,2281,2405,-124,0,133,0,6
89589,1,2532,2543,-11,0,265,0,6
89590,2,2431,2457,-26,0,244,0,6
89591,2,2499,2467,32,0,300,0,6
89592,2,2591,2507,84,0,260,0,6
89593,2,2297,2429,-132,0,14,0,6
89594,2,2456,2292,164,0,241,1,6
89595,1,2635,2224,411,4,134,0,11
89596,1,2419,2437,-18,0,386,0,6
89597,2,2410,2327,83,0,200,1,6
89598,2,2442,2337,105,0,4,0,6
89599,2,2452,2350,102,0,245,0,6
89600,2,2422,2279,143,0,100,0,6
89601,2,2403,2400,3,0,272,0,6
89602,1,2703,2785,-82,0,337,0,6
89603,2,2402,2372,30,0,240,1,6
89604,1,2455,2418,37,0,130,0,6
89605,2,2407,2594,-187,0,106,0,6
89606,2,2304,2428,-124,0,404,1,6
89607,1,2566,2392,174,0,245,0,6
89608,2,2430,2424,6,0,190,0,6
89609,3,2439,2502,-63,0,43,0,6
89610,1,2538,2433,105,0,190,0,6
89611,1,2443,2248,195,0,41,0,6
89612,2,2335,2481,-146,0,200,0,6
89613,1,2251,2481,-230,0,153,0,8
89614,3,2537,2552,-15,0,151,0,6
89615,1,2337,2401,-64,0,48,0,6
89616,2,2382,2470,-88,0,458,0,6
89617,2,2361,2460,-99,0,175,0,6
89618,1,2345,2423,-78,0,111,0,6
89619,3,2413,2402,11,0,106,0,6
89620,2,2429,2496,-67,0,306,0,6
89621,1,2397,2542,-145,0,264,0,6
89622,1,2397,2471,-74,0,148,1,6
89623,2,2442,2398,44,0,320,1,6
89624,1,2424,2406,18,0,338,0,6
89625,2,2514,2584,-70,0,40,0,6
89626,1,2501,2504,-3,0,301,1,6
89627,1,2431,2425,6,0,41,0,6
89628,2,2430,2404,26,0,225,1,6
89629,1,2597,2389,208,0,200,1,6
89630,1,2445,2225,220,0,213,0,6
89631,1,2426,2569,-143,0,40,0,6
89632,3,2474,2493,-19,0,5,0,6
89633,2,2344,2434,-90,0,1,0,6
89634,2,2552,2537,15,0,258,0,6
89635,1,2501,2440,61,0,200,1,6
89636,2,2426,2402,24,0,115,0,6
89637,2,2358,2444,-86,0,50,1,6
89638,2,2411,2463,-52,0,295,0,6
89639,1,2778,2710,68,0,474,0,6
89640,1,2334,2403,-69,0,20,0,6
89641,2,2398,2534,-136,0,335,1,6
89642,2,2474,2378,96,0,15,1,6
89643,1,2347,2508,-161,0,0,1,6
89644,2,2238,2531,-293,4,277,0,13
89645,1,2447,2400,47,0,140,0,6
89646,2,2436,2286,150,0,57,0,6
89647,1,2253,2405,-152,0,300,0,6
89648,1,2400,2282,118,0,121,0,6
89649,1,2379,2465,-86,0,170,0,6
89650,2,2331,2484,-153,0,45,1,6
89651,2,2416,2352,64,0,47,0,6
89652,1,2413,2387,26,0,107,0,6
89653,1,2450,2207,243,0,210,0,6
89654,2,2456,2437,19,0,373,0,6
89655,2,2419,2472,-53,0,491,0,6
89656,3,2589,2510,79,0,1,0,6
89657,1,2545,2507,38,0,10,0,6
89658,2,2458,2387,71,0,200,0,6
89659,3,2474,2363,111,0,211,0,8
89660,1,2397,2534,-137,0,406,1,6
89661,2,2227,2610,-383,0,123,0,6
89662,2,2400,2474,-74,0,310,0,6
89663,2,2544,2546,-2,0,58,0,6
89664,2,2377,2464,-87,0,140,0,6
89665,2,2706,2782,-76,0,112,0,6
89666,1,2493,2405,88,0,45,0,6
89667,1,2400,2282,118,0,13,0,6
89668,2,2337,2448,-111,0,48,0,6
89669,2,2449,2354,95,0,264,1,6
89670,3,2436,2506,-70,0,20,0,6
89671,1,2499,2503,-4,0,311,0,6
89672,1,2420,2418,2,0,198,1,6
89673,2,2324,2405,-81,0,113,0,6
89674,2,2468,2538,-70,0,133,0,6
89675,1,2359,2410,-51,0,11,0,6
89676,2,2340,2402,-62,0,1,0,6
89677,1,2291,2401,-110,0,250,0,6
89678,2,2412,2430,-18,0,146,1,6
89679,2,2561,2611,-50,0,253,1,6
89680,1,2419,2319,100,0,253,0,6
89681,2,2387,2434,-47,0,1,0,6
89682,2,2401,2497,-96,0,272,0,6
89683,2,2418,2452,-34,0,129,0,6
89684,1,2431,2328,103,0,43,0,6
89685,1,2467,2488,-21,0,461,0,6
89686,3,2438,2385,53,0,386,0,6
89687,1,2390,2407,-17,0,106,0,6
89688,2,2411,2493,-82,0,151,0,6
89689,1,2394,2450,-56,0,2,0,6
89690,2,2787,2701,86,0,464,1,6
89691,1,2443,2424,19,0,10,1,6
89692,2,2335,2428,-93,0,1,0,6
89693,3,2411,2359,52,0,211,0,6
89694,2,2556,2406,150,0,108,0,6
89695,1,2534,2415,119,0,190,1,6
89696,1,2403,2365,38,0,47,1,6
89697,2,2313,2452,-139,0,40,1,6
89698,1,2397,2414,-17,0,190,0,6
89699,1,2416,2404,12,0,45,0,6
89701,1,2526,2405,121,0,326,0,6
89702,3,2543,2463,80,0,277,0,6
89703,2,2511,2588,-77,0,45,1,6
89704,2,2304,2419,-115,0,305,0,6
89705,1,2552,2538,14,0,258,0,6
89706,1,2432,2262,170,0,41,0,6
89707,2,2339,2461,-122,0,41,1,6
89708,1,2479,2498,-19,0,5,0,6
89709,1,2401,2373,28,0,227,0,6
89710,1,2451,2350,101,0,238,1,6
89711,2,2401,2530,-129,0,414,1,6
89712,1,2401,2322,79,0,128,1,6
89713,1,2505,2437,68,0,100,1,6
89714,2,2396,2435,-39,0,0,0,6
89715,1,2616,2557,59,0,113,0,6
89716,2,2376,2407,-31,0,46,0,6
89717,1,2522,2504,18,0,101,1,6
89718,2,2361,2442,-81,0,102,1,6
89719,2,2312,2425,-113,0,107,0,8
89720,1,2439,2331,108,0,4,0,6
89721,3,2381,2472,-91,0,406,0,8
89722,2,2482,2312,170,0,4,1,6
89723,1,2501,2439,62,0,4,1,6
89724,1,2402,2406,-4,0,302,0,6
89725,1,2400,2548,-148,0,3,1,6
89726,2,2302,2400,-98,0,4,0,6
89727,2,2416,2638,-222,4,201,0,8
89728,1,2507,2202,305,0,101,0,7
89729,1,2408,2396,12,0,55,0,6
89730,2,2360,2409,-49,0,254,0,6
89731,1,2386,2438,-52,0,7,1,6
89732,2,2350,2457,-107,0,2,0,6
89733,1,2397,2413,-16,0,140,0,6
89734,1,2374,2404,-30,0,106,0,6
89735,2,2708,2780,-72,0,115,0,6
89736,2,2360,2408,-48,0,110,0,6
89737,1,2508,2414,94,0,45,0,6
89738,2,2449,2391,58,0,414,0,6
89739,2,2464,2440,24,0,112,0,6
89740,2,2541,2548,-7,0,42,0,6
89741,1,2503,2469,34,0,301,0,6
89742,2,2412,2403,9,0,11,0,6
89743,2,2543,2550,-7,0,254,0,6
89744,2,2238,2414,-176,0,428,0,6
89745,1,2538,2485,53,0,265,0,6
89746,2,2368,2406,-38,0,103,0,6
89747,1,2321,2435,-114,0,96,1,6
89748,1,2466,2421,45,0,42,0,6
89749,1,2443,2557,-114,0,113,0,6
89750,1,2534,2397,137,0,326,0,6
89751,2,2446,2357,89,0,245,1,6
89752,1,2552,2621,-69,0,300,0,6
89753,1,2410,2455,-45,0,301,0,6
89754,2,2382,2513,-131,0,1,1,6
89755,1,2278,2458,-180,0,380,0,6
89756,2,2327,2432,-105,0,1,0,6
89757,1,2536,2418,118,0,190,1,6
89758,1,2233,2400,-167,0,336,1,6
89759,2,2605,2603,2,0,40,0,6
89760,2,2462,2404,58,0,28,0,6
89761,1,2321,2473,-152,0,4,0,6
89762,2,2555,2630,-75,0,22,0,6
89763,2,2400,2416,-16,0,102,1,6
89764,2,2401,2303,98,0,202,1,6
89765,1,2434,2446,-12,0,456,1,6
89766,3,2499,2554,-55,0,46,0,6
89767,2,2537,2408,129,0,203,0,6
89768,1,2429,2308,121,0,464,0,8
89769,1,2613,2335,278,0,133,0,6
89770,1,2409,2431,-22,0,291,1,6
89771,2,2401,2533,-132,0,22,1,6
89772,3,2356,2442,-86,0,289,0,6
89773,2,2785,2704,81,0,104,0,6
89774,1,2537,2508,29,0,306,0,6
89775,2,2418,2406,12,0,150,0,6
89776,1,2393,2412,-19,0,4,1,6
89777,2,2233,2409,-176,0,123,0,6
89778,2,2477,2458,19,0,221,1,6
89779,1,2411,2363,48,0,246,0,6
89780,2,2449,2417,32,0,109,1,6
89781,3,2393,2538,-145,0,211,0,6
89782,2,2413,2355,58,0,47,0,6
89783,1,2436,2398,38,0,43,0,6
89784,1,2480,2428,52,0,4,0,6
89785,2,2370,2452,-82,0,112,1,6
89786,2,2361,2543,-182,0,106,0,6
89787,2,2452,2455,-3,0,129,0,6
89788,1,2465,2393,72,0,4,1,6
89789,1,2512,2464,48,0,338,1,6
89790,2,2309,2436,-127,0,110,0,6
89791,1,2281,2450,-169,0,20,1,6
89792,2,2474,2457,17,0,112,0,6
89793,1,2412,2286,126,0,240,0,6
89794,2,2599,2559,40,0,45,0,6
89795,2,2398,2540,-142,0,306,0,6
89796,2,2635,2551,84,0,332,0,6
89797,2,2416,2526,-110,0,3,0,6
89798,2,2228,2615,-387,0,474,0,6
89799,1,2304,2433,-129,0,211,0,8
89800,3,2415,2503,-88,0,101,0,6
89801,2,2711,2778,-67,0,112,1,6
89802,1,2432,2304,128,0,398,0,6
89803,2,2440,2412,28,0,409,0,6
89804,1,2440,2332,108,0,111,0,6
89805,1,2395,2408,-13,0,110,0,6
89806,2,2535,2396,139,0,325,0,6
89807,1,2550,2416,134,0,128,0,6
89808,3,2425,2323,102,0,40,0,6
89809,1,2436,2440,-4,0,311,1,6
89810,1,2441,2358,83,0,10,1,6
89811,3,2399,2441,-42,0,4,0,6
89812,2,2423,2415,8,0,468,0,6
89813,2,2336,2616,-280,0,150,0,6
89814,2,2362,2407,-45,0,110,1,6
89815,2,2505,2500,5,0,45,0,6
89816,2,2565,2593,-28,0,145,1,6
89817,2,2471,2357,114,0,120,0,6
89818,2,2536,2397,139,0,296,0,6
89819,2,2357,2402,-45,0,0,0,6
89820,1,2542,2517,25,0,302,0,6
89821,2,2287,2446,-159,0,426,0,6
89822,2,2463,2371,92,0,128,0,6
89823,1,2417,2306,111,0,30,1,6
89824,2,2264,2461,-197,0,36,0,6
89825,1,2543,2364,179,0,200,0,6
89826,1,2400,2413,-13,0,5,0,6
89827,1,2470,2394,76,0,0,1,6
89828,2,2403,2343,60,0,170,1,6
89829,1,2532,2468,64,0,190,1,6
89830,1,2389,2442,-53,0,153,0,6
89831,1,2558,2628,-70,0,22,0,6
89832,1,2401,2284,117,4,120,1,13
89833,2,2407,2352,55,0,373,0,6
89834,2,2307,2444,-137,0,200,0,6
89835,2,2404,2528,-124,0,211,0,6
89836,2,2565,2546,19,0,302,1,6
89837,1,2782,2706,76,0,106,0,6
89838,3,2414,2361,53,0,211,0,6
89839,1,2501,2347,154,0,83,0,6
89840,3,2618,2554,64,0,112,0,6
89841,2,2423,2419,4,0,405,0,6
89842,2,2404,2434,-30,0,112,0,6
89843,1,2545,2447,98,0,100,0,6
89844,2,2285,2412,-127,0,201,0,6
89845,2,2354,2445,-91,0,3,0,6
89846,1,2403,2442,-39,0,337,0,6
89847,1,2464,2296,168,0,172,0,6
89848,1,2415,2400,15,0,4,0,6
89849,2,2378,2403,-25,0,43,0,6
89850,2,2349,2441,-92,0,4,1,6
89851,1,2598,2560,38,0,125,1,6
89852,1,2379,2406,-27,0,45,0,6
89853,1,2412,2357,55,0,40,0,6
89854,3,2443,2279,164,0,245,0,6
89855,1,2344,2404,-60,0,302,0,6
89856,2,2245,2425,-180,0,106,0,6
89857,1,2412,2549,-137,0,3,0,6
89858,2,2443,2441,2,0,22,0,6
89859,1,2449,2292,157,0,201,0,6
89860,3,2401,2440,-39,0,400,0,6
89861,2,2299,2421,-122,0,27,0,6
89862,2,2531,2400,131,0,65,1,6
89863,2,2448,2475,-27,0,460,0,6
89864,3,2538,2565,-27,0,244,0,6
89865,1,2552,2390,162,0,244,0,6
89866,2,2425,2312,113,0,466,0,6
89868,3,2505,2464,41,0,107,0,6
89869,1,2702,2787,-85,0,110,1,6
89870,2,2413,2304,109,0,118,0,6
89871,2,2362,2503,-141,0,241,0,6
89872,2,2448,2358,90,0,184,0,6
89873,2,2241,2426,-185,0,107,0,8
89874,1,2324,2408,-84,0,329,0,6
89875,2,2424,2590,-166,0,140,0,6
89876,1,2372,2405,-33,0,291,0,6
89877,2,2467,2617,-150,0,484,0,6
89878,1,2421,2409,12,0,133,0,6
89879,1,2416,2423,-7,0,200,0,6
89881,1,2437,2373,64,0,36,0,6
89882,2,2358,2416,-58,0,202,0,6
89883,1,2480,2341,139,0,21,0,6
89884,3,2507,2428,79,0,43,0,6
89885,1,2436,2362,74,0,43,0,6
89886,1,2409,2388,21,0,306,0,6
89887,1,2482,2400,82,0,43,0,6
89888,1,2352,2417,-65,0,302,1,6
89889,2,2445,2396,49,0,1,1,6
89890,1,2568,2420,148,0,13,0,6
89891,2,2293,2446,-153,0,46,0,6
89892,2,2555,2604,-49,0,145,0,6
89893,2,2338,2409,-71,0,140,0,6
89894,2,2441,2296,145,0,0,0,6
89895,2,2439,2465,-26,0,40,0,6
89896,1,2408,2524,-116,0,206,0,6
89897,1,2434,2312,122,0,46,0,6
89898,2,2506,2565,-59,0,334,0,6
89899,2,2301,2417,-116,0,202,1,6
89900,1,2320,2401,-81,0,46,1,6
89901,2,2416,2620,-204,0,301,0,6
89902,2,2386,2571,-185,0,41,1,6
89903,2,2417,2504,-87,0,3,0,6
89904,1,2780,2709,71,0,40,0,6
89905,2,2464,2556,-92,0,161,1,6
89906,2,2287,2430,-143,4,43,0,13
89907,1,2401,2301,100,0,42,0,6
89908,1,2243,2487,-244,0,45,0,6
89909,2,2396,2621,-225,0,401,0,6
89910,2,2292,2463,-171,0,315,1,6
89911,2,2365,2484,-119,0,205,0,6
89912,1,2299,2403,-104,0,133,1,6
89913,2,2337,2442,-105,0,4,0,6
89914,1,2441,2347,94,0,132,1,6
89915,3,2569,2516,53,0,34,0,6
89916,2,2331,2455,-124,0,112,0,6
89917,3,2422,2417,5,0,45,0,6
89918,2,2351,2415,-64,0,3,1,6
89919,1,2410,2359,51,0,45,1,6
89920,3,2609,2550,59,0,200,0,6
89921,2,2477,2273,204,0,404,0,6
89922,1,2429,2229,200,0,44,0,6
89923,1,2434,2427,7,0,48,1,6
89924,2,2439,2448,-9,0,11,0,6
89925,2,2400,2257,143,0,103,0,6
89926,1,2341,2404,-63,0,302,1,6
89927,1,2623,2345,278,0,265,1,6
89928,2,2593,2488,105,0,205,0,6
89929,2,2335,2447,-112,0,414,0,6
89930,1,2431,2331,100,0,46,0,6
89931,2,2308,2446,-138,0,483,0,6
89932,2,2302,2405,-103,0,302,0,6
89933,1,2416,2201,215,0,176,0,6
89934,1,2574,2484,90,0,10,0,6
89935,1,2623,2414,209,0,41,1,6
89936,2,2467,2229,238,0,103,0,6
89937,1,2704,2785,-81,0,337,0,6
89938,2,2460,2560,-100,0,130,0,6
89939,1,2402,2421,-19,0,201,1,6
89940,1,2445,2360,85,0,200,0,6
89941,1,2470,2557,-87,0,302,0,6
89942,2,2333,2460,-127,0,112,0,6
89943,2,2446,2268,178,0,0,0,6
89944,1,2470,2383,87,0,0,1,6
89945,2,2517,2569,-52,0,334,0,6
89946,1,2542,2412,130,0,100,0,6
89947,1,2253,2419,-166,0,123,1,6
89948,1,2421,2401,20,0,267,1,6
89949,1,2356,2450,-94,0,140,1,6
89950,1,2401,2362,39,0,128,1,6
89951,1,2419,2346,73,0,80,0,6
89952,1,2474,2367,107,0,40,0,6
89953,1,2453,2433,20,0,28,1,6
89954,2,2551,2608,-57,0,45,1,6
89955,1,2415,2247,168,0,411,0,6
89956,1,2564,2385,179,0,102,0,6
89957,1,2405,2308,97,4,200,0,13
89958,1,2507,2456,51,0,45,0,6
89959,2,2263,2408,-145,0,319,0,6
89960,1,2344,2478,-134,0,128,0,6
89961,1,2434,2238,196,0,115,0,6
89962,2,2411,2545,-134,0,250,0,6
89963,2,2450,2439,11,0,110,0,6
89964,2,2495,2480,15,0,4,0,6
89965,2,2253,2457,-204,0,128,0,6
89966,2,2778,2711,67,0,454,0,6
89967,2,2342,2625,-283,0,107,0,6
89968,2,2573,2512,61,0,34,0,6
89969,2,2421,2420,1,0,260,0,6
89970,1,2415,2340,75,0,84,1,6
89971,1,2335,2480,-145,0,331,0,6
89972,1,2342,2424,-82,0,102,0,6
89973,2,2455,2511,-56,0,300,1,6
89974,1,2550,2411,139,0,128,0,6
89975,2,2301,2477,-176,0,122,0,6
89976,2,2432,2440,-8,0,40,0,6
89977,2,2475,2494,-19,0,0,0,6
89978,1,2470,2352,118,0,406,0,6
89979,2,2286,2406,-120,0,1,1,6
89980,1,2460,2466,-6,0,335,0,6
89981,1,2533,2409,124,0,202,0,6
89982,2,2348,2438,-90,0,315,0,6
89983,2,2393,2410,-17,0,4,0,6
89984,1,2567,2427,140,0,241,0,6
89985,2,2428,2459,-31,0,288,1,6
89986,2,2450,2363,87,0,302,0,6
89987,1,2627,2378,249,0,242,0,6
89988,2,2226,2418,-192,0,110,0,6
89989,2,2330,2443,-113,0,31,1,6
89990,1,2438,2311,127,4,50,0,13
89991,1,2612,2546,66,0,123,0,6
89992,2,2417,2408,9,0,150,0,6
89993,2,2266,2554,-288,0,306,0,6
89994,2,2407,2314,93,0,190,0,6
89995,2,2411,2626,-215,0,301,0,6
89996,2,2426,2415,11,0,474,0,6
89997,3,2549,2422,127,0,151,0,6
89998,1,2417,2349,68,0,337,0,6
89999,2,2285,2466,-181,0,35,0,6
90000,2,2328,2459,-131,0,110,0,6
90001,1,2330,2422,-92,0,202,0,6
90002,1,2354,2444,-90,0,40,0,6
90003,3,2519,2567,-48,0,334,0,6
90004,1,2498,2445,53,0,300,1,6
90005,2,2718,2771,-53,0,337,0,6
90006,2,2336,2489,-153,0,45,0,6
90007,1,2486,2367,119,0,122,0,6
90008,2,2303,2437,-134,0,40,0,6
90009,2,2386,2629,-243,0,14,0,6
90010,2,2348,2474,-126,0,128,0,6
90011,1,2428,2213,215,0,107,0,6
90012,1,2416,2321,95,0,240,1,6
90013,3,2472,2371,101,0,140,0,6
90014,1,2463,2266,197,0,201,0,6
90015,2,2421,2223,198,0,313,0,6
90016,2,2390,2420,-30,0,302,0,6
90017,2,2370,2426,-56,0,40,0,6
90018,2,2344,2422,-78,0,103,0,6
90019,1,2239,2401,-162,0,285,0,6
90020,3,2516,2571,-55,0,45,0,6
90021,2,2421,2420,1,0,228,0,6
90022,1,2469,2277,192,0,194,0,6
90023,1,2493,2328,165,0,7,0,6
90024,2,2424,2470,-46,0,100,1,6
90025,1,2426,2340,86,0,80,0,6
90026,2,2363,2446,-83,0,40,0,6
90027,2,2437,2443,-6,0,0,0,6
90028,1,2356,2400,-44,0,112,0,6
90029,1,2423,2463,-40,0,483,0,6
90030,1,2447,2326,121,0,200,0,6
90031,1,2482,2400,82,0,398,0,6
90032,2,2334,2438,-104,0,108,0,6
90033,1,2549,2398,151,0,462,0,6
90034,2,2464,2422,42,0,84,0,6
90035,2,2440,2372,68,0,241,1,6
90036,1,2466,2390,76,0,0,0,8
90037,1,2285,2411,-126,0,215,1,6
90039,2,2410,2329,81,0,170,0,6
90040,1,2632,2278,354,0,140,0,6
90041,1,2348,2450,-102,0,4,0,6
90042,2,2776,2714,62,0,474,0,6
90043,1,2360,2496,-136,0,487,1,6
90044,3,2424,2423,1,0,140,0,6
90045,2,2327,2472,-145,0,121,0,6
90046,1,2478,2344,134,0,337,0,6
90047,3,2402,2441,-39,0,14,0,6
90048,2,2298,2400,-102,0,121,0,6
90049,1,2479,2462,17,0,260,1,6
90050,1,2425,2287,138,0,421,1,6
90051,1,2232,2412,-180,0,110,1,6
90052,2,2341,2482,-141,0,128,0,6
90053,2,2393,2431,-38,0,457,0,6
90054,2,2420,2386,34,0,146,0,6
90055,2,2322,2450,-128,0,31,0,6
90056,1,2336,2431,-95,0,102,1,6
90057,2,2625,2617,8,0,57,0,6
90058,1,2429,2365,64,0,300,0,6
90059,2,2356,2458,-102,0,301,0,6
90060,2,2450,2570,-120,0,45,1,6
90061,2,2430,2282,148,0,483,0,6
90062,2,2279,2457,-178,0,45,0,6
90063,2,2475,2330,145,0,0,0,6
90064,1,2333,2433,-100,0,245,0,6
90065,1,2468,2334,134,0,156,0,6
90066,2,2485,2337,148,0,406,0,6
90067,2,2364,2484,-120,0,46,0,6
90068,1,2278,2470,-192,0,127,0,8
90069,1,2405,2512,-107,0,3,1,6
90070,1,2434,2226,208,0,112,0,6
90071,1,2476,2633,-157,0,474,0,6
90072,2,2304,2410,-106,4,201,0,13
90073,3,2521,2565,-44,0,334,0,6
90074,2,2403,2396,7,0,265,0,6
90075,2,2436,2423,13,0,140,0,6
90076,1,2623,2619,4,0,46,1,6
90077,3,2404,2344,60,0,130,0,6
90078,1,2720,2769,-49,0,380,0,6
90079,1,2371,2422,-51,0,295,0,6
90080,1,2488,2484,4,0,16,0,6
90081,2,2395,2414,-19,0,4,0,6
90082,2,2440,2462,-22,0,311,0,6
90083,2,2416,2429,-13,0,203,0,6
90084,2,2261,2489,-228,0,123,0,6
90085,1,2460,2351,109,0,120,0,6
90086,3,2404,2241,163,0,44,0,6
90087,1,2426,2279,147,0,113,0,6
90088,3,2320,2472,-152,0,408,0,6
90089,1,2436,2378,58,0,50,1,6
90090,1,2546,2521,25,0,148,1,6
90091,1,2454,2319,135,0,200,0,6
90092,3,2574,2446,128,0,100,0,6
90093,1,2434,2281,153,0,142,1,6
90094,1,2345,2477,-132,0,128,0,6
90095,2,2395,2404,-9,0,150,0,6
90096,1,2393,2419,-26,0,244,0,6
90097,1,2423,2343,80,0,337,0,6
90098,1,2558,2378,180,0,133,1,6
90099,2,2346,2467,-121,0,106,0,6
90100,2,2411,2286,125,0,486,0,6
90101,1,2479,2494,-15,0,45,0,6
90102,2,2763,2727,36,0,56,1,6
90103,1,2402,2435,-33,0,133,0,6
90104,2,2324,2466,-142,0,209,0,6
90105,1,2467,2359,108,0,28,1,6
90106,2,2429,2427,2,0,144,0,6
90107,2,2415,2248,167,0,17,0,6
90108,2,2515,2565,-50,0,200,0,6
90109,2,2338,2428,-90,0,107,0,6
90110,1,2613,2629,-16,0,58,0,6
90111,1,2266,2418,-152,0,45,0,6
90112,2,2504,2430,74,0,306,1,6
90113,2,2243,2402,-159,0,110,0,6
90114,1,2408,2458,-50,0,120,0,6
90115,2,2412,2569,-157,0,2,0,6
90116,1,2470,2353,117,0,46,0,6
90117,1,2404,2410,-6,0,0,0,6
90118,2,2303,2401,-98,0,35,0,6
90119,2,2352,2433,-81,0,487,0,6
90120,1,2488,2423,65,0,4,0,6
90121,1,2405,2240,165,0,30,0,6
90122,2,2515,2572,-57,0,341,1,6
90123,1,2441,2376,65,0,308,0,6
90124,1,2432,2334,98,0,80,1,6
90125,2,2299,2437,-138,0,123,0,6
90126,1,2572,2448,124,0,115,0,6
90127,2,2623,2619,4,0,107,0,6
90128,1,2421,2552,-131,0,6,1,6
90129,1,2471,2412,59,0,0,1,6
90130,2,2410,2351,59,0,409,0,6
90131,1,2479,2341,138,0,7,0,6
90132,1,2471,2547,-76,0,28,1,6
90133,1,2428,2456,-28,0,41,1,6
90134,2,2372,2404,-32,0,255,0,6
90135,2,2339,2407,-68,0,229,0,6
90136,2,2570,2578,-8,0,36,1,6
90137,1,2413,2256,157,0,110,0,6
90138,1,2404,2409,-5,0,0,0,6
90139,1,2446,2408,38,0,312,0,6
90140,1,2733,2756,-23,0,415,0,6
90141,1,2291,2400,-109,0,253,0,6
90142,1,2550,2415,135,0,102,0,6
90143,2,2410,2389,21,0,200,0,6
90144,1,2419,2405,14,0,133,1,6
90145,1,2493,2361,132,0,4,1,6
90146,1,2511,2576,-65,0,483,0,6
90147,1,2445,2555,-110,0,301,0,6
90148,1,2419,2435,-16,0,345,1,6
90149,2,2349,2473,-124,0,100,0,6
90150,2,2237,2408,-171,0,110,0,6
90151,2,2300,2414,-114,4,201,0,13
90152,1,2531,2411,120,0,102,0,6
90153,1,2412,2327,85,0,483,0,6
90154,2,2265,2441,-176,0,200,0,6
90155,1,2330,2436,-106,0,2,0,6
90156,1,2451,2483,-32,0,441,1,6
90157,1,2584,2409,175,0,13,0,6
90158,1,2403,2403,0,0,250,0,6
90159,2,2297,2407,-110,0,0,0,6
90160,2,2475,2404,71,0,0,0,6
90161,1,2750,2739,11,0,270,0,6
90162,1,2478,2410,68,0,11,0,6
90163,3,2328,2488,-160,0,15,0,6
90164,2,2334,2480,-146,0,190,1,6
90165,1,2477,2346,131,0,360,0,6
90166,1,2564,2540,24,0,22,0,6
90167,3,2429,2338,91,0,240,0,6
90168,2,2406,2483,-77,0,226,0,6
90169,1,2411,2234,177,0,313,0,6
90170,2,2366,2534,-168,0,8,0,6
90171,2,2400,2390,10,0,115,0,6
90172,3,2424,2496,-72,0,200,0,6
90173,2,2416,2416,0,0,249,0,6
90174,2,2365,2451,-86,0,4,0,6
90175,2,2360,2444,-84,0,106,1,6
90176,2,2429,2422,7,0,337,1,6
90177,2,2406,2546,-140,0,3,0,6
90178,1,2545,2393,152,0,13,1,6
90179,2,2417,2409,8,0,265,0,6
90180,2,2231,2415,-184,0,3,1,6
90181,2,2396,2404,-8,0,150,0,6
90182,1,2734,2756,-22,0,7,0,6
90183,1,2411,2306,105,0,18,0,6
90184,1,2411,2469,-58,0,10,0,6
90185,1,2425,2457,-32,0,414,0,6
90186,1,2302,2415,-113,0,125,0,6
90187,1,2388,2429,-41,0,244,0,6
90188,2,2486,2304,182,0,43,1,6
90189,2,2342,2481,-139,0,128,0,6
90190,1,2472,2449,23,4,334,0,13
90191,2,2349,2484,-135,0,487,0,6
90192,2,2750,2740,10,0,102,0,6
90193,2,2550,2569,-19,0,334,0,6
90194,1,2452,2508,-56,0,301,0,6
90195,1,2456,2361,95,0,109,1,6
90196,2,2488,2401,87,0,10,0,6
90197,2,2272,2401,-129,0,4,0,6
90198,2,2339,2428,-89,0,2,0,6
90199,1,2379,2415,-36,0,108,0,6
90200,2,2495,2426,69,0,8,1,6
90201,2,2335,2487,-152,0,483,0,6
90202,1,2415,2417,-2,0,152,0,6
90203,2,2390,2462,-72,0,4,0,6
90204,2,2336,2448,-112,0,40,0,6
90205,2,2400,2418,-18,0,337,0,6
90206,1,2408,2394,14,0,20,1,6
90207,2,2575,2517,58,0,25,0,6
90208,1,2491,2385,106,0,129,0,6
90209,2,2310,2432,-122,0,194,0,6
90210,2,2356,2460,-104,0,108,1,6
90211,2,2292,2412,-120,0,302,0,6
90212,1,2231,2477,-246,0,110,0,6
90213,2,2452,2481,-29,0,386,1,6
90214,3,2524,2535,-11,0,45,0,6
90215,1,2432,2335,97,0,240,0,6
90216,1,2409,2390,19,0,200,1,6
90217,2,2565,2459,106,0,46,0,6
90218,2,2416,2318,98,0,248,0,6
90219,1,2405,2269,136,0,112,0,6
90220,1,2336,2467,-131,0,100,1,6
90221,1,2539,2477,62,0,40,0,6
90222,3,2358,2437,-79,0,49,0,6
90223,2,2432,2488,-56,0,130,0,6
90224,2,2274,2417,-143,0,405,0,5
90225,1,2625,2403,222,0,330,0,6
90226,2,2308,2418,-110,4,40,0,13
90227,3,2221,2565,-344,0,300,0,6
90228,1,2424,2381,43,0,124,0,6
90229,2,2400,2333,67,0,90,0,6
90230,1,2495,2413,82,0,142,0,6
90231,1,2464,2352,112,0,111,0,6
90232,1,2422,2323,99,0,0,0,6
90233,1,2486,2447,39,0,10,1,6
90234,2,2325,2408,-83,0,300,0,6
90235,3,2408,2391,17,0,106,0,8
90236,2,2265,2409,-144,0,37,0,6
90237,3,2412,2353,59,0,107,0,6
90238,1,2493,2428,65,0,18,0,6
90239,2,2505,2568,-63,0,334,1,6
90240,1,2535,2400,135,0,203,0,6
90241,1,2544,2500,44,0,151,0,6
90242,1,2409,2302,107,0,211,0,6
90243,2,2398,2478,-80,4,0,0,13
90244,2,2351,2537,-186,0,154,0,6
90245,1,2459,2287,172,0,0,0,6
90246,2,2447,2357,90,0,242,0,6
90247,2,2443,2423,20,0,13,1,6
90248,2,2450,2363,87,0,100,0,6
90249,1,2348,2468,-120,0,39,0,6
90250,1,2386,2436,-50,0,386,1,6
90251,3,2387,2548,-161,0,10,0,6
90252,2,2286,2462,-176,0,40,0,6
90253,2,2328,2427,-99,0,106,0,6
90254,1,2412,2280,132,0,123,0,6
90255,2,2441,2383,58,0,244,1,6
90256,2,2396,2538,-142,0,3,0,6
90257,1,2413,2321,92,0,45,0,6
90258,2,2528,2523,5,0,300,0,6
90259,2,2319,2436,-117,0,103,0,6
90260,2,2423,2498,-75,0,106,0,6
90261,2,2442,2491,-49,0,9,1,6
90262,2,2330,2413,-83,0,45,0,6
90263,2,2370,2410,-40,0,57,0,6
90264,2,2544,2483,61,0,112,1,6
90265,1,2495,2368,127,0,230,0,6
90266,1,2461,2356,105,0,128,1,6
90267,2,2281,2411,-130,0,0,0,6
90268,1,2434,2346,88,0,130,0,6
90269,1,2542,2440,102,0,105,0,6
90270,2,2312,2417,-105,0,140,0,6
90271,2,2244,2416,-172,0,120,0,6
90272,1,2412,2261,151,0,312,0,6
90273,2,2573,2549,24,0,22,0,6
90274,1,2393,2509,-116,0,2,0,6
90275,1,2465,2342,123,0,0,1,6
90276,1,2431,2324,107,0,0,1,6
90277,1,2417,2326,91,0,315,0,6
90278,1,2744,2705,39,0,414,0,6
90279,2,2521,2582,-61,0,343,1,6
90280,2,2365,2498,-133,0,485,1,6
90281,1,2430,2365,65,0,110,0,6
90282,1,2529,2522,7,0,103,0,6
90283,2,2429,2421,8,0,302,0,6
90284,2,2555,2567,-12,0,302,0,6
90285,1,2496,2437,59,0,10,1,6
90286,2,2352,2465,-113,0,456,1,6
90287,2,2258,2416,-158,0,30,0,6
90288,1,2400,2398,2,0,101,0,6
90289,2,2517,2534,-17,0,0,0,6
90290,1,2433,2336,97,0,212,0,6
90291,1,2546,2438,108,0,110,1,6
90292,1,2401,2300,101,0,354,1,6
90293,2,2700,2749,-49,0,380,1,6
90294,2,2540,2511,29,0,103,0,6
90295,1,2420,2338,82,0,202,1,6
90296,1,2469,2308,161,0,0,1,6
90297,2,2434,2530,-96,0,458,1,6
90298,1,2423,2274,149,4,120,0,13
90299,2,2280,2405,-125,0,205,0,8
90300,1,2321,2422,-101,0,45,1,6
90302,2,2368,2436,-68,0,61,0,6
90303,2,2320,2436,-116,0,141,0,6
90304,1,2573,2550,23,0,22,0,6
90305,2,2427,2364,63,0,4,0,6
90306,1,2546,2393,153,0,13,0,6
90307,2,2437,2423,14,0,112,0,6
90308,1,2502,2437,65,0,142,1,6
90309,1,2423,2429,-6,0,310,1,6
90310,2,2469,2348,121,0,470,0,6
90311,2,2432,2501,-69,0,310,0,6
90312,2,2416,2383,33,0,241,1,6
90313,1,2518,2578,-60,0,300,0,6
90314,2,2331,2438,-107,0,463,0,6
90315,2,2348,2414,-66,0,211,0,6
90316,2,2371,2420,-49,0,315,0,6
90317,2,2253,2571,-318,0,194,0,6
90318,1,2754,2695,59,0,110,0,6
90319,1,2466,2264,202,0,202,0,6
90320,1,2428,2550,-122,0,35,0,6
90321,1,2392,2421,-29,0,7,0,6
90322,1,2419,2255,164,0,311,0,6
90323,2,2440,2297,143,0,101,0,6
90324,2,2518,2586,-68,0,343,0,6
90325,2,2409,2250,159,0,48,0,8
90326,1,2414,2329,85,0,315,0,6
90327,1,2430,2338,92,0,455,0,6
90328,1,2440,2316,124,0,1,0,6
90329,2,2429,2507,-78,0,461,0,6
90330,1,2429,2298,131,0,45,0,6
90331,1,2356,2461,-105,0,4,0,6
90332,1,2423,2428,-5,0,40,1,6
90333,2,2285,2434,-149,0,141,0,6
90334,1,2571,2555,16,0,13,0,6
90335,2,2390,2402,-12,0,45,0,6
90336,2,2419,2429,-10,0,263,1,6
90337,2,2359,2431,-72,0,308,0,6
90338,2,2691,2759,-68,0,386,0,6
90339,2,2425,2366,59,0,15,0,6
90340,2,2406,2351,55,0,346,0,6
90341,2,2577,2524,53,0,22,0,6
90342,1,2591,2513,78,0,46,0,6
90343,1,2550,2419,131,0,327,0,6
90344,1,2409,2234,175,0,131,0,6
90345,1,2511,2395,116,0,147,1,6
90346,2,2415,2425,-10,0,15,0,6
90347,2,2324,2419,-95,0,43,0,6
90348,1,2415,2436,-21,0,277,1,6
90349,1,2454,2363,91,0,102,1,6
90350,1,2408,2259,149,0,386,0,6
90351,2,2553,2384,169,0,477,0,6
90352,1,2355,2472,-117,0,41,0,6
90353,1,2350,2436,-86,0,301,1,6
90354,1,2373,2419,-46,0,57,0,6
90355,1,2422,2509,-87,0,40,0,6
90356,2,2509,2595,-86,0,343,0,6
90357,1,2398,2438,-40,0,5,1,6
90358,1,2549,2433,116,0,8,0,6
90359,2,2252,2422,-170,0,4,0,6
90360,1,2764,2686,78,0,380,0,6
90361,1,2570,2552,18,0,335,1,6
90362,2,2355,2426,-71,4,200,1,13
90363,2,2423,2320,103,0,113,1,6
90365,2,2401,2374,27,0,302,0,8
90366,2,2401,2403,-2,0,46,0,6
90367,2,2311,2500,-189,0,2,1,6
90368,3,2393,2414,-21,0,45,0,6
90369,1,2430,2545,-115,0,46,0,6
90370,2,2359,2458,-99,0,4,0,6
90371,1,2600,2504,96,0,46,0,6
90372,2,2501,2429,72,0,40,0,6
90373,1,2409,2515,-106,0,15,0,6
90374,1,2465,2257,208,0,11,0,6
90375,2,2217,2541,-324,0,154,1,6
90376,1,2554,2270,284,0,115,0,6
90377,2,2249,2587,-338,0,114,1,6
90378,1,2625,2300,325,0,132,1,6
90379,3,2430,2305,125,0,15,0,6
90380,2,2564,2557,7,0,15,0,6
90381,1,2465,2362,103,0,0,0,6
90382,2,2429,2577,-148,0,153,1,6
90383,2,2294,2493,-199,0,33,0,6
90384,2,2682,2768,-86,0,111,0,6
90385,1,2416,2397,19,0,65,0,6
90386,2,2432,2282,150,0,34,0,6
90387,1,2538,2508,30,0,70,0,6
90388,1,2436,2355,81,0,170,1,6
90389,1,2643,2576,67,0,334,0,6
90390,1,2438,2428,10,0,312,1,6
90391,1,2425,2248,177,0,260,1,6
90392,1,2335,2415,-80,0,40,0,6
90393,1,2391,2421,-30,0,205,1,6
90394,2,2500,2604,-104,0,352,0,6
90395,1,2563,2559,4,0,4,0,6
90396,1,2773,2677,96,0,386,0,6
90397,1,2534,2543,-9,0,277,1,6
90398,1,2428,2469,-41,0,10,1,6
90399,2,2384,2445,-61,0,335,0,6
90400,1,2413,2419,-6,0,241,0,6
90401,1,2580,2571,9,0,200,0,6
90402,1,2475,2627,-152,0,6,0,6
90403,2,2244,2458,-214,0,40,0,6
90404,1,2544,2436,108,0,207,1,6
90405,2,2332,2467,-135,0,142,0,6
90406,3,2360,2556,-196,0,46,0,6
90407,2,2588,2438,150,0,311,0,6
90408,1,2425,2368,57,0,130,0,6
90409,2,2412,2553,-141,0,5,0,6
90410,2,2424,2501,-77,0,107,0,6
90411,2,2397,2446,-49,0,135,0,6
90412,1,2290,2462,-172,0,130,1,6
90414,1,2441,2387,54,0,1,0,6
90415,1,2415,2444,-29,0,53,1,6
90416,1,2608,2496,112,0,43,1,6
90417,2,2398,2569,-171,0,102,0,6
90418,1,2673,2777,-104,0,112,0,6
90419,2,2586,2553,33,0,115,1,6
90420,2,2245,2428,-183,0,37,0,6
90421,3,2352,2463,-111,0,41,0,6
90422,1,2450,2312,138,0,335,0,6
90423,1,2403,2244,159,0,354,0,6
90424,2,2537,2540,-3,0,101,0,6
90425,2,2411,2364,47,0,43,0,6
90426,1,2413,2430,-17,0,150,0,6
90427,1,2619,2432,187,0,201,0,6
90428,1,2405,2580,-175,0,118,1,6
90429,2,2446,2483,-37,0,4,0,6
90430,1,2553,2387,166,0,101,0,6
90431,2,2291,2464,-173,0,218,1,6
90432,1,2471,2552,-81,0,15,1,6
90433,2,2313,2492,-179,0,4,0,6
90434,1,2431,2350,81,4,120,1,13
90435,1,2279,2434,-155,0,40,1,6
90436,1,2376,2446,-70,0,4,1,6
90437,1,2488,2352,136,0,46,0,6
90438,2,2429,2271,158,0,45,1,6
90439,2,2391,2419,-28,0,13,0,6
90440,2,2318,2421,-103,0,140,0,6
90441,1,2432,2358,74,0,466,0,6
90442,1,2454,2438,16,0,335,0,6
90443,1,2612,2572,40,0,373,0,6
90444,3,2395,2451,-56,0,106,0,6
90445,2,2559,2580,-21,0,15,0,6
90446,2,2473,2317,156,0,113,0,6
90447,1,2545,2531,14,0,253,1,6
90448,2,2493,2409,84,0,365,0,6
90449,1,2424,2419,5,0,236,0,6
90450,1,2461,2354,107,0,0,0,6
90451,2,2405,2264,141,0,405,1,6
90452,2,2376,2495,-119,0,301,0,6
90453,2,2426,2310,116,0,418,1,6
90454,1,2569,2466,103,0,100,0,6
90455,2,2246,2441,-195,0,317,0,6
90456,2,2539,2622,-83,0,112,0,6
90457,1,2442,2307,135,0,7,0,6
90458,2,2299,2414,-115,0,200,0,6
90459,2,2488,2556,-68,0,6,0,6
90460,1,2471,2478,-7,0,140,0,6
90461,1,2465,2428,37,0,0,1,6
90462,1,2407,2307,100,4,301,0,13
90463,1,2426,2439,-13,0,18,0,6
90464,1,2320,2465,-145,0,100,0,6
90465,3,2490,2434,56,0,4,0,6
90466,1,2392,2502,-110,0,36,0,6
90467,2,2585,2424,161,0,118,0,6
90468,1,2557,2406,151,0,462,0,6
90469,3,2435,2359,76,0,37,0,6
90470,2,2389,2561,-172,0,306,0,6
90471,1,2492,2381,111,0,440,0,6
90472,2,2437,2526,-89,0,157,0,6
90473,2,2457,2432,25,0,201,0,6
90474,1,2286,2431,-145,0,445,0,6
90475,2,2567,2617,-50,0,7,0,6
90476,1,2413,2430,-17,0,175,1,6
90477,2,2450,2318,132,0,386,0,6
90478,2,2400,2527,-127,0,328,0,6
90479,2,2421,2276,145,0,40,0,6
90480,3,2531,2526,5,0,301,0,6
90481,1,2487,2397,90,0,30,0,6
90482,1,2499,2372,127,0,41,0,6
90483,1,2424,2325,99,0,217,0,6
90484,2,2419,2292,127,0,57,0,6
90485,2,2481,2385,96,0,106,0,6
90486,1,2333,2433,-100,0,301,0,6
90487,2,2360,2442,-82,0,102,0,6
90488,2,2554,2573,-19,0,15,1,6
90489,1,2530,2355,175,0,300,0,6
90490,2,2433,2432,1,0,404,1,6
90491,2,2432,2577,-145,0,18,0,6
90492,2,2526,2531,-5,0,103,1,6
90493,1,2495,2384,111,0,80,0,6
90494,2,2416,2413,3,0,8,0,6
90495,2,2374,2435,-61,0,263,0,6
90496,2,2438,2490,-52,0,49,0,6
90497,2,2531,2446,85,0,100,1,6
90498,1,2561,2483,78,0,205,0,6
90499,1,2626,2359,267,0,101,0,6
90500,1,2295,2418,-123,0,218,0,6
90501,1,2443,2337,106,0,6,0,6
90502,3,2472,2484,-12,0,10,0,6
90503,1,2496,2401,95,0,335,0,6
90504,2,2227,2443,-216,0,40,0,6
90505,1,2680,2622,58,0,330,0,6
90506,2,2424,2419,5,0,140,1,6
90507,1,2245,2433,-188,0,125,1,6
90508,2,2263,2564,-301,0,6,0,6
90509,1,2531,2458,73,0,45,0,6
90510,2,2368,2503,-135,0,301,0,6
90511,2,2321,2411,-90,0,70,0,6
90512,3,2446,2356,90,0,8,0,6
90513,1,2581,2429,152,0,111,1,6
90514,2,2258,2533,-275,0,122,0,6
90515,1,2472,2341,131,0,4,0,6
90516,1,2403,2396,7,0,419,1,6
90517,1,2422,2560,-138,0,40,0,6
90518,1,2437,2427,10,0,36,1,6
90519,2,2462,2579,-117,0,45,0,6
90520,1,2495,2457,38,0,106,0,6
90521,2,2409,2433,-24,0,241,0,6
90522,2,2384,2402,-18,0,268,1,6
90523,1,2617,2685,-68,0,49,0,6
90524,1,2476,2321,155,0,4,0,6
90525,2,2215,2501,-286,0,205,1,6
90526,2,2384,2484,-100,0,106,0,6
90527,2,2249,2419,-170,0,115,0,6
90528,2,2453,2254,199,0,142,1,6
90529,1,2507,2365,142,0,41,0,6
90530,1,2567,2295,272,0,245,0,6
90531,1,2415,2366,49,0,468,1,6
90532,2,2357,2445,-88,0,11,0,6
90533,2,2436,2365,71,4,242,1,13
90534,2,2445,2520,-75,0,386,0,6
90535,1,2474,2628,-154,0,152,1,6
90536,2,2410,2473,-63,0,125,0,6
90537,2,2224,2453,-229,0,100,0,6
90538,1,2484,2303,181,0,12,0,6
90539,3,2448,2565,-117,0,6,0,6
90540,1,2439,2451,-12,0,302,1,6
90541,2,2443,2320,123,0,45,1,6
90542,1,2425,2584,-159,0,23,0,6
90543,3,2273,2536,-263,0,320,0,6
90544,1,2500,2338,162,0,201,0,6
90545,1,2583,2459,124,0,100,0,6
90546,1,2679,2624,55,0,10,0,6
90547,1,2402,2425,-23,0,48,0,8
90548,1,2488,2408,80,0,11,0,6
90549,1,2479,2442,37,0,6,0,6
90550,1,2390,2409,-19,0,254,0,6
90551,1,2422,2443,-21,0,140,1,6
90552,1,2424,2212,212,0,264,0,6
90553,2,2668,2537,131,0,104,0,6
90554,1,2489,2312,177,0,43,0,6
90555,2,2330,2569,-239,0,21,0,6
90556,2,2349,2459,-110,0,110,0,6
90557,1,2431,2470,-39,0,131,0,6
90558,1,2576,2598,-22,0,190,0,6
90559,2,2434,2361,73,0,10,0,6
90560,2,2449,2353,96,0,15,1,6
90561,2,2314,2500,-186,0,200,0,6
90562,1,2491,2375,116,0,315,0,6
90563,3,2399,2420,-21,0,203,0,6
90564,3,2425,2429,-4,0,123,0,6
90565,1,2525,2441,84,0,106,0,6
90566,2,2327,2436,-109,0,101,0,6
90567,2,2256,2536,-280,0,150,1,6
90568,2,2300,2620,-320,0,118,1,6
90569,2,2491,2487,4,0,253,0,6
90570,1,2564,2477,87,0,141,0,6
90571,3,2455,2449,6,0,8,0,6
90572,2,2255,2422,-167,0,113,0,6
90573,1,2403,2294,109,0,10,0,6
90574,3,2587,2445,142,0,119,0,6
90575,1,2494,2294,200,0,414,0,6
90576,1,2437,2321,116,0,331,1,6
90577,1,2484,2245,239,0,201,0,6
90578,3,2373,2533,-160,0,110,0,6
90579,2,2463,2345,118,0,50,0,6
90580,2,2455,2582,-127,0,45,0,6
90581,2,2437,2428,9,0,96,1,6
90582,2,2389,2515,-126,0,380,0,6
90583,2,2404,2495,-91,0,106,0,6
90584,2,2545,2659,-114,0,45,0,6
90585,2,2428,2392,36,0,262,0,6
90586,2,2331,2412,-81,4,404,0,13
90587,2,2296,2420,-124,0,184,0,6
90588,3,2420,2392,28,0,468,0,6
90589,1,2292,2400,-108,0,41,1,6
90590,1,2447,2229,218,0,100,1,6
90591,1,2470,2304,166,0,4,0,6
90592,1,2368,2470,-102,0,40,1,6
90593,2,2250,2427,-177,0,2,1,6
90594,1,2460,2437,23,0,440,0,6
90595,1,2360,2442,-82,0,226,0,6
90596,2,2334,2552,-218,0,202,0,6
90597,2,2450,2343,107,0,40,1,6
90598,1,2398,2440,-42,0,470,1,6
90599,1,2436,2228,208,0,57,0,6
90600,1,2427,2220,207,0,187,0,6
90601,1,2487,2285,202,0,4,0,6
90602,2,2423,2529,-106,0,250,0,6
90603,3,2448,2333,115,0,263,0,6
90604,1,2286,2496,-210,0,15,0,6
90605,1,2403,2396,7,0,419,1,6
90606,1,2538,2349,189,0,300,0,6
90607,1,2585,2420,165,0,216,0,6
90608,1,2664,2541,123,0,102,0,6
90609,2,2353,2456,-103,0,112,0,6
90610,1,2560,2473,87,0,140,1,6
90611,2,2408,2419,-11,0,302,0,8
90612,1,2473,2255,218,0,380,0,6
90613,3,2450,2480,-30,0,4,0,6
90614,1,2493,2455,38,0,4,1,6
90615,1,2622,2568,54,0,138,0,6
90616,1,2586,2451,135,0,100,1,6
90617,1,2441,2490,-49,0,40,0,6
90618,2,2206,2443,-237,0,127,0,6
90619,2,2302,2425,-123,0,13,0,6
90620,1,2447,2424,23,0,46,0,6
90621,2,2288,2447,-159,0,249,0,6
90622,1,2434,2364,70,0,1,0,6
90623,1,2408,2283,125,0,10,0,6
90624,2,2533,2419,114,0,108,1,6
90625,2,2537,2668,-131,0,0,0,6
90626,2,2393,2405,-12,0,245,0,6
90627,1,2229,2400,-171,0,338,1,6
90628,1,2430,2337,93,0,36,0,6
90629,1,2366,2427,-61,0,335,0,6
90630,2,2435,2367,68,0,4,0,6
90631,2,2422,2473,-51,0,45,1,6
90632,1,2421,2293,128,0,463,0,5
90633,2,2213,2458,-245,0,48,0,6
90634,1,2376,2402,-26,0,301,0,6
90635,2,2249,2449,-200,0,463,0,6
90636,1,2495,2214,281,0,456,0,6
90637,1,2338,2439,-101,0,106,0,6
90638,1,2434,2405,29,0,460,1,6
90639,2,2210,2487,-277,0,112,0,6
90640,1,2503,2294,209,0,40,1,6
90641,2,2420,2378,42,0,107,1,6
90642,2,2262,2446,-184,0,110,0,6
90643,2,2292,2433,-141,0,101,0,6
90644,2,2460,2499,-39,0,106,0,6
90645,2,2386,2447,-61,0,255,0,6
90646,2,2452,2416,36,0,40,1,6
90647,1,2418,2273,145,0,4,0,6
90648,2,2205,2402,-197,0,304,1,8
90649,1,2429,2299,130,0,45,1,6
90650,2,2408,2588,-180,0,200,1,6
90651,1,2499,2237,262,0,335,0,6
90652,1,2531,2366,165,0,300,0,6
90654,1,2425,2377,48,0,454,1,8
90655,1,2351,2428,-77,0,0,1,6
90656,1,2437,2288,149,0,90,0,6
90657,1,2485,2309,176,0,4,0,6
90658,1,2452,2205,247,0,43,1,6
90659,1,2391,2408,-17,0,254,0,6
90660,1,2463,2307,156,0,0,1,6
90661,1,2312,2411,-99,0,336,1,6
90662,1,2589,2439,150,0,200,1,6
90663,1,2414,2237,177,0,36,0,6
90664,3,2374,2428,-54,0,302,0,6
90665,2,2417,2321,96,4,123,0,13
90666,1,2422,2320,102,0,140,0,6
90667,1,2526,2544,-18,0,104,0,6
90668,2,2427,2432,-5,0,106,0,6
90669,3,2560,2375,185,0,13,0,6
90670,2,2452,2534,-82,0,110,1,6
90671,1,2449,2387,62,0,244,0,6
90672,2,2400,2382,18,0,4,0,6
90673,2,2368,2439,-71,0,112,0,6
90674,2,2542,2436,106,0,45,0,6
90675,2,2415,2301,114,0,124,0,6
90676,1,2501,2356,145,0,476,0,6
90677,1,2551,2603,-52,0,112,0,6
90678,1,2323,2458,-135,0,123,0,6
90679,2,2393,2455,-62,0,380,1,6
90680,2,2320,2454,-134,0,255,0,6
90681,1,2532,2446,86,0,110,1,6
90682,1,2454,2352,102,0,123,0,6
90683,2,2329,2488,-159,0,40,0,6
90684,1,2478,2200,278,0,300,0,6
90685,2,2535,2669,-134,0,228,0,6
90686,1,2459,2409,50,0,125,0,6
90687,2,2317,2405,-88,0,343,0,8
90688,1,2417,2231,186,0,16,0,6
90689,1,2591,2593,-2,0,156,0,6
90690,3,2435,2364,71,0,278,0,6
90691,1,2273,2407,-134,0,1,0,6
90692,1,2566,2319,247,0,101,1,6
90693,2,2460,2217,243,0,368,0,6
90694,1,2400,2367,33,0,112,0,6
90695,2,2402,2397,5,0,419,0,6
90696,1,2673,2532,141,0,4,0,6
90697,1,2438,2247,191,0,118,0,6
90698,1,2295,2433,-138,0,13,0,6
90699,1,2437,2563,-126,0,441,0,6
90700,2,2288,2482,-194,0,5,0,6
90701,1,2466,2405,61,0,0,1,6
90702,1,2316,2426,-110,0,277,0,6
90703,2,2450,2281,169,0,4,0,6
90704,1,2400,2336,64,0,110,0,6
90705,2,2331,2504,-173,0,0,0,6
90706,1,2448,2264,184,0,207,0,6
90707,3,2372,2430,-58,0,469,0,8
90708,2,2369,2555,-186,0,211,0,6
90709,1,2478,2218,260,0,62,0,6
90710,3,2202,2458,-256,0,255,0,6
90711,1,2400,2418,-18,0,308,0,6
90712,1,2460,2388,72,0,320,0,6
90713,1,2265,2444,-179,0,385,1,6
90714,1,2507,2405,102,0,331,1,6
90715,1,2557,2358,199,0,4,0,6
90716,1,2362,2405,-43,0,229,1,6
90717,1,2304,2442,-138,0,106,1,6
90718,1,2348,2485,-137,0,40,0,6
90719,2,2285,2458,-173,0,454,0,6
90720,1,2324,2434,-110,0,0,1,6
90721,1,2597,2536,61,0,278,1,6
90722,1,2442,2587,-145,0,302,1,6
90723,1,2410,2285,125,0,211,0,6
90724,1,2288,2463,-175,0,110,0,6
90725,1,2270,2533,-263,0,113,0,6
90726,1,2389,2451,-62,0,100,1,6
90727,1,2444,2355,89,0,15,0,6
90728,2,2410,2312,98,0,46,0,8
90729,1,2401,2556,-155,0,107,0,6
90730,1,2425,2451,-26,0,245,0,5
90731,3,2340,2420,-80,0,228,0,6
90732,2,2358,2423,-65,0,245,1,6
90733,2,2528,2677,-149,0,0,0,6
90734,3,2324,2404,-80,0,215,0,6
90735,1,2335,2441,-106,0,394,0,6
90736,2,2568,2231,337,0,210,0,6
90737,2,2389,2404,-15,0,454,0,6
90738,1,2406,2233,173,0,57,1,6
90739,1,2444,2242,202,0,135,0,6
90740,1,2401,2471,-70,0,100,0,6
90741,3,2403,2319,84,0,101,0,6
90742,2,2355,2560,-205,0,0,0,6
90743,2,2403,2397,6,0,205,0,6
90744,2,2368,2456,-88,0,244,0,6
90745,2,2384,2464,-80,0,388,1,6
90746,2,2434,2512,-78,0,4,0,6
90747,2,2401,2225,176,0,207,1,6
90748,2,2281,2414,-133,0,143,0,6
90749,1,2464,2408,56,0,0,1,6
90750,2,2567,2379,188,0,1,1,6
90751,3,2429,2373,56,0,459,0,8
90752,2,2427,2332,95,0,306,1,6
90753,2,2444,2506,-62,0,201,0,6
90754,1,2404,2366,38,0,48,1,6
90755,1,2470,2221,249,0,106,0,6
90756,1,2548,2532,16,0,222,0,6
90757,1,2579,2450,129,0,200,0,6
90758,2,2357,2572,-215,0,28,0,6
90759,2,2458,2375,83,0,133,1,6
90760,1,2434,2409,25,0,150,0,6
90761,3,2478,2358,120,0,29,0,6
90762,1,2524,2311,213,0,45,0,6
90763,1,2409,2374,35,0,190,1,6
90764,1,2680,2525,155,0,100,0,6
90765,1,2460,2310,150,0,426,1,6
90766,1,2428,2409,19,0,403,1,6
90767,3,2402,2360,42,0,123,0,6
90768,1,2286,2474,-188,0,313,0,6
90769,2,2403,2397,6,0,228,0,6
90770,3,2497,2328,169,0,7,0,6
90771,1,2394,2558,-164,0,122,0,6
90772,1,2254,2409,-155,0,106,0,6
90773,3,2364,2516,-152,0,456,0,6
90775,2,2418,2277,141,0,80,1,6
90776,1,2553,2558,-5,0,386,0,6
90777,1,2469,2379,90,0,335,1,6
90778,1,2388,2411,-23,0,300,0,6
90779,1,2526,2583,-57,0,157,0,6
90780,2,2454,2521,-67,0,40,0,6
90781,2,2386,2402,-16,0,200,0,8
90782,1,2212,2536,-324,0,42,0,6
90783,2,2339,2419,-80,0,0,1,6
90784,1,2465,2360,105,0,301,0,6
90785,1,2469,2409,60,0,0,0,6
90786,1,2562,2352,210,0,4,0,6
90787,2,2403,2397,6,0,218,0,6
90788,1,2454,2279,175,0,101,1,6
90789,1,2409,2299,110,0,359,0,6
90790,1,2404,2423,-19,0,40,1,6
90791,1,2325,2428,-103,0,200,0,8
90792,1,2262,2403,-141,0,10,1,6
90793,2,2522,2684,-162,0,296,0,6
90794,2,2451,2397,54,0,242,0,6
90795,1,2422,2230,192,0,100,0,8
90796,2,2404,2414,-10,0,57,1,6
90797,2,2576,2550,26,0,115,0,6
90798,2,2285,2410,-125,0,107,0,6
90799,3,2328,2450,-122,0,110,0,6
90800,3,2437,2533,-96,0,28,0,6
90801,2,2375,2473,-98,0,302,0,6
90802,1,2687,2518,169,0,104,0,6
90803,1,2526,2439,87,0,245,0,6
90804,1,2424,2335,89,0,102,1,6
90805,1,2326,2411,-85,0,106,0,6
90806,1,2417,2403,14,0,468,1,6
90807,1,2330,2414,-84,0,253,0,6
90808,1,2682,2683,-1,0,45,0,6
90809,2,2403,2397,6,0,419,0,6
90810,2,2408,2380,28,0,49,0,8
90811,2,2527,2474,53,0,106,0,6
90812,2,2404,2444,-40,0,101,0,6
90813,2,2515,2690,-175,0,0,1,6
90814,3,2425,2285,140,0,141,0,8
90815,1,2531,2668,-137,0,152,1,6
90816,1,2556,2422,134,0,150,0,6
90817,2,2570,2398,172,0,153,0,6
90819,2,2366,2515,-149,0,46,0,6
90820,2,2331,2428,-97,0,0,1,6
90821,2,2529,2382,147,0,40,0,6
90822,1,2425,2208,217,0,107,0,6
90823,1,2445,2439,6,0,143,1,6
90824,1,2449,2399,50,0,242,0,6
90825,2,2678,2688,-10,0,101,0,6
90826,3,2399,2520,-121,0,110,0,6
90827,1,2405,2226,179,0,56,0,8
90828,1,2407,2282,125,0,80,0,6
90829,2,2481,2562,-81,0,0,0,6
90830,2,2434,2331,103,0,201,0,6
90831,2,2431,2450,-19,0,459,0,6
90832,1,2693,2512,181,0,102,0,6
90833,2,2446,2353,93,0,398,1,6
90834,1,2470,2539,-69,0,248,1,6
90835,1,2386,2402,-16,0,345,0,8
90836,2,2394,2454,-60,0,196,0,6
90837,1,2403,2397,6,0,292,0,6
90838,1,2567,2411,156,0,190,1,6
90839,1,2432,2326,106,0,300,1,6
90840,2,2275,2406,-131,0,226,0,6
90841,1,2401,2246,155,0,278,1,6
90842,1,2376,2476,-100,0,100,1,6
90843,2,2378,2421,-43,0,10,0,6
90844,1,2459,2389,70,0,243,1,6
90845,1,2509,2570,-61,0,300,0,6
90846,1,2407,2381,26,0,491,0,6
90847,2,2358,2472,-114,0,296,1,6
90848,1,2341,2477,-136,0,4,0,6
90849,1,2426,2282,144,0,241,0,6
90850,2,2395,2563,-168,0,302,1,6
90851,2,2322,2437,-115,0,0,1,6
90852,1,2538,2394,144,0,40,0,6
90853,2,2469,2406,63,0,131,0,6
90854,2,2518,2475,43,0,40,0,6
90855,1,2469,2383,86,0,0,1,6
90856,2,2422,2337,85,0,151,0,6
90857,2,2286,2458,-172,0,229,0,6
90858,1,2558,2369,189,0,15,0,6
90859,1,2405,2230,175,0,0,1,6
90860,1,2410,2322,88,0,466,0,6
90861,2,2391,2409,-18,0,267,0,6
90862,1,2385,2464,-79,0,101,0,6
90863,1,2441,2227,214,0,123,0,6
90864,1,2482,2401,81,0,57,0,6
90865,1,2516,2512,4,0,300,0,6
90866,1,2376,2413,-37,0,122,1,6
90867,3,2355,2417,-62,0,21,0,6
90868,1,2311,2463,-152,0,10,0,6
90869,2,2240,2412,-172,0,123,0,6
90870,2,2392,2541,-149,0,4,0,8
90871,2,2436,2451,-15,0,20,1,6
90872,1,2441,2319,122,0,102,1,6
90873,2,2389,2460,-71,0,311,0,6
90874,1,2567,2522,45,0,102,0,6
90875,1,2533,2506,27,0,110,0,6
90876,2,2445,2368,77,0,335,1,6
90877,1,2379,2473,-94,0,101,1,6
90878,2,2408,2359,49,0,142,1,6
90879,2,2205,2672,-467,0,40,0,6
90880,3,2457,2392,65,0,242,0,6
90881,2,2371,2404,-33,0,334,0,6
90882,2,2572,2455,117,0,132,0,6
90883,3,2414,2386,28,0,292,0,6
90884,1,2417,2430,-13,0,265,0,6
90885,2,2361,2402,-41,0,43,0,6
90886,2,2517,2538,-21,0,301,0,6
90887,1,2462,2284,178,0,140,0,6
90888,1,2501,2450,51,0,107,0,6
90889,1,2291,2416,-125,0,112,0,6
90890,1,2420,2271,149,0,112,0,8
90891,3,2406,2382,24,0,491,0,6
90892,2,2299,2430,-131,0,118,1,6
90893,1,2480,2456,24,0,307,0,6
90894,1,2459,2287,172,0,253,0,6
90895,2,2315,2444,-129,0,0,0,6
90896,1,2673,2204,469,0,110,0,6
90897,3,2415,2379,36,0,43,0,6
90898,1,2543,2511,32,0,103,0,6
90899,2,2466,2386,80,0,0,0,6
90900,2,2465,2438,27,0,40,1,6
90901,2,2559,2564,-5,0,0,0,6
90902,1,2462,2336,126,0,110,0,6
90903,2,2297,2462,-165,0,249,1,6
90904,2,2506,2549,-43,0,228,0,6
90905,3,2383,2406,-23,0,122,0,6
90906,2,2393,2456,-63,0,196,0,6
90907,2,2561,2424,137,0,7,0,6
90908,1,2372,2408,-36,0,27,0,6
90909,1,2475,2228,247,4,27,1,11
90910,2,2203,2674,-471,0,40,0,6
90911,2,2455,2553,-98,0,46,0,6
90912,1,2570,2506,64,0,117,1,6
90913,2,2445,2459,-14,0,100,0,6
90914,1,2448,2311,137,0,306,0,6
90915,1,2386,2414,-28,0,265,1,6
90916,1,2434,2356,78,0,335,0,6
90917,2,2299,2414,-115,0,176,0,6
90918,2,2423,2329,94,0,200,0,6
90919,3,2465,2294,171,0,112,0,6
90920,1,2460,2388,72,0,243,1,6
90921,1,2399,2466,-67,0,136,0,6
90922,2,2579,2628,-49,0,41,1,6
90923,3,2554,2501,53,0,103,0,6
90924,1,2675,2203,472,0,330,0,6
90925,2,2268,2424,-156,0,466,0,8
90926,2,2330,2445,-115,0,108,1,6
90927,2,2459,2298,161,0,48,0,6
90928,2,2322,2452,-130,0,110,0,6
90929,1,2485,2403,82,4,110,0,13
90930,2,2402,2385,17,0,125,1,6
90931,1,2406,2383,23,0,491,0,6
90932,1,2331,2451,-120,0,300,0,6
90933,2,2447,2558,-111,0,107,0,6
90934,1,2419,2264,155,0,200,0,6
90935,2,2456,2500,-44,0,410,1,6
90936,2,2486,2318,168,0,127,0,6
90937,2,2501,2321,180,0,300,0,6
90938,2,2202,2675,-473,0,106,1,6
90939,2,2443,2575,-132,0,46,0,6
90940,1,2426,2318,108,0,112,0,6
90941,1,2553,2440,113,0,203,0,6
90942,2,2339,2414,-75,0,13,0,6
90943,1,2418,2290,128,0,301,1,6
90944,2,2562,2502,60,0,0,0,6
90945,1,2297,2463,-166,0,458,1,6
90946,2,2335,2440,-105,0,106,1,6
90947,2,2465,2406,59,0,0,0,6
90948,1,2395,2465,-70,0,302,0,6
90949,3,2633,2574,59,0,405,0,6
90950,1,2343,2427,-84,0,101,0,8
90951,1,2332,2416,-84,0,199,1,6
90952,1,2449,2431,18,0,485,0,6
90953,2,2396,2422,-26,0,125,1,6
90954,1,2433,2362,71,0,13,0,6
90955,2,2422,2252,170,0,259,1,6
90956,1,2443,2533,-90,0,301,1,6
90957,1,2553,2405,148,0,13,0,6
90958,1,2505,2451,54,0,459,1,6
90959,1,2458,2301,157,0,4,1,6
90960,1,2676,2201,475,0,312,0,6
90961,2,2413,2493,-80,0,448,1,6
90962,3,2555,2587,-32,0,80,0,6
90963,1,2509,2557,-48,0,45,0,6
90964,2,2367,2402,-35,0,311,0,6
90965,2,2578,2439,139,0,101,0,6
90966,1,2432,2360,72,0,100,0,6
90967,2,2378,2439,-61,0,200,0,6
90968,1,2477,2389,88,4,10,0,11
90969,3,2444,2458,-14,0,101,0,6
90970,1,2575,2632,-57,0,73,0,6
90971,1,2419,2335,84,0,90,0,6
90972,3,2518,2426,92,0,300,0,6
90973,2,2409,2339,70,0,101,1,6
90974,2,2200,2677,-477,0,130,0,6
90975,2,2526,2451,75,0,56,0,6
90976,1,2446,2497,-51,0,331,0,6
90977,1,2515,2556,-41,0,45,0,6
90978,1,2545,2233,312,0,45,0,6
90979,2,2550,2570,-20,0,127,1,6
90980,2,2266,2420,-154,0,48,0,8
90981,2,2279,2447,-168,0,101,0,6
90982,3,2461,2382,79,0,113,0,6
90983,1,2625,2582,43,0,483,0,6
90984,2,2411,2517,-106,0,241,1,6
90985,1,2444,2301,143,0,190,1,6
90986,1,2418,2220,198,0,113,0,8
90987,1,2491,2452,39,0,300,0,6
90988,1,2458,2298,160,0,134,0,6
90989,1,2451,2316,135,0,40,0,6
90990,2,2431,2393,38,0,245,0,5
90991,1,2458,2519,-61,0,301,0,6
90992,1,2292,2402,-110,0,121,0,6
90993,2,2330,2423,-93,0,8,0,6
90994,1,2575,2549,26,0,241,0,6
90995,2,2586,2557,29,0,40,1,6
90996,2,2447,2496,-49,0,327,1,6
90997,1,2576,2401,175,0,200,0,6
90998,2,2545,2522,23,0,103,1,6
90999,2,2577,2630,-53,0,73,0,6
91000,2,2297,2454,-157,0,315,0,6
91001,2,2384,2402,-18,0,45,1,6
91002,2,2499,2408,91,0,464,0,6
91003,2,2390,2512,-122,0,13,0,6
91004,1,2448,2407,41,0,245,0,6
91005,2,2544,2579,-35,0,46,0,6
91006,1,2427,2326,101,0,312,0,6
91007,2,2461,2325,136,0,109,0,6
91008,2,2399,2425,-26,0,414,0,5
91009,1,2244,2400,-156,0,22,0,6
91010,2,2410,2284,126,0,96,0,6
91011,1,2580,2492,88,0,143,0,6
91012,2,2396,2584,-188,0,306,0,6
91013,1,2416,2539,-123,0,107,0,6
91014,1,2501,2442,59,0,45,0,6
91015,1,2516,2347,169,0,40,0,6
91016,2,2402,2400,2,0,310,1,6
91017,2,2635,2572,63,0,464,1,6
91018,2,2458,2339,119,0,48,1,6
91019,1,2444,2322,122,0,215,0,6
91020,1,2546,2430,116,0,45,1,5
91021,1,2408,2438,-30,0,45,1,6
91022,2,2333,2453,-120,0,317,0,6
91023,1,2587,2394,193,0,115,0,6
91024,1,2428,2343,85,0,192,0,6
91025,2,2344,2519,-175,0,331,0,6
91026,2,2531,2488,43,0,143,0,6
91027,2,2506,2465,41,0,45,0,6
91028,2,2378,2448,-70,0,310,0,6
91029,1,2579,2629,-50,0,40,0,6
91030,1,2382,2502,-120,0,102,0,6
91031,1,2477,2352,125,0,487,1,6
91032,1,2400,2382,18,0,202,0,6
91033,2,2450,2330,120,0,48,0,6
91034,1,2405,2414,-9,0,125,0,6
91035,1,2457,2329,128,0,107,0,6
91036,2,2226,2550,-324,0,13,1,6
91037,2,2590,2615,-25,0,277,0,6
91038,2,2342,2494,-152,0,50,0,6
91039,2,2436,2539,-103,0,414,0,6
91040,2,2471,2500,-29,0,300,1,6
91041,2,2428,2396,32,0,326,1,6
91042,1,2494,2379,115,0,311,0,6
91043,2,2522,2341,181,0,40,0,6
91044,1,2645,2528,117,0,406,0,6
91045,1,2464,2543,-79,0,278,0,6
91046,1,2622,2585,37,0,453,0,6
91047,2,2377,2405,-28,0,41,0,6
91048,2,2390,2443,-53,0,302,0,6
91049,1,2351,2403,-52,0,463,0,6
91050,2,2445,2563,-118,0,201,1,6
91051,2,2282,2461,-179,0,101,0,6
91052,1,2438,2299,139,0,45,0,6
91053,1,2421,2287,134,0,288,1,8
91054,1,2408,2324,84,0,300,0,6
91055,2,2620,2585,35,0,8,0,6
91056,1,2333,2402,-69,0,121,0,6
91057,1,2401,2294,107,0,104,1,6
91058,1,2365,2415,-50,0,127,1,6
91059,3,2505,2466,39,0,45,0,6
91060,2,2349,2514,-165,0,330,0,6
91061,2,2524,2567,-43,0,15,0,6
91062,1,2410,2372,38,0,202,0,6
91063,3,2539,2398,141,0,45,0,6
91064,1,2403,2536,-133,0,414,1,6
91065,1,2472,2380,92,0,107,0,6
91066,1,2432,2366,66,0,406,0,6
91067,1,2580,2627,-47,0,73,0,6
91068,2,2591,2649,-58,0,115,1,6
91069,2,2525,2401,124,0,404,0,6
91070,1,2597,2464,133,0,300,1,6
91071,2,2319,2412,-93,0,130,1,6
91072,2,2347,2424,-77,0,101,0,8
91073,1,2367,2416,-49,0,43,1,6
91074,1,2504,2519,-15,0,45,0,6
91075,1,2363,2411,-48,0,4,1,6
91076,2,2633,2580,53,0,300,0,6
91077,1,2517,2346,171,0,331,0,6
91078,2,2477,2405,72,0,106,1,6
91079,2,2520,2389,131,0,307,0,6
91080,3,2356,2528,-172,0,405,0,6
91081,2,2409,2238,171,0,40,0,6
91082,2,2548,2466,82,0,2,0,6
91083,3,2621,2587,34,0,483,0,6
91084,2,2513,2510,3,0,200,0,6
91085,1,2288,2447,-159,0,315,1,6
91086,2,2361,2437,-76,0,15,0,6
91087,1,2586,2517,69,0,190,0,6
91088,2,2417,2315,102,0,40,0,6
91089,2,2461,2325,136,0,200,1,6
91090,1,2397,2513,-116,0,310,1,6
91091,1,2586,2623,-37,0,40,0,6
91092,2,2379,2426,-47,0,315,0,6
91093,1,2409,2373,36,0,202,0,6
91094,3,2412,2486,-74,0,13,0,6
91095,2,2270,2421,-151,0,25,0,6
91096,2,2428,2371,57,0,106,0,8
91097,2,2567,2582,-15,0,15,0,6
91098,1,2508,2521,-13,0,107,0,6
91099,1,2405,2377,28,0,45,0,6
91100,2,2385,2401,-16,0,43,0,6
91101,2,2368,2414,-46,0,41,0,6
91102,1,2492,2515,-23,0,405,0,6
91103,1,2323,2409,-86,0,130,0,6
91104,1,2587,2620,-33,0,44,1,6
91105,3,2587,2614,-27,0,7,0,6
91106,2,2436,2393,43,0,112,1,6
91107,2,2285,2439,-154,0,0,1,6
91108,2,2442,2327,115,0,82,0,6
91109,1,2297,2413,-116,0,49,0,6
91110,2,2512,2474,38,0,100,0,6
91111,2,2562,2591,-29,0,46,1,6
91112,1,2453,2451,2,0,191,0,6
91113,1,2357,2406,-49,0,90,0,6
91114,2,2340,2515,-175,0,107,1,6
91115,1,2419,2363,56,0,202,0,6
91116,1,2514,2541,-27,0,300,0,6
91117,3,2416,2403,13,0,459,0,6
91118,3,2333,2505,-172,0,331,0,6
91119,2,2401,2366,35,0,112,0,6
91120,2,2596,2501,95,0,260,0,6
91121,2,2487,2498,-11,0,373,0,6
91122,1,2402,2330,72,0,300,1,6
91123,1,2553,2505,48,0,46,1,6
91124,2,2351,2406,-55,0,107,0,6
91125,3,2445,2485,-40,0,205,0,6
91126,1,2552,2397,155,0,45,0,6
91127,1,2425,2273,152,4,306,0,13
91128,3,2358,2424,-66,0,41,0,6
91129,2,2403,2415,-12,0,122,0,6
91130,2,2443,2410,33,0,40,1,6
91131,1,2377,2422,-45,0,4,1,8
91132,1,2548,2587,-39,0,485,0,6
91133,2,2518,2520,-2,0,45,0,6
91134,2,2504,2502,2,0,330,0,6
91135,2,2557,2587,-30,0,5,1,6
91136,2,2256,2459,-203,0,310,1,6
91137,2,2480,2589,-109,0,211,0,6
91138,2,2445,2498,-53,0,455,0,6
91139,2,2358,2441,-83,0,4,1,6
91140,3,2508,2535,-27,0,302,0,6
91141,2,2394,2555,-161,0,212,0,6
91142,2,2300,2481,-181,0,302,0,6
91143,2,2407,2409,-2,0,45,1,6
91144,2,2395,2435,-40,0,214,0,6
91145,1,2394,2430,-36,0,43,0,6
91146,1,2411,2499,-88,0,213,0,6
91147,1,2423,2360,63,0,202,1,6
91148,1,2358,2404,-46,0,90,0,6
91149,1,2404,2393,11,0,4,0,6
91150,1,2400,2290,110,0,305,0,8
91151,1,2513,2548,-35,0,45,0,6
91152,1,2417,2437,-20,0,101,0,6
91153,1,2412,2380,32,0,4,1,6
91154,2,2317,2441,-124,0,45,0,6
91155,2,2593,2551,42,0,3,0,6
91156,2,2526,2503,23,0,45,0,6
91157,2,2358,2401,-43,0,4,0,6
91158,2,2476,2593,-117,0,300,0,6
91159,1,2509,2440,69,0,484,1,6
91160,2,2234,2402,-168,0,153,0,6
91161,1,2581,2555,26,0,103,0,6
91162,1,2280,2461,-181,0,101,0,6
91163,2,2492,2654,-162,0,112,0,6
91164,2,2390,2418,-28,0,107,0,6
91165,2,2535,2603,-68,0,3,1,6
91166,1,2302,2421,-119,0,134,0,6
91167,2,2453,2573,-120,0,258,0,6
91168,2,2216,2401,-185,0,268,1,6
91169,2,2409,2327,82,0,55,1,6
91170,2,2388,2451,-63,0,107,1,6
91171,1,2678,2544,134,0,123,0,6
91172,1,2519,2365,154,0,45,1,6
91173,2,2355,2428,-73,0,41,0,6
91174,1,2403,2327,76,0,121,0,6
91175,1,2431,2361,70,0,302,0,6
91176,3,2407,2418,-11,0,106,0,6
91177,1,2614,2541,73,0,0,0,6
91178,1,2445,2313,132,0,53,0,6
91179,1,2445,2370,75,0,40,0,6
91180,1,2424,2382,42,0,40,0,6
91181,3,2488,2406,82,0,132,0,6
91182,2,2275,2485,-210,0,246,0,6
91183,2,2597,2520,77,0,102,0,6
91184,1,2507,2472,35,0,16,0,6
91185,2,2509,2336,173,0,466,0,6
91186,1,2576,2530,46,0,13,1,6
91187,2,2449,2513,-64,0,258,1,6
91188,1,2414,2415,-1,0,31,0,6
91189,2,2294,2473,-179,0,310,0,6
91190,2,2537,2618,-81,0,107,1,6
91191,1,2541,2682,-141,0,145,0,6
91192,1,2623,2608,15,0,373,0,6
91193,1,2486,2384,102,0,4,1,6
91194,2,2467,2512,-45,0,45,0,6
91195,1,2432,2350,82,0,202,0,6
91196,2,2449,2365,84,0,40,0,6
91197,1,2627,2435,192,0,101,0,6
91198,2,2452,2407,45,0,10,0,6
91199,1,2600,2404,196,0,245,1,6
91200,2,2346,2437,-91,0,41,1,6
91201,2,2423,2287,136,0,405,1,6
91202,1,2603,2590,13,0,335,0,6
91203,2,2441,2444,-3,0,123,0,6
91204,1,2432,2299,133,0,302,0,6
91205,2,2400,2487,-87,0,61,0,6
91206,1,2413,2408,5,0,394,0,6
91207,3,2517,2462,55,0,56,0,6
91208,2,2400,2363,37,0,112,1,6
91209,1,2674,2549,125,0,123,0,6
91210,1,2419,2321,98,0,80,0,6
91211,2,2419,2293,126,0,45,1,6
91212,1,2402,2314,88,0,43,1,6
91213,3,2671,2525,146,0,102,0,6
91214,1,2343,2518,-175,0,13,1,6
91215,1,2438,2348,90,0,199,0,6
91216,1,2436,2396,40,0,48,0,6
91217,1,2304,2446,-142,0,332,1,6
91218,2,2414,2435,-21,0,109,0,6
91219,1,2317,2424,-107,0,131,0,6
91220,2,2463,2511,-48,0,301,0,6
91221,2,2324,2442,-118,0,102,0,6
91222,3,2266,2441,-175,0,101,0,6
91223,1,2491,2538,-47,0,167,0,6
91224,1,2469,2391,78,0,111,0,6
91225,2,2407,2312,95,0,45,0,6
91226,2,2331,2516,-185,0,190,1,6
91227,2,2510,2450,60,0,343,0,6
91228,1,2373,2446,-73,0,313,0,6
91229,1,2291,2441,-150,0,404,0,6
91230,1,2449,2409,40,0,56,1,6
91231,2,2416,2325,91,0,80,0,6
91232,1,2455,2498,-43,0,152,1,6
91233,1,2404,2272,132,4,267,0,13
91234,1,2323,2411,-88,0,45,0,6
91235,2,2353,2439,-86,0,300,0,6
91236,1,2559,2282,277,0,118,1,6
91237,2,2503,2543,-40,0,344,0,6
91238,1,2489,2336,153,0,214,0,6
91239,1,2439,2443,-4,0,314,0,6
91240,2,2368,2492,-124,0,45,0,6
91241,2,2381,2441,-60,0,411,0,6
91242,1,2332,2409,-77,0,42,0,6
91243,2,2440,2315,125,0,136,0,6
91244,2,2409,2461,-52,0,256,1,6
91245,2,2315,2433,-118,0,190,0,6
91246,2,2577,2668,-91,0,101,0,6
91247,1,2484,2333,151,0,57,0,6
91248,3,2565,2558,7,0,351,0,6
91249,1,2352,2498,-146,0,330,0,6
91250,2,2549,2518,31,0,373,1,6
91251,2,2419,2464,-45,0,263,1,6
91252,2,2437,2353,84,0,40,0,6
91253,1,2445,2492,-47,0,404,0,6
91254,1,2673,2573,100,0,122,0,6
91255,1,2386,2414,-28,0,43,0,6
91256,1,2519,2354,165,0,414,1,6
91257,1,2437,2311,126,0,101,1,6
91258,1,2446,2376,70,0,127,0,6
91259,1,2466,2558,-92,0,145,0,6
91261,2,2496,2343,153,0,117,0,6
91262,1,2456,2402,54,0,6,0,6
91263,2,2428,2432,-4,0,300,1,6
91264,2,2239,2404,-165,0,400,0,6
91265,3,2490,2360,130,0,50,0,6
91266,1,2257,2434,-177,0,112,0,6
91267,1,2561,2259,302,0,144,1,6
91268,2,2327,2494,-167,0,45,0,6
91269,1,2677,2545,132,0,122,1,6
91270,2,2474,2455,19,0,123,0,6
91271,2,2400,2355,45,0,140,0,6
91272,1,2417,2473,-56,0,459,0,6
91273,2,2469,2551,-82,0,335,0,6
91274,1,2296,2430,-134,0,310,1,6
91275,2,2485,2542,-57,0,112,1,6
91276,2,2355,2438,-83,0,315,0,6
91277,1,2432,2386,46,0,118,0,6
91278,1,2525,2451,74,0,46,0,6
91279,2,2371,2440,-69,0,373,0,6
91280,1,2424,2308,116,0,300,0,6
91281,1,2488,2523,-35,0,187,0,6
91282,2,2432,2367,65,0,15,0,6
91283,1,2433,2385,48,0,123,1,6
91284,2,2408,2383,25,0,190,0,6
91285,1,2497,2238,259,0,107,1,6
91286,2,2362,2488,-126,0,330,0,6
91287,2,2404,2425,-21,0,150,1,6
91288,1,2555,2465,90,0,311,1,6
91289,2,2284,2563,-279,0,42,0,6
91290,1,2447,2345,102,0,313,1,6
91291,2,2437,2338,99,0,184,0,6
91292,2,2569,2529,40,0,338,0,6
91293,2,2381,2438,-57,0,380,0,6
91294,2,2339,2480,-141,0,152,0,6
91295,2,2484,2547,-63,0,320,0,6
91296,1,2532,2428,104,0,456,0,6
91297,1,2467,2304,163,0,101,0,6
91298,1,2422,2329,93,0,48,1,6
91299,1,2514,2372,142,0,6,0,6
91300,2,2516,2494,22,0,110,1,6
91301,1,2403,2356,47,0,406,0,6
91302,2,2461,2507,-46,0,6,0,6
91303,1,2541,2430,111,0,136,0,6
91304,1,2461,2517,-56,0,41,0,6
91305,2,2438,2292,146,0,217,1,6
91306,2,2400,2360,40,0,453,1,6
91307,1,2278,2425,-147,0,107,0,6
91308,1,2401,2216,185,0,11,0,6
91309,1,2425,2250,175,0,40,1,6
91310,2,2451,2351,100,0,453,0,6
91311,3,2426,2368,58,0,107,0,6
91312,1,2470,2358,112,0,201,1,6
91313,2,2351,2492,-141,0,345,0,6
91314,1,2460,2335,125,0,85,0,6
91315,2,2484,2417,67,0,107,1,6
91316,1,2315,2500,-185,0,247,0,6
91317,1,2552,2537,15,0,373,0,6
91318,1,2560,2562,-2,0,15,0,6
91319,2,2562,2536,26,0,13,0,6
91320,2,2358,2427,-69,0,302,0,6
91321,2,2262,2409,-147,0,112,1,6
91322,2,2363,2511,-148,0,143,0,6
91323,2,2326,2444,-118,0,102,1,6
91324,2,2418,2456,-38,0,345,0,6
91325,3,2380,2545,-165,0,49,0,6
91326,2,2332,2464,-132,0,255,0,6
91327,1,2556,2537,19,0,21,0,6
91328,2,2530,2558,-28,0,132,1,6
91329,1,2402,2316,86,0,143,0,6
91330,2,2450,2623,-173,0,100,0,6
91331,2,2352,2425,-73,0,0,0,6
91332,2,2406,2374,32,0,193,0,6
91333,2,2409,2474,-65,0,265,1,6
91334,1,2496,2348,148,0,407,0,6
91335,3,2261,2409,-148,0,111,0,6
91336,2,2281,2431,-150,0,122,0,6
91337,1,2400,2400,0,0,316,0,6
91338,2,2477,2400,77,0,101,0,6
91339,1,2510,2436,74,0,122,1,6
91340,1,2607,2557,50,0,125,0,6
91341,3,2476,2272,204,0,112,0,6
91342,3,2414,2326,88,0,107,0,6
91343,1,2514,2423,91,0,123,0,6
91344,2,2431,2293,138,0,40,0,6
91345,2,2501,2527,-26,0,104,0,6
91346,2,2287,2413,-126,0,103,0,6
91347,1,2467,2354,113,0,490,0,6
91348,1,2391,2430,-39,0,174,0,6
91349,1,2542,2448,94,0,343,0,6
91350,1,2344,2499,-155,0,345,0,6
91351,1,2468,2328,140,0,113,1,6
91352,1,2430,2461,-31,0,300,0,6
91353,1,2563,2524,39,0,373,0,6
91354,1,2304,2424,-120,0,201,0,6
91355,2,2519,2518,1,0,103,0,6
91356,2,2531,2543,-12,0,120,0,6
91357,1,2382,2447,-65,0,435,0,6
91358,2,2407,2413,-6,0,138,1,6
91359,1,2230,2473,-243,0,50,0,6
91360,2,2444,2279,165,0,202,1,5
91361,2,2552,2543,9,0,311,1,6
91362,2,2479,2404,75,0,151,0,6
91363,1,2314,2424,-110,0,101,0,6
91364,1,2417,2355,62,0,41,0,6
91365,1,2413,2357,56,0,111,0,6
91366,2,2365,2470,-105,0,192,0,6
91367,2,2565,2430,135,0,13,1,6
91368,1,2303,2405,-102,0,45,1,6
91369,2,2373,2515,-142,0,45,0,6
91370,2,2495,2626,-131,0,106,0,6
91371,2,2283,2422,-139,0,120,0,6
91372,3,2357,2443,-86,0,102,0,6
91373,1,2393,2467,-74,0,112,0,6
91374,2,2532,2546,-14,0,45,0,6
91375,1,2319,2494,-175,0,267,1,6
91376,1,2491,2325,166,0,356,1,6
91377,2,2279,2417,-138,0,303,0,6
91378,1,2352,2418,-66,0,115,0,6
91379,1,2518,2568,-50,0,131,1,6
91380,2,2280,2417,-137,0,112,1,8
91381,2,2441,2513,-72,0,241,1,6
91382,2,2411,2471,-60,0,263,0,6
91383,1,2442,2279,163,0,330,0,6
91384,1,2325,2426,-101,0,142,1,6
91385,1,2400,2418,-18,0,10,0,6
91386,2,2401,2215,186,0,15,1,6
91387,1,2405,2375,30,0,246,0,6
91388,2,2501,2603,-102,0,101,0,6
91389,1,2416,2350,66,0,41,0,6
91390,1,2604,2455,149,4,242,0,13
91391,2,2321,2471,-150,0,193,0,6
91392,2,2233,2464,-231,0,404,0,6
91394,2,2317,2474,-157,0,66,1,6
91395,1,2216,2436,-220,0,190,1,5
91396,1,2518,2361,157,0,50,1,6
91397,2,2204,2558,-354,0,0,1,6
91398,1,2446,2382,64,0,40,0,6
91399,2,2252,2401,-149,0,195,0,6
91400,2,2477,2370,107,0,130,0,6
91401,1,2442,2276,166,0,330,1,6
91402,3,2402,2487,-85,0,135,0,6
91403,2,2275,2436,-161,0,47,0,6
91404,3,2370,2494,-124,0,292,0,6
91405,3,2486,2340,146,0,264,0,6
91406,1,2517,2527,-10,0,440,0,6
91407,1,2476,2399,77,0,41,0,6
91408,1,2412,2330,82,0,127,1,6
91409,3,2526,2407,119,0,176,0,6
91410,1,2418,2256,162,0,331,1,6
91411,2,2439,2272,167,0,113,1,6
91412,2,2424,2332,92,0,4,0,6
91413,1,2559,2327,232,0,13,0,6
91414,2,2257,2421,-164,0,101,1,6
91415,1,2411,2359,52,0,143,0,6
91416,3,2475,2450,25,0,317,0,6
91417,2,2455,2377,78,0,6,0,6
91418,2,2478,2493,-15,0,265,0,6
91419,2,2404,2326,78,4,107,0,13
91420,1,2607,2545,62,0,154,0,6
91421,2,2345,2403,-58,0,48,0,6
91422,2,2370,2400,-30,0,301,0,6
91423,1,2486,2390,96,0,84,0,6
91424,1,2394,2481,-87,0,301,1,6
91425,3,2402,2412,-10,0,110,0,6
91426,2,2286,2445,-159,0,102,0,6
91427,2,2308,2408,-100,0,132,0,8
91428,1,2417,2339,78,0,110,0,6
91429,2,2498,2552,-54,0,190,0,6
91430,2,2492,2472,20,0,490,1,6
91432,2,2470,2387,83,0,132,0,6
91433,2,2523,2493,30,0,0,0,6
91434,2,2372,2428,-56,0,230,0,6
91435,2,2273,2422,-149,0,144,0,6
91436,2,2255,2431,-176,0,123,1,6
91437,2,2524,2456,68,0,131,0,6
91438,2,2290,2484,-194,0,245,1,6
91439,1,2451,2280,171,0,345,0,6
91440,1,2328,2475,-147,0,312,0,6
91441,2,2404,2278,126,0,246,0,6
91442,1,2406,2324,82,0,404,0,6
91443,2,2493,2315,178,0,106,0,6
91444,2,2392,2463,-71,0,4,1,6
91445,2,2388,2433,-45,0,13,0,6
91446,2,2412,2457,-45,0,120,0,6
91447,1,2493,2424,69,0,315,1,6
91448,2,2421,2359,62,0,6,0,6
91449,2,2592,2470,122,0,131,0,6
91450,1,2612,2517,95,0,107,0,6
91451,1,2540,2499,41,0,371,0,6
91452,1,2557,2371,186,0,46,0,6
91453,1,2401,2425,-24,0,300,0,6
91454,1,2562,2283,279,0,8,0,6
91455,2,2449,2269,180,0,302,0,6
91456,1,2474,2353,121,0,41,0,6
91457,2,2431,2416,15,0,58,0,6
91458,2,2367,2482,-115,0,411,1,6
91459,1,2417,2341,76,0,115,0,6
91460,2,2557,2521,36,0,4,0,6
91461,2,2486,2269,217,0,101,1,6
91463,2,2479,2516,-37,0,187,0,6
91464,1,2462,2320,142,0,15,1,6
91465,1,2312,2402,-90,0,20,0,6
91466,2,2467,2398,69,0,297,0,6
91467,1,2434,2486,-52,0,255,0,6
91468,2,2560,2439,121,0,398,0,6
91469,3,2313,2409,-96,0,10,0,6
91470,1,2268,2412,-144,0,310,0,8
91471,3,2401,2264,137,0,58,0,6
91472,3,2278,2440,-162,0,103,0,6
91473,1,2512,2487,25,0,90,0,6
91474,3,2660,2616,44,0,403,0,6
91475,1,2422,2425,-3,0,278,0,6
91476,1,2399,2564,-165,0,140,0,6
91477,2,2348,2414,-66,0,475,1,6
91478,1,2498,2497,1,0,265,0,6
91479,1,2420,2277,143,0,40,1,6
91480,2,2480,2441,39,0,406,0,6
91481,2,2391,2411,-20,0,4,1,6
91482,1,2400,2313,87,0,301,0,6
91483,2,2494,2551,-57,0,380,1,6
91484,2,2419,2285,134,0,337,0,6
91485,2,2498,2358,140,0,50,1,6
91486,1,2451,2391,60,4,221,0,13
91487,1,2491,2478,13,0,201,0,6
91488,1,2401,2284,117,0,110,0,6
91489,1,2504,2543,-39,0,409,0,6
91490,1,2408,2363,45,0,301,1,6
91491,2,2481,2422,59,0,106,0,6
91492,2,2528,2555,-27,0,301,0,6
91493,3,2336,2466,-130,0,48,0,6
91494,1,2420,2264,156,0,38,0,8
91495,1,2486,2363,123,0,440,0,6
91496,2,2354,2421,-67,0,101,0,6
91497,3,2473,2438,35,0,102,0,6
91498,1,2523,2446,77,0,46,0,6
91499,2,2419,2428,-9,0,320,0,6
91500,2,2329,2403,-74,0,143,0,8
91502,1,2413,2366,47,0,106,0,6
91503,1,2594,2617,-23,0,341,1,6
91504,2,2326,2418,-92,0,9,0,6
91505,2,2447,2474,-27,0,13,1,6
91506,2,2432,2432,0,0,269,0,6
91507,1,2556,2549,7,0,5,1,6
91508,1,2344,2405,-61,0,190,0,6
91509,2,2301,2419,-118,0,107,0,6
91510,2,2280,2467,-187,0,187,0,6
91511,2,2430,2239,191,0,202,0,5
91512,2,2423,2429,-6,0,241,1,6
91513,1,2472,2293,179,0,201,0,6
91514,1,2411,2336,75,0,20,0,6
91515,2,2453,2490,-37,0,105,1,6
91516,1,2502,2522,-20,0,45,0,6
91517,2,2327,2460,-133,0,45,1,6
91518,1,2497,2404,93,0,150,0,6
91519,3,2335,2446,-111,0,212,0,6
91520,1,2506,2335,171,0,401,0,6
91521,1,2405,2312,93,0,353,0,6
91522,1,2423,2413,10,0,241,0,6
91523,2,2359,2490,-131,0,411,1,6
91524,1,2441,2275,166,0,310,0,6
91525,1,2439,2475,-36,0,263,1,6
91526,2,2224,2526,-302,0,406,0,6
91527,1,2438,2306,132,0,337,0,6
91528,1,2315,2426,-111,0,51,0,6
91529,1,2496,2473,23,0,190,0,6
91530,1,2534,2409,125,0,250,0,6
91531,2,2611,2660,-49,0,190,1,6
91532,1,2513,2476,37,0,315,0,6
91533,1,2479,2407,72,0,356,0,6
91534,1,2487,2349,138,0,65,0,6
91535,2,2416,2278,138,0,130,0,6
91536,2,2470,2359,111,0,344,0,6
91537,2,2417,2316,101,0,20,0,6
91538,2,2434,2427,7,0,333,0,6
91539,1,2323,2561,-238,0,336,0,6
91540,1,2388,2423,-35,0,463,1,6
91541,2,2404,2504,-100,0,251,0,6
91542,1,2401,2289,112,0,101,0,6
91543,3,2552,2479,73,0,312,0,6
91544,2,2503,2517,-14,0,103,0,6
91545,2,2407,2501,-94,0,301,0,6
91546,2,2331,2444,-113,0,341,0,6
91547,2,2270,2442,-172,0,123,0,6
91548,3,2403,2377,26,0,130,0,6
91549,2,2543,2602,-59,0,106,1,6
91550,2,2445,2297,148,0,152,0,6
91551,2,2431,2469,-38,0,331,0,6
91552,1,2490,2496,-6,0,85,0,6
91553,3,2442,2518,-76,0,46,0,6
91554,1,2479,2356,123,0,442,0,6
91555,1,2413,2211,202,4,123,0,8
91557,2,2332,2410,-78,0,70,0,6
91558,3,2606,2600,6,0,241,0,6
91559,3,2612,2586,26,0,101,0,6
91560,1,2484,2468,16,0,70,1,6
91561,2,2387,2408,-21,0,309,0,6
91563,2,2286,2444,-158,0,202,0,6
91564,1,2404,2250,154,0,101,0,8
91565,3,2403,2448,-45,0,208,0,6
91566,1,2508,2403,105,0,241,0,6
91567,2,2315,2403,-88,0,150,0,6
91568,2,2470,2550,-80,0,335,1,6
91569,1,2417,2386,31,0,13,1,6
91570,2,2365,2429,-64,0,80,0,6
91571,1,2352,2483,-131,0,332,0,6
91572,1,2297,2403,-106,0,45,0,6
91573,2,2480,2551,-71,0,112,1,6
91574,1,2367,2581,-214,0,45,1,8
91575,1,2464,2473,-9,0,100,0,6
91576,1,2395,2441,-46,0,352,1,6
91577,2,2370,2414,-44,0,15,0,6
91578,3,2377,2425,-48,0,201,0,6
91579,1,2338,2443,-105,0,313,0,6
91580,2,2594,2730,-136,0,45,0,6
91581,2,2539,2587,-48,0,241,1,6
91582,1,2517,2533,-16,0,302,1,6
91583,2,2490,2436,54,0,32,1,6
91584,1,2454,2387,67,0,17,0,6
91585,1,2600,2606,-6,0,340,1,6
91586,1,2406,2268,138,0,35,0,6
91587,3,2404,2466,-62,0,318,0,6
91588,1,2355,2447,-92,0,45,1,6
91589,1,2407,2426,-19,0,292,0,6
91590,1,2573,2524,49,0,46,0,6
91591,2,2438,2462,-24,0,483,1,6
91592,2,2382,2489,-107,0,331,0,6
91593,3,2408,2233,175,0,332,0,8
91594,1,2287,2460,-173,0,414,0,6
91595,1,2360,2474,-114,0,344,0,6
91596,1,2403,2466,-63,0,113,0,6
91597,1,2491,2350,141,0,326,0,6
91598,1,2448,2512,-64,0,4,1,6
91599,2,2305,2418,-113,0,127,1,6
91600,2,2303,2415,-112,0,107,0,6
91601,1,2734,2590,144,0,215,0,6
91602,2,2383,2480,-97,0,331,0,6
91603,2,2339,2419,-80,0,100,0,6
91604,2,2519,2665,-146,0,491,0,6
91605,2,2459,2599,-140,0,202,0,6
91606,2,2350,2425,-75,0,310,0,6
91607,2,2409,2309,100,0,415,0,6
91608,1,2475,2493,-18,0,292,1,6
91609,1,2450,2378,72,0,15,0,6
91610,1,2592,2534,58,0,0,0,6
91611,1,2405,2346,59,0,106,0,6
91612,2,2561,2519,42,0,102,0,6
91613,1,2527,2364,163,0,45,1,6
91614,1,2476,2365,111,0,300,0,6
91615,1,2429,2415,14,0,201,1,6
91616,1,2443,2272,171,0,140,0,6
91617,2,2467,2367,100,0,426,0,6
91618,2,2440,2413,27,0,123,0,6
91619,1,2483,2378,105,0,405,0,6
91620,2,2587,2737,-150,0,300,0,6
91621,2,2419,2299,120,0,10,1,6
91622,1,2310,2491,-181,0,301,0,6
91623,3,2459,2409,50,0,426,0,6
91624,2,2468,2578,-110,0,0,0,6
91625,1,2577,2208,369,4,220,0,13
91626,1,2531,2420,111,0,254,1,6
91627,1,2558,2523,35,0,107,0,6
91628,1,2467,2511,-44,0,200,0,6
91629,1,2459,2405,54,0,107,0,6
91630,1,2332,2405,-73,0,13,1,8
91631,3,2469,2467,2,0,40,0,6
91632,2,2391,2435,-44,0,113,0,6
91633,2,2423,2308,115,0,301,0,6
91634,1,2429,2484,-55,0,43,0,6
91635,2,2443,2337,106,0,10,1,6
91636,1,2452,2452,0,0,123,0,6
91637,1,2419,2303,116,0,263,0,6
91639,1,2374,2410,-36,0,41,0,6
91640,1,2329,2487,-158,0,21,1,6
91641,2,2500,2446,54,0,8,0,6
91642,1,2415,2346,69,0,112,0,6
91643,2,2363,2487,-124,0,13,0,6
91644,2,2410,2434,-24,0,107,1,6
91645,1,2481,2457,24,0,112,0,6
91646,2,2512,2491,21,0,101,0,6
91647,2,2426,2554,-128,0,414,1,6
91648,2,2295,2416,-121,0,106,1,6
91649,1,2221,2406,-185,0,45,0,8
91650,1,2464,2454,10,0,112,0,6
91651,2,2425,2341,84,0,0,0,6
91652,1,2307,2412,-105,0,484,1,6
91653,1,2473,2363,110,0,45,0,6
91654,1,2584,2798,-214,0,45,1,6
91655,1,2449,2470,-21,0,20,1,6
91656,1,2525,2611,-86,0,301,0,6
91657,3,2495,2472,23,0,474,0,6
91658,2,2434,2454,-20,0,192,0,6
91659,1,2299,2423,-124,0,122,0,6
91660,1,2454,2470,-16,0,409,0,6
91661,2,2400,2464,-64,0,301,0,6
91662,1,2582,2563,19,0,398,0,6
91663,2,2408,2464,-56,0,33,0,6
91664,2,2288,2402,-114,0,102,1,6
91665,3,2315,2447,-132,0,202,0,6
91666,2,2464,2307,157,0,15,0,6
91667,1,2571,2304,267,4,223,0,13
91668,2,2454,2426,28,0,48,0,6
91669,1,2741,2360,381,0,244,0,6
91670,1,2304,2471,-167,0,302,0,6
91671,1,2416,2359,57,0,134,0,6
91672,1,2491,2347,144,0,490,0,6
91673,1,2479,2440,39,0,474,0,6
91674,2,2228,2427,-199,0,40,0,5
91675,1,2477,2487,-10,0,292,0,6
91676,1,2421,2404,17,0,207,0,6
91677,1,2407,2314,93,0,244,1,6
91678,2,2473,2480,-7,0,140,0,6
91679,2,2366,2435,-69,0,485,1,6
91680,2,2330,2456,-126,0,45,0,6
91681,1,2409,2423,-14,0,211,0,6
91682,2,2279,2578,-299,4,220,0,13
91683,2,2469,2329,140,0,335,1,6
91684,2,2460,2404,56,0,178,0,6
91685,1,2782,2592,190,0,337,0,6
91686,1,2703,2782,-79,0,45,1,6
91687,1,2314,2416,-102,0,385,0,6
91688,2,2435,2440,-5,0,398,0,6
91689,1,2373,2433,-60,0,106,0,6
91690,1,2420,2312,108,0,122,0,6
91691,2,2448,2428,20,0,4,0,6
91692,1,2464,2455,9,0,112,0,6
91693,2,2552,2558,-6,0,323,0,6
91694,1,2320,2408,-88,0,440,0,6
91695,1,2406,2305,101,4,380,0,13
91696,2,2495,2385,110,0,453,0,6
91697,1,2403,2380,23,0,320,0,6
91698,1,2468,2425,43,0,263,0,6
91699,3,2452,2347,105,0,406,0,6
91700,2,2460,2563,-103,0,15,1,6
91701,1,2654,2533,121,0,103,1,6
91702,1,2742,2546,196,0,140,1,6
91703,3,2544,2359,185,2,192,0,30
91704,1,2473,2494,-21,0,148,0,6
91705,1,2426,2357,69,0,113,1,6
91706,1,2413,2460,-47,0,5,0,6
91707,1,2445,2349,96,0,43,0,6
91708,1,2358,2658,-300,0,15,0,6
91709,2,2381,2484,-103,0,88,0,6
91710,1,2408,2352,56,0,15,0,8
91711,2,2449,2469,-20,0,472,1,6
91712,2,2462,2312,150,0,132,0,6
91713,1,2406,2334,72,0,352,1,6
91714,2,2494,2370,124,0,380,0,6
91715,2,2389,2463,-74,0,301,0,6
91716,2,2485,2485,0,0,45,0,6
91717,1,2776,2770,6,0,106,1,6
91718,1,2348,2468,-120,0,43,0,6
91719,1,2590,2787,-197,0,300,0,6
91720,3,2442,2333,109,0,1,0,6
91721,2,2430,2461,-31,0,331,0,6
91722,1,2445,2415,30,0,122,0,6
91723,2,2648,2371,277,0,415,0,6
91724,1,2403,2352,51,0,177,0,6
91725,1,2320,2411,-91,0,16,1,6
91726,2,2375,2408,-33,0,135,0,6
91727,2,2392,2487,-95,0,277,0,6
91728,2,2464,2468,-4,0,100,1,6
91729,2,2349,2451,-102,0,45,1,6
91730,1,2412,2322,90,0,108,1,6
91731,2,2567,2481,86,0,292,0,6
91732,1,2474,2423,51,0,112,1,6
91733,2,2420,2312,108,0,112,0,6
91734,2,2342,2405,-63,0,201,0,6
91735,1,2772,2598,174,0,216,0,6
91736,2,2544,2745,-201,0,15,0,6
91737,1,2483,2431,52,0,4,0,6
91738,2,2310,2424,-114,0,65,0,6
91739,2,2450,2489,-39,0,81,0,6
91740,1,2451,2409,42,0,105,0,6
91741,1,2504,2541,-37,0,191,0,6
91742,3,2467,2481,-14,0,143,0,6
91743,2,2265,2408,-143,0,470,0,6
91744,1,2488,2479,9,0,112,0,6
91745,1,2638,2466,172,0,330,1,6
91746,1,2475,2424,51,0,454,0,6
91747,2,2420,2242,178,0,4,0,6
91748,2,2491,2388,103,0,453,0,6
91749,1,2454,2377,77,0,411,0,6
91750,1,2413,2370,43,0,302,1,6
91752,1,2413,2314,99,0,120,0,6
91753,2,2586,2529,57,0,190,1,6
91754,2,2383,2516,-133,0,13,0,6
91755,1,2298,2446,-148,0,303,1,6
91756,3,2765,2748,17,0,175,0,6
91757,2,2377,2465,-88,0,310,0,6
91758,1,2569,2213,356,0,375,0,8
91759,3,2455,2345,110,0,406,0,6
91760,1,2595,2777,-182,0,83,0,6
91761,2,2491,2534,-43,0,15,0,6
91762,2,2350,2401,-51,0,398,0,6
91763,1,2535,2468,67,0,80,0,6
91764,2,2517,2561,-44,0,245,0,6
91765,2,2481,2329,152,0,4,0,6
91766,1,2446,2304,142,0,40,0,6
91767,1,2298,2445,-147,0,200,0,6
91768,2,2480,2411,69,0,45,0,6
91769,2,2419,2480,-61,0,265,0,6
91770,3,2485,2494,-9,0,8,0,6
91771,2,2426,2429,-3,0,113,0,6
91772,2,2317,2422,-105,0,123,0,6
91773,2,2417,2418,-1,0,313,0,6
91774,2,2426,2369,57,0,111,0,6
91775,2,2539,2486,53,0,192,0,6
91776,2,2349,2432,-83,0,151,0,5
91777,2,2373,2417,-44,0,405,0,6
91778,2,2396,2484,-88,0,234,0,6
91779,1,2428,2473,-45,0,245,0,6
91780,1,2321,2429,-108,0,490,1,6
91781,2,2470,2556,-86,0,110,0,6
91782,1,2434,2357,77,0,226,1,6
91783,2,2365,2419,-54,0,135,1,6
91784,2,2463,2330,133,0,84,0,6
91785,1,2316,2411,-95,0,10,0,6
91786,1,2396,2416,-20,0,49,1,6
91787,1,2494,2468,26,0,474,0,6
91788,1,2347,2453,-106,0,45,0,6
91789,1,2470,2278,192,0,106,1,8
91790,1,2426,2322,104,0,0,1,6
91791,1,2242,2425,-183,0,13,0,6
91792,2,2465,2285,180,0,121,0,6
91793,1,2560,2378,182,0,255,0,6
91794,2,2763,2604,159,0,43,1,6
91795,2,2259,2437,-178,0,453,0,6
91796,1,2404,2301,103,0,111,0,6
91797,2,2464,2579,-115,0,2,0,6
91798,1,2539,2389,150,0,385,0,6
91799,2,2370,2421,-51,0,101,1,6
91800,2,2284,2405,-121,0,343,0,6
91801,1,2485,2415,70,0,122,0,6
91802,3,2259,2400,-141,0,352,0,8
91803,2,2314,2458,-144,0,40,1,6
91804,1,2539,2353,186,0,146,0,6
91805,1,2406,2294,112,0,8,0,6
91806,3,2435,2338,97,0,337,0,6
91807,2,2419,2426,-7,0,248,0,6
91808,1,2731,2420,311,0,45,0,6
91809,1,2402,2485,-83,0,300,0,6
91810,2,2477,2494,-17,0,252,0,6
91811,2,2442,2504,-62,0,201,0,6
91812,2,2355,2460,-105,0,453,0,6
91813,2,2460,2488,-28,0,4,0,6
91814,1,2446,2354,92,0,15,0,6
91815,2,2290,2422,-132,0,35,0,6
91816,2,2486,2421,65,0,107,0,6
91817,2,2370,2570,-200,0,43,0,8
91818,2,2452,2419,33,0,5,0,6
91819,1,2493,2542,-49,0,292,1,6
91820,2,2493,2532,-39,0,10,0,6
91821,2,2410,2490,-80,0,265,0,6
91822,1,2488,2349,139,0,307,0,6
91823,1,2489,2642,-153,0,1,0,6
91824,1,2457,2304,153,0,272,0,6
91825,2,2256,2410,-154,0,330,0,6
91826,2,2350,2450,-100,0,46,0,6
91827,2,2423,2360,63,0,302,0,6
91828,1,2434,2382,52,0,113,0,6
91829,2,2303,2413,-110,0,121,0,6
91830,1,2432,2523,-91,0,106,0,6
91831,1,2408,2402,6,0,0,0,6
91832,2,2439,2479,-40,0,123,0,6
91833,2,2323,2473,-150,0,16,1,6
91834,3,2418,2404,14,0,45,0,6
91835,1,2450,2467,-17,0,466,0,6
91836,3,2612,2749,-137,0,300,0,6
91837,1,2400,2401,-1,0,112,0,6
91838,2,2341,2499,-158,0,105,1,6
91839,2,2536,2583,-47,0,142,1,6
91840,2,2447,2479,-32,0,136,1,6
91841,1,2426,2329,97,0,337,0,6
91842,2,2377,2543,-166,0,405,0,6
91843,2,2428,2365,63,0,201,0,6
91844,2,2356,2460,-104,0,154,0,6
91845,2,2397,2413,-16,0,102,1,6
91846,2,2341,2409,-68,0,300,0,6
91847,2,2413,2353,60,0,473,0,6
91848,1,2408,2472,-64,0,133,0,6
91849,1,2361,2418,-57,0,112,0,6
91850,1,2346,2492,-146,0,268,1,6
91851,2,2499,2494,5,0,265,0,6
91852,2,2528,2558,-30,0,2,0,6
91853,2,2454,2346,108,0,130,0,6
91854,1,2387,2419,-32,0,292,1,6
91855,2,2342,2447,-105,0,345,1,6
91856,3,2406,2499,-93,0,270,0,6
91857,1,2407,2458,-51,0,140,0,6
91858,2,2509,2437,72,0,358,0,6
91859,2,2379,2439,-60,0,106,1,6
91860,1,2516,2518,-2,0,10,0,6
91861,1,2465,2415,50,0,109,1,6
91862,1,2563,2478,85,0,250,1,6
91863,1,2355,2473,-118,0,64,1,8
91864,3,2367,2440,-73,0,123,0,6
91865,1,2393,2426,-33,0,120,0,6
91866,2,2322,2460,-138,0,141,1,6
91867,1,2301,2409,-108,0,336,0,6
91868,2,2434,2352,82,0,217,1,6
91869,2,2367,2450,-83,0,314,0,6
91870,1,2745,2614,131,0,200,0,6
91871,2,2338,2444,-106,0,418,1,6
91872,1,2500,2380,120,0,441,1,6
91873,1,2243,2438,-195,0,343,0,5
91874,1,2573,2313,260,0,317,0,8
91875,1,2546,2493,53,0,317,1,6
91876,2,2422,2325,97,0,122,0,6
91877,1,2484,2324,160,0,253,0,6
91878,1,2393,2446,-53,0,112,0,6
91879,2,2476,2439,37,0,45,0,6
91880,2,2300,2418,-118,0,278,1,6
91881,1,2411,2442,-31,0,202,0,6
91882,1,2588,2396,192,0,110,0,6
91883,1,2380,2411,-31,0,43,0,6
91884,1,2502,2618,-116,0,325,0,6
91885,1,2465,2406,59,0,217,1,6
91886,1,2408,2368,40,0,103,1,6
91887,1,2419,2391,28,0,10,0,6
91888,1,2337,2414,-77,0,302,0,6
91889,1,2304,2454,-150,0,106,0,6
91890,1,2393,2522,-129,0,447,1,6
91891,3,2243,2471,-228,0,406,0,8
91892,1,2464,2386,78,0,369,0,6
91893,2,2512,2414,98,0,46,0,6
91894,2,2332,2484,-152,0,302,0,6
91895,2,2353,2447,-94,0,45,1,6
91896,2,2435,2293,142,0,203,0,6
91897,1,2410,2470,-60,0,205,0,6
91898,1,2368,2412,-44,0,123,0,6
91899,2,2237,2404,-167,0,10,0,6
91900,1,2413,2498,-85,0,156,0,6
91901,1,2444,2338,106,0,28,0,6
91902,1,2418,2444,-26,0,300,0,6
91903,1,2456,2487,-31,0,140,0,6
91904,1,2610,2751,-141,0,320,0,6
91905,1,2474,2407,67,0,5,0,6
91906,1,2381,2504,-123,0,4,1,6
91907,1,2420,2292,128,0,43,0,6
91908,1,2451,2488,-37,0,190,0,6
91909,2,2464,2417,47,0,101,1,6
91910,2,2419,2302,117,0,153,0,6
91911,2,2610,2490,120,0,242,1,6
91912,1,2450,2304,146,0,57,0,8
91913,1,2403,2377,26,0,424,0,6
91914,1,2407,2424,-17,0,463,1,6
91915,1,2425,2291,134,0,400,1,8
91916,2,2489,2505,-16,0,241,0,6
91917,1,2363,2510,-147,0,152,0,6
91918,2,2400,2286,114,0,112,0,6
91919,3,2406,2374,32,0,207,0,6
91920,1,2408,2366,42,0,206,1,6
91921,1,2382,2482,-100,0,1,0,6
91922,1,2401,2320,81,0,106,0,6
91923,1,2468,2246,222,0,196,0,8
91924,2,2438,2446,-8,0,133,0,6
91925,2,2451,2349,102,0,47,0,6
91926,1,2317,2470,-153,0,123,0,6
91927,1,2301,2448,-147,0,300,1,6
91928,2,2310,2472,-162,0,40,0,6
91929,1,2481,2462,19,0,255,0,6
91930,1,2415,2301,114,0,85,0,6
91931,2,2243,2502,-259,0,200,0,8
91932,3,2262,2424,-162,0,9,0,6
91933,1,2739,2618,121,0,207,0,6
91934,2,2234,2402,-168,0,5,0,6
91935,1,2382,2451,-69,0,133,1,6
91936,3,2401,2420,-19,0,352,0,6
91937,2,2478,2415,63,0,5,1,6
91938,1,2502,2276,226,0,4,1,6
91939,3,2409,2353,56,0,150,0,6
91940,1,2496,2389,107,0,190,0,6
91941,1,2482,2458,24,0,14,1,6
91942,1,2491,2371,120,0,103,1,6
91943,2,2265,2403,-138,0,236,1,6
91944,1,2437,2374,63,0,101,0,6
91945,2,2375,2551,-176,0,13,0,6
91946,3,2458,2409,49,0,327,0,6
91947,2,2372,2453,-81,0,45,0,8
91948,2,2422,2276,146,0,107,0,6
91949,1,2361,2412,-51,0,463,0,6
91950,2,2511,2603,-92,0,0,0,6
91951,1,2483,2497,-14,0,242,0,6
91952,2,2405,2359,46,0,229,0,6
91953,2,2357,2444,-87,0,102,1,6
91954,1,2405,2320,85,0,455,0,6
91955,2,2418,2297,121,0,360,0,6
91956,1,2375,2406,-31,0,123,0,6
91957,3,2412,2316,96,0,135,0,6
91958,1,2455,2389,66,0,455,0,6
91959,2,2475,2495,-20,0,269,0,6
91960,1,2484,2341,143,0,106,0,6
91961,1,2728,2538,190,0,246,0,6
91962,2,2443,2401,42,0,45,0,6
91963,1,2477,2328,149,0,330,0,6
91964,2,2397,2419,-22,0,236,0,6
91965,3,2566,2563,3,0,15,0,6
91966,2,2464,2469,-5,0,267,0,6
91967,2,2246,2442,-196,0,40,0,6
91968,2,2440,2448,-8,0,351,1,6
91969,1,2560,2498,62,0,167,0,6
91970,2,2380,2428,-48,0,331,1,6
91971,1,2614,2745,-131,0,40,1,6
91972,1,2486,2506,-20,0,107,0,6
91973,2,2357,2421,-64,0,0,0,6
91974,2,2483,2488,-5,0,302,0,6
91975,2,2506,2365,141,0,264,0,6
91976,2,2555,2472,83,0,311,1,6
91977,2,2329,2502,-173,0,487,0,6
91978,1,2489,2456,33,0,112,0,6
91979,3,2487,2208,279,4,124,0,23
91980,3,2244,2470,-226,0,409,0,8
91981,2,2410,2413,-3,0,310,0,6
91982,1,2322,2410,-88,0,108,0,6
91983,1,2500,2367,133,0,347,0,6
91984,2,2338,2459,-121,0,34,0,6
91985,2,2425,2504,-79,0,190,0,6
91986,2,2401,2297,104,0,40,0,8
91987,2,2438,2419,19,0,115,0,6
91988,1,2770,2743,27,0,474,0,6
91989,1,2520,2494,26,0,245,1,6
91990,2,2448,2352,96,0,16,0,6
91991,2,2453,2487,-34,0,176,0,6
91992,1,2425,2222,203,0,107,0,5
91993,2,2465,2365,100,0,53,1,6
91994,1,2490,2411,79,0,46,1,6
91995,3,2384,2472,-88,0,426,0,6
91996,1,2426,2326,100,0,337,0,6
91997,2,2306,2457,-151,0,202,0,6
91998,2,2535,2731,-196,0,490,0,6
91999,2,2454,2435,19,0,25,0,6
92000,2,2418,2242,176,0,207,0,6
92001,3,2403,2496,-93,0,123,0,6
92002,2,2341,2462,-121,0,140,0,6
92003,2,2279,2428,-149,0,8,0,8
92004,2,2600,2535,65,0,244,0,6
92005,2,2470,2498,-28,0,265,0,6
92006,1,2394,2410,-16,0,101,0,6
92007,2,2430,2481,-51,0,331,0,6
92008,2,2437,2477,-40,0,45,1,6
92009,1,2360,2441,-81,0,45,0,6
92010,1,2733,2622,111,0,207,0,6
92011,2,2390,2457,-67,0,336,1,6
92012,1,2493,2318,175,0,344,0,6
92013,1,2419,2247,172,0,101,0,6
92014,2,2462,2393,69,0,394,0,6
92015,1,2452,2270,182,0,103,0,6
92016,1,2538,2466,72,0,140,0,6
92017,2,2500,2504,-4,0,353,0,6
92018,1,2548,2479,69,0,265,0,6
92019,1,2413,2420,-7,0,4,0,6
92020,1,2297,2414,-117,0,143,1,6
92021,2,2438,2488,-50,0,45,0,6
92022,3,2432,2368,64,0,111,0,6
92023,2,2422,2446,-24,0,106,0,6
92024,1,2376,2405,-29,0,123,0,6
92025,2,2494,2489,5,0,319,0,6
92026,2,2409,2404,5,0,118,0,6
92027,1,2537,2626,-89,0,380,0,6
92028,1,2710,2775,-65,0,45,0,6
92029,1,2435,2334,101,0,5,0,8
92030,1,2455,2290,165,0,0,0,6
92031,1,2441,2448,-7,0,351,0,6
92032,2,2425,2467,-42,0,414,0,6
92033,2,2486,2536,-50,0,338,0,6
92034,3,2467,2247,220,0,278,0,8
92035,1,2471,2366,105,0,28,0,6
92036,1,2406,2495,-89,0,4,0,6
92037,1,2428,2251,177,0,240,0,5
92038,2,2535,2495,40,0,107,0,6
92039,3,2542,2593,-51,0,164,0,6
92040,3,2618,2739,-121,0,345,0,6
92041,1,2510,2393,117,0,113,0,6
92042,1,2442,2447,-5,0,113,1,6
92043,1,2415,2461,-46,0,6,0,6
92044,2,2438,2422,16,0,373,0,6
92045,2,2218,2509,-291,0,194,0,6
92046,2,2404,2451,-47,0,114,0,6
92047,1,2461,2386,75,0,43,1,6
92048,2,2483,2386,97,0,15,0,6
92049,2,2378,2417,-39,0,311,0,6
92050,2,2419,2456,-37,0,300,1,6
92051,1,2400,2367,33,0,331,1,6
92052,2,2416,2432,-16,0,57,1,6
92053,2,2379,2421,-42,0,122,0,6
92054,1,2474,2419,55,0,8,0,6
92055,2,2371,2553,-182,0,28,0,6
92056,1,2768,2749,19,0,50,0,6
92057,2,2352,2489,-137,0,126,0,6
92058,2,2431,2410,21,0,131,0,6
92059,2,2495,2496,-1,0,292,1,6
92060,1,2369,2403,-34,0,4,0,6
92061,2,2532,2458,74,0,382,1,6
92062,1,2426,2308,118,0,115,0,6
92063,2,2634,2476,158,0,414,0,6
92064,2,2665,2619,46,0,369,1,6
92066,3,2250,2464,-214,0,406,0,8
92067,1,2483,2345,138,0,312,1,6
92068,3,2420,2332,88,0,414,0,6
92069,3,2372,2455,-83,0,335,0,6
92070,3,2461,2300,161,0,45,0,6
92071,1,2541,2457,84,0,15,0,6
92072,1,2493,2431,62,0,152,0,6
92073,3,2236,2442,-206,0,40,0,6
92074,2,2447,2582,-135,0,143,0,6
92075,1,2736,2620,116,0,43,0,6
92076,1,2524,2439,85,0,405,0,6
92077,1,2428,2373,55,0,254,0,6
92078,2,2456,2475,-19,0,202,1,6
92079,1,2469,2293,176,0,210,0,6
92080,3,2626,2526,100,0,138,0,6
92081,2,2399,2475,-76,0,200,0,6
92082,1,2514,2593,-79,0,134,0,6
92083,2,2491,2479,12,0,315,0,6
92084,2,2528,2399,129,0,395,1,6
92085,1,2421,2402,19,0,45,0,6
92086,1,2529,2433,96,0,331,0,6
92087,1,2421,2382,39,0,106,0,6
92088,2,2296,2425,-129,0,40,1,6
92089,2,2556,2367,189,0,108,1,6
92090,2,2466,2405,61,0,201,0,6
92091,1,2410,2381,29,0,140,1,6
92092,2,2215,2403,-188,0,4,0,6
92093,2,2286,2439,-153,0,202,0,8
92094,3,2465,2492,-27,0,123,0,6
92095,2,2402,2288,114,2,210,0,18
92096,2,2485,2625,-140,0,45,0,6
92097,2,2480,2551,-71,0,311,1,6
92098,2,2291,2475,-184,0,200,0,6
92099,1,2441,2271,170,0,130,0,6
92100,3,2454,2348,106,0,109,0,6
92101,2,2377,2502,-125,0,1,0,6
92102,2,2721,2774,-53,0,300,1,6
92103,3,2546,2489,57,0,317,0,6
92104,1,2426,2353,73,0,0,0,6
92105,1,2276,2452,-176,0,112,1,6
92106,2,2485,2543,-58,0,7,0,6
92107,2,2657,2453,204,0,474,0,6
92108,3,2235,2401,-166,0,101,0,6
92109,2,2327,2419,-92,0,200,1,6
92110,2,2340,2518,-178,0,43,1,6
92111,2,2391,2494,-103,0,205,0,6
92112,3,2629,2481,148,0,398,0,6
92113,3,2253,2431,-178,0,115,0,5
92114,1,2468,2371,97,0,41,1,6
92115,1,2291,2419,-128,0,261,1,6
92116,3,2624,2635,-11,0,18,0,6
92117,1,2433,2280,153,0,102,0,6
92118,1,2586,2521,65,0,241,0,6
92119,2,2400,2344,56,0,135,0,6
92120,2,2616,2742,-126,0,345,0,6
92121,2,2506,2544,-38,0,311,1,6
92122,2,2714,2426,288,0,268,0,6
92123,2,2459,2590,-131,0,45,0,6
92124,2,2308,2459,-151,0,25,0,6
92125,1,2412,2414,-2,0,311,0,6
92126,2,2462,2649,-187,0,0,0,6
92127,3,2325,2441,-116,0,0,0,6
92128,2,2492,2429,63,0,56,1,6
92129,1,2480,2415,65,0,8,0,6
92130,3,2444,2427,17,0,211,0,6
92131,1,2602,2376,226,0,43,0,6
92132,2,2373,2475,-102,0,247,0,6
92133,3,2461,2357,104,0,267,0,8
92134,1,2556,2590,-34,0,340,1,6
92135,1,2330,2455,-125,0,122,0,6
92136,3,2547,2548,-1,0,112,0,6
92137,1,2506,2466,40,0,380,0,6
92138,1,2431,2400,31,0,225,0,6
92139,2,2406,2334,72,0,142,0,6
92140,1,2420,2367,53,0,487,1,6
92141,1,2512,2491,21,0,107,0,6
92142,1,2480,2288,192,0,133,1,6
92143,1,2461,2511,-50,0,292,0,6
92144,2,2321,2545,-224,0,338,0,6
92145,1,2482,2300,182,0,218,0,6
92146,2,2341,2408,-67,0,110,0,6
92147,1,2414,2395,19,0,464,0,6
92148,3,2484,2627,-143,0,335,0,6
92149,1,2778,2698,80,0,131,0,6
92150,1,2439,2327,112,0,380,1,6
92151,1,2468,2566,-98,0,398,0,6
92152,2,2423,2521,-98,0,43,1,6
92153,1,2401,2365,36,0,311,0,6
92154,3,2747,2613,134,0,200,0,6
92155,1,2467,2285,182,0,132,0,6
92156,1,2420,2295,125,0,130,1,6
92157,1,2597,2442,155,0,47,0,6
92158,1,2459,2307,152,0,132,1,6
92159,1,2308,2443,-135,0,210,0,8
92160,1,2341,2436,-95,0,107,0,6
92161,1,2418,2411,7,0,325,0,6
92162,2,2429,2542,-113,0,45,0,6
92163,2,2652,2459,193,0,310,1,6
92164,1,2492,2624,-132,0,369,1,6
92165,2,2377,2404,-27,0,123,0,6
92166,2,2204,2455,-251,0,140,0,6
92167,2,2369,2449,-80,0,115,0,6
92168,1,2428,2251,177,0,106,0,6
92169,2,2436,2696,-260,0,140,1,6
92170,1,2490,2516,-26,0,139,0,6
92171,1,2521,2345,176,0,43,0,6
92172,2,2491,2463,28,0,249,1,6
92173,1,2382,2404,-22,0,190,0,6
92174,1,2584,2562,22,0,107,0,6
92175,2,2479,2495,-16,0,342,0,6
92176,2,2251,2429,-178,0,343,0,5
92177,1,2357,2406,-49,0,331,0,6
92178,1,2625,2486,139,0,55,0,6
92179,1,2428,2444,-16,0,147,0,6
92180,2,2398,2461,-63,0,205,0,6
92181,2,2458,2549,-91,0,170,0,6
92182,1,2271,2416,-145,0,142,1,8
92183,2,2401,2374,27,0,1,1,6
92184,1,2485,2485,0,0,315,1,6
92185,1,2427,2372,55,0,323,1,6
92186,1,2434,2373,61,0,130,0,6
92187,1,2469,2325,144,0,40,0,6
92188,1,2471,2425,46,0,125,0,6
92189,2,2282,2547,-265,0,132,1,6
92190,2,2376,2419,-43,0,107,1,6
92191,2,2466,2485,-19,0,373,0,6
92192,1,2323,2443,-120,0,0,1,6
92193,2,2678,2783,-105,0,300,0,6
92194,2,2276,2423,-147,0,5,1,6
92195,2,2244,2411,-167,0,261,0,6
92196,3,2297,2485,-188,0,138,0,6
92197,1,2321,2505,-184,0,1,1,6
92198,1,2472,2319,153,0,335,0,6
92199,3,2485,2448,37,0,120,0,6
92200,2,2405,2423,-18,0,218,0,6
92201,2,2436,2455,-19,0,190,0,6
92202,2,2615,2745,-130,0,345,0,6
92203,1,2526,2590,-64,0,125,0,6
92204,2,2291,2419,-128,0,13,0,6
92205,1,2750,2611,139,0,207,0,6
92206,1,2643,2496,147,0,310,0,6
92207,1,2429,2349,80,0,106,0,6
92208,1,2594,2476,118,0,40,0,6
92209,2,2395,2457,-62,0,200,0,6
92210,2,2351,2435,-84,0,200,0,8
92211,2,2482,2628,-146,0,317,0,6
92212,1,2603,2338,265,0,404,0,6
92213,1,2632,2513,119,0,7,1,6
92214,1,2634,2617,17,0,127,0,6
92215,3,2337,2454,-117,0,112,0,6
92216,1,2350,2524,-174,0,126,0,6
92217,2,2338,2422,-84,0,484,0,6
92218,2,2424,2401,23,0,101,0,6
92219,1,2282,2411,-129,0,335,1,8
92220,2,2297,2472,-175,0,100,0,6
92221,2,2467,2598,-131,0,122,0,6
92222,2,2258,2426,-168,4,211,0,13
92223,2,2438,2434,4,0,206,0,6
92224,1,2454,2368,86,0,45,1,6
92225,1,2413,2486,-73,0,211,0,6
92226,1,2748,2377,371,0,271,0,6
92227,2,2434,2380,54,0,140,0,6
92228,2,2416,2289,127,0,115,0,6
92229,1,2367,2432,-65,0,123,0,6
92230,1,2583,2532,51,0,154,0,6
92231,1,2420,2382,38,0,140,0,6
92232,1,2440,2432,8,0,207,0,6
92233,1,2479,2433,46,0,4,0,6
92234,2,2491,2476,15,0,331,0,6
92235,1,2425,2360,65,0,45,0,6
92236,2,2342,2498,-156,0,152,1,6
92237,2,2323,2403,-80,0,296,1,6
92239,1,2436,2317,119,0,108,1,6
92240,1,2493,2557,-64,0,101,0,6
92241,3,2491,2400,91,0,4,0,6
92242,1,2424,2364,60,0,426,0,6
92243,1,2460,2408,52,0,49,0,6
92244,2,2549,2556,-7,0,110,0,6
92245,1,2464,2395,69,0,249,0,6
92246,1,2787,2662,125,0,15,0,6
92247,1,2390,2543,-153,0,229,1,6
92248,1,2316,2476,-160,0,344,0,6
92249,2,2426,2445,-19,0,211,1,6
92250,1,2429,2382,47,0,111,1,6
92251,1,2454,2280,174,0,130,0,6
92252,2,2280,2461,-181,0,145,0,6
92253,1,2496,2330,166,0,40,0,6
92254,2,2511,2407,104,0,4,0,6
92255,2,2385,2515,-130,0,80,0,6
92256,1,2553,2440,113,0,474,0,6
92257,2,2452,2335,117,0,106,0,6
92258,1,2611,2657,-46,0,337,0,6
92259,1,2608,2754,-146,0,345,0,6
92260,2,2503,2636,-133,0,200,1,6
92261,1,2336,2431,-95,0,121,0,6
92262,1,2601,2436,165,0,189,0,6
92263,3,2424,2349,75,0,140,0,6
92264,3,2432,2349,83,0,107,0,5
92265,1,2528,2588,-60,0,101,0,6
92266,1,2377,2426,-49,0,305,0,6
92267,2,2546,2607,-61,0,143,0,6
92268,2,2337,2400,-63,0,151,0,6
92269,1,2367,2429,-62,0,326,0,6
92270,1,2335,2422,-87,0,153,0,6
92271,1,2448,2386,62,0,45,1,6
92272,2,2394,2429,-35,0,107,1,6
92273,3,2548,2485,63,0,302,0,6
92274,1,2374,2431,-57,0,135,1,6
92275,2,2499,2605,-106,0,302,0,6
92276,2,2224,2435,-211,4,171,0,13
92277,2,2452,2316,136,0,50,1,6
92278,2,2355,2430,-75,0,300,0,6
92279,2,2473,2519,-46,0,153,0,6
92280,2,2432,2267,165,0,107,0,6
92281,2,2468,2485,-17,0,43,1,6
92282,2,2229,2434,-205,0,40,1,6
92283,1,2266,2414,-148,0,40,0,6
92284,3,2404,2254,150,0,58,0,8
92285,2,2226,2401,-175,0,319,0,6
92286,1,2423,2385,38,0,202,1,6
92287,1,2338,2439,-101,0,140,0,6
92288,2,2465,2528,-63,0,40,0,6
92289,1,2749,2376,373,0,272,0,6
92290,2,2374,2452,-78,0,315,1,6
92291,2,2415,2324,91,0,150,0,6
92292,1,2474,2342,132,0,134,0,6
92293,1,2294,2429,-135,0,41,0,6
92294,1,2544,2458,86,0,15,0,6
92295,2,2391,2470,-79,0,140,0,6
92296,2,2277,2503,-226,0,190,0,6
92297,1,2647,2791,-144,0,4,1,6
92298,1,2550,2616,-66,0,474,0,6
92299,1,2436,2398,38,0,466,0,6
92300,2,2490,2456,34,0,7,1,6
92301,2,2451,2421,30,0,178,0,6
92302,2,2401,2554,-153,0,46,0,6
92303,1,2246,2430,-184,0,41,0,5
92304,1,2494,2302,192,0,58,0,6
92305,2,2581,2534,47,0,140,1,6
92306,1,2714,2640,74,0,203,1,6
92307,1,2400,2343,57,0,345,0,6
92308,3,2311,2424,-113,0,253,0,6
92309,2,2495,2370,125,0,315,0,6
92310,1,2432,2364,68,0,20,0,6
92311,2,2306,2428,-122,0,110,0,6
92312,3,2238,2408,-170,0,380,0,6
92313,1,2267,2419,-152,0,412,0,6
92314,1,2461,2292,169,0,40,0,6
92315,1,2414,2486,-72,0,267,1,6
92316,2,2434,2380,54,0,107,0,6
92317,1,2506,2274,232,0,6,0,6
92318,1,2445,2381,64,0,207,0,6
92319,1,2430,2255,175,4,8,0,13
92320,1,2413,2296,117,0,170,0,6
92321,1,2427,2468,-41,0,116,0,6
92322,1,2483,2261,222,4,125,0,23
92323,2,2294,2455,-161,0,120,0,6
92324,2,2411,2427,-16,0,380,1,6
92325,1,2453,2370,83,0,45,0,6
92327,2,2456,2369,87,0,226,0,6
92328,1,2364,2441,-77,0,474,0,6
92329,2,2331,2404,-73,0,315,0,6
92330,2,2329,2407,-78,0,122,0,6
92331,1,2444,2436,8,0,310,0,6
92332,2,2750,2630,120,0,277,0,6
92333,3,2524,2457,67,0,395,0,6
92334,1,2409,2285,124,0,7,1,6
92335,2,2366,2548,-182,0,300,0,6
92336,1,2477,2327,150,0,4,0,6
92337,1,2328,2501,-173,0,46,1,6
92338,2,2299,2474,-175,0,46,0,6
92339,2,2380,2414,-34,0,245,0,6
92340,2,2424,2251,173,0,227,1,8
92341,2,2464,2483,-19,0,454,1,6
92342,2,2426,2405,21,0,303,0,6
92343,1,2550,2462,88,0,256,0,6
92344,1,2783,2677,106,0,47,1,6
92345,1,2651,2683,-32,0,254,0,6
92346,1,2386,2532,-146,0,107,0,6
92347,2,2440,2534,-94,0,121,0,6
92348,3,2305,2462,-157,0,300,0,6
92349,2,2484,2541,-57,0,120,0,6
92350,2,2378,2488,-110,0,331,0,6
92351,3,2508,2575,-67,0,6,0,6
92352,1,2437,2411,26,0,20,0,6
92353,2,2406,2297,109,0,426,0,6
92354,1,2329,2456,-127,0,337,0,6
92355,2,2635,2719,-84,0,4,0,6
92356,1,2257,2434,-177,0,13,0,6
92357,2,2430,2415,15,0,28,0,6
92358,1,2368,2450,-82,0,1,1,6
92359,3,2364,2412,-48,0,313,0,6
92360,3,2376,2449,-73,0,211,0,6
92361,2,2251,2401,-150,0,241,0,8
92362,2,2477,2481,-4,0,339,1,6
92363,2,2411,2479,-68,0,315,0,6
92364,2,2604,2422,182,0,400,0,6
92365,2,2372,2441,-69,0,4,0,6
92366,1,2434,2371,63,0,70,0,6
92367,1,2359,2401,-42,0,335,1,6
92368,2,2458,2421,37,0,43,1,6
92369,2,2413,2296,117,0,110,0,6
92370,3,2402,2327,75,0,190,0,6
92371,2,2493,2462,31,0,5,0,6
92372,2,2638,2742,-104,0,120,1,6
92373,1,2426,2325,101,0,106,0,6
92374,2,2523,2428,95,0,312,1,6
92375,1,2424,2377,47,0,18,1,6
92376,1,2421,2449,-28,0,111,0,6
92377,3,2433,2463,-30,0,263,0,6
92378,3,2369,2476,-107,0,14,0,6
92379,1,2458,2294,164,0,330,0,6
92380,2,2723,2631,92,0,200,0,6
92381,2,2674,2787,-113,0,311,0,6
92382,2,2482,2363,119,0,394,1,6
92383,2,2374,2442,-68,0,45,0,6
92384,2,2382,2424,-42,0,56,0,6
92385,1,2492,2374,118,0,315,0,6
92386,1,2449,2406,43,0,133,0,6
92387,2,2502,2611,-109,0,106,0,6
92388,1,2574,2524,50,0,108,0,6
92389,2,2677,2657,20,0,331,0,6
92390,1,2538,2436,102,0,211,0,6
92391,2,2411,2367,44,0,106,1,6
92392,1,2375,2591,-216,0,15,1,6
92393,2,2509,2378,131,0,6,0,6
92394,2,2546,2590,-44,0,143,0,6
92395,1,2489,2487,2,0,4,0,6
92396,1,2431,2480,-49,0,50,0,6
92397,2,2468,2439,29,0,216,0,6
92398,1,2443,2377,66,0,320,1,6
92399,1,2483,2496,-13,0,7,0,6
92400,1,2330,2405,-75,0,1,0,6
92401,1,2519,2364,155,0,278,0,6
92402,2,2394,2472,-78,0,200,1,6
92403,2,2579,2591,-12,0,128,0,6
92404,1,2408,2241,167,4,403,0,13
92405,2,2357,2401,-44,0,13,1,6
92406,2,2791,2670,121,0,130,0,6
92407,1,2405,2338,67,0,330,0,8
92408,2,2437,2480,-43,0,45,1,6
92409,2,2443,2328,115,0,190,1,6
92410,1,2409,2354,55,0,300,0,6
92411,2,2747,2634,113,0,277,0,6
92412,1,2498,2397,101,0,101,0,6
92413,2,2263,2457,-194,4,146,0,13
92414,2,2422,2413,9,0,265,0,6
92415,1,2400,2373,27,0,115,1,6
92416,2,2663,2671,-8,0,152,0,6
92417,1,2372,2416,-44,0,43,1,6
92418,2,2423,2429,-6,0,207,0,6
92419,1,2316,2427,-111,0,200,0,6
92420,1,2419,2313,106,0,200,0,6
92421,1,2436,2463,-27,0,40,0,6
92422,2,2523,2638,-115,0,100,1,6
92423,1,2420,2419,1,0,255,0,6
92424,1,2420,2433,-13,0,4,0,6
92426,1,2489,2432,57,0,5,0,6
92427,1,2370,2465,-95,0,45,0,6
92428,1,2393,2448,-55,0,45,1,6
92429,2,2490,2337,153,0,40,0,6
92430,2,2324,2468,-144,0,102,0,6
92431,1,2351,2401,-50,0,401,0,6
92432,2,2303,2455,-152,0,302,0,6
92433,1,2369,2502,-133,0,87,0,6
92434,1,2470,2351,119,0,100,0,6
92435,2,2429,2294,135,0,43,0,6
92436,1,2435,2418,17,0,466,0,6
92437,1,2482,2315,167,0,101,0,6
92438,1,2495,2495,0,0,112,1,6
92439,2,2678,2783,-105,0,242,1,6
92440,3,2262,2424,-162,0,110,0,8
92441,2,2379,2541,-162,0,193,1,6
92442,2,2373,2448,-75,0,101,0,6
92443,1,2426,2369,57,0,130,1,6
92444,2,2419,2416,3,0,405,0,6
92445,1,2598,2437,161,0,385,0,6
92446,1,2476,2390,86,0,4,0,6
92447,2,2252,2433,-181,4,218,1,13
92448,2,2642,2573,69,0,38,0,6
92449,2,2386,2481,-95,0,45,0,6
92450,2,2341,2436,-95,0,278,1,6
92451,1,2407,2370,37,0,200,0,6
92452,1,2336,2458,-122,0,300,0,6
92453,2,2560,2519,41,0,456,0,6
92454,1,2428,2426,2,0,101,1,6
92455,2,2406,2300,106,0,459,0,6
92456,1,2263,2433,-170,0,484,0,6
92457,2,2257,2510,-253,0,242,0,7
92458,1,2461,2508,-47,0,466,1,6
92459,1,2517,2432,85,0,57,0,6
92460,2,2373,2457,-84,0,344,0,6
92461,2,2642,2739,-97,0,301,1,6
92462,1,2232,2567,-335,0,45,0,6
92463,2,2282,2494,-212,0,154,0,6
92464,1,2525,2377,148,0,0,0,6
92465,1,2462,2427,35,0,202,0,6
92466,1,2665,2658,7,0,190,1,6
92467,2,2473,2410,63,0,123,0,6
92468,1,2402,2300,102,0,16,1,6
92469,1,2410,2284,126,0,50,0,8
92470,2,2420,2583,-163,0,41,0,6
92471,2,2558,2559,-1,0,411,0,6
92472,3,2427,2262,165,0,107,0,6
92473,3,2677,2658,19,0,52,0,6
92474,1,2632,2442,190,0,245,0,6
92475,1,2325,2489,-164,0,40,0,6
92476,1,2412,2441,-29,0,334,1,6
92477,1,2345,2482,-137,0,1,0,6
92478,1,2497,2280,217,0,4,1,6
92479,1,2520,2439,81,0,261,0,6
92480,1,2438,2416,22,4,128,0,13
92481,2,2417,2400,17,0,36,0,6
92482,1,2580,2636,-56,0,200,0,6
92483,1,2416,2362,54,0,301,0,6
92484,2,2450,2399,51,0,143,0,6
92485,2,2563,2529,34,0,159,0,6
92486,2,2461,2369,92,0,426,0,6
92487,1,2787,2674,113,0,152,0,6
92488,2,2374,2529,-155,0,45,0,6
92489,1,2452,2368,84,0,4,1,6
92490,2,2489,2467,22,0,5,0,6
92491,1,2343,2442,-99,0,405,1,6
92492,1,2400,2321,79,0,40,0,6
92493,1,2554,2562,-8,0,208,0,6
92494,1,2434,2355,79,0,455,0,6
92495,1,2440,2433,7,0,134,0,6
92496,2,2422,2414,8,0,255,0,6
92497,2,2525,2502,23,0,190,0,6
92498,3,2413,2426,-13,0,153,0,6
92499,1,2444,2362,82,0,104,1,6
92500,1,2408,2431,-23,0,45,0,6
92501,2,2406,2353,53,0,314,1,6
92502,3,2406,2357,49,0,43,0,6
92503,2,2337,2421,-84,0,101,1,6
92504,1,2474,2368,106,0,136,1,6
92505,1,2532,2370,162,0,101,0,6
92506,1,2414,2308,106,0,45,0,6
92507,2,2562,2560,2,0,401,1,6
92508,1,2400,2232,168,0,106,0,6
92509,3,2545,2603,-58,0,143,0,6
92510,1,2493,2524,-31,0,145,0,6
92511,1,2422,2482,-60,0,103,0,6
92512,1,2474,2353,121,0,40,0,6
92513,2,2556,2325,231,0,107,1,6
92514,1,2406,2360,46,0,251,0,6
92515,3,2310,2466,-156,4,131,0,13
92516,2,2428,2425,3,0,41,0,6
92517,2,2670,2791,-121,0,133,0,6
92518,2,2552,2556,-4,0,34,1,6
92519,1,2411,2327,84,0,335,0,8
92520,1,2535,2382,153,0,133,0,6
92521,1,2449,2318,131,0,45,0,6
92522,1,2382,2419,-37,0,107,0,6
92523,2,2587,2615,-28,0,106,0,6
92524,2,2445,2450,-5,0,454,0,6
92525,2,2653,2676,-23,0,398,0,6
92526,2,2469,2429,40,0,4,0,6
92527,1,2560,2557,3,0,45,0,6
92528,2,2390,2499,-109,0,122,1,6
92529,1,2591,2511,80,0,490,0,6
92530,1,2281,2413,-132,0,330,0,8
92531,2,2548,2372,176,0,300,0,6
92532,2,2457,2442,15,0,310,1,6
92533,1,2425,2364,61,0,211,0,6
92534,2,2468,2603,-135,0,466,1,6
92535,2,2562,2483,79,0,231,0,6
92536,2,2309,2415,-106,0,90,1,6
92537,1,2474,2402,72,0,112,0,6
92538,1,2613,2504,109,0,210,0,6
92539,1,2412,2358,54,0,374,0,6
92540,2,2508,2304,204,0,112,1,6
92541,2,2315,2453,-138,0,40,1,6
92542,1,2416,2332,84,0,253,0,6
92543,2,2403,2364,39,0,138,0,6
92544,1,2367,2535,-168,0,45,0,6
92545,1,2347,2417,-70,0,405,0,6
92546,3,2428,2333,95,0,254,0,6
92547,2,2426,2288,138,0,45,0,6
92548,2,2577,2389,188,0,131,1,6
92549,1,2459,2462,-3,0,400,0,6
92550,2,2478,2364,114,0,70,0,6
92551,1,2518,2349,169,0,100,0,6
92552,1,2512,2441,71,0,10,0,6
92553,1,2556,2457,99,0,5,0,6
92554,2,2431,2376,55,0,122,0,6
92555,3,2351,2409,-58,0,398,0,6
92556,1,2401,2292,109,0,151,0,6
92557,2,2620,2582,38,0,355,0,6
92558,1,2500,2422,78,0,150,1,6
92559,1,2597,2566,31,0,113,0,6
92560,2,2405,2595,-190,0,380,0,6
92561,1,2795,2666,129,0,33,0,6
92562,3,2647,2635,12,0,453,0,6
92563,2,2506,2426,80,0,327,0,6
92564,2,2388,2448,-60,0,190,0,6
92565,2,2419,2416,3,0,83,0,6
92566,2,2428,2551,-123,0,466,1,6
92567,2,2443,2546,-103,0,133,0,6
92568,1,2282,2431,-149,0,319,1,6
92569,1,2565,2435,130,0,1,0,6
92570,1,2527,2375,152,0,414,0,6
92571,2,2319,2547,-228,0,70,0,6
92572,1,2424,2565,-141,0,103,1,6
92573,2,2413,2334,79,0,353,0,6
92575,2,2359,2430,-71,0,250,1,6
92576,1,2436,2301,135,0,128,0,6
92577,1,2427,2310,117,4,131,0,13
92578,2,2562,2517,45,0,485,0,6
92579,1,2555,2499,56,0,230,1,6
92580,2,2546,2515,31,0,160,0,6
92581,2,2419,2371,48,0,140,0,6
92582,2,2658,2682,-24,0,46,0,6
92583,3,2473,2490,-17,0,470,0,6
92584,1,2602,2402,200,0,13,0,6
92585,1,2436,2249,187,4,8,0,13
92586,2,2478,2414,64,0,202,0,6
92587,2,2453,2445,8,0,115,0,6
92588,1,2266,2676,-410,4,337,0,8
92589,2,2371,2452,-81,0,134,0,6
92590,1,2470,2560,-90,0,344,1,6
92591,2,2413,2539,-126,0,131,0,6
92592,3,2555,2588,-33,0,101,0,6
92593,2,2335,2401,-66,0,370,0,6
92594,1,2557,2555,2,0,310,0,6
92595,1,2550,2362,188,0,85,0,6
92596,2,2215,2486,-271,4,466,0,23
92597,2,2662,2799,-137,0,20,0,6
92598,2,2371,2402,-31,0,143,0,6
92599,2,2393,2491,-98,0,112,1,6
92600,1,2561,2360,201,0,40,0,6
92601,2,2372,2531,-159,0,40,0,6
92602,1,2418,2504,-86,0,45,0,6
92603,1,2635,2491,144,0,245,0,6
92604,3,2555,2406,149,0,311,0,8
92605,1,2422,2320,102,0,101,1,6
92606,1,2559,2530,29,0,106,0,6
92607,3,2433,2499,-66,0,150,0,6
92608,2,2390,2400,-10,0,17,0,6
92609,3,2485,2521,-36,0,122,0,6
92610,1,2451,2451,0,0,407,0,6
92611,2,2297,2457,-160,0,102,0,6
92612,1,2413,2249,164,0,222,1,6
92613,1,2404,2228,176,4,101,0,13
92614,1,2431,2456,-25,0,255,0,6
92615,1,2434,2354,80,0,211,0,6
92616,3,2606,2539,67,0,464,0,6
92617,1,2524,2407,117,0,246,0,6
92618,1,2463,2542,-79,0,4,1,6
92619,1,2490,2495,-5,0,334,0,6
92620,2,2557,2433,124,0,7,0,6
92621,3,2312,2560,-248,0,302,0,6
92622,1,2408,2246,162,0,4,0,6
92623,1,2389,2502,-113,0,380,0,6
92624,3,2534,2369,165,0,6,0,6
92625,1,2488,2294,194,0,48,0,6
92626,2,2632,2563,69,0,311,0,6
92627,2,2638,2647,-9,0,190,0,6
92628,1,2423,2452,-29,0,103,0,6
92629,1,2447,2569,-122,0,190,1,6
92630,2,2422,2414,8,0,255,0,6
92631,1,2401,2352,49,0,100,0,6
92632,2,2553,2478,75,0,7,0,6
92633,3,2464,2524,-60,0,483,0,6
92634,2,2471,2525,-54,0,112,1,6
92635,3,2450,2438,12,0,211,0,6
92636,1,2478,2316,162,0,172,0,6
92637,3,2803,2659,144,0,106,0,6
92638,2,2406,2386,20,0,426,0,6
92639,2,2587,2563,24,0,243,0,6
92640,2,2453,2439,14,0,380,0,6
92641,1,2416,2287,129,4,267,0,13
92642,2,2371,2531,-160,0,391,0,6
92643,1,2494,2497,-3,0,121,0,6
92644,3,2445,2457,-12,0,15,0,6
92645,1,2316,2427,-111,0,200,0,6
92646,3,2413,2303,110,4,110,0,18
92647,1,2451,2291,160,0,128,0,6
92648,2,2366,2416,-50,0,245,0,6
92649,3,2555,2527,28,0,485,0,6
92650,2,2357,2406,-49,0,4,0,6
92651,2,2405,2434,-29,0,203,0,6
92652,1,2553,2537,16,0,380,0,6
92653,1,2543,2410,133,0,113,0,6
92654,2,2361,2439,-78,0,45,1,6
92655,1,2403,2385,18,0,4,0,6
92656,3,2507,2521,-14,0,478,0,6
92657,2,2442,2540,-98,0,123,0,6
92658,2,2406,2485,-79,0,260,0,6
92659,1,2318,2494,-176,0,126,0,6
92660,2,2489,2557,-68,0,260,0,6
92661,2,2439,2332,107,0,106,0,6
92662,2,2413,2377,36,0,441,0,6
92663,2,2243,2411,-168,0,302,0,6
92664,2,2468,2383,85,0,415,0,6
92665,2,2337,2550,-213,0,45,0,6
92666,1,2476,2481,-5,0,15,0,6
92667,2,2260,2444,-184,4,49,0,13
92668,2,2452,2457,-5,0,265,1,6
92669,2,2445,2311,134,0,330,1,6
92671,3,2541,2605,-64,0,143,0,6
92672,3,2553,2279,274,0,483,0,8
92673,2,2349,2450,-101,0,255,0,6
92675,3,2438,2485,-47,0,255,0,6
92676,2,2408,2233,175,0,405,0,8
92677,1,2353,2406,-53,0,140,0,6
92678,1,2565,2464,101,0,118,0,6
92679,1,2402,2383,19,0,406,0,6
92680,2,2455,2467,-12,0,45,0,6
92681,1,2408,2350,58,0,4,0,6
92682,1,2420,2416,4,0,83,0,6
92683,2,2268,2426,-158,0,154,0,6
92684,3,2661,2801,-140,0,113,0,6
92685,1,2419,2324,95,0,10,0,6
92686,2,2440,2550,-110,0,103,1,6
92687,1,2446,2313,133,0,43,0,6
92688,1,2535,2368,167,0,200,1,6
92689,2,2392,2457,-65,0,337,0,6
92690,2,2411,2491,-80,0,41,0,6
92691,1,2288,2401,-113,0,255,0,6
92692,2,2528,2581,-53,0,134,0,6
92693,2,2454,2294,160,0,133,0,6
92694,2,2349,2481,-132,0,250,0,6
92695,2,2532,2440,92,0,200,1,6
92696,1,2357,2400,-43,0,49,0,6
92697,2,2431,2436,-5,0,242,0,6
92698,1,2499,2449,50,0,111,0,6
92699,2,2246,2439,-193,4,218,0,13
92700,3,2460,2569,-109,0,330,0,6
92701,1,2443,2356,87,0,115,0,6
92702,2,2436,2443,-7,0,31,0,6
92703,2,2561,2555,6,0,215,1,6
92704,2,2295,2402,-107,0,137,0,6
92705,3,2327,2432,-105,0,48,0,6
92706,2,2371,2446,-75,0,332,1,6
92707,1,2484,2439,45,0,484,1,6
92708,1,2475,2484,-9,0,247,0,6
92709,1,2444,2447,-3,0,300,0,6
92710,2,2449,2504,-55,0,302,0,6
92711,2,2372,2461,-89,0,218,1,6
92712,1,2260,2404,-144,0,51,1,6
92713,2,2432,2407,25,0,373,1,6
92714,2,2462,2484,-22,0,44,0,6
92715,2,2320,2423,-103,0,121,0,6
92716,1,2447,2378,69,0,150,0,6
92717,2,2359,2509,-150,0,45,0,6
92718,1,2669,2221,448,2,278,0,18
92719,1,2400,2359,41,0,30,0,6
92720,1,2567,2462,105,0,106,0,6
92722,1,2405,2457,-52,0,226,0,6
92723,1,2345,2413,-68,0,57,1,6
92724,1,2603,2542,61,0,45,0,6
92725,1,2431,2631,-200,0,15,1,6
92726,1,2461,2345,116,0,464,0,6
92727,1,2378,2485,-107,0,277,0,6
92728,1,2798,2663,135,0,110,0,6
92729,2,2421,2407,14,0,45,0,6
92730,1,2320,2426,-106,0,123,0,6
92731,2,2586,2587,-1,0,107,0,6
92732,3,2489,2549,-60,0,11,0,8
92733,2,2400,2361,39,0,145,0,6
92734,1,2490,2478,12,0,255,0,6
92735,1,2406,2352,54,0,344,1,6
92736,2,2440,2444,-4,0,321,0,6
92737,1,2410,2425,-15,0,46,0,6
92738,2,2562,2566,-4,0,401,1,6
92739,1,2442,2243,199,4,202,0,13
92740,2,2314,2429,-115,0,300,0,6
92741,2,2449,2430,19,0,200,1,6
92742,1,2437,2429,8,0,203,0,6
92743,2,2291,2407,-116,0,255,0,6
92744,2,2404,2625,-221,0,15,0,6
92745,2,2298,2426,-128,0,246,0,8
92746,1,2496,2507,-11,0,0,1,6
92747,1,2352,2448,-96,0,45,0,6
92748,2,2458,2571,-113,0,330,0,6
92749,2,2458,2522,-64,0,45,0,6
92750,2,2381,2400,-19,0,245,0,8
92751,1,2554,2436,118,0,7,0,6
92752,2,2402,2450,-48,0,112,0,6
92753,2,2373,2451,-78,0,332,0,6
92754,2,2537,2610,-73,0,143,0,6
92755,1,2414,2266,148,0,315,1,6
92756,1,2456,2525,-69,0,122,0,6
92757,2,2413,2418,-5,0,101,0,6
92758,2,2363,2546,-183,0,45,0,6
92759,2,2405,2495,-90,0,331,1,6
92760,1,2411,2406,5,0,107,0,6
92761,1,2257,2464,-207,0,253,1,6
92762,1,2421,2287,134,0,302,1,8
92763,2,2204,2554,-350,0,45,0,6
92764,1,2488,2473,15,0,46,0,6
92765,3,2453,2428,25,0,107,0,6
92766,1,2512,2500,12,0,302,1,6
92767,2,2294,2439,-145,0,246,0,6
92768,2,2434,2287,147,0,392,1,6
92769,2,2455,2569,-114,0,303,0,6
92770,1,2623,2465,158,0,103,0,6
92771,1,2418,2554,-136,0,41,0,6
92772,1,2318,2481,-163,0,205,0,6
92773,1,2405,2263,142,0,406,0,8
92774,1,2510,2454,56,0,315,0,6
92775,3,2413,2349,64,0,140,0,6
92776,1,2418,2389,29,0,11,0,6
92777,2,2396,2452,-56,0,211,0,6
92778,2,2660,2802,-142,0,218,0,6
92779,1,2443,2347,96,0,250,1,6
92780,2,2407,2436,-29,0,0,0,6
92781,1,2303,2424,-121,0,22,0,6
92782,1,2455,2432,23,0,250,0,6
92783,1,2556,2581,-25,0,0,1,6
92784,1,2463,2358,105,0,121,0,6
92785,1,2485,2489,-4,0,292,0,6
92786,2,2524,2421,103,0,469,0,6
92787,1,2518,2502,16,0,45,0,6
92788,2,2419,2416,3,0,83,0,6
92789,1,2316,2457,-141,0,255,0,6
92790,1,2435,2522,-87,0,241,0,6
92791,1,2401,2387,14,0,107,0,6
92792,2,2441,2359,82,0,115,1,6
92793,2,2461,2626,-165,0,120,0,6
92794,1,2471,2411,60,0,0,0,6
92795,2,2401,2462,-61,0,174,1,6
92796,3,2406,2432,-26,0,101,0,6
92797,3,2584,2248,336,4,220,0,13
92799,1,2457,2391,66,0,127,0,6
92800,1,2416,2314,102,0,210,0,6
92801,3,2424,2442,-18,0,277,0,6
92802,2,2422,2397,25,0,4,0,6
92803,2,2408,2328,80,0,200,0,6
92804,1,2526,2481,45,0,56,1,6
92805,1,2368,2502,-134,0,107,0,6
92806,2,2211,2502,-291,0,45,0,6
92807,1,2452,2443,9,0,229,1,6
92808,1,2262,2425,-163,0,45,0,6
92809,2,2274,2573,-299,4,101,0,13
92810,1,2427,2420,7,0,121,0,6
92811,1,2449,2515,-66,0,426,0,6
92812,1,2473,2277,196,0,57,0,8
92813,1,2310,2440,-130,0,43,1,6
92814,2,2428,2535,-107,0,157,1,6
92815,2,2461,2451,10,0,119,0,6
92816,2,2467,2494,-27,0,102,0,6
92817,2,2561,2518,43,0,42,1,6
92818,1,2429,2312,117,0,491,0,8
92819,1,2555,2217,338,0,119,1,6
92820,1,2397,2493,-96,0,0,0,6
92821,1,2515,2442,73,0,45,0,6
92822,1,2617,2532,85,0,491,1,6
92823,2,2549,2244,305,0,343,1,6
92824,1,2240,2445,-205,4,218,0,13
92825,3,2578,2264,314,4,220,0,13
92826,1,2497,2440,57,0,46,0,6
92827,1,2369,2467,-98,0,85,1,6
92828,2,2400,2297,103,0,132,0,6
92829,1,2534,2401,133,0,5,0,6
92830,2,2406,2296,110,0,34,1,6
92831,3,2476,2491,-15,0,0,0,6
92832,2,2359,2456,-97,0,453,1,6
92833,3,2318,2455,-137,0,310,0,6
92834,1,2402,2402,0,0,51,0,6
92835,1,2483,2442,41,0,380,0,6
92836,1,2806,2656,150,0,270,0,6
92837,2,2353,2447,-94,0,21,0,6
92838,1,2575,2562,13,0,132,0,6
92839,1,2402,2412,-10,0,58,0,6
92840,2,2241,2403,-162,0,255,0,6
92841,1,2614,2561,53,0,409,1,6
92842,1,2449,2457,-8,0,380,0,6
92843,2,2263,2426,-163,0,306,0,6
92844,2,2521,2387,134,0,300,1,6
92845,2,2460,2494,-34,0,107,1,6
92846,1,2366,2434,-68,0,45,0,6
92847,1,2633,2629,4,0,123,0,6
92848,1,2455,2342,113,0,100,0,6
92849,1,2406,2396,10,0,120,0,6
92850,1,2406,2476,-70,0,150,0,6
92851,2,2508,2456,52,0,315,1,6
92852,2,2274,2476,-202,0,288,0,8
92853,1,2438,2520,-82,0,241,0,6
92854,2,2435,2407,28,0,107,0,6
92855,1,2303,2417,-114,0,301,0,6
92856,2,2524,2398,126,0,400,0,6
92857,1,2580,2558,22,0,154,0,6
92858,2,2465,2409,56,0,140,0,8
92859,2,2524,2573,-49,0,46,0,6
92860,2,2433,2396,37,0,21,0,6
92861,1,2456,2284,172,0,71,0,6
92862,3,2445,2386,59,0,313,0,6
92863,1,2440,2242,198,0,343,0,6
92865,2,2499,2639,-140,0,106,1,6
92866,1,2479,2271,208,0,58,0,8
92867,2,2424,2435,-11,0,216,0,6
92868,3,2413,2383,30,0,311,0,6
92869,3,2437,2488,-51,0,8,0,6
92870,1,2501,2307,194,0,46,0,6
92871,1,2433,2602,-169,0,409,1,8
92872,3,2453,2320,133,0,102,0,6
92873,1,2490,2513,-23,0,107,1,6
92874,2,2495,2352,143,0,200,1,6
92875,1,2476,2368,108,0,0,1,6
92876,3,2422,2247,175,0,107,0,6
92877,2,2452,2455,-3,0,46,0,6
92878,2,2376,2432,-56,0,57,0,6
92879,1,2211,2557,-346,0,110,1,6
92880,1,2486,2318,168,0,40,0,6
92881,2,2653,2809,-156,0,28,0,6
92882,2,2478,2337,141,0,128,0,6
92883,2,2406,2303,103,0,380,0,6
92884,3,2451,2349,102,0,152,0,6
92885,2,2312,2401,-89,0,371,0,6
92886,3,2433,2355,78,0,106,0,6
92887,1,2399,2408,-9,0,130,0,6
92888,2,2272,2401,-129,0,267,0,6
92889,1,2520,2602,-82,0,13,0,6
92890,1,2417,2367,50,0,130,0,6
92891,2,2593,2445,148,0,28,0,6
92892,2,2619,2673,-54,0,83,0,6
92893,1,2413,2516,-103,0,80,1,6
92894,1,2578,2395,183,0,15,0,6
92895,2,2427,2373,54,0,115,0,6
92896,2,2403,2419,-16,0,109,0,6
92897,2,2441,2453,-12,0,106,1,6
92898,2,2513,2515,-2,0,161,1,6
92899,1,2553,2586,-33,0,101,0,6
92900,1,2311,2448,-137,0,175,0,6
92901,1,2410,2408,2,0,309,1,6
92902,2,2206,2505,-299,0,45,0,6
92903,2,2422,2504,-82,0,107,1,6
92904,2,2556,2571,-15,0,335,0,6
92905,1,2377,2459,-82,0,300,0,6
92906,2,2271,2430,-159,0,335,0,8
92907,2,2552,2510,42,0,88,0,6
92908,1,2406,2405,1,0,337,0,6
92909,1,2380,2444,-64,0,301,0,6
92910,1,2588,2585,3,0,241,0,6
92911,2,2528,2623,-95,0,143,0,6
92912,1,2488,2452,36,0,84,1,6
92913,2,2405,2489,-84,0,264,0,6
92914,2,2535,2490,45,0,250,0,6
92915,1,2402,2397,5,0,130,0,6
92916,2,2437,2424,13,0,109,1,6
92917,2,2437,2445,-8,0,456,1,6
92918,2,2315,2411,-96,0,324,0,6
92919,2,2329,2427,-98,0,470,0,6
92920,1,2322,2451,-129,0,314,0,6
92921,2,2496,2495,1,0,108,0,6
92922,1,2463,2500,-37,0,107,0,6
92923,1,2309,2404,-95,0,228,0,6
92925,1,2507,2496,11,0,300,0,6
92926,2,2392,2450,-58,0,123,1,6
92927,1,2505,2453,52,0,190,0,6
92928,2,2447,2282,165,4,105,0,13
92929,1,2413,2371,42,0,343,1,6
92930,1,2400,2351,49,0,47,1,6
92931,1,2414,2264,150,0,20,1,6
92932,2,2269,2482,-213,0,107,0,8
92933,2,2283,2409,-126,0,246,1,8
92934,1,2494,2312,182,0,48,0,6
92935,2,2380,2420,-40,0,40,1,6
92936,2,2502,2527,-25,0,426,1,6
92937,3,2313,2459,-146,0,0,0,6
92938,1,2537,2421,116,0,41,0,6
92939,1,2415,2355,60,0,302,1,6
92940,1,2579,2559,20,0,154,0,6
92941,1,2461,2435,26,0,143,1,6
92942,1,2496,2509,-13,0,110,0,6
92943,1,2429,2406,23,0,113,0,6
92944,1,2541,2417,124,0,10,0,6
92945,1,2440,2367,73,0,5,0,6
92946,1,2579,2507,72,0,469,0,6
92947,2,2452,2599,-147,0,106,0,6
92948,1,2653,2602,51,0,330,1,6
92949,1,2400,2509,-109,0,484,0,6
92950,1,2507,2361,146,0,453,1,6
92951,1,2435,2282,153,0,113,0,6
92952,3,2388,2415,-27,0,9,0,6
92953,3,2485,2542,-57,0,17,0,6
92954,1,2437,2249,188,4,8,0,13
92955,1,2415,2281,134,0,107,1,6
92956,1,2412,2332,80,0,43,0,6
92957,2,2470,2392,78,0,100,0,6
92958,2,2360,2413,-53,0,58,0,6
92959,1,2415,2330,85,0,45,0,6
92960,2,2319,2493,-174,0,269,0,6
92961,1,2468,2629,-161,0,140,0,6
92962,1,2490,2491,-1,0,343,0,6
92963,1,2401,2386,15,0,106,0,6
92964,1,2501,2550,-49,0,7,0,6
92965,1,2503,2403,100,0,120,0,6
92966,1,2432,2497,-65,0,140,0,6
92967,2,2594,2266,328,0,480,1,8
92968,1,2331,2419,-88,0,2,0,6
92969,1,2446,2460,-14,0,45,0,6
92970,1,2366,2431,-65,0,57,0,6
92971,2,2469,2494,-25,0,130,0,6
92972,2,2455,2387,68,0,45,0,6
92973,2,2430,2418,12,0,264,0,6
92974,1,2605,2613,-8,0,123,1,6
92975,2,2363,2489,-126,0,207,1,6
92976,2,2412,2448,-36,0,332,1,6
92977,1,2346,2405,-59,0,10,0,6
92978,3,2493,2307,186,0,1,0,6
92979,2,2532,2565,-33,0,9,0,6
92980,3,2436,2377,59,4,107,0,13
92981,1,2424,2373,51,0,45,1,6
92982,3,2424,2386,38,0,337,0,6
92983,1,2470,2569,-99,0,218,0,6
92984,2,2553,2585,-32,0,101,1,6
92985,1,2505,2351,154,0,41,0,6
92986,2,2406,2413,-7,0,107,0,6
92987,3,2394,2468,-74,0,118,0,6
92988,2,2442,2406,36,0,200,1,6
92989,1,2288,2406,-118,0,123,0,6
92990,1,2614,2545,69,0,60,0,6
92991,2,2501,2445,56,0,0,0,6
92992,2,2374,2461,-87,0,16,0,6
92993,1,2362,2411,-49,0,102,0,6
92994,1,2430,2450,-20,0,244,0,6
92995,2,2366,2411,-45,4,241,0,34
92996,1,2582,2407,175,0,40,0,6
92997,1,2541,2496,45,0,57,0,6
92998,1,2319,2486,-167,0,30,0,6
92999,2,2485,2408,77,0,143,0,6
93000,3,2277,2418,-141,0,101,0,6
93001,1,2415,2334,81,0,13,0,6
93002,2,2454,2452,2,0,380,1,6
93003,1,2583,2683,-100,0,152,1,6
93004,1,2440,2281,159,0,11,0,8
93005,1,2507,2464,43,0,4,0,6
93006,1,2388,2438,-50,0,4,0,6
93007,2,2399,2561,-162,0,0,1,6
93008,1,2463,2352,111,0,140,1,6
93009,1,2445,2401,44,0,310,0,6
93010,2,2490,2315,175,0,48,0,6
93011,2,2461,2496,-35,0,225,0,6
93012,2,2275,2424,-149,0,46,1,6
93013,2,2302,2476,-174,0,200,0,6
93014,1,2424,2495,-71,0,100,0,6
93015,1,2313,2451,-138,0,337,0,6
93016,2,2458,2507,-49,0,110,0,6
93018,2,2365,2431,-66,0,45,0,6
93019,1,2493,2491,2,0,316,1,6
93020,3,2552,2478,74,0,409,0,6
93021,1,2427,2253,174,0,110,0,6
93022,2,2327,2438,-111,0,321,1,6
93023,2,2424,2419,5,0,30,1,6
93024,1,2418,2279,139,0,40,1,8
93025,1,2416,2433,-17,0,40,0,6
93026,1,2607,2540,67,0,53,0,6
93027,2,2325,2452,-127,0,200,0,6
93028,1,2448,2473,-25,0,40,0,6
93029,2,2590,2548,42,0,154,1,6
93030,2,2415,2478,-63,0,311,0,6
93031,2,2454,2338,116,0,240,0,6
93032,2,2436,2407,29,0,150,0,6
93033,3,2555,2490,65,0,10,0,6
93034,2,2467,2412,55,0,107,0,6
93035,1,2423,2482,-59,0,310,1,6
93036,1,2405,2422,-17,0,250,0,6
93037,3,2466,2395,71,0,45,0,6
93038,1,2362,2421,-59,0,477,0,6
93039,2,2401,2407,-6,0,258,0,6
93040,2,2436,2657,-221,0,242,1,6
93041,2,2297,2584,-287,0,394,0,8
93042,1,2443,2303,140,0,7,0,6
93043,1,2527,2512,15,0,265,0,6
93044,1,2501,2459,42,0,354,0,6
93045,1,2379,2435,-56,4,127,0,13
93046,1,2321,2425,-104,0,267,0,6
93047,2,2585,2541,44,0,104,0,6
93048,1,2458,2449,9,0,46,0,6
93049,2,2360,2458,-98,0,4,0,6
93050,1,2510,2351,159,0,12,0,6
93051,2,2247,2440,-193,4,218,0,13
93052,2,2676,2591,85,0,272,0,6
93053,1,2365,2424,-59,0,395,0,6
93054,1,2348,2467,-119,0,345,1,6
93055,1,2485,2419,66,0,107,0,6
93056,3,2427,2406,21,0,14,0,6
93057,1,2368,2432,-64,0,41,1,6
93058,2,2424,2483,-59,0,135,0,6
93059,1,2424,2393,31,0,474,0,6
93060,1,2488,2315,173,0,0,0,6
93061,2,2373,2403,-30,0,50,0,6
93062,1,2565,2616,-51,0,320,0,6
93063,2,2499,2391,108,0,13,1,6
93064,1,2414,2490,-76,0,203,0,6
93065,1,2554,2485,69,0,11,1,6
93066,2,2514,2301,213,0,15,0,6
93067,1,2396,2413,-17,0,249,0,6
93069,2,2289,2414,-125,0,8,0,6
93070,2,2341,2422,-81,0,43,1,6
93071,1,2531,2584,-53,0,107,0,6
93072,2,2417,2339,78,0,100,1,6
93073,1,2479,2446,33,0,325,0,6
93074,1,2551,2584,-33,0,403,1,6
93075,1,2346,2411,-65,0,102,1,6
93076,1,2442,2368,74,0,0,0,6
93077,1,2441,2317,124,0,107,0,6
93078,2,2352,2443,-91,0,300,0,6
93079,1,2454,2396,58,0,135,0,6
93080,3,2456,2321,135,0,150,0,6
93081,2,2299,2409,-110,0,122,0,6
93082,1,2410,2274,136,0,404,0,6
93083,2,2506,2612,-106,0,380,0,6
93084,2,2373,2488,-115,0,200,0,6
93085,1,2267,2459,-192,0,127,0,8
93086,2,2375,2491,-116,0,107,0,6
93087,1,2425,2300,125,0,106,0,6
93088,1,2430,2299,131,0,110,0,6
93089,1,2547,2447,100,0,107,1,6
93090,1,2362,2597,-235,0,107,0,6
93091,1,2443,2413,30,0,190,1,6
93092,3,2394,2446,-52,0,47,0,6
93093,1,2404,2352,52,0,255,0,6
93094,2,2463,2598,-135,0,229,0,6
93095,1,2491,2310,181,0,1,1,6
93096,2,2660,2668,-8,0,382,0,6
93097,2,2399,2429,-30,0,210,0,6
93098,2,2427,2507,-80,0,15,1,6
93099,1,2418,2329,89,0,103,0,6
93100,1,2512,2555,-43,0,32,0,6
93101,2,2292,2417,-125,0,453,0,6
93102,1,2443,2464,-21,0,380,0,6
93103,2,2544,2532,12,0,41,0,6
93104,2,2459,2488,-29,0,135,0,6
93105,1,2388,2441,-53,0,270,0,6
93106,1,2467,2391,76,0,490,0,6
93107,1,2484,2426,58,0,492,0,6
93108,1,2443,2244,199,4,200,0,13
93109,2,2291,2429,-138,0,16,0,6
93110,1,2459,2356,103,0,36,0,6
93111,2,2211,2428,-217,4,42,0,13
93113,3,2375,2469,-94,0,338,0,6
93114,1,2413,2395,18,0,265,1,6
93115,1,2448,2351,97,0,133,0,6
93116,1,2408,2581,-173,0,25,1,6
93117,1,2578,2538,40,0,469,0,6
93118,1,2407,2324,83,0,128,0,6
93119,1,2422,2316,106,0,107,0,8
93120,2,2572,2559,13,0,385,0,6
93121,2,2422,2394,28,0,102,0,6
93122,1,2400,2359,41,0,5,0,6
93123,1,2481,2604,-123,0,325,1,6
93124,1,2674,2653,21,0,242,0,6
93125,1,2246,2435,-189,0,261,1,6
93126,3,2417,2503,-86,0,122,0,8
93127,1,2314,2440,-126,0,64,0,6
93128,2,2409,2455,-46,0,132,0,6
93129,2,2334,2426,-92,0,484,0,6
93130,2,2476,2504,-28,0,123,0,6
93131,1,2578,2558,20,0,128,0,6
93132,2,2413,2348,65,0,337,1,6
93133,1,2279,2429,-150,0,192,0,6
93134,1,2457,2373,84,0,101,0,6
93135,1,2455,2502,-47,0,269,0,6
93137,1,2409,2485,-76,0,321,1,6
93138,2,2295,2459,-164,0,110,0,6
93139,2,2406,2402,4,0,202,0,6
93140,2,2420,2311,109,0,4,1,6
93141,2,2215,2586,-371,0,140,0,8
93142,2,2225,2427,-202,0,474,0,6
93143,1,2453,2434,19,0,250,0,6
93144,1,2433,2547,-114,0,130,0,6
93145,2,2460,2402,58,0,3,0,6
93146,2,2387,2472,-85,0,117,0,6
93147,2,2458,2449,9,0,45,0,6
93148,2,2422,2386,36,0,218,0,6
93149,1,2445,2346,99,0,85,1,6
93150,1,2433,2377,56,0,426,1,6
93151,1,2422,2372,50,0,130,0,6
93152,2,2463,2463,0,0,120,0,6
93153,2,2507,2357,150,0,9,1,6
93154,2,2419,2292,127,0,110,0,6
93155,1,2495,2325,170,0,7,0,6
93156,2,2490,2512,-22,0,466,1,6
93157,2,2451,2401,50,0,102,0,6
93158,1,2459,2363,96,0,106,0,6
93159,1,2548,2538,10,0,208,0,6
93160,2,2323,2454,-131,0,335,1,6
93161,2,2496,2461,35,0,324,1,6
93162,3,2493,2489,4,0,242,0,6
93163,2,2435,2307,128,0,330,1,6
93164,1,2552,2583,-31,0,403,0,6
93165,2,2433,2229,204,4,85,0,13
93166,2,2649,2680,-31,0,193,1,6
93167,3,2437,2376,61,0,14,0,6
93168,2,2494,2353,141,0,1,1,6
93169,3,2616,2583,33,0,107,0,6
93170,1,2432,2471,-39,0,190,1,6
93171,1,2354,2405,-51,0,134,1,6
93172,2,2404,2402,2,0,150,0,6
93173,1,2491,2646,-155,0,302,0,6
93174,2,2408,2359,49,0,113,0,6
93175,2,2453,2448,5,0,40,0,6
93176,1,2400,2427,-27,0,270,0,6
93177,1,2424,2415,9,0,490,0,6
93178,1,2565,2471,94,0,35,0,6
93179,2,2320,2498,-178,0,100,0,6
93180,2,2264,2421,-157,0,45,0,6
93181,2,2406,2378,28,0,454,1,6
93182,1,2591,2395,196,0,123,0,6
93183,2,2488,2453,35,0,80,1,6
93184,3,2254,2401,-147,0,106,0,6
93185,3,2327,2421,-94,0,271,0,6
93186,1,2499,2334,165,0,15,0,6
93187,2,2310,2426,-116,0,269,0,8
93188,1,2550,2445,105,0,124,0,6
93189,2,2540,2658,-118,0,39,0,6
93190,1,2390,2418,-28,0,190,0,6
93191,2,2408,2368,40,0,9,1,6
93192,2,2296,2443,-147,0,46,0,6
93193,2,2450,2381,69,0,72,0,6
93194,1,2455,2418,37,0,123,0,6
93195,2,2412,2396,16,0,265,0,6
93196,1,2421,2330,91,0,103,0,6
93197,2,2383,2518,-135,0,123,0,6
93198,1,2489,2566,-77,0,15,0,6
93199,2,2416,2353,63,0,100,1,6
93200,1,2406,2341,65,0,233,1,6
93201,1,2493,2469,24,0,172,1,6
93202,2,2573,2399,174,0,301,0,6
93203,2,2299,2456,-157,0,201,0,6
93204,2,2457,2501,-44,0,156,0,6
93205,2,2346,2447,-101,0,140,0,6
93206,2,2454,2427,27,0,210,0,6
93207,1,2410,2429,-19,0,190,0,6
93208,1,2577,2558,19,0,128,0,6
93209,2,2240,2403,-163,0,110,0,6
93210,1,2502,2569,-67,0,267,0,6
93211,2,2380,2484,-104,0,300,1,6
93212,2,2367,2418,-51,0,58,0,8
93213,2,2554,2637,-83,0,242,1,6
93214,3,2415,2219,196,0,246,0,6
93216,2,2421,2407,14,0,151,0,6
93217,1,2435,2421,14,0,202,0,6
93218,1,2272,2431,-159,0,130,1,6
93219,1,2411,2372,39,0,152,0,6
93220,1,2685,2643,42,0,270,0,6
93221,2,2547,2439,108,0,46,1,6
93222,2,2465,2489,-24,0,331,0,6
93223,2,2533,2553,-20,0,321,0,6
93224,1,2501,2436,65,0,10,0,6
93225,1,2425,2317,108,0,382,0,6
93226,1,2366,2414,-48,0,140,0,6
93227,1,2482,2486,-4,0,107,0,6
93228,2,2441,2301,140,0,7,0,6
93229,1,2370,2495,-125,0,353,0,6
93230,2,2451,2509,-58,0,45,0,6
93231,2,2375,2536,-161,0,40,0,6
93232,1,2306,2411,-105,0,463,0,6
93233,2,2352,2499,-147,0,331,1,6
93235,1,2400,2459,-59,0,80,0,6
93236,1,2503,2374,129,0,4,0,6
93237,2,2366,2562,-196,0,278,0,6
93238,1,2448,2296,152,0,101,0,6
93239,2,2522,2423,99,0,45,1,6
93240,1,2509,2420,89,0,271,1,6
93241,3,2478,2447,31,0,245,0,6
93242,2,2433,2416,17,0,58,0,6
93243,1,2416,2392,24,0,135,0,6
93244,1,2403,2299,104,0,338,1,6
93245,2,2311,2417,-106,0,49,1,6
93246,2,2570,2443,127,0,279,0,6
93247,2,2379,2536,-157,0,115,0,6
93248,1,2464,2320,144,0,200,0,6
93249,2,2241,2446,-205,4,218,0,13
93250,1,2558,2476,82,0,330,0,6
93251,1,2429,2367,62,0,335,0,6
93252,1,2607,2525,82,0,130,0,6
93253,2,2506,2413,93,0,130,1,6
93254,2,2313,2452,-139,0,255,0,6
93255,1,2411,2274,137,0,310,0,6
93256,2,2654,2488,166,0,103,0,6
93257,1,2375,2401,-26,0,102,0,6
93258,2,2481,2528,-47,0,1,0,6
93259,2,2509,2481,28,0,400,0,6
93260,1,2412,2377,35,0,150,0,6
93261,1,2388,2496,-108,0,45,1,6
93262,1,2293,2433,-140,0,45,1,6
93263,1,2409,2313,96,0,213,0,6
93264,2,2573,2582,-9,0,355,0,6
93265,1,2464,2367,97,0,345,0,6
93267,3,2412,2289,123,0,311,0,6
93268,2,2337,2447,-110,0,2,1,6
93269,2,2432,2361,71,0,4,0,6
93270,2,2362,2433,-71,0,151,0,6
93271,2,2326,2404,-78,0,249,1,6
93272,2,2404,2524,-120,0,321,0,6
93273,2,2452,2496,-44,0,107,0,6
93274,2,2312,2468,-156,0,46,1,6
93275,1,2401,2376,25,0,20,0,8
93276,1,2642,2550,92,0,466,0,6
93277,1,2539,2451,88,0,4,1,6
93278,1,2495,2356,139,0,352,0,6
93279,2,2337,2441,-104,0,216,0,6
93280,1,2511,2374,137,0,310,0,6
93281,2,2376,2455,-79,0,415,0,6
93282,2,2293,2465,-172,0,202,0,6
93283,2,2329,2502,-173,0,132,1,8
93284,2,2222,2412,-190,0,150,0,6
93285,1,2413,2407,6,0,0,1,6
93286,1,2516,2645,-129,0,325,0,6
93287,2,2317,2446,-129,0,426,0,6
93288,1,2540,2430,110,0,48,0,6
93289,1,2565,2559,6,0,331,0,6
93290,1,2431,2287,144,4,250,0,13
93291,1,2540,2372,168,0,18,0,6
93292,1,2465,2376,89,0,16,0,6
93293,1,2387,2421,-34,0,15,1,6
93294,1,2440,2325,115,0,5,0,8
93295,1,2490,2451,39,0,43,1,6
93296,1,2451,2377,74,0,45,0,6
93297,1,2487,2337,150,0,101,0,6
93298,1,2407,2240,167,0,453,0,6
93299,1,2503,2348,155,0,46,0,6
93300,1,2453,2456,-3,0,2,0,6
93301,1,2424,2450,-26,0,103,0,6
93302,2,2369,2543,-174,0,40,0,6
93303,2,2352,2498,-146,0,220,1,6
93304,1,2445,2498,-53,0,292,0,6
93305,2,2309,2449,-140,0,101,0,6
93306,2,2415,2355,60,0,150,1,6
93307,2,2514,2520,-6,0,353,0,6
93308,1,2362,2514,-152,0,129,1,6
93309,3,2400,2544,-144,0,415,0,6
93310,2,2416,2368,48,0,4,1,6
93311,2,2472,2563,-91,0,311,0,6
93312,3,2540,2421,119,0,40,0,6
93313,1,2547,2396,151,0,49,0,6
93314,1,2527,2347,180,0,404,0,6
93315,2,2553,2571,-18,0,338,0,6
93316,2,2420,2499,-79,0,80,1,6
93317,1,2450,2302,148,0,132,0,6
93318,1,2329,2514,-185,0,43,0,6
93319,2,2425,2257,168,0,270,0,6
93320,1,2444,2325,119,0,27,0,6
93321,2,2438,2386,52,0,419,0,6
93322,1,2424,2336,88,4,118,1,13
93323,1,2294,2403,-109,0,16,0,6
93325,2,2431,2411,20,0,101,0,6
93326,2,2545,2647,-102,0,242,0,6
93327,2,2249,2402,-153,0,242,1,8
93328,1,2427,2476,-49,0,53,0,6
93329,1,2487,2378,109,0,40,1,6
93330,2,2425,2418,7,0,5,0,6
93331,3,2588,2530,58,0,215,0,6
93332,2,2404,2508,-104,0,0,0,6
93333,1,2376,2423,-47,0,40,1,6
93334,1,2526,2525,1,0,138,0,6
93335,1,2472,2515,-43,0,310,0,6
93336,1,2332,2447,-115,0,1,1,6
93337,2,2442,2404,38,0,122,0,6
93338,2,2345,2447,-102,0,335,0,6
93339,3,2445,2332,113,0,100,0,6
93340,1,2448,2468,-20,0,13,0,6
93341,3,2272,2440,-168,0,123,0,6
93342,2,2460,2544,-84,0,484,0,6
93343,1,2612,2455,157,0,140,0,6
93344,1,2447,2456,-9,0,9,0,6
93345,1,2326,2419,-93,0,134,0,6
93346,1,2424,2414,10,0,154,0,6
93347,2,2371,2470,-99,0,123,0,6
93348,1,2442,2567,-125,0,20,1,6
93349,2,2392,2580,-188,0,311,0,6
93350,3,2210,2465,-255,0,119,0,6
93351,1,2435,2304,131,4,120,0,13
93352,3,2418,2355,63,0,319,0,6
93353,2,2576,2548,28,0,13,0,6
93354,1,2305,2410,-105,0,167,1,6
93355,3,2495,2503,-8,0,302,0,6
93356,2,2462,2290,172,0,40,0,6
93357,2,2412,2333,79,0,302,1,6
93359,1,2406,2308,98,0,106,0,6
93360,1,2450,2459,-9,0,135,0,6
93361,1,2596,2582,14,0,123,0,6
93362,2,2451,2341,110,0,144,1,6
93363,2,2546,2530,16,0,17,1,6
93364,1,2419,2410,9,0,45,0,6
93365,1,2542,2409,133,0,302,0,6
93366,2,2420,2467,-47,0,303,0,6
93367,1,2452,2358,94,0,45,0,6
93368,1,2334,2434,-100,0,245,0,6
93369,1,2503,2403,100,0,106,0,6
93370,1,2300,2403,-103,0,45,0,6
93371,2,2346,2431,-85,0,192,1,6
93372,1,2393,2409,-16,0,253,1,6
93373,2,2400,2425,-25,0,0,0,6
93374,3,2562,2596,-34,0,312,0,6
93375,1,2509,2499,10,0,312,0,6
93376,2,2531,2541,-10,0,45,0,6
93377,2,2367,2455,-88,0,268,0,6
93378,2,2261,2524,-263,0,405,0,8
93379,2,2410,2318,92,0,108,0,6
93380,1,2400,2298,102,0,300,0,6
93381,1,2453,2368,85,0,110,0,6
93382,1,2469,2467,2,0,1,1,6
93383,2,2454,2440,14,0,40,1,6
93384,2,2365,2508,-143,0,46,0,6
93385,3,2298,2475,-177,0,454,0,6
93386,2,2404,2404,0,0,484,0,6
93387,1,2365,2434,-69,0,210,0,6
93388,1,2587,2551,36,0,104,0,6
93389,1,2496,2467,29,0,338,0,6
93390,1,2560,2450,110,0,108,0,6
93391,1,2583,2464,119,0,213,0,6
93392,2,2405,2545,-140,0,113,0,6
93393,1,2503,2495,8,0,326,0,6
93394,2,2374,2491,-117,0,112,0,6
93395,1,2483,2375,108,0,211,0,6
93396,2,2527,2605,-78,0,304,0,6
93397,1,2577,2399,178,0,106,0,6
93398,2,2271,2417,-146,0,123,0,6
93399,2,2353,2403,-50,0,43,1,6
93400,1,2403,2327,76,0,343,0,6
93401,1,2554,2570,-16,0,317,0,6
93402,1,2453,2456,-3,0,3,0,6
93403,1,2321,2456,-135,0,458,0,6
93404,1,2460,2425,35,0,41,0,6
93405,1,2405,2212,193,0,43,0,6
93406,1,2463,2348,115,0,140,0,6
93408,1,2444,2323,121,0,203,0,6
93409,2,2406,2341,65,0,115,0,6
93410,1,2427,2475,-48,0,53,0,6
93411,1,2430,2346,84,0,107,0,6
93412,2,2526,2538,-12,0,41,0,6
93413,3,2521,2593,-72,0,4,0,6
93414,3,2399,2462,-63,0,343,0,6
93415,3,2239,2401,-162,4,190,0,13
93416,1,2493,2379,114,0,123,0,6
93417,3,2436,2382,54,0,31,0,6
93418,1,2490,2510,-20,0,312,0,6
93419,1,2396,2580,-184,0,58,0,6
93420,1,2346,2427,-81,0,212,1,6
93421,2,2283,2425,-142,0,302,1,8
93422,1,2416,2403,13,0,45,0,6
93423,1,2587,2399,188,0,113,0,6
93424,1,2449,2238,211,4,200,0,13
93425,2,2446,2564,-118,0,13,1,6
93426,1,2492,2450,42,0,100,0,6
93427,1,2425,2382,43,0,343,0,8
93428,2,2297,2460,-163,0,151,0,6
93429,1,2355,2480,-125,4,110,0,8
93430,1,2538,2493,45,0,136,0,6
93431,1,2405,2269,136,0,300,0,6
93432,2,2430,2427,3,0,216,0,6
93433,1,2410,2308,102,0,163,0,6
93434,2,2323,2407,-84,0,47,0,6
93435,2,2460,2451,9,0,120,0,6
93436,3,2531,2592,-61,0,101,0,6
93437,1,2446,2398,48,0,40,1,6
93438,2,2546,2381,165,0,101,1,6
93439,2,2450,2459,-9,0,135,0,6
93440,2,2473,2514,-41,0,113,1,6
93441,1,2472,2430,42,0,46,0,6
93442,1,2348,2402,-54,0,250,1,6
93443,2,2547,2510,37,0,127,0,6
93444,1,2426,2443,-17,0,45,0,6
93445,2,2421,2386,35,0,264,1,6
93446,1,2448,2358,90,0,205,1,6
93447,2,2319,2435,-116,0,464,1,6
93448,3,2520,2350,170,0,45,0,6
93449,2,2502,2496,6,0,326,0,6
93450,1,2337,2467,-130,0,1,0,6
93451,1,2563,2590,-27,0,346,1,6
93452,2,2320,2501,-181,0,400,1,6
93453,2,2340,2435,-95,0,202,0,6
93454,2,2404,2500,-96,0,464,0,6
93455,2,2572,2558,14,0,245,0,6
93456,2,2408,2288,120,0,43,0,6
93457,1,2690,2612,78,0,108,0,6
93458,3,2413,2376,37,0,7,0,6
93459,2,2335,2408,-73,0,156,1,6
93460,2,2276,2548,-272,0,246,0,8
93461,2,2448,2365,83,0,45,0,6
93462,1,2402,2367,35,4,4,0,13
93463,1,2502,2495,7,0,312,0,6
93464,2,2378,2435,-57,0,2,1,6
93465,1,2542,2548,-6,0,127,0,6
93466,1,2488,2543,-55,0,292,0,6
93467,1,2415,2240,175,0,101,0,6
93468,1,2541,2523,18,0,145,0,6
93469,2,2431,2517,-86,0,463,1,6
93470,1,2241,2420,-179,0,300,1,6
93471,1,2348,2509,-161,0,101,1,6
93472,1,2497,2430,67,0,167,1,6
93473,2,2348,2425,-77,0,123,0,6
93474,1,2433,2415,18,0,310,0,6
93475,2,2354,2463,-109,0,1,0,6
93476,3,2469,2589,-120,0,1,0,6
93477,1,2461,2228,233,0,405,0,6
93478,1,2417,2364,53,0,90,0,6
93479,1,2464,2445,19,0,2,0,6
93480,2,2505,2517,-12,0,219,1,6
93481,1,2454,2567,-113,0,175,0,6
93482,2,2591,2532,59,0,145,1,6
93483,2,2419,2412,7,0,45,0,6
93484,2,2356,2425,-69,0,46,0,6
93485,1,2477,2403,74,0,395,1,6
93486,2,2467,2396,71,0,338,0,6
93487,1,2468,2538,-70,0,201,1,6
93488,1,2402,2255,147,0,315,1,6
93489,2,2416,2259,157,0,484,0,6
93490,1,2300,2410,-110,0,9,0,6
93491,3,2519,2400,119,0,5,0,6
93492,2,2395,2441,-46,0,140,0,6
93493,2,2439,2368,71,0,122,0,6
93494,1,2517,2547,-30,0,40,1,6
93495,2,2584,2395,189,0,106,1,6
93496,2,2429,2550,-121,0,229,0,8
93497,2,2606,2504,102,0,255,0,6
93498,2,2372,2536,-164,0,127,0,6
93499,2,2369,2400,-31,0,335,0,6
93500,3,2564,2566,-2,0,122,0,6
93501,2,2402,2410,-8,0,400,0,6
93502,1,2400,2237,163,0,130,1,6
93504,2,2265,2438,-173,4,127,0,13
93505,2,2330,2405,-75,0,200,0,6
93506,1,2488,2507,-19,0,320,0,6
93507,1,2439,2349,90,0,208,1,6
93508,2,2444,2504,-60,0,104,0,6
93509,1,2413,2440,-27,0,150,0,6
93510,2,2311,2401,-90,0,45,0,6
93511,1,2503,2385,118,0,48,0,6
93512,2,2426,2397,29,0,45,1,6
93513,1,2553,2569,-16,0,311,0,6
93514,1,2439,2426,13,0,414,0,6
93515,1,2483,2311,172,0,240,0,6
93516,1,2410,2389,21,0,4,1,6
93517,2,2522,2475,47,0,122,1,6
93518,3,2445,2404,41,0,57,0,6
93519,2,2393,2462,-69,0,45,0,6
93520,2,2237,2418,-181,0,429,0,6
93521,3,2373,2441,-68,0,211,0,8
93522,1,2439,2337,102,0,204,1,6
93523,2,2461,2377,84,0,203,0,6
93524,2,2560,2518,42,0,477,0,6
93525,1,2587,2402,185,0,463,0,6
93526,2,2394,2517,-123,0,315,0,6
93527,1,2585,2523,62,0,215,0,6
93528,2,2461,2389,72,4,5,0,8
93529,2,2402,2232,170,0,48,0,6
93530,2,2414,2603,-189,0,40,0,6
93531,2,2540,2596,-56,0,246,0,6
93532,2,2365,2435,-70,0,133,0,6
93533,2,2472,2564,-92,0,123,0,6
93534,2,2399,2459,-60,0,48,0,6
93535,1,2482,2339,143,0,4,0,6
93536,1,2447,2390,57,0,300,0,6
93537,1,2452,2518,-66,0,202,0,6
93538,2,2357,2466,-109,0,56,0,6
93539,2,2277,2430,-153,0,113,1,8
93540,1,2531,2547,-16,0,153,0,6
93541,1,2408,2231,177,0,127,0,6
93542,2,2434,2351,83,0,41,0,6
93543,2,2563,2559,4,0,337,0,6
93544,1,2291,2406,-115,0,414,0,6
93545,2,2509,2589,-80,0,341,0,6
93546,1,2440,2402,38,0,100,0,6
93548,1,2590,2575,15,0,310,0,6
93549,2,2399,2511,-112,0,331,0,6
93550,2,2414,2541,-127,0,40,0,6
93551,2,2420,2375,45,0,4,0,6
93552,3,2316,2432,-116,0,330,0,6
93553,2,2405,2523,-118,0,46,1,6
93554,2,2533,2506,27,0,65,0,6
93555,1,2344,2444,-100,0,45,0,6
93556,1,2350,2451,-101,0,1,0,6
93557,1,2308,2470,-162,0,55,1,6
93558,3,2433,2380,53,0,343,0,8
93559,2,2331,2415,-84,0,469,1,6
93560,1,2516,2450,66,0,131,1,6
93561,3,2439,2360,79,0,311,0,6
93562,2,2393,2535,-142,0,127,0,6
93563,1,2343,2486,-143,0,46,1,6
93564,2,2521,2421,100,0,17,1,6
93565,2,2394,2454,-60,0,405,0,6
93566,2,2528,2445,83,0,140,1,6
93567,1,2405,2421,-16,0,337,0,6
93568,1,2423,2307,116,0,48,0,6
93569,2,2554,2600,-46,0,337,1,6
93570,1,2569,2444,125,0,201,1,6
93571,2,2362,2410,-48,4,1,0,13
93572,1,2419,2390,29,0,284,1,6
93573,2,2470,2354,116,0,199,1,6
93574,3,2524,2515,9,0,103,0,6
93575,3,2439,2374,65,0,395,0,8
93576,1,2545,2369,176,0,278,0,6
93577,1,2437,2352,85,0,113,1,6
93578,2,2408,2384,24,0,15,0,6
93579,2,2412,2374,38,0,49,0,6
93580,1,2504,2485,19,0,300,0,6
93581,1,2442,2262,180,4,120,0,13
93582,2,2594,2541,53,0,154,0,6
93583,1,2460,2280,180,0,311,0,6
93584,1,2336,2504,-168,0,1,0,6
93585,1,2410,2465,-55,0,301,1,6
93586,1,2606,2411,195,0,289,0,6
93587,1,2451,2417,34,0,300,0,6
93588,2,2385,2429,-44,0,140,1,6
93589,3,2574,2611,-37,0,242,0,6
93590,1,2284,2464,-180,0,1,0,6
93591,1,2512,2319,193,0,40,0,6
93592,1,2363,2414,-51,0,41,0,6
93593,3,2282,2447,-165,0,210,0,6
93594,3,2444,2439,5,0,215,0,6
93595,2,2310,2427,-117,0,143,1,6
93596,2,2524,2492,32,0,404,0,6
93597,3,2512,2527,-15,0,46,0,6
93598,2,2527,2445,82,0,246,1,6
93599,1,2570,2595,-25,0,106,1,6
93600,2,2235,2403,-168,0,0,0,6
93601,2,2515,2457,58,0,55,0,6
93602,1,2382,2401,-19,0,331,1,6
93603,3,2395,2601,-206,0,463,0,6
93604,2,2364,2414,-50,0,140,0,6
93605,2,2433,2336,97,0,143,0,6
93606,2,2403,2289,114,0,248,0,6
93607,2,2307,2438,-131,0,123,1,6
93608,1,2357,2427,-70,0,1,0,6
93609,2,2403,2548,-145,0,354,0,6
93610,2,2277,2443,-166,0,123,0,6
93611,3,2420,2514,-94,0,408,0,6
93612,1,2478,2351,127,0,122,0,6
93613,2,2390,2539,-149,0,41,1,6
93614,2,2402,2389,13,0,20,0,6
93615,1,2496,2389,107,0,45,1,6
93616,2,2228,2411,-183,0,302,0,6
93617,1,2462,2465,-3,0,1,0,6
93618,2,2605,2549,56,0,4,1,6
93619,1,2515,2514,1,0,300,0,6
93620,2,2515,2551,-36,0,122,0,6
93621,2,2460,2537,-77,0,102,0,6
93622,1,2424,2370,54,0,130,1,6
93623,2,2463,2509,-46,0,300,0,6
93624,2,2430,2273,157,0,45,1,6
93625,1,2420,2285,135,0,302,0,6
93626,2,2347,2441,-94,0,45,1,6
93627,3,2510,2440,70,0,201,0,6
93628,1,2408,2609,-201,0,40,0,6
93629,2,2556,2518,38,0,88,0,6
93630,2,2587,2524,63,0,215,1,6
93631,1,2427,2428,-1,0,212,1,6
93632,2,2284,2463,-179,0,152,0,6
93633,3,2439,2444,-5,0,245,0,6
93634,1,2300,2433,-133,0,110,0,8
93635,2,2452,2521,-69,0,394,0,6
93636,2,2314,2498,-184,0,3,1,6
93637,2,2376,2462,-86,0,143,0,6
93638,1,2446,2308,138,0,307,1,6
93639,1,2575,2474,101,0,209,0,6
93640,1,2448,2330,118,0,123,0,6
93641,1,2468,2527,-59,0,120,0,6
93642,1,2431,2440,-9,0,419,0,6
93643,2,2452,2520,-68,0,241,0,6
93644,2,2512,2421,91,0,45,0,6
93646,1,2598,2589,9,0,106,1,6
93647,1,2378,2472,-94,0,220,0,6
93648,1,2541,2398,143,0,106,0,6
93649,1,2463,2377,86,0,436,0,6
93650,1,2552,2550,2,0,170,0,6
93651,1,2517,2388,129,0,40,0,6
93652,3,2409,2417,-8,0,90,0,6
93653,1,2495,2482,13,0,205,1,6
93654,2,2397,2520,-123,0,411,1,6
93655,1,2456,2337,119,0,404,1,8
93656,2,2433,2299,134,0,112,0,6
93657,1,2587,2423,164,0,45,0,6
93658,1,2514,2458,56,0,55,0,6
93659,1,2434,2331,103,0,112,1,6
93661,3,2544,2558,-14,0,60,0,6
93662,2,2395,2615,-220,0,415,0,6
93663,2,2365,2521,-156,0,483,1,6
93664,2,2437,2434,3,0,414,0,6
93665,2,2329,2407,-78,0,54,1,6
93666,1,2555,2599,-44,0,56,0,6
93667,1,2508,2384,124,0,10,0,6
93669,1,2438,2375,63,0,317,0,8
93670,1,2425,2468,-43,0,41,0,6
93671,2,2445,2343,102,0,241,0,6
93672,2,2417,2342,75,0,108,1,6
93673,2,2401,2466,-65,0,121,0,6
93674,3,2302,2425,-123,0,22,0,6
93675,1,2433,2408,25,0,300,1,6
93676,1,2428,2505,-77,0,6,0,6
93677,1,2520,2474,46,0,315,0,6
93678,2,2422,2467,-45,0,162,0,6
93679,1,2326,2418,-92,0,0,0,6
93680,1,2470,2579,-109,0,248,0,6
93681,3,2525,2581,-56,0,345,0,6
93682,2,2428,2395,33,0,8,1,6
93683,1,2459,2545,-86,0,202,0,6
93684,1,2485,2282,203,0,123,0,8
93685,1,2415,2225,190,0,42,0,6
93686,1,2431,2449,-18,0,40,0,6
93687,2,2526,2447,79,0,104,0,6
93688,1,2440,2371,69,0,311,0,6
93689,1,2330,2482,-152,0,140,0,5
93691,1,2403,2501,-98,0,202,0,6
93692,3,2304,2425,-121,0,117,0,8
93693,1,2303,2452,-149,0,466,0,6
93694,1,2618,2392,226,0,460,0,6
93695,1,2374,2512,-138,0,0,0,6
93696,2,2469,2525,-56,0,201,0,6
93697,1,2734,2694,40,0,192,0,6
93698,3,2334,2405,-71,0,269,0,6
93699,3,2490,2311,179,0,338,0,6
93700,3,2454,2575,-121,0,300,0,6
93701,3,2524,2390,134,0,5,0,6
93702,2,2519,2604,-85,0,46,1,6
93703,1,2600,2417,183,0,201,0,6
93704,1,2584,2512,72,0,335,0,6
93705,2,2438,2531,-93,0,260,0,6
93706,2,2557,2544,13,0,106,0,6
93707,2,2531,2509,22,0,453,0,6
93708,1,2593,2562,31,0,374,0,6
93709,2,2207,2549,-342,0,112,0,5
93710,2,2304,2422,-118,0,113,0,6
93711,2,2404,2341,63,0,48,1,6
93712,2,2314,2438,-124,0,10,0,6
93713,1,2441,2358,83,0,107,0,6
93714,1,2437,2433,4,0,253,0,6
93715,2,2538,2565,-27,0,225,0,6
93716,1,2443,2362,81,0,40,1,6
93717,3,2482,2478,4,0,305,0,6
93718,1,2498,2387,111,0,483,0,6
93719,3,2500,2530,-30,0,195,0,6
93720,2,2498,2436,62,0,45,1,6
93721,2,2689,2739,-50,0,101,0,6
93722,2,2557,2466,91,0,190,1,6
93723,1,2382,2443,-61,0,0,0,6
93724,1,2504,2456,48,0,16,0,6
93725,1,2376,2410,-34,0,51,1,6
93726,2,2573,2396,177,0,217,0,6
93727,3,2442,2444,-2,0,455,0,6
93728,2,2286,2429,-143,0,0,0,6
93729,1,2461,2417,44,0,80,0,6
93730,1,2362,2438,-76,0,101,0,6
93731,1,2402,2421,-19,0,90,0,6
93732,2,2462,2417,45,0,1,0,6
93733,2,2550,2551,-1,0,54,0,6
93734,2,2595,2621,-26,0,156,0,6
93735,2,2367,2472,-105,0,218,0,6
93736,1,2580,2526,54,0,245,0,6
93737,3,2399,2422,-23,0,1,0,6
93738,2,2267,2445,-178,0,255,0,6
93739,2,2415,2437,-22,0,303,0,6
93740,3,2412,2410,2,0,415,0,6
93741,1,2283,2442,-159,0,106,1,6
93742,2,2557,2598,-41,0,469,0,6
93743,3,2447,2409,38,0,4,0,6
93744,2,2460,2488,-28,0,344,0,8
93745,2,2487,2554,-67,0,492,0,6
93746,1,2468,2354,114,0,106,0,6
93747,1,2276,2437,-161,0,319,1,6
93748,1,2588,2424,164,0,469,0,6
93749,2,2394,2522,-128,0,47,0,6
93750,1,2475,2377,98,0,133,0,5
93751,3,2406,2420,-14,0,153,0,6
93752,2,2608,2514,94,0,302,0,6
93753,2,2222,2418,-196,0,264,1,6
93754,1,2446,2356,90,0,102,0,6
93755,2,2345,2518,-173,2,111,0,30
93756,2,2454,2519,-65,0,50,0,6
93757,3,2626,2451,175,0,55,0,6
93758,1,2449,2320,129,0,311,0,6
93759,2,2415,2408,7,0,201,0,6
93760,1,2291,2402,-111,0,143,0,6
93761,2,2383,2533,-150,0,102,0,6
93762,1,2557,2545,12,0,123,0,6
93763,2,2478,2485,-7,0,123,0,6
93764,1,2350,2483,-133,0,46,0,6
93765,1,2525,2516,9,0,80,0,6
93766,2,2744,2685,59,0,258,1,6
93767,2,2358,2448,-90,0,50,1,6
93768,1,2522,2601,-79,0,490,0,6
93769,2,2329,2418,-89,4,107,1,13
93770,2,2565,2509,56,0,110,0,6
93771,1,2433,2354,79,0,8,0,6
93772,2,2403,2320,83,4,401,0,13
93773,2,2418,2552,-134,0,16,0,6
93774,1,2410,2222,188,0,406,0,6
93775,1,2231,2404,-173,0,354,1,6
93776,1,2363,2466,-103,0,45,1,6
93777,1,2444,2442,2,0,122,0,6
93778,2,2254,2423,-169,0,310,1,8
93779,1,2414,2410,4,0,90,0,6
93780,3,2362,2413,-51,0,315,0,6
93781,1,2603,2272,331,4,7,0,11
93782,2,2521,2585,-64,0,353,0,6
93783,2,2529,2462,67,0,315,0,6
93784,1,2491,2564,-73,0,345,1,6
93785,2,2414,2603,-189,0,40,0,6
93786,2,2450,2343,107,0,109,0,6
93787,1,2559,2411,148,0,131,0,6
93788,2,2424,2417,7,0,101,1,6
93789,1,2365,2426,-61,0,113,0,6
93790,3,2317,2497,-180,0,154,0,6
93791,2,2526,2502,24,0,462,0,6
93792,2,2370,2443,-73,0,245,0,8
93793,1,2411,2536,-125,0,302,0,6
93794,3,2455,2354,101,0,1,0,6
93795,1,2485,2383,102,0,386,0,6
93796,2,2594,2529,65,0,301,0,6
93797,2,2404,2513,-109,0,10,1,6
93798,1,2446,2377,69,0,306,0,6
93799,1,2428,2284,144,0,123,0,6
93800,1,2412,2325,87,0,100,0,6
93801,1,2421,2397,24,0,122,0,6
93802,1,2493,2455,38,0,288,0,8
93803,2,2453,2623,-170,0,45,0,6
93804,3,2351,2443,-92,0,157,0,6
93805,2,2491,2510,-19,0,190,1,6
93806,1,2413,2466,-53,0,317,1,6
93808,1,2388,2414,-26,0,49,1,6
93809,2,2436,2444,-8,0,312,0,6
93810,2,2536,2587,-51,0,490,1,6
93811,3,2395,2437,-42,0,150,0,6
93812,1,2691,2738,-47,0,101,1,6
93813,2,2539,2563,-24,0,375,0,6
93814,2,2358,2431,-73,0,43,0,6
93815,1,2584,2530,54,0,45,0,6
93816,1,2481,2460,21,0,312,0,6
93817,2,2432,2418,14,0,123,1,6
93818,1,2560,2523,37,0,4,1,6
93819,2,2494,2443,51,0,65,0,6
93820,1,2481,2472,9,0,211,0,6
93821,1,2436,2483,-47,0,4,0,6
93822,1,2528,2501,27,0,120,0,6
93823,1,2452,2287,165,0,470,0,6
93824,3,2589,2516,73,0,138,0,6
93825,1,2448,2227,221,0,478,0,6
93826,1,2508,2606,-98,0,463,0,6
93827,1,2558,2498,60,0,135,0,6
93828,2,2220,2421,-201,0,107,1,6
93829,2,2489,2379,110,0,386,0,6
93830,2,2207,2553,-346,0,110,0,5
93831,2,2327,2411,-84,0,110,0,6
93832,1,2421,2399,22,0,4,0,6
93833,2,2568,2534,34,0,301,1,6
93834,2,2442,2320,122,0,6,0,6
93835,2,2333,2491,-158,0,45,1,6
93836,1,2412,2263,149,0,121,0,6
93837,2,2420,2406,14,0,106,0,6
93838,1,2407,2339,68,0,200,0,6
93839,2,2418,2472,-54,0,119,0,6
93840,1,2364,2410,-46,0,9,0,6
93841,1,2436,2359,77,0,301,0,6
93842,2,2469,2502,-33,0,432,0,6
93843,2,2603,2471,132,0,100,0,6
93844,2,2557,2619,-62,0,9,0,6
93845,1,2392,2454,-62,0,245,0,6
93846,2,2353,2426,-73,0,48,0,6
93847,1,2450,2516,-66,0,267,0,6
93848,1,2352,2450,-98,0,277,0,8
93849,2,2308,2400,-92,0,353,1,6
93850,1,2416,2462,-46,0,400,0,6
93851,2,2316,2425,-109,0,120,0,6
93852,3,2450,2515,-65,0,300,0,6
93853,3,2467,2487,-20,0,125,0,6
93854,2,2567,2626,-59,0,36,0,6
93855,2,2342,2441,-99,0,41,1,6
93856,2,2393,2406,-13,0,4,0,6
93857,2,2401,2301,100,0,46,1,6
93858,1,2485,2487,-2,0,117,0,6
93859,1,2539,2555,-16,0,175,0,6
93860,2,2417,2379,38,0,236,0,6
93861,2,2458,2442,16,0,395,1,6
93862,1,2516,2362,154,0,402,0,6
93863,1,2455,2435,20,0,463,0,6
93864,3,2447,2483,-36,0,4,0,6
93865,2,2424,2426,-2,0,40,1,6
93866,1,2378,2475,-97,0,247,1,6
93867,2,2531,2518,13,0,344,0,6
93868,1,2496,2533,-37,0,200,1,6
93869,2,2517,2588,-71,0,335,0,6
93870,2,2396,2451,-55,0,202,0,6
93871,1,2386,2481,-95,0,59,0,6
93872,1,2373,2437,-64,0,16,0,6
93873,2,2507,2589,-82,0,46,0,6
93874,1,2309,2446,-137,0,374,0,8
93875,2,2279,2453,-174,0,48,0,6
93876,1,2431,2328,103,0,260,1,6
93877,1,2478,2413,65,0,0,0,6
93878,1,2404,2349,55,0,115,0,6
93879,2,2562,2553,9,0,123,1,6
93880,1,2410,2494,-84,0,122,0,6
93881,3,2280,2430,-150,4,105,0,13
93882,1,2426,2272,154,0,486,0,8
93883,1,2437,2295,142,0,41,0,6
93884,2,2482,2345,137,0,453,0,6
93885,2,2369,2428,-59,0,40,0,6
93886,1,2440,2457,-17,0,301,0,6
93887,3,2448,2366,82,0,342,0,8
93888,2,2352,2436,-84,0,152,0,6
93889,1,2540,2562,-22,0,44,0,6
93890,1,2528,2464,64,0,310,0,6
93891,1,2429,2260,169,0,14,0,6
93892,2,2416,2566,-150,0,222,1,6
93893,1,2631,2491,140,0,454,0,6
93894,2,2356,2439,-83,0,102,1,6
93895,3,2491,2309,182,4,252,0,13
93896,2,2524,2525,-1,0,331,0,6
93897,3,2401,2430,-29,0,250,0,6
93898,2,2383,2430,-47,0,201,1,6
93899,2,2519,2481,38,0,398,1,6
93900,1,2487,2511,-24,0,100,0,6
93901,2,2318,2450,-132,0,300,0,8
93902,1,2474,2394,80,0,4,0,6
93903,1,2451,2278,173,0,45,1,6
93904,1,2564,2409,155,0,415,0,6
93905,2,2593,2525,68,0,215,1,6
93906,2,2425,2449,-24,0,102,0,6
93907,1,2456,2358,98,0,331,0,6
93908,2,2535,2595,-60,0,325,1,6
93909,3,2308,2409,-101,0,241,0,6
93910,2,2432,2394,38,0,7,0,6
93911,2,2395,2461,-66,0,50,1,6
93912,2,2411,2404,7,0,352,0,6
93913,1,2502,2452,50,0,344,0,6
93914,1,2405,2549,-144,0,177,0,6
93915,2,2496,2302,194,0,0,0,6
93916,1,2431,2419,12,0,123,0,6
93917,1,2468,2557,-89,0,311,1,6
93918,2,2420,2344,76,0,115,1,6
93919,1,2467,2451,16,0,123,0,6
93920,1,2559,2623,-64,0,106,0,6
93921,2,2414,2426,-12,0,190,0,6
93922,2,2400,2446,-46,0,43,1,6
93923,2,2487,2505,-18,0,45,0,6
93924,2,2517,2549,-32,0,4,0,6
93925,2,2455,2317,138,0,43,0,6
93926,1,2487,2517,-30,0,10,0,6
93927,1,2435,2454,-19,0,201,0,6
93928,1,2291,2474,-183,0,492,0,6
93929,3,2355,2449,-94,0,385,0,6
93930,2,2231,2412,-181,0,45,0,6
93931,1,2404,2329,75,0,325,0,6
93932,2,2407,2435,-28,0,46,1,6
93933,3,2465,2487,-22,0,300,0,6
93934,2,2556,2546,10,0,175,0,6
93935,2,2302,2425,-123,4,107,0,13
93936,1,2389,2479,-90,0,308,0,6
93937,2,2460,2635,-175,0,429,0,6
93938,2,2577,2549,28,0,15,0,6
93939,2,2354,2443,-89,0,405,0,6
93940,3,2531,2518,13,0,40,0,6
93941,2,2276,2412,-136,0,310,1,6
93942,3,2467,2338,129,0,0,0,6
93943,1,2420,2309,111,0,122,0,6
93944,1,2497,2389,108,0,491,0,6
93945,2,2409,2431,-22,0,464,0,6
93946,2,2291,2456,-165,0,395,0,6
93947,3,2456,2353,103,0,302,0,6
93948,2,2378,2403,-25,0,45,1,6
93949,3,2343,2466,-123,0,140,0,5
93950,2,2349,2454,-105,0,46,0,6
93951,2,2278,2418,-140,4,80,0,11
93952,1,2546,2586,-40,0,120,0,6
93953,1,2420,2499,-79,0,194,1,6
93954,1,2408,2349,59,0,347,1,6
93955,1,2413,2437,-24,0,40,1,6
93956,1,2532,2512,20,0,53,0,6
93957,2,2305,2443,-138,0,115,0,6
93958,1,2399,2410,-11,0,1,0,6
93959,1,2459,2405,54,0,255,0,6
93960,1,2511,2565,-54,0,57,0,6
93961,2,2380,2402,-22,0,101,0,6
93962,1,2403,2389,14,0,131,0,6
93963,1,2407,2310,97,0,150,0,6
93964,1,2602,2672,-70,0,250,0,6
93965,1,2447,2413,34,0,394,1,6
93966,1,2460,2507,-47,0,4,1,6
93967,2,2472,2396,76,0,49,0,6
93968,2,2431,2512,-81,0,484,0,6
93969,3,2441,2513,-72,0,90,0,6
93970,1,2226,2402,-176,0,310,1,6
93971,1,2507,2475,32,0,45,0,6
93972,2,2638,2549,89,0,317,0,6
93973,2,2448,2350,98,0,195,1,6
93974,1,2451,2441,10,0,45,0,6
93975,2,2418,2248,170,0,41,0,6
93976,1,2531,2538,-7,0,215,0,6
93977,2,2459,2481,-22,0,335,1,6
93978,1,2415,2206,209,0,325,0,6
93979,1,2443,2335,108,0,344,0,8
93980,2,2388,2421,-33,0,4,1,6
93981,2,2288,2424,-136,0,106,0,6
93982,2,2552,2550,2,0,44,0,6
93983,2,2395,2405,-10,0,43,0,6
93984,2,2487,2501,-14,0,212,0,6
93985,3,2470,2612,-142,0,325,0,6
93986,2,2282,2447,-165,0,214,0,6
93987,2,2454,2512,-58,0,30,0,6
93988,1,2571,2592,-21,0,30,0,6
93989,1,2580,2553,27,0,211,1,6
93990,1,2518,2530,-12,0,13,0,6
93991,2,2403,2457,-54,0,101,0,6
93992,1,2402,2354,48,0,48,0,8
93993,1,2430,2345,85,0,128,1,6
93994,1,2512,2465,47,0,352,0,6
93995,2,2446,2498,-52,0,167,0,6
93996,3,2459,2420,39,0,45,0,6
93997,2,2404,2412,-8,0,487,1,6
93998,1,2465,2377,88,0,125,0,5
93999,1,2411,2416,-5,0,311,1,6
94000,2,2494,2556,-62,0,4,0,6
94001,2,2462,2329,133,0,210,0,6
94002,2,2427,2431,-4,0,200,0,6
94003,1,2631,2513,118,0,43,1,6
94004,1,2409,2332,77,0,115,0,6
94005,1,2451,2488,-37,4,236,0,13
94006,1,2439,2306,133,0,160,0,6
94007,2,2380,2408,-28,0,484,1,6
94008,2,2427,2426,1,0,202,0,6
94009,3,2516,2501,15,0,4,0,6
94010,2,2446,2273,173,0,4,1,6
94011,2,2449,2348,101,0,150,0,6
94012,3,2429,2407,22,0,345,0,6
94013,3,2249,2418,-169,0,45,0,6
94014,2,2401,2488,-87,0,40,0,6
94015,1,2256,2554,-298,0,4,0,5
94016,1,2357,2442,-85,0,436,0,6
94017,1,2408,2448,-40,0,211,0,6
94018,1,2488,2489,-1,0,312,0,6
94019,3,2559,2517,42,0,203,0,6
94020,2,2357,2441,-84,0,405,0,6
94021,1,2525,2524,1,0,95,0,6
94022,1,2426,2264,162,0,16,0,6
94023,1,2411,2389,22,0,301,0,6
94024,2,2434,2383,51,0,4,1,6
94025,1,2429,2428,1,4,200,0,13
94026,2,2369,2433,-64,0,8,0,6
94027,1,2435,2472,-37,0,406,0,6
94028,2,2506,2517,-11,0,335,1,6
94029,1,2517,2532,-15,0,40,1,6
94030,1,2511,2413,98,0,6,1,6
94031,2,2453,2413,40,0,102,1,6
94032,1,2414,2266,148,0,110,0,6
94033,1,2450,2304,146,0,15,1,6
94034,1,2383,2457,-74,0,300,0,6
94035,2,2601,2586,15,0,123,0,6
94036,2,2364,2458,-94,0,301,1,6
94037,1,2420,2400,20,0,127,1,6
94038,2,2415,2562,-147,0,163,1,6
94039,1,2585,2525,60,0,105,0,6
94040,2,2345,2415,-70,0,151,1,6
94041,2,2588,2447,141,0,15,1,8
94042,2,2442,2490,-48,0,267,0,6
94043,2,2377,2561,-184,0,43,0,6
94044,1,2467,2321,146,0,40,0,6
94045,1,2405,2434,-29,0,11,1,6
94046,1,2445,2353,92,0,195,0,6
94047,2,2344,2422,-78,0,4,1,6
94048,3,2456,2572,-116,0,330,0,6
94049,2,2547,2577,-30,0,180,0,6
94050,2,2432,2438,-6,0,311,0,6
94051,1,2453,2437,16,0,92,1,6
94052,2,2406,2416,-10,0,40,0,6
94053,2,2588,2503,85,0,120,1,6
94054,2,2509,2635,-126,0,189,0,6
94055,2,2520,2590,-70,0,353,0,6
94056,2,2501,2473,28,0,360,1,6
94057,1,2516,2501,15,0,7,0,6
94058,2,2523,2501,22,0,46,0,6
94059,1,2421,2328,93,0,466,0,6
94060,2,2429,2483,-54,0,10,1,6
94061,2,2514,2495,19,0,311,0,6
94062,2,2403,2554,-151,0,316,0,8
94063,2,2466,2530,-64,0,347,0,6
94064,1,2273,2402,-129,0,113,0,6
94065,1,2583,2429,154,0,469,0,6
94066,3,2449,2456,-7,0,5,0,6
94067,1,2427,2344,83,0,10,0,6
94068,2,2384,2417,-33,0,343,0,6
94069,2,2441,2462,-21,0,54,0,6
94070,1,2419,2300,119,0,16,0,6
94071,1,2564,2453,111,0,110,0,6
94072,1,2523,2431,92,0,43,1,6
94073,2,2443,2536,-93,0,17,1,6
94074,2,2269,2412,-143,0,131,1,6
94075,1,2508,2426,82,0,225,0,6
94076,1,2501,2419,82,0,8,0,6
94077,3,2456,2219,237,0,4,0,6
94078,3,2449,2252,197,0,4,0,6
94079,2,2431,2321,110,4,4,0,13
94080,2,2639,2505,134,0,228,0,6
94081,1,2582,2542,40,0,28,0,6
94082,2,2361,2409,-48,0,242,0,6
94083,1,2422,2411,11,0,50,0,6
94084,2,2275,2410,-135,0,46,0,6
94085,1,2546,2417,129,0,45,1,6
94086,1,2450,2515,-65,0,105,1,6
94087,1,2349,2449,-100,0,45,0,6
94088,3,2334,2428,-94,0,343,0,6
94089,2,2404,2412,-8,0,331,0,6
94090,1,2515,2409,106,0,6,0,6
94091,1,2340,2475,-135,0,1,1,6
94092,1,2504,2459,45,0,337,1,6
94093,1,2404,2326,78,0,45,0,6
94094,2,2431,2308,123,0,123,0,6
94095,2,2486,2618,-132,0,366,1,6
94096,3,2568,2493,75,0,15,0,6
94097,1,2436,2324,112,0,344,0,6
94098,1,2358,2449,-91,0,8,0,6
94099,2,2495,2495,0,0,409,1,6
94100,2,2479,2568,-89,0,124,0,6
94101,2,2593,2522,71,0,474,0,6
94102,2,2339,2545,-206,0,119,0,5
94103,2,2354,2537,-183,0,141,0,6
94104,2,2557,2581,-24,0,14,1,8
94105,2,2287,2470,-183,0,111,0,6
94106,1,2466,2336,130,0,301,0,6
94107,2,2423,2369,54,0,6,0,6
94108,2,2435,2331,104,0,200,0,6
94109,1,2488,2344,144,0,202,0,6
94110,2,2442,2356,86,0,269,0,6
94111,1,2421,2292,129,0,45,0,6
94112,1,2410,2353,57,0,37,1,6
94113,2,2424,2513,-89,0,110,0,6
94114,1,2587,2629,-42,0,21,0,6
94115,1,2435,2200,235,4,100,0,13
94116,1,2421,2513,-92,0,265,1,6
94117,1,2447,2289,158,0,13,0,6
94118,3,2403,2260,143,0,241,0,6
94119,2,2270,2417,-147,0,330,0,6
94120,2,2536,2458,78,0,111,0,6
94121,1,2439,2427,12,0,37,0,6
94122,2,2572,2528,44,0,107,1,6
94123,2,2244,2452,-208,0,5,0,6
94124,1,2442,2297,145,0,200,0,6
94125,1,2426,2300,126,0,13,0,6
94126,1,2417,2414,3,0,190,0,6
94127,1,2537,2570,-33,0,265,0,6
94128,2,2338,2508,-170,0,80,1,6
94129,1,2329,2420,-91,4,46,0,13
94130,2,2567,2465,102,0,45,0,6
94131,1,2406,2428,-22,0,297,0,6
94132,2,2506,2512,-6,0,265,1,6
94133,2,2407,2457,-50,0,300,0,6
94134,1,2414,2375,39,0,115,0,6
94135,3,2509,2440,69,0,31,0,6
94136,1,2402,2281,121,4,201,0,13
94137,1,2558,2473,85,0,48,0,6
94138,1,2304,2432,-128,4,302,0,13
94139,2,2621,2509,112,0,138,0,6
94140,1,2444,2294,150,0,7,0,8
94141,1,2442,2351,91,0,374,0,6
94142,1,2448,2373,75,0,20,0,6
94143,1,2414,2374,40,0,193,0,6
94144,1,2528,2425,103,0,4,0,6
94145,1,2482,2459,23,4,251,0,13
94146,1,2363,2435,-72,0,102,0,6
94147,1,2325,2414,-89,0,106,0,6
94148,2,2320,2416,-96,0,8,0,6
94149,1,2371,2417,-46,0,336,1,6
94150,1,2501,2492,9,0,108,1,6
94151,2,2263,2489,-226,4,337,0,13
94152,1,2475,2467,8,0,100,1,6
94153,1,2422,2419,3,0,112,1,6
94154,2,2445,2383,62,0,30,1,6
94155,1,2270,2471,-201,0,4,0,5
94156,3,2349,2451,-102,0,375,0,6
94157,1,2405,2520,-115,0,153,0,6
94158,1,2489,2424,65,4,211,0,13
94159,2,2473,2308,165,0,4,0,6
94160,2,2408,2361,47,0,100,0,6
94161,1,2429,2427,2,0,270,1,6
94162,2,2507,2517,-10,0,310,0,6
94163,1,2417,2391,26,0,41,0,6
94164,1,2555,2617,-62,0,106,1,6
94165,3,2322,2415,-93,0,301,0,6
94166,1,2421,2373,48,0,43,0,6
94167,1,2446,2366,80,4,454,1,13
94168,2,2285,2454,-169,0,49,0,6
94169,1,2518,2543,-25,0,46,0,6
94170,2,2415,2566,-151,0,104,1,6
94171,1,2511,2562,-51,0,202,0,6
94172,1,2421,2533,-112,0,48,1,6
94173,2,2403,2264,139,0,300,0,6
94174,2,2781,2698,83,0,152,0,6
94175,1,2430,2441,-11,0,102,0,6
94176,1,2494,2316,178,0,154,0,6
94177,1,2507,2559,-52,0,44,0,6
94178,2,2341,2446,-105,0,111,1,6
94179,1,2540,2457,83,0,200,0,6
94180,1,2428,2374,54,0,107,1,6
94181,1,2614,2562,52,0,331,0,6
94182,2,2421,2259,162,0,335,0,6
94183,2,2537,2524,13,0,278,0,6
94184,2,2369,2452,-83,0,4,0,6
94185,1,2415,2439,-24,0,203,0,6
94186,2,2511,2511,0,0,40,0,6
94187,2,2263,2427,-164,0,7,1,6
94188,3,2513,2524,-11,0,15,0,6
94189,3,2217,2426,-209,0,315,0,6
94190,2,2341,2424,-83,4,50,0,13
94191,2,2220,2549,-329,0,110,0,5
94192,2,2427,2438,-11,0,115,0,6
94193,2,2469,2743,-274,0,169,0,6
94194,1,2414,2453,-39,0,311,0,6
94195,1,2397,2433,-36,0,268,0,6
94196,1,2506,2548,-42,0,46,0,6
94197,2,2486,2350,136,0,4,0,6
94198,1,2447,2269,178,0,48,1,6
94199,2,2298,2586,-288,0,141,0,8
94200,1,2552,2414,138,0,90,0,8
94201,1,2270,2408,-138,0,207,0,6
94202,2,2419,2293,126,0,426,0,6
94203,1,2449,2389,60,0,455,0,6
94204,2,2354,2446,-92,0,45,0,6
94205,2,2435,2398,37,0,419,0,6
94206,2,2288,2453,-165,0,40,0,6
94207,1,2423,2377,46,0,338,1,6
94208,1,2471,2517,-46,0,140,1,6
94209,1,2421,2302,119,0,159,1,6
94210,2,2419,2326,93,0,210,0,6
94211,1,2556,2434,122,0,46,0,6
94212,1,2369,2421,-52,0,108,0,6
94213,2,2301,2415,-114,0,45,1,6
94214,2,2545,2495,50,0,112,1,6
94215,2,2447,2554,-107,0,153,0,6
94216,2,2525,2773,-248,0,4,0,6
94217,2,2402,2354,48,0,258,1,6
94218,1,2458,2278,180,0,249,0,8
94219,1,2531,2513,18,0,103,1,6
94220,2,2312,2430,-118,0,241,0,6
94221,2,2473,2487,-14,0,17,1,6
94222,2,2404,2365,39,0,41,0,6
94223,1,2486,2514,-28,0,81,0,6
94224,1,2473,2447,26,0,310,0,6
94225,2,2387,2450,-63,0,9,0,6
94226,2,2610,2619,-9,0,48,0,6
94227,1,2433,2337,96,0,245,0,6
94228,1,2455,2359,96,0,5,0,6
94229,1,2430,2260,170,0,101,1,6
94230,3,2370,2444,-74,0,313,0,6
94231,1,2540,2506,34,0,226,0,6
94232,1,2557,2422,135,0,241,0,6
94233,3,2467,2210,257,0,36,0,6
94234,1,2368,2427,-59,0,1,0,6
94235,2,2523,2399,124,0,306,0,6
94236,2,2430,2512,-82,0,190,0,6
94237,2,2411,2339,72,0,462,0,6
94238,3,2592,2776,-184,0,112,0,6
94239,2,2348,2429,-81,0,1,0,6
94240,1,2407,2372,35,0,20,1,6
94241,1,2487,2332,155,4,112,0,13
94243,2,2393,2402,-9,0,45,0,6
94244,1,2455,2361,94,0,43,0,6
94245,2,2308,2473,-165,0,200,1,6
94246,2,2415,2428,-13,0,157,1,6
94247,1,2437,2560,-123,0,200,0,6
94248,1,2356,2460,-104,0,123,0,6
94249,2,2431,2421,10,0,152,0,6
94250,3,2603,2538,65,0,43,0,6
94251,1,2451,2375,76,0,10,0,6
94252,3,2625,2596,29,0,10,0,6
94253,2,2445,2304,141,0,126,0,6
94254,2,2313,2451,-138,0,374,1,6
94255,2,2411,2336,75,4,241,0,13
94256,2,2419,2372,47,0,404,1,6
94257,1,2401,2422,-21,0,344,0,6
94258,1,2507,2514,-7,0,200,0,6
94259,1,2410,2284,126,0,46,0,6
94260,1,2433,2475,-42,0,1,1,6
94261,2,2305,2419,-114,0,123,1,6
94262,1,2383,2412,-29,0,335,0,6
94263,2,2508,2595,-87,0,311,1,6
94264,1,2298,2492,-194,0,171,0,6
94265,1,2588,2411,177,0,4,0,8
94266,1,2456,2333,123,0,414,1,6
94267,1,2335,2412,-77,0,106,0,6
94268,1,2437,2498,-61,0,159,0,6
94269,1,2586,2537,49,0,380,0,6
94270,1,2439,2409,30,0,484,1,6
94271,1,2662,2602,60,0,312,0,6
94272,2,2333,2497,-164,0,113,1,6
94273,1,2452,2271,181,0,302,0,6
94274,3,2410,2432,-22,0,301,0,6
94275,3,2315,2461,-146,0,41,0,8
94276,1,2459,2561,-102,0,302,0,6
94277,1,2418,2408,10,0,275,0,6
94278,1,2425,2539,-114,0,103,0,6
94279,2,2549,2658,-109,0,344,0,6
94280,1,2511,2360,151,0,13,0,6
94281,2,2356,2558,-202,0,45,0,6
94282,2,2773,2594,179,0,4,0,6
94283,1,2421,2358,63,0,385,0,6
94284,2,2313,2427,-114,0,119,0,6
94285,3,2564,2515,49,0,112,0,6
94286,2,2552,2385,167,0,269,0,6
94287,2,2569,2624,-55,0,122,0,6
94288,2,2597,2526,71,0,3,0,6
94289,2,2445,2514,-69,0,120,0,6
94290,2,2305,2513,-208,0,113,0,6
94291,1,2524,2240,284,0,4,0,6
94292,2,2315,2407,-92,0,302,0,6
94293,1,2425,2523,-98,0,119,0,6
94294,1,2545,2480,65,0,359,0,6
94295,2,2358,2455,-97,0,8,0,6
94296,2,2357,2409,-52,0,45,0,6
94297,1,2663,2349,314,0,211,0,6
94298,2,2360,2433,-73,0,50,0,6
94299,2,2274,2533,-259,0,202,0,8
94300,2,2492,2476,16,0,210,0,6
94301,1,2348,2444,-96,0,102,0,6
94302,2,2361,2456,-95,4,221,0,13
94303,1,2440,2319,121,0,1,0,6
94304,2,2423,2504,-81,0,85,0,6
94305,1,2406,2312,94,0,8,1,6
94306,2,2460,2469,-9,0,330,1,6
94307,2,2222,2405,-183,0,242,0,6
94308,1,2402,2370,32,0,40,0,6
94309,1,2484,2362,122,0,453,0,6
94310,1,2532,2591,-59,0,206,0,6
94311,3,2463,2219,244,0,46,0,6
94312,2,2347,2416,-69,0,101,0,6
94313,2,2403,2260,143,0,380,0,6
94314,2,2412,2311,101,0,200,0,6
94315,2,2333,2454,-121,0,115,0,6
94316,2,2342,2425,-83,0,310,0,6
94317,2,2476,2549,-73,0,125,0,6
94318,2,2379,2431,-52,0,306,1,6
94320,1,2348,2411,-63,0,109,1,6
94321,1,2459,2332,127,0,140,0,6
94322,3,2415,2467,-52,0,300,0,6
94323,3,2366,2459,-93,0,107,0,8
94324,3,2516,2436,80,0,38,0,6
94325,2,2394,2526,-132,0,247,0,6
94326,2,2310,2405,-95,0,484,1,6
94327,2,2350,2477,-127,0,2,0,6
94328,2,2533,2590,-57,0,101,0,6
94329,2,2521,2765,-244,0,110,0,6
94330,1,2409,2519,-110,0,300,0,6
94331,1,2665,2603,62,0,104,0,6
94332,1,2560,2551,9,0,8,0,6
94333,2,2490,2562,-72,0,272,1,6
94334,2,2420,2402,18,0,12,0,6
94335,1,2438,2322,116,0,310,1,6
94336,2,2507,2440,67,0,491,1,6
94337,1,2328,2491,-163,4,280,0,13
94338,2,2554,2471,83,0,208,0,6
94339,1,2481,2387,94,0,112,1,6
94340,1,2591,2335,256,0,327,0,8
94341,1,2536,2272,264,0,221,1,8
94342,2,2602,2414,188,0,490,0,6
94343,2,2352,2444,-92,0,113,0,6
94344,1,2401,2344,57,4,141,0,13
94345,1,2422,2388,34,0,31,0,6
94346,1,2603,2593,10,0,241,0,6
94347,2,2495,2298,197,4,106,0,13
94348,1,2482,2425,57,0,4,0,6
94349,1,2485,2363,122,0,280,1,6
94350,1,2585,2539,46,0,474,0,6
94351,2,2309,2418,-109,0,15,0,6
94352,1,2661,2516,145,0,110,0,6
94353,2,2423,2327,96,0,106,0,6
94354,1,2417,2451,-34,0,114,0,6
94355,2,2482,2352,130,0,153,1,6
94356,1,2338,2454,-116,0,188,0,6
94357,1,2532,2433,99,0,226,0,6
94358,1,2597,2395,202,0,216,0,6
94359,1,2445,2256,189,0,7,0,6
94360,1,2343,2485,-142,0,400,0,6
94361,1,2488,2437,51,0,52,1,6
94362,1,2443,2207,236,0,106,0,8
94363,1,2429,2432,-3,0,46,0,6
94364,2,2560,2507,53,0,484,0,6
94365,2,2351,2404,-53,0,46,0,6
94366,2,2307,2421,-114,0,200,1,6
94367,1,2408,2327,81,0,285,0,6
94368,1,2466,2390,76,0,46,0,6
94369,2,2416,2512,-96,0,45,0,6
94370,2,2598,2671,-73,0,368,0,6
94371,3,2605,2619,-14,0,40,0,6
94372,3,2767,2595,172,0,4,0,6
94373,2,2448,2431,17,0,102,0,6
94374,1,2458,2282,176,0,131,0,8
94375,2,2436,2424,12,0,107,0,6
94376,1,2460,2269,191,0,460,1,6
94377,1,2433,2348,85,0,6,0,6
94378,1,2423,2588,-165,0,142,0,6
94379,1,2404,2338,66,0,215,0,6
94380,1,2530,2379,151,0,264,1,6
94381,1,2487,2515,-28,0,4,0,6
94382,3,2505,2414,91,0,255,0,6
94383,1,2484,2442,42,0,167,0,6
94384,3,2458,2368,90,0,200,0,6
94385,2,2425,2298,127,0,345,0,6
94386,2,2512,2500,12,0,408,0,6
94387,2,2534,2590,-56,0,203,0,6
94388,3,2429,2447,-18,0,342,0,6
94389,2,2593,2340,253,0,15,0,8
94390,2,2297,2451,-154,4,40,0,13
94391,1,2414,2409,5,0,315,0,6
94392,1,2517,2413,104,0,6,0,6
94393,1,2409,2390,19,0,111,0,6
94394,2,2485,2431,54,0,244,0,6
94395,2,2392,2419,-27,0,454,0,6
94396,2,2423,2426,-3,0,278,0,6
94397,1,2350,2455,-105,0,122,0,6
94398,1,2445,2352,93,0,7,0,6
94399,2,2489,2553,-64,0,141,0,6
94400,2,2360,2459,-99,0,218,0,6
94401,1,2543,2402,141,0,378,0,6
94402,1,2595,2529,66,0,426,0,6
94403,1,2346,2442,-96,0,40,0,6
94404,2,2392,2600,-208,0,310,0,6
94405,2,2501,2382,119,0,154,0,6
94406,2,2464,2355,109,0,250,0,6
94407,3,2524,2599,-75,0,203,0,6
94408,2,2520,2536,-16,0,212,0,6
94409,1,2444,2339,105,4,49,0,13
94410,1,2521,2235,286,0,122,0,6
94411,1,2414,2294,120,0,463,0,6
94412,2,2516,2499,17,0,453,0,6
94413,1,2432,2493,-61,0,171,0,6
94414,1,2676,2506,170,0,211,0,6
94415,3,2354,2448,-94,0,280,0,6
94416,3,2610,2501,109,0,313,0,6
94417,2,2508,2447,61,0,38,0,6
94418,3,2471,2493,-22,0,455,0,6
94419,3,2566,2392,174,0,4,0,6
94420,2,2405,2268,137,0,199,0,6
94421,2,2527,2548,-21,0,200,0,6
94422,1,2478,2343,135,0,202,0,6
94423,2,2579,2594,-15,0,13,0,6
94424,2,2544,2490,54,0,300,0,6
94425,2,2362,2414,-52,0,315,0,6
94426,1,2410,2373,37,0,200,0,6
94427,2,2412,2419,-7,0,211,0,6
94428,1,2430,2396,34,0,436,1,6
94429,3,2413,2524,-111,0,61,0,6
94430,2,2448,2506,-58,0,183,0,6
94431,1,2516,2255,261,0,108,0,6
94432,1,2276,2413,-137,0,305,0,6
94433,1,2433,2324,109,0,332,1,6
94434,1,2415,2266,149,0,51,0,6
94435,1,2416,2416,0,0,278,1,6
94437,2,2493,2369,124,0,4,0,6
94438,1,2385,2415,-30,0,107,1,6
94439,2,2231,2463,-232,0,380,0,6
94440,1,2420,2354,66,0,300,0,6
94441,1,2377,2435,-58,0,57,0,6
94442,2,2397,2428,-31,0,325,0,6
94443,2,2455,2408,47,4,107,0,13
94444,1,2449,2357,92,0,4,0,6
94445,1,2487,2346,141,0,201,0,6
94446,2,2437,2399,38,0,56,1,6
94447,2,2452,2372,80,0,16,0,6
94448,1,2574,2605,-31,0,110,1,6
94449,2,2599,2552,47,0,7,0,6
94450,2,2486,2429,57,4,225,0,13
94451,1,2402,2277,125,0,337,0,6
94452,2,2409,2489,-80,0,337,1,6
94453,3,2261,2457,-196,0,113,0,6
94454,1,2467,2354,113,0,0,1,6
94455,1,2358,2430,-72,0,300,0,6
94456,2,2366,2533,-167,0,9,0,6
94457,1,2593,2502,91,0,4,0,6
94458,1,2558,2510,48,0,61,0,6
94459,2,2206,2446,-240,0,227,0,6
94460,1,2420,2402,18,0,310,0,6
94461,1,2456,2340,116,0,101,1,6
94462,2,2347,2482,-135,0,459,0,6
94463,1,2430,2484,-54,0,241,0,6
94465,2,2598,2526,72,0,0,0,6
94466,2,2337,2426,-89,0,132,1,6
94467,1,2512,2558,-46,0,375,0,6
94468,2,2313,2528,-215,0,345,0,6
94469,2,2455,2343,112,0,106,1,6
94470,3,2510,2679,-169,0,191,0,6
94471,1,2454,2355,99,0,31,0,6
94472,3,2408,2397,11,0,48,0,6
94473,1,2428,2297,131,0,50,1,6
94474,2,2425,2326,99,0,45,0,6
94475,2,2345,2443,-98,0,150,0,6
94476,2,2511,2517,-6,0,247,0,6
94477,1,2378,2461,-83,0,183,0,6
94478,2,2502,2382,120,0,147,0,6
94479,1,2320,2584,-264,0,409,0,8
94480,1,2371,2479,-108,0,200,1,6
94481,2,2428,2302,126,0,81,0,6
94482,3,2502,2608,-106,0,8,0,6
94483,2,2431,2454,-23,0,15,0,6
94484,2,2497,2618,-121,0,483,0,6
94485,1,2425,2330,95,0,306,0,6
94486,1,2373,2436,-63,0,107,1,6
94487,1,2407,2377,30,0,354,0,6
94488,2,2390,2485,-95,0,56,0,6
94489,2,2425,2307,118,0,52,1,6
94490,1,2334,2409,-75,0,477,0,6
94491,1,2417,2518,-101,0,80,0,6
94492,1,2409,2308,101,0,129,0,6
94493,1,2296,2404,-108,0,193,0,6
94494,1,2453,2364,89,0,414,0,6
94495,1,2405,2264,141,0,114,0,6
94496,3,2606,2438,168,0,58,0,6
94497,2,2305,2437,-132,0,484,1,6
94498,1,2552,2503,49,0,110,1,6
94499,2,2389,2410,-21,0,45,0,6
94500,1,2409,2406,3,0,150,1,6
94501,2,2253,2567,-314,0,453,0,6
94502,1,2419,2285,134,0,151,0,6
94503,1,2486,2371,115,0,82,0,6
94504,3,2533,2591,-58,0,203,0,6
94505,2,2430,2506,-76,0,302,0,6
94506,2,2423,2432,-9,0,28,0,6
94507,3,2523,2367,156,0,46,0,6
94508,1,2506,2328,178,0,7,0,6
94509,1,2395,2563,-168,0,0,1,6
94510,2,2431,2350,81,0,40,1,6
94511,2,2430,2265,165,0,4,0,6
94512,2,2304,2413,-109,0,398,1,6
94513,2,2223,2488,-265,4,13,0,13
94514,2,2304,2426,-122,0,1,0,6
94515,1,2459,2406,53,0,120,0,6
94516,2,2465,2270,195,0,310,0,6
94517,2,2526,2677,-151,0,345,0,6
94518,2,2454,2437,17,0,43,0,6
94519,2,2447,2353,94,0,242,0,6
94520,1,2253,2575,-322,0,202,1,8
94521,1,2363,2432,-69,0,253,0,6
94522,2,2478,2460,18,0,203,0,6
94523,2,2393,2417,-24,0,42,0,6
94524,2,2336,2485,-149,0,121,0,6
94525,2,2330,2442,-112,0,206,0,6
94526,1,2401,2396,5,0,245,1,6
94527,3,2578,2431,147,0,60,0,6
94528,1,2406,2276,130,0,122,0,6
94529,2,2503,2515,-12,0,484,0,6
94530,1,2407,2288,119,0,405,0,6
94531,1,2542,2561,-19,0,226,0,6
94532,2,2358,2430,-72,0,226,0,6
94533,1,2404,2440,-36,0,303,0,6
94534,3,2593,2490,103,0,4,0,6
94535,1,2429,2241,188,4,43,0,13
94536,1,2622,2500,122,0,242,0,6
94537,1,2422,2479,-57,4,43,0,13
94538,2,2348,2430,-82,0,42,0,6
94539,1,2493,2503,-10,0,483,0,6
94540,3,2449,2458,-9,0,8,0,6
94541,3,2590,2425,165,0,17,0,6
94542,1,2382,2418,-36,0,200,0,6
94543,2,2301,2423,-122,0,202,0,6
94544,2,2416,2417,-1,0,226,0,6
94545,2,2416,2437,-21,0,57,1,6
94546,1,2281,2423,-142,0,253,1,6
94547,1,2385,2416,-31,0,110,0,6
94548,2,2350,2494,-144,0,398,0,6
94549,1,2369,2401,-32,0,0,0,6
94550,2,2576,2590,-14,0,45,0,6
94551,2,2411,2464,-53,0,110,1,6
94552,2,2402,2521,-119,0,216,0,6
94553,2,2334,2423,-89,0,150,0,6
94554,1,2432,2386,46,0,260,0,6
94555,2,2441,2303,138,0,4,1,6
94556,2,2434,2434,0,0,305,0,6
94557,2,2280,2415,-135,0,101,0,8
94558,2,2401,2414,-13,0,241,0,6
94559,1,2448,2371,77,0,200,0,6
94560,1,2438,2423,15,0,445,0,6
94561,2,2338,2420,-82,0,484,0,6
94562,3,2510,2407,103,0,436,0,6
94563,2,2498,2680,-182,0,373,1,6
94564,1,2429,2359,70,0,223,0,6
94565,2,2285,2417,-132,0,118,0,6
94566,3,2606,2522,84,0,152,0,6
94567,1,2466,2426,40,0,130,1,6
94568,2,2489,2555,-66,0,483,1,6
94569,2,2437,2404,33,0,45,1,6
94570,1,2435,2331,104,0,474,0,6
94571,2,2606,2472,134,0,4,0,6
94572,2,2323,2472,-149,0,152,0,6
94573,1,2425,2259,166,0,10,0,6
94574,2,2209,2492,-283,0,131,0,6
94575,3,2281,2518,-237,0,125,0,6
94576,2,2274,2404,-130,0,327,0,6
94577,1,2427,2316,111,0,112,0,6
94578,2,2425,2229,196,0,343,0,6
94579,2,2626,2599,27,0,123,0,6
94580,2,2353,2498,-145,0,200,1,6
94581,1,2255,2424,-169,0,47,0,6
94582,1,2331,2410,-79,0,111,0,6
94583,1,2557,2591,-34,0,250,0,6
94584,1,2410,2392,18,0,4,1,6
94585,1,2389,2492,-103,0,45,0,6
94586,2,2359,2569,-210,0,53,0,6
94587,2,2663,2476,187,0,45,0,6
94588,2,2434,2368,66,0,242,1,6
94589,1,2420,2395,25,0,150,0,6
94590,2,2378,2501,-123,0,1,0,6
94591,1,2411,2378,33,0,415,0,6
94592,2,2585,2427,158,0,115,1,6
94593,1,2381,2437,-56,0,106,0,6
94594,2,2357,2411,-54,0,46,1,6
94595,1,2401,2323,78,0,20,0,6
94596,3,2509,2388,121,0,40,0,6
94597,2,2255,2453,-198,0,49,0,6
94598,1,2410,2341,69,0,386,0,6
94599,3,2443,2548,-105,0,102,0,6
94600,2,2413,2330,83,0,140,1,6
94601,2,2423,2343,80,0,200,0,6
94602,2,2406,2368,38,0,123,0,6
94603,1,2406,2324,82,0,210,0,6
94604,1,2571,2398,173,0,45,0,6
94605,2,2596,2620,-24,0,454,0,6
94606,1,2428,2371,57,0,49,0,6
94607,2,2480,2597,-117,0,242,0,6
94608,2,2408,2267,141,0,112,1,6
94609,1,2469,2522,-53,0,110,0,6
94610,2,2370,2433,-63,0,107,0,6
94611,1,2506,2383,123,0,320,0,6
94612,1,2415,2417,-2,0,70,0,6
94613,2,2421,2538,-117,0,80,0,6
94614,1,2354,2471,-117,0,217,0,6
94615,2,2401,2415,-14,0,380,0,6
94616,2,2484,2684,-200,0,310,0,6
94617,1,2410,2431,-21,0,0,0,6
94618,1,2559,2605,-46,0,405,0,6
94619,2,2417,2449,-32,4,217,0,13
94620,2,2360,2471,-111,0,265,0,6
94621,2,2403,2484,-81,0,0,0,6
94622,3,2440,2284,156,0,158,0,6
94623,1,2345,2415,-70,0,45,0,6
94624,1,2386,2417,-31,0,200,1,6
94625,3,2431,2337,94,0,130,0,6
94626,1,2374,2416,-42,0,106,0,6
94627,1,2525,2398,127,0,484,0,6
94628,3,2458,2416,42,0,8,0,6
94629,1,2449,2316,133,0,7,1,6
94630,3,2443,2407,36,0,143,0,6
94631,2,2438,2585,-147,0,6,0,6
94632,1,2501,2443,58,0,463,0,6
94633,2,2359,2532,-173,0,140,0,6
94634,1,2546,2563,-17,0,153,0,6
94635,2,2445,2455,-10,0,151,1,6
94636,2,2412,2507,-95,0,300,0,6
94637,2,2251,2411,-160,0,321,0,6
94638,1,2443,2402,41,0,104,1,6
94639,2,2504,2476,28,0,114,0,6
94640,2,2495,2504,-9,0,46,0,6
94641,2,2425,2342,83,0,458,0,6
94642,2,2433,2405,28,0,194,0,6
94643,2,2523,2605,-82,0,278,0,6
94644,1,2439,2341,98,0,337,0,6
94645,1,2542,2417,125,0,415,1,6
94646,1,2572,2357,215,0,148,0,6
94647,1,2577,2582,-5,0,132,1,6
94648,2,2427,2400,27,0,211,0,6
94649,1,2558,2374,184,0,201,0,6
94650,1,2430,2388,42,0,255,0,6
94651,2,2288,2479,-191,4,4,0,0
94652,1,2361,2416,-55,0,28,0,6
94653,1,2625,2499,126,0,111,0,6
94654,2,2591,2574,17,0,308,0,6
94655,1,2475,2356,119,0,45,0,6
94656,3,2687,2481,206,0,177,0,6
94657,1,2436,2429,7,4,201,0,13
94658,1,2406,2352,54,0,115,0,6
94659,1,2421,2235,186,0,246,0,6
94660,2,2350,2405,-55,0,244,0,6
94661,1,2375,2429,-54,0,56,0,6
94662,1,2442,2277,165,4,122,0,13
94663,2,2425,2421,4,0,45,1,6
94664,2,2412,2416,-4,0,406,0,6
94665,1,2390,2425,-35,0,107,0,6
94666,2,2478,2580,-102,0,309,0,6
94667,1,2489,2421,68,0,303,0,6
94668,1,2390,2407,-17,0,245,0,6
94669,1,2338,2400,-62,0,178,1,6
94670,1,2588,2435,153,0,461,0,6
94671,3,2417,2290,127,0,40,0,6
94672,1,2280,2458,-178,0,200,0,6
94673,2,2396,2443,-47,0,127,0,6
94674,3,2396,2566,-170,0,485,0,6
94675,3,2598,2587,11,0,123,0,6
94676,1,2408,2427,-19,0,440,0,6
94677,1,2511,2461,50,0,45,0,6
94678,1,2410,2346,64,0,40,0,6
94679,1,2438,2274,164,0,101,0,6
94680,2,2375,2493,-118,0,40,0,6
94681,2,2422,2406,16,0,0,0,6
94682,1,2510,2552,-42,0,335,0,6
94683,3,2358,2515,-157,0,410,0,6
94684,2,2528,2262,266,0,5,1,6
94685,1,2263,2454,-191,0,110,0,6
94686,1,2414,2283,131,0,101,0,6
94687,3,2356,2416,-60,0,113,0,6
94688,2,2557,2629,-72,0,107,0,6
94689,1,2275,2411,-136,0,15,1,6
94690,1,2479,2421,58,0,308,0,6
94691,2,2329,2509,-180,4,4,1,13
94693,2,2437,2349,88,0,100,1,6
94694,3,2574,2373,201,0,210,0,6
94695,1,2413,2546,-133,0,46,0,6
94696,1,2409,2448,-39,0,107,0,6
94697,2,2461,2347,114,0,106,0,6
94698,1,2609,2519,90,0,20,1,6
94699,2,2484,2684,-200,0,310,0,6
94700,2,2439,2418,21,0,243,0,6
94701,1,2482,2513,-31,0,102,1,6
94702,2,2495,2497,-2,0,380,0,6
94703,1,2584,2371,213,0,80,0,6
94704,2,2493,2419,74,0,46,0,6
94705,2,2419,2299,120,0,44,0,8
94706,2,2512,2318,194,4,300,0,13
94707,2,2260,2429,-169,0,106,0,6
94708,3,2429,2427,2,0,50,0,6
94709,2,2510,2419,91,0,57,0,6
94710,2,2400,2277,123,0,354,0,8
94711,2,2431,2592,-161,0,6,0,6
94712,2,2401,2371,30,0,48,0,6
94713,2,2552,2587,-35,0,101,0,6
94714,2,2432,2454,-22,0,1,0,6
94715,2,2412,2416,-4,0,409,0,6
94716,1,2563,2423,140,0,56,1,6
94717,1,2415,2244,171,0,403,0,6
94718,1,2419,2343,76,0,195,0,6
94719,1,2448,2441,7,0,334,0,6
94720,1,2588,2565,23,0,411,0,6
94721,2,2504,2402,102,4,300,0,13
94722,1,2543,2516,27,0,132,1,6
94723,1,2426,2433,-7,0,1,0,6
94724,1,2416,2484,-68,0,36,0,6
94725,1,2408,2448,-40,0,120,0,6
94726,1,2687,2482,205,0,133,0,6
94727,1,2445,2389,56,4,248,0,13
94728,1,2442,2450,-8,0,176,0,6
94729,2,2287,2571,-284,0,255,0,6
94730,3,2516,2474,42,0,311,0,6
94731,1,2416,2385,31,0,200,0,6
94732,2,2598,2634,-36,0,123,1,6
94733,2,2344,2401,-57,0,315,0,8
94734,2,2355,2415,-60,0,300,0,6
94735,1,2434,2407,27,0,201,0,6
94736,2,2454,2429,25,0,50,1,6
94737,2,2404,2423,-19,0,131,1,6
94738,1,2576,2553,23,0,151,1,6
94739,1,2538,2379,159,0,200,0,6
94740,1,2487,2311,176,0,303,0,6
94741,3,2595,2428,167,0,107,0,6
94742,2,2334,2421,-87,0,1,0,6
94744,2,2507,2456,51,0,46,1,6
94745,2,2435,2596,-161,0,49,0,6
94746,3,2238,2458,-220,0,385,0,6
94747,1,2452,2432,20,0,127,1,6
94748,1,2592,2460,132,0,426,0,6
94749,2,2454,2410,44,4,107,0,13
94750,2,2427,2424,3,0,118,0,6
94752,1,2427,2272,155,0,394,0,6
94753,2,2282,2429,-147,0,106,1,6
94754,2,2689,2488,201,0,113,0,6
94755,2,2426,2435,-9,0,111,0,6
94756,1,2444,2268,176,0,176,0,6
94757,2,2448,2494,-46,0,189,0,6
94758,2,2389,2547,-158,0,60,0,6
94759,1,2515,2614,-99,0,211,0,6
94760,1,2442,2342,100,0,474,0,6
94761,2,2475,2442,33,4,250,0,13
94762,3,2415,2367,48,0,13,0,6
94763,2,2566,2602,-36,0,13,1,6
94764,1,2423,2268,155,0,120,0,6
94765,1,2421,2414,7,0,46,0,6
94766,2,2478,2443,35,0,292,0,6
94767,2,2249,2406,-157,0,305,0,6
94768,2,2391,2563,-172,0,105,0,6
94769,2,2512,2567,-55,0,143,0,6
94770,3,2414,2361,53,0,288,0,6
94771,1,2381,2479,-98,0,37,0,6
94772,1,2277,2419,-142,0,113,1,6
94773,1,2454,2429,25,0,412,0,6
94774,2,2420,2456,-36,0,52,0,6
94775,3,2402,2412,-10,0,300,0,6
94776,3,2454,2450,4,0,7,0,6
94777,1,2291,2418,-127,0,193,0,6
94778,1,2502,2595,-93,0,106,0,6
94779,1,2429,2421,8,0,253,0,6
94780,1,2593,2583,10,0,14,1,6
94781,2,2337,2515,-178,0,113,0,6
94782,1,2435,2374,61,0,211,0,6
94783,2,2425,2317,108,0,227,1,6
94784,3,2564,2475,89,0,140,0,6
94785,1,2433,2344,89,0,107,1,6
94786,1,2436,2490,-54,0,221,0,6
94787,2,2424,2416,8,0,288,0,6
94788,3,2426,2459,-33,0,18,0,6
94789,1,2224,2454,-230,0,253,0,6
94790,1,2447,2398,49,0,200,1,6
94791,3,2311,2553,-242,0,0,0,6
94792,2,2385,2431,-46,0,130,0,6
94793,1,2572,2384,188,0,57,0,6
94794,2,2379,2420,-41,0,46,1,6
94795,1,2418,2272,146,0,150,1,6
94796,3,2381,2414,-33,0,302,0,6
94797,1,2547,2581,-34,0,130,1,6
94798,1,2488,2428,60,0,31,0,6
94799,1,2435,2413,22,0,122,0,6
94800,2,2500,2681,-181,0,344,0,6
94801,1,2446,2275,171,0,61,0,6
94802,2,2370,2601,-231,0,1,0,6
94803,1,2497,2499,-2,0,120,1,6
94804,2,2319,2440,-121,0,334,0,6
94805,2,2398,2427,-29,0,106,1,6
94806,1,2437,2458,-21,0,324,1,6
94807,1,2411,2372,39,0,210,0,6
94808,2,2439,2373,66,0,200,1,6
94809,2,2433,2287,146,0,180,0,6
94810,1,2427,2442,-15,0,331,0,6
94811,1,2472,2430,42,0,409,0,6
94812,1,2608,2561,47,0,332,0,6
94813,1,2410,2252,158,0,106,1,6
94814,1,2415,2246,169,0,487,0,6
94815,3,2260,2410,-150,0,312,0,6
94816,1,2422,2439,-17,0,140,1,6
94817,1,2532,2497,35,0,3,0,6
94818,3,2497,2483,14,0,242,0,6
94819,1,2476,2562,-86,0,228,0,6
94820,3,2445,2453,-8,0,8,0,6
94821,2,2447,2380,67,0,107,0,6
94822,1,2684,2518,166,0,113,0,6
94824,2,2436,2575,-139,0,454,0,6
94825,1,2577,2602,-25,0,243,0,6
94826,3,2505,2506,-1,0,4,0,6
94827,3,2408,2239,169,0,95,0,6
94828,2,2312,2402,-90,0,345,1,6
94829,3,2603,2367,236,0,80,0,6
94830,3,2606,2409,197,0,112,0,6
94831,1,2420,2418,2,0,46,0,6
94832,1,2381,2427,-46,0,143,0,6
94833,3,2459,2418,41,0,314,0,6
94834,2,2549,2315,234,0,131,0,6
94835,3,2567,2388,179,0,262,0,6
94836,1,2243,2449,-206,0,311,0,6
94837,2,2553,2489,64,0,112,0,6
94838,1,2483,2369,114,0,202,0,6
94839,2,2279,2452,-173,0,1,0,6
94840,1,2392,2477,-85,0,375,0,6
94841,2,2400,2345,55,0,4,1,6
94842,2,2554,2462,92,0,0,0,6
94843,3,2426,2366,60,0,106,0,6
94844,2,2422,2288,134,0,140,1,6
94845,2,2205,2425,-220,0,301,0,8
94846,1,2432,2332,100,0,40,0,6
94847,3,2423,2493,-70,0,40,0,6
94848,1,2407,2537,-130,0,40,1,6
94849,2,2400,2374,26,0,200,0,6
94850,2,2279,2402,-123,0,277,1,6
94851,2,2331,2452,-121,0,107,0,6
94852,1,2412,2269,143,0,347,0,8
94853,1,2413,2338,75,0,343,0,6
94854,2,2554,2503,51,0,112,0,6
94855,2,2324,2503,-179,0,315,0,6
94856,2,2415,2296,119,0,142,0,6
94857,1,2498,2322,176,0,101,0,6
94858,1,2545,2556,-11,0,254,0,6
94859,3,2432,2428,4,0,15,0,6
94860,2,2326,2411,-85,0,41,1,6
94861,1,2497,2319,178,4,300,0,13
94862,3,2432,2343,89,0,52,0,6
94863,1,2578,2515,63,0,315,1,6
94864,1,2449,2424,25,0,51,0,6
94865,1,2469,2583,-114,0,341,0,6
94866,2,2438,2595,-157,0,14,0,6
94867,1,2717,2649,68,0,301,0,6
94868,2,2333,2418,-85,0,245,0,6
94869,1,2381,2411,-30,0,334,0,6
94870,2,2433,2320,113,0,110,1,6
94871,2,2468,2448,20,4,345,0,13
94872,3,2371,2592,-221,0,101,0,6
94873,3,2407,2308,99,0,43,0,6
94874,2,2333,2419,-86,0,206,0,6
94875,1,2412,2458,-46,0,120,1,6
94876,2,2505,2444,61,0,4,0,6
94877,1,2537,2347,190,0,276,0,6
94878,1,2477,2342,135,0,10,1,6
94879,1,2349,2420,-71,0,201,1,6
94880,3,2394,2436,-42,0,277,0,6
94881,1,2400,2241,159,0,50,0,6
94882,1,2440,2487,-47,0,226,0,6
94883,1,2547,2546,1,0,175,0,6
94884,1,2419,2228,191,4,211,0,13
94885,2,2492,2424,68,0,31,0,6
94886,1,2303,2463,-160,0,45,0,6
94887,1,2423,2359,64,0,356,1,6
94888,1,2550,2551,-1,0,21,0,6
94889,3,2367,2425,-58,0,1,0,6
94890,1,2529,2415,114,0,2,0,6
94891,1,2225,2401,-176,0,245,0,8
94892,1,2508,2213,295,0,102,0,6
94893,2,2201,2520,-319,0,30,0,6
94894,1,2360,2421,-61,0,100,1,6
94895,2,2436,2337,99,0,4,0,6
94896,1,2509,2497,12,0,200,0,6
94897,1,2433,2306,127,0,40,1,6
94898,1,2328,2437,-109,0,0,0,6
94899,2,2422,2329,93,0,325,0,6
94900,1,2506,2345,161,0,84,1,6
94901,1,2456,2333,123,0,140,0,6
94902,1,2506,2448,58,0,352,0,6
94903,2,2481,2508,-27,0,80,0,6
94904,1,2434,2409,25,0,15,1,6
94905,1,2274,2440,-166,0,31,1,6
94906,1,2576,2431,145,0,153,0,6
94907,2,2340,2477,-137,0,254,0,6
94908,2,2416,2321,95,0,245,0,6
94909,1,2428,2499,-71,0,265,0,6
94910,2,2319,2426,-107,0,4,0,6
94911,2,2412,2454,-42,0,120,0,6
94912,1,2455,2389,66,0,313,0,6
94913,1,2510,2338,172,0,131,0,6
94914,2,2519,2546,-27,0,5,0,6
94915,2,2456,2405,51,0,317,0,6
94916,1,2408,2358,50,0,491,1,6
94917,1,2429,2348,81,0,60,0,6
94918,1,2451,2472,-21,0,311,1,6
94919,2,2589,2556,33,0,332,1,6
94920,1,2411,2533,-122,0,40,0,6
94921,1,2496,2540,-44,0,44,0,6
94922,1,2419,2425,-6,0,106,0,6
94923,1,2431,2485,-54,0,40,0,6
94924,2,2477,2502,-25,0,101,1,6
94925,1,2429,2433,-4,0,357,0,6
94926,2,2374,2511,-137,0,1,0,6
94927,1,2402,2360,42,0,10,1,6
94928,2,2444,2481,-37,0,57,0,6
94929,1,2387,2509,-122,0,7,1,6
94930,2,2419,2371,48,0,197,1,6
94931,2,2424,2367,57,0,110,0,6
94932,2,2414,2458,-44,0,120,1,6
94933,2,2270,2622,-352,4,337,1,8
94934,2,2428,2351,77,0,415,0,6
94935,1,2336,2415,-79,0,245,0,6
94936,1,2575,2550,25,0,211,1,6
94937,3,2450,2425,25,0,132,0,6
94938,2,2644,2721,-77,0,104,0,6
94939,2,2309,2434,-125,0,45,0,6
94940,2,2476,2399,77,0,40,0,6
94941,3,2337,2460,-123,0,107,0,6
94942,1,2481,2298,183,0,44,0,6
94943,3,2335,2459,-124,0,243,0,6
94944,2,2438,2339,99,0,100,0,6
94945,1,2427,2227,200,0,110,0,8
94946,2,2372,2492,-120,0,487,0,6
94947,3,2384,2427,-43,0,156,0,6
94948,1,2515,2579,-64,0,101,0,6
94949,1,2444,2266,178,0,121,0,6
94950,2,2399,2440,-41,0,246,1,6
94951,2,2401,2602,-201,0,2,0,6
94952,1,2435,2287,148,0,142,1,6
94953,1,2520,2496,24,0,187,1,6
94954,1,2550,2342,208,0,13,0,6
94955,1,2459,2320,139,0,100,0,6
94956,3,2600,2310,290,0,150,0,6
94957,1,2491,2492,-1,0,267,0,6
94958,1,2424,2249,175,0,14,0,6
94959,2,2534,2616,-82,0,150,0,6
94960,2,2457,2403,54,0,469,0,6
94961,1,2479,2435,44,0,39,0,6
94962,1,2514,2370,144,0,205,0,6
94963,3,2555,2514,41,0,140,0,6
94964,2,2371,2514,-143,0,117,0,6
94965,1,2526,2553,-27,0,3,0,6
94966,1,2463,2408,55,0,141,0,6
94967,2,2391,2460,-69,0,320,0,6
94968,2,2419,2425,-6,0,102,0,6
94969,1,2431,2469,-38,0,408,0,6
94970,2,2353,2413,-60,0,101,0,6
94971,2,2406,2387,19,0,0,1,6
94972,2,2583,2486,97,0,45,0,6
94973,1,2307,2432,-125,0,45,0,6
94974,1,2322,2408,-86,0,300,0,6
94975,1,2508,2492,16,0,56,1,6
94976,2,2412,2313,99,0,111,0,6
94977,1,2458,2378,80,0,337,0,6
94978,3,2562,2518,44,0,25,0,6
94979,2,2349,2417,-68,0,14,0,6
94980,3,2337,2421,-84,0,211,0,6
94981,1,2409,2264,145,0,110,0,6
94982,2,2430,2484,-54,0,115,1,6
94983,2,2513,2398,115,0,40,1,6
94984,1,2502,2573,-71,0,315,0,6
94985,1,2380,2458,-78,0,247,0,6
94986,1,2246,2408,-162,0,251,0,6
94987,1,2454,2423,31,4,178,1,13
94988,2,2400,2450,-50,0,241,1,6
94989,1,2438,2306,132,0,50,0,6
94990,1,2340,2467,-127,0,145,0,6
94991,1,2346,2427,-81,0,1,0,6
94992,1,2447,2389,58,0,121,0,6
94993,1,2484,2315,169,0,106,0,6
94994,3,2359,2479,-120,0,40,0,6
94995,1,2512,2367,145,0,205,0,6
94996,1,2458,2369,89,0,203,0,6
94997,2,2462,2562,-100,0,303,0,6
94998,2,2235,2428,-193,0,110,1,6
94999,1,2521,2338,183,0,9,1,6
95000,1,2415,2283,132,0,257,0,6
95001,3,2276,2426,-150,0,4,0,6
95002,1,2414,2338,76,0,120,0,6
95003,2,2427,2357,70,0,176,1,6
95004,1,2388,2437,-49,0,453,0,6
95005,2,2339,2400,-61,0,260,0,6
95006,2,2404,2488,-84,4,277,0,13
95007,1,2553,2564,-11,0,110,0,6
95008,2,2364,2436,-72,0,107,0,6
95009,1,2379,2418,-39,0,106,0,6
95010,1,2547,2532,15,0,214,0,6
95011,2,2484,2413,71,0,380,0,6
95012,2,2509,2522,-13,0,306,1,6
95013,1,2566,2405,161,0,121,0,6
95014,1,2344,2451,-107,0,487,1,6
95015,1,2414,2410,4,0,228,1,6
95016,1,2404,2472,-68,0,111,0,6
95017,2,2530,2486,44,0,253,0,6
95018,1,2374,2462,-88,0,325,0,6
95019,1,2421,2387,34,0,40,1,6
95020,1,2442,2480,-38,0,45,0,6
95021,2,2640,2616,24,0,200,0,6
95022,2,2405,2393,12,0,13,0,6
95024,1,2414,2367,47,0,107,0,6
95025,2,2224,2430,-206,0,236,0,8
95026,1,2503,2458,45,0,243,1,6
95027,1,2462,2452,10,0,4,0,6
95028,1,2580,2555,25,0,150,1,6
95029,2,2726,2639,87,0,301,0,6
95030,3,2240,2415,-175,0,205,0,6
95031,1,2569,2575,-6,0,101,0,6
95032,2,2350,2418,-68,0,46,1,6
95033,1,2420,2320,100,0,315,0,6
95034,1,2464,2370,94,0,338,0,6
95035,2,2588,2560,28,0,46,0,6
95036,2,2405,2513,-108,0,3,0,6
95037,2,2394,2400,-6,0,108,0,6
95038,2,2487,2515,-28,0,302,1,6
95039,3,2310,2418,-108,0,311,0,6
95040,2,2349,2401,-52,0,144,1,6
95041,2,2519,2561,-42,0,247,0,6
95042,1,2455,2381,74,0,152,0,6
95043,2,2337,2420,-83,0,40,0,6
95044,2,2460,2471,-11,0,153,0,6
95045,1,2509,2363,146,0,100,0,6
95046,1,2619,2516,103,0,107,0,6
95047,2,2374,2412,-38,0,143,1,6
95048,1,2339,2447,-108,0,240,0,6
95049,2,2554,2559,-5,0,490,1,6
95050,1,2493,2468,25,0,45,0,6
95051,2,2399,2400,-1,0,17,0,6
95052,2,2288,2441,-153,0,180,0,6
95053,2,2520,2487,33,0,46,0,6
95054,2,2517,2455,62,0,43,1,6
95055,1,2390,2431,-41,0,241,0,6
95056,2,2448,2566,-118,0,455,0,6
95057,2,2420,2478,-58,0,13,0,6
95058,2,2353,2440,-87,0,1,0,6
95059,2,2527,2552,-25,0,3,0,6
95060,1,2423,2445,-22,0,45,1,6
95061,1,2344,2474,-130,0,103,0,6
95062,2,2523,2448,75,0,0,0,6
95063,1,2566,2514,52,0,25,1,6
95064,2,2451,2320,131,4,202,0,13
95065,1,2493,2506,-13,0,4,0,6
95066,1,2432,2349,83,0,4,0,6
95067,1,2494,2379,115,0,130,1,6
95068,1,2517,2388,129,0,122,1,6
95069,1,2369,2444,-75,0,49,0,6
95070,2,2426,2343,83,0,310,0,6
95071,1,2559,2575,-16,0,315,0,6
95072,2,2360,2404,-44,0,1,0,6
95073,2,2570,2512,58,0,330,0,6
95074,1,2411,2330,81,0,212,0,6
95075,1,2517,2436,81,0,106,0,6
95076,2,2581,2401,180,0,40,0,6
95077,2,2376,2460,-84,0,107,0,6
95078,2,2406,2443,-37,0,250,0,6
95079,1,2325,2477,-152,0,303,1,8
95080,2,2294,2471,-177,0,156,0,6
95081,1,2501,2303,198,0,106,0,6
95082,1,2566,2586,-20,0,398,1,6
95083,1,2453,2338,115,0,300,0,6
95084,2,2503,2508,-5,0,48,0,6
95085,2,2394,2512,-118,0,16,1,6
95086,2,2410,2573,-163,0,2,0,6
95087,1,2396,2419,-23,0,279,0,6
95088,2,2477,2425,52,0,288,0,6
95089,2,2430,2465,-35,0,115,0,6
95090,3,2317,2441,-124,0,180,0,6
95091,1,2424,2346,78,0,41,0,6
95092,2,2358,2423,-65,0,45,1,6
95093,2,2355,2439,-84,0,271,0,6
95094,2,2432,2315,117,0,0,1,6
95095,1,2481,2454,27,0,106,0,6
95096,1,2388,2457,-69,0,54,0,6
95097,1,2497,2499,-2,0,278,0,6
95098,1,2514,2425,89,0,112,1,6
95099,1,2508,2497,11,0,101,0,6
95100,2,2433,2222,211,0,264,0,8
95101,1,2431,2527,-96,0,200,0,6
95102,1,2421,2564,-143,0,487,0,6
95103,1,2363,2437,-74,0,474,1,6
95104,3,2417,2427,-10,0,468,0,6
95105,1,2432,2470,-38,0,151,0,6
95106,3,2391,2423,-32,0,337,0,6
95107,2,2493,2569,-76,0,302,1,6
95108,1,2446,2469,-23,0,127,0,6
95109,2,2445,2323,122,0,113,0,6
95110,1,2451,2487,-36,0,46,0,6
95111,1,2482,2415,67,0,380,0,6
95112,1,2409,2257,152,0,106,0,6
95113,1,2511,2384,127,0,0,0,6
95114,2,2255,2416,-161,0,307,0,6
95115,1,2500,2366,134,0,409,0,6
95116,2,2499,2455,44,0,7,1,6
95117,2,2545,2360,185,0,153,0,6
95118,1,2439,2384,55,0,414,1,6
95119,1,2521,2447,74,0,2,0,6
95120,2,2349,2498,-149,0,1,0,6
95121,1,2504,2355,149,0,80,0,6
95122,1,2571,2565,6,0,25,0,6
95123,2,2474,2291,183,0,0,0,6
95124,2,2429,2503,-74,0,40,0,6
95125,2,2444,2429,15,0,200,0,6
95126,2,2402,2255,147,0,121,0,6
95127,1,2599,2563,36,0,311,0,6
95128,3,2356,2419,-63,0,100,0,6
95129,1,2524,2251,273,0,8,1,6
95130,1,2407,2213,194,0,32,0,6
95131,1,2464,2438,26,0,250,0,6
95132,1,2394,2457,-63,0,247,0,6
95133,1,2481,2576,-95,0,43,0,6
95134,1,2438,2372,66,0,14,0,6
95135,2,2493,2341,152,0,115,0,6
95136,3,2622,2653,-31,0,300,0,6
95137,2,2449,2401,48,0,323,1,6
95138,1,2412,2424,-12,0,45,0,6
95139,2,2501,2407,94,0,200,0,6
95140,2,2361,2449,-88,0,307,0,6
95141,3,2391,2416,-25,0,203,0,6
95142,1,2412,2246,166,0,200,0,6
95143,2,2366,2493,-127,0,463,0,6
95144,1,2425,2333,92,0,45,0,6
95145,1,2452,2212,240,0,306,0,8
95146,1,2557,2425,132,0,10,0,6
95147,2,2367,2442,-75,0,487,0,6
95148,1,2429,2469,-40,0,302,0,6
95149,1,2433,2485,-52,0,106,0,6
95150,1,2349,2530,-181,0,300,0,6
95151,2,2410,2537,-127,0,4,1,6
95152,1,2423,2324,99,0,22,0,6
95153,1,2403,2346,57,0,40,0,6
95154,1,2446,2319,127,0,143,1,6
95155,3,2439,2358,81,0,106,0,6
95156,1,2593,2418,175,0,4,0,6
95157,2,2427,2450,-23,0,54,0,6
95158,1,2452,2514,-62,0,110,0,6
95159,2,2400,2259,141,4,261,0,13
95160,1,2370,2439,-69,0,106,0,6
95161,1,2560,2577,-17,0,332,0,6
95162,1,2420,2341,79,0,100,0,6
95163,1,2520,2518,2,0,100,0,6
95164,1,2444,2270,174,0,464,0,6
95165,1,2574,2488,86,0,102,1,6
95166,2,2489,2569,-80,0,43,0,6
95167,2,2350,2412,-62,0,202,0,6
95168,2,2352,2558,-206,0,101,0,6
95169,2,2412,2299,113,0,202,0,6
95170,2,2447,2437,10,0,20,0,6
95171,2,2231,2424,-193,0,278,0,8
95172,3,2647,2719,-72,0,104,0,6
95173,1,2462,2345,117,0,40,1,6
95174,1,2442,2526,-84,0,214,0,6
95175,1,2487,2349,138,0,43,0,6
95176,2,2317,2409,-92,0,244,1,6
95177,2,2453,2462,-9,0,415,0,6
95178,1,2418,2522,-104,0,4,1,6
95179,3,2413,2326,87,0,405,0,6
95180,1,2406,2306,100,0,210,0,6
95181,2,2289,2428,-139,0,127,0,6
95182,1,2435,2255,180,0,415,0,6
95183,2,2389,2459,-70,4,345,1,13
95184,2,2414,2508,-94,0,3,0,6
95185,1,2300,2466,-166,0,4,0,6
95186,2,2505,2322,183,0,121,0,6
95187,1,2415,2291,124,0,45,0,6
95188,1,2746,2599,147,0,360,0,6
95189,1,2405,2339,66,0,101,1,6
95190,2,2329,2429,-100,0,121,1,6
95191,1,2481,2415,66,0,45,0,6
95192,1,2484,2519,-35,0,97,1,6
95193,2,2392,2402,-10,4,145,0,13
95194,2,2201,2455,-254,0,200,1,8
95195,1,2449,2560,-111,0,241,0,6
95196,1,2391,2413,-22,0,312,1,6
95197,3,2652,2634,18,0,125,0,6
95198,3,2416,2537,-121,0,15,0,6
95199,1,2401,2288,113,0,200,0,6
95200,2,2407,2337,70,0,214,0,6
95201,2,2414,2596,-182,0,335,0,6
95202,2,2425,2328,97,0,226,0,6
95203,1,2438,2317,121,0,484,1,6
95204,3,2359,2437,-78,0,191,0,6
95205,2,2386,2463,-77,0,241,1,6
95206,2,2336,2448,-112,0,1,0,6
95207,1,2447,2467,-20,0,7,0,6
95208,1,2621,2436,185,0,419,0,6
95209,2,2316,2449,-133,0,176,1,6
95210,1,2459,2335,124,0,101,0,6
95211,2,2333,2508,-175,0,302,1,6
95212,2,2395,2447,-52,0,122,0,6
95213,2,2478,2440,38,0,45,0,6
95214,1,2462,2340,122,0,343,0,6
95215,1,2577,2565,12,0,15,1,6
95216,1,2296,2452,-156,0,202,0,6
95217,1,2512,2516,-4,0,315,1,6
95218,2,2404,2418,-14,0,201,0,6
95219,2,2320,2411,-91,0,150,1,6
95220,3,2432,2377,55,0,227,0,6
95221,1,2456,2429,27,0,46,1,6
95222,2,2287,2419,-132,0,201,1,6
95223,1,2244,2422,-178,0,343,0,6
95224,2,2358,2417,-59,0,80,1,6
95225,1,2574,2484,90,0,8,1,6
95226,1,2578,2410,168,0,200,0,6
95227,1,2492,2537,-45,0,302,0,6
95228,2,2460,2319,141,0,310,0,6
95229,1,2443,2489,-46,4,122,0,13
95230,2,2466,2376,90,0,45,1,6
95231,2,2264,2410,-146,0,337,0,6
95232,3,2596,2373,223,0,1,0,6
95233,2,2571,2604,-33,0,487,0,6
95234,3,2497,2362,135,0,200,0,6
95235,1,2439,2300,139,0,263,0,6
95236,2,2501,2349,152,0,10,0,6
95237,2,2566,2750,-184,0,40,0,6
95238,2,2464,2394,70,0,125,0,6
95239,2,2435,2441,-6,0,373,0,6
95240,1,2432,2400,32,0,42,0,6
95241,1,2344,2452,-108,0,101,1,6
95242,1,2514,2426,88,0,45,0,6
95243,1,2446,2472,-26,0,108,0,6
95244,3,2554,2599,-45,0,277,0,6
95245,1,2509,2369,140,0,320,0,6
95246,1,2413,2313,100,0,200,1,6
95247,2,2363,2449,-86,0,310,0,6
95248,1,2433,2410,23,0,148,1,6
95249,2,2486,2553,-67,0,490,1,6
95250,2,2580,2540,40,0,109,0,6
95251,1,2428,2455,-27,0,102,0,6
95252,2,2411,2426,-15,0,59,0,6
95253,3,2407,2375,32,0,330,0,6
95254,2,2470,2462,8,0,7,0,6
95255,1,2525,2502,23,0,0,0,6
95257,2,2634,2652,-18,0,130,0,6
95258,1,2629,2507,122,0,21,0,6
95259,2,2427,2228,199,0,101,0,8
95260,1,2718,2648,70,0,301,0,6
95261,1,2753,2563,190,0,406,0,6
95262,2,2433,2624,-191,0,302,1,6
95263,2,2418,2513,-95,0,201,0,6
95264,1,2407,2389,18,0,13,0,6
95265,2,2461,2333,128,0,100,0,6
95266,2,2387,2453,-66,0,140,1,6
95267,1,2330,2457,-127,0,302,0,6
95268,1,2452,2418,34,0,310,1,6
95269,1,2468,2581,-113,0,101,1,6
95270,2,2447,2285,162,0,38,1,6
95271,2,2407,2511,-104,0,2,0,6
95272,2,2269,2442,-173,0,200,0,6
95273,1,2573,2570,3,0,344,0,6
95274,2,2328,2512,-184,0,374,0,6
95275,2,2418,2526,-108,0,4,0,6
95276,2,2442,2279,163,0,45,1,6
95277,1,2421,2563,-142,0,122,0,6
95278,1,2400,2398,2,0,6,1,6
95279,1,2468,2316,152,0,143,0,6
95280,2,2340,2454,-114,0,1,0,6
95281,2,2517,2521,-4,0,2,1,6
95282,1,2521,2498,23,0,110,1,6
95283,1,2459,2312,147,0,15,0,6
95284,1,2377,2408,-31,0,310,0,6
95285,3,2286,2414,-128,0,254,0,6
95286,2,2357,2511,-154,0,120,0,6
95287,1,2595,2518,77,0,10,0,6
95288,1,2643,2722,-79,0,103,0,6
95289,3,2414,2423,-9,0,414,0,6
95290,2,2315,2543,-228,0,406,0,8
95291,1,2549,2633,-84,0,248,1,6
95292,1,2559,2560,-1,0,112,0,6
95293,1,2461,2338,123,0,45,0,6
95294,2,2385,2449,-64,0,123,1,6
95295,1,2343,2423,-80,0,0,1,6
95296,1,2479,2528,-49,0,302,1,6
95297,2,2429,2578,-149,0,43,0,6
95298,2,2356,2429,-73,0,36,0,6
95299,2,2422,2519,-97,0,127,1,6
95300,2,2353,2491,-138,0,46,1,6
95301,2,2610,2566,44,0,265,0,6
95302,3,2555,2403,152,0,210,0,6
95303,2,2355,2429,-74,0,110,1,6
95304,1,2457,2210,247,0,310,0,8
95305,1,2433,2462,-29,0,109,1,6
95306,2,2356,2443,-87,0,6,0,6
95307,1,2756,2265,491,0,315,0,6
95308,2,2546,2497,49,0,121,0,6
95309,2,2449,2465,-16,0,4,0,6
95310,1,2572,2458,114,0,402,0,6
95311,2,2430,2512,-82,0,304,0,6
95312,2,2400,2373,27,0,310,0,6
95313,1,2466,2316,150,0,310,0,6
95314,1,2493,2483,10,4,121,0,13
95315,2,2418,2423,-5,0,46,1,6
95316,3,2327,2414,-87,0,101,0,6
95317,1,2554,2555,-1,0,455,0,6
95318,1,2410,2452,-42,0,288,0,6
95319,2,2421,2253,168,0,113,1,6
95320,2,2405,2438,-33,0,140,0,6
95321,1,2555,2522,33,0,249,0,6
95322,1,2383,2471,-88,0,309,0,6
95323,2,2471,2337,134,0,145,0,6
95324,1,2481,2441,40,0,45,1,6
95325,1,2291,2432,-141,0,113,0,6
95326,2,2231,2409,-178,0,245,0,6
95327,2,2366,2445,-79,0,310,0,6
95328,1,2412,2413,-1,0,175,0,6
95329,1,2310,2456,-146,0,106,0,6
95330,2,2627,2430,197,0,419,0,6
95331,2,2287,2444,-157,0,278,0,6
95332,2,2237,2418,-181,0,231,1,8
95333,1,2466,2570,-104,0,122,1,6
95334,3,2454,2581,-127,0,43,0,6
95335,2,2305,2416,-111,0,133,0,8
95336,2,2576,2574,2,0,30,0,6
95337,1,2411,2333,78,0,405,0,6
95338,1,2477,2475,2,0,107,0,6
95339,1,2331,2413,-82,0,27,0,6
95340,2,2296,2466,-170,0,300,0,6
95341,2,2432,2314,118,0,5,0,6
95342,3,2377,2575,-198,0,31,0,6
95343,2,2437,2328,109,0,0,0,6
95344,2,2603,2514,89,0,142,0,6
95345,1,2756,2572,184,0,334,0,6
95346,1,2434,2258,176,0,40,0,6
95347,1,2364,2417,-53,0,61,0,6
95348,2,2653,2629,24,0,335,0,6
95349,2,2405,2552,-147,0,3,1,6
95350,1,2465,2526,-61,0,303,0,6
95351,2,2427,2334,93,0,20,0,6
95352,1,2514,2338,176,0,100,0,6
95353,1,2515,2354,161,0,80,0,6
95354,1,2454,2395,59,0,463,1,6
95355,1,2549,2560,-11,0,112,0,6
95356,2,2401,2277,124,0,300,0,6
95357,1,2470,2551,-81,0,255,0,6
95358,3,2375,2482,-107,0,101,0,6
95359,1,2486,2465,21,0,315,0,6
95360,2,2415,2443,-28,0,145,1,6
95361,1,2333,2400,-67,0,17,0,6
95362,1,2493,2502,-9,0,127,0,6
95364,1,2523,2417,106,0,45,0,6
95365,2,2439,2619,-180,0,302,0,6
95366,2,2517,2469,48,0,56,1,6
95367,2,2268,2408,-140,0,123,0,6
95368,1,2437,2626,-189,0,138,0,6
95369,1,2406,2338,68,0,30,0,6
95370,2,2462,2425,37,0,6,1,6
95371,3,2540,2322,218,0,48,0,6
95372,2,2434,2350,84,0,21,0,6
95373,3,2359,2449,-90,0,300,0,6
95374,1,2447,2351,96,0,140,0,6
95375,1,2533,2427,106,0,310,0,6
95376,2,2342,2439,-97,0,43,1,6
95377,2,2572,2427,145,0,45,0,6
95378,3,2456,2446,10,0,288,0,6
95379,1,2252,2416,-164,0,200,0,6
95380,2,2456,2336,120,0,100,1,6
95381,1,2448,2318,130,0,0,0,6
95382,3,2580,2373,207,0,9,0,6
95383,2,2407,2371,36,0,20,1,6
95384,2,2471,2532,-61,0,131,0,6
95385,2,2460,2310,150,0,313,0,6
95386,1,2428,2262,166,0,45,0,6
95387,1,2412,2300,112,0,302,0,6
95388,1,2715,2650,65,0,301,0,6
95389,2,2491,2561,-70,0,355,1,6
95390,1,2418,2449,-31,0,199,0,6
95391,1,2503,2463,40,0,133,0,6
95392,2,2569,2759,-190,0,10,0,6
95394,1,2580,2598,-18,0,107,0,6
95395,1,2504,2305,199,0,140,0,6
95396,2,2412,2329,83,0,414,0,6
95397,1,2499,2341,158,0,121,0,6
95398,1,2555,2554,1,0,112,0,6
95399,2,2517,2486,31,0,138,0,6
95400,1,2481,2427,54,0,277,0,6
95401,1,2624,2622,2,0,43,0,6
95402,2,2477,2499,-22,4,270,0,13
95403,1,2511,2340,171,0,112,0,6
95404,1,2262,2406,-144,0,247,1,6
95405,2,2407,2349,58,0,228,0,6
95406,3,2546,2390,156,0,440,0,8
95407,2,2384,2423,-39,0,310,1,6
95408,1,2521,2338,183,0,354,1,6
95409,2,2315,2451,-136,0,106,0,6
95410,1,2537,2564,-27,0,46,0,6
95411,1,2438,2507,-69,0,0,0,6
95412,2,2518,2383,135,0,337,1,6
95413,1,2455,2311,144,0,0,0,6
95414,1,2329,2429,-100,0,170,0,6
95415,2,2507,2588,-81,0,264,1,6
95416,1,2556,2402,154,0,210,0,6
95417,1,2439,2372,67,0,117,0,8
95418,1,2425,2325,100,0,4,0,6
95419,1,2544,2438,106,0,190,1,6
95420,2,2367,2416,-49,0,40,0,6
95421,2,2389,2521,-132,0,300,0,8
95422,2,2549,2561,-12,0,0,0,6
95423,1,2464,2379,85,4,278,0,13
95424,1,2477,2275,202,0,140,0,6
95425,2,2345,2527,-182,0,134,0,6
95426,2,2403,2517,-114,0,426,0,6
95427,1,2390,2415,-25,0,415,0,6
95428,2,2413,2527,-114,0,127,1,6
95429,1,2443,2453,-10,0,112,0,6
95430,1,2434,2226,208,0,6,0,6
95431,1,2439,2530,-91,0,409,0,6
95432,1,2513,2475,38,0,267,0,6
95433,3,2449,2446,3,0,242,0,6
95434,2,2381,2437,-56,0,455,0,6
95435,1,2563,2443,120,0,256,1,6
95436,3,2470,2463,7,0,474,0,6
95437,1,2476,2345,131,0,45,0,6
95438,1,2465,2385,80,0,118,1,6
95439,2,2308,2459,-151,0,106,0,6
95440,2,2448,2416,32,0,50,0,6
95441,1,2558,2383,175,0,115,0,6
95442,2,2443,2452,-9,0,242,0,6
95443,1,2357,2424,-67,0,46,0,6
95444,2,2300,2445,-145,0,106,0,6
95445,3,2635,2647,-12,0,255,0,6
95446,2,2344,2432,-88,0,1,0,6
95447,1,2316,2410,-94,0,151,1,6
95448,3,2515,2487,28,0,103,0,6
95449,2,2259,2448,-189,0,21,0,6
95450,3,2480,2514,-34,0,40,0,6
95451,1,2565,2518,47,0,248,0,6
95452,2,2428,2400,28,0,43,0,6
95453,1,2762,2567,195,0,334,0,6
95454,2,2377,2401,-24,0,310,0,6
95455,1,2566,2543,23,0,110,0,6
95456,2,2401,2384,17,0,253,1,6
95457,1,2501,2537,-36,0,131,0,6
95458,1,2462,2304,158,0,0,0,6
95459,1,2421,2364,57,0,106,0,6
95460,1,2486,2362,124,0,200,0,6
95461,2,2398,2559,-161,0,3,0,6
95462,2,2401,2270,131,0,255,1,6
95463,1,2458,2289,169,0,331,0,6
95464,1,2493,2511,-18,0,44,0,6
95465,2,2329,2449,-120,0,46,0,6
95466,2,2458,2456,2,0,4,0,6
95467,2,2429,2335,94,0,4,0,6
95468,1,2458,2479,-21,0,320,0,6
95469,3,2617,2630,-13,0,45,0,6
95470,2,2416,2422,-6,0,226,0,8
95471,1,2563,2395,168,0,210,0,6
95472,2,2523,2629,-106,0,47,0,6
95473,2,2293,2424,-131,0,65,0,6
95474,1,2593,2499,94,0,50,1,6
95475,3,2543,2561,-18,0,4,0,6
95476,3,2446,2326,120,0,1,0,6
95477,3,2469,2535,-66,0,102,0,6
95478,1,2447,2300,147,0,260,0,6
95479,2,2301,2465,-164,0,4,0,6
95480,3,2392,2543,-151,0,50,0,8
95481,2,2501,2570,-69,0,330,0,6
95482,1,2524,2513,11,0,386,0,6
95483,2,2341,2480,-139,0,245,0,6
95484,2,2428,2419,9,0,394,1,6
95485,2,2339,2400,-61,0,128,0,6
95486,1,2548,2473,75,0,241,0,6
95488,2,2507,2448,59,0,100,1,6
95489,1,2446,2449,-3,0,145,0,6
95490,1,2407,2434,-27,0,187,1,6
95491,2,2469,2298,171,0,0,0,6
95492,3,2425,2270,155,0,107,0,6
95493,2,2315,2472,-157,4,8,0,13
95494,1,2564,2510,54,0,30,0,6
95495,1,2412,2437,-25,0,40,0,6
95496,2,2340,2508,-168,0,300,0,6
95497,1,2531,2410,121,0,45,0,6
95498,1,2363,2474,-111,0,200,0,6
95499,2,2452,2442,10,0,462,0,6
95500,1,2354,2409,-55,0,46,1,6
95501,2,2462,2337,125,0,337,0,6
95502,2,2374,2433,-59,0,453,0,6
95503,1,2392,2566,-174,0,2,0,6
95504,1,2408,2407,1,0,40,0,6
95505,2,2522,2765,-243,0,270,0,6
95506,2,2531,2422,109,0,40,1,6
95507,2,2456,2514,-58,0,130,0,6
95508,1,2232,2449,-217,0,45,1,6
95509,1,2306,2460,-154,0,41,0,6
95510,3,2403,2257,146,0,470,0,6
95511,2,2514,2487,27,0,300,0,6
95512,3,2434,2462,-28,0,14,0,6
95513,2,2389,2411,-22,0,54,1,6
95514,2,2338,2483,-145,0,278,0,6
95515,2,2292,2401,-109,0,22,1,6
95516,2,2404,2335,69,0,80,0,6
95517,2,2340,2405,-65,0,1,0,6
95518,2,2558,2400,158,0,210,0,6
95519,2,2402,2475,-73,0,198,0,6
95520,2,2506,2599,-93,0,300,0,6
95521,2,2529,2569,-40,0,334,0,6
95522,2,2379,2460,-81,0,106,0,6
95523,1,2558,2538,20,0,13,0,6
95524,1,2575,2496,79,0,203,0,6
95525,1,2534,2499,35,0,147,0,6
95526,1,2416,2359,57,0,40,0,6
95527,1,2457,2544,-87,0,1,0,6
95528,2,2344,2426,-82,0,264,0,6
95529,1,2470,2469,1,0,300,0,6
95530,2,2428,2329,99,0,41,0,6
95531,1,2572,2519,53,0,201,0,6
95532,1,2469,2421,48,0,250,0,6
95533,3,2470,2537,-67,0,246,0,6
95534,1,2358,2421,-63,0,122,0,6
95535,1,2567,2553,14,0,244,0,6
95536,1,2561,2599,-38,0,40,0,6
95537,3,2427,2253,174,0,110,0,8
95538,1,2516,2511,5,0,302,0,6
95539,1,2617,2600,17,0,345,0,6
95540,1,2507,2464,43,0,243,0,6
95541,1,2354,2413,-59,0,40,1,6
95542,1,2452,2314,138,0,0,0,6
95543,1,2495,2597,-102,0,20,1,6
95544,1,2487,2337,150,0,10,1,6
95545,1,2422,2330,92,0,311,0,6
95546,2,2514,2633,-119,0,58,0,6
95547,2,2409,2550,-141,0,2,0,6
95548,2,2254,2532,-278,0,130,0,6
95549,2,2466,2430,36,0,0,0,6
95550,2,2447,2617,-170,0,45,0,6
95551,1,2435,2427,8,0,8,1,6
95552,2,2401,2400,1,0,106,1,6
95553,1,2446,2402,44,0,455,1,6
95554,2,2235,2414,-179,0,245,1,6
95555,3,2403,2349,54,0,350,0,6
95556,3,2547,2577,-30,0,101,0,6
95557,2,2290,2451,-161,0,8,0,6
95558,1,2767,2519,248,0,123,0,6
95559,2,2423,2517,-94,0,245,0,6
95560,1,2493,2468,25,0,49,0,6
95561,2,2457,2293,164,0,4,0,6
95562,2,2251,2401,-150,0,5,0,6
95563,1,2501,2492,9,0,29,0,6
95564,2,2410,2314,96,0,302,1,6
95565,1,2461,2439,22,0,380,0,6
95567,2,2402,2426,-24,0,404,1,6
95568,1,2410,2292,118,0,344,0,6
95569,1,2406,2288,118,0,250,1,6
95570,1,2523,2519,4,0,162,1,6
95571,2,2311,2456,-145,0,107,0,6
95572,1,2443,2457,-14,0,484,1,6
95573,1,2401,2371,30,4,241,0,13
95574,1,2501,2537,-36,0,100,0,6
95575,3,2522,2338,184,0,466,0,6
95576,3,2365,2437,-72,0,405,0,6
95577,1,2437,2329,108,0,6,0,6
95578,1,2524,2284,240,0,14,0,6
95579,1,2361,2487,-126,0,42,0,6
95580,2,2262,2415,-153,0,10,0,6
95581,2,2287,2516,-229,0,4,0,6
95582,1,2459,2447,12,0,106,0,6
95583,1,2375,2414,-39,0,122,0,6
95584,1,2364,2461,-97,0,250,0,6
95585,2,2531,2503,28,0,57,1,6
95586,2,2452,2417,35,0,122,0,6
95587,1,2563,2442,121,0,13,0,6
95588,1,2550,2620,-70,0,485,0,6
95589,1,2494,2418,76,0,317,0,6
95590,1,2553,2405,148,0,330,0,6
95591,2,2335,2501,-166,0,1,0,6
95592,1,2521,2443,78,0,289,0,6
95593,1,2430,2418,12,0,9,0,6
95594,1,2406,2361,45,0,4,0,6
95595,1,2464,2286,178,0,337,0,6
95596,3,2402,2458,-56,0,40,0,6
95597,2,2436,2334,102,0,48,0,6
95598,3,2395,2407,-12,0,152,0,6
95599,3,2408,2476,-68,0,220,0,6
95600,2,2455,2437,18,0,210,0,6
95601,2,2229,2406,-177,0,140,0,6
95602,2,2437,2285,152,0,110,0,6
95603,2,2526,2510,16,0,200,0,6
95604,2,2480,2361,119,0,15,0,6
95605,3,2318,2611,-293,0,122,0,8
95606,2,2594,2622,-28,0,202,0,6
95607,2,2301,2507,-206,0,101,0,6
95608,1,2350,2427,-77,0,245,0,6
95609,1,2474,2460,14,0,7,0,6
95610,1,2505,2521,-16,0,41,1,6
95611,1,2533,2567,-34,0,101,1,6
95612,1,2391,2411,-20,0,241,1,6
95613,2,2324,2472,-148,0,123,0,6
95614,2,2517,2770,-253,0,106,0,6
95616,1,2590,2472,118,0,345,0,6
95617,2,2408,2356,52,0,41,0,6
95618,2,2519,2384,135,0,300,1,6
95619,3,2323,2444,-121,0,48,0,6
95620,1,2621,2576,45,0,34,0,6
95621,1,2490,2440,50,0,41,0,6
95622,2,2539,2574,-35,0,225,0,6
95623,2,2397,2412,-15,0,57,1,6
95624,1,2432,2446,-14,0,10,1,6
95625,1,2499,2451,48,0,46,0,6
95626,2,2548,2516,32,0,218,1,6
95627,2,2576,2520,56,0,112,0,6
95628,2,2313,2449,-136,0,337,0,6
95629,2,2505,2432,73,0,4,1,6
95630,2,2284,2409,-125,0,10,1,6
95631,2,2322,2403,-81,0,0,1,6
95632,2,2253,2429,-176,0,48,0,6
95633,1,2637,2526,111,0,404,1,6
95634,3,2460,2307,153,0,0,0,6
95635,2,2454,2337,117,0,9,1,6
95636,2,2402,2557,-155,0,2,0,6
95637,1,2414,2332,82,0,40,0,6
95638,1,2464,2529,-65,0,375,1,6
95639,2,2431,2465,-34,0,40,1,6
95640,2,2567,2465,102,0,473,0,6
95641,1,2357,2419,-62,0,57,0,6
95642,1,2532,2429,103,0,40,0,6
95643,2,2342,2510,-168,0,101,0,6
95645,1,2442,2479,-37,0,0,0,6
95646,1,2772,2515,257,0,344,0,6
95647,2,2359,2451,-92,0,122,1,6
95648,1,2430,2334,96,0,101,0,6
95649,2,2449,2468,-19,0,142,0,6
95650,1,2354,2433,-79,0,45,0,6
95651,1,2413,2319,94,0,45,1,6
95652,2,2321,2436,-115,0,490,0,6
95653,1,2363,2401,-38,0,46,0,6
95654,2,2647,2638,9,0,309,0,6
95655,2,2701,2521,180,0,57,0,6
95656,2,2444,2399,45,0,140,0,6
95657,2,2502,2569,-67,0,48,1,6
95658,1,2534,2498,36,0,45,0,6
95659,1,2406,2256,150,0,360,0,6
95660,1,2241,2402,-161,0,280,0,6
95661,3,2534,2560,-26,0,123,0,6
95662,1,2579,2594,-15,0,21,1,6
95663,1,2365,2425,-60,0,44,0,6
95664,2,2305,2462,-157,0,242,0,6
95665,1,2436,2495,-59,0,4,0,6
95666,2,2384,2429,-45,0,172,0,6
95667,1,2403,2304,99,0,463,1,6
95668,1,2522,2468,54,0,265,0,6
95669,2,2475,2425,50,0,115,0,6
95670,3,2276,2422,-146,0,112,0,6
95671,1,2422,2389,33,0,245,1,6
95672,1,2405,2397,8,0,45,1,6
95673,2,2512,2321,191,0,107,0,6
95674,1,2474,2412,62,0,45,0,6
95675,1,2525,2641,-116,0,270,0,6
95676,2,2409,2421,-12,0,4,1,6
95677,1,2443,2330,113,0,228,0,6
95678,1,2543,2398,145,0,13,0,6
95679,2,2379,2420,-41,0,310,0,6
95680,3,2626,2509,117,0,455,0,6
95681,1,2536,2376,160,0,40,1,6
95682,2,2303,2600,-297,0,113,0,6
95683,1,2630,2635,-5,0,333,0,6
95684,2,2515,2560,-45,0,4,0,6
95685,1,2458,2525,-67,0,40,0,6
95686,1,2561,2539,22,0,45,0,6
95687,2,2310,2457,-147,0,107,0,6
95688,2,2416,2410,6,0,200,0,6
95689,2,2405,2346,59,0,15,0,6
95690,1,2340,2519,-179,0,380,0,6
95691,2,2511,2472,39,0,380,0,6
95692,1,2512,2774,-262,0,45,0,6
95693,1,2452,2295,157,0,119,0,6
95694,1,2416,2467,-51,0,4,0,6
95695,2,2316,2435,-119,0,251,0,6
95696,1,2572,2454,118,0,302,1,6
95697,1,2607,2322,285,0,201,0,8
95699,2,2440,2438,2,0,140,1,6
95700,1,2455,2504,-49,0,105,1,6
95701,2,2440,2475,-35,0,230,0,6
95702,2,2426,2362,64,0,455,1,6
95703,1,2534,2541,-7,0,225,0,6
95704,2,2522,2560,-38,0,304,0,6
95705,1,2453,2403,50,0,125,0,6
95706,2,2473,2493,-20,0,5,0,6
95707,1,2513,2503,10,0,131,0,6
95708,2,2329,2450,-121,0,45,0,6
95709,2,2465,2276,189,0,123,0,6
95710,2,2522,2549,-27,0,345,1,6
95711,2,2367,2434,-67,0,43,1,6
95712,2,2439,2270,169,0,15,0,6
95713,1,2396,2466,-70,0,40,0,6
95714,2,2519,2301,218,0,46,0,6
95715,2,2522,2574,-52,0,101,0,6
95716,1,2765,2522,243,0,414,0,6
95717,2,2509,2497,12,0,404,0,6
95718,2,2598,2419,179,0,7,0,6
95719,3,2449,2432,17,0,302,0,6
95720,1,2456,2370,86,0,296,0,6
95721,1,2633,2590,43,0,331,0,6
95722,2,2408,2498,-90,0,146,0,6
95723,2,2315,2465,-150,0,404,0,6
95724,2,2588,2585,3,0,334,0,6
95725,1,2418,2278,140,0,300,0,6
95726,1,2497,2448,49,0,301,0,6
95727,2,2433,2519,-86,0,400,0,6
95728,2,2534,2536,-2,0,247,0,6
95729,2,2566,2439,127,0,45,0,6
95730,2,2479,2505,-26,0,120,0,6
95731,1,2395,2546,-151,0,3,0,6
95732,2,2442,2540,-98,0,5,0,6
95733,1,2536,2489,47,0,106,0,6
95734,2,2368,2414,-46,0,1,0,6
95735,1,2463,2529,-66,0,104,0,6
95736,3,2520,2624,-104,0,5,0,6
95737,1,2408,2438,-30,0,464,0,6
95738,3,2353,2469,-116,0,7,0,6
95739,2,2602,2298,304,0,39,1,6
95740,2,2413,2337,76,0,106,0,6
95741,1,2403,2593,-190,0,43,0,6
95742,2,2425,2511,-86,0,330,0,6
95743,1,2398,2458,-60,0,4,0,6
95744,1,2443,2377,66,0,46,0,6
95745,2,2418,2374,44,0,272,0,6
95746,1,2438,2297,141,0,45,0,6
95747,1,2461,2306,155,0,0,0,6
95748,1,2450,2369,81,0,107,1,6
95749,2,2517,2565,-48,0,41,0,6
95750,1,2468,2498,-30,0,5,0,6
95751,2,2473,2533,-60,0,120,0,6
95752,1,2499,2575,-76,0,43,0,6
95753,2,2336,2410,-74,0,106,0,6
95754,2,2235,2541,-306,4,120,0,11
95755,1,2446,2355,91,0,73,0,6
95756,3,2447,2269,178,0,337,0,8
95757,1,2693,2813,-120,0,123,0,6
95758,1,2538,2403,135,0,13,0,6
95759,2,2358,2494,-136,0,487,1,6
95760,2,2309,2410,-101,0,456,1,6
95761,2,2424,2430,-6,0,45,0,6
95762,2,2541,2460,81,0,280,0,6
95763,1,2420,2343,77,0,302,1,6
95764,1,2434,2366,68,0,20,0,6
95765,1,2541,2511,30,0,45,0,6
95766,2,2438,2349,89,0,448,1,6
95767,2,2420,2437,-17,0,401,1,6
95768,2,2520,2767,-247,0,103,0,6
95769,1,2523,2337,186,0,241,0,6
95770,3,2348,2448,-100,0,150,0,6
95771,3,2389,2403,-14,0,46,0,6
95772,1,2458,2428,30,0,111,0,6
95773,2,2512,2497,15,0,105,0,6
95774,1,2589,2528,61,0,46,0,6
95775,2,2283,2445,-162,0,10,1,6
95776,2,2236,2442,-206,0,45,0,6
95777,2,2591,2582,9,0,10,0,6
95778,1,2411,2325,86,0,380,1,6
95779,2,2416,2483,-67,0,268,1,6
95780,1,2438,2518,-80,0,121,1,6
95781,2,2454,2326,128,0,6,0,6
95782,2,2403,2447,-44,0,331,0,6
95783,1,2502,2516,-14,0,143,1,6
95784,1,2804,2701,103,0,466,1,6
95785,1,2579,2590,-11,0,277,0,6
95786,1,2444,2387,57,0,403,0,6
95787,1,2420,2305,115,0,400,1,6
95788,2,2365,2460,-95,0,302,0,6
95789,2,2503,2548,-45,0,326,1,6
95790,1,2559,2512,47,0,46,0,6
95792,2,2484,2362,122,0,315,0,6
95793,1,2470,2506,-36,0,131,0,6
95794,2,2585,2438,147,0,4,0,6
95795,1,2404,2328,76,0,100,0,6
95796,1,2376,2476,-100,0,117,0,6
95797,1,2629,2622,7,0,255,0,6
95798,2,2372,2544,-172,0,102,1,6
95799,3,2318,2463,-145,0,0,0,6
95800,1,2432,2381,51,0,120,0,6
95801,2,2339,2452,-113,0,302,0,6
95802,2,2468,2466,2,0,101,0,6
95803,2,2350,2497,-147,0,7,0,6
95804,1,2382,2434,-52,0,310,1,6
95805,1,2405,2413,-8,0,6,0,6
95806,2,2517,2500,17,0,40,1,6
95807,2,2415,2338,77,0,45,1,6
95808,1,2769,2518,251,0,112,0,6
95809,1,2447,2534,-87,0,255,0,6
95810,2,2308,2407,-99,0,122,0,6
95811,2,2365,2474,-109,0,43,0,6
95812,1,2467,2289,178,0,43,0,6
95813,2,2452,2526,-74,0,9,0,6
95814,1,2446,2506,-60,0,264,0,6
95815,2,2363,2457,-94,0,326,0,6
95816,2,2226,2411,-185,0,302,1,6
95817,1,2399,2564,-165,0,3,0,6
95818,2,2439,2413,26,0,20,0,6
95819,2,2588,2585,3,0,334,0,6
95820,1,2375,2498,-123,0,45,0,6
95821,1,2618,2556,62,0,7,0,6
95822,1,2541,2478,63,0,101,0,6
95823,3,2584,2585,-1,0,7,0,6
95824,2,2381,2498,-117,0,466,0,6
95825,1,2236,2414,-178,0,375,0,6
95826,2,2432,2476,-44,0,40,0,6
95827,1,2613,2419,194,0,107,1,6
95828,3,2507,2580,-73,0,331,0,6
95829,3,2469,2547,-78,0,300,0,6
95830,2,2437,2394,43,0,113,1,6
95831,1,2423,2398,25,0,400,0,6
95832,1,2407,2411,-4,0,310,0,6
95833,1,2465,2303,162,0,331,1,6
95834,1,2339,2424,-85,0,40,0,6
95835,2,2488,2443,45,0,300,0,6
95836,1,2342,2412,-70,0,265,0,6
95837,2,2523,2538,-15,0,133,0,6
95838,2,2345,2473,-128,0,40,0,6
95839,1,2501,2469,32,0,102,0,6
95840,1,2585,2584,1,0,253,0,6
95841,1,2511,2377,134,0,268,0,6
95842,3,2617,2444,173,0,334,0,6
95843,1,2436,2279,157,0,45,0,6
95844,1,2508,2416,92,0,6,0,6
95845,1,2591,2582,9,0,40,1,6
95846,3,2531,2501,30,0,151,0,6
95847,3,2447,2394,53,0,45,0,6
95848,1,2419,2294,125,0,3,0,6
95849,1,2370,2433,-63,0,10,1,6
95850,1,2263,2426,-163,0,334,0,6
95851,2,2567,2388,179,0,15,0,6
95852,1,2333,2424,-91,0,300,1,6
95853,1,2697,2809,-112,0,190,0,6
95854,2,2359,2535,-176,0,140,0,6
95855,2,2463,2339,124,0,241,0,6
95856,2,2414,2553,-139,0,113,1,6
95857,1,2311,2499,-188,0,80,0,6
95858,1,2499,2476,23,0,345,1,6
95859,1,2456,2462,-6,0,241,0,6
95860,1,2565,2586,-21,0,160,0,6
95861,2,2505,2507,-2,0,48,0,6
95862,1,2203,2413,-210,0,244,0,6
95863,2,2515,2772,-257,0,103,0,6
95864,1,2459,2319,140,4,400,0,13
95865,3,2495,2546,-51,0,154,0,6
95866,3,2414,2335,79,0,1,0,6
95867,1,2407,2368,39,0,132,0,6
95868,1,2531,2346,185,0,254,0,6
95869,3,2578,2546,32,0,152,0,6
95870,1,2449,2453,-4,0,41,1,6
95871,3,2448,2502,-54,0,300,0,6
95872,1,2405,2413,-8,0,315,1,6
95873,2,2300,2470,-170,0,386,0,6
95874,2,2446,2427,19,0,151,0,6
95875,1,2468,2342,126,0,474,0,6
95876,2,2527,2470,57,0,113,1,6
95877,2,2347,2428,-81,0,212,0,6
95878,1,2477,2455,22,0,0,0,6
95879,1,2439,2351,88,0,45,0,6
95880,2,2546,2556,-10,0,1,0,6
95881,2,2461,2346,115,0,394,1,6
95882,2,2447,2477,-30,0,484,0,6
95883,1,2543,2233,310,4,40,0,11
95884,2,2501,2534,-33,0,0,0,6
95885,3,2343,2449,-106,0,156,0,6
95886,1,2451,2345,106,0,198,1,6
95887,1,2774,2513,261,0,219,0,6
95888,2,2511,2444,67,0,302,1,6
95889,3,2481,2403,78,0,13,0,6
95890,1,2295,2423,-128,0,100,1,6
95891,2,2578,2591,-13,0,455,0,6
95892,3,2539,2383,156,0,203,0,6
95893,2,2419,2623,-204,0,45,0,6
95894,2,2478,2335,143,0,5,0,6
95895,2,2370,2470,-100,0,3,0,6
95896,2,2277,2453,-176,0,143,0,6
95897,1,2356,2409,-53,0,248,1,6
95898,1,2614,2509,105,0,28,0,6
95899,2,2473,2323,150,0,100,1,6
95900,2,2414,2493,-79,0,300,0,6
95901,3,2433,2447,-14,0,13,0,6
95902,2,2505,2626,-121,0,60,0,6
95903,1,2571,2408,163,0,201,0,6
95904,2,2561,2446,115,0,300,1,6
95905,2,2417,2346,71,0,302,0,6
95906,2,2237,2416,-179,0,101,0,6
95907,2,2580,2521,59,0,262,0,6
95908,1,2431,2361,70,0,106,0,6
95909,1,2405,2317,88,0,247,1,6
95910,1,2503,2514,-11,0,49,0,6
95911,2,2421,2355,66,0,16,1,6
95912,2,2417,2456,-39,0,43,0,6
95913,2,2490,2618,-128,0,377,0,6
95914,1,2800,2705,95,0,466,1,6
95915,1,2505,2518,-13,0,50,0,6
95916,1,2577,2597,-20,0,334,0,6
95917,2,2425,2438,-13,0,312,0,6
95918,2,2373,2426,-53,0,380,0,6
95919,2,2573,2427,146,0,121,0,6
95920,1,2411,2244,167,0,42,1,6
95921,1,2261,2406,-145,0,108,0,6
95922,1,2397,2455,-58,0,37,1,6
95923,3,2544,2512,32,0,103,0,6
95924,1,2471,2505,-34,0,241,0,6
95925,3,2436,2212,224,0,455,0,6
95926,2,2513,2511,2,0,453,0,6
95927,1,2454,2462,-8,0,335,0,6
95928,2,2570,2416,154,0,200,0,6
95929,1,2416,2386,30,0,151,0,6
95930,2,2474,2455,19,0,154,0,6
95931,1,2543,2499,44,0,112,0,6
95932,1,2557,2502,55,0,4,0,6
95933,1,2596,2573,23,0,45,0,6
95934,2,2483,2437,46,0,190,0,6
95935,3,2547,2578,-31,0,354,0,6
95936,2,2447,2403,44,0,6,0,6
95937,1,2377,2477,-100,0,219,0,6
95938,2,2551,2368,183,0,273,0,6
95939,1,2431,2407,24,0,11,0,6
95940,2,2407,2411,-4,0,320,0,6
95941,1,2347,2444,-97,0,433,0,6
95942,2,2343,2521,-178,0,335,0,6
95943,3,2433,2401,32,0,427,0,6
95944,2,2390,2454,-64,0,107,0,6
95945,1,2418,2409,9,0,57,1,6
95946,1,2527,2554,-27,0,110,0,6
95947,2,2341,2454,-113,0,46,1,6
95948,2,2511,2776,-265,0,270,0,6
95949,3,2405,2574,-169,0,2,0,6
95950,3,2386,2559,-173,0,143,0,6
95951,2,2353,2410,-57,0,112,0,6
95952,2,2415,2372,43,0,0,0,6
95953,2,2267,2546,-279,4,133,0,11
95954,1,2435,2251,184,0,80,0,6
95955,2,2356,2480,-124,0,40,0,6
95956,1,2468,2334,134,0,263,1,6
95957,2,2269,2405,-136,0,131,0,6
95958,2,2474,2300,174,0,58,0,6
95959,2,2366,2400,-34,0,2,0,6
95960,1,2513,2505,8,0,135,1,6
95961,1,2329,2453,-124,0,7,0,6
95962,1,2499,2477,22,0,320,1,6
95963,2,2545,2502,43,0,131,0,6
95964,3,2562,2450,112,0,373,0,6
95965,3,2542,2622,-80,0,224,0,6
95966,1,2486,2507,-21,0,310,0,6
95967,1,2376,2413,-37,0,118,1,6
95968,1,2488,2410,78,0,317,0,6
95969,1,2460,2470,-10,0,44,0,6
95970,1,2591,2583,8,0,40,0,6
95971,1,2454,2412,42,0,455,0,6
95972,2,2497,2548,-51,0,45,1,6
95973,2,2516,2565,-49,0,315,0,6
95974,1,2343,2412,-69,0,113,1,6
95975,1,2497,2417,80,0,153,0,6
95976,2,2313,2455,-142,0,484,0,6
95977,1,2509,2554,-45,0,101,0,6
95978,1,2413,2338,75,0,40,0,6
95979,1,2409,2320,89,0,153,0,6
95981,1,2403,2379,24,0,332,1,6
95982,2,2357,2452,-95,0,310,0,6
95983,1,2584,2509,75,0,102,1,6
95984,3,2444,2471,-27,0,247,0,6
95985,1,2629,2495,134,0,0,1,6
95986,2,2412,2236,176,0,240,0,6
95987,1,2464,2339,125,0,0,0,6
95988,3,2489,2443,46,0,487,0,6
95989,2,2484,2567,-83,0,18,0,6
95990,2,2235,2543,-308,0,141,0,6
95991,2,2291,2436,-145,0,112,1,6
95992,1,2401,2412,-11,0,153,0,6
95994,1,2377,2403,-26,0,466,0,6
95995,1,2437,2297,140,0,45,0,6
95997,1,2446,2360,86,0,130,0,6
95998,1,2539,2474,65,0,293,0,6
95999,2,2395,2401,-6,0,380,0,6
96000,1,2549,2265,284,4,0,1,11
96001,1,2515,2409,106,0,154,1,6
96002,1,2411,2316,95,0,45,0,6
96003,1,2406,2278,128,0,311,1,6
96004,1,2778,2509,269,0,119,0,6
96005,1,2572,2407,165,0,201,0,6
96006,1,2547,2557,-10,0,123,0,6
96007,2,2275,2419,-144,0,51,0,6
96008,2,2422,2570,-148,0,300,1,6
96009,2,2577,2596,-19,0,8,1,6
96010,1,2432,2548,-116,0,60,1,6
96011,2,2460,2501,-41,0,41,0,6
96012,3,2414,2352,62,0,138,0,6
96013,2,2459,2378,81,0,459,0,6
96014,1,2387,2403,-16,0,43,0,6
96015,2,2406,2275,131,0,4,1,6
96016,2,2572,2458,114,0,221,0,6
96017,1,2400,2201,199,4,100,1,11
96018,2,2507,2780,-273,0,453,0,6
96019,2,2436,2337,99,0,150,0,6
96020,2,2383,2424,-41,0,101,1,6
96021,1,2533,2542,-9,0,100,0,6
96022,2,2434,2560,-126,0,122,0,6
96023,1,2469,2435,34,0,57,0,6
96024,1,2525,2341,184,0,40,0,6
96025,2,2495,2621,-126,0,370,1,6
96026,1,2415,2348,67,0,302,0,6
96027,2,2405,2493,-88,0,45,0,6
96028,2,2463,2466,-3,0,153,0,6
96029,2,2352,2407,-55,0,0,0,6
96030,2,2459,2335,124,0,310,0,6
96031,2,2518,2546,-28,0,101,0,6
96032,1,2472,2504,-32,0,131,0,6
96033,2,2334,2417,-83,0,107,0,6
96034,2,2422,2383,39,0,45,0,6
96035,1,2385,2452,-67,0,107,0,6
96036,1,2280,2409,-129,0,107,0,6
96037,3,2301,2423,-122,0,101,0,6
96038,1,2366,2462,-96,0,483,0,8
96039,2,2452,2530,-78,0,330,0,6
96040,1,2361,2544,-183,0,45,0,6
96041,1,2471,2353,118,0,195,0,6
96042,1,2405,2319,86,0,327,0,6
96043,3,2406,2440,-34,0,354,0,6
96044,1,2552,2456,96,0,310,0,6
96045,2,2404,2575,-171,0,2,1,6
96046,1,2326,2493,-167,0,122,0,6
96047,1,2441,2471,-30,0,140,0,6
96048,1,2443,2393,50,0,28,0,6
96049,1,2403,2277,126,0,114,0,6
96050,2,2551,2492,59,0,302,0,6
96051,2,2505,2553,-48,0,306,1,6
96052,1,2418,2397,21,0,45,0,6
96053,1,2803,2702,101,0,466,0,6
96054,2,2396,2480,-84,0,108,0,6
96055,2,2440,2299,141,0,15,1,6
96056,1,2356,2450,-94,0,152,0,6
96057,1,2430,2307,123,0,302,0,8
96058,1,2401,2356,45,0,49,0,8
96059,1,2536,2383,153,0,268,0,6
96060,2,2782,2505,277,0,118,0,6
96061,2,2452,2593,-141,0,463,0,6
96062,1,2343,2426,-83,0,110,0,6
96063,2,2423,2510,-87,0,45,0,6
96064,3,2282,2409,-127,0,394,0,6
96065,2,2424,2471,-47,0,0,0,6
96066,2,2498,2478,20,0,45,0,6
96067,1,2521,2469,52,0,190,1,6
96068,3,2466,2390,76,0,314,0,6
96069,1,2548,2536,12,0,9,1,6
96070,1,2508,2372,136,0,484,0,6
96071,2,2386,2539,-153,0,140,0,6
96072,2,2486,2565,-79,0,332,0,6
96073,1,2602,2572,30,0,11,0,6
96074,2,2344,2403,-59,0,81,1,6
96076,1,2401,2330,71,0,483,0,6
96077,1,2534,2540,-6,0,463,0,6
96078,1,2444,2405,39,0,8,0,6
96079,1,2413,2310,103,0,247,1,6
96080,1,2438,2440,-2,0,45,0,6
96081,2,2392,2445,-53,0,107,0,6
96082,1,2635,2638,-3,0,255,0,6
96083,2,2265,2459,-194,0,43,1,6
96084,2,2312,2401,-89,0,135,0,6
96085,1,2568,2365,203,0,356,1,6
96086,2,2491,2341,150,0,107,0,6
96087,2,2447,2436,11,0,46,0,6
96089,1,2412,2400,12,0,0,0,6
96090,3,2561,2568,-7,0,330,0,6
96091,1,2542,2522,20,0,112,0,6
96092,1,2422,2424,-2,0,37,0,6
96093,2,2456,2302,154,0,56,1,6
96094,2,2484,2392,92,0,28,0,6
96095,1,2407,2365,42,0,122,1,6
96096,1,2441,2391,50,0,102,0,6
96097,2,2396,2443,-47,0,177,0,6
96098,1,2535,2475,60,0,41,0,6
96099,2,2407,2307,100,0,53,0,6
96100,1,2506,2352,154,0,15,0,6
96101,2,2515,2773,-258,0,103,0,6
96102,1,2492,2444,48,0,315,0,6
96103,1,2338,2415,-77,0,122,0,6
96104,2,2501,2447,54,0,150,0,6
96105,1,2476,2417,59,0,215,1,6
96106,2,2531,2374,157,0,491,0,6
96107,1,2466,2286,180,0,335,1,6
96108,2,2448,2321,127,4,46,0,13
96109,1,2596,2449,147,0,8,1,6
96110,1,2583,2513,70,0,101,0,6
96111,2,2558,2430,128,0,40,0,6
96112,1,2440,2336,104,0,45,0,6
96113,1,2331,2439,-108,0,466,1,6
96114,3,2389,2407,-18,0,380,0,6
96115,1,2402,2234,168,0,140,1,6
96116,3,2500,2481,19,0,360,0,6
96117,2,2569,2529,40,0,102,1,6
96118,2,2389,2422,-33,0,102,0,6
96119,1,2448,2411,37,0,242,0,6
96120,1,2578,2401,177,0,201,0,6
96121,2,2316,2512,-196,0,20,0,6
96122,2,2356,2465,-109,0,381,0,6
96123,2,2377,2427,-50,0,31,0,6
96124,2,2241,2442,-201,0,218,0,6
96125,2,2483,2526,-43,0,277,1,6
96126,2,2248,2565,-317,0,140,0,8
96127,1,2315,2452,-137,0,331,0,6
96128,2,2515,2491,24,0,346,0,6
96129,2,2567,2607,-40,0,300,1,6
96130,2,2476,2588,-112,0,52,0,6
96131,1,2641,2509,132,0,200,0,6
96132,2,2432,2414,18,0,15,0,6
96133,2,2296,2475,-179,0,123,0,6
96134,2,2410,2263,147,0,202,1,6
96135,1,2585,2317,268,0,8,1,6
96136,1,2388,2410,-22,0,245,1,6
96137,2,2485,2335,150,0,65,0,6
96138,1,2403,2380,23,0,247,0,6
96139,1,2462,2407,55,0,326,0,6
96140,2,2454,2574,-120,0,160,0,6
96141,1,2398,2581,-183,0,2,0,6
96142,1,2531,2301,230,0,236,0,6
96143,1,2534,2406,128,0,226,1,6
96144,1,2406,2255,151,0,4,1,6
96145,2,2453,2444,9,0,101,1,6
96146,1,2465,2316,149,0,313,0,6
96147,2,2405,2274,131,0,4,0,6
96148,2,2386,2446,-60,0,68,1,6
96149,1,2407,2450,-43,0,483,0,6
96150,2,2775,2513,262,0,190,0,6
96151,2,2440,2547,-107,0,6,0,6
96152,2,2531,2541,-10,0,17,0,6
96153,2,2464,2339,125,0,150,1,6
96154,2,2214,2446,-232,0,253,0,8
96155,3,2544,2520,24,0,461,0,6
96156,2,2453,2323,130,0,389,0,6
96157,2,2288,2455,-167,0,241,0,6
96158,1,2468,2383,85,0,335,0,6
96159,1,2573,2406,167,0,201,0,6
96160,3,2360,2477,-117,0,45,0,6
96161,2,2625,2494,131,0,310,1,6
96162,2,2424,2351,73,0,121,1,8
96163,2,2566,2406,160,0,14,0,8
96164,3,2483,2312,171,0,45,0,6
96165,2,2235,2429,-194,0,198,0,6
96166,2,2505,2525,-20,0,4,0,6
96167,1,2497,2527,-30,0,45,0,6
96168,2,2551,2500,51,0,300,0,6
96169,1,2385,2442,-57,0,337,0,6
96170,1,2469,2356,113,0,130,0,6
96171,2,2528,2582,-54,0,220,1,6
96172,1,2444,2483,-39,0,64,0,6
96173,2,2217,2494,-277,0,426,1,6
96175,1,2426,2383,43,0,110,0,6
96176,1,2408,2406,2,0,72,1,6
96177,2,2445,2581,-136,0,332,0,6
96178,2,2576,2389,187,0,150,0,6
96179,2,2305,2412,-107,0,150,0,6
96180,1,2600,2454,146,0,5,0,6
96181,2,2414,2376,38,0,280,0,6
96182,2,2459,2342,117,0,112,0,6
96183,1,2633,2510,123,0,487,0,6
96184,2,2431,2419,12,0,201,0,6
96185,1,2419,2338,81,0,0,1,6
96186,2,2534,2237,297,0,101,1,6
96187,1,2633,2496,137,0,461,0,6
96188,3,2472,2356,116,0,310,0,6
96189,1,2592,2403,189,0,210,0,6
96190,1,2612,2562,50,0,11,0,6
96191,1,2349,2513,-164,0,250,0,6
96192,2,2563,2469,94,0,255,0,6
96193,1,2329,2404,-75,0,300,1,6
96194,2,2445,2300,145,0,268,1,6
96195,2,2322,2443,-121,0,115,0,6
96196,1,2449,2314,135,0,242,1,6
96197,1,2434,2347,87,0,8,0,6
96198,3,2427,2384,43,0,331,0,6
96199,2,2535,2509,26,0,40,0,6
96200,1,2511,2344,167,0,483,0,6
96201,1,2531,2348,183,0,190,0,6
96202,2,2522,2766,-244,0,106,0,6
96203,2,2521,2478,43,0,143,0,6
96204,2,2448,2564,-116,0,434,0,6
96205,2,2578,2503,75,0,140,0,6
96206,1,2420,2387,33,0,45,0,6
96207,1,2402,2326,76,0,40,0,6
96208,2,2473,2538,-65,0,209,1,6
96209,1,2504,2533,-29,0,301,0,6
96210,2,2322,2407,-85,0,81,0,6
96211,2,2534,2500,34,0,103,0,6
96212,2,2414,2409,5,0,45,0,6
96213,2,2546,2525,21,0,113,0,6
96214,1,2451,2381,70,0,321,0,6
96215,1,2450,2447,3,0,200,0,6
96216,1,2557,2617,-60,0,332,0,6
96217,1,2383,2407,-24,0,183,1,6
96218,3,2356,2468,-112,0,243,0,6
96219,2,2315,2587,-272,0,347,0,6
96220,1,2261,2402,-141,0,242,0,6
96221,2,2374,2475,-101,0,106,0,6
96222,2,2287,2407,-120,0,143,0,6
96223,2,2478,2313,165,0,40,1,6
96224,1,2332,2467,-135,0,125,0,6
96225,2,2347,2414,-67,0,303,1,6
96226,1,2406,2432,-26,0,153,0,6
96227,3,2425,2351,74,0,414,0,6
96228,2,2534,2450,84,0,107,0,6
96229,1,2570,2477,93,0,34,0,6
96230,2,2380,2492,-112,0,110,1,6
96231,2,2400,2520,-120,0,2,0,6
96232,1,2424,2205,219,0,200,1,6
96233,2,2404,2544,-140,0,458,0,6
96234,2,2515,2529,-14,0,415,1,6
96235,2,2338,2446,-108,0,253,1,6
96236,2,2275,2511,-236,0,100,1,6
96237,1,2450,2506,-56,0,108,0,6
96238,1,2617,2656,-39,0,38,0,6
96239,2,2273,2436,-163,0,462,0,6
96240,2,2603,2556,47,0,4,0,6
96242,2,2397,2459,-62,0,111,0,6
96243,3,2768,2520,248,0,326,0,6
96244,2,2505,2450,55,0,133,0,6
96245,2,2334,2469,-135,0,255,0,6
96246,1,2422,2285,137,0,15,0,6
96247,2,2309,2444,-135,0,46,1,6
96248,2,2345,2496,-151,0,301,1,6
96249,2,2442,2595,-153,0,51,1,6
96250,2,2345,2414,-69,0,42,0,6
96251,3,2449,2296,153,0,202,0,6
96252,3,2454,2502,-48,0,226,0,6
96253,1,2471,2417,54,0,13,1,6
96254,2,2311,2452,-141,0,140,0,6
96255,2,2377,2456,-79,0,488,1,6
96256,2,2514,2563,-49,0,132,0,6
96257,2,2540,2571,-31,0,18,0,6
96258,1,2510,2425,85,0,45,1,6
96259,3,2378,2431,-53,0,190,0,6
96260,3,2352,2456,-104,0,313,0,6
96261,1,2524,2397,127,0,203,0,6
96262,3,2540,2637,-97,0,0,0,6
96263,2,2466,2457,9,0,15,0,6
96264,3,2562,2385,177,0,40,0,6
96265,1,2589,2313,276,0,373,1,6
96266,1,2418,2468,-50,0,45,0,6
96267,2,2314,2480,-166,0,143,0,6
96268,1,2415,2409,6,0,4,0,6
96269,2,2221,2430,-209,0,53,0,6
96270,1,2436,2251,185,0,46,0,6
96271,1,2307,2535,-228,0,110,0,6
96272,1,2524,2553,-29,0,112,0,6
96273,2,2417,2420,-3,0,122,0,8
96274,2,2444,2531,-87,0,101,0,6
96275,1,2535,2350,185,0,80,0,6
96276,1,2479,2370,109,0,35,1,6
96277,3,2374,2441,-67,4,335,0,13
96278,1,2610,2564,46,0,106,0,6
96279,1,2472,2344,128,0,25,0,6
96280,1,2422,2326,96,0,250,0,6
96281,2,2395,2574,-179,0,241,0,6
96282,1,2498,2452,46,0,200,0,6
96283,2,2477,2452,25,0,124,1,6
96284,2,2526,2510,16,0,300,1,6
96285,1,2413,2426,-13,0,253,0,6
96286,3,2402,2332,70,0,122,0,6
96287,1,2623,2479,144,0,21,0,6
96288,1,2457,2536,-79,0,345,0,6
96289,2,2392,2527,-135,0,245,0,6
96290,3,2425,2445,-20,0,45,0,6
96291,2,2535,2509,26,0,43,0,6
96292,1,2568,2391,177,0,8,0,6
96293,1,2482,2342,140,0,46,0,6
96294,2,2650,2611,39,0,120,1,6
96295,2,2350,2402,-52,0,15,0,6
96296,3,2547,2507,40,0,7,0,6
96297,1,2333,2514,-181,0,150,0,6
96298,1,2449,2211,238,0,302,0,8
96299,1,2500,2456,44,0,49,1,6
96300,1,2577,2571,6,0,101,0,6
96301,1,2547,2597,-50,0,315,0,6
96302,2,2418,2424,-6,0,265,0,6
96303,2,2523,2764,-241,0,109,0,6
96304,3,2394,2426,-32,0,114,0,6
96305,2,2375,2462,-87,0,141,0,6
96306,1,2501,2425,76,0,105,0,6
96307,1,2473,2330,143,0,53,1,6
96308,2,2510,2598,-88,0,386,0,6
96309,2,2562,2570,-8,0,100,0,6
96310,2,2538,2420,118,0,45,1,6
96311,1,2506,2326,180,0,311,0,6
96312,2,2293,2452,-159,0,270,0,6
96313,1,2528,2458,70,0,107,0,6
96314,2,2245,2406,-161,0,40,0,6
96315,2,2254,2401,-147,0,247,0,6
96316,2,2353,2492,-139,0,102,1,6
96317,2,2459,2385,74,0,331,0,6
96318,2,2340,2476,-136,0,56,1,6
96319,2,2428,2320,108,0,122,0,6
96320,1,2475,2348,127,0,453,0,6
96321,1,2393,2559,-166,0,2,1,6
96322,1,2576,2448,128,0,101,0,6
96323,2,2345,2477,-132,0,1,1,6
96324,1,2422,2250,172,0,13,1,6
96325,2,2297,2526,-229,0,110,0,6
96326,1,2535,2627,-92,0,264,0,6
96327,2,2407,2403,4,0,343,1,6
96328,1,2447,2323,124,0,111,0,6
96329,2,2355,2574,-219,0,221,0,6
96330,2,2347,2509,-162,0,1,0,6
96331,2,2590,2671,-81,0,5,0,6
96332,2,2392,2569,-177,0,210,0,6
96333,1,2426,2234,192,0,23,0,6
96334,1,2455,2399,56,0,226,0,6
96335,3,2421,2515,-94,0,301,0,6
96336,3,2412,2295,117,0,101,0,6
96337,2,2439,2270,169,0,15,0,6
96338,1,2469,2431,38,0,56,0,6
96339,1,2767,2521,246,0,385,0,6
96340,1,2499,2421,78,0,48,0,6
96341,2,2516,2529,-13,0,103,1,6
96342,1,2326,2431,-105,0,129,1,6
96343,1,2475,2269,206,0,133,0,6
96344,1,2311,2591,-280,0,343,0,6
96345,2,2454,2307,147,0,158,0,6
96346,1,2412,2503,-91,0,270,0,6
96347,1,2420,2328,92,0,15,0,6
96348,2,2547,2587,-40,0,9,0,6
96349,2,2307,2409,-102,0,100,1,6
96350,2,2427,2363,64,0,140,0,6
96351,2,2216,2403,-187,0,130,0,6
96352,2,2302,2411,-109,0,48,1,8
96353,1,2371,2554,-183,0,291,0,6
96354,1,2322,2450,-128,0,404,1,6
96355,1,2419,2319,100,0,112,1,6
96356,1,2529,2396,133,0,142,1,6
96357,2,2603,2505,98,0,245,0,6
96358,1,2453,2444,9,0,103,0,6
96359,1,2485,2531,-46,0,142,0,6
96360,1,2323,2409,-86,0,151,0,6
96361,2,2466,2519,-53,0,190,0,6
96362,1,2604,2583,21,0,107,1,6
96363,2,2566,2438,128,0,8,1,6
96364,2,2251,2492,-241,0,114,0,6
96366,2,2411,2479,-68,0,172,0,6
96367,1,2547,2557,-10,0,4,0,6
96368,2,2485,2586,-101,0,46,0,6
96369,1,2407,2341,66,0,197,0,6
96370,1,2508,2339,169,0,46,1,6
96371,2,2430,2413,17,0,120,0,6
96372,2,2249,2505,-256,0,110,1,6
96373,1,2635,2542,93,0,0,0,6
96374,3,2698,2643,55,0,110,0,6
96375,3,2489,2393,96,0,49,0,6
96376,1,2403,2507,-104,0,330,0,6
96377,2,2404,2530,-126,0,308,0,6
96378,2,2420,2345,75,0,200,1,6
96379,2,2421,2544,-123,0,300,1,6
96380,2,2543,2580,-37,0,130,0,6
96381,1,2449,2403,46,0,4,0,6
96382,3,2483,2520,-37,0,123,0,6
96383,1,2299,2461,-162,0,14,0,6
96384,2,2412,2306,106,0,202,0,6
96385,1,2454,2321,133,0,0,0,8
96386,1,2397,2451,-54,0,123,1,6
96387,1,2524,2505,19,0,103,0,6
96388,1,2413,2281,132,0,108,0,6
96389,1,2315,2447,-132,0,150,0,6
96390,2,2513,2595,-82,0,57,0,6
96391,2,2325,2572,-247,0,200,1,6
96392,2,2442,2557,-115,0,40,0,6
96393,1,2440,2351,89,0,113,0,6
96394,2,2420,2306,114,0,4,0,8
96395,1,2620,2418,202,0,21,0,6
96396,2,2479,2496,-17,0,86,0,6
96397,1,2546,2542,4,0,391,0,6
96398,2,2480,2330,150,0,0,0,6
96399,3,2416,2503,-87,0,15,0,6
96400,1,2529,2551,-22,0,321,1,6
96401,2,2401,2305,96,0,112,0,6
96402,2,2359,2466,-107,0,404,0,6
96403,1,2525,2380,145,0,190,0,6
96404,2,2514,2312,202,0,120,1,6
96405,2,2454,2410,44,0,13,1,6
96406,2,2312,2401,-89,0,140,0,6
96407,1,2581,2320,261,0,458,0,6
96408,2,2491,2512,-21,0,119,0,6
96409,1,2498,2412,86,0,484,0,6
96410,2,2510,2596,-86,0,101,1,6
96411,2,2513,2534,-21,0,45,0,6
96412,2,2534,2446,88,0,45,1,6
96413,2,2428,2389,39,0,47,1,6
96414,1,2481,2342,139,0,474,0,6
96415,1,2406,2385,21,0,5,1,6
96416,1,2407,2341,66,0,1,1,6
96417,2,2402,2292,110,0,110,0,6
96418,2,2247,2448,-201,0,58,0,6
96419,1,2426,2431,-5,0,306,0,6
96420,2,2419,2424,-5,0,225,0,6
96421,1,2537,2532,5,0,20,1,6
96422,2,2238,2404,-166,0,302,0,6
96423,1,2676,2401,275,0,40,0,6
96424,1,2453,2364,89,0,4,0,6
96425,1,2253,2430,-177,0,187,1,6
96426,1,2622,2494,128,0,335,0,6
96427,1,2387,2417,-30,0,107,0,6
96428,2,2538,2542,-4,0,112,1,6
96429,1,2459,2472,-13,0,64,1,6
96430,1,2344,2455,-111,0,1,0,6
96431,2,2412,2329,83,0,253,0,6
96432,1,2408,2419,-11,0,131,0,6
96433,2,2336,2476,-140,0,302,0,6
96434,1,2446,2558,-112,0,466,0,6
96435,2,2399,2577,-178,0,107,0,6
96436,3,2658,2609,49,0,394,0,6
96437,2,2406,2332,74,0,190,1,6
96438,1,2432,2386,46,0,415,0,6
96439,1,2526,2395,131,0,344,0,8
96440,1,2529,2590,-61,0,115,0,6
96441,2,2499,2517,-18,0,46,1,6
96442,2,2318,2458,-140,0,454,1,8
96443,1,2451,2303,148,0,152,0,6
96444,1,2408,2272,136,0,128,0,6
96445,2,2644,2697,-53,0,270,0,6
96446,1,2423,2444,-21,0,200,1,6
96447,1,2442,2438,4,0,128,1,6
96448,3,2279,2431,-152,0,462,0,6
96449,1,2600,2508,92,0,1,0,6
96450,1,2409,2450,-41,0,302,1,6
96451,1,2439,2323,116,0,158,0,6
96452,2,2415,2278,137,0,106,0,6
96453,1,2507,2380,127,0,474,0,6
96454,1,2430,2413,17,0,320,0,6
96455,1,2574,2299,275,0,53,0,6
96456,1,2417,2444,-27,0,300,0,6
96457,2,2502,2418,84,0,0,0,6
96458,2,2399,2678,-279,0,2,0,6
96459,1,2415,2274,141,0,260,0,8
96460,1,2528,2553,-25,0,181,0,6
96461,1,2425,2475,-50,0,200,0,6
96462,2,2423,2441,-18,0,41,1,6
96463,1,2534,2508,26,0,147,1,6
96464,1,2470,2314,156,0,41,0,6
96465,1,2567,2355,212,0,226,0,6
96466,1,2260,2407,-147,0,0,0,6
96467,2,2392,2405,-13,0,265,0,6
96468,2,2318,2583,-265,0,192,0,6
96469,2,2395,2535,-140,0,426,0,6
96470,1,2413,2260,153,0,138,0,6
96471,2,2518,2545,-27,0,332,0,6
96472,3,2312,2411,-99,0,120,0,6
96473,2,2474,2457,17,0,48,0,6
96474,2,2300,2454,-154,0,278,0,6
96475,2,2401,2415,-14,0,4,0,6
96476,1,2376,2448,-72,0,153,0,6
96477,2,2352,2417,-65,0,1,0,6
96478,2,2402,2395,7,0,2,0,6
96479,1,2404,2435,-31,0,119,0,6
96480,1,2421,2453,-32,0,46,0,6
96481,1,2680,2397,283,0,40,0,6
96482,2,2376,2491,-115,0,297,0,6
96483,2,2215,2411,-196,0,40,0,6
96484,1,2393,2411,-18,0,310,0,6
96485,1,2418,2331,87,0,307,0,6
96486,1,2580,2527,53,0,27,0,6
96487,1,2504,2604,-100,0,112,0,6
96488,1,2411,2238,173,0,50,0,8
96489,2,2610,2657,-47,0,45,0,6
96490,1,2228,2405,-177,0,45,0,6
96491,1,2527,2506,21,0,242,0,6
96492,2,2263,2440,-177,4,250,0,13
96493,2,2408,2435,-27,0,220,1,6
96494,1,2423,2583,-160,0,140,0,6
96495,1,2576,2386,190,0,345,0,6
96496,1,2421,2332,89,0,46,0,6
96497,2,2371,2402,-31,0,394,0,6
96498,2,2241,2509,-268,0,0,0,6
96499,1,2465,2371,94,0,381,0,6
96501,2,2551,2454,97,0,374,0,6
96502,2,2422,2344,78,0,216,0,6
96503,2,2466,2347,119,0,0,0,6
96504,2,2641,2641,0,0,111,1,6
96505,1,2484,2354,130,0,330,1,6
96506,2,2495,2570,-75,0,313,0,6
96507,2,2387,2437,-50,0,106,1,6
96508,2,2395,2682,-287,0,3,0,6
96509,1,2539,2407,132,0,404,0,6
96510,1,2457,2430,27,0,206,0,6
96511,1,2585,2316,269,0,8,1,6
96512,2,2456,2506,-50,0,206,0,6
96513,2,2215,2410,-195,0,122,0,6
96515,1,2431,2264,167,0,108,1,6
96516,1,2519,2515,4,0,45,0,6
96517,1,2423,2325,98,0,462,0,6
96518,1,2494,2514,-20,0,49,0,6
96519,2,2319,2443,-124,0,101,0,6
96520,1,2429,2428,1,0,202,0,6
96521,2,2447,2349,98,0,193,0,6
96522,1,2393,2429,-36,0,200,0,6
96523,1,2438,2336,102,0,269,0,6
96524,2,2425,2495,-70,0,4,0,6
96525,2,2352,2438,-86,0,300,1,6
96526,2,2388,2435,-47,0,123,0,6
96527,2,2684,2394,290,0,331,0,6
96528,3,2260,2445,-185,0,4,0,6
96529,3,2551,2520,31,0,455,0,6
96530,2,2290,2438,-148,0,49,0,6
96531,2,2484,2347,137,0,300,0,6
96532,1,2408,2366,42,0,48,0,6
96533,2,2250,2573,-323,0,21,0,6
96534,1,2461,2493,-32,0,140,0,8
96535,2,2401,2513,-112,0,311,0,6
96536,2,2550,2458,92,0,100,1,6
96537,1,2367,2469,-102,0,218,0,6
96538,1,2412,2232,180,0,46,0,6
96539,1,2503,2534,-31,0,45,1,6
96540,1,2355,2547,-192,0,1,0,6
96541,1,2575,2425,150,0,5,0,6
96542,1,2579,2385,194,0,455,1,6
96543,2,2415,2446,-31,0,217,0,6
96544,1,2440,2383,57,0,483,1,6
96545,2,2351,2441,-90,0,46,1,6
96546,1,2443,2256,187,4,338,0,13
96547,2,2522,2540,-18,0,330,1,6
96548,2,2585,2458,127,0,18,0,6
96549,1,2405,2265,140,0,1,0,6
96550,2,2421,2395,26,0,343,1,6
96551,3,2419,2304,115,0,207,0,8
96552,1,2414,2274,140,0,1,0,6
96553,2,2415,2452,-37,0,110,0,6
96554,1,2480,2557,-77,0,473,0,6
96555,1,2440,2402,38,0,320,0,6
96556,2,2511,2543,-32,0,112,1,6
96557,1,2392,2516,-124,0,245,0,6
96558,1,2422,2266,156,0,320,1,6
96559,1,2461,2500,-39,0,326,0,6
96560,2,2574,2576,-2,0,300,0,6
96561,3,2298,2473,-175,0,112,0,6
96562,3,2532,2410,122,0,40,0,6
96563,3,2462,2374,88,0,454,0,6
96564,1,2355,2410,-55,0,446,0,6
96565,1,2328,2511,-183,0,46,1,6
96566,1,2639,2662,-23,0,120,1,6
96567,1,2451,2500,-49,0,103,1,6
96568,3,2366,2490,-124,0,297,0,6
96569,2,2334,2447,-113,0,245,0,6
96570,1,2409,2355,54,0,263,0,6
96571,2,2404,2542,-138,0,106,0,6
96572,2,2335,2404,-69,0,140,1,6
96573,1,2421,2579,-158,0,121,0,6
96574,2,2422,2488,-66,0,48,0,6
96575,1,2415,2331,84,0,143,0,6
96576,1,2577,2400,177,0,122,0,6
96577,2,2248,2562,-314,0,9,0,6
96578,1,2296,2404,-108,0,211,1,6
96579,3,2403,2675,-272,0,2,0,6
96580,2,2314,2588,-274,0,343,0,6
96581,1,2367,2447,-80,0,101,0,6
96582,1,2434,2426,8,0,49,0,6
96583,2,2447,2457,-10,0,462,0,6
96584,2,2502,2538,-36,0,43,1,6
96585,1,2451,2415,36,0,101,0,8
96586,1,2401,2448,-47,0,288,0,6
96587,1,2447,2374,73,0,46,0,6
96588,2,2442,2364,78,0,202,1,6
96589,2,2458,2252,206,0,110,0,6
96590,1,2313,2410,-97,0,120,1,6
96591,1,2443,2348,95,0,101,0,6
96592,2,2516,2585,-69,0,148,0,6
96593,2,2590,2312,278,0,8,0,6
96594,2,2398,2421,-23,0,248,0,6
96595,2,2438,2431,7,0,45,0,6
96596,3,2478,2337,141,0,42,0,6
96597,2,2585,2515,70,0,277,0,6
96598,3,2400,2308,92,0,46,0,6
96599,2,2591,2525,66,0,3,0,6
96600,2,2466,2347,119,0,207,0,6
96601,2,2441,2578,-137,0,37,0,6
96602,1,2509,2303,206,0,56,0,6
96603,2,2494,2355,139,0,105,0,6
96604,2,2517,2380,137,0,332,0,6
96605,1,2321,2466,-145,0,100,0,6
96606,1,2558,2540,18,0,103,0,6
96607,2,2528,2522,6,0,130,0,6
96608,1,2512,2351,161,0,48,0,6
96609,3,2543,2409,134,0,256,0,6
96610,3,2452,2445,7,0,110,0,6
96611,1,2442,2383,59,0,61,0,6
96612,2,2571,2430,141,0,5,0,6
96613,1,2413,2509,-96,0,302,1,6
96614,2,2397,2582,-185,0,337,0,6
96615,2,2402,2415,-13,0,345,0,6
96616,1,2430,2407,23,0,380,1,6
96618,1,2397,2446,-49,0,255,0,6
96619,1,2407,2308,99,0,200,1,6
96620,2,2569,2454,115,0,45,1,6
96621,2,2546,2488,58,0,45,0,6
96622,1,2361,2511,-150,0,101,0,6
96623,1,2550,2494,56,0,102,0,6
96624,1,2407,2458,-51,0,250,1,6
96625,2,2422,2519,-97,0,28,0,6
96626,2,2546,2400,146,0,337,0,6
96627,2,2549,2506,43,0,4,0,6
96628,2,2414,2460,-46,0,109,1,6
96629,1,2469,2568,-99,0,103,0,6
96630,2,2299,2564,-265,0,101,1,6
96631,2,2403,2471,-68,0,46,0,6
96632,2,2503,2375,128,0,143,0,6
96633,2,2582,2539,43,0,440,1,6
96634,2,2397,2448,-51,0,127,0,6
96635,1,2532,2508,24,0,280,1,6
96636,3,2414,2352,62,0,123,0,6
96637,1,2416,2233,183,0,9,0,6
96638,2,2375,2417,-42,0,405,0,6
96639,2,2427,2378,49,0,88,0,6
96640,3,2431,2367,64,0,200,0,6
96641,1,2412,2563,-151,0,141,0,6
96642,1,2365,2467,-102,0,41,0,8
96643,2,2487,2496,-9,0,103,0,6
96644,1,2543,2384,159,0,5,0,6
96645,2,2418,2253,165,0,310,0,6
96646,2,2355,2458,-103,0,302,0,6
96647,1,2671,2407,264,0,0,0,6
96648,3,2409,2330,79,0,211,0,6
96649,2,2458,2346,112,0,0,1,6
96650,2,2505,2467,38,0,315,0,6
96651,2,2317,2584,-267,0,0,0,6
96652,1,2401,2228,173,0,190,0,6
96653,1,2363,2486,-123,0,13,0,6
96654,1,2440,2375,65,0,133,0,6
96655,2,2220,2443,-223,0,107,0,6
96656,2,2305,2417,-112,0,48,0,8
96657,2,2420,2447,-27,0,337,0,6
96658,1,2304,2515,-211,0,477,0,6
96659,2,2512,2692,-180,0,337,1,6
96660,1,2520,2622,-102,0,326,0,6
96661,1,2372,2440,-68,0,8,1,6
96662,3,2438,2500,-62,0,255,0,6
96663,1,2578,2492,86,0,170,0,6
96664,2,2509,2476,33,0,408,0,6
96665,3,2367,2410,-43,0,203,0,6
96666,2,2534,2563,-29,0,0,1,6
96667,2,2405,2673,-268,0,3,0,6
96668,1,2437,2513,-76,0,4,1,6
96669,1,2290,2452,-162,0,120,0,6
96670,2,2322,2580,-258,0,343,0,6
96671,1,2581,2370,211,0,123,1,6
96672,2,2427,2336,91,0,374,0,6
96673,3,2566,2386,180,0,45,0,6
96674,2,2493,2207,286,0,120,0,6
96675,2,2528,2541,-13,0,300,0,6
96676,2,2340,2522,-182,0,409,1,6
96677,1,2440,2412,28,0,350,1,6
96678,3,2539,2502,37,0,414,0,6
96679,1,2495,2383,112,0,43,0,6
96680,1,2385,2408,-23,0,335,0,6
96681,1,2444,2384,60,0,253,1,6
96682,2,2347,2586,-239,0,201,0,6
96683,2,2465,2368,97,0,40,0,6
96684,3,2402,2417,-15,0,196,0,6
96685,1,2419,2364,55,0,1,1,6
96686,3,2370,2414,-44,0,331,0,6
96687,1,2489,2561,-72,0,344,1,6
96688,1,2418,2268,150,0,483,0,6
96689,2,2332,2413,-81,0,211,0,6
96690,1,2555,2562,-7,0,7,0,6
96691,1,2675,2403,272,0,0,0,6
96692,1,2451,2411,40,0,101,0,6
96693,3,2287,2462,-175,0,453,0,6
96694,2,2403,2304,99,0,255,1,6
96695,2,2658,2638,20,0,1,0,6
96696,1,2360,2504,-144,0,9,0,6
96697,1,2597,2487,110,0,25,0,6
96698,1,2278,2447,-169,0,106,0,6
96699,2,2465,2451,14,0,13,0,6
96700,1,2356,2409,-53,0,212,0,6
96701,1,2547,2421,126,0,8,0,6
96702,2,2262,2409,-147,0,110,0,6
96703,1,2409,2299,110,0,109,0,8
96704,1,2446,2281,165,4,47,1,13
96705,2,2583,2550,33,0,277,0,6
96706,2,2370,2563,-193,0,101,0,6
96707,2,2257,2476,-219,0,113,0,6
96708,2,2331,2407,-76,0,140,0,6
96709,1,2370,2589,-219,0,45,0,6
96710,2,2502,2429,73,0,405,0,6
96711,3,2452,2470,-18,0,42,0,6
96712,1,2478,2370,108,0,102,1,6
96713,1,2459,2415,44,0,117,0,6
96714,1,2240,2589,-349,0,40,0,6
96715,1,2582,2320,262,0,8,1,6
96716,2,2224,2404,-180,0,188,1,6
96717,1,2450,2301,149,0,0,0,6
96718,1,2473,2318,155,0,200,0,6
96719,3,2479,2256,223,0,1,0,6
96720,3,2446,2251,195,0,106,0,6
96721,1,2360,2421,-61,0,40,0,6
96722,3,2389,2460,-71,0,107,0,8
96723,1,2439,2257,182,0,225,0,6
96724,2,2450,2495,-45,0,205,0,6
96725,2,2350,2401,-51,0,302,0,6
96726,1,2457,2397,60,0,127,0,6
96727,1,2447,2368,79,0,106,0,6
96728,2,2403,2305,98,0,48,0,6
96729,2,2240,2500,-260,0,302,0,6
96730,2,2404,2476,-72,0,203,0,6
96731,2,2401,2388,13,0,5,1,6
96732,2,2488,2368,120,0,483,1,6
96733,1,2402,2336,66,0,130,0,6
96734,3,2460,2503,-43,0,113,0,6
96735,2,2581,2439,142,0,469,0,6
96736,2,2433,2442,-9,0,225,1,6
96737,1,2529,2542,-13,0,101,0,6
96738,2,2401,2677,-276,0,3,0,6
96739,1,2556,2681,-125,0,100,0,6
96740,3,2381,2499,-118,0,301,0,6
96741,1,2588,2255,333,0,406,1,6
96742,2,2320,2417,-97,0,196,0,6
96743,2,2506,2701,-195,0,353,1,6
96744,2,2561,2388,173,0,7,0,6
96745,2,2444,2452,-8,0,400,0,6
96746,1,2417,2302,115,0,200,1,6
96747,2,2567,2479,88,0,112,1,6
96748,2,2530,2537,-7,0,394,0,6
96749,1,2547,2424,123,0,121,1,6
96750,2,2583,2206,377,0,307,1,6
96751,1,2422,2421,1,0,10,0,6
96752,2,2351,2523,-172,0,0,1,6
96753,2,2380,2413,-33,0,8,0,6
96754,1,2576,2396,180,0,190,0,6
96755,2,2363,2449,-86,0,310,0,6
96756,1,2502,2461,41,0,45,1,6
96757,1,2406,2371,35,0,268,0,6
96758,2,2569,2539,30,0,248,0,6
96759,2,2550,2445,105,0,15,0,6
96760,1,2356,2421,-65,0,13,1,6
96761,3,2417,2456,-39,0,135,0,6
96762,2,2459,2496,-37,0,102,0,6
96763,1,2679,2399,280,0,331,0,6
96764,1,2554,2402,152,0,45,1,6
96765,2,2436,2517,-81,0,308,0,6
96766,1,2436,2391,45,0,108,0,6
96767,2,2464,2454,10,0,100,0,6
96768,1,2559,2523,36,0,100,1,6
96769,3,2422,2579,-157,0,330,0,6
96770,1,2601,2652,-51,0,14,1,6
96771,2,2463,2410,53,0,4,0,6
96772,2,2566,2365,201,0,330,0,6
96773,1,2425,2496,-71,0,1,0,6
96774,1,2499,2393,106,0,122,0,6
96775,1,2407,2379,28,0,152,0,6
96776,2,2397,2681,-284,0,3,0,6
96777,3,2497,2495,2,0,80,0,6
96778,2,2436,2358,78,0,333,1,6
96779,2,2329,2495,-166,0,3,0,6
96780,2,2308,2460,-152,0,277,0,6
96781,2,2235,2412,-177,0,395,0,6
96782,2,2438,2392,46,0,484,0,6
96783,3,2342,2406,-64,0,201,0,6
96784,2,2366,2483,-117,0,13,1,6
96785,2,2470,2453,17,0,3,0,6
96786,1,2460,2454,6,0,190,0,6
96787,2,2318,2584,-266,0,343,1,6
96789,1,2399,2403,-4,0,80,0,6
96790,2,2474,2375,99,0,122,1,6
96791,2,2501,2590,-89,0,49,1,6
96792,1,2337,2431,-94,0,310,0,8
96793,1,2535,2543,-8,0,301,0,6
96794,2,2500,2453,47,0,250,1,6
96795,1,2389,2502,-113,0,145,0,6
96796,2,2576,2458,118,0,447,0,6
96797,1,2546,2439,107,0,133,0,6
96798,2,2489,2316,173,0,120,0,6
96799,3,2366,2432,-66,0,10,0,6
96800,2,2307,2442,-135,0,267,1,8
96801,2,2371,2502,-131,0,1,0,6
96802,1,2545,2562,-17,0,200,1,6
96803,1,2526,2348,178,0,106,0,6
96804,2,2564,2573,-9,0,140,0,6
96805,2,2448,2325,123,0,106,0,6
96806,2,2447,2481,-34,0,121,1,6
96807,2,2674,2542,132,0,120,0,6
96808,2,2295,2412,-117,0,184,0,8
96809,2,2391,2454,-63,0,42,1,6
96810,2,2389,2427,-38,0,140,0,6
96811,1,2282,2457,-175,0,45,0,6
96812,3,2590,2249,341,0,460,0,6
96813,3,2532,2253,279,0,104,0,6
96814,1,2645,2537,108,0,43,0,6
96815,1,2704,2503,201,0,40,1,6
96816,2,2511,2541,-30,0,46,0,6
96817,2,2417,2577,-160,0,307,1,6
96818,1,2413,2312,101,0,313,1,6
96819,2,2263,2437,-174,0,101,0,6
96820,3,2420,2416,4,0,455,0,6
96821,1,2486,2352,134,0,347,0,6
96822,1,2683,2395,288,0,331,0,6
96823,1,2506,2380,126,0,107,0,6
96824,1,2454,2540,-86,0,106,0,6
96825,2,2368,2573,-205,0,250,0,6
96826,1,2451,2358,93,0,28,0,6
96827,1,2521,2351,170,0,326,0,6
96828,1,2524,2239,285,0,109,0,6
96829,3,2350,2413,-63,0,101,0,8
96830,1,2420,2507,-87,0,130,0,6
96831,2,2460,2399,61,0,0,0,6
96832,2,2385,2439,-54,0,153,0,6
96833,1,2441,2249,192,0,100,0,6
96834,2,2276,2557,-281,0,10,0,6
96835,2,2511,2357,154,0,132,0,6
96836,2,2454,2559,-105,0,301,0,6
96837,2,2437,2579,-142,0,107,0,6
96839,2,2373,2470,-97,0,56,0,6
96840,2,2345,2529,-184,0,131,1,6
96841,1,2518,2353,165,0,8,1,6
96842,3,2495,2456,39,0,409,0,6
96843,3,2256,2508,-252,0,120,0,6
96844,2,2590,2557,33,0,175,0,6
96845,1,2421,2415,6,0,45,0,8
96846,2,2312,2497,-185,0,277,1,6
96847,1,2405,2343,62,0,14,0,6
96848,1,2449,2466,-17,0,311,0,6
96849,3,2415,2459,-44,0,136,0,6
96850,1,2314,2401,-87,0,41,0,6
96851,2,2365,2481,-116,0,101,0,6
96852,2,2325,2576,-251,0,255,1,6
96853,3,2550,2445,105,0,4,0,6
96854,3,2448,2533,-85,0,48,0,6
96855,1,2429,2252,177,0,463,1,6
96856,3,2546,2666,-120,0,301,0,6
96857,1,2464,2435,29,0,2,0,6
96858,1,2558,2438,120,0,40,0,6
96859,2,2414,2552,-138,0,409,0,6
96860,2,2356,2427,-71,0,268,1,6
96861,1,2486,2363,123,0,102,1,6
96862,2,2470,2524,-54,0,215,0,6
96863,1,2393,2524,-131,0,3,0,6
96864,2,2494,2369,125,0,122,0,6
96865,1,2483,2370,113,0,84,0,6
96866,3,2494,2497,-3,0,103,0,6
96867,1,2409,2465,-56,0,253,0,6
96868,2,2635,2649,-14,0,150,0,6
96869,2,2244,2510,-266,0,300,0,6
96870,1,2369,2402,-33,0,2,0,6
96871,1,2485,2212,273,0,200,0,6
96872,1,2461,2384,77,0,191,0,6
96873,2,2432,2450,-18,0,106,1,6
96874,2,2523,2563,-40,0,300,0,6
96875,2,2449,2372,77,0,8,0,6
96876,2,2316,2559,-243,0,311,1,6
96877,3,2324,2450,-126,0,106,0,6
96878,2,2283,2432,-149,0,41,0,6
96879,1,2413,2562,-149,0,485,1,6
96880,2,2580,2562,18,0,242,0,6
96881,2,2486,2404,82,0,453,0,6
96882,1,2339,2426,-87,0,331,1,5
96883,2,2563,2584,-21,0,447,0,6
96884,1,2425,2274,151,0,123,0,6
96885,1,2416,2247,169,0,12,0,8
96886,2,2378,2487,-109,0,306,0,6
96887,1,2442,2504,-62,0,8,1,6
96888,1,2486,2557,-71,0,242,0,6
96889,2,2354,2422,-68,0,380,0,6
96890,1,2389,2444,-55,0,470,0,6
96891,1,2246,2432,-186,0,354,0,6
96892,1,2432,2317,115,0,487,0,6
96893,2,2583,2542,41,0,365,1,6
96894,2,2458,2441,17,0,15,1,6
96895,3,2503,2487,16,0,263,0,6
96896,3,2512,2499,13,0,301,0,6
96897,2,2365,2453,-88,0,67,0,6
96898,2,2325,2420,-95,0,45,0,6
96899,2,2334,2460,-126,0,432,0,6
96900,1,2426,2455,-29,0,492,0,6
96901,1,2459,2510,-51,0,122,0,6
96902,3,2586,2373,213,0,331,0,6
96903,1,2500,2495,5,0,84,0,6
96904,2,2409,2377,32,0,245,0,6
96905,2,2430,2487,-57,0,4,0,6
96906,2,2350,2422,-72,0,45,0,6
96907,1,2707,2532,175,0,50,0,6
96908,2,2469,2469,0,0,80,0,6
96909,2,2458,2425,33,0,207,0,6
96910,1,2462,2349,113,0,123,0,6
96911,2,2568,2548,20,0,131,0,6
96912,1,2396,2416,-20,0,15,1,6
96913,1,2517,2401,116,0,40,0,6
96914,2,2415,2408,7,0,144,1,6
96915,2,2532,2458,74,0,4,0,6
96916,1,2664,2548,116,0,102,0,6
96917,1,2401,2309,92,0,4,0,6
96918,1,2404,2351,53,0,247,0,6
96919,1,2445,2409,36,0,380,0,8
96920,2,2246,2400,-154,0,212,0,6
96921,1,2359,2490,-131,0,13,0,6
96922,2,2427,2396,31,0,67,0,6
96923,2,2268,2448,-180,0,218,0,6
96924,2,2369,2435,-66,0,41,0,6
96925,2,2456,2427,29,0,213,0,6
96926,2,2412,2351,61,0,123,0,8
96927,3,2589,2558,31,0,175,0,6
96928,2,2244,2423,-179,0,123,0,6
96929,2,2439,2319,120,0,15,1,6
96930,1,2494,2337,157,0,200,0,6
96931,2,2497,2465,32,0,315,1,6
96932,1,2512,2237,275,0,210,0,6
96933,1,2500,2236,264,0,46,1,6
96934,2,2316,2465,-149,0,190,0,6
96935,1,2574,2425,149,0,132,0,6
96936,2,2380,2411,-31,0,140,0,6
96937,1,2309,2404,-95,0,253,0,6
96938,1,2446,2487,-41,0,244,0,6
96939,2,2443,2503,-60,0,404,0,6
96940,1,2568,2526,42,0,300,0,6
96941,1,2492,2359,133,0,404,1,6
96942,2,2414,2376,38,0,6,1,6
96943,2,2550,2493,57,0,120,0,6
96944,1,2465,2349,116,0,122,0,6
96945,1,2578,2220,358,0,150,0,6
96946,1,2554,2422,132,0,114,1,6
96947,1,2504,2373,131,0,491,0,6
96948,3,2439,2277,162,0,457,0,6
96949,1,2556,2411,145,0,4,0,6
96950,1,2237,2405,-168,0,106,0,6
96951,1,2459,2363,96,0,132,0,6
96952,1,2404,2294,110,0,108,0,8
96953,2,2255,2583,-328,0,12,0,6
96954,2,2451,2317,134,0,351,1,8
96955,1,2286,2450,-164,4,271,0,13
96956,3,2448,2326,122,0,326,0,6
96957,1,2522,2549,-27,0,5,0,6
96958,3,2448,2452,-4,0,4,0,6
96960,2,2529,2710,-181,0,300,0,6
96961,1,2464,2448,16,0,211,0,6
96962,3,2401,2533,-132,0,40,0,6
96963,1,2464,2330,134,0,142,1,6
96964,1,2249,2426,-177,0,121,0,6
96965,2,2449,2449,0,0,101,0,6
96966,2,2397,2525,-128,0,2,0,6
96967,2,2439,2392,47,0,139,0,6
96968,1,2465,2402,63,0,0,0,6
96969,1,2362,2514,-152,0,1,0,6
96970,2,2374,2433,-59,0,143,0,6
96971,2,2489,2506,-17,0,405,0,6
96972,1,2555,2390,165,0,5,0,6
96973,2,2377,2444,-67,0,142,1,8
96974,3,2411,2362,49,4,35,0,13
96975,1,2462,2562,-100,0,110,0,6
96976,2,2544,2668,-124,0,0,0,6
96977,2,2376,2580,-204,0,48,0,6
96978,2,2529,2394,135,0,4,0,6
96979,2,2429,2273,156,0,125,0,6
96980,1,2426,2305,121,0,311,0,6
96981,1,2416,2374,42,0,194,0,6
96982,2,2424,2475,-51,0,4,0,6
96983,2,2433,2427,6,0,190,0,6
96984,3,2802,2628,174,0,202,0,6
96985,1,2451,2409,42,0,151,0,6
96986,1,2483,2367,116,0,102,0,6
96987,1,2404,2243,161,0,152,1,6
96988,1,2481,2453,28,0,57,0,6
96989,2,2397,2410,-13,0,464,0,6
96990,2,2358,2406,-48,0,310,0,8
96991,3,2618,2436,182,0,45,0,6
96992,3,2334,2497,-163,0,1,0,6
96993,1,2438,2358,80,0,107,1,6
96994,2,2500,2543,-43,0,312,0,6
96995,1,2469,2463,6,0,104,0,6
96996,1,2241,2490,-249,0,399,0,6
96997,1,2563,2382,181,0,330,0,6
96998,3,2558,2583,-25,0,7,0,6
96999,1,2526,2383,143,0,300,0,6
97000,1,2672,2540,132,0,102,0,6
97001,2,2355,2463,-108,0,140,1,6
97002,3,2422,2432,-10,0,400,0,6
97003,2,2277,2494,-217,0,27,1,6
97004,2,2537,2676,-139,0,100,0,6
97005,2,2555,2578,-23,0,130,0,6
97006,3,2346,2469,-123,0,469,0,6
97007,1,2369,2508,-139,0,265,0,6
97008,3,2502,2320,182,0,15,0,6
97009,1,2589,2491,98,0,105,1,6
97010,2,2477,2592,-115,0,106,0,6
97011,2,2442,2379,63,0,135,0,6
97012,1,2406,2426,-20,0,43,1,6
97013,1,2531,2369,162,0,49,0,6
97014,2,2417,2352,65,0,161,1,6
97015,1,2363,2487,-124,0,13,0,6
97016,2,2475,2438,37,0,122,0,6
97017,2,2427,2367,60,0,345,0,6
97018,1,2521,2418,103,0,330,1,6
97019,1,2468,2462,6,0,462,0,8
97020,1,2371,2450,-79,0,219,0,8
97021,1,2402,2251,151,0,28,1,6
97022,1,2713,2503,210,0,345,0,6
97023,3,2356,2421,-65,0,20,0,6
97024,2,2496,2350,146,0,57,1,6
97025,2,2282,2585,-303,0,10,0,6
97026,2,2398,2529,-131,0,255,0,6
97027,2,2403,2345,58,0,331,0,6
97028,1,2455,2443,12,0,45,0,6
97029,2,2266,2457,-191,0,101,0,6
97030,2,2543,2548,-5,0,20,0,6
97031,2,2442,2484,-42,0,103,0,6
97032,2,2402,2512,-110,0,2,0,6
97033,2,2372,2417,-45,0,463,0,6
97034,2,2290,2408,-118,0,4,0,8
97035,2,2490,2385,105,0,302,0,6
97036,1,2561,2248,313,0,19,0,6
97037,1,2480,2603,-123,0,3,0,6
97038,3,2368,2449,-81,0,375,0,6
97039,2,2415,2452,-37,0,123,1,6
97040,2,2399,2566,-167,0,308,0,6
97041,1,2375,2468,-93,0,45,0,6
97042,1,2641,2528,113,0,301,0,6
97043,2,2286,2496,-210,0,101,0,6
97044,2,2266,2445,-179,0,40,1,6
97045,1,2554,2537,17,0,120,1,6
97046,3,2441,2373,68,0,1,0,6
97047,1,2506,2228,278,0,211,0,6
97048,1,2630,2799,-169,0,438,0,6
97049,3,2500,2445,55,0,45,0,6
97050,1,2430,2457,-27,0,46,1,6
97052,1,2467,2348,119,0,190,0,6
97053,2,2583,2583,0,0,341,0,6
97055,2,2437,2558,-121,0,311,0,6
97056,1,2239,2407,-168,0,212,1,6
97057,1,2461,2422,39,0,301,1,6
97058,1,2432,2294,138,0,17,0,6
97059,1,2679,2533,146,0,100,0,6
97060,2,2467,2470,-3,0,153,0,6
97061,1,2417,2351,66,0,131,0,6
97062,1,2474,2516,-42,0,427,1,6
97063,2,2314,2443,-129,0,140,0,6
97064,1,2411,2353,58,0,259,0,8
97065,2,2371,2499,-128,0,1,0,6
97066,2,2524,2487,37,0,46,0,6
97067,2,2347,2528,-181,0,7,1,6
97068,1,2577,2649,-72,0,52,1,6
97069,1,2596,2509,87,0,374,0,6
97070,2,2442,2269,173,4,46,0,13
97071,3,2403,2297,106,0,405,0,6
97072,2,2489,2589,-100,0,302,1,6
97073,2,2479,2371,108,0,102,1,6
97074,2,2510,2500,10,0,130,0,6
97075,1,2470,2414,56,0,112,0,6
97076,1,2416,2464,-48,0,113,0,6
97077,1,2525,2398,127,0,92,0,6
97078,2,2502,2487,15,0,4,0,6
97079,1,2483,2382,101,0,49,0,6
97080,1,2586,2357,229,0,404,0,6
97081,3,2340,2495,-155,0,205,0,6
97082,1,2309,2449,-140,0,120,0,8
97083,2,2344,2471,-127,0,469,0,6
97084,2,2422,2321,101,0,406,0,6
97085,1,2486,2395,91,0,426,0,6
97086,2,2402,2439,-37,0,106,0,6
97087,1,2457,2319,138,0,214,0,6
97088,1,2420,2252,168,0,300,1,8
97089,3,2435,2458,-23,0,21,0,8
97090,1,2447,2281,166,0,4,0,6
97091,2,2407,2584,-177,0,41,1,8
97092,1,2380,2402,-22,0,250,0,8
97093,3,2631,2703,-72,0,45,0,8
97094,2,2497,2427,70,0,43,0,6
97095,2,2530,2683,-153,0,301,0,6
97096,2,2412,2237,175,0,101,1,8
97097,1,2499,2434,65,0,5,0,6
97098,1,2446,2517,-71,0,54,1,6
97099,2,2433,2436,-3,0,277,1,6
97100,1,2456,2402,54,0,0,0,8
97101,1,2569,2352,217,0,386,0,6
97102,1,2455,2317,138,0,15,0,6
97103,1,2532,2559,-27,0,11,0,6
97105,1,2446,2374,72,0,200,0,6
97106,2,2245,2422,-177,0,200,0,6
97107,3,2291,2462,-171,0,13,0,6
97108,2,2259,2422,-163,0,190,1,6
97109,1,2429,2407,22,0,312,0,6
97110,2,2503,2394,109,0,210,1,6
97111,1,2480,2487,-7,0,112,0,6
97112,1,2446,2436,10,0,373,1,6
97113,2,2359,2504,-145,0,46,1,6
97114,1,2450,2240,210,0,106,1,6
97115,1,2457,2343,114,0,101,0,6
97116,2,2303,2462,-159,0,157,0,6
97117,2,2516,2417,99,0,45,1,6
97118,1,2403,2339,64,0,43,0,6
97119,1,2360,2466,-106,0,109,0,6
97120,2,2325,2454,-129,0,48,0,6
97121,1,2531,2235,296,0,135,0,6
97122,1,2502,2481,21,0,4,0,6
97123,1,2475,2340,135,0,110,0,6
97124,1,2506,2504,2,0,145,0,6
97125,2,2268,2633,-365,0,300,0,8
97126,2,2274,2461,-187,0,121,0,8
97127,3,2437,2451,-14,0,121,0,6
97128,1,2696,2470,226,0,331,0,6
97129,1,2361,2409,-48,0,147,0,6
97130,1,2348,2416,-68,0,4,1,8
97131,2,2267,2415,-148,0,456,0,6
97132,2,2485,2636,-151,0,52,0,6
97133,1,2402,2461,-59,0,58,0,6
97134,2,2378,2472,-94,0,13,1,6
97135,1,2414,2350,64,0,307,1,6
97136,2,2379,2492,-113,0,215,0,6
97137,2,2368,2501,-133,0,140,0,6
97138,1,2439,2271,168,0,190,1,6
97139,1,2469,2374,95,0,200,1,6
97140,3,2449,2398,51,0,335,0,6
97141,1,2402,2434,-32,0,141,0,6
97142,3,2353,2584,-231,0,340,0,6
97143,1,2408,2395,13,0,151,0,6
97144,1,2311,2589,-278,0,210,0,6
97145,1,2481,2339,142,0,41,1,6
97146,1,2441,2397,44,0,115,0,8
97147,2,2407,2390,17,0,200,0,6
97148,2,2242,2405,-163,0,14,0,6
97149,2,2452,2483,-31,0,201,1,6
97150,2,2434,2283,151,0,106,0,6
97151,2,2444,2476,-32,0,320,0,6
97152,2,2538,2526,12,0,20,0,6
97153,1,2418,2365,53,0,110,1,6
97154,2,2491,2508,-17,0,270,1,6
97155,1,2465,2431,34,0,43,1,6
97156,2,2248,2572,-324,0,1,0,6
97157,2,2511,2558,-47,0,43,0,6
97158,1,2402,2280,122,0,120,1,6
97159,1,2392,2446,-54,0,48,0,8
97160,1,2493,2453,40,0,108,0,6
97161,1,2493,2418,75,0,3,0,6
97162,2,2491,2384,107,0,40,0,6
97163,2,2428,2427,1,0,250,1,6
97164,1,2496,2375,121,0,110,0,6
97165,2,2397,2497,-100,0,200,1,6
97166,2,2339,2481,-142,0,88,0,6
97167,3,2459,2337,122,0,30,0,6
97168,2,2447,2504,-57,0,442,1,6
97169,1,2498,2512,-14,0,130,1,6
97170,1,2460,2511,-51,0,380,0,6
97171,2,2247,2453,-206,0,201,0,6
97172,2,2237,2533,-296,0,190,0,6
97173,1,2348,2495,-147,0,251,0,6
97174,1,2424,2502,-78,0,302,1,6
97175,3,2431,2345,86,0,7,0,6
97176,2,2426,2398,28,0,200,0,6
97177,1,2438,2355,83,0,46,1,6
97178,2,2467,2698,-231,0,278,0,6
97179,1,2464,2383,81,0,373,0,8
97180,1,2444,2264,180,0,15,0,6
97181,2,2328,2471,-143,0,1,0,6
97182,2,2323,2423,-100,4,408,0,13
97183,1,2383,2442,-59,0,469,0,6
97184,1,2437,2500,-63,0,100,0,6
97185,1,2401,2502,-101,0,3,0,6
97186,2,2450,2506,-56,0,7,0,6
97187,1,2408,2327,81,0,311,0,6
97188,1,2452,2367,85,0,344,0,6
97189,1,2491,2360,131,0,57,0,6
97190,2,2454,2407,47,0,243,0,6
97191,2,2244,2402,-158,0,212,1,6
97192,2,2433,2410,23,4,302,0,13
97193,1,2581,2539,42,0,54,0,6
97194,2,2402,2445,-43,0,132,1,6
97195,1,2335,2434,-99,0,112,1,6
97196,1,2469,2356,113,0,4,0,6
97197,1,2275,2400,-125,0,1,0,6
97198,1,2476,2374,102,0,102,0,6
97199,1,2607,2220,387,0,107,0,8
97200,2,2404,2348,56,0,133,0,6
97201,2,2505,2364,141,0,157,0,6
97202,2,2322,2500,-178,0,332,0,6
97203,3,2480,2521,-41,0,466,0,6
97204,1,2387,2404,-17,0,469,0,6
97205,1,2573,2287,286,0,45,0,6
97206,1,2506,2214,292,0,107,0,6
97207,3,2498,2511,-13,0,46,0,6
97208,1,2445,2349,96,0,4,1,6
97209,2,2334,2703,-369,0,45,0,8
97210,1,2401,2390,11,0,429,1,6
97211,2,2277,2579,-302,0,10,1,6
97212,1,2473,2371,102,0,191,0,6
97213,2,2403,2375,28,0,174,0,6
97214,1,2420,2354,66,0,123,1,6
97215,1,2498,2467,31,0,46,1,6
97216,2,2301,2413,-112,0,253,0,6
97217,1,2413,2389,24,0,442,0,6
97218,2,2411,2469,-58,0,331,0,6
97219,2,2448,2457,-9,0,40,0,6
97220,2,2391,2483,-92,0,263,0,6
97221,1,2532,2586,-54,0,14,0,6
97222,1,2406,2485,-79,0,105,0,6
97223,1,2495,2409,86,0,203,0,6
97224,1,2534,2448,86,0,45,0,6
97225,2,2494,2444,50,0,0,1,6
97226,1,2360,2405,-45,0,244,0,6
97227,2,2414,2498,-84,0,10,1,6
97228,1,2491,2336,155,0,40,0,6
97229,2,2398,2470,-72,0,15,0,6
97230,1,2401,2297,104,0,40,1,6
97231,1,2448,2334,114,0,269,1,6
97232,2,2402,2433,-31,0,330,0,6
97233,1,2409,2299,110,0,107,0,8
97234,3,2575,2393,182,0,310,0,6
97235,1,2506,2513,-7,0,247,0,6
97236,2,2648,2637,11,0,142,0,6
97237,1,2312,2423,-111,0,227,1,6
97238,1,2506,2504,2,0,0,0,6
97239,2,2326,2442,-116,0,128,0,6
97240,1,2535,2257,278,0,106,0,6
97241,1,2495,2475,20,0,315,0,6
97242,1,2431,2622,-191,0,302,1,6
97243,2,2579,2482,97,0,313,0,6
97244,2,2353,2475,-122,0,461,0,6
97245,2,2550,2539,11,0,378,0,6
97246,1,2339,2426,-87,0,31,1,6
97247,2,2371,2477,-106,0,1,0,6
97248,1,2362,2456,-94,0,201,0,6
97249,2,2414,2601,-187,0,80,1,6
97250,3,2533,2501,32,0,315,0,6
97251,3,2338,2444,-106,0,460,0,6
97252,1,2372,2497,-125,0,40,0,6
97253,2,2503,2319,184,0,103,1,6
97254,2,2510,2442,68,0,43,0,6
97255,3,2333,2494,-161,0,45,0,6
97256,2,2436,2250,186,0,0,0,6
97257,2,2362,2509,-147,0,120,0,6
97258,2,2269,2439,-170,0,7,1,6
97259,1,2406,2241,165,0,152,1,6
97260,2,2441,2375,66,0,303,0,6
97261,1,2374,2443,-69,0,45,0,6
97262,2,2402,2333,69,0,330,1,8
97263,1,2407,2399,8,0,400,0,6
97264,3,2581,2446,135,0,354,0,6
97265,1,2450,2397,53,0,140,0,6
97266,2,2336,2425,-89,0,469,1,6
97267,3,2498,2450,48,0,302,0,6
97268,3,2512,2241,271,0,130,0,6
97269,1,2462,2487,-25,0,20,0,6
97270,1,2387,2419,-32,0,422,0,6
97271,1,2562,2422,140,0,300,0,6
97272,1,2528,2326,202,0,174,0,6
97273,1,2565,2539,26,0,241,0,6
97274,2,2405,2499,-94,0,3,0,6
97275,1,2371,2417,-46,0,301,0,6
97276,2,2297,2424,-127,0,45,0,6
97277,1,2349,2416,-67,0,10,0,6
97279,1,2339,2504,-165,0,40,1,6
97280,1,2336,2429,-93,0,123,1,6
97281,1,2478,2364,114,0,40,0,6
97282,1,2644,2642,2,0,374,0,6
97283,2,2474,2701,-227,0,335,0,6
97284,1,2448,2536,-88,0,107,0,6
97285,1,2393,2406,-13,0,172,0,6
97286,2,2533,2431,102,0,45,0,6
97287,1,2443,2501,-58,0,130,0,6
97288,1,2396,2475,-79,0,400,1,6
97289,1,2393,2572,-179,0,7,1,6
97290,2,2313,2424,-111,0,0,0,6
97291,2,2451,2487,-36,0,100,0,6
97292,1,2415,2456,-41,0,200,1,6
97293,2,2409,2377,32,0,53,0,6
97294,1,2545,2545,0,0,20,1,6
97295,1,2445,2339,106,0,15,0,6
97296,2,2475,2480,-5,0,112,1,6
97297,1,2504,2512,-8,0,40,0,6
97298,1,2342,2408,-66,0,405,1,8
97299,2,2498,2512,-14,0,121,0,6
97300,2,2264,2433,-169,0,45,0,6
97301,1,2644,2629,15,0,156,0,6
97302,1,2415,2320,95,0,0,1,6
97303,1,2503,2400,103,0,203,0,6
97304,3,2704,2616,88,0,106,0,8
97305,3,2489,2380,109,0,0,0,6
97306,1,2448,2293,155,0,49,1,6
97307,2,2428,2579,-151,0,200,1,6
97308,3,2449,2537,-88,0,152,0,6
97309,2,2449,2572,-123,0,302,0,6
97310,2,2418,2440,-22,0,46,0,6
97311,2,2295,2413,-118,0,45,0,8
97312,2,2409,2481,-72,0,101,0,6
97313,2,2367,2402,-35,0,1,0,6
97314,2,2342,2531,-189,0,302,0,6
97315,1,2439,2434,5,0,110,0,6
97316,2,2428,2249,179,0,0,1,6
97317,2,2448,2604,-156,0,270,0,6
97318,2,2381,2438,-57,0,57,1,8
97319,1,2482,2341,141,0,107,0,6
97320,1,2495,2439,56,0,190,0,6
97321,2,2494,2526,-32,0,46,0,6
97322,1,2267,2404,-137,0,226,1,8
97323,1,2509,2253,256,0,150,0,6
97324,1,2325,2412,-87,0,365,1,6
97325,2,2436,2328,108,0,123,0,6
97326,1,2492,2335,157,0,67,0,6
97327,2,2528,2455,73,0,46,0,6
97328,2,2264,2409,-145,0,106,1,6
97329,1,2562,2451,111,0,7,0,6
97330,1,2245,2405,-160,0,49,0,6
97331,1,2419,2361,58,0,102,0,6
97332,1,2346,2410,-64,0,245,1,6
97333,1,2546,2497,49,0,105,1,6
97334,1,2384,2449,-65,0,195,0,6
97335,1,2593,2396,197,0,200,0,6
97336,1,2474,2469,5,0,464,0,8
97337,1,2636,2650,-14,0,0,1,6
97338,3,2492,2596,-104,0,341,0,6
97339,1,2333,2403,-70,0,120,0,6
97340,1,2495,2481,14,0,302,0,6
97341,3,2507,2493,14,0,121,0,6
97342,1,2405,2287,118,0,0,0,6
97343,1,2445,2469,-24,0,31,0,6
97344,2,2663,2576,87,0,300,1,6
97345,3,2488,2469,19,0,6,0,6
97346,2,2273,2440,-167,0,10,0,6
97347,1,2539,2551,-12,0,426,0,6
97348,1,2346,2402,-56,0,57,0,6
97349,3,2450,2403,47,0,131,0,6
97350,1,2299,2424,-125,0,0,1,6
97351,2,2468,2536,-68,0,324,0,6
97352,2,2419,2336,83,0,14,1,6
97353,1,2486,2491,-5,0,191,1,6
97354,1,2388,2428,-40,0,0,0,6
97355,1,2275,2431,-156,0,49,0,6
97356,2,2368,2564,-196,0,101,0,6
97357,2,2401,2399,2,0,410,0,6
97358,1,2440,2278,162,0,131,0,6
97359,1,2485,2423,62,0,31,1,6
97360,2,2393,2439,-46,0,112,0,6
97361,1,2413,2248,165,0,189,0,6
97362,2,2329,2511,-182,0,125,0,6
97363,2,2442,2343,99,0,415,1,6
97364,3,2434,2457,-23,0,345,0,6
97365,3,2428,2445,-17,0,46,0,6
97366,2,2369,2428,-59,4,415,1,13
97367,1,2409,2273,136,0,0,0,6
97368,2,2311,2419,-108,0,200,0,6
97369,2,2467,2427,40,4,287,0,13
97370,2,2583,2452,131,0,354,1,6
97371,3,2534,2425,109,0,211,0,6
97372,1,2483,2230,253,0,15,0,6
97373,1,2607,2624,-17,0,453,1,6
97374,1,2420,2347,73,0,209,1,6
97375,1,2520,2462,58,0,200,0,6
97376,2,2357,2421,-64,0,190,0,6
97377,2,2538,2445,93,0,4,0,6
97378,1,2442,2489,-47,0,134,0,6
97379,1,2594,2650,-56,0,250,1,6
97380,1,2374,2422,-48,0,80,0,6
97381,1,2413,2391,22,0,400,0,6
97382,2,2450,2344,106,0,335,0,6
97383,1,2463,2270,193,0,195,0,6
97384,2,2573,2481,92,0,118,0,6
97385,1,2468,2410,58,0,300,0,6
97386,1,2380,2407,-27,0,187,0,6
97387,2,2567,2443,124,0,80,0,6
97388,1,2400,2204,196,0,120,0,6
97389,1,2443,2391,52,0,484,0,6
97390,2,2424,2402,22,0,122,0,6
97391,1,2339,2418,-79,4,139,1,13
97392,2,2447,2282,165,0,7,0,6
97393,2,2393,2566,-173,0,3,0,6
97394,3,2530,2493,37,0,45,0,6
97395,1,2551,2571,-20,0,190,0,6
97396,2,2396,2500,-104,0,21,1,6
97397,1,2395,2449,-54,0,5,1,6
97398,1,2404,2352,52,0,411,0,6
97399,2,2388,2484,-96,0,140,0,6
97400,2,2396,2494,-98,0,0,0,6
97401,2,2450,2361,89,0,122,1,8
97402,1,2404,2401,3,0,40,1,6
97403,3,2484,2364,120,0,311,0,6
97404,1,2545,2545,0,0,311,0,6
97405,2,2406,2472,-66,0,460,1,6
97406,1,2644,2642,2,0,0,0,6
97407,3,2288,2445,-157,0,4,0,6
97408,2,2501,2471,30,0,45,0,6
97409,2,2393,2463,-70,0,344,1,6
97410,1,2540,2246,294,0,176,0,6
97411,1,2201,2403,-202,0,123,0,6
97412,1,2424,2390,34,0,0,1,6
97413,3,2507,2507,0,0,253,0,6
97414,2,2506,2493,13,0,133,0,6
97415,1,2451,2313,138,0,206,0,6
97416,1,2559,2322,237,0,45,1,6
97417,1,2456,2451,5,0,35,0,6
97418,2,2448,2551,-103,0,4,0,6
97419,3,2635,2703,-68,0,45,0,8
97420,2,2323,2463,-140,0,84,1,6
97421,1,2214,2429,-215,0,113,0,6
97422,2,2445,2401,44,0,37,1,6
97423,1,2331,2466,-135,0,463,1,6
97424,2,2424,2376,48,0,47,1,8
97425,1,2412,2372,40,0,10,0,6
97426,1,2426,2357,69,0,123,1,6
97427,3,2412,2532,-120,0,288,0,6
97428,1,2469,2488,-19,0,112,0,6
97429,2,2331,2417,-86,0,101,0,8
97430,2,2352,2490,-138,0,105,0,6
97431,2,2418,2563,-145,0,45,1,6
97432,1,2485,2492,-7,0,190,0,6
97433,1,2447,2457,-10,0,228,0,6
97434,3,2583,2434,149,0,415,0,6
97435,1,2531,2417,114,0,8,0,6
97436,1,2542,2385,157,0,241,1,6
97437,1,2409,2310,99,0,190,1,3
97438,1,2457,2484,-27,0,126,0,6
97439,2,2702,2388,314,0,45,0,8
97440,2,2289,2415,-126,0,40,0,6
97441,2,2438,2352,86,0,4,1,6
97442,2,2636,2650,-14,0,301,0,6
97443,3,2238,2426,-188,0,4,0,6
97444,1,2717,2688,29,0,150,0,6
97445,2,2386,2420,-34,0,143,0,6
97446,3,2313,2405,-92,0,46,0,6
97447,2,2263,2419,-156,0,136,0,6
97448,2,2280,2575,-295,0,210,1,6
97449,1,2448,2376,72,0,156,0,6
97450,2,2359,2416,-57,0,5,0,6
97451,1,2482,2498,-16,0,45,1,6
97452,2,2452,2569,-117,0,112,0,6
97453,1,2390,2551,-161,0,338,0,6
97454,2,2482,2343,139,0,241,0,6
97455,2,2366,2562,-196,0,10,0,6
97456,1,2423,2270,153,0,4,1,6
97457,1,2539,2551,-12,0,378,0,6
97458,2,2420,2372,48,0,373,0,6
97459,3,2459,2365,94,0,152,0,8
97460,2,2378,2465,-87,0,300,0,6
97461,2,2408,2418,-10,0,41,0,6
97462,3,2643,2565,78,0,193,0,6
97463,2,2289,2453,-164,0,147,0,6
97464,1,2451,2493,-42,0,103,1,6
97465,2,2373,2402,-29,0,5,0,6
97466,1,2419,2254,165,0,199,0,6
97467,2,2336,2454,-118,0,123,1,6
97468,2,2460,2500,-40,0,96,0,6
97469,1,2448,2356,92,4,255,0,13
97470,1,2499,2551,-52,0,244,1,6
97471,3,2504,2446,58,0,190,0,6
97472,1,2338,2480,-142,0,45,1,6
97473,1,2486,2491,-5,0,191,1,6
97474,2,2289,2409,-120,0,311,1,6
97475,2,2477,2466,11,0,45,1,6
97476,2,2573,2390,183,0,4,0,6
97477,3,2314,2442,-128,0,210,0,6
97478,1,2476,2367,109,0,331,0,6
97479,1,2303,2401,-98,0,206,1,8
97480,2,2441,2255,186,0,201,0,6
97481,1,2448,2555,-107,0,128,1,6
97482,1,2419,2285,134,0,123,1,6
97483,1,2682,2722,-40,0,169,0,6
97484,3,2552,2703,-151,0,6,0,6
97485,2,2425,2361,64,0,14,0,6
97486,3,2429,2418,11,0,338,0,6
97487,1,2367,2422,-55,0,30,0,6
97488,1,2457,2286,171,0,10,0,6
97489,2,2464,2494,-30,0,103,1,6
97490,1,2469,2414,55,0,43,0,6
97491,1,2494,2581,-87,0,265,0,6
97492,1,2656,2631,25,0,4,0,6
97493,2,2422,2260,162,0,176,0,6
97494,2,2437,2453,-16,0,58,0,6
97495,2,2279,2426,-147,0,45,1,6
97496,3,2458,2531,-73,0,295,0,6
97497,2,2478,2463,15,0,58,0,6
97498,2,2310,2413,-103,0,111,0,6
97499,1,2412,2535,-123,0,281,1,6
97500,2,2281,2564,-283,0,101,0,6
97501,1,2377,2417,-40,0,131,1,6
97502,2,2383,2441,-58,0,40,1,6
97503,1,2568,2419,149,0,125,0,6
97504,1,2415,2431,-16,0,45,0,6
97505,2,2370,2546,-176,0,195,0,6
97506,1,2421,2332,89,0,151,0,6
97507,1,2258,2408,-150,0,466,1,6
97508,1,2461,2577,-116,0,311,0,6
97509,3,2458,2319,139,0,243,0,6
97510,1,2423,2391,32,0,143,0,6
97511,1,2565,2431,134,0,4,1,6
97512,3,2503,2442,61,0,121,0,6
97513,1,2456,2381,75,0,202,1,6
97514,1,2545,2545,0,0,114,0,6
97515,1,2492,2346,146,0,406,0,6
97516,2,2260,2497,-237,0,5,0,6
97517,2,2626,2662,-36,0,8,0,6
97518,1,2315,2428,-113,0,5,0,6
97519,2,2309,2402,-93,0,320,0,6
97520,1,2421,2327,94,0,80,0,8
97521,1,2458,2440,18,0,112,0,6
97522,2,2692,2227,465,0,107,0,8
97523,2,2357,2458,-101,0,10,1,6
97524,1,2487,2499,-12,0,85,0,6
97525,1,2424,2287,137,0,122,1,6
97526,3,2472,2532,-60,0,331,0,6
97527,1,2492,2579,-87,0,300,0,6
97528,2,2566,2407,159,0,45,0,6
97529,1,2566,2399,167,0,331,0,6
97530,2,2304,2434,-130,4,40,1,13
97531,2,2420,2456,-36,0,57,0,6
97532,1,2505,2455,50,0,247,0,6
97533,2,2354,2460,-106,0,47,0,6
97534,1,2585,2496,89,0,10,1,6
97535,1,2572,2550,22,0,120,0,6
97536,2,2545,2359,186,0,37,0,6
97537,2,2427,2343,84,0,128,0,6
97538,1,2401,2488,-87,0,46,0,6
97539,2,2506,2506,0,0,151,0,6
97540,1,2447,2469,-22,0,456,0,6
97541,1,2499,2510,-11,0,107,1,6
97542,1,2503,2522,-19,0,200,0,6
97543,1,2334,2457,-123,0,41,0,8
97544,1,2428,2326,102,0,245,1,6
97545,2,2328,2426,-98,0,380,1,6
97546,2,2472,2584,-112,0,11,0,6
97547,2,2471,2350,121,0,300,0,6
97548,1,2543,2399,144,0,45,1,6
97549,3,2346,2492,-146,0,6,0,6
97550,2,2447,2368,79,0,140,0,6
97551,1,2455,2480,-25,0,242,0,6
97552,2,2529,2392,137,0,210,0,6
97553,1,2409,2459,-50,0,181,0,6
97554,2,2415,2474,-59,0,400,0,6
97555,3,2347,2448,-101,0,203,0,6
97556,3,2404,2315,89,0,200,0,6
97557,3,2539,2327,212,0,242,0,6
97558,2,2276,2425,-149,0,365,0,6
97559,1,2547,2430,117,0,102,0,6
97560,1,2335,2400,-65,0,20,0,8
97561,1,2423,2463,-40,0,0,1,6
97562,1,2417,2305,112,0,303,1,6
97563,2,2250,2536,-286,0,113,0,8
97564,2,2330,2469,-139,0,46,0,6
97565,1,2569,2242,327,0,405,0,6
97566,2,2716,2689,27,0,130,0,6
97567,3,2306,2413,-107,0,289,0,3
97568,2,2420,2374,46,0,300,0,6
97569,1,2502,2472,30,0,122,1,6
97570,1,2350,2411,-61,0,453,1,6
97571,1,2588,2456,132,0,46,1,6
97572,2,2385,2429,-44,0,112,0,6
97573,2,2461,2421,40,0,170,0,6
97574,2,2324,2569,-245,0,115,0,6
97575,1,2380,2413,-33,0,200,0,6
97576,3,2307,2429,-122,0,4,0,6
97577,3,2418,2429,-11,0,53,0,6
97578,2,2374,2569,-195,0,132,0,6
97579,2,2428,2554,-126,0,354,0,6
97580,2,2511,2469,42,0,31,0,6
97581,2,2354,2446,-92,0,429,0,6
97582,3,2269,2401,-132,0,203,0,6
97583,2,2368,2418,-50,0,301,0,6
97584,3,2406,2312,94,0,310,0,6
97585,1,2493,2402,91,0,50,0,6
97586,1,2290,2444,-154,0,50,0,6
97587,2,2307,2630,-323,0,122,0,8
97588,1,2429,2372,57,0,190,0,6
97589,2,2235,2449,-214,0,250,0,6
97590,2,2493,2569,-76,0,338,1,6
97591,2,2406,2301,105,0,30,0,6
97592,1,2450,2510,-60,0,96,0,6
97593,2,2484,2642,-158,0,4,0,6
97594,1,2305,2403,-98,0,41,0,6
97595,2,2473,2455,18,0,15,0,6
97596,2,2443,2392,51,0,41,0,6
97597,1,2442,2265,177,0,21,0,8
97598,2,2233,2416,-183,0,107,0,6
97600,2,2442,2604,-162,0,151,0,6
97601,1,2288,2440,-152,0,250,0,6
97602,2,2270,2427,-157,0,311,0,6
97603,1,2667,2620,47,0,455,0,6
97604,2,2464,2350,114,0,8,0,6
97605,2,2462,2558,-96,0,101,0,6
97606,1,2614,2427,187,0,57,1,6
97608,2,2375,2440,-65,0,46,0,6
97609,3,2421,2354,67,0,40,0,6
97610,2,2394,2411,-17,0,310,1,6
97611,2,2434,2500,-66,4,131,0,13
97612,2,2551,2540,11,0,200,0,6
97613,1,2426,2369,57,0,190,1,6
97614,3,2478,2505,-27,0,123,0,6
97615,2,2459,2476,-17,0,216,1,6
97616,2,2345,2439,-94,0,302,1,6
97617,2,2608,2396,212,0,203,0,6
97618,2,2401,2681,-280,0,265,0,8
97619,2,2354,2446,-92,0,8,1,6
97620,2,2545,2509,36,0,20,0,6
97621,2,2272,2451,-179,0,428,0,6
97622,1,2457,2350,107,0,302,0,6
97623,1,2481,2453,28,0,45,0,6
97624,2,2462,2357,105,0,4,0,6
97625,2,2588,2577,11,0,48,0,6
97626,1,2473,2285,188,0,40,0,6
97627,1,2492,2342,150,0,190,0,6
97628,2,2432,2464,-32,0,241,1,6
97629,3,2437,2401,36,0,400,0,6
97630,1,2515,2500,15,0,133,0,6
97631,2,2365,2429,-64,0,380,0,6
97632,2,2327,2639,-312,0,207,0,8
97633,2,2390,2504,-114,0,215,0,6
97634,2,2440,2407,33,0,40,0,6
97635,2,2330,2468,-138,0,301,0,6
97636,3,2563,2571,-8,0,330,0,6
97637,2,2343,2417,-74,0,125,0,6
97638,3,2479,2339,140,0,47,0,6
97639,2,2356,2430,-74,0,3,0,6
97640,2,2508,2549,-41,0,311,1,6
97641,1,2405,2504,-99,0,110,0,6
97642,1,2490,2348,142,0,107,0,6
97643,2,2434,2332,102,0,10,1,6
97644,1,2419,2217,202,0,0,0,6
97645,2,2401,2284,117,0,100,0,6
97646,1,2404,2457,-53,0,13,0,6
97647,1,2429,2357,72,0,123,0,6
97648,1,2397,2507,-110,0,1,0,6
97649,2,2514,2326,188,0,150,0,6
97650,1,2376,2461,-85,0,325,1,6
97651,1,2481,2498,-17,0,102,0,6
97652,1,2536,2591,-55,0,100,0,6
97653,2,2467,2508,-41,0,438,1,6
97654,2,2388,2473,-85,0,200,1,6
97655,1,2403,2536,-133,0,30,0,6
97656,3,2380,2462,-82,0,122,0,6
97657,1,2469,2370,99,0,302,0,6
97658,1,2433,2400,33,0,200,0,6
97659,1,2218,2571,-353,0,110,0,6
97660,1,2427,2346,81,0,0,0,6
97661,2,2557,2422,135,0,455,0,6
97662,2,2339,2507,-168,0,4,0,8
97663,2,2441,2343,98,0,112,0,6
97664,1,2454,2424,30,0,190,1,6
97665,2,2449,2289,160,0,8,0,8
97666,2,2324,2504,-180,0,344,0,6
97667,2,2476,2358,118,0,43,1,6
97668,1,2583,2489,94,0,110,0,6
97669,1,2748,2582,166,0,317,0,6
97670,2,2399,2423,-24,0,27,0,6
97671,2,2574,2539,35,0,70,1,6
97672,2,2434,2425,9,0,4,0,6
97673,3,2411,2308,103,0,190,0,3
97674,2,2488,2484,4,0,343,1,6
97675,2,2233,2505,-272,0,132,1,6
97676,1,2616,2672,-56,0,141,0,6
97677,1,2523,2587,-64,0,176,0,6
97678,2,2305,2402,-97,0,4,1,6
97679,1,2432,2300,132,0,113,0,6
97680,1,2367,2433,-66,0,40,1,6
97681,3,2361,2420,-59,0,310,0,6
97682,1,2454,2388,66,0,135,1,6
97683,2,2243,2416,-173,0,134,0,6
97684,3,2640,2445,195,0,218,0,8
97685,1,2399,2405,-6,0,13,1,6
97686,2,2303,2437,-134,0,196,0,6
97687,1,2450,2545,-95,0,128,0,6
97688,2,2314,2495,-181,0,127,0,6
97689,1,2599,2495,104,0,125,0,6
97690,2,2547,2477,70,0,101,0,6
97691,2,2364,2431,-67,0,104,1,6
97692,2,2435,2352,83,0,131,0,6
97693,1,2452,2329,123,0,4,0,6
97694,1,2414,2425,-11,0,150,1,6
97695,2,2571,2422,149,0,57,1,6
97696,1,2563,2365,198,0,54,0,6
97697,2,2345,2493,-148,0,150,1,6
97698,2,2462,2487,-25,0,415,0,6
97699,2,2405,2550,-145,0,2,0,6
97700,2,2355,2434,-79,0,43,0,6
97701,1,2508,2352,156,0,46,0,6
97702,2,2381,2428,-47,0,16,1,6
97703,2,2240,2428,-188,0,153,1,6
97704,2,2295,2436,-141,0,49,0,6
97705,2,2462,2576,-114,0,107,1,6
97706,2,2349,2443,-94,0,300,0,6
97707,1,2585,2571,14,0,45,0,6
97708,1,2373,2481,-108,0,485,0,6
97709,1,2469,2326,143,0,300,0,6
97710,1,2405,2355,50,0,331,0,6
97711,1,2339,2427,-88,0,45,1,6
97712,1,2500,2428,72,0,140,0,6
97713,3,2431,2503,-72,0,80,0,6
97714,1,2515,2554,-39,0,110,0,6
97715,2,2492,2378,114,0,311,0,6
97716,1,2423,2273,150,0,128,1,6
97717,2,2487,2473,14,0,205,0,6
97718,1,2514,2462,52,0,121,0,6
97719,1,2472,2366,106,0,30,0,6
97720,2,2504,2534,-30,0,153,1,6
97721,1,2450,2461,-11,0,45,0,6
97722,2,2578,2751,-173,0,300,0,6
97723,1,2614,2434,180,0,45,0,6
97724,2,2454,2377,77,0,150,1,6
97725,1,2353,2402,-49,0,409,0,6
97726,2,2310,2438,-128,4,0,1,13
97727,2,2430,2470,-40,0,101,0,6
97728,1,2666,2622,44,0,0,0,6
97729,2,2400,2322,78,0,405,0,6
97730,1,2454,2468,-14,0,128,1,6
97731,1,2419,2458,-39,0,345,1,6
97732,1,2498,2311,187,0,314,0,6
97733,1,2419,2384,35,0,48,0,6
97734,2,2538,2473,65,0,122,0,6
97735,2,2491,2601,-110,0,112,0,6
97736,2,2490,2567,-77,0,31,1,6
97737,1,2546,2545,1,0,448,0,6
97738,2,2344,2561,-217,0,304,0,6
97739,2,2483,2476,7,0,359,1,6
97740,2,2362,2436,-74,0,56,0,6
97741,1,2300,2448,-148,0,207,0,8
97742,1,2575,2462,113,0,46,0,6
97743,3,2240,2459,-219,0,180,0,6
97744,1,2419,2385,34,0,398,0,6
97745,1,2511,2381,130,0,48,0,6
97746,1,2410,2255,155,0,418,0,6
97747,2,2285,2444,-159,0,485,0,6
97748,1,2501,2399,102,0,106,0,6
97749,1,2624,2392,232,0,351,1,8
97750,3,2460,2537,-77,0,453,0,6
97751,1,2346,2438,-92,0,43,1,6
97752,1,2359,2420,-61,0,415,0,6
97753,1,2350,2434,-84,0,201,0,6
97754,2,2484,2426,58,0,453,1,6
97755,2,2346,2540,-194,0,320,0,6
97756,1,2580,2411,169,0,27,1,6
97757,1,2439,2290,149,0,277,0,6
97758,2,2423,2433,-10,0,460,0,6
97759,2,2325,2457,-132,0,448,0,6
97760,2,2230,2426,-196,0,40,0,8
97761,1,2275,2445,-170,0,245,0,8
97762,1,2492,2456,36,0,45,0,6
97763,1,2457,2519,-62,0,354,0,6
97764,2,2382,2441,-59,0,41,0,8
97765,2,2563,2566,-3,0,309,1,6
97766,1,2440,2362,78,0,123,1,6
97767,1,2310,2410,-100,0,344,1,3
97768,2,2617,2671,-54,0,120,0,6
97769,2,2349,2497,-148,0,310,0,6
97770,2,2564,2254,310,0,45,0,6
97771,2,2430,2342,88,0,176,1,6
97772,1,2455,2553,-98,0,331,0,6
97773,3,2427,2320,107,0,200,0,6
97774,1,2401,2522,-121,0,3,0,6
97775,2,2548,2479,69,0,205,0,6
97776,2,2374,2431,-57,0,40,0,6
97777,2,2559,2382,177,0,106,1,6
97778,1,2566,2481,85,0,5,0,6
97779,1,2377,2425,-48,0,112,0,6
97780,3,2441,2348,93,0,485,0,6
97781,2,2407,2590,-183,0,200,1,6
97782,2,2476,2603,-127,0,20,0,6
97783,1,2484,2502,-18,0,80,0,6
97784,2,2252,2418,-166,0,140,0,6
97785,1,2447,2439,8,0,108,0,6
97786,2,2242,2405,-163,0,41,1,6
97787,2,2420,2351,69,0,20,0,6
97788,3,2531,2399,132,0,400,0,6
97789,1,2559,2522,37,0,247,0,6
97790,2,2543,2509,34,0,132,0,6
97791,1,2540,2551,-11,0,345,0,6
97792,1,2497,2318,179,0,302,1,6
97793,1,2607,2472,135,0,215,0,6
97794,2,2456,2294,162,0,194,1,6
97795,3,2424,2387,37,0,322,0,6
97796,2,2421,2355,66,0,206,0,6
97797,1,2456,2300,156,0,301,0,6
97798,2,2402,2406,-4,0,200,0,6
97799,1,2462,2321,141,0,4,0,6
97800,1,2653,2286,367,0,45,0,6
97801,1,2294,2456,-162,0,102,1,6
97802,2,2514,2487,27,0,145,0,6
97803,1,2285,2443,-158,0,250,0,6
97804,1,2579,2541,38,0,300,0,6
97805,2,2251,2431,-180,0,46,0,6
97806,2,2451,2564,-113,0,106,1,6
97807,2,2333,2447,-114,0,147,0,6
97808,2,2475,2498,-23,0,104,0,6
97809,1,2292,2452,-160,0,389,0,8
97810,2,2368,2531,-163,0,300,0,6
97811,3,2336,2423,-87,0,40,0,6
97812,2,2490,2425,65,0,405,1,6
97814,1,2431,2369,62,0,150,0,6
97815,3,2517,2572,-55,0,22,0,6
97816,3,2642,2679,-37,0,45,0,8
97817,2,2486,2477,9,0,31,0,6
97820,1,2676,2612,64,0,13,0,6
97821,1,2403,2317,86,0,190,0,3
97822,1,2546,2716,-170,0,20,0,6
97823,2,2409,2515,-106,0,3,0,6
97824,1,2469,2610,-141,0,20,0,6
97825,2,2448,2441,7,0,7,1,6
97826,1,2323,2505,-182,0,143,0,6
97827,3,2434,2344,90,0,106,0,6
97828,1,2451,2497,-46,0,415,0,6
97829,1,2534,2584,-50,0,101,0,6
97830,2,2486,2479,7,0,462,0,6
97831,1,2417,2357,60,0,302,0,6
97832,2,2418,2480,-62,0,40,0,6
97833,2,2504,2470,34,0,101,1,6
97834,1,2643,2213,430,0,45,1,8
97835,1,2462,2483,-21,0,56,0,6
97836,1,2500,2369,131,0,106,1,6
97837,1,2546,2353,193,0,50,0,6
97838,1,2433,2255,178,0,106,0,6
97839,2,2496,2507,-11,0,242,0,6
97840,1,2433,2476,-43,0,83,0,6
97841,2,2431,2344,87,0,122,0,6
97842,2,2570,2404,166,0,5,1,6
97843,1,2444,2557,-113,0,200,0,6
97844,3,2571,2477,94,0,45,0,6
97845,2,2593,2486,107,0,302,0,6
97846,3,2447,2421,26,0,118,0,8
97847,2,2300,2464,-164,0,1,0,6
97848,1,2537,2323,214,0,42,0,6
97849,2,2515,2343,172,0,255,1,6
97850,1,2498,2381,117,0,45,0,6
97851,1,2435,2363,72,0,109,0,6
97852,1,2519,2391,128,0,315,0,6
97853,2,2553,2405,148,0,210,0,6
97854,1,2379,2427,-48,0,45,1,6
97855,2,2397,2535,-138,0,332,1,6
97856,2,2318,2466,-148,0,110,1,6
97857,2,2233,2424,-191,0,121,0,6
97858,2,2253,2436,-183,0,244,0,6
97859,1,2508,2630,-122,0,134,0,6
97860,2,2413,2414,-1,0,11,1,6
97861,1,2461,2485,-24,0,110,0,6
97862,2,2412,2535,-123,0,106,0,6
97863,1,2435,2296,139,0,353,0,6
97864,3,2603,2477,126,0,215,0,6
97865,1,2435,2460,-25,0,346,0,6
97866,2,2408,2451,-43,0,325,0,6
97867,2,2314,2637,-323,0,122,0,8
97868,2,2252,2448,-196,0,180,0,6
97869,1,2387,2436,-49,0,190,0,6
97870,2,2608,2680,-72,0,0,0,6
97871,1,2414,2263,151,0,106,0,6
97872,1,2276,2422,-146,0,151,0,6
97873,1,2497,2332,165,0,0,0,6
97874,3,2269,2535,-266,0,4,0,8
97875,2,2408,2283,125,0,13,0,6
97876,2,2568,2554,14,0,120,0,6
97877,3,2447,2447,0,0,346,0,6
97878,3,2428,2373,55,0,395,0,6
97879,1,2287,2448,-161,0,0,0,6
97880,1,2428,2371,57,4,140,0,13
97881,2,2459,2390,69,0,108,0,6
97882,3,2333,2442,-109,0,200,0,8
97883,1,2580,2644,-64,0,400,1,6
97884,2,2358,2484,-126,0,80,0,6
97885,1,2493,2549,-56,0,245,0,6
97886,1,2659,2344,315,0,45,0,6
97887,2,2497,2432,65,0,125,0,6
97888,1,2453,2321,132,0,131,1,6
97889,1,2491,2458,33,0,45,0,6
97890,2,2571,2494,77,0,80,0,6
97891,2,2479,2507,-28,0,335,0,6
97892,2,2578,2543,35,0,300,0,6
97893,2,2290,2443,-153,0,288,0,8
97894,1,2678,2363,315,0,45,0,8
97895,1,2550,2570,-20,0,320,0,6
97896,1,2501,2323,178,0,301,0,6
97897,2,2351,2452,-101,0,57,0,6
97898,2,2360,2467,-107,0,440,1,6
97899,1,2436,2437,-1,0,181,0,6
97900,1,2584,2477,107,0,16,1,6
97901,2,2481,2443,38,0,211,0,6
97902,1,2485,2479,6,0,40,0,6
97903,2,2322,2554,-232,0,112,0,6
97904,3,2542,2408,134,0,207,0,6
97905,3,2351,2424,-73,0,103,0,6
97906,2,2395,2545,-150,0,9,0,6
97907,1,2494,2586,-92,0,40,0,6
97908,2,2395,2439,-44,0,225,0,6
97909,2,2498,2458,40,0,247,0,6
97910,2,2440,2357,83,0,43,0,6
97911,1,2440,2350,90,0,190,0,6
97912,1,2467,2471,-4,0,6,0,6
97913,2,2423,2353,70,0,130,0,6
97914,1,2431,2361,70,0,0,0,8
97915,1,2470,2314,156,0,4,0,6
97916,3,2545,2413,132,0,200,0,6
97917,2,2352,2430,-78,0,48,1,6
97918,2,2513,2391,122,0,102,0,6
97919,3,2323,2504,-181,0,300,0,6
97920,1,2268,2439,-171,0,302,0,6
97921,2,2438,2487,-49,0,86,0,6
97922,2,2377,2562,-185,0,45,0,6
97923,1,2473,2273,200,0,40,1,6
97924,1,2512,2427,85,0,130,0,6
97925,3,2583,2276,307,0,83,0,6
97926,2,2418,2516,-98,0,206,0,6
97927,2,2531,2546,-15,0,45,0,6
97928,2,2447,2354,93,0,21,0,6
97929,1,2538,2622,-84,0,256,0,6
97930,1,2269,2514,-245,0,46,1,6
97931,2,2551,2386,165,0,202,0,6
97932,1,2421,2392,29,0,90,1,6
97933,2,2564,2340,224,0,310,0,6
97934,2,2337,2556,-219,0,89,0,6
97935,1,2412,2453,-41,0,203,1,6
97936,1,2433,2366,67,0,132,0,6
97937,2,2307,2408,-101,0,111,1,6
97938,2,2419,2260,159,0,40,0,6
97939,2,2685,2603,82,0,5,1,6
97940,1,2405,2412,-7,0,10,0,6
97941,2,2456,2372,84,0,123,0,6
97943,1,2447,2319,128,0,281,0,6
97944,1,2556,2254,302,0,41,0,6
97945,1,2424,2397,27,0,138,1,6
97946,2,2419,2517,-98,0,19,1,6
97947,1,2531,2371,160,0,163,0,8
97948,2,2403,2562,-159,0,4,1,6
97949,2,2266,2401,-135,0,315,1,8
97950,1,2450,2302,148,0,121,0,6
97951,1,2560,2542,18,0,20,0,6
97952,3,2447,2444,3,0,113,0,6
97953,1,2500,2500,0,0,415,0,6
97954,2,2359,2416,-57,0,144,0,6
97955,1,2664,2361,303,0,45,0,6
97956,1,2509,2518,-9,0,250,0,6
97957,2,2479,2390,89,0,13,0,6
97958,2,2346,2444,-98,0,21,0,6
97959,1,2311,2474,-163,0,115,0,6
97960,1,2503,2325,178,0,45,0,6
97961,2,2422,2325,97,0,44,0,6
97962,2,2564,2510,54,0,106,0,6
97963,2,2218,2422,-204,0,110,1,8
97964,2,2473,2491,-18,0,54,0,6
97965,1,2361,2437,-76,0,202,0,6
97966,1,2453,2496,-43,0,415,1,6
97967,2,2558,2452,106,0,327,0,6
97968,2,2456,2303,153,0,150,0,6
97969,3,2393,2432,-39,0,40,0,6
97970,1,2587,2565,22,0,302,0,6
97972,2,2302,2440,-138,0,20,1,6
97973,3,2433,2396,37,0,6,0,6
97974,2,2439,2520,-81,0,44,0,6
97975,2,2473,2572,-99,0,49,1,6
97976,1,2447,2414,33,0,142,0,6
97977,2,2210,2555,-345,0,300,0,6
97978,1,2388,2529,-141,0,73,0,6
97979,1,2320,2490,-170,0,37,0,6
97980,2,2328,2442,-114,0,207,0,8
97981,3,2397,2402,-5,0,278,0,6
97982,1,2551,2526,25,0,41,0,6
97983,2,2336,2434,-98,4,411,0,13
97984,2,2475,2491,-16,0,103,0,6
97985,3,2391,2476,-85,0,101,0,6
97986,2,2251,2579,-328,0,202,0,6
97987,2,2361,2449,-88,0,40,0,6
97988,1,2541,2331,210,0,116,0,6
97989,1,2415,2543,-128,0,3,1,6
97991,1,2349,2415,-66,0,121,1,6
97992,2,2465,2503,-38,0,131,0,6
97993,2,2406,2433,-27,0,49,0,6
97994,2,2434,2334,100,0,190,0,6
97995,1,2615,2546,69,0,332,0,6
97996,2,2501,2543,-42,0,145,1,6
97997,1,2537,2434,103,0,426,1,6
97998,2,2524,2566,-42,0,190,1,6
97999,1,2482,2307,175,0,1,0,6
98000,2,2500,2399,101,0,307,1,6
98001,1,2448,2341,107,0,121,0,6
98002,1,2481,2371,110,0,200,0,6
98003,1,2468,2426,42,0,330,0,6
98004,1,2395,2431,-36,0,162,0,6
98006,1,2419,2415,4,0,110,0,6
98007,2,2338,2649,-311,0,200,0,8
98008,2,2430,2399,31,0,57,0,6
98009,1,2431,2473,-42,0,312,1,6
98010,2,2355,2421,-66,0,14,0,6
98011,2,2394,2506,-112,0,43,0,6
98012,1,2345,2411,-66,0,310,0,6
98013,1,2459,2412,47,0,380,0,6
98014,1,2492,2419,73,0,474,1,6
98015,1,2505,2343,162,0,46,1,6
98016,2,2351,2445,-94,4,1,0,13
98017,2,2389,2442,-53,0,61,1,6
98018,2,2610,2678,-68,0,100,0,6
98019,2,2271,2408,-137,0,248,1,6
98020,2,2565,2558,7,0,247,0,6
98021,3,2276,2451,-175,0,20,0,6
98022,1,2507,2429,78,0,108,0,6
98023,2,2360,2552,-192,0,8,1,6
98024,1,2398,2472,-74,0,202,0,6
98025,2,2439,2400,39,0,45,0,6
98026,1,2494,2575,-81,0,129,0,6
98027,1,2427,2449,-22,0,200,0,6
98028,1,2444,2292,152,0,100,0,6
98029,2,2422,2447,-25,0,48,0,6
98030,1,2620,2512,108,0,83,0,6
98031,1,2413,2282,131,0,302,0,6
98032,1,2497,2465,32,0,45,0,6
98033,1,2271,2475,-204,0,101,0,6
98034,3,2541,2601,-60,0,121,0,6
98035,1,2420,2209,211,0,338,0,6
98036,1,2560,2593,-33,0,5,0,6
98037,1,2425,2333,92,0,101,0,6
98038,1,2460,2321,139,0,108,1,6
98039,1,2551,2209,342,0,88,1,6
98040,2,2441,2276,165,0,29,0,6
98041,1,2405,2424,-19,0,16,0,6
98042,2,2443,2438,5,0,122,0,6
98043,1,2446,2260,186,0,21,0,8
98044,1,2521,2415,106,0,67,0,6
98045,2,2349,2464,-115,0,300,0,6
98046,1,2448,2407,41,0,111,0,6
98047,1,2521,2512,9,0,40,0,6
98048,1,2510,2390,120,0,0,0,6
98049,2,2289,2402,-113,0,1,0,6
98050,2,2344,2538,-194,0,240,0,6
98051,2,2469,2469,0,0,359,1,6
98052,2,2476,2490,-14,0,125,1,6
98053,2,2241,2511,-270,0,132,0,6
98054,1,2425,2210,215,0,264,0,6
98055,3,2426,2395,31,0,331,0,6
98056,1,2576,2615,-39,0,248,0,6
98057,1,2454,2408,46,0,377,0,6
98058,3,2571,2524,47,0,21,0,6
98059,2,2465,2519,-54,0,44,1,6
98060,1,2357,2400,-43,0,48,0,6
98061,1,2466,2290,176,0,43,1,6
98062,1,2386,2561,-175,0,300,1,6
98063,1,2514,2508,6,0,310,0,6
98064,1,2670,2357,313,0,43,0,6
98065,2,2375,2467,-92,0,45,0,6
98066,2,2683,2606,77,0,4,0,6
98067,1,2425,2404,21,0,245,1,6
98068,3,2514,2544,-30,0,107,0,6
98069,2,2401,2365,36,4,255,0,13
98070,2,2401,2201,200,0,202,0,8
98071,2,2508,2624,-116,0,253,0,6
98072,2,2485,2507,-22,0,140,0,6
98073,1,2443,2278,165,0,123,0,6
98074,2,2409,2433,-24,0,469,0,6
98075,1,2406,2362,44,0,203,0,6
98076,2,2464,2536,-72,0,200,1,6
98077,3,2471,2392,79,0,202,0,6
98078,1,2497,2473,24,0,112,1,6
98079,2,2440,2316,124,0,180,1,6
98080,2,2507,2427,80,0,43,0,6
98081,1,2407,2313,94,0,343,1,3
98082,2,2617,2423,194,0,210,0,6
98083,1,2337,2439,-102,0,484,0,6
98084,3,2681,2243,438,0,45,0,8
98085,1,2541,2401,140,0,43,0,6
98086,1,2437,2335,102,0,122,1,6
98087,2,2444,2438,6,0,326,0,6
98088,1,2454,2213,241,0,245,0,6
98089,2,2467,2430,37,0,4,0,6
98090,1,2459,2326,133,0,6,1,6
98091,2,2418,2411,7,0,62,0,6
98092,1,2503,2502,1,0,54,0,6
98093,1,2416,2430,-14,0,104,1,6
98094,1,2519,2496,23,0,315,0,6
98095,2,2402,2453,-51,0,10,0,6
98096,2,2425,2491,-66,0,405,1,6
98097,2,2312,2493,-181,0,255,1,6
98098,2,2406,2479,-73,0,20,0,6
98099,2,2403,2354,49,0,201,0,6
98100,3,2555,2464,91,0,45,0,6
98101,2,2324,2523,-199,0,114,0,8
98102,2,2321,2404,-83,0,300,1,6
98103,2,2325,2402,-77,0,332,0,6
98104,3,2347,2431,-84,4,1,0,13
98105,2,2586,2566,20,0,131,1,6
98106,2,2446,2497,-51,0,102,0,6
98107,1,2564,2414,150,0,464,0,6
98108,1,2405,2257,148,0,100,0,8
98109,1,2559,2400,159,0,120,0,6
98110,3,2449,2348,101,4,112,0,13
98111,2,2253,2508,-255,0,45,0,6
98112,1,2448,2552,-104,0,210,0,6
98113,2,2609,2582,27,0,21,0,6
98114,1,2501,2542,-41,0,128,0,6
98115,1,2406,2465,-59,0,13,0,6
98116,1,2411,2525,-114,0,19,0,6
98117,1,2423,2241,182,4,133,0,8
98118,2,2266,2447,-181,0,65,0,6
98119,1,2454,2363,91,0,113,0,6
98120,2,2628,2545,83,0,270,1,6
98121,1,2263,2432,-169,0,130,0,6
98122,2,2348,2455,-107,0,67,0,6
98123,1,2514,2323,191,0,127,0,6
98124,1,2543,2356,187,0,115,0,6
98125,1,2504,2506,-2,0,218,0,6
98126,3,2556,2398,158,0,40,0,6
98127,2,2613,2676,-63,0,142,0,6
98128,3,2496,2508,-12,0,300,0,6
98129,2,2412,2345,67,0,200,0,6
98130,3,2398,2468,-70,0,201,0,6
98131,2,2600,2524,76,0,215,1,6
98132,2,2396,2412,-16,0,4,1,6
98133,2,2417,2439,-22,0,17,0,6
98134,2,2344,2456,-112,0,200,0,7
98135,1,2444,2458,-14,0,130,0,6
98136,1,2239,2417,-178,0,341,1,6
98137,2,2495,2471,24,0,332,0,6
98138,2,2526,2463,63,0,109,1,6
98139,2,2461,2466,-5,0,310,0,6
98140,1,2498,2359,139,0,0,1,6
98141,2,2329,2400,-71,0,355,1,6
98142,1,2545,2376,169,0,455,0,6
98143,2,2336,2448,-112,0,16,0,6
98144,1,2403,2500,-97,0,40,0,6
98145,1,2434,2439,-5,0,100,0,6
98146,1,2509,2333,176,0,58,0,6
98147,1,2403,2431,-28,0,301,0,6
98148,2,2284,2460,-176,0,1,0,6
98149,1,2237,2411,-174,0,245,0,6
98150,2,2570,2563,7,0,10,0,6
98151,1,2460,2425,35,0,9,0,6
98152,2,2483,2402,81,0,302,1,6
98153,1,2370,2441,-71,0,400,0,6
98154,1,2437,2491,-54,0,310,0,6
98155,1,2424,2270,154,0,114,0,6
98156,2,2318,2401,-83,0,200,0,6
98157,1,2432,2542,-110,0,29,0,6
98158,2,2496,2441,55,0,49,1,6
98159,1,2522,2532,-10,0,22,0,6
98160,1,2335,2455,-120,0,195,0,6
98161,1,2385,2517,-132,0,132,0,6
98162,2,2309,2432,-123,0,250,1,6
98163,1,2432,2345,87,0,50,1,6
98164,2,2554,2448,106,0,45,0,6
98165,1,2601,2502,99,0,101,1,6
98166,2,2308,2411,-103,0,344,0,3
98167,2,2458,2397,61,0,111,1,6
98168,2,2536,2532,4,0,102,0,6
98169,1,2458,2447,11,0,14,0,6
98170,1,2437,2242,195,0,302,0,8
98171,1,2422,2338,84,0,4,0,6
98172,2,2554,2275,279,0,40,0,6
98173,2,2424,2240,184,0,205,0,6
98174,1,2567,2460,107,0,338,0,6
98175,2,2480,2297,183,0,1,0,6
98176,2,2491,2525,-34,0,141,0,6
98177,1,2409,2254,155,0,106,0,6
98178,3,2439,2317,122,4,151,0,13
98179,1,2465,2509,-44,0,46,0,6
98180,2,2220,2546,-326,0,121,0,6
98181,1,2444,2464,-20,0,35,1,6
98182,1,2432,2572,-140,0,3,0,6
98183,2,2405,2450,-45,0,122,0,6
98184,1,2589,2603,-14,0,250,0,6
98185,2,2452,2452,0,0,133,1,6
98186,2,2500,2564,-64,0,444,1,6
98187,2,2238,2426,-188,4,144,0,8
98188,2,2569,2580,-11,0,110,0,6
98189,2,2420,2512,-92,0,15,0,6
98190,1,2496,2434,62,0,45,0,6
98191,1,2443,2552,-109,0,381,0,6
98192,1,2527,2528,-1,0,0,1,6
98193,1,2432,2469,-37,0,301,0,6
98194,2,2426,2285,141,0,45,0,6
98195,2,2284,2440,-156,0,107,1,6
98196,2,2390,2544,-154,0,318,1,6
98197,2,2433,2349,84,0,337,0,6
98198,1,2463,2387,76,0,135,0,6
98199,2,2394,2458,-64,0,319,0,6
98200,1,2442,2508,-66,0,307,0,6
98201,2,2517,2419,98,0,58,0,6
98202,1,2681,2608,73,0,460,0,6
98203,2,2333,2417,-84,0,3,0,6
98204,1,2412,2285,127,0,374,0,6
98205,3,2450,2263,187,0,202,0,6
98206,1,2319,2548,-229,0,210,0,6
98207,2,2477,2489,-12,0,125,0,6
98208,3,2531,2467,64,0,200,0,6
98209,1,2512,2347,165,0,1,0,8
98210,2,2511,2557,-46,0,202,0,6
98211,1,2418,2399,19,0,43,0,6
98212,2,2496,2395,101,0,200,0,6
98213,1,2470,2472,-2,0,343,0,6
98214,1,2477,2356,121,0,115,0,6
98215,1,2425,2464,-39,0,205,0,6
98216,1,2403,2245,158,0,101,0,6
98217,2,2306,2493,-187,0,211,0,6
98218,2,2350,2411,-61,0,302,0,6
98219,1,2404,2426,-22,0,247,0,6
98220,1,2564,2605,-41,0,7,0,6
98221,2,2322,2455,-133,0,300,0,6
98222,1,2456,2400,56,0,200,1,6
98223,2,2421,2467,-46,0,109,1,6
98224,2,2237,2413,-176,0,4,0,6
98225,1,2463,2359,104,0,409,0,6
98226,1,2604,2685,-81,0,140,1,6
98227,1,2686,2593,93,0,120,1,6
98228,2,2446,2289,157,0,45,0,6
98229,1,2488,2389,99,0,267,0,6
98230,2,2341,2436,-95,0,25,0,6
98231,1,2476,2423,53,0,470,0,6
98232,2,2331,2480,-149,0,112,1,8
98233,1,2444,2426,18,0,115,0,6
98234,1,2356,2402,-46,0,40,0,6
98235,1,2393,2436,-43,0,246,0,6
98236,2,2249,2415,-166,0,144,0,6
98237,2,2424,2271,153,0,39,1,6
98238,2,2390,2440,-50,0,211,0,6
98239,3,2440,2336,104,0,73,0,6
98240,1,2561,2500,61,0,335,0,6
98241,1,2455,2328,127,0,123,0,6
98242,3,2539,2547,-8,0,300,0,6
98243,1,2513,2409,104,0,105,1,6
98244,1,2420,2410,10,0,150,0,6
98245,1,2352,2451,-99,0,300,1,6
98246,3,2530,2486,44,0,0,0,6
98247,2,2404,2268,136,0,22,0,6
98248,2,2544,2595,-51,0,312,0,6
98249,1,2501,2438,63,0,45,0,6
98250,2,2597,2563,34,0,40,0,6
98251,2,2338,2530,-192,0,300,0,6
98252,2,2264,2456,-192,0,6,0,6
98253,1,2472,2355,117,0,46,1,6
98254,1,2531,2405,126,0,202,0,6
98255,2,2390,2430,-40,0,20,1,6
98256,2,2623,2586,37,0,303,1,6
98257,2,2451,2546,-95,0,351,0,6
98258,2,2361,2471,-110,0,40,1,6
98259,2,2378,2481,-103,0,210,0,6
98260,1,2548,2375,173,0,135,1,6
98261,1,2419,2245,174,0,453,0,6
98262,1,2502,2479,23,0,211,0,6
98263,1,2538,2605,-67,0,140,0,6
98264,2,2405,2448,-43,0,110,0,6
98265,1,2503,2415,88,0,130,1,6
98266,2,2314,2467,-153,0,123,0,6
98267,2,2420,2450,-30,0,45,1,6
98268,2,2458,2411,47,0,85,1,6
98269,2,2383,2526,-143,0,107,0,6
98270,1,2754,2569,185,0,414,1,6
98271,1,2420,2214,206,0,4,0,6
98272,1,2548,2449,99,0,43,1,6
98273,1,2324,2403,-79,0,56,1,6
98274,1,2405,2397,8,0,152,0,6
98275,1,2381,2471,-90,0,153,1,6
98276,1,2347,2459,-112,0,201,0,6
98277,3,2415,2304,111,0,190,0,3
98279,2,2563,2431,132,0,120,0,6
98280,2,2468,2430,38,0,80,1,6
98281,2,2458,2463,-5,0,106,0,6
98282,3,2530,2476,54,0,103,0,6
98283,3,2430,2402,28,0,261,0,6
98284,1,2467,2490,-23,0,331,0,6
98285,2,2447,2378,69,0,245,0,6
98286,1,2406,2337,69,0,107,0,6
98287,1,2250,2421,-171,0,414,1,6
98288,2,2500,2514,-14,0,50,0,6
98289,1,2402,2386,16,0,394,1,6
98290,2,2318,2462,-144,0,301,1,6
98291,2,2436,2395,41,0,0,0,6
98292,2,2338,2439,-101,0,25,0,6
98293,2,2410,2324,86,0,462,0,6
98294,2,2416,2234,182,0,386,1,6
98295,2,2392,2570,-178,0,106,0,6
98296,1,2492,2506,-14,0,122,0,6
98297,2,2413,2481,-68,0,37,0,6
98298,1,2546,2332,214,0,43,0,6
98299,1,2254,2425,-171,0,7,0,8
98300,2,2349,2539,-190,0,210,0,6
98301,1,2419,2395,24,0,466,0,6
98302,1,2384,2555,-171,0,43,0,6
98303,3,2246,2416,-170,0,250,0,6
98304,2,2516,2356,160,0,466,0,6
98305,2,2319,2528,-209,0,200,0,8
98306,1,2539,2439,100,0,58,0,6
98307,1,2348,2469,-121,0,200,1,6
98308,3,2423,2365,58,0,6,0,6
98310,2,2400,2315,85,0,245,0,6
98311,1,2516,2341,175,0,46,0,6
98312,1,2492,2395,97,0,49,1,6
98313,2,2405,2426,-21,0,110,0,6
98314,2,2380,2447,-67,0,49,1,6
98315,2,2358,2411,-53,0,135,0,6
98316,2,2323,2507,-184,0,132,0,6
98317,2,2444,2385,59,0,150,0,6
98318,3,2405,2517,-112,0,36,0,6
98319,1,2435,2374,61,0,122,0,6
98320,2,2487,2529,-42,0,100,0,6
98321,2,2507,2447,60,0,301,1,6
98322,2,2552,2530,22,0,4,1,6
98323,2,2389,2476,-87,0,128,0,6
98326,2,2417,2260,157,0,241,0,8
98327,2,2402,2312,90,0,203,0,6
98328,2,2592,2616,-24,0,40,0,6
98329,2,2470,2388,82,0,466,0,6
98330,1,2471,2551,-80,0,195,0,6
98331,2,2292,2413,-121,0,107,1,6
98332,1,2440,2537,-97,0,140,0,6
98333,1,2384,2453,-69,0,252,0,6
98334,2,2229,2610,-381,0,249,0,8
98335,2,2445,2452,-7,0,213,0,6
98336,1,2455,2446,9,0,462,1,6
98337,2,2426,2510,-84,0,240,1,6
98338,1,2452,2210,242,0,100,0,6
98339,1,2510,2355,155,0,150,0,6
98340,2,2451,2400,51,0,227,1,6
98341,2,2566,2598,-32,0,15,0,6
98342,1,2496,2352,144,0,305,1,6
98343,2,2415,2285,130,0,13,0,6
98345,1,2497,2321,176,0,109,0,6
98346,1,2298,2430,-132,0,40,0,6
98347,2,2216,2519,-303,0,201,0,6
98348,2,2461,2462,-1,0,243,1,6
98349,1,2458,2307,151,0,15,0,6
98350,1,2547,2351,196,0,3,0,6
98351,1,2475,2357,118,0,111,0,6
98352,2,2319,2448,-129,4,45,1,13
98353,2,2436,2477,-41,0,145,1,6
98354,1,2462,2473,-11,0,300,0,6
98355,1,2549,2422,127,0,45,0,6
98356,1,2350,2529,-179,0,216,0,6
98357,1,2573,2476,97,0,107,0,6
98358,2,2385,2498,-113,0,264,0,6
98359,2,2280,2416,-136,0,128,0,6
98360,1,2325,2427,-102,0,0,0,6
98361,1,2401,2236,165,4,152,0,13
98362,2,2439,2328,111,0,330,1,8
98364,2,2589,2500,89,0,123,0,6
98365,1,2443,2334,109,0,150,0,6
98366,1,2407,2287,120,0,40,0,6
98367,3,2454,2381,73,0,40,0,6
98368,1,2422,2353,69,0,0,0,6
98369,1,2550,2247,303,0,121,0,6
98370,1,2413,2350,63,0,413,1,6
98371,1,2253,2408,-155,0,250,0,6
98372,1,2235,2451,-216,4,101,0,8
98373,2,2283,2400,-117,0,118,1,6
98374,1,2243,2408,-165,0,4,0,6
98375,2,2544,2514,30,0,2,0,6
98376,2,2486,2544,-58,0,400,0,6
98377,1,2479,2263,216,0,6,0,7
98378,1,2463,2545,-82,0,120,0,6
98379,1,2419,2420,-1,0,300,0,6
98380,1,2338,2542,-204,0,210,0,6
98381,2,2440,2617,-177,0,2,0,6
98382,2,2330,2447,-117,0,25,0,6
98383,3,2417,2437,-20,0,10,0,6
98384,2,2437,2319,118,0,300,0,6
98385,3,2306,2414,-108,0,289,0,3
98386,1,2603,2544,59,0,108,0,6
98387,1,2435,2400,35,0,152,0,6
98388,2,2534,2482,52,0,6,1,6
98390,1,2406,2505,-99,0,10,0,6
98391,2,2587,2552,35,0,310,0,6
98392,2,2409,2408,1,0,8,0,6
98393,2,2353,2403,-50,0,250,0,6
98394,1,2500,2386,114,0,301,0,6
98395,3,2439,2553,-114,0,101,0,6
98396,2,2457,2418,39,0,123,0,6
98397,1,2406,2431,-25,0,102,0,6
98398,2,2453,2531,-78,0,332,0,6
98399,1,2394,2508,-114,0,380,0,6
98400,2,2294,2407,-113,0,101,0,6
98401,1,2221,2411,-190,0,125,1,6
98402,1,2409,2390,19,0,101,0,6
98403,1,2461,2504,-43,0,25,0,6
98404,1,2467,2468,-1,0,345,1,6
98405,1,2577,2495,82,0,200,0,6
98406,2,2360,2520,-160,0,305,0,6
98407,1,2472,2500,-28,0,46,0,6
98408,1,2468,2455,13,0,15,1,6
98409,1,2521,2569,-48,0,110,0,6
98410,1,2391,2426,-35,0,103,0,6
98411,1,2485,2349,136,0,122,0,6
98412,2,2440,2427,13,0,200,0,6
98413,1,2562,2370,192,0,310,0,6
98414,1,2488,2507,-19,0,140,0,6
98415,1,2431,2386,45,0,145,1,6
98416,2,2489,2526,-37,0,40,0,6
98417,2,2532,2621,-89,0,300,0,6
98418,2,2201,2523,-322,0,45,1,6
98419,3,2611,2317,294,0,392,0,8
98420,1,2399,2448,-49,0,190,0,6
98421,1,2551,2361,190,0,45,1,6
98422,1,2534,2365,169,0,404,0,6
98423,1,2312,2414,-102,0,202,1,6
98424,1,2538,2489,49,0,455,1,6
98425,2,2425,2256,169,0,4,0,6
98426,2,2400,2251,149,0,101,1,6
98427,1,2515,2422,93,0,58,0,6
98428,2,2345,2481,-136,0,31,0,6
98429,1,2549,2321,228,0,90,0,6
98430,1,2451,2368,83,0,123,1,6
98431,3,2312,2440,-128,0,66,0,6
98432,2,2404,2335,69,0,101,0,6
98433,2,2451,2326,125,0,201,1,6
98434,1,2452,2355,97,4,200,0,13
98435,1,2481,2374,107,0,321,1,6
98436,1,2353,2445,-92,0,201,0,6
98437,2,2536,2581,-45,0,106,0,6
98438,1,2408,2348,60,0,200,0,6
98439,2,2561,2581,-20,0,136,0,6
98440,3,2532,2370,162,0,106,0,8
98441,1,2457,2298,159,0,112,0,6
98442,2,2437,2318,119,0,100,1,6
98443,1,2420,2276,144,0,39,1,6
98444,1,2497,2538,-41,0,302,0,6
98445,1,2498,2414,84,0,103,0,6
98446,1,2453,2449,4,0,121,0,6
98447,1,2434,2414,20,0,0,0,6
98448,1,2411,2290,121,0,200,0,6
98449,1,2369,2462,-93,0,200,0,6
98450,1,2500,2362,138,0,301,0,6
98451,2,2286,2537,-251,0,210,0,6
98452,2,2403,2478,-75,0,476,1,6
98453,1,2420,2398,22,0,64,0,6
98454,2,2562,2437,125,0,4,1,6
98455,2,2415,2498,-83,0,45,0,6
98456,1,2359,2551,-192,0,300,0,6
98457,2,2405,2446,-41,0,270,1,8
98458,2,2488,2528,-40,0,141,0,6
98459,1,2340,2417,-77,0,110,0,6
98460,1,2566,2501,65,0,53,0,6
98461,2,2385,2415,-30,0,247,0,6
98462,3,2499,2452,47,0,106,0,6
98463,2,2443,2467,-24,0,58,0,6
98464,1,2491,2531,-40,0,332,0,6
98465,2,2402,2322,80,0,484,0,6
98466,1,2327,2430,-103,0,101,0,6
98467,1,2383,2405,-22,0,432,0,6
98468,2,2352,2473,-121,0,310,0,6
98469,1,2462,2355,107,0,70,0,6
98470,2,2353,2503,-150,0,211,0,6
98471,1,2586,2382,204,0,200,0,6
98472,2,2337,2409,-72,0,100,1,6
98473,1,2608,2528,80,0,45,0,6
98474,2,2341,2421,-80,0,122,1,6
98475,1,2234,2427,-193,0,40,0,8
98476,2,2417,2519,-102,0,208,1,6
98477,1,2458,2478,-20,0,109,1,6
98478,2,2471,2528,-57,0,201,0,6
98479,2,2526,2554,-28,0,110,0,6
98480,1,2436,2256,180,0,211,1,6
98481,1,2422,2395,27,0,353,1,6
98483,2,2434,2449,-15,0,338,1,6
98484,2,2408,2206,202,0,250,0,6
98485,1,2297,2517,-220,0,40,1,8
98486,1,2418,2497,-79,0,22,0,6
98487,1,2380,2415,-35,0,125,0,6
98488,1,2485,2350,135,0,411,0,6
98489,2,2586,2554,32,0,302,1,6
98490,2,2497,2529,-32,0,300,0,6
98491,1,2543,2566,-23,0,45,0,6
98492,2,2300,2706,-406,0,101,0,8
98493,1,2431,2341,90,0,335,1,6
98494,2,2499,2589,-90,0,40,1,6
98495,1,2625,2495,130,0,202,0,6
98496,1,2522,2353,169,0,39,0,6
98497,2,2413,2438,-25,0,101,1,6
98498,2,2343,2412,-69,0,123,0,6
98499,2,2334,2443,-109,0,21,0,6
98500,2,2267,2414,-147,0,405,1,6
98501,3,2457,2247,210,0,106,0,6
98502,2,2351,2447,-96,2,112,0,18
98503,1,2282,2431,-149,0,31,0,6
98504,1,2455,2400,55,0,151,0,6
98505,2,2361,2485,-124,0,46,0,6
98506,2,2409,2502,-93,0,11,1,6
98507,1,2543,2438,105,0,4,1,6
98508,1,2429,2409,20,0,107,0,6
98509,2,2438,2501,-63,0,25,0,6
98510,2,2410,2540,-130,0,6,0,6
98511,2,2466,2457,9,0,380,1,6
98512,2,2532,2403,129,0,224,1,6
98513,1,2419,2322,97,0,463,0,5
98514,2,2453,2498,-45,0,405,1,6
98515,2,2328,2443,-115,0,107,0,6
98516,1,2328,2405,-77,0,0,0,6
98517,1,2426,2440,-14,0,395,0,6
98518,2,2409,2473,-64,0,15,0,6
98519,2,2380,2403,-23,0,142,0,6
98520,2,2533,2483,50,0,9,1,6
98521,1,2555,2466,89,0,5,0,6
98522,1,2560,2328,232,0,40,0,6
98523,1,2305,2483,-178,0,48,0,6
98524,1,2533,2441,92,0,153,0,6
98525,2,2331,2403,-72,0,331,0,6
98526,2,2502,2380,122,0,301,0,6
98527,1,2504,2614,-110,0,40,0,6
98528,2,2371,2477,-106,0,130,0,6
98529,2,2216,2549,-333,0,101,0,6
98530,2,2273,2423,-150,0,102,0,6
98531,1,2412,2308,104,0,343,1,3
98532,1,2491,2322,169,0,382,0,6
98533,1,2417,2339,78,0,202,1,6
98534,1,2536,2491,45,0,55,0,6
98536,1,2217,2439,-222,0,13,1,6
98537,1,2425,2404,21,0,244,0,6
98538,2,2472,2524,-52,0,327,0,6
98539,1,2420,2289,131,0,455,0,6
98540,2,2478,2476,2,0,20,0,6
98541,1,2395,2460,-65,0,45,0,6
98542,3,2447,2330,117,0,150,0,6
98543,2,2524,2571,-47,0,107,0,6
98544,3,2454,2521,-67,0,123,0,6
98546,2,2408,2425,-17,0,16,0,6
98547,3,2346,2489,-143,0,57,0,6
98548,2,2417,2355,62,0,381,0,6
98549,1,2421,2265,156,0,8,0,6
98550,1,2390,2439,-49,0,245,1,6
98551,1,2594,2497,97,0,110,0,6
98552,1,2406,2244,162,0,49,0,6
98553,2,2562,2580,-18,0,112,0,6
98554,2,2408,2416,-8,0,302,1,6
98556,1,2358,2455,-97,0,46,0,6
98557,2,2418,2432,-14,0,107,0,6
98558,1,2320,2429,-109,0,46,0,6
98559,1,2329,2503,-174,0,245,0,6
98560,1,2452,2402,50,0,112,0,6
98561,1,2357,2404,-47,0,121,0,6
98562,1,2707,2268,439,0,106,0,8
98563,2,2319,2494,-175,0,15,1,6
98564,2,2337,2411,-74,0,404,0,6
98565,1,2451,2277,174,0,249,0,8
98566,3,2427,2337,90,0,373,0,6
98567,1,2629,2445,184,0,203,0,6
98568,2,2444,2366,78,0,1,0,6
98569,3,2301,2406,-105,4,211,0,13
98570,1,2400,2407,-7,0,43,0,6
98571,2,2507,2405,102,0,105,0,6
98572,2,2508,2347,161,0,1,0,8
98573,2,2372,2403,-31,0,162,0,6
98574,2,2411,2338,73,0,120,0,6
98575,2,2249,2414,-165,0,81,1,6
98576,2,2321,2483,-162,0,312,1,6
98577,2,2529,2491,38,0,121,0,6
98578,1,2493,2468,25,0,8,1,6
98579,2,2447,2343,104,0,127,0,6
98580,2,2400,2421,-21,0,46,0,6
98581,2,2408,2374,34,0,101,1,6
98582,2,2701,2523,178,0,440,0,6
98583,3,2598,2460,138,0,200,0,6
98584,1,2384,2457,-73,0,57,0,6
98585,1,2543,2253,290,0,86,0,6
98586,1,2495,2525,-30,0,21,0,6
98587,1,2635,2559,76,0,320,0,6
98588,2,2397,2446,-49,0,102,1,6
98589,2,2507,2525,-18,0,115,0,6
98590,3,2310,2530,-220,0,48,0,8
98591,1,2334,2422,-88,0,113,0,6
98592,1,2434,2495,-61,0,54,0,6
98593,1,2401,2339,62,0,111,0,6
98594,1,2576,2519,57,0,441,0,6
98595,1,2410,2351,59,0,46,0,6
98596,2,2474,2208,266,0,218,0,6
98597,2,2539,2618,-79,0,121,0,6
98598,2,2490,2527,-37,0,245,0,6
98599,2,2355,2472,-117,0,200,0,6
98600,1,2453,2402,51,0,128,1,6
98601,1,2606,2511,95,0,113,1,6
98603,1,2462,2636,-174,0,220,0,6
98604,1,2431,2384,47,0,190,0,6
98605,1,2376,2558,-182,0,302,0,6
98606,1,2416,2275,141,0,320,1,6
98607,1,2455,2414,41,0,123,0,6
98608,1,2487,2362,125,0,45,0,6
98609,2,2367,2437,-70,0,101,0,6
98610,2,2427,2444,-17,0,300,0,6
98611,1,2493,2328,165,0,13,0,6
98612,1,2427,2269,158,0,157,0,6
98613,1,2406,2413,-7,0,40,0,6
98614,2,2519,2396,123,0,150,0,6
98615,2,2314,2490,-176,0,320,0,6
98616,2,2448,2547,-99,0,101,0,6
98617,1,2387,2401,-14,0,4,0,6
98618,3,2456,2345,111,4,102,0,13
98619,2,2437,2430,7,0,58,0,6
98620,1,2486,2333,153,0,15,0,6
98621,3,2433,2353,80,0,101,0,6
98622,2,2364,2416,-52,0,414,0,6
98623,1,2637,2536,101,0,54,0,6
98625,2,2511,2465,46,0,140,0,6
98626,1,2404,2378,26,0,4,0,6
98627,2,2402,2309,93,0,302,1,6
98628,2,2422,2402,20,0,43,1,6
98629,2,2375,2496,-121,0,277,1,6
98630,2,2641,2611,30,0,381,0,6
98631,2,2389,2458,-69,0,15,0,6
98632,1,2530,2411,119,0,101,1,6
98633,2,2532,2485,47,0,190,0,6
98634,2,2367,2545,-178,0,305,0,6
98635,2,2383,2708,-325,0,106,0,8
98636,2,2439,2341,98,0,132,0,6
98637,3,2413,2499,-86,0,11,0,6
98638,1,2476,2498,-22,0,21,0,6
98639,2,2430,2533,-103,0,6,0,6
98640,1,2319,2565,-246,0,46,0,6
98641,2,2421,2463,-42,0,204,0,6
98642,2,2403,2481,-78,0,7,0,6
98643,1,2462,2490,-28,0,46,0,6
98644,3,2451,2523,-72,0,128,0,6
98645,1,2383,2551,-168,0,302,0,6
98646,3,2358,2519,-161,0,215,0,6
98647,1,2414,2342,72,0,127,0,6
98648,1,2628,2514,114,0,414,0,6
98649,2,2427,2400,27,0,380,1,6
98650,1,2454,2320,134,0,140,1,8
98651,2,2498,2490,8,0,179,0,6
98652,2,2340,2410,-70,0,115,0,6
98653,2,2353,2509,-156,0,201,0,6
98654,2,2392,2624,-232,0,474,1,6
98655,2,2398,2488,-90,0,101,1,6
98656,2,2497,2505,-8,0,263,0,6
98657,1,2471,2249,222,0,143,1,6
98658,1,2493,2505,-12,0,330,1,6
98659,1,2417,2332,85,0,1,0,6
98660,3,2331,2403,-72,0,0,0,6
98661,1,2407,2329,78,0,1,0,6
98662,2,2471,2449,22,0,414,0,6
98663,1,2412,2463,-51,0,45,0,6
98664,1,2422,2375,47,0,300,0,6
98665,2,2403,2380,23,0,245,0,6
98666,1,2414,2252,162,0,346,0,6
98667,1,2496,2371,125,0,40,1,6
98668,1,2421,2245,176,0,113,0,6
98669,2,2557,2470,87,0,247,0,6
98670,1,2556,2585,-29,0,136,0,6
98671,1,2420,2272,148,0,320,1,6
98672,1,2337,2419,-82,0,102,0,6
98673,1,2548,2432,116,0,43,0,6
98674,2,2359,2441,-82,0,65,1,6
98675,2,2337,2494,-157,0,245,0,6
98676,1,2431,2447,-16,0,466,0,6
98677,1,2463,2342,121,0,263,0,6
98678,1,2449,2349,100,0,11,0,6
98679,2,2247,2556,-309,0,88,0,6
98680,2,2485,2460,25,0,302,0,6
98681,2,2337,2432,-95,0,80,1,6
98682,2,2548,2492,56,0,463,0,6
98683,1,2355,2477,-122,0,112,0,6
98684,1,2428,2273,155,0,264,0,8
98685,2,2384,2534,-150,0,49,0,6
98686,1,2527,2357,170,0,140,0,8
98687,1,2408,2395,13,0,4,0,6
98688,1,2491,2525,-34,0,245,1,6
98689,1,2416,2387,29,0,101,0,6
98690,2,2589,2632,-43,0,21,1,6
98691,2,2348,2468,-120,0,200,0,6
98692,1,2444,2334,110,0,150,1,6
98693,3,2464,2444,20,0,205,0,6
98694,1,2423,2337,86,0,162,0,5
98695,2,2516,2370,146,0,133,1,6
98696,3,2360,2429,-69,0,215,0,6
98697,1,2484,2318,166,0,45,0,6
98698,1,2522,2469,53,0,102,1,6
98699,1,2508,2507,1,0,101,1,6
98700,1,2698,2661,37,0,190,1,6
98701,2,2384,2498,-114,0,200,0,6
98702,2,2414,2482,-68,0,15,1,6
98703,1,2557,2543,14,0,310,0,6
98705,2,2325,2402,-77,0,454,0,6
98706,2,2410,2425,-15,0,49,1,6
98707,1,2499,2230,269,0,46,0,6
98708,1,2404,2422,-18,0,301,0,6
98709,2,2511,2611,-100,0,301,1,6
98710,2,2370,2427,-57,0,470,1,6
98711,1,2483,2253,230,0,6,0,7
98712,1,2462,2288,174,0,106,0,6
98713,1,2579,2563,16,0,125,0,6
98714,1,2510,2532,-22,0,0,0,6
98715,1,2434,2421,13,0,80,0,6
98716,2,2462,2487,-25,0,462,0,6
98717,1,2500,2371,129,0,107,0,6
98718,1,2499,2328,171,0,200,0,6
98719,1,2390,2474,-84,0,48,0,6
98720,2,2426,2479,-53,0,30,0,6
98721,1,2510,2479,31,0,311,0,6
98722,1,2406,2382,24,0,101,1,6
98723,2,2421,2539,-118,0,1,0,6
98724,1,2477,2550,-73,0,120,0,6
98725,2,2358,2501,-143,0,4,1,6
98726,1,2594,2603,-9,0,132,1,6
98727,3,2392,2453,-61,0,20,0,6
98728,1,2436,2466,-30,0,19,1,6
98729,1,2387,2401,-14,0,176,0,6
98730,2,2424,2381,43,0,16,1,6
98731,1,2412,2344,68,0,200,0,6
98732,1,2505,2501,4,0,140,1,6
98734,2,2502,2350,152,0,127,0,6
98735,3,2242,2563,-321,0,216,0,6
98736,2,2537,2417,120,0,454,0,6
98737,2,2338,2467,-129,0,344,1,6
98738,2,2414,2422,-8,0,131,0,6
98739,1,2455,2305,150,4,240,0,13
98740,1,2295,2458,-163,0,143,0,6
98741,2,2341,2428,-87,0,106,0,6
98742,1,2384,2552,-168,0,327,0,6
98744,1,2502,2325,177,0,115,1,6
98745,1,2465,2493,-28,0,100,0,6
98746,2,2446,2367,79,0,1,1,6
98747,2,2248,2710,-462,0,0,0,8
98748,1,2685,2618,67,0,35,0,6
98749,1,2291,2522,-231,4,202,0,13
98750,1,2471,2252,219,4,480,0,13
98751,1,2402,2332,70,0,103,1,6
98752,1,2462,2408,54,0,106,1,6
98753,1,2505,2627,-122,0,50,0,6
98754,1,2436,2337,99,0,141,1,6
98755,2,2498,2386,112,0,211,0,6
98756,1,2413,2247,166,0,0,0,8
98757,2,2335,2415,-80,0,102,0,6
98758,3,2400,2458,-58,0,241,0,8
98759,3,2330,2448,-118,0,21,0,6
98760,2,2472,2499,-27,0,484,1,6
98761,1,2519,2498,21,0,125,1,6
98762,2,2333,2416,-83,0,0,0,6
98763,2,2320,2405,-85,0,125,0,6
98764,1,2406,2428,-22,0,204,0,6
98765,2,2358,2530,-172,0,101,0,6
98766,2,2425,2494,-69,0,130,0,6
98767,1,2444,2513,-69,0,200,1,6
98768,2,2571,2593,-22,0,128,1,6
98769,1,2560,2527,33,0,128,0,6
98770,2,2464,2495,-31,0,49,1,6
98771,3,2487,2361,126,0,15,0,6
98772,1,2417,2372,45,0,106,0,6
98773,2,2409,2469,-60,0,20,0,6
98774,1,2404,2227,177,0,241,1,6
98775,1,2526,2492,34,0,45,1,6
98776,1,2531,2609,-78,0,236,0,8
98777,1,2431,2388,43,0,4,0,6
98778,2,2687,2655,32,0,194,1,6
98779,2,2432,2307,125,0,213,0,8
98780,2,2557,2585,-28,0,136,0,6
98781,1,2493,2350,143,0,40,0,6
98782,3,2444,2442,2,0,190,0,6
98783,1,2433,2224,209,0,217,0,6
98784,1,2340,2417,-77,0,101,0,6
98785,1,2519,2340,179,0,42,0,6
98786,1,2432,2355,77,0,43,1,6
98787,2,2268,2408,-140,0,227,0,8
98788,3,2421,2280,141,0,4,0,6
98789,1,2499,2365,134,0,150,0,6
98790,1,2428,2405,23,0,466,1,6
98791,3,2452,2393,59,0,138,0,6
98792,2,2328,2467,-139,0,48,1,6
98793,1,2504,2355,149,0,43,0,6
98794,1,2486,2471,15,0,301,1,6
98795,2,2637,2597,40,0,101,0,6
98796,1,2460,2380,80,0,40,0,6
98797,1,2533,2263,270,0,40,0,6
98798,1,2508,2413,95,0,143,0,6
98799,2,2376,2543,-167,0,106,0,6
98800,1,2544,2548,-4,0,310,0,6
98801,2,2387,2505,-118,0,40,0,6
98802,1,2460,2419,41,0,103,0,6
98803,1,2420,2331,89,0,8,0,6
98804,2,2502,2526,-24,0,49,1,6
98805,1,2370,2420,-50,0,245,0,6
98806,1,2376,2560,-184,0,200,0,6
98807,1,2419,2438,-19,0,453,0,6
98808,2,2367,2484,-117,0,200,0,6
98809,1,2440,2341,99,0,122,1,6
98810,2,2239,2435,-196,0,108,1,6
98811,2,2302,2517,-215,0,49,1,6
98812,1,2367,2522,-155,0,109,0,6
98813,2,2389,2434,-45,0,302,1,6
98814,1,2268,2486,-218,0,101,1,7
98815,3,2379,2535,-156,0,311,0,6
98816,1,2403,2410,-7,0,107,0,6
98817,2,2522,2346,176,0,110,1,6
98818,2,2613,2601,12,0,267,0,6
98820,1,2402,2257,145,0,213,0,6
98821,2,2423,2356,67,0,46,0,6
98822,1,2405,2333,72,4,45,0,13
98823,2,2442,2305,137,0,14,0,6
98824,2,2478,2405,73,0,40,1,6
98825,2,2483,2344,139,4,229,0,13
98826,1,2422,2412,10,0,468,0,6
98827,1,2279,2458,-179,4,42,1,13
98828,2,2466,2459,7,0,57,0,6
98829,2,2309,2425,-116,0,150,0,6
98830,2,2404,2396,8,0,48,1,6
98831,1,2544,2363,181,0,106,0,6
98832,2,2662,2681,-19,0,195,0,6
98833,1,2427,2346,81,0,81,1,6
98834,2,2409,2374,35,0,246,1,6
98835,3,2341,2451,-110,0,46,0,6
98836,1,2506,2503,3,0,211,0,6
98837,1,2615,2516,99,0,104,0,6
98838,2,2442,2615,-173,0,3,0,6
98839,1,2265,2420,-155,0,140,0,8
98840,1,2492,2525,-33,0,141,1,6
98841,1,2446,2332,114,0,50,1,6
98842,1,2443,2485,-42,0,460,0,6
98843,2,2410,2347,63,0,127,0,6
98844,1,2327,2508,-181,0,395,0,6
98845,3,2327,2406,-79,0,107,0,6
98846,1,2453,2500,-47,0,46,1,6
98847,2,2387,2513,-126,0,215,1,6
98848,2,2424,2401,23,0,15,0,6
98849,2,2233,2417,-184,0,100,0,6
98850,2,2590,2551,39,0,125,0,6
98851,1,2350,2509,-159,0,40,0,6
98852,1,2531,2504,27,0,45,0,6
98853,1,2422,2255,167,0,46,1,6
98854,2,2604,2526,78,0,245,0,6
98855,2,2438,2357,81,0,138,0,6
98856,1,2418,2316,102,0,19,1,6
98857,2,2414,2547,-133,0,106,0,6
98858,1,2422,2407,15,0,58,0,6
98859,2,2457,2353,104,0,36,0,6
98860,3,2643,2538,105,0,112,0,6
98861,3,2420,2513,-93,0,1,0,6
98862,2,2347,2514,-167,0,474,0,6
98863,1,2531,2414,117,0,102,0,6
98864,1,2471,2227,244,0,218,0,6
98865,1,2415,2325,90,0,123,1,6
98866,2,2618,2490,128,0,45,0,6
98867,1,2465,2416,49,0,103,0,6
98868,2,2321,2411,-90,0,102,1,6
98869,3,2438,2535,-97,0,250,0,6
98870,1,2686,2656,30,0,194,0,6
98871,1,2412,2424,-12,0,15,0,8
98872,2,2533,2550,-17,0,80,1,6
98873,1,2542,2241,301,0,300,0,6
98874,2,2492,2546,-54,0,301,0,6
98875,2,2359,2548,-189,0,240,0,6
98876,1,2451,2360,91,0,108,0,6
98877,1,2512,2200,312,0,80,0,6
98878,1,2444,2287,157,0,106,0,6
98879,1,2513,2299,214,4,428,0,13
98880,1,2407,2427,-20,0,204,0,6
98881,1,2465,2466,-1,0,145,0,6
98882,2,2239,2431,-192,0,107,0,6
98883,3,2404,2450,-46,0,45,0,6
98884,1,2581,2619,-38,0,331,0,6
98885,2,2478,2377,101,0,11,0,6
98886,1,2425,2436,-11,0,190,1,6
98887,1,2438,2293,145,0,37,0,6
98888,3,2449,2336,113,0,116,0,6
98889,2,2439,2472,-33,0,123,1,6
98890,1,2495,2384,111,0,40,0,6
98891,2,2512,2534,-22,0,40,0,6
98892,1,2407,2418,-11,0,105,0,6
98893,1,2504,2338,166,0,133,0,6
98894,3,2349,2461,-112,0,1,0,6
98895,1,2412,2465,-53,0,20,0,6
98896,1,2434,2287,147,0,145,0,6
98897,2,2362,2602,-240,0,249,0,6
98898,1,2514,2359,155,0,121,1,6
98899,2,2410,2395,15,0,112,1,6
98900,1,2465,2477,-12,0,46,0,6
98901,3,2550,2438,112,0,210,0,6
98902,1,2585,2427,158,0,131,0,6
98904,3,2355,2466,-111,0,110,0,6
98905,1,2501,2429,72,0,132,0,6
98906,2,2541,2473,68,0,477,0,6
98907,3,2518,2447,71,0,156,0,6
98908,1,2448,2436,12,0,122,0,6
98909,2,2422,2420,2,0,241,0,6
98910,2,2328,2450,-122,0,10,0,6
98911,1,2292,2412,-120,0,300,1,8
98912,1,2631,2460,171,0,211,0,6
98913,1,2544,2396,148,0,45,1,6
98914,1,2471,2494,-23,0,110,1,6
98915,2,2376,2421,-45,0,4,0,6
98916,3,2597,2588,9,0,107,0,6
98917,1,2516,2384,132,0,223,1,6
98918,1,2518,2499,19,0,126,1,6
98919,1,2389,2419,-30,0,476,0,6
98920,1,2651,2692,-41,0,62,0,6
98921,1,2501,2441,60,0,463,0,6
98922,1,2498,2447,51,0,200,0,6
98923,1,2338,2432,-94,0,296,1,8
98924,1,2361,2449,-88,0,113,0,6
98925,3,2431,2505,-74,0,461,0,6
98926,1,2539,2422,117,0,140,1,6
98928,2,2558,2633,-75,0,140,0,6
98929,2,2499,2346,153,0,83,0,6
98930,1,2527,2438,89,0,43,0,6
98931,1,2555,2369,186,0,44,0,6
98932,1,2429,2305,124,0,242,0,6
98933,2,2499,2551,-52,0,7,0,6
98934,2,2323,2459,-136,0,445,0,6
98935,1,2415,2487,-72,0,307,0,6
98936,2,2247,2400,-153,0,0,0,6
98937,1,2345,2500,-155,0,46,0,6
98938,1,2323,2418,-95,0,142,0,8
98939,1,2410,2374,36,0,409,0,6
98940,1,2442,2368,74,0,30,0,6
98941,1,2421,2413,8,0,466,0,6
98942,1,2338,2447,-109,0,0,0,6
98943,1,2433,2336,97,0,266,0,6
98944,1,2480,2532,-52,0,101,0,6
98945,2,2496,2537,-41,0,411,1,6
98946,1,2587,2549,38,0,455,0,6
98947,1,2406,2283,123,0,210,0,6
98948,2,2412,2349,63,0,4,1,6
98949,1,2498,2423,75,0,101,0,6
98950,2,2409,2408,1,0,246,0,6
98951,1,2453,2418,35,0,40,0,6
98952,1,2426,2371,55,0,207,1,6
98953,2,2461,2474,-13,0,4,0,6
98954,2,2367,2552,-185,0,40,0,6
98955,2,2417,2386,31,0,1,0,6
98956,2,2372,2471,-99,0,301,0,6
98957,2,2349,2480,-131,0,190,0,6
98958,2,2434,2324,110,0,153,0,6
98959,2,2459,2340,119,0,380,0,6
98960,2,2431,2454,-23,0,40,1,6
98961,1,2457,2548,-91,0,49,0,6
98962,1,2471,2517,-46,0,123,1,6
98963,2,2355,2442,-87,0,347,1,6
98964,1,2440,2685,-245,0,3,0,6
98965,1,2356,2422,-66,0,100,0,6
98966,1,2512,2348,164,0,332,0,6
98967,2,2535,2413,122,0,474,0,6
98968,2,2267,2404,-137,0,226,0,6
98970,1,2510,2353,157,0,300,0,6
98971,2,2492,2558,-66,0,330,0,6
98972,2,2366,2438,-72,0,106,0,6
98973,1,2473,2393,80,0,492,0,6
98974,1,2516,2510,6,0,267,0,6
98975,1,2588,2416,172,0,28,0,6
98976,1,2426,2387,39,0,4,0,6
98977,2,2597,2618,-21,0,154,0,6
98978,2,2503,2243,260,0,111,0,6
98979,2,2364,2447,-83,0,113,0,6
98980,1,2406,2271,135,0,221,0,6
98981,2,2366,2548,-182,0,115,1,6
98982,1,2491,2439,52,0,45,0,6
98983,1,2488,2634,-146,0,320,0,6
98984,2,2257,2487,-230,0,180,0,6
98985,2,2310,2410,-100,0,4,1,6
98986,2,2525,2396,129,0,330,0,6
98987,1,2504,2477,27,0,242,0,6
98988,3,2556,2494,62,0,461,0,6
98989,1,2403,2243,160,0,100,1,6
98990,2,2327,2527,-200,0,46,1,6
98991,2,2421,2343,78,0,0,0,6
98992,2,2449,2405,44,0,245,0,6
98993,2,2659,2487,172,0,140,1,6
98994,1,2440,2349,91,0,277,0,6
98995,1,2418,2278,140,0,301,0,6
98996,1,2323,2494,-171,0,132,0,6
98997,2,2389,2402,-13,0,454,1,6
98998,2,2493,2524,-31,0,200,0,6
98999,3,2377,2405,-28,0,454,0,6
99000,2,2442,2229,213,0,193,1,6
99001,2,2480,2573,-93,0,300,0,6
99002,1,2367,2422,-55,0,57,0,6
99003,2,2380,2579,-199,0,130,1,6
99004,2,2475,2464,11,0,11,1,6
99005,1,2407,2427,-20,0,202,1,6
99006,2,2543,2540,3,0,0,0,6
99007,1,2350,2488,-138,0,305,0,6
99008,1,2397,2514,-117,0,401,1,6
99009,2,2563,2486,77,0,333,0,6
99010,2,2298,2478,-180,0,46,1,6
99011,2,2522,2323,199,0,10,0,6
99012,1,2451,2381,70,0,335,0,6
99013,2,2544,2676,-132,0,190,0,6
99014,2,2282,2421,-139,0,156,1,6
99015,2,2244,2410,-166,0,1,0,6
99016,1,2413,2403,10,0,225,0,6
99017,1,2485,2591,-106,0,474,0,6
99018,2,2413,2462,-49,0,20,1,6
99019,1,2403,2228,175,0,324,1,6
99020,2,2275,2426,-151,0,200,0,6
99021,1,2680,2540,140,0,142,0,6
99022,1,2406,2299,107,0,8,0,6
99023,1,2301,2433,-132,0,22,0,6
99024,2,2422,2260,162,0,335,1,6
99025,1,2451,2359,92,0,30,1,6
99026,1,2404,2401,3,0,228,0,8
99027,1,2479,2511,-32,0,302,0,6
99028,2,2235,2408,-173,0,255,1,6
99029,1,2551,2414,137,0,45,0,6
99030,1,2496,2478,18,0,57,0,6
99032,1,2446,2425,21,0,43,0,6
99033,2,2520,2492,28,0,140,1,6
99034,2,2618,2592,26,0,340,0,6
99035,1,2624,2450,174,0,210,0,6
99036,1,2505,2449,56,0,102,0,6
99037,2,2433,2517,-84,0,101,0,6
99038,1,2404,2489,-85,0,145,0,6
99039,1,2626,2496,130,0,122,0,6
99040,1,2431,2338,93,0,6,0,6
99041,2,2417,2326,91,0,260,0,8
99042,1,2445,2366,79,0,123,0,6
99043,1,2530,2338,192,0,380,1,6
99044,1,2418,2515,-97,0,3,0,6
99045,1,2418,2456,-38,0,215,1,6
99046,1,2398,2444,-46,0,107,0,6
99047,2,2408,2458,-50,0,45,0,6
99048,1,2556,2508,48,0,160,0,6
99049,2,2425,2318,107,0,3,0,6
99050,3,2344,2415,-71,0,80,0,6
99052,1,2488,2420,68,0,9,0,6
99053,1,2346,2498,-152,0,255,0,6
99054,1,2510,2430,80,0,200,0,6
99055,1,2450,2309,141,4,101,0,13
99056,1,2495,2472,23,0,242,0,6
99057,2,2529,2488,41,0,122,0,6
99058,2,2327,2405,-78,0,250,1,6
99059,1,2415,2374,41,0,330,0,6
99060,1,2476,2383,93,0,211,0,6
99061,2,2410,2556,-146,0,1,0,6
99062,2,2555,2577,-22,0,343,0,6
99063,2,2493,2277,216,0,140,0,6
99064,1,2282,2684,-402,0,101,0,6
99065,2,2388,2410,-22,0,333,0,6
99066,2,2440,2481,-41,0,243,0,6
99067,1,2598,2501,97,0,115,1,6
99068,2,2374,2503,-129,0,301,0,6
99069,2,2459,2383,76,0,112,0,6
99070,1,2486,2645,-159,0,302,0,6
99071,1,2469,2295,174,0,20,0,6
99072,2,2325,2647,-322,0,411,0,6
99073,2,2421,2413,8,0,468,0,6
99074,2,2584,2627,-43,0,28,0,6
99075,1,2506,2313,193,0,109,0,6
99076,1,2536,2493,43,0,140,0,6
99078,1,2504,2510,-6,0,256,0,6
99079,3,2416,2435,-19,0,45,0,6
99080,3,2472,2493,-21,0,124,0,6
99081,1,2495,2410,85,0,45,1,6
99082,3,2405,2449,-44,0,57,0,6
99083,1,2405,2334,71,0,133,1,6
99084,1,2408,2405,3,0,41,0,6
99086,2,2362,2411,-49,0,210,0,6
99087,2,2482,2356,126,0,211,0,6
99088,1,2424,2579,-155,0,108,0,6
99089,3,2369,2420,-51,0,57,0,6
99090,1,2425,2248,177,0,13,1,8
99091,1,2403,2351,52,0,354,0,6
99092,2,2434,2514,-80,0,43,1,6
99093,1,2382,2406,-24,0,113,0,6
99094,1,2632,2498,134,0,140,0,6
99095,1,2400,2289,111,0,403,1,6
99096,1,2352,2533,-181,0,46,0,6
99097,2,2425,2279,146,0,13,0,6
99098,1,2411,2330,81,0,190,1,6
99099,1,2522,2370,152,0,45,1,6
99100,2,2356,2418,-62,0,101,0,6
99101,1,2346,2429,-83,0,106,0,6
99102,1,2334,2436,-102,0,475,0,6
99103,1,2420,2336,84,0,140,0,8
99104,1,2509,2262,247,0,301,0,6
99105,1,2484,2481,3,0,128,0,6
99106,1,2414,2203,211,0,48,0,6
99107,2,2376,2438,-62,0,107,0,6
99108,3,2480,2390,90,0,45,0,6
99109,1,2522,2217,305,0,45,1,6
99110,2,2425,2309,116,0,248,0,6
99111,1,2637,2600,37,0,107,0,6
99112,2,2450,2332,118,0,415,1,6
99113,1,2560,2555,5,0,310,0,6
99114,2,2219,2407,-188,0,122,1,6
99115,3,2463,2403,60,0,176,0,6
99116,2,2467,2494,-27,0,200,0,6
99117,2,2495,2523,-28,0,245,0,6
99118,1,2423,2202,221,0,43,0,6
99119,2,2496,2501,-5,0,476,1,6
99120,1,2401,2312,89,0,46,1,6
99121,3,2400,2390,10,0,311,0,6
99122,2,2571,2514,57,0,487,0,6
99123,2,2473,2432,41,0,14,0,6
99124,1,2367,2541,-174,0,45,0,6
99125,2,2488,2550,-62,0,45,0,6
99126,2,2409,2335,74,0,46,0,6
99127,1,2377,2485,-108,0,139,0,6
99128,1,2364,2425,-61,0,335,0,6
99129,2,2420,2353,67,0,386,0,6
99130,1,2503,2332,171,0,308,0,6
99131,1,2497,2370,127,0,330,0,6
99132,1,2543,2510,33,0,128,1,6
99133,2,2504,2602,-98,0,156,0,6
99134,1,2557,2496,61,0,216,0,6
99135,2,2562,2507,55,0,256,0,6
99136,1,2364,2449,-85,0,214,0,6
99137,1,2410,2422,-12,0,107,0,6
99138,2,2474,2406,68,0,135,1,6
99139,2,2380,2410,-30,0,485,0,8
99140,1,2413,2419,-6,0,48,0,6
99141,1,2399,2416,-17,0,301,1,6
99142,2,2365,2490,-125,0,305,0,6
99143,2,2342,2411,-69,0,40,0,6
99144,1,2443,2278,165,0,113,0,6
99145,1,2324,2514,-190,0,405,0,6
99146,1,2630,2609,21,0,7,0,6
99147,2,2499,2479,20,0,302,0,6
99148,2,2499,2636,-137,0,320,0,6
99149,2,2338,2403,-65,0,211,0,6
99150,1,2462,2564,-102,0,241,0,6
99151,1,2428,2341,87,0,6,0,6
99152,1,2495,2409,86,0,102,1,6
99153,1,2366,2525,-159,0,485,1,6
99154,2,2301,2453,-152,0,107,0,7
99155,1,2521,2342,179,0,244,0,6
99156,1,2565,2399,166,0,310,0,6
99157,2,2255,2416,-161,0,4,1,6
99158,1,2595,2642,-47,0,152,0,6
99159,2,2435,2404,31,0,178,0,6
99160,1,2562,2533,29,0,123,1,6
99161,2,2442,2511,-69,0,200,1,6
99162,2,2308,2476,-168,4,129,1,13
99163,2,2439,2347,92,0,142,0,8
99164,2,2407,2409,-2,0,474,0,6
99165,2,2411,2413,-2,0,14,1,6
99166,1,2431,2309,122,0,31,0,6
99167,1,2473,2501,-28,0,110,0,6
99168,1,2462,2366,96,0,190,0,6
99169,1,2416,2271,145,0,106,0,6
99170,2,2416,2524,-108,0,101,0,6
99171,1,2416,2364,52,0,133,0,6
99172,2,2506,2466,40,0,58,0,6
99173,2,2439,2483,-44,0,53,0,6
99174,1,2407,2468,-61,0,113,1,6
99175,1,2424,2309,115,0,331,0,8
99176,2,2390,2442,-52,0,200,0,6
99177,1,2433,2429,4,0,483,0,6
99178,2,2505,2307,198,0,474,1,6
99179,2,2493,2417,76,0,200,0,6
99180,1,2414,2404,10,0,1,0,6
99181,2,2287,2417,-130,0,156,0,6
99182,2,2420,2539,-119,0,115,0,6
99183,1,2446,2435,11,0,122,1,6
99184,1,2606,2500,106,0,245,0,6
99185,2,2328,2489,-161,0,190,1,6
99186,2,2630,2592,38,0,202,0,6
99187,2,2506,2519,-13,0,200,0,6
99188,2,2308,2419,-111,0,404,0,6
99189,1,2424,2294,130,0,107,0,8
99190,3,2496,2354,142,0,154,0,6
99191,1,2221,2426,-205,0,80,0,6
99192,2,2257,2421,-164,0,142,1,6
99193,3,2317,2418,-101,0,121,0,6
99194,2,2493,2466,27,0,46,0,6
99195,2,2506,2350,156,0,306,0,6
99196,2,2329,2417,-88,0,252,1,6
99197,2,2433,2263,170,0,133,1,6
99198,1,2411,2244,167,4,405,0,18
99200,2,2528,2472,56,0,45,0,6
99201,3,2604,2635,-31,0,106,0,6
99202,1,2505,2337,168,0,122,0,6
99203,3,2376,2438,-62,0,201,0,6
99204,1,2424,2416,8,0,108,1,6
99205,3,2486,2569,-83,0,210,0,6
99206,1,2369,2543,-174,0,112,0,6
99207,2,2423,2369,54,0,3,0,6
99208,2,2291,2455,-164,0,331,1,6
99209,1,2639,2673,-34,0,101,1,6
99210,3,2306,2454,-148,4,47,0,13
99211,2,2517,2414,103,0,338,0,6
99212,1,2415,2375,40,0,115,0,8
99213,2,2357,2468,-111,0,48,0,6
99214,3,2405,2390,15,0,40,0,6
99215,1,2605,2479,126,0,16,0,6
99216,2,2410,2306,104,0,45,0,6
99217,1,2487,2365,122,0,463,0,6
99218,1,2419,2314,105,0,221,0,6
99219,3,2599,2557,42,0,41,0,6
99220,2,2420,2294,126,0,1,1,6
99221,2,2405,2499,-94,0,30,0,6
99222,1,2432,2290,142,0,107,0,8
99223,2,2636,2602,34,0,142,0,6
99224,1,2469,2517,-48,0,108,0,6
99225,2,2225,2414,-189,0,200,1,6
99226,1,2415,2354,61,0,60,0,6
99227,2,2249,2428,-179,0,455,0,8
99228,2,2429,2524,-95,0,151,0,6
99229,2,2434,2406,28,0,41,0,6
99230,2,2362,2473,-111,0,57,0,6
99231,1,2623,2500,123,0,122,0,6
99232,2,2412,2428,-16,0,300,1,6
99233,3,2488,2497,-9,0,45,0,6
99234,2,2326,2410,-84,0,242,0,8
99235,1,2600,2546,54,0,151,0,6
99236,2,2554,2418,136,0,202,0,6
99237,2,2447,2567,-120,0,3,0,6
99238,1,2513,2349,164,0,113,0,6
99239,1,2516,2263,253,0,106,0,6
99240,2,2337,2437,-100,0,46,1,6
99241,1,2528,2393,135,0,130,0,6
99242,1,2419,2405,14,0,165,1,6
99243,1,2496,2610,-114,0,101,1,6
99244,2,2524,2483,41,0,110,1,6
99245,2,2472,2377,95,0,211,1,6
99246,1,2472,2459,13,0,243,1,6
99247,1,2500,2501,-1,0,5,0,6
99248,2,2315,2407,-92,0,204,0,6
99249,2,2447,2377,70,0,483,0,6
99250,1,2458,2487,-29,0,200,0,6
99251,2,2420,2428,-8,0,101,1,8
99252,3,2355,2518,-163,0,201,0,6
99253,1,2422,2515,-93,0,2,0,6
99254,1,2414,2322,92,0,191,0,8
99255,2,2423,2316,107,0,123,0,6
99256,2,2423,2438,-15,0,461,0,6
99257,2,2387,2415,-28,0,474,1,6
99258,2,2493,2304,189,0,141,1,6
99259,2,2498,2536,-38,0,107,0,6
99260,1,2430,2488,-58,0,145,0,6
99261,1,2567,2410,157,0,40,0,6
99263,1,2443,2588,-145,0,2,1,6
99264,2,2424,2505,-81,0,244,0,6
99265,2,2536,2294,242,0,45,0,6
99266,1,2425,2425,0,0,206,1,6
99267,2,2242,2402,-160,0,40,0,6
99268,2,2397,2521,-124,0,308,1,6
99269,2,2308,2478,-170,0,128,1,6
99270,1,2287,2436,-149,0,45,0,8
99271,1,2422,2325,97,0,11,0,6
99272,2,2508,2413,95,0,102,0,6
99273,1,2440,2344,96,0,335,0,6
99274,1,2503,2401,102,0,102,1,6
99275,2,2350,2481,-131,0,125,0,6
99276,2,2420,2349,71,0,387,0,6
99277,2,2215,2421,-206,0,0,1,6
99278,2,2411,2436,-25,0,200,0,6
99279,1,2475,2496,-21,0,126,0,6
99280,3,2518,2532,-14,0,453,0,6
99281,2,2511,2425,86,0,264,0,6
99282,1,2388,2461,-73,0,106,0,6
99283,1,2604,2646,-42,0,302,0,6
99284,2,2608,2629,-21,0,11,1,6
99285,1,2492,2476,16,0,15,1,6
99286,1,2250,2407,-157,0,10,0,6
99287,2,2323,2437,-114,0,202,0,6
99288,3,2557,2598,-41,0,13,0,6
99289,2,2426,2461,-35,0,6,0,6
99290,2,2388,2403,-15,0,7,0,6
99291,1,2635,2528,107,0,45,1,6
99292,3,2496,2401,95,0,334,0,6
99293,1,2421,2283,138,0,411,0,6
99294,3,2498,2336,162,0,331,0,6
99295,3,2408,2358,50,0,331,0,6
99296,2,2321,2426,-105,0,105,0,6
99297,1,2604,2488,116,0,140,0,6
99298,2,2441,2337,104,0,123,1,6
99299,1,2603,2503,100,0,245,0,6
99300,1,2322,2416,-94,0,89,0,6
99301,1,2415,2264,151,0,110,0,6
99302,2,2412,2345,67,0,56,0,6
99303,2,2495,2481,14,0,315,0,6
99304,1,2541,2406,135,0,4,0,6
99305,2,2464,2433,31,0,130,1,6
99306,1,2648,2478,170,0,125,0,6
99307,1,2494,2346,148,0,110,0,6
99308,2,2318,2419,-101,0,242,0,8
99309,2,2355,2400,-45,0,121,0,6
99310,1,2429,2424,5,0,3,0,6
99311,2,2416,2318,98,0,100,0,6
99312,1,2288,2423,-135,0,4,0,6
99313,1,2627,2591,36,0,228,0,6
99314,2,2518,2485,33,0,101,1,6
99315,1,2420,2415,5,0,221,0,6
99316,2,2452,2444,8,0,200,0,6
99317,3,2485,2526,-41,0,110,0,6
99318,1,2516,2464,52,0,109,0,6
99319,2,2509,2490,19,0,474,0,6
99320,1,2430,2317,113,0,310,0,6
99321,2,2542,2538,4,0,45,0,6
99322,1,2417,2262,155,0,56,0,6
99323,1,2383,2583,-200,0,231,0,6
99324,2,2393,2405,-12,0,470,1,6
99325,2,2442,2525,-83,0,101,0,6
99326,2,2444,2418,26,0,483,1,6
99327,1,2509,2639,-130,0,8,0,6
99328,1,2482,2572,-90,0,80,0,6
99329,1,2477,2391,86,0,15,1,6
99330,2,2441,2475,-34,0,446,1,6
99331,1,2580,2451,129,0,200,0,6
99332,2,2319,2400,-81,0,121,0,6
99333,2,2405,2412,-7,0,83,0,6
99334,2,2212,2486,-274,0,305,0,6
99335,2,2246,2526,-280,0,115,1,6
99336,1,2422,2314,108,0,301,0,6
99337,2,2493,2568,-75,0,247,0,6
99338,2,2611,2653,-42,0,303,1,6
99339,1,2454,2405,49,0,442,0,6
99340,1,2410,2425,-15,0,143,0,6
99341,1,2484,2340,144,0,245,0,6
99342,2,2203,2404,-201,0,4,0,6
99343,2,2312,2420,-108,0,31,0,6
99344,2,2419,2454,-35,0,106,1,6
99345,2,2361,2501,-140,0,4,0,6
99346,1,2490,2481,9,0,45,1,6
99347,1,2421,2302,119,0,190,0,6
99348,2,2540,2503,37,0,109,0,6
99349,1,2339,2437,-98,0,337,0,6
99350,1,2419,2430,-11,0,225,0,6
99351,2,2635,2603,32,0,142,0,6
99352,2,2529,2307,222,0,45,0,6
99353,1,2531,2518,13,0,101,0,6
99354,2,2398,2413,-15,0,311,1,6
99355,1,2203,2423,-220,0,41,0,6
99356,2,2499,2607,-108,0,101,0,6
99357,3,2490,2404,86,0,403,0,6
99358,1,2439,2366,73,0,18,0,6
99359,2,2389,2545,-156,0,250,0,6
99360,1,2458,2383,75,0,4,0,6
99361,2,2327,2419,-92,0,123,0,6
99362,1,2431,2254,177,0,107,1,8
99363,1,2487,2470,17,0,302,0,6
99364,1,2243,2415,-172,0,48,0,8
99365,2,2484,2608,-124,0,300,0,6
99366,2,2415,2354,61,0,222,0,6
99367,2,2489,2494,-5,0,4,0,6
99368,2,2405,2391,14,0,10,0,6
99369,2,2434,2428,6,0,454,0,8
99370,1,2488,2411,77,0,150,0,6
99371,2,2544,2597,-53,0,337,1,6
99372,3,2435,2433,2,0,2,0,6
99373,1,2524,2450,74,0,347,1,6
99374,2,2407,2489,-82,0,128,0,6
99375,1,2565,2430,135,0,338,0,6
99376,2,2735,2586,149,0,8,0,6
99377,1,2416,2440,-24,0,330,1,6
99378,1,2574,2536,38,0,46,0,6
99379,2,2313,2434,-121,0,220,0,6
99380,1,2344,2434,-90,0,214,0,6
99381,2,2280,2424,-144,0,156,1,6
99382,1,2278,2405,-127,0,201,0,6
99383,3,2403,2512,-109,0,44,0,6
99384,1,2285,2433,-148,0,303,1,6
99385,1,2318,2406,-88,0,48,0,6
99386,1,2573,2496,77,0,112,0,6
99387,3,2470,2491,-21,0,7,0,6
99388,1,2383,2400,-17,0,1,1,6
99389,2,2326,2409,-83,0,4,0,6
99390,2,2298,2424,-126,0,40,0,6
99391,1,2438,2426,12,0,115,0,6
99392,1,2615,2481,134,0,140,0,6
99393,1,2555,2612,-57,0,315,0,6
99394,2,2353,2426,-73,0,106,1,6
99395,2,2439,2488,-49,0,7,0,6
99396,1,2528,2335,193,0,45,0,6
99397,3,2427,2406,21,0,110,0,6
99398,2,2568,2492,76,0,398,1,6
99399,2,2407,2497,-90,0,49,0,6
99400,1,2632,2632,0,0,116,0,6
99401,1,2438,2309,129,0,4,0,6
99402,1,2629,2447,182,0,40,0,6
99403,2,2393,2427,-34,0,1,1,6
99404,1,2424,2425,-1,0,40,0,6
99405,1,2505,2489,16,0,102,0,6
99406,2,2425,2481,-56,0,206,0,6
99407,1,2443,2357,86,0,436,1,6
99408,1,2480,2534,-54,0,203,0,6
99409,2,2424,2436,-12,0,40,0,6
99410,3,2407,2522,-115,0,200,0,6
99411,2,2375,2495,-120,0,160,0,6
99412,2,2594,2723,-129,0,25,0,6
99413,2,2493,2426,67,0,330,1,6
99414,2,2495,2493,2,0,315,0,6
99415,2,2405,2339,66,0,13,0,6
99416,1,2459,2308,151,0,4,0,6
99417,2,2389,2558,-169,0,405,0,6
99418,1,2660,2527,133,0,125,0,6
99419,2,2359,2404,-45,0,241,0,6
99420,2,2404,2240,164,4,200,0,13
99421,2,2318,2409,-91,0,101,0,6
99422,1,2512,2345,167,0,302,1,6
99423,2,2378,2462,-84,0,460,0,6
99424,2,2450,2537,-87,0,106,0,6
99425,1,2492,2566,-74,0,306,0,6
99426,2,2611,2495,116,0,245,1,6
99427,3,2409,2364,45,0,112,0,6
99428,2,2419,2520,-101,0,40,0,6
99429,2,2409,2420,-11,0,222,0,6
99430,1,2465,2500,-35,0,195,0,6
99431,1,2441,2402,39,0,302,0,6
99432,2,2305,2442,-137,0,1,0,6
99433,1,2482,2430,52,0,5,0,6
99434,2,2423,2392,31,0,201,0,8
99435,2,2491,2579,-88,0,300,0,6
99436,2,2531,2522,9,0,45,0,6
99437,3,2334,2401,-67,0,34,0,6
99438,2,2406,2248,158,0,7,0,6
99439,1,2329,2424,-95,0,16,0,6
99440,1,2463,2284,179,0,4,0,6
99441,1,2427,2294,133,0,107,0,6
99442,2,2418,2400,18,0,1,0,6
99443,1,2541,2305,236,0,143,0,6
99444,1,2531,2562,-31,0,300,1,6
99445,2,2322,2450,-128,0,16,0,6
99446,3,2382,2499,-117,0,124,0,6
99447,3,2314,2446,-132,0,300,0,6
99448,3,2606,2529,77,0,140,0,6
99449,2,2397,2446,-49,0,140,1,6
99450,2,2467,2632,-165,0,7,0,6
99451,1,2337,2420,-83,0,114,0,6
99452,1,2433,2422,11,0,49,0,6
99453,1,2343,2408,-65,0,134,0,6
99454,1,2360,2433,-73,0,264,0,6
99455,2,2409,2355,54,0,152,0,6
99456,3,2350,2510,-160,0,128,0,6
99457,2,2558,2510,48,0,44,0,6
99458,1,2477,2484,-7,0,45,0,6
99459,1,2633,2444,189,0,210,0,6
99460,1,2401,2349,52,0,46,0,6
99461,1,2549,2376,173,0,153,1,6
99462,1,2432,2255,177,0,106,0,6
99463,1,2459,2405,54,0,107,1,6
99464,2,2434,2428,6,0,116,0,8
99465,1,2527,2487,40,0,120,0,6
99466,2,2406,2388,18,0,115,0,8
99467,2,2425,2394,31,0,400,1,6
99468,1,2321,2403,-82,0,49,0,6
99470,3,2336,2436,-100,0,100,0,6
99471,1,2637,2545,92,0,211,0,6
99472,1,2377,2486,-109,0,201,0,6
99473,3,2635,2464,171,0,144,0,6
99474,2,2434,2420,14,0,45,0,6
99475,2,2236,2403,-167,0,300,1,6
99477,2,2254,2421,-167,0,302,0,6
99478,1,2491,2599,-108,0,110,0,6
99479,1,2490,2499,-9,0,45,0,6
99480,1,2728,2590,138,0,267,0,6
99481,3,2401,2370,31,0,12,0,6
99482,1,2406,2412,-6,0,100,0,6
99483,2,2254,2403,-149,0,21,0,6
99484,2,2350,2463,-113,0,148,1,6
99485,2,2352,2413,-61,0,310,0,6
99486,2,2664,2578,86,0,291,0,6
99487,2,2426,2350,76,0,176,0,6
99488,3,2562,2489,73,0,15,0,6
99489,3,2516,2627,-111,0,311,0,6
99490,2,2320,2451,-131,0,106,0,6
99491,1,2503,2604,-101,0,101,1,6
99492,1,2530,2604,-74,0,0,1,6
99493,2,2295,2461,-166,0,331,0,6
99494,1,2444,2353,91,0,70,1,6
99495,2,2508,2488,20,0,110,1,6
99496,1,2487,2471,16,0,0,1,6
99497,2,2425,2483,-58,0,461,1,6
99498,1,2403,2464,-61,0,40,0,6
99499,2,2482,2533,-51,0,211,1,6
99500,2,2414,2448,-34,0,2,1,6
99501,2,2478,2647,-169,0,58,0,6
99502,1,2303,2401,-98,0,310,1,6
99503,2,2371,2536,-165,0,406,0,6
99504,1,2517,2359,158,0,190,0,6
99505,1,2410,2400,10,0,43,0,6
99506,2,2458,2466,-8,0,106,0,6
99507,2,2416,2439,-23,0,311,0,6
99508,1,2531,2419,112,0,8,0,6
99509,2,2587,2734,-147,0,25,0,6
99510,3,2541,2428,113,0,210,0,6
99511,1,2377,2417,-40,0,248,0,8
99512,2,2499,2661,-162,0,120,0,6
99513,2,2434,2426,8,0,233,0,6
99514,2,2371,2400,-29,0,110,0,6
99515,2,2402,2409,-7,0,130,0,6
99516,1,2356,2520,-164,0,44,1,6
99517,1,2632,2441,191,0,210,0,6
99518,1,2377,2466,-89,0,4,0,6
99519,2,2479,2493,-14,0,11,0,6
99521,3,2419,2350,69,0,394,0,6
99522,1,2417,2384,33,0,241,1,6
99523,1,2407,2364,43,0,180,0,6
99524,1,2498,2475,23,0,411,0,6
99525,1,2434,2428,6,0,40,0,8
99526,1,2400,2382,18,0,345,0,6
99527,1,2585,2411,174,0,268,0,6
99528,2,2444,2506,-62,0,46,0,6
99529,3,2417,2417,0,0,156,0,6
99530,1,2507,2552,-45,0,253,0,6
99531,3,2583,2561,22,0,45,0,6
99532,1,2418,2400,18,0,41,0,6
99533,1,2493,2496,-3,0,302,0,6
99534,2,2257,2434,-177,0,140,0,8
99535,1,2455,2317,138,0,110,0,6
99536,1,2518,2492,26,0,6,1,6
99537,2,2596,2510,86,0,245,1,6
99538,2,2383,2517,-134,0,405,1,6
99539,2,2495,2598,-103,0,317,0,6
99540,1,2464,2537,-73,0,140,1,6
99541,3,2319,2406,-87,0,278,0,6
99542,1,2470,2525,-55,0,487,0,6
99543,2,2430,2415,15,0,40,0,6
99544,2,2448,2539,-91,0,65,0,6
99545,1,2471,2452,19,0,0,1,6
99546,1,2488,2420,68,0,45,0,6
99547,1,2537,2477,60,0,120,0,6
99548,1,2348,2502,-154,0,4,1,6
99549,2,2310,2419,-109,0,40,0,6
99550,1,2504,2540,-36,0,45,0,6
99551,1,2312,2418,-106,0,300,0,6
99552,1,2466,2502,-36,0,246,0,6
99553,1,2675,2496,179,0,112,1,6
99554,2,2432,2409,23,0,156,0,6
99555,2,2456,2642,-186,0,6,0,6
99556,1,2438,2581,-143,0,2,1,6
99557,1,2635,2625,10,0,113,0,6
99558,1,2406,2331,75,0,1,0,6
99559,1,2739,2583,156,0,202,0,6
99560,1,2562,2440,122,0,311,0,6
99561,2,2426,2364,62,0,150,0,6
99562,1,2410,2306,104,0,469,0,6
99563,1,2588,2412,176,0,263,0,6
99564,1,2512,2510,2,0,200,0,6
99565,2,2309,2424,-115,0,331,0,6
99566,2,2429,2453,-24,0,487,0,6
99567,2,2533,2439,94,0,0,0,6
99568,1,2413,2283,130,0,122,0,6
99569,1,2400,2444,-44,0,1,0,6
99570,1,2645,2491,154,0,142,0,6
99571,1,2454,2382,72,0,267,0,6
99572,2,2394,2537,-143,0,301,0,6
99573,1,2423,2397,26,0,302,0,6
99574,1,2453,2346,107,0,42,0,6
99575,1,2271,2431,-160,0,302,0,6
99576,2,2490,2499,-9,0,57,0,6
99577,2,2324,2428,-104,0,365,0,6
99578,1,2498,2602,-104,0,112,0,6
99579,1,2346,2423,-77,0,310,1,6
99580,1,2511,2398,113,0,48,1,6
99581,2,2287,2423,-136,0,40,0,6
99582,2,2561,2583,-22,0,9,0,6
99583,2,2400,2344,56,0,56,1,6
99584,1,2608,2578,30,0,213,0,6
99585,2,2517,2589,-72,0,0,0,6
99586,2,2492,2466,26,0,40,0,6
99587,1,2306,2408,-102,0,454,0,6
99588,2,2580,2559,21,0,25,0,6
99589,2,2459,2379,80,0,315,0,6
99590,3,2544,2487,57,0,101,0,6
99591,3,2302,2471,-169,0,337,0,6
99592,2,2252,2408,-156,0,101,0,6
99593,2,2472,2378,94,0,120,1,6
99594,1,2530,2542,-12,0,200,0,6
99595,1,2472,2466,6,0,140,0,6
99596,1,2473,2345,128,0,20,0,6
99597,2,2505,2484,21,0,427,0,6
99598,2,2395,2567,-172,0,242,1,8
99599,1,2504,2472,32,0,455,0,6
99600,2,2422,2517,-95,0,201,0,6
99601,1,2401,2347,54,0,34,1,6
99602,1,2494,2459,35,0,121,1,6
99603,1,2545,2366,179,0,254,0,6
99604,2,2513,2426,87,0,38,0,6
99605,2,2502,2513,-11,0,130,0,6
99606,1,2583,2641,-58,0,344,0,6
99607,1,2687,2648,39,0,300,0,6
99608,2,2390,2400,-10,0,4,0,6
99609,2,2405,2429,-24,0,125,0,6
99610,2,2415,2417,-2,0,96,0,6
99611,1,2574,2446,128,0,202,0,6
99612,2,2254,2423,-169,0,101,1,6
99613,1,2468,2438,30,0,204,0,6
99614,1,2619,2587,32,0,112,0,6
99615,2,2327,2406,-79,0,484,1,6
99616,2,2335,2412,-77,0,277,0,6
99617,1,2427,2409,18,0,226,0,6
99618,1,2486,2436,50,0,300,0,6
99619,1,2493,2565,-72,0,221,0,6
99620,1,2417,2383,34,0,204,1,6
99621,2,2487,2496,-9,0,110,1,6
99622,2,2584,2591,-7,0,278,1,6
99623,1,2458,2300,158,0,453,0,6
99624,1,2371,2415,-44,0,46,1,6
99625,2,2420,2325,95,0,250,1,6
99626,1,2542,2488,54,0,4,1,6
99627,1,2391,2435,-44,0,300,0,6
99628,2,2460,2510,-50,0,205,0,6
99629,1,2506,2409,97,0,245,1,6
99630,2,2594,2513,81,0,267,1,6
99631,1,2275,2405,-130,0,248,0,6
99632,2,2324,2422,-98,0,107,0,6
99633,1,2432,2415,17,0,48,0,6
99634,3,2589,2594,-5,0,300,0,6
99635,2,2321,2452,-131,0,106,0,6
99636,2,2406,2375,31,0,150,0,6
99637,1,2457,2277,180,0,200,0,8
99638,2,2573,2590,-17,0,45,0,6
99639,2,2536,2536,0,0,120,0,6
99640,2,2418,2413,5,0,180,1,6
99641,2,2423,2386,37,0,404,0,6
99642,1,2386,2452,-66,0,217,0,6
99643,1,2412,2248,164,0,3,1,6
99644,1,2515,2522,-7,0,46,1,6
99645,3,2401,2351,50,0,200,0,6
99646,2,2462,2321,141,0,335,0,6
99647,2,2443,2577,-134,0,3,0,6
99648,2,2433,2505,-72,0,241,1,6
99649,2,2342,2457,-115,0,290,0,6
99650,1,2416,2355,61,0,201,1,6
99651,1,2403,2314,89,0,142,0,6
99652,1,2432,2368,64,0,111,0,6
99653,1,2289,2440,-151,0,48,1,8
99654,1,2460,2477,-17,0,206,0,6
99655,2,2394,2543,-149,0,20,0,6
99656,2,2488,2382,106,0,210,0,6
99657,3,2565,2643,-78,0,314,0,6
99658,1,2543,2499,44,0,200,0,6
99659,2,2508,2490,18,0,241,1,6
99660,2,2495,2706,-211,0,122,0,6
99661,2,2453,2499,-46,0,300,0,6
99662,2,2512,2607,-95,0,16,1,6
99663,1,2451,2510,-59,0,30,0,6
99664,2,2332,2425,-93,0,133,0,6
99665,2,2406,2432,-26,0,9,1,6
99666,1,2545,2491,54,0,462,1,6
99667,2,2293,2417,-124,0,101,0,6
99668,1,2355,2548,-193,0,264,0,6
99669,1,2595,2574,21,0,330,0,6
99670,2,2401,2379,22,0,256,0,6
99671,3,2542,2531,11,0,1,0,6
99672,3,2567,2431,136,0,300,0,6
99673,1,2559,2500,59,0,62,1,6
99674,1,2411,2322,89,0,211,1,6
99675,1,2390,2428,-38,0,4,0,6
99676,1,2469,2625,-156,0,101,0,6
99677,3,2594,2589,5,0,242,0,6
99678,2,2312,2438,-126,0,48,1,6
99679,2,2409,2406,3,0,5,0,6
99680,3,2333,2413,-80,0,4,0,6
99681,1,2284,2461,-177,0,5,0,6
99682,1,2376,2400,-24,0,405,0,6
99683,2,2546,2597,-51,0,288,0,6
99684,1,2427,2397,30,0,241,1,6
99685,2,2637,2549,88,0,190,0,6
99686,2,2416,2331,85,0,332,0,6
99687,2,2520,2587,-67,0,13,0,6
99688,2,2377,2456,-79,0,394,0,6
99689,2,2343,2409,-66,0,49,0,6
99690,2,2347,2400,-53,0,225,0,6
99691,2,2350,2520,-170,0,245,0,6
99692,2,2435,2378,57,0,4,0,6
99693,2,2428,2355,73,0,116,0,6
99694,1,2392,2403,-11,0,344,0,6
99695,1,2571,2392,179,0,235,0,8
99696,3,2481,2363,118,0,404,0,6
99697,1,2328,2445,-117,0,475,0,6
99698,3,2424,2496,-72,0,112,0,6
99699,2,2405,2510,-105,0,310,0,6
99700,1,2412,2504,-92,0,128,0,6
99701,2,2422,2371,51,0,245,0,6
99702,1,2419,2516,-97,0,216,0,6
99703,1,2650,2639,11,0,280,0,6
99704,2,2421,2364,57,0,358,0,6
99705,3,2642,2581,61,0,173,0,6
99706,2,2471,2476,-5,0,15,0,6
99707,1,2402,2493,-91,0,49,1,6
99708,2,2548,2716,-168,0,153,0,6
99709,1,2408,2325,83,0,143,0,6
99710,1,2431,2291,140,0,144,1,6
99711,2,2439,2565,-126,0,3,0,6
99712,1,2496,2502,-6,0,44,0,6
99714,1,2453,2397,56,0,485,1,6
99715,3,2333,2437,-104,0,106,0,6
99716,3,2405,2396,9,0,245,0,6
99717,2,2633,2655,-22,0,4,0,6
99718,2,2531,2542,-11,0,249,0,6
99719,1,2411,2334,77,0,255,0,6
99720,2,2399,2507,-108,0,4,1,6
99721,2,2438,2428,10,0,70,0,6
99722,1,2460,2256,204,0,104,0,8
99723,2,2352,2400,-48,0,10,1,6
99724,2,2394,2461,-67,0,250,0,6
99725,1,2589,2594,-5,0,45,0,6
99726,1,2487,2438,49,0,45,0,6
99728,2,2592,2515,77,0,245,0,6
99729,1,2460,2373,87,0,190,0,6
99730,1,2634,2495,139,0,464,1,6
99731,2,2442,2347,95,0,4,0,6
99732,1,2415,2362,53,0,2,0,6
99733,2,2391,2479,-88,0,426,1,6
99734,1,2541,2612,-71,0,115,0,6
99735,2,2361,2412,-51,0,80,0,6
99736,2,2514,2401,113,0,258,0,6
99737,2,2393,2432,-39,0,110,0,6
99738,2,2413,2392,21,0,241,1,6
99739,2,2428,2432,-4,0,374,0,6
99740,2,2495,2550,-55,0,123,1,6
99741,1,2560,2328,232,2,337,0,18
99742,1,2414,2355,59,0,327,0,6
99743,1,2509,2340,169,0,100,0,6
99744,2,2532,2491,41,0,315,1,6
99745,1,2438,2338,100,0,190,0,6
99746,1,2522,2518,4,0,101,0,6
99747,1,2569,2435,134,0,200,0,6
99748,2,2502,2497,5,0,332,1,6
99749,1,2574,2432,142,0,101,0,8
99750,1,2516,2368,148,0,454,0,6
99751,2,2372,2545,-173,0,43,0,6
99752,2,2464,2392,72,0,245,1,6
99753,2,2661,2628,33,0,341,1,6
99754,1,2727,2641,86,0,150,1,6
99755,2,2336,2413,-77,0,300,1,6
99756,2,2465,2313,152,0,15,0,6
99757,2,2582,2434,148,0,101,0,6
99758,2,2392,2458,-66,0,407,1,6
99759,1,2547,2525,22,0,5,0,6
99760,1,2304,2428,-124,0,415,0,8
99761,1,2509,2435,74,0,7,1,6
99762,1,2581,2482,99,0,414,0,6
99763,1,2435,2492,-57,0,140,0,6
99764,3,2500,2433,67,0,484,0,6
99765,2,2324,2435,-111,0,10,0,6
99766,1,2428,2255,173,0,380,0,6
99767,2,2539,2453,86,0,256,1,6
99768,3,2588,2595,-7,0,242,0,6
99769,1,2326,2422,-96,0,16,1,6
99770,1,2437,2388,49,0,246,1,6
99771,2,2462,2417,45,0,248,0,6
99772,1,2329,2416,-87,0,8,0,6
99773,2,2350,2463,-113,0,107,0,8
99774,2,2365,2432,-67,0,344,0,6
99775,2,2520,2553,-33,0,249,0,6
99776,2,2378,2495,-117,0,48,0,6
99777,1,2452,2512,-60,0,129,0,6
99778,1,2405,2396,9,0,446,0,6
99779,1,2522,2585,-63,0,101,0,6
99780,1,2467,2548,-81,0,455,0,6
99781,2,2375,2404,-29,0,307,0,6
99782,2,2434,2605,-171,0,119,1,6
99783,1,2432,2573,-141,0,3,0,6
99784,1,2442,2494,-52,0,46,0,6
99785,2,2261,2412,-151,0,311,0,6
99786,1,2323,2416,-93,0,45,0,6
99787,1,2483,2458,25,0,331,0,6
99788,2,2340,2419,-79,0,50,0,6
99789,2,2586,2638,-52,0,101,0,6
99790,2,2398,2407,-9,0,45,0,6
99791,1,2385,2415,-30,0,320,0,6
99792,1,2466,2389,77,0,112,0,6
99793,1,2325,2457,-132,0,200,0,6
99794,2,2432,2328,104,0,233,0,6
99795,1,2503,2578,-75,0,244,0,6
99796,1,2533,2497,36,0,25,0,6
99797,1,2361,2422,-61,0,385,1,6
99798,2,2478,2485,-7,0,55,0,6
99799,2,2350,2442,-92,0,106,1,6
99800,1,2320,2417,-97,0,415,0,6
99801,1,2595,2589,6,0,45,0,6
99802,2,2464,2394,70,0,121,0,6
99803,1,2463,2387,76,0,6,1,6
99804,1,2637,2498,139,0,115,1,6
99805,1,2504,2399,105,0,11,0,6
99806,1,2565,2440,125,0,40,1,6
99807,2,2548,2741,-193,0,123,0,6
99808,1,2574,2459,115,0,123,0,6
99809,1,2417,2331,86,0,315,0,6
99810,1,2455,2346,109,0,194,0,6
99811,1,2341,2438,-97,0,45,0,6
99812,2,2434,2360,74,0,6,0,6
99813,2,2327,2448,-121,0,100,0,6
99814,1,2430,2513,-83,0,387,0,6
99815,2,2265,2437,-172,0,202,0,6
99816,1,2512,2499,13,0,253,0,6
99817,2,2424,2386,38,0,144,0,6
99818,2,2349,2456,-107,0,310,1,6
99819,1,2353,2479,-126,0,405,0,6
99820,1,2578,2529,49,0,247,0,6
99821,1,2558,2515,43,0,212,0,6
99822,3,2433,2382,51,0,130,0,6
99824,1,2338,2425,-87,0,290,1,6
99825,2,2442,2541,-99,0,49,1,6
99826,2,2489,2571,-82,0,40,0,6
99827,2,2388,2453,-65,0,302,0,6
99828,1,2453,2389,64,0,300,0,8
99829,2,2393,2510,-117,0,301,0,6
99830,1,2452,2306,146,0,466,0,6
99831,2,2342,2459,-117,0,215,0,6
99832,1,2485,2545,-60,0,43,0,6
99833,1,2458,2335,123,0,440,0,6
99834,2,2455,2578,-123,0,120,0,6
99835,1,2313,2417,-104,0,80,0,6
99836,1,2349,2414,-65,0,45,0,6
99837,2,2409,2385,24,0,382,0,6
99838,1,2380,2458,-78,0,61,0,6
99839,3,2491,2538,-47,0,331,0,6
99840,1,2608,2581,27,0,9,0,6
99841,2,2450,2336,114,0,15,1,6
99842,1,2410,2431,-21,0,221,1,6
99843,2,2491,2644,-153,0,40,0,6
99844,2,2494,2509,-15,0,484,0,6
99845,2,2421,2531,-110,0,6,1,6
99846,2,2444,2518,-74,0,21,1,6
99847,3,2440,2416,24,0,80,0,6
99848,1,2386,2424,-38,0,100,1,6
99849,2,2523,2584,-61,0,64,0,6
99850,1,2446,2383,63,0,151,1,6
99851,1,2506,2437,69,0,7,1,6
99852,1,2466,2305,161,0,311,1,6
99853,2,2405,2330,75,0,218,0,6
99854,2,2422,2400,22,0,70,1,6
99855,2,2410,2327,83,0,102,0,6
99856,2,2383,2410,-27,0,302,0,6
99857,3,2467,2372,95,0,106,0,8
99858,2,2201,2403,-202,0,109,0,6
99859,2,2510,2569,-59,0,120,0,6
99860,2,2524,2583,-59,0,101,0,6
99861,1,2351,2409,-58,0,151,0,6
99862,2,2367,2463,-96,0,300,0,6
99863,2,2416,2368,48,0,4,1,6
99864,1,2398,2409,-11,0,107,0,6
99865,1,2514,2576,-62,0,244,0,6
99866,1,2327,2432,-105,0,144,0,6
99867,1,2600,2436,164,0,200,0,6
99868,1,2441,2456,-15,0,49,1,6
99869,2,2628,2471,157,0,409,1,6
99870,2,2468,2461,7,0,210,0,6
99871,1,2337,2419,-82,0,302,0,6
99872,1,2407,2484,-77,0,101,0,6
99873,2,2620,2494,126,0,1,0,6
99874,2,2451,2576,-125,0,101,0,6
99875,1,2648,2487,161,0,54,0,6
99876,1,2492,2539,-47,0,45,0,6
99877,1,2458,2488,-30,0,13,0,6
99878,1,2515,2492,23,0,0,0,6
99879,2,2431,2354,77,0,122,0,6
99880,3,2546,2360,186,0,250,0,6
99881,1,2548,2363,185,0,330,0,6
99882,1,2408,2277,131,0,211,0,6
99883,3,2425,2363,62,0,150,0,6
99884,2,2460,2521,-61,0,122,0,6
99885,2,2574,2505,69,0,300,0,6
99886,2,2346,2442,-96,0,200,0,6
99887,1,2421,2338,83,0,115,0,6
99888,2,2297,2451,-154,0,4,1,6
99889,2,2439,2418,21,0,56,1,6
99890,2,2416,2522,-106,0,205,0,6
99891,1,2415,2378,37,0,100,0,6
99892,1,2412,2392,20,0,302,0,6
99893,1,2472,2433,39,0,311,0,6
99894,2,2418,2248,170,0,154,0,6
99895,3,2402,2358,44,0,245,0,6
99896,2,2428,2465,-37,0,107,0,8
99897,2,2638,2604,34,0,0,0,6
99898,2,2532,2348,184,0,100,1,6
99899,2,2499,2488,11,0,45,1,6
99900,1,2406,2416,-10,0,110,1,6
99901,2,2377,2403,-26,0,4,0,6
99902,3,2330,2458,-128,0,107,0,8
99903,2,2360,2551,-191,0,225,0,6
99904,1,2588,2520,68,0,244,1,6
99905,2,2502,2540,-38,0,302,1,6
99906,1,2399,2521,-122,0,15,1,6
99907,2,2403,2447,-44,0,131,0,6
99908,2,2467,2462,5,0,112,1,6
99909,3,2484,2477,7,0,45,0,6
99910,1,2511,2295,216,0,5,1,6
99911,2,2414,2440,-26,0,198,0,6
99912,1,2363,2543,-180,0,56,1,6
