Result,WhiteElo,BlackElo,EloDiff,Event,ECO_enc,Termination,TimeControl_enc
1,2669,2625,44,0,101,0,6
1,2516,2337,179,0,120,1,6
1,2468,2435,33,0,106,0,6
1,2404,2337,67,0,10,0,6
1,2295,2438,-143,0,492,0,6
1,2638,2445,193,0,346,0,6
1,2484,2260,224,0,201,0,8
1,2427,2365,62,0,36,1,6
1,2444,2450,-6,0,414,1,6
1,2386,2508,-122,0,43,1,6
1,2395,2449,-54,0,5,1,6
1,2402,2370,32,0,211,0,8
1,2334,2442,-108,0,335,0,6
1,2549,2468,81,0,1,0,6
1,2597,2338,259,0,5,0,6
1,2636,2411,225,0,477,0,6
1,2400,2473,-73,0,304,1,8
1,2469,2211,258,0,40,0,6
1,2465,2376,89,0,16,0,6
1,2361,2510,-149,0,106,1,6
1,2534,2448,86,0,101,0,6
1,2487,2251,236,0,11,1,6
1,2518,2509,9,0,112,0,6
1,2665,2555,110,0,53,0,6
1,2585,2317,268,0,8,1,6
1,2442,2327,115,0,145,0,6
1,2406,2358,48,0,333,1,6
1,2737,2657,80,0,301,0,6
1,2334,2411,-77,0,49,0,6
1,2557,2483,74,0,101,0,6
1,2438,2364,74,0,44,0,6
1,2306,2417,-111,0,40,0,6
1,2479,2422,57,0,7,0,6
1,2408,2280,128,0,154,1,6
1,2495,2382,113,0,17,1,6
1,2540,2497,43,0,200,0,6
1,2307,2439,-132,0,40,0,6
1,2413,2483,-70,0,57,1,6
1,2275,2438,-163,0,106,1,6
1,2421,2533,-112,0,122,0,6
1,2354,2440,-86,0,48,0,6
1,2444,2381,63,0,265,0,6
1,2431,2474,-43,0,123,0,6
1,2549,2421,128,0,30,0,6
1,2422,2477,-55,0,107,0,6
1,2540,2453,87,0,153,0,6
1,2409,2398,11,0,96,0,6
1,2259,2419,-160,0,48,0,6
1,2554,2525,29,0,454,0,6
1,2343,2434,-91,0,31,0,6
1,2506,2483,23,0,301,1,6
1,2442,2447,-5,0,43,1,6
1,2378,2471,-93,0,229,0,6
1,2543,2379,164,0,130,1,6
1,2267,2459,-192,0,127,0,8
1,2401,2383,18,0,147,1,10
1,2592,2534,58,0,0,0,6
1,2403,2479,-76,0,337,0,8
1,2306,2487,-181,0,45,0,6
1,2468,2394,74,0,10,1,6
1,2480,2474,6,0,300,0,6
1,2737,2704,33,0,315,0,6
1,2377,2441,-64,0,123,1,6
1,2419,2386,33,0,450,0,6
1,2459,2536,-77,0,130,1,6
1,2276,2454,-178,0,48,0,6
1,2480,2408,72,0,152,1,6
1,2400,2333,67,0,463,0,6
1,2479,2512,-33,0,308,0,6
1,2501,2537,-36,0,100,0,6
1,2542,2343,199,0,8,0,6
1,2650,2615,35,0,242,1,6
1,2223,2527,-304,4,302,0,13
1,2574,2578,-4,0,207,0,6
1,2455,2264,191,0,200,0,6
1,2413,2452,-39,0,46,1,6
1,2374,2550,-176,0,4,0,6
1,2441,2335,106,0,13,0,6
1,2271,2411,-140,0,44,0,6
1,2494,2456,38,0,52,1,6
1,2231,2409,-178,0,46,0,8
1,2443,2334,109,0,150,0,6
1,2460,2456,4,0,190,0,6
1,2455,2308,147,0,200,1,8
1,2415,2443,-28,0,426,0,6
1,2493,2396,97,0,44,0,6
1,2374,2417,-43,0,45,0,8
1,2373,2461,-88,0,120,0,6
1,2583,2505,78,0,405,0,6
1,2653,2286,367,0,45,0,6
1,2333,2417,-84,0,162,1,6
1,2470,2559,-89,0,337,0,6
1,2406,2266,140,0,237,0,6
1,2597,2290,307,0,0,0,6
1,2409,2390,19,0,200,1,6
1,2601,2487,114,0,191,0,6
1,2451,2316,135,0,40,0,6
1,2451,2311,140,0,97,0,6
1,2482,2328,154,0,382,0,6
1,2441,2298,143,0,205,0,6
1,2695,2561,134,0,300,0,6
1,2425,2561,-136,0,406,1,6
1,2416,2573,-157,0,490,0,6
1,2440,2350,90,0,190,0,6
1,2633,2542,91,0,143,0,6
1,2457,2556,-99,0,310,0,6
1,2493,2454,39,0,440,0,6
1,2515,2345,170,0,0,0,6
1,2367,2413,-46,0,255,0,6
1,2412,2544,-132,0,411,0,6
1,2529,2515,14,0,34,1,6
1,2538,2473,65,0,130,1,8
1,2442,2404,38,0,106,1,6
1,2559,2600,-41,0,300,0,6
1,2443,2341,102,0,130,0,6
1,2394,2410,-16,0,101,0,6
1,2508,2492,16,0,56,1,6
1,2488,2414,74,0,4,0,6
1,2408,2396,12,0,55,0,6
1,2486,2548,-62,0,242,0,6
1,2483,2519,-36,0,302,1,6
1,2502,2595,-93,0,1,1,6
1,2362,2400,-38,0,120,0,6
1,2555,2490,65,0,140,0,6
1,2575,2392,183,0,245,0,6
1,2399,2410,-11,0,36,0,6
1,2549,2644,-95,0,127,0,6
1,2475,2344,131,0,320,1,5
1,2405,2292,113,0,112,0,6
1,2454,2451,3,0,58,0,6
1,2508,2499,9,0,102,0,6
1,2505,2433,72,0,110,0,6
1,2642,2674,-32,0,0,0,6
1,2451,2528,-77,0,106,0,6
1,2410,2270,140,0,406,1,6
1,2547,2399,148,0,13,0,6
1,2486,2600,-114,0,40,0,6
1,2286,2431,-145,0,445,0,6
1,2548,2255,293,0,285,0,6
1,2576,2604,-28,0,11,0,6
1,2347,2414,-67,0,100,0,6
1,2429,2620,-191,0,0,0,6
1,2418,2357,61,0,103,0,6
1,2410,2291,119,0,103,1,6
1,2534,2599,-65,0,122,0,6
1,2431,2396,35,0,5,0,6
1,2429,2422,7,0,133,0,6
1,2456,2380,76,0,4,0,6
1,2478,2469,9,0,15,0,6
1,2360,2529,-169,0,106,1,6
1,2551,2508,43,0,10,0,6
1,2498,2475,23,0,260,0,6
1,2459,2605,-146,0,9,0,6
1,2607,2545,62,0,154,0,6
1,2421,2255,166,0,43,0,6
1,2452,2290,162,0,210,0,6
1,2486,2248,238,0,201,0,6
1,2618,2527,91,0,104,0,6
1,2470,2504,-34,0,4,0,6
1,2464,2387,77,0,43,0,6
1,2620,2522,98,0,125,0,6
1,2443,2514,-71,0,0,0,6
1,2383,2460,-77,0,218,0,6
1,2465,2402,63,0,0,0,6
1,2416,2355,61,0,211,1,6
1,2447,2319,128,0,281,0,6
1,2565,2328,237,0,123,0,6
1,2440,2243,197,0,104,1,6
1,2397,2436,-39,0,171,1,6
1,2713,2671,42,0,133,0,6
1,2460,2439,21,0,5,0,6
1,2423,2425,-2,0,123,0,6
1,2324,2494,-170,0,213,0,6
1,2464,2342,122,4,200,1,13
1,2760,2555,205,0,60,0,6
1,2541,2457,84,0,15,0,6
1,2356,2417,-61,0,4,1,6
1,2373,2508,-135,0,211,0,5
1,2541,2237,304,0,40,0,6
1,2480,2374,106,0,301,1,6
1,2480,2244,236,0,202,0,6
1,2357,2493,-136,0,300,0,6
1,2469,2298,171,0,143,0,6
1,2346,2498,-152,0,255,0,6
1,2407,2479,-72,0,190,0,6
1,2593,2449,144,4,42,0,13
1,2498,2564,-66,0,1,1,6
1,2449,2383,66,0,40,1,6
1,2567,2579,-12,0,108,0,8
1,2615,2473,142,0,200,0,6
1,2509,2380,129,0,52,0,6
1,2443,2374,69,0,1,0,6
1,2504,2316,188,0,106,0,8
1,2304,2432,-128,0,140,1,6
1,2433,2440,-7,0,311,0,6
1,2409,2265,144,0,335,0,8
1,2414,2406,8,0,113,0,6
1,2453,2494,-41,0,46,1,6
1,2439,2228,211,4,247,0,13
1,2404,2372,32,0,124,0,6
1,2422,2406,16,0,196,1,6
1,2417,2237,180,0,7,1,6
1,2408,2417,-9,0,197,0,8
1,2482,2393,89,0,241,1,6
1,2527,2401,126,0,5,0,6
1,2537,2565,-28,0,484,0,6
1,2630,2508,122,0,40,1,6
1,2435,2329,106,0,13,0,6
1,2409,2336,73,0,129,0,6
1,2358,2404,-46,0,90,0,6
1,2664,2403,261,0,16,0,6
1,2452,2257,195,0,218,0,6
1,2487,2421,66,0,3,0,6
1,2657,2551,106,0,41,0,6
1,2553,2423,130,0,405,0,6
1,2508,2402,106,0,133,0,6
1,2412,2395,17,0,127,1,6
1,2417,2382,35,0,100,1,6
1,2260,2452,-192,0,388,1,8
1,2488,2485,3,0,40,0,6
1,2468,2556,-88,0,201,0,6
1,2353,2522,-169,0,150,1,6
1,2263,2411,-148,4,245,0,13
1,2698,2505,193,0,132,0,6
1,2415,2325,90,0,123,1,6
1,2587,2614,-27,0,40,1,6
1,2439,2401,38,0,245,0,6
1,2289,2464,-175,0,106,0,6
1,2417,2392,25,0,45,0,6
1,2620,2669,-49,0,45,1,6
1,2586,2326,260,0,89,0,6
1,2461,2419,42,0,151,1,6
1,2478,2452,26,0,311,0,6
1,2488,2579,-91,0,192,0,6
1,2441,2445,-4,0,405,0,6
1,2512,2520,-8,0,4,1,6
1,2451,2221,230,0,335,0,6
1,2386,2488,-102,0,106,0,6
1,2288,2451,-163,0,115,1,8
1,2570,2297,273,0,150,0,6
1,2427,2366,61,0,0,0,8
1,2618,2663,-45,0,113,0,6
1,2460,2408,52,0,245,0,6
1,2576,2688,-112,0,28,1,6
1,2672,2603,69,0,206,0,6
1,2475,2414,61,4,0,1,13
1,2514,2481,33,0,40,1,6
1,2629,2479,150,0,355,0,6
1,2338,2430,-92,0,302,0,8
1,2599,2614,-15,0,382,0,6
1,2510,2537,-27,0,242,0,6
1,2430,2457,-27,0,200,1,6
1,2483,2375,108,0,107,0,6
1,2587,2620,-33,0,44,1,6
1,2468,2520,-52,0,110,0,6
1,2661,2443,218,0,270,0,6
1,2547,2276,271,0,300,0,6
1,2516,2263,253,0,106,0,6
1,2519,2473,46,0,110,0,6
1,2276,2428,-152,0,48,0,6
1,2400,2290,110,0,0,0,6
1,2364,2403,-39,0,118,0,6
1,2554,2244,310,0,112,1,6
1,2497,2415,82,0,8,0,8
1,2713,2695,18,0,311,0,6
1,2358,2430,-72,0,310,1,6
1,2540,2346,194,0,150,0,6
1,2509,2503,6,0,0,1,6
1,2461,2314,147,0,0,1,6
1,2541,2293,248,0,122,0,6
1,2730,2551,179,0,245,0,6
1,2360,2441,-81,0,45,0,6
1,2415,2430,-15,0,57,1,6
1,2405,2438,-33,0,45,0,6
1,2324,2412,-88,0,1,1,6
1,2450,2378,72,0,15,0,6
1,2428,2295,133,0,140,0,6
1,2375,2458,-83,0,205,0,6
1,2656,2446,210,0,45,0,6
1,2565,2607,-42,0,4,0,6
1,2448,2264,184,0,44,0,8
1,2424,2285,139,0,333,0,6
1,2388,2496,-108,0,45,1,6
1,2447,2300,147,0,260,0,6
1,2461,2503,-42,0,190,1,6
1,2497,2414,83,0,4,0,6
1,2369,2502,-133,0,87,0,6
1,2482,2483,-1,0,45,0,6
1,2561,2473,88,0,121,0,6
1,2484,2474,10,0,256,0,6
1,2455,2279,176,0,314,0,6
1,2436,2602,-166,0,320,0,6
1,2466,2430,36,0,313,0,6
1,2450,2461,-11,0,45,0,6
1,2533,2529,4,0,112,0,6
1,2453,2444,9,0,300,0,6
1,2415,2291,124,0,45,0,6
1,2425,2300,125,0,106,0,6
1,2333,2635,-302,0,104,0,6
1,2499,2341,158,0,121,0,6
1,2590,2506,84,0,414,1,6
1,2489,2392,97,0,22,0,6
1,2233,2424,-191,0,105,0,6
1,2406,2299,107,0,448,0,6
1,2420,2376,44,0,241,0,6
1,2443,2361,82,0,345,1,6
1,2550,2571,-21,0,56,0,6
1,2303,2420,-117,0,310,0,6
1,2403,2323,80,0,150,0,6
1,2462,2403,59,0,153,1,6
1,2442,2397,45,4,50,0,13
1,2675,2333,342,0,154,0,6
1,2449,2387,62,0,244,0,6
1,2542,2487,55,0,300,1,6
1,2499,2320,179,0,106,0,6
1,2275,2429,-154,0,200,0,6
1,2479,2453,26,0,250,1,6
1,2333,2417,-84,4,46,1,13
1,2424,2562,-138,0,106,1,6
1,2584,2565,19,0,7,0,6
1,2331,2430,-99,0,45,0,6
1,2508,2343,165,0,84,0,6
1,2359,2551,-192,0,300,0,6
1,2369,2462,-93,0,200,0,6
1,2421,2297,124,0,372,0,6
1,2471,2576,-105,0,101,0,6
1,2513,2522,-9,0,360,0,6
1,2655,2600,55,0,300,0,6
1,2472,2269,203,0,201,0,6
1,2409,2490,-81,0,148,0,6
1,2426,2272,154,0,8,0,6
1,2423,2316,107,0,20,0,6
1,2425,2247,178,0,302,0,6
1,2269,2440,-171,0,45,1,6
1,2370,2491,-121,0,205,0,6
1,2448,2659,-211,0,60,0,6
1,2301,2415,-114,0,113,0,6
1,2606,2592,14,0,250,0,6
1,2428,2281,147,0,108,1,6
1,2546,2437,109,0,474,0,6
1,2434,2394,40,0,184,1,6
1,2328,2407,-79,0,123,0,6
1,2554,2478,76,0,15,0,6
1,2462,2223,239,0,380,0,6
1,2541,2496,45,0,57,0,6
1,2416,2364,52,0,102,0,6
1,2498,2388,110,0,242,1,6
1,2581,2499,82,0,10,0,6
1,2528,2419,109,0,45,0,6
1,2345,2411,-66,0,310,0,6
1,2466,2496,-30,0,40,1,6
1,2613,2567,46,0,487,0,6
1,2424,2307,117,0,80,1,6
1,2423,2397,26,0,80,0,6
1,2558,2488,70,0,335,0,6
1,2528,2446,82,0,8,1,6
1,2452,2408,44,0,111,0,6
1,2449,2399,50,0,46,0,6
1,2541,2388,153,0,200,0,6
1,2581,2566,15,0,45,0,6
1,2364,2426,-62,0,487,0,6
1,2561,2485,76,0,0,0,6
1,2287,2448,-161,0,80,0,6
1,2447,2300,147,0,123,0,6
1,2480,2300,180,0,6,0,6
1,2477,2295,182,0,309,0,6
1,2460,2439,21,0,46,0,6
1,2583,2511,72,0,11,0,6
1,2390,2619,-229,0,311,0,6
1,2258,2411,-153,0,257,0,8
1,2418,2450,-32,0,4,1,6
1,2444,2456,-12,0,14,1,6
1,2438,2299,139,0,45,0,6
1,2609,2519,90,0,20,1,6
1,2406,2406,0,0,200,0,6
1,2436,2545,-109,0,16,0,6
1,2451,2421,30,0,480,0,8
1,2516,2439,77,0,49,0,6
1,2503,2527,-24,0,46,0,6
1,2392,2432,-40,0,343,1,6
1,2442,2438,4,0,128,1,6
1,2413,2283,130,0,80,1,6
1,2443,2459,-16,0,144,0,6
1,2468,2393,75,0,140,0,6
1,2255,2419,-164,0,302,0,6
1,2413,2212,201,4,404,0,8
1,2575,2576,-1,0,406,0,6
1,2511,2416,95,0,105,1,6
1,2441,2455,-14,0,132,0,6
1,2571,2508,63,0,40,0,6
1,2401,2234,167,0,343,1,6
1,2417,2409,8,0,4,1,6
1,2330,2625,-295,0,133,0,6
1,2461,2371,90,0,5,0,6
1,2337,2421,-84,0,0,1,6
1,2426,2448,-22,0,117,0,6
1,2444,2414,30,0,4,0,6
1,2482,2514,-32,0,394,0,6
1,2572,2441,131,0,202,0,6
1,2405,2342,63,0,300,0,6
1,2455,2313,142,0,108,0,6
1,2388,2496,-108,0,228,0,6
1,2439,2261,178,0,246,0,6
1,2437,2427,10,0,190,0,6
1,2697,2497,200,0,260,0,6
1,2411,2287,124,0,382,0,6
1,2463,2403,60,0,102,0,6
1,2271,2410,-139,0,241,0,6
1,2490,2385,105,0,187,0,6
1,2445,2540,-95,0,242,1,6
1,2490,2410,80,0,7,0,6
1,2487,2354,133,0,16,0,6
1,2545,2212,333,0,106,0,6
1,2430,2361,69,0,231,0,6
1,2492,2205,287,0,52,0,6
1,2452,2287,165,0,470,0,6
1,2432,2523,-91,0,106,0,6
1,2455,2286,169,0,140,0,6
1,2431,2274,157,0,7,0,6
1,2494,2612,-118,0,45,0,6
1,2240,2403,-163,0,453,1,6
1,2438,2355,83,0,106,0,6
1,2510,2219,291,0,315,1,6
1,2457,2483,-26,0,15,0,6
1,2544,2455,89,0,246,0,6
1,2516,2503,13,0,118,1,6
1,2501,2419,82,0,190,1,6
1,2658,2210,448,0,106,0,6
1,2592,2655,-63,0,112,1,6
1,2416,2551,-135,0,107,0,6
1,2771,2291,480,0,150,0,6
1,2402,2277,125,0,337,0,6
1,2551,2382,169,0,7,1,6
1,2523,2399,124,0,170,0,6
1,2477,2344,133,0,223,0,6
1,2553,2481,72,0,151,1,6
1,2430,2389,41,0,260,0,6
1,2463,2421,42,0,127,0,6
1,2476,2486,-10,0,15,0,6
1,2719,2594,125,0,4,1,6
1,2432,2468,-36,0,131,1,6
1,2420,2264,156,0,38,0,8
1,2389,2420,-31,0,195,0,6
1,2429,2441,-12,0,106,0,6
1,2487,2277,210,0,130,0,6
1,2389,2481,-92,0,0,1,6
1,2406,2257,149,0,104,0,6
1,2570,2403,167,0,0,1,6
1,2510,2536,-26,0,302,1,6
1,2554,2436,118,0,7,0,6
1,2420,2242,178,0,70,0,6
1,2272,2421,-149,0,115,0,6
1,2618,2665,-47,0,112,0,6
1,2471,2448,23,0,200,1,6
1,2426,2313,113,0,108,0,6
1,2617,2532,85,0,491,1,6
1,2561,2632,-71,0,45,0,6
1,2413,2364,49,0,2,1,6
1,2455,2405,50,0,284,0,6
1,2486,2486,0,0,108,0,6
1,2377,2467,-90,0,149,0,6
1,2404,2405,-1,0,331,0,6
1,2496,2440,56,0,289,0,6
1,2454,2540,-86,0,106,0,6
1,2481,2511,-30,0,100,0,6
1,2729,2202,527,0,240,0,6
1,2616,2481,135,0,122,0,6
1,2491,2623,-132,0,255,0,6
1,2479,2526,-47,0,105,0,6
1,2469,2537,-68,0,46,1,6
1,2477,2364,113,0,326,0,6
1,2448,2459,-11,0,190,1,6
1,2553,2424,129,0,200,0,6
1,2419,2352,67,0,4,0,6
1,2472,2405,67,0,414,0,6
1,2372,2457,-85,0,463,0,6
1,2403,2342,61,0,352,0,6
1,2411,2338,73,0,453,0,6
1,2304,2446,-142,0,332,1,6
1,2447,2494,-47,0,302,0,6
1,2636,2358,278,0,278,0,8
1,2433,2289,144,0,10,0,6
1,2428,2277,151,0,253,0,6
1,2525,2388,137,0,4,0,6
1,2427,2402,25,0,106,0,6
1,2301,2432,-131,0,302,0,6
1,2255,2415,-160,0,300,0,6
1,2624,2627,-3,0,110,0,6
1,2340,2495,-155,0,1,0,6
1,2437,2382,55,0,14,0,6
1,2418,2358,60,0,43,1,6
1,2401,2412,-11,0,49,1,6
1,2455,2460,-5,0,321,0,6
1,2600,2533,67,0,337,0,6
1,2400,2382,18,0,111,1,6
1,2340,2461,-121,0,28,0,6
1,2418,2426,-8,0,344,0,6
1,2446,2436,10,0,88,1,6
1,2503,2436,67,0,302,0,6
1,2438,2272,166,0,90,0,6
1,2410,2460,-50,0,314,1,6
1,2445,2566,-121,0,224,1,6
1,2506,2548,-42,0,46,0,6
1,2638,2553,85,0,345,1,6
1,2540,2486,54,0,104,0,6
1,2477,2471,6,0,256,1,6
1,2459,2287,172,0,0,0,6
1,2507,2564,-57,0,302,1,6
1,2636,2674,-38,0,101,0,6
1,2277,2419,-142,0,113,1,6
1,2416,2321,95,0,4,0,8
1,2421,2382,39,0,106,0,6
1,2234,2515,-281,0,264,0,6
1,2470,2458,12,0,45,0,6
1,2457,2378,79,0,147,1,6
1,2448,2402,46,0,4,0,6
1,2444,2262,182,0,102,0,6
1,2492,2467,25,0,310,0,6
1,2478,2435,43,0,110,0,6
1,2525,2212,313,0,411,0,6
1,2534,2406,128,0,4,0,6
1,2373,2460,-87,0,5,1,6
1,2449,2370,79,0,145,0,6
1,2424,2377,47,0,104,1,6
1,2578,2526,52,0,3,0,6
1,2293,2446,-153,0,145,0,6
1,2368,2453,-85,0,405,0,6
1,2544,2446,98,0,40,0,6
1,2571,2341,230,0,13,0,6
1,2522,2241,281,0,45,0,6
1,2351,2459,-108,0,45,0,6
1,2548,2532,16,0,222,0,6
1,2430,2479,-49,0,337,0,6
1,2411,2244,167,0,110,0,10
1,2466,2204,262,0,453,0,6
1,2382,2447,-65,0,409,0,6
1,2681,2557,124,0,122,0,6
1,2521,2526,-5,0,121,0,6
1,2527,2371,156,0,2,0,6
1,2459,2338,121,0,115,1,6
1,2416,2564,-148,0,104,0,6
1,2474,2346,128,0,124,0,6
1,2414,2413,1,0,248,0,6
1,2381,2419,-38,0,300,1,6
1,2429,2401,28,0,133,0,6
1,2427,2381,46,0,4,0,6
1,2414,2510,-96,0,436,1,6
1,2255,2414,-159,0,463,1,6
1,2513,2561,-48,0,404,0,6
1,2413,2466,-53,0,61,1,6
1,2415,2273,142,0,4,0,6
1,2462,2319,143,0,248,0,6
1,2370,2499,-129,0,200,1,6
1,2384,2428,-44,0,117,1,6
1,2404,2339,65,0,62,0,6
1,2402,2248,154,0,406,1,8
1,2411,2440,-29,0,207,0,8
1,2439,2406,33,0,300,0,6
1,2586,2564,22,0,1,0,6
1,2241,2402,-161,0,154,0,6
1,2427,2406,21,0,107,0,6
1,2495,2525,-30,0,6,0,6
1,2633,2426,207,0,140,0,6
1,2455,2535,-80,0,150,0,6
1,2453,2315,138,0,123,1,6
1,2371,2450,-79,0,219,0,8
1,2410,2348,62,0,487,1,6
1,2441,2352,89,0,226,0,6
1,2415,2316,99,0,120,1,8
1,2508,2326,182,0,105,1,6
1,2291,2407,-116,0,101,0,6
1,2564,2382,182,0,49,0,6
1,2402,2412,-10,0,58,0,6
1,2679,2492,187,0,106,1,6
1,2608,2278,330,0,488,0,8
1,2423,2272,151,0,464,0,8
1,2441,2322,119,0,48,0,6
1,2523,2301,222,0,302,0,6
1,2351,2409,-58,0,151,0,6
1,2250,2417,-167,0,5,1,6
1,2787,2662,125,0,15,0,6
1,2701,2611,90,0,202,0,6
1,2515,2226,289,0,13,1,6
1,2327,2437,-110,0,190,0,6
1,2408,2529,-121,0,320,0,6
1,2432,2229,203,0,28,0,6
1,2414,2428,-14,0,254,1,8
1,2240,2405,-165,0,343,1,6
1,2504,2410,94,0,52,0,6
1,2520,2363,157,0,37,0,6
1,2455,2427,28,0,255,0,6
1,2473,2553,-80,0,49,1,6
1,2331,2451,-120,0,306,0,6
1,2457,2350,107,0,300,0,6
1,2430,2437,-7,0,405,1,6
1,2536,2642,-106,0,190,0,6
1,2373,2454,-81,0,4,0,6
1,2342,2440,-98,0,11,0,8
1,2419,2335,84,0,302,0,6
1,2458,2500,-42,0,48,0,6
1,2430,2410,20,0,100,1,6
1,2451,2343,108,0,6,1,6
1,2451,2411,40,0,101,0,6
1,2481,2401,80,0,111,1,6
1,2578,2563,15,0,30,0,6
1,2423,2452,-29,0,211,1,6
1,2494,2338,156,0,0,0,6
1,2526,2237,289,0,101,0,6
1,2425,2591,-166,0,101,0,6
1,2331,2453,-122,0,300,0,6
1,2456,2501,-45,0,125,1,6
1,2478,2404,74,0,40,1,6
1,2634,2421,213,0,331,1,6
1,2407,2232,175,0,311,1,6
1,2316,2426,-110,0,277,0,6
1,2418,2331,87,0,307,0,6
1,2428,2275,153,0,400,1,6
1,2330,2400,-70,0,20,1,6
1,2434,2331,103,0,112,1,6
1,2411,2473,-62,0,30,0,6
1,2408,2458,-50,0,108,0,6
1,2411,2459,-48,0,123,1,6
1,2517,2348,169,0,4,0,6
1,2416,2358,58,0,115,1,6
1,2543,2417,126,0,103,0,6
1,2277,2453,-176,0,4,0,6
1,2429,2379,50,0,45,0,6
1,2451,2325,126,0,7,0,6
1,2407,2316,91,0,103,0,6
1,2263,2566,-303,0,46,0,6
1,2275,2424,-149,0,140,0,6
1,2422,2376,46,0,339,0,6
1,2569,2235,334,0,103,0,6
1,2402,2286,116,4,122,0,13
1,2462,2289,173,0,405,0,6
1,2497,2414,83,0,1,0,6
1,2537,2440,97,0,406,0,6
1,2380,2401,-21,0,300,0,6
1,2570,2204,366,0,101,0,6
1,2286,2413,-127,0,120,0,6
1,2271,2418,-147,0,45,0,6
1,2448,2415,33,0,40,0,6
1,2291,2418,-127,0,193,0,6
1,2315,2515,-200,0,409,0,6
1,2357,2474,-117,0,15,0,6
1,2478,2365,113,0,40,1,6
1,2395,2444,-49,0,296,0,6
1,2411,2427,-16,0,132,0,6
1,2620,2478,142,0,17,0,6
1,2483,2579,-96,0,424,0,6
1,2476,2476,0,0,278,0,6
1,2435,2468,-33,0,101,0,6
1,2628,2301,327,0,107,0,8
1,2519,2483,36,0,453,0,6
1,2447,2408,39,0,118,0,6
1,2503,2585,-82,0,253,0,6
1,2474,2412,62,0,45,0,6
1,2452,2308,144,0,110,0,6
1,2421,2485,-64,0,315,1,6
1,2400,2491,-91,0,40,0,6
1,2447,2529,-82,0,104,0,6
1,2452,2387,65,0,101,0,6
1,2528,2362,166,0,145,0,6
1,2541,2612,-71,0,115,0,6
1,2468,2376,92,0,30,0,6
1,2528,2426,102,0,344,1,6
1,2435,2372,63,0,150,0,6
1,2483,2375,108,0,211,0,6
1,2768,2682,86,0,352,1,6
1,2304,2421,-117,0,200,0,6
1,2298,2452,-154,0,190,0,6
1,2415,2354,61,0,376,0,6
1,2304,2474,-170,0,202,0,6
1,2440,2375,65,0,133,0,6
1,2535,2217,318,0,45,1,6
1,2375,2409,-34,0,200,0,6
1,2430,2503,-73,0,413,0,5
1,2374,2432,-58,0,310,1,6
1,2513,2475,38,0,267,0,6
1,2558,2493,65,0,45,0,6
1,2421,2404,17,0,43,0,6
1,2525,2408,117,0,25,0,6
1,2422,2325,97,0,11,0,6
1,2430,2389,41,0,243,0,6
1,2368,2506,-138,0,311,0,6
1,2357,2410,-53,0,11,1,6
1,2449,2318,131,0,45,0,6
1,2411,2295,116,0,41,0,6
1,2410,2502,-92,0,4,1,6
1,2724,2715,9,0,404,0,6
1,2453,2310,143,4,101,0,13
1,2478,2350,128,0,190,1,6
1,2425,2482,-57,0,202,0,6
1,2696,2514,182,0,6,0,6
1,2482,2504,-22,0,102,0,6
1,2579,2576,3,0,194,0,6
1,2386,2431,-45,0,15,1,6
1,2544,2484,60,0,112,0,6
1,2726,2592,134,0,216,0,6
1,2474,2532,-58,0,42,0,6
1,2361,2487,-126,0,42,0,6
1,2394,2421,-27,0,4,0,6
1,2422,2443,-21,0,45,0,6
1,2418,2409,9,0,218,1,6
1,2432,2398,34,0,201,0,6
1,2335,2501,-166,0,331,0,8
1,2405,2334,71,0,133,1,6
1,2654,2547,107,0,31,0,6
1,2431,2526,-95,0,469,0,6
1,2453,2247,206,0,44,0,5
1,2386,2436,-50,0,0,0,6
1,2522,2354,168,0,80,0,6
1,2307,2451,-144,0,107,1,8
1,2424,2280,144,0,306,0,6
1,2395,2440,-45,0,302,1,6
1,2426,2396,30,0,214,0,6
1,2697,2402,295,0,134,0,6
1,2547,2557,-10,0,4,0,6
1,2395,2430,-35,0,253,0,6
1,2403,2346,57,0,131,1,6
1,2417,2358,59,0,111,1,6
1,2448,2454,-6,0,246,0,6
1,2432,2573,-141,0,3,0,6
1,2488,2517,-29,0,301,0,6
1,2439,2461,-22,0,394,0,6
1,2413,2441,-28,0,130,1,6
1,2555,2581,-26,0,9,0,6
1,2449,2536,-87,0,102,0,6
1,2449,2450,-1,0,9,0,6
1,2507,2653,-146,0,46,1,6
1,2419,2432,-13,0,112,0,6
1,2676,2504,172,0,144,0,6
1,2415,2356,59,0,122,0,6
1,2481,2572,-91,0,490,0,6
1,2446,2457,-11,0,309,1,6
1,2437,2498,-61,0,159,0,6
1,2400,2301,99,0,418,0,6
1,2525,2339,186,0,125,1,6
1,2490,2355,135,0,46,0,6
1,2407,2341,66,0,1,1,6
1,2712,2776,-64,0,211,0,6
1,2216,2436,-220,0,190,1,5
1,2621,2713,-92,0,302,1,6
1,2360,2417,-57,0,263,0,6
1,2469,2389,80,0,4,0,6
1,2439,2309,130,0,46,1,6
1,2537,2386,151,0,453,0,6
1,2422,2221,201,0,150,1,8
1,2431,2331,100,0,205,0,6
1,2574,2277,297,0,318,0,8
1,2418,2319,99,0,462,0,6
1,2450,2345,105,0,466,1,6
1,2315,2428,-113,0,5,0,6
1,2396,2427,-31,0,118,0,6
1,2430,2281,149,0,200,0,6
1,2483,2317,166,0,4,1,6
1,2272,2509,-237,0,117,0,6
1,2394,2420,-26,0,200,0,6
1,2448,2411,37,0,121,0,6
1,2463,2348,115,0,140,0,6
1,2411,2455,-44,0,294,0,6
1,2413,2426,-13,0,253,0,6
1,2516,2364,152,0,331,0,6
1,2643,2555,88,0,311,0,6
1,2449,2297,152,0,27,1,6
1,2485,2283,202,0,113,0,6
1,2510,2387,123,0,113,0,6
1,2409,2421,-12,0,309,0,6
1,2410,2310,100,0,2,1,6
1,2475,2368,107,0,202,0,6
1,2461,2338,123,0,45,0,6
1,2421,2439,-18,0,270,1,6
1,2340,2401,-61,0,269,1,6
1,2533,2550,-17,0,398,1,6
1,2629,2581,48,0,45,0,6
1,2527,2371,156,0,13,1,6
1,2438,2304,134,0,305,1,6
1,2517,2547,-30,0,40,1,6
1,2216,2454,-238,0,100,0,6
1,2534,2425,109,0,10,1,6
1,2456,2376,80,0,41,1,6
1,2503,2329,174,0,300,0,6
1,2340,2419,-79,0,49,0,6
1,2546,2483,63,0,151,0,6
1,2407,2246,161,0,300,0,6
1,2277,2501,-224,0,1,0,6
1,2437,2278,159,0,474,0,6
1,2365,2411,-46,0,426,1,6
1,2343,2409,-66,4,344,1,13
1,2490,2525,-35,0,4,1,6
1,2436,2393,43,0,258,0,6
1,2390,2534,-144,0,3,1,6
1,2418,2233,185,0,302,0,6
1,2406,2269,137,0,455,1,6
1,2456,2284,172,0,71,0,6
1,2563,2458,105,0,311,0,6
1,2430,2386,44,0,1,0,6
1,2407,2307,100,4,301,0,13
1,2480,2601,-121,0,359,0,6
1,2452,2512,-60,0,129,0,6
1,2563,2503,60,0,1,0,6
1,2629,2314,315,0,490,0,6
1,2422,2410,12,0,114,0,6
1,2801,2502,299,0,145,1,6
1,2345,2403,-58,0,40,0,6
1,2458,2452,6,0,160,0,6
1,2264,2516,-252,0,107,1,6
1,2453,2471,-18,0,45,0,6
1,2436,2457,-21,0,307,0,6
1,2297,2413,-116,0,49,0,6
1,2630,2512,118,0,22,0,6
1,2471,2417,54,0,13,1,6
1,2449,2414,35,0,110,1,6
1,2327,2443,-116,0,208,1,6
1,2504,2525,-21,0,124,0,6
1,2431,2468,-37,0,115,0,6
1,2579,2358,221,0,46,0,6
1,2369,2423,-54,0,248,0,6
1,2482,2416,66,0,132,0,6
1,2721,2496,225,0,112,0,6
1,2419,2254,165,0,199,0,6
1,2405,2257,148,0,100,0,8
1,2443,2552,-109,0,381,0,6
1,2533,2483,50,0,4,0,6
1,2418,2494,-76,0,130,1,6
1,2444,2342,102,0,302,0,6
1,2563,2360,203,0,28,0,6
1,2336,2484,-148,0,310,0,6
1,2380,2492,-112,0,196,0,6
1,2435,2307,128,0,253,0,6
1,2523,2578,-55,0,15,0,6
1,2513,2397,116,0,394,0,6
1,2509,2392,117,0,302,0,6
1,2478,2469,9,0,112,0,6
1,2291,2429,-138,0,40,0,6
1,2468,2631,-163,0,110,1,6
1,2370,2418,-48,0,216,1,6
1,2307,2497,-190,0,205,0,6
1,2431,2273,158,0,43,0,6
1,2377,2457,-80,0,474,0,6
1,2429,2461,-32,0,81,0,6
1,2484,2468,16,0,70,1,6
1,2240,2558,-318,0,106,0,6
1,2451,2460,-9,0,45,0,6
1,2426,2328,98,0,305,1,6
1,2405,2550,-145,0,440,0,6
1,2255,2415,-160,0,111,0,6
1,2506,2352,154,0,15,0,6
1,2413,2389,24,0,442,0,6
1,2319,2406,-87,0,4,0,6
1,2400,2413,-13,0,5,0,6
1,2527,2488,39,0,5,0,6
1,2652,2649,3,0,307,0,6
1,2613,2432,181,0,131,0,6
1,2393,2425,-32,0,315,0,6
1,2431,2302,129,0,485,0,6
1,2714,2621,93,0,10,1,6
1,2522,2362,160,0,405,0,6
1,2583,2601,-18,0,337,0,6
1,2298,2417,-119,0,40,1,6
1,2520,2402,118,0,241,1,6
1,2443,2248,195,0,41,0,6
1,2432,2675,-243,0,122,1,6
1,2411,2437,-26,0,120,0,6
1,2571,2398,173,0,45,0,6
1,2369,2508,-139,0,265,0,6
1,2349,2530,-181,0,300,0,6
1,2510,2640,-130,0,106,0,6
1,2465,2452,13,0,10,1,6
1,2455,2457,-2,0,58,0,6
1,2286,2421,-135,0,246,0,6
1,2538,2481,57,0,5,0,6
1,2430,2439,-9,0,13,1,6
1,2544,2233,311,0,176,0,6
1,2353,2416,-63,0,4,1,6
1,2560,2646,-86,0,469,0,6
1,2393,2412,-19,0,8,0,6
1,2456,2568,-112,0,216,1,6
1,2490,2342,148,0,277,0,6
1,2401,2510,-109,0,150,1,6
1,2311,2404,-93,0,113,0,6
1,2424,2437,-13,0,331,0,6
1,2542,2483,59,0,315,0,6
1,2424,2432,-8,0,300,0,6
1,2451,2321,130,0,45,1,6
1,2553,2304,249,0,20,1,6
1,2497,2290,207,0,0,0,6
1,2600,2404,196,0,245,1,6
1,2400,2402,-2,0,455,0,6
1,2436,2449,-13,0,57,0,6
1,2475,2377,98,0,133,0,5
1,2440,2381,59,0,220,1,6
1,2406,2271,135,0,221,0,6
1,2203,2458,-255,0,140,0,6
1,2448,2398,50,0,200,1,6
1,2404,2438,-34,0,122,0,6
1,2498,2243,255,0,469,0,6
1,2491,2452,39,0,300,0,6
1,2605,2341,264,0,15,0,6
1,2467,2464,3,0,49,0,6
1,2449,2395,54,0,89,0,6
1,2493,2267,226,0,348,0,6
1,2436,2381,55,0,107,0,6
1,2487,2283,204,0,210,0,6
1,2438,2346,92,0,123,0,6
1,2468,2338,130,0,170,0,5
1,2411,2386,25,0,320,0,6
1,2426,2392,34,0,7,1,6
1,2458,2433,25,0,241,0,6
1,2548,2440,108,0,41,0,6
1,2453,2516,-63,0,302,0,6
1,2404,2297,107,0,45,0,6
1,2587,2627,-40,0,3,0,6
1,2511,2330,181,0,115,0,6
1,2598,2679,-81,0,150,0,6
1,2602,2562,40,0,190,0,6
1,2501,2429,72,0,132,0,6
1,2414,2490,-76,0,10,0,6
1,2397,2427,-30,0,400,1,6
1,2578,2463,115,0,117,0,6
1,2449,2305,144,0,253,0,6
1,2425,2352,73,0,202,1,6
1,2440,2337,103,0,104,0,6
1,2567,2233,334,4,235,0,13
1,2600,2508,92,0,1,0,6
1,2534,2528,6,0,152,0,6
1,2456,2440,16,0,46,1,6
1,2375,2414,-39,0,113,0,6
1,2442,2456,-14,0,150,0,6
1,2436,2422,14,0,1,1,6
1,2406,2401,5,0,202,0,6
1,2584,2593,-9,0,4,0,6
1,2321,2412,-91,0,470,1,6
1,2429,2297,132,0,241,0,6
1,2439,2457,-18,0,241,1,6
1,2496,2404,92,0,200,0,6
1,2509,2368,141,0,150,0,6
1,2467,2225,242,0,335,0,6
1,2375,2403,-28,0,1,0,6
1,2434,2388,46,0,151,0,6
1,2425,2319,106,0,330,0,6
1,2422,2378,44,0,132,0,6
1,2520,2530,-10,0,0,0,6
1,2412,2379,33,0,13,0,6
1,2533,2547,-14,0,125,1,6
1,2337,2433,-96,0,260,0,6
1,2459,2472,-13,0,400,1,6
1,2444,2327,117,0,337,0,6
1,2665,2549,116,0,42,0,6
1,2496,2559,-63,0,101,0,6
1,2386,2430,-44,0,8,0,6
1,2449,2276,173,0,100,1,8
1,2477,2333,144,0,4,0,6
1,2475,2444,31,0,46,0,6
1,2419,2446,-27,0,106,0,6
1,2474,2332,142,0,110,1,6
1,2500,2422,78,0,150,1,6
1,2278,2456,-178,0,385,0,6
1,2527,2451,76,0,108,1,6
1,2574,2323,251,0,61,0,6
1,2583,2683,-100,0,152,1,6
1,2566,2438,128,0,109,0,6
1,2488,2299,189,0,88,1,6
1,2552,2316,236,0,46,0,6
1,2376,2438,-62,0,302,0,6
1,2417,2377,40,0,267,0,6
1,2238,2438,-200,0,15,0,6
1,2428,2365,63,0,31,0,6
1,2492,2317,175,0,110,1,6
1,2413,2370,43,0,43,1,6
1,2438,2358,80,0,40,0,6
1,2537,2343,194,0,205,0,6
1,2517,2367,150,0,455,1,6
1,2466,2379,87,0,487,0,6
1,2239,2410,-171,0,46,0,6
1,2418,2420,-2,0,105,0,6
1,2432,2470,-38,0,151,0,6
1,2457,2459,-2,0,40,0,6
1,2406,2375,31,0,8,0,6
1,2465,2345,120,4,344,0,0
1,2430,2457,-27,0,46,1,6
1,2617,2437,180,0,103,0,6
1,2361,2410,-49,0,20,0,6
1,2368,2531,-163,0,7,0,6
1,2493,2490,3,0,100,0,5
1,2600,2457,143,0,101,0,6
1,2431,2298,133,0,1,0,6
1,2455,2522,-67,0,133,1,6
1,2507,2328,179,0,135,0,6
1,2422,2419,3,0,106,0,6
1,2499,2316,183,0,409,1,6
1,2555,2421,134,0,335,0,6
1,2329,2521,-192,0,245,1,6
1,2561,2601,-40,0,409,0,6
1,2390,2425,-35,0,21,0,6
1,2482,2448,34,0,454,0,6
1,2494,2531,-37,0,36,1,6
1,2424,2444,-20,0,270,1,6
1,2438,2397,41,0,454,1,6
1,2478,2572,-94,0,193,0,6
1,2518,2490,28,0,100,0,6
1,2359,2410,-51,0,300,0,6
1,2474,2341,133,0,453,0,6
1,2487,2473,14,0,107,1,6
1,2459,2398,61,0,45,1,6
1,2595,2620,-25,0,101,0,6
1,2431,2411,20,0,345,1,6
1,2370,2525,-155,0,232,0,6
1,2398,2409,-11,0,460,0,6
1,2429,2361,68,0,242,0,6
1,2416,2284,132,0,4,1,6
1,2466,2452,14,0,28,0,6
1,2485,2383,102,0,386,0,6
1,2402,2406,-4,0,4,0,6
1,2435,2440,-5,0,0,0,6
1,2636,2581,55,0,345,0,6
1,2536,2589,-53,0,400,0,6
1,2421,2411,10,0,101,0,6
1,2458,2346,112,0,45,1,6
1,2521,2478,43,0,108,0,6
1,2541,2363,178,0,50,0,6
1,2575,2592,-17,0,106,0,6
1,2365,2404,-39,0,2,1,6
1,2409,2405,4,0,18,1,6
1,2464,2445,19,0,2,0,6
1,2523,2444,79,0,45,0,6
1,2481,2257,224,0,400,0,5
1,2424,2221,203,0,63,1,6
1,2394,2484,-90,0,200,1,6
1,2407,2396,11,0,0,0,6
1,2406,2212,194,0,45,0,6
1,2423,2334,89,0,4,1,6
1,2387,2442,-55,0,132,1,6
1,2395,2475,-80,0,4,0,6
1,2434,2324,110,0,49,0,6
1,2461,2378,83,0,0,0,6
1,2430,2467,-37,0,190,0,6
1,2402,2553,-151,0,46,0,6
1,2689,2590,99,0,61,0,6
1,2416,2250,166,0,145,1,8
1,2621,2484,137,0,380,1,6
1,2465,2316,149,0,206,0,6
1,2433,2365,68,0,107,0,6
1,2617,2561,56,0,103,0,6
1,2316,2476,-160,0,344,0,6
1,2482,2217,265,0,302,0,6
1,2662,2462,200,0,104,0,6
1,2563,2491,72,0,132,0,6
1,2632,2632,0,0,116,0,6
1,2502,2426,76,0,330,0,6
1,2556,2233,323,0,48,0,6
1,2476,2426,50,0,115,0,6
1,2448,2290,158,0,46,0,6
1,2494,2223,271,0,202,1,6
1,2458,2454,4,0,114,0,6
1,2387,2404,-17,0,4,1,6
1,2554,2531,23,0,181,1,6
1,2478,2487,-9,0,143,0,6
1,2380,2446,-66,0,113,0,6
1,2451,2497,-46,0,415,0,6
1,2297,2474,-177,0,17,0,6
1,2515,2515,0,0,414,0,6
1,2405,2275,130,4,175,0,10
1,2435,2464,-29,0,115,0,6
1,2358,2409,-51,0,128,0,6
1,2536,2418,118,0,404,0,6
1,2480,2428,52,0,40,0,6
1,2620,2654,-34,0,331,0,6
1,2580,2517,63,0,101,0,6
1,2409,2326,83,0,113,0,6
1,2307,2444,-137,0,6,0,6
1,2381,2464,-83,0,45,0,6
1,2499,2296,203,0,190,0,6
1,2398,2443,-45,0,250,0,6
1,2500,2367,133,0,347,0,6
1,2469,2307,162,0,4,0,6
1,2556,2532,24,0,270,1,6
1,2417,2395,22,0,140,0,6
1,2610,2559,51,0,202,0,6
1,2446,2535,-89,0,41,0,6
1,2420,2285,135,0,123,1,6
1,2341,2445,-104,0,45,0,6
1,2510,2536,-26,0,182,1,6
1,2389,2490,-101,0,134,0,6
1,2515,2567,-52,0,106,0,6
1,2503,2292,211,0,113,0,5
1,2565,2415,150,0,17,0,6
1,2544,2616,-72,0,300,0,6
1,2276,2435,-159,0,101,0,8
1,2311,2471,-160,0,46,0,6
1,2502,2414,88,0,16,0,6
1,2546,2540,6,0,6,1,6
1,2439,2306,133,0,160,0,6
1,2339,2460,-121,0,18,0,6
1,2477,2374,103,0,441,0,6
1,2468,2421,47,0,40,0,6
1,2576,2433,143,0,10,1,6
1,2530,2559,-29,0,309,0,6
1,2313,2453,-140,0,311,0,6
1,2446,2274,172,0,8,0,6
1,2425,2328,97,0,44,0,6
1,2459,2405,54,0,255,0,6
1,2803,2783,20,0,45,0,6
1,2577,2602,-25,0,243,0,6
1,2505,2559,-54,0,230,0,6
1,2336,2428,-92,0,315,1,6
1,2565,2448,117,0,56,1,6
1,2585,2404,181,0,4,0,6
1,2472,2424,48,0,347,0,6
1,2376,2492,-116,0,123,0,6
1,2593,2511,82,0,0,0,6
1,2388,2431,-43,0,253,0,6
1,2604,2685,-81,0,140,1,6
1,2242,2410,-168,0,190,0,8
1,2453,2272,181,0,131,1,8
1,2393,2405,-12,0,255,0,6
1,2438,2409,29,0,127,0,6
1,2608,2524,84,0,106,0,6
1,2371,2415,-44,0,100,1,6
1,2549,2634,-85,0,190,0,6
1,2519,2345,174,0,128,0,6
1,2461,2554,-93,0,46,0,6
1,2329,2412,-83,0,485,0,6
1,2411,2379,32,0,41,0,6
1,2534,2584,-50,0,101,0,6
1,2563,2559,4,0,0,0,6
1,2546,2737,-191,0,205,1,6
1,2474,2475,-1,0,45,0,6
1,2487,2483,4,0,106,0,6
1,2485,2293,192,0,10,0,5
1,2429,2410,19,0,103,0,6
1,2339,2442,-103,0,40,0,6
1,2459,2424,35,0,143,1,6
1,2369,2441,-72,0,217,0,6
1,2385,2449,-64,0,102,0,6
1,2441,2482,-41,0,345,1,6
1,2488,2403,85,0,241,0,6
1,2730,2637,93,0,487,0,6
1,2416,2428,-12,0,301,0,6
1,2499,2366,133,0,100,1,6
1,2339,2498,-159,0,152,1,6
1,2410,2380,30,0,301,0,6
1,2386,2458,-72,0,132,0,6
1,2515,2515,0,0,0,1,6
1,2322,2414,-92,0,122,0,6
1,2531,2419,112,0,40,0,6
1,2310,2403,-93,0,373,1,6
1,2429,2270,159,0,200,0,6
1,2411,2297,114,0,201,0,6
1,2491,2375,116,0,315,0,6
1,2450,2561,-111,0,175,0,6
1,2413,2387,26,0,41,0,6
1,2319,2410,-91,4,11,0,13
1,2603,2270,333,0,326,0,6
1,2408,2288,120,0,5,0,8
1,2442,2338,104,0,15,0,6
1,2570,2368,202,0,225,1,6
1,2523,2348,175,0,163,0,6
1,2392,2418,-26,0,426,0,6
1,2447,2391,56,0,343,0,6
1,2490,2558,-68,0,380,0,6
1,2566,2431,135,0,202,1,6
1,2412,2397,15,0,157,1,6
1,2407,2295,112,0,462,0,6
1,2454,2442,12,0,123,0,6
1,2437,2403,34,0,300,0,6
1,2475,2332,143,0,46,1,6
1,2412,2385,27,0,216,0,6
1,2512,2500,12,0,104,0,6
1,2598,2665,-67,0,460,0,6
1,2408,2352,56,0,15,0,8
1,2497,2491,6,0,43,1,6
1,2444,2429,15,0,408,0,6
1,2490,2313,177,0,332,0,6
1,2448,2435,13,0,411,0,6
1,2422,2225,197,0,156,1,6
1,2456,2426,30,0,106,0,6
1,2502,2322,180,0,4,0,8
1,2458,2439,19,0,111,1,6
1,2400,2526,-126,0,300,0,6
1,2566,2465,101,0,250,0,6
1,2527,2522,5,0,106,0,6
1,2414,2356,58,0,410,1,6
1,2597,2569,28,0,338,1,6
1,2448,2379,69,0,331,0,6
1,2497,2379,118,0,200,0,6
1,2408,2340,68,0,302,0,6
1,2581,2558,23,0,300,0,6
1,2420,2557,-137,0,388,1,6
1,2356,2424,-68,0,4,0,6
1,2274,2413,-139,0,260,1,6
1,2413,2361,52,0,246,0,6
1,2402,2275,127,0,211,1,6
1,2422,2365,57,0,453,0,6
1,2534,2387,147,0,236,0,6
1,2510,2507,3,0,46,1,6
1,2419,2406,13,0,241,0,6
1,2538,2433,105,0,242,0,6
1,2417,2407,10,0,0,0,6
1,2325,2410,-85,0,130,0,6
1,2518,2489,29,0,1,0,6
1,2266,2437,-171,0,122,0,6
1,2290,2452,-162,0,120,0,6
1,2271,2446,-175,0,394,0,6
1,2400,2245,155,0,101,0,6
1,2459,2284,175,0,301,0,6
1,2410,2378,32,0,333,0,6
1,2451,2227,224,0,4,1,6
1,2463,2399,64,0,211,0,6
1,2318,2450,-132,0,45,0,5
1,2447,2446,1,0,148,0,6
1,2577,2469,108,0,102,0,6
1,2402,2413,-11,0,8,0,6
1,2250,2457,-207,0,420,0,6
1,2531,2547,-16,0,153,0,6
1,2433,2280,153,0,102,0,6
1,2415,2315,100,0,122,0,6
1,2432,2440,-8,0,476,1,6
1,2684,2526,158,0,0,0,6
1,2579,2473,106,0,300,0,6
1,2333,2419,-86,0,1,0,6
1,2240,2488,-248,0,40,0,6
1,2461,2501,-40,0,265,0,6
1,2413,2471,-58,0,203,1,6
1,2483,2463,20,0,125,0,6
1,2394,2426,-32,0,1,0,6
1,2458,2443,15,0,310,0,6
1,2357,2404,-47,0,58,0,8
1,2406,2334,72,0,352,1,6
1,2433,2356,77,0,102,0,6
1,2562,2418,144,0,241,0,6
1,2474,2419,55,0,8,0,6
1,2695,2713,-18,0,106,0,6
1,2401,2402,-1,0,459,0,6
1,2283,2532,-249,0,110,0,6
1,2423,2433,-10,0,406,0,6
1,2347,2485,-138,0,202,1,6
1,2433,2430,3,0,45,0,6
1,2334,2442,-108,0,106,0,6
1,2437,2435,2,0,49,1,6
1,2304,2417,-113,0,202,0,6
1,2512,2352,160,0,128,0,6
1,2413,2516,-103,0,45,0,6
1,2413,2290,123,0,305,0,6
1,2421,2399,22,0,341,1,6
1,2342,2441,-99,0,4,0,6
1,2438,2440,-2,0,4,0,6
1,2434,2325,109,0,140,0,6
1,2405,2457,-52,0,112,0,6
1,2440,2289,151,0,313,0,6
1,2469,2483,-14,0,141,0,6
1,2446,2457,-11,0,22,0,6
1,2363,2453,-90,0,201,1,6
1,2529,2314,215,0,16,0,6
1,2350,2436,-86,0,301,1,6
1,2470,2339,131,0,127,0,6
1,2424,2359,65,0,22,0,6
1,2441,2255,186,0,142,1,6
1,2543,2515,28,0,45,1,6
1,2465,2375,90,0,41,0,6
1,2537,2536,1,0,206,0,6
1,2619,2601,18,0,302,0,6
1,2519,2336,183,0,110,0,6
1,2465,2353,112,0,4,0,6
1,2454,2443,11,0,80,0,6
1,2460,2442,18,0,150,0,6
1,2438,2407,31,0,8,0,6
1,2552,2503,49,0,110,1,6
1,2518,2357,161,0,106,0,6
1,2320,2419,-99,0,255,0,6
1,2470,2218,252,0,267,0,6
1,2439,2427,12,0,122,1,6
1,2414,2375,39,0,200,0,6
1,2459,2442,17,0,107,1,6
1,2592,2344,248,0,274,0,6
1,2483,2473,10,0,110,0,6
1,2294,2477,-183,4,244,0,13
1,2354,2415,-61,0,338,1,6
1,2403,2469,-66,0,103,0,6
1,2489,2441,48,0,153,1,6
1,2297,2400,-103,0,41,0,6
1,2492,2445,47,0,312,0,6
1,2527,2473,54,0,247,0,6
1,2509,2253,256,0,150,0,6
1,2435,2460,-25,0,5,0,6
1,2390,2411,-21,0,306,0,6
1,2419,2338,81,0,0,1,6
1,2400,2237,163,0,130,1,6
1,2432,2566,-134,0,0,0,6
1,2537,2548,-11,0,145,0,6
1,2452,2459,-7,0,44,0,6
1,2439,2671,-232,0,40,0,6
1,2427,2332,95,0,43,0,6
1,2663,2696,-33,0,289,0,6
1,2402,2274,128,0,10,0,6
1,2485,2464,21,0,315,0,6
1,2331,2454,-123,0,0,0,6
1,2420,2305,115,0,400,1,6
1,2356,2456,-100,0,247,1,6
1,2566,2627,-61,0,306,0,6
1,2433,2382,51,0,1,0,6
1,2455,2317,138,0,101,0,6
1,2468,2394,74,0,13,0,6
1,2463,2542,-79,0,4,1,6
1,2412,2437,-25,0,40,0,6
1,2761,2554,207,0,121,0,6
1,2662,2417,245,0,151,1,6
1,2603,2503,100,0,245,0,6
1,2522,2506,16,0,219,0,6
1,2451,2493,-42,0,103,1,6
1,2405,2325,80,0,15,0,6
1,2404,2440,-36,0,303,0,6
1,2441,2261,180,0,45,0,6
1,2470,2300,170,0,41,0,6
1,2281,2405,-124,0,133,0,6
1,2450,2411,39,0,45,0,6
1,2304,2471,-167,0,302,0,6
1,2503,2460,43,0,161,1,6
1,2400,2259,141,0,250,1,6
1,2677,2472,205,0,245,0,6
1,2435,2267,168,0,121,0,6
1,2527,2469,58,0,45,0,6
1,2401,2234,167,0,13,1,6
1,2442,2360,82,0,414,0,6
1,2435,2388,47,0,200,1,6
1,2250,2413,-163,0,46,1,6
1,2538,2478,60,0,8,1,6
1,2409,2368,41,0,45,1,6
1,2445,2397,48,0,411,0,6
1,2460,2429,31,0,107,0,6
1,2412,2367,45,0,190,0,6
1,2362,2450,-88,0,247,0,6
1,2462,2394,68,0,354,0,6
1,2441,2471,-30,0,110,1,6
1,2425,2296,129,0,201,1,8
1,2400,2465,-65,0,210,1,6
1,2492,2311,181,0,474,0,6
1,2539,2353,186,0,335,0,6
1,2454,2254,200,0,120,0,6
1,2433,2339,94,0,202,0,6
1,2607,2547,60,0,121,0,6
1,2410,2216,194,0,486,0,6
1,2570,2449,121,0,30,0,6
1,2438,2407,31,0,141,0,6
1,2516,2517,-1,0,4,0,6
1,2393,2563,-170,0,41,1,6
1,2411,2276,135,0,245,0,8
1,2578,2447,131,0,4,1,6
1,2415,2333,82,0,19,0,6
1,2527,2437,90,0,43,1,6
1,2273,2410,-137,0,115,1,6
1,2406,2389,17,0,0,0,6
1,2334,2408,-74,0,45,0,6
1,2406,2317,89,0,7,0,6
1,2468,2375,93,0,190,0,6
1,2677,2599,78,0,120,0,6
1,2432,2386,46,0,415,0,6
1,2483,2419,64,0,435,1,6
1,2409,2457,-48,0,202,0,6
1,2508,2327,181,0,315,0,6
1,2397,2402,-5,0,277,0,6
1,2401,2386,15,0,45,0,6
1,2548,2481,67,0,45,1,6
1,2505,2550,-45,0,107,0,6
1,2393,2429,-36,0,113,0,6
1,2573,2387,186,0,344,0,6
1,2564,2326,238,0,83,0,6
1,2461,2345,116,0,469,0,6
1,2681,2594,87,0,112,0,6
1,2421,2407,14,0,12,0,6
1,2691,2559,132,0,371,0,6
1,2390,2443,-53,0,216,0,6
1,2626,2363,263,0,46,0,6
1,2442,2372,70,0,100,0,6
1,2690,2352,338,0,10,0,6
1,2434,2369,65,0,0,1,6
1,2656,2697,-41,0,83,1,6
1,2414,2296,118,0,234,1,6
1,2434,2352,82,0,29,0,6
1,2502,2339,163,0,348,0,6
1,2331,2415,-84,0,138,0,6
1,2407,2437,-30,0,250,0,6
1,2463,2427,36,0,302,0,6
1,2461,2332,129,4,343,0,13
1,2575,2569,6,0,257,0,6
1,2257,2468,-211,0,146,0,6
1,2231,2528,-297,0,265,0,6
1,2278,2458,-180,0,380,0,6
1,2627,2639,-12,0,462,0,6
1,2378,2417,-39,0,40,0,6
1,2298,2427,-129,0,247,1,6
1,2444,2318,126,0,96,0,6
1,2440,2313,127,0,46,1,6
1,2509,2218,291,0,80,0,6
1,2337,2468,-131,0,311,0,6
1,2445,2360,85,0,220,0,6
1,2616,2640,-24,0,455,0,6
1,2457,2475,-18,0,300,0,6
1,2423,2257,166,0,0,0,8
1,2606,2540,66,0,303,0,6
1,2443,2418,25,0,30,0,6
1,2430,2489,-59,0,113,0,6
1,2520,2340,180,0,7,0,6
1,2629,2445,184,0,203,0,6
1,2505,2370,135,0,114,0,6
1,2408,2301,107,0,201,0,6
1,2557,2545,12,0,123,0,6
1,2401,2254,147,0,176,0,6
1,2323,2452,-129,0,308,0,6
1,2616,2332,284,0,101,0,6
1,2392,2488,-96,0,101,1,6
1,2557,2624,-67,0,87,0,6
1,2324,2408,-84,0,329,0,6
1,2549,2466,83,0,380,0,6
1,2466,2479,-13,0,4,0,6
1,2418,2374,44,0,180,0,6
1,2447,2334,113,0,123,0,6
1,2416,2486,-70,0,123,0,6
1,2329,2420,-91,4,46,0,13
1,2511,2335,176,0,337,1,6
1,2452,2318,134,0,101,1,6
1,2505,2511,-6,0,200,0,6
1,2486,2411,75,0,380,0,6
1,2374,2414,-40,0,1,1,6
1,2448,2320,128,0,48,1,6
1,2406,2410,-4,0,319,0,6
1,2444,2374,70,0,211,0,6
1,2549,2552,-3,0,45,0,6
1,2482,2341,141,0,107,0,6
1,2566,2817,-251,0,146,0,6
1,2393,2443,-50,0,106,0,6
1,2531,2505,26,0,40,0,6
1,2438,2493,-55,0,400,0,6
1,2495,2229,266,0,141,0,6
1,2404,2297,107,0,258,0,6
1,2484,2652,-168,0,352,0,6
1,2429,2432,-3,0,311,1,6
1,2422,2446,-24,0,302,0,6
1,2330,2443,-113,0,123,0,6
1,2495,2373,122,0,106,1,6
1,2607,2548,59,0,406,1,6
1,2637,2603,34,0,121,1,6
1,2457,2473,-16,0,190,0,6
1,2249,2421,-172,0,111,0,6
1,2504,2366,138,0,380,0,6
1,2479,2435,44,0,39,0,6
1,2511,2224,287,0,11,1,6
1,2473,2286,187,0,307,0,6
1,2378,2499,-121,0,106,0,6
1,2423,2278,145,0,45,1,6
1,2671,2310,361,0,101,0,6
1,2319,2454,-135,0,127,1,6
1,2565,2356,209,0,30,0,6
1,2558,2509,49,0,101,0,6
1,2616,2448,168,0,18,1,6
1,2514,2475,39,0,110,0,6
1,2452,2449,3,0,345,0,6
1,2566,2522,44,0,0,0,6
1,2479,2444,35,0,14,1,6
1,2465,2482,-17,0,466,0,6
1,2449,2355,94,0,101,0,6
1,2565,2678,-113,0,337,0,6
1,2396,2496,-100,0,206,1,6
1,2605,2605,0,0,0,0,6
1,2446,2431,15,0,484,0,6
1,2438,2215,223,0,51,0,6
1,2482,2397,85,0,398,1,6
1,2524,2251,273,0,8,1,6
1,2431,2396,35,0,207,0,6
1,2469,2423,46,0,133,0,6
1,2323,2434,-111,0,201,0,6
1,2618,2670,-52,0,101,0,6
1,2346,2405,-59,0,300,0,6
1,2253,2405,-152,0,300,0,6
1,2489,2547,-58,0,280,0,6
1,2449,2330,119,0,190,0,6
1,2530,2442,88,0,251,0,6
1,2438,2561,-123,0,4,0,6
1,2516,2463,53,0,300,0,6
1,2393,2482,-89,0,201,1,6
1,2228,2400,-172,4,13,0,13
1,2406,2290,116,0,40,0,6
1,2469,2342,127,0,204,0,6
1,2471,2435,36,0,123,0,6
1,2411,2426,-15,0,0,1,6
1,2498,2431,67,0,344,0,6
1,2553,2387,166,0,101,0,6
1,2338,2443,-105,0,313,0,6
1,2495,2571,-76,0,292,1,6
1,2440,2394,46,0,101,0,6
1,2523,2260,263,4,48,0,13
1,2532,2380,152,0,341,0,6
1,2594,2445,149,0,129,0,6
1,2416,2414,2,0,0,0,6
1,2470,2493,-23,0,122,0,6
1,2494,2297,197,0,40,0,6
1,2408,2389,19,0,337,0,6
1,2463,2528,-65,0,453,0,6
1,2284,2407,-123,0,45,0,8
1,2396,2502,-106,0,373,0,6
1,2412,2210,202,0,7,0,8
1,2298,2446,-148,0,303,1,6
1,2531,2387,144,0,4,1,6
1,2427,2307,120,0,50,0,6
1,2407,2237,170,0,48,1,6
1,2502,2595,-93,0,106,0,6
1,2599,2468,131,0,40,0,6
1,2445,2569,-124,0,107,0,6
1,2447,2388,59,0,0,1,6
1,2829,2545,284,0,13,0,6
1,2426,2386,40,0,241,0,6
1,2450,2470,-20,0,4,0,6
1,2452,2212,240,0,108,0,8
1,2399,2425,-26,0,7,0,6
1,2424,2288,136,0,112,0,6
1,2385,2401,-16,0,255,0,6
1,2472,2310,162,0,202,1,6
1,2410,2389,21,0,11,0,6
1,2342,2493,-151,0,40,0,8
1,2400,2453,-53,0,40,1,6
1,2462,2434,28,0,16,0,6
1,2456,2391,65,0,57,0,6
1,2380,2515,-135,0,20,0,6
1,2409,2343,66,0,115,0,6
1,2413,2438,-25,0,190,0,6
1,2420,2395,25,0,44,1,6
1,2554,2362,192,0,250,0,6
1,2373,2542,-169,0,248,0,6
1,2560,2297,263,4,231,1,13
1,2360,2415,-55,0,7,0,6
1,2459,2494,-35,0,434,0,6
1,2356,2541,-185,0,330,1,6
1,2604,2503,101,0,81,0,6
1,2360,2477,-117,0,11,0,6
1,2421,2367,54,0,218,0,6
1,2561,2248,313,0,19,0,6
1,2535,2562,-27,0,269,0,6
1,2442,2317,125,0,132,1,6
1,2426,2437,-11,0,2,1,6
1,2437,2382,55,0,8,1,6
1,2499,2265,234,0,145,0,6
1,2394,2508,-114,0,380,0,6
1,2507,2594,-87,0,80,0,6
1,2264,2404,-140,0,264,1,8
1,2553,2399,154,0,224,0,6
1,2469,2512,-43,0,124,0,6
1,2518,2260,258,0,171,0,6
1,2469,2391,78,0,111,0,6
1,2446,2296,150,0,84,0,6
1,2454,2316,138,0,315,1,6
1,2371,2415,-44,0,46,1,6
1,2495,2490,5,0,45,1,6
1,2512,2494,18,0,46,0,6
1,2221,2406,-185,0,45,0,8
1,2463,2544,-81,0,30,0,6
1,2359,2422,-63,0,225,0,6
1,2404,2394,10,0,15,0,6
1,2454,2422,32,0,101,0,6
1,2343,2416,-73,0,40,0,6
1,2550,2456,94,0,4,0,6
1,2422,2369,53,0,310,0,6
1,2389,2445,-56,0,17,0,8
1,2404,2411,-7,0,58,0,6
1,2477,2270,207,0,0,1,6
1,2503,2491,12,0,104,1,6
1,2338,2400,-62,0,80,0,6
1,2447,2292,155,0,1,1,6
1,2465,2497,-32,0,17,0,6
1,2276,2577,-301,0,123,1,6
1,2375,2431,-56,0,156,0,6
1,2507,2548,-41,0,62,1,6
1,2557,2454,103,0,400,0,6
1,2528,2425,103,0,200,0,6
1,2237,2409,-172,0,34,0,6
1,2518,2413,105,0,40,0,6
1,2409,2262,147,4,45,0,13
1,2416,2287,129,4,267,0,13
1,2506,2546,-40,0,392,0,6
1,2468,2434,34,0,107,1,6
1,2300,2451,-151,0,126,0,8
1,2423,2383,40,0,45,0,6
1,2340,2401,-61,0,40,0,6
1,2479,2441,38,0,302,0,6
1,2489,2521,-32,0,40,0,6
1,2561,2572,-11,0,43,0,6
1,2570,2393,177,0,414,0,6
1,2329,2564,-235,0,15,0,6
1,2401,2259,142,0,0,1,6
1,2485,2456,29,0,255,0,6
1,2433,2462,-29,0,109,1,6
1,2605,2551,54,0,7,1,6
1,2574,2510,64,0,400,1,6
1,2409,2465,-56,0,253,0,6
1,2520,2622,-102,0,326,0,6
1,2573,2496,77,0,112,0,6
1,2465,2460,5,0,106,0,6
1,2297,2447,-150,0,315,1,6
1,2567,2517,50,0,310,0,6
1,2240,2403,-163,0,454,0,6
1,2694,2588,106,0,278,0,6
1,2423,2241,182,4,133,0,8
1,2606,2586,20,0,242,0,6
1,2466,2485,-19,0,112,0,6
1,2508,2497,11,0,46,0,6
1,2453,2382,71,0,300,0,6
1,2454,2352,102,0,13,0,6
1,2566,2557,9,0,56,0,6
1,2557,2302,255,0,331,0,6
1,2304,2414,-110,0,48,0,6
1,2495,2312,183,0,15,0,6
1,2524,2416,108,0,1,0,6
1,2432,2319,113,4,477,1,13
1,2373,2432,-59,0,110,1,6
1,2480,2323,157,0,44,0,6
1,2360,2419,-59,0,315,0,6
1,2596,2589,7,0,241,0,6
1,2379,2429,-50,0,131,0,6
1,2430,2238,192,0,57,1,6
1,2420,2384,36,0,148,0,6
1,2443,2244,199,4,200,0,13
1,2288,2431,-143,0,386,1,6
1,2367,2422,-55,0,218,0,6
1,2405,2385,20,0,31,0,6
1,2376,2483,-107,0,20,0,6
1,2402,2285,117,0,101,0,6
1,2402,2442,-40,4,480,0,13
1,2452,2632,-180,0,310,0,6
1,2496,2359,137,0,255,0,6
1,2417,2200,217,0,108,0,6
1,2426,2486,-60,0,257,1,6
1,2531,2420,111,0,254,1,6
1,2546,2677,-131,0,21,0,6
1,2401,2294,107,0,122,0,6
1,2225,2415,-190,0,245,1,6
1,2406,2324,82,0,404,0,6
1,2502,2355,147,0,15,0,6
1,2537,2477,60,0,120,0,6
1,2356,2488,-132,0,153,0,6
1,2461,2290,171,0,325,0,6
1,2410,2428,-18,0,214,0,8
1,2362,2404,-42,0,40,0,6
1,2456,2446,10,0,261,0,6
1,2328,2418,-90,0,1,0,6
1,2592,2453,139,0,35,0,6
1,2468,2429,39,0,45,0,6
1,2556,2209,347,0,130,0,8
1,2475,2326,149,0,110,0,6
1,2358,2444,-86,0,147,0,6
1,2447,2428,19,0,301,1,6
1,2413,2324,89,0,0,0,6
1,2419,2374,45,0,201,0,6
1,2459,2477,-18,0,302,0,6
1,2478,2572,-94,0,201,0,6
1,2576,2330,246,0,143,0,6
1,2499,2224,275,0,133,0,6
1,2464,2299,165,0,46,0,6
1,2552,2439,113,0,150,0,6
1,2541,2441,100,0,0,0,6
1,2411,2513,-102,0,80,0,6
1,2605,2570,35,0,412,0,6
1,2333,2420,-87,0,245,1,6
1,2265,2434,-169,0,45,0,6
1,2411,2357,54,0,330,1,6
1,2464,2323,141,0,352,0,6
1,2478,2312,166,0,263,1,6
1,2454,2450,4,0,218,0,6
1,2665,2413,252,0,40,1,6
1,2495,2597,-102,0,20,1,6
1,2653,2563,90,0,113,1,6
1,2259,2452,-193,0,122,1,6
1,2435,2383,52,0,101,0,6
1,2452,2243,209,0,466,0,6
1,2392,2410,-18,0,172,0,8
1,2402,2283,119,0,251,0,6
1,2515,2380,135,0,40,0,6
1,2429,2271,158,0,153,0,6
1,2423,2363,60,0,10,0,6
1,2558,2377,181,0,101,0,6
1,2523,2253,270,0,190,0,6
1,2408,2272,136,0,58,1,6
1,2524,2239,285,0,109,0,6
1,2435,2243,192,0,48,0,6
1,2489,2313,176,0,100,0,6
1,2346,2524,-178,0,300,0,6
1,2397,2434,-37,0,115,0,6
1,2442,2491,-49,0,300,1,6
1,2443,2516,-73,0,41,0,6
1,2598,2434,164,0,15,0,6
1,2451,2376,75,0,112,0,6
1,2402,2379,23,0,40,0,6
1,2578,2582,-4,0,106,0,6
1,2439,2376,63,0,46,0,6
1,2527,2475,52,0,440,1,6
1,2411,2321,90,0,46,0,6
1,2511,2362,149,0,307,1,6
1,2407,2232,175,0,4,0,8
1,2363,2411,-48,0,120,0,6
1,2472,2383,89,0,125,0,6
1,2453,2319,134,0,404,0,6
1,2358,2487,-129,0,240,0,6
1,2441,2359,82,0,269,0,6
1,2461,2316,145,0,153,0,6
1,2681,2567,114,0,107,0,6
1,2451,2355,96,0,133,0,6
1,2221,2414,-193,0,123,0,6
1,2604,2457,147,0,107,1,6
1,2425,2495,-70,0,10,1,6
1,2455,2393,62,0,200,0,6
1,2449,2409,40,0,107,0,6
1,2411,2271,140,0,40,0,6
1,2379,2539,-160,0,3,0,6
1,2451,2432,19,0,310,0,6
1,2491,2441,50,0,101,1,6
1,2280,2458,-178,0,200,0,6
1,2365,2541,-176,0,112,0,6
1,2438,2354,84,0,14,1,6
1,2439,2460,-21,0,112,0,6
1,2465,2233,232,0,8,0,6
1,2415,2423,-8,0,112,0,6
1,2545,2599,-54,0,7,1,6
1,2498,2480,18,0,2,0,6
1,2400,2248,152,0,0,0,6
1,2528,2377,151,0,201,0,6
1,2400,2241,159,0,50,0,6
1,2514,2493,21,0,245,0,6
1,2416,2384,32,0,45,1,6
1,2493,2502,-9,0,127,0,6
1,2350,2511,-161,0,332,1,6
1,2524,2464,60,0,40,0,6
1,2713,2591,122,0,45,1,6
1,2507,2429,78,0,2,0,6
1,2563,2515,48,0,432,0,6
1,2517,2561,-44,0,4,0,6
1,2533,2565,-32,0,122,0,6
1,2405,2366,39,0,20,0,6
1,2388,2400,-12,0,45,0,6
1,2407,2394,13,0,227,1,6
1,2471,2374,97,0,43,0,6
1,2366,2434,-68,0,43,0,6
1,2400,2276,124,0,7,0,6
1,2419,2499,-80,0,4,0,6
1,2577,2533,44,0,409,0,6
1,2410,2357,53,0,40,0,6
1,2549,2732,-183,0,310,1,6
1,2424,2403,21,0,50,0,6
1,2422,2538,-116,0,31,0,6
1,2609,2585,24,0,215,0,6
1,2530,2409,121,0,0,0,6
1,2439,2397,42,0,197,0,6
1,2502,2463,39,0,255,0,6
1,2526,2357,169,0,61,0,6
1,2457,2405,52,0,218,0,6
1,2419,2405,14,0,165,1,6
1,2443,2316,127,0,132,0,6
1,2419,2420,-1,0,40,0,6
1,2409,2404,5,0,247,0,6
1,2474,2628,-154,0,152,1,6
1,2405,2392,13,0,113,0,6
1,2521,2540,-19,0,426,0,6
1,2512,2351,161,0,308,0,6
1,2440,2285,155,0,153,0,6
1,2785,2421,364,0,341,0,6
1,2383,2446,-63,0,46,0,6
1,2519,2452,67,0,41,0,6
1,2400,2230,170,0,404,0,8
1,2411,2319,92,4,256,0,13
1,2551,2547,4,0,45,0,6
1,2425,2374,51,0,112,0,6
1,2533,2445,88,0,454,0,6
1,2496,2414,82,0,241,1,6
1,2488,2334,154,0,45,0,6
1,2612,2557,55,0,405,0,6
1,2506,2514,-8,0,41,0,6
1,2508,2372,136,0,484,0,6
1,2407,2422,-15,0,45,0,6
1,2424,2348,76,0,242,1,6
1,2454,2438,16,0,267,1,6
1,2320,2417,-97,0,415,0,6
1,2524,2470,54,0,46,0,6
1,2304,2441,-137,0,310,0,6
1,2407,2466,-59,0,40,1,6
1,2440,2276,164,0,346,0,6
1,2415,2237,178,0,25,0,6
1,2644,2653,-9,0,180,0,6
1,2477,2328,149,0,184,0,6
1,2540,2305,235,0,190,0,6
1,2538,2554,-16,0,70,0,6
1,2402,2471,-69,0,311,0,6
1,2582,2410,172,0,330,0,6
1,2533,2509,24,0,113,0,6
1,2438,2422,16,0,13,0,6
1,2432,2328,104,0,250,0,6
1,2436,2329,107,0,46,1,6
1,2451,2434,17,0,128,0,6
1,2587,2600,-13,0,112,0,6
1,2321,2466,-145,0,264,1,6
1,2424,2245,179,0,115,0,8
1,2347,2413,-66,0,111,0,6
1,2418,2208,210,0,392,0,6
1,2424,2331,93,0,106,0,6
1,2431,2270,161,0,144,0,6
1,2445,2290,155,0,454,0,8
1,2514,2331,183,0,300,0,6
1,2433,2418,15,0,15,0,6
1,2421,2235,186,0,246,0,6
1,2468,2207,261,0,209,0,6
1,2564,2394,170,0,212,0,6
1,2437,2559,-122,0,48,0,5
1,2409,2386,23,0,176,0,6
1,2448,2244,204,0,0,0,6
1,2826,2543,283,0,205,0,6
1,2420,2388,32,0,400,0,6
1,2435,2520,-85,0,484,0,6
1,2340,2407,-67,0,255,0,6
1,2450,2339,111,0,107,0,6
1,2512,2445,67,0,315,0,6
1,2623,2631,-8,0,131,0,6
1,2435,2369,66,0,122,0,6
1,2467,2232,235,0,137,0,6
1,2617,2656,-39,0,322,1,6
1,2457,2347,110,0,0,0,6
1,2404,2210,194,0,0,0,6
1,2301,2464,-163,0,195,1,6
1,2400,2384,16,0,102,0,8
1,2435,2459,-24,0,102,0,6
1,2486,2330,156,0,45,1,6
1,2446,2434,12,0,41,0,6
1,2555,2394,161,0,255,0,6
1,2437,2347,90,0,337,0,6
1,2441,2287,154,0,404,1,6
1,2290,2454,-164,0,310,1,6
1,2516,2331,185,0,4,0,6
1,2542,2455,87,0,490,0,6
1,2420,2255,165,0,48,0,6
1,2471,2388,83,0,211,1,6
1,2527,2402,125,0,6,0,6
1,2519,2505,14,0,438,0,6
1,2247,2406,-159,0,277,0,8
1,2461,2521,-60,0,43,1,6
1,2419,2302,117,0,203,0,6
1,2444,2388,56,0,205,0,6
1,2483,2406,77,0,0,1,6
1,2441,2274,167,0,134,1,6
1,2511,2308,203,0,0,0,6
1,2390,2442,-52,0,106,0,6
1,2469,2441,28,0,391,0,6
1,2435,2483,-48,0,131,1,6
1,2476,2653,-177,0,241,0,6
1,2560,2581,-21,0,36,0,6
1,2455,2404,51,0,415,1,6
1,2518,2472,46,0,34,0,6
1,2462,2316,146,0,224,0,6
1,2505,2545,-40,0,106,0,6
1,2624,2392,232,0,351,1,8
1,2592,2424,168,0,16,0,6
1,2461,2556,-95,0,20,1,6
1,2444,2458,-14,0,130,0,6
1,2280,2413,-133,0,27,1,6
1,2499,2320,179,0,330,0,6
1,2409,2401,8,0,311,1,6
1,2580,2514,66,0,244,0,6
1,2336,2433,-97,0,1,1,6
1,2551,2364,187,0,200,0,6
1,2492,2393,99,0,18,0,6
1,2423,2274,149,4,120,0,13
1,2541,2584,-43,0,105,0,6
1,2411,2292,119,0,300,0,6
1,2558,2500,58,0,46,0,6
1,2395,2419,-24,0,474,1,6
1,2408,2343,65,0,406,0,6
1,2468,2486,-18,0,222,0,6
1,2370,2463,-93,0,20,0,6
1,2596,2383,213,0,145,0,6
1,2408,2394,14,0,20,1,6
1,2383,2464,-81,0,0,0,6
1,2511,2506,5,0,200,0,6
1,2417,2335,82,0,41,1,6
1,2390,2547,-157,0,313,0,8
1,2537,2449,88,0,405,0,6
1,2529,2511,18,0,302,0,6
1,2487,2466,21,0,344,0,6
1,2332,2426,-94,0,230,0,6
1,2440,2398,42,0,10,0,6
1,2553,2448,105,0,110,0,6
1,2696,2470,226,0,1,0,6
1,2645,2281,364,0,15,0,6
1,2540,2370,170,0,337,0,8
1,2631,2487,144,0,13,0,6
1,2409,2386,23,0,311,0,6
1,2416,2385,31,0,200,0,6
1,2465,2217,248,0,4,0,6
1,2324,2403,-79,0,263,0,8
1,2386,2431,-45,0,184,0,6
1,2440,2211,229,0,0,0,6
1,2419,2374,45,0,37,0,6
1,2458,2317,141,4,16,1,8
1,2413,2429,-16,0,46,1,6
1,2346,2405,-59,0,10,0,6
1,2503,2502,1,0,54,0,6
1,2501,2473,28,0,123,0,6
1,2615,2384,231,0,267,0,6
1,2386,2492,-106,0,300,0,6
1,2350,2409,-59,0,200,0,6
1,2410,2443,-33,0,46,0,6
1,2428,2287,141,0,48,1,6
1,2444,2368,76,0,46,0,6
1,2591,2531,60,0,466,0,6
1,2200,2421,-221,0,322,1,6
1,2483,2378,105,0,4,0,6
1,2400,2245,155,0,30,0,6
1,2660,2635,25,0,45,0,6
1,2501,2537,-36,0,131,0,6
1,2407,2291,116,0,123,0,6
1,2459,2462,-3,0,400,0,6
1,2426,2285,141,0,125,0,6
1,2581,2368,213,0,315,0,6
1,2531,2261,270,0,200,0,6
1,2444,2318,126,0,124,0,6
1,2410,2369,41,0,247,0,6
1,2517,2568,-51,0,317,1,6
1,2352,2426,-74,0,210,0,8
1,2574,2405,169,0,254,0,6
1,2438,2378,60,0,459,1,6
1,2347,2419,-72,0,0,0,6
1,2541,2231,310,0,4,0,6
1,2364,2409,-45,0,3,1,6
1,2527,2510,17,0,153,1,6
1,2504,2524,-20,0,310,1,6
1,2484,2567,-83,0,311,0,6
1,2404,2228,176,4,101,0,13
1,2464,2340,124,0,104,0,6
1,2620,2534,86,0,4,0,6
1,2449,2379,70,0,202,0,6
1,2446,2469,-23,0,127,0,6
1,2641,2528,113,0,110,1,6
1,2565,2497,68,0,101,0,6
1,2392,2405,-13,0,306,0,6
1,2423,2326,97,0,119,0,5
1,2538,2243,295,0,40,0,6
1,2453,2361,92,0,143,0,6
1,2410,2386,24,0,484,0,6
1,2443,2311,132,0,70,0,8
1,2521,2339,182,0,38,0,6
1,2385,2548,-163,0,191,0,6
1,2404,2488,-84,0,147,0,5
1,2506,2449,57,0,310,0,6
1,2362,2419,-57,0,106,1,6
1,2515,2471,44,0,325,0,6
1,2545,2439,106,0,216,0,6
1,2569,2558,11,0,139,0,6
1,2418,2326,92,0,296,1,6
1,2663,2522,141,0,455,0,6
1,2514,2552,-38,0,0,0,6
1,2421,2308,113,0,4,0,6
1,2589,2594,-5,0,45,0,6
1,2671,2546,125,0,7,1,6
1,2607,2640,-33,0,49,0,6
1,2415,2235,180,0,130,0,6
1,2405,2251,154,4,48,0,10
1,2447,2400,47,0,403,1,6
1,2539,2378,161,0,474,1,6
1,2434,2202,232,0,103,0,6
1,2412,2261,151,0,312,0,6
1,2514,2556,-42,0,194,0,6
1,2339,2412,-73,0,90,0,6
1,2459,2364,95,0,264,0,6
1,2515,2530,-15,0,110,0,6
1,2403,2262,141,0,40,0,6
1,2511,2531,-20,0,207,0,6
1,2410,2368,42,0,347,0,6
1,2477,2372,105,0,13,0,6
1,2343,2501,-158,0,394,0,6
1,2437,2343,94,0,4,1,6
1,2457,2484,-27,0,126,0,6
1,2423,2453,-30,0,46,0,6
1,2564,2566,-2,0,105,1,6
1,2446,2402,44,0,455,1,6
1,2443,2364,79,0,190,0,6
1,2418,2338,80,0,311,0,6
1,2304,2474,-170,0,190,0,6
1,2399,2536,-137,0,5,0,6
1,2431,2529,-98,0,301,1,6
1,2458,2357,101,0,153,1,6
1,2528,2553,-25,0,255,1,6
1,2534,2546,-12,0,380,0,6
1,2452,2434,18,0,107,1,6
1,2395,2432,-37,0,229,1,6
1,2527,2395,132,0,257,0,6
1,2531,2430,101,0,228,0,6
1,2382,2482,-100,0,1,0,6
1,2443,2572,-129,0,140,1,6
1,2437,2379,58,0,123,1,6
1,2546,2417,129,0,129,1,6
1,2453,2464,-11,0,15,0,6
1,2445,2561,-116,0,4,0,6
1,2508,2606,-98,0,463,0,6
1,2386,2408,-22,0,145,1,6
1,2435,2505,-70,0,102,0,6
1,2526,2340,186,0,250,0,6
1,2380,2457,-77,0,120,0,6
1,2402,2393,9,0,477,1,6
1,2538,2527,11,0,300,0,6
1,2537,2444,93,0,107,0,6
1,2506,2449,57,0,121,1,6
1,2416,2366,50,0,200,0,6
1,2435,2364,71,0,100,1,6
1,2463,2530,-67,0,300,0,6
1,2460,2373,87,0,4,1,6
1,2536,2251,285,0,40,0,6
1,2488,2229,259,0,4,0,6
1,2477,2328,149,0,121,0,6
1,2687,2518,169,0,104,0,6
1,2424,2490,-66,0,311,0,6
1,2443,2278,165,0,113,0,6
1,2609,2627,-18,0,5,0,6
1,2330,2426,-96,0,45,1,6
1,2610,2524,86,0,344,0,6
1,2606,2628,-22,0,300,0,6
1,2446,2443,3,0,0,0,6
1,2496,2493,3,0,45,0,6
1,2343,2437,-94,0,10,0,6
1,2595,2753,-158,0,190,0,6
1,2471,2356,115,0,332,0,6
1,2467,2426,41,0,45,0,6
1,2263,2599,-336,0,135,0,6
1,2326,2461,-135,0,45,0,6
1,2419,2412,7,0,241,0,6
1,2516,2473,43,0,46,0,6
1,2540,2607,-67,0,405,0,6
1,2496,2446,50,0,123,1,6
1,2452,2374,78,0,80,0,6
1,2422,2542,-120,0,55,0,6
1,2556,2339,217,0,30,1,6
1,2539,2525,14,0,153,1,6
1,2506,2340,166,0,45,1,6
1,2651,2457,194,0,110,0,6
1,2453,2266,187,0,150,0,6
1,2313,2537,-224,0,49,0,6
1,2644,2521,123,0,156,1,6
1,2423,2284,139,0,131,0,6
1,2445,2340,105,0,241,0,6
1,2435,2429,6,0,0,1,6
1,2519,2432,87,0,426,0,6
1,2454,2477,-23,0,242,0,6
1,2615,2453,162,0,302,0,6
1,2580,2654,-74,0,244,0,6
1,2614,2504,110,0,107,0,6
1,2498,2416,82,0,49,0,6
1,2562,2533,29,0,123,1,6
1,2405,2246,159,0,0,0,6
1,2547,2532,15,0,214,0,6
1,2470,2475,-5,0,45,1,6
1,2503,2363,140,0,302,0,6
1,2349,2473,-124,0,218,0,6
1,2440,2361,79,0,45,0,6
1,2275,2495,-220,0,15,0,6
1,2401,2434,-33,0,12,1,6
1,2496,2460,36,0,140,1,6
1,2414,2375,39,0,368,0,8
1,2583,2483,100,0,112,0,6
1,2415,2487,-72,0,307,0,6
1,2527,2682,-155,0,150,0,6
1,2286,2419,-133,0,302,0,6
1,2475,2383,92,0,201,0,6
1,2563,2543,20,0,200,0,6
1,2378,2431,-53,0,142,0,6
1,2428,2436,-8,0,250,0,6
1,2299,2424,-125,0,315,0,6
1,2414,2441,-27,0,121,1,6
1,2523,2539,-16,0,302,1,6
1,2556,2529,27,0,302,0,6
1,2418,2389,29,0,11,0,6
1,2462,2506,-44,0,130,0,6
1,2459,2449,10,0,130,0,6
1,2601,2382,219,0,1,1,6
1,2448,2497,-49,0,1,0,6
1,2448,2451,-3,0,203,0,6
1,2412,2531,-119,0,331,0,6
1,2501,2303,198,0,106,0,6
1,2581,2321,260,0,335,0,6
1,2508,2384,124,0,10,0,6
1,2475,2298,177,0,8,0,6
1,2495,2489,6,0,249,0,6
1,2418,2413,5,0,225,0,6
1,2430,2281,149,0,212,0,6
1,2577,2276,301,0,130,1,6
1,2607,2412,195,0,398,0,6
1,2419,2259,160,0,400,0,6
1,2434,2508,-74,0,242,0,8
1,2574,2438,136,0,345,0,6
1,2438,2422,16,0,70,0,6
1,2397,2471,-74,0,148,1,6
1,2355,2419,-64,0,102,0,6
1,2373,2490,-117,0,337,1,6
1,2441,2459,-18,0,303,1,6
1,2256,2478,-222,0,310,0,6
1,2296,2484,-188,0,100,0,6
1,2615,2273,342,0,114,0,6
1,2485,2375,110,0,30,0,6
1,2406,2480,-74,0,57,0,6
1,2411,2272,139,0,310,0,6
1,2543,2612,-69,0,46,0,6
1,2490,2288,202,0,106,0,6
1,2344,2451,-107,0,255,1,6
1,2561,2248,313,0,335,0,6
1,2515,2389,126,0,49,0,6
1,2452,2533,-81,0,45,0,6
1,2403,2226,177,0,52,0,6
1,2402,2314,88,0,43,1,6
1,2499,2272,227,0,25,0,6
1,2433,2420,13,0,143,1,6
1,2502,2418,84,0,244,1,6
1,2433,2486,-53,0,4,0,6
1,2596,2648,-52,0,0,0,6
1,2438,2399,39,0,341,0,6
1,2572,2407,165,0,5,0,6
1,2413,2575,-162,0,40,0,6
1,2451,2281,170,0,335,0,6
1,2451,2377,74,0,45,0,6
1,2647,2539,108,0,302,0,6
1,2561,2600,-39,0,30,0,8
1,2497,2338,159,0,0,0,6
1,2290,2537,-247,0,4,0,6
1,2477,2403,74,0,395,1,6
1,2432,2268,164,0,344,0,6
1,2430,2356,74,0,28,0,6
1,2404,2264,140,0,100,0,6
1,2418,2304,114,0,310,0,6
1,2377,2429,-52,0,302,0,6
1,2471,2331,140,0,243,0,6
1,2415,2413,2,0,113,0,6
1,2449,2292,157,0,469,0,6
1,2520,2530,-10,0,395,0,6
1,2277,2430,-153,0,106,0,6
1,2297,2486,-189,0,48,0,6
1,2425,2289,136,0,142,0,6
1,2388,2540,-152,0,202,0,6
1,2455,2449,6,0,106,0,6
1,2482,2483,-1,0,40,0,6
1,2413,2403,10,0,225,0,6
1,2487,2573,-86,0,41,0,6
1,2381,2475,-94,0,192,0,6
1,2405,2433,-28,0,48,0,6
1,2352,2425,-73,0,300,0,6
1,2319,2433,-114,0,124,1,6
1,2279,2406,-127,0,120,0,6
1,2476,2321,155,0,4,0,6
1,2525,2251,274,0,45,0,6
1,2513,2519,-6,0,101,1,6
1,2451,2450,1,0,102,1,6
1,2468,2462,6,0,454,1,6
1,2450,2369,81,0,263,0,6
1,2527,2522,5,0,134,0,6
1,2375,2511,-136,0,117,0,6
1,2402,2406,-4,0,302,0,6
1,2449,2388,61,0,40,0,6
1,2537,2440,97,0,269,0,6
1,2539,2402,137,0,455,0,6
1,2358,2658,-300,0,15,0,6
1,2363,2456,-93,0,101,1,6
1,2567,2431,136,0,310,0,6
1,2415,2354,61,0,62,0,6
1,2492,2248,244,0,45,0,6
1,2443,2288,155,0,101,0,6
1,2408,2388,20,0,118,0,6
1,2322,2403,-81,0,13,0,6
1,2499,2477,22,0,311,0,6
1,2486,2394,92,0,15,0,6
1,2403,2361,42,0,100,0,6
1,2401,2374,27,0,300,0,6
1,2420,2261,159,0,125,0,6
1,2442,2212,230,0,42,0,6
1,2371,2425,-54,0,343,0,6
1,2420,2315,105,0,4,1,6
1,2312,2407,-95,0,41,1,6
1,2601,2526,75,0,102,0,6
1,2486,2456,30,0,404,0,6
1,2453,2522,-69,0,131,0,6
1,2283,2401,-118,4,409,0,8
1,2499,2483,16,0,40,0,6
1,2393,2488,-95,0,302,0,6
1,2421,2276,145,0,327,1,6
1,2557,2424,133,0,300,1,6
1,2468,2404,64,0,52,0,6
1,2420,2470,-50,0,145,0,6
1,2411,2408,3,0,107,0,6
1,2456,2320,136,0,150,0,6
1,2552,2578,-26,0,313,0,6
1,2576,2615,-39,0,248,0,6
1,2501,2544,-43,0,130,1,6
1,2411,2256,155,0,200,0,6
1,2391,2531,-140,0,103,0,6
1,2406,2417,-11,0,255,0,6
1,2446,2209,237,0,8,0,6
1,2478,2388,90,0,299,0,6
1,2426,2218,208,0,41,0,6
1,2403,2408,-5,0,9,0,6
1,2418,2400,18,0,48,0,6
1,2443,2353,90,0,130,0,8
1,2262,2420,-158,0,4,0,6
1,2539,2543,-4,0,300,1,6
1,2465,2285,180,0,244,0,6
1,2619,2535,84,0,346,0,6
1,2435,2411,24,0,31,0,6
1,2320,2468,-148,0,45,0,6
1,2584,2565,19,0,244,1,6
1,2448,2364,84,0,483,0,6
1,2437,2462,-25,0,130,0,6
1,2455,2454,1,0,382,0,6
1,2459,2415,44,0,118,0,6
1,2493,2336,157,0,4,0,6
1,2266,2433,-167,0,106,0,6
1,2556,2422,134,0,150,0,6
1,2281,2513,-232,0,225,0,6
1,2491,2443,48,0,196,0,6
1,2372,2428,-56,0,245,0,8
1,2405,2288,117,0,483,0,6
1,2406,2310,96,0,41,0,6
1,2333,2424,-91,0,202,1,6
1,2476,2283,193,0,85,0,6
1,2426,2473,-47,0,13,1,6
1,2547,2597,-50,0,315,0,6
1,2490,2348,142,0,107,0,6
1,2413,2301,112,0,85,0,6
1,2464,2433,31,0,39,0,6
1,2430,2259,171,0,404,0,6
1,2390,2432,-42,0,15,0,6
1,2582,2567,15,0,302,0,6
1,2437,2371,66,0,60,0,6
1,2384,2490,-106,0,123,0,6
1,2412,2441,-29,0,334,1,6
1,2417,2369,48,0,45,0,6
1,2412,2463,-51,0,45,0,6
1,2515,2353,162,0,331,0,6
1,2484,2304,180,0,406,0,6
1,2579,2507,72,0,469,0,6
1,2610,2426,184,0,302,0,6
1,2551,2347,204,0,330,0,6
1,2539,2311,228,0,0,0,6
1,2357,2508,-151,0,1,0,6
1,2490,2350,140,0,122,1,6
1,2430,2318,112,0,405,0,6
1,2489,2546,-57,0,335,0,6
1,2338,2625,-287,0,0,0,6
1,2497,2499,-2,0,120,1,6
1,2368,2408,-40,0,106,1,6
1,2452,2309,143,0,454,0,6
1,2472,2347,125,0,395,0,6
1,2331,2439,-108,0,200,0,6
1,2600,2440,160,0,123,0,6
1,2404,2256,148,0,250,0,8
1,2577,2359,218,0,176,0,6
1,2403,2382,21,0,313,1,6
1,2534,2241,293,0,140,0,6
1,2633,2634,-1,0,22,0,6
1,2556,2372,184,0,107,0,6
1,2488,2549,-61,0,2,1,6
1,2499,2465,34,0,301,0,6
1,2595,2466,129,0,453,0,6
1,2559,2400,159,0,120,0,6
1,2401,2407,-6,4,301,0,13
1,2548,2587,-39,0,455,0,6
1,2418,2432,-14,0,6,0,6
1,2475,2429,46,0,302,0,6
1,2659,2445,214,0,46,0,6
1,2416,2459,-43,0,152,0,6
1,2476,2367,109,0,331,0,6
1,2461,2399,62,0,103,0,6
1,2439,2351,88,0,45,0,6
1,2427,2267,160,0,307,0,10
1,2506,2381,125,0,245,0,6
1,2582,2443,139,0,122,0,6
1,2457,2446,11,0,112,0,6
1,2416,2350,66,0,41,0,6
1,2458,2391,67,0,41,0,6
1,2416,2302,114,0,40,0,6
1,2372,2423,-51,0,416,0,6
1,2401,2410,-9,0,115,0,6
1,2451,2452,-1,0,45,0,6
1,2402,2452,-50,0,302,0,6
1,2487,2208,279,0,140,0,6
1,2427,2365,62,0,101,1,6
1,2427,2238,189,0,16,0,6
1,2496,2517,-21,0,491,0,6
1,2434,2343,91,0,101,0,6
1,2230,2411,-181,0,252,0,6
1,2386,2419,-33,0,7,1,6
1,2641,2407,234,0,474,0,6
1,2376,2438,-62,0,130,0,6
1,2294,2553,-259,0,4,0,6
1,2376,2402,-26,0,80,0,6
1,2414,2315,99,0,0,1,6
1,2495,2481,14,0,102,0,6
1,2415,2391,24,0,242,0,6
1,2592,2423,169,0,122,0,6
1,2556,2514,42,0,104,0,6
1,2324,2400,-76,0,414,0,6
1,2551,2487,64,0,448,0,8
1,2497,2307,190,0,101,1,6
1,2534,2559,-25,0,125,0,6
1,2432,2386,46,0,260,0,6
1,2345,2408,-63,0,46,0,6
1,2437,2535,-98,0,455,0,6
1,2416,2402,14,0,100,0,6
1,2555,2563,-8,0,112,0,6
1,2415,2283,132,0,469,1,6
1,2524,2375,149,0,398,1,6
1,2496,2424,72,0,40,0,6
1,2490,2457,33,0,190,0,6
1,2487,2412,75,0,375,0,6
1,2420,2287,133,0,439,0,6
1,2425,2333,92,0,46,0,6
1,2481,2370,111,0,454,0,6
1,2453,2363,90,0,331,0,6
1,2552,2439,113,0,112,1,6
1,2494,2244,250,0,115,1,6
1,2498,2474,24,0,245,0,6
1,2373,2436,-63,0,429,0,6
1,2331,2404,-73,0,101,0,6
1,2474,2669,-195,0,443,0,6
1,2475,2469,6,0,331,1,6
1,2406,2338,68,0,49,0,6
1,2707,2643,64,0,487,0,6
1,2437,2343,94,0,300,1,8
1,2260,2402,-142,0,120,0,6
1,2518,2340,178,0,123,1,6
1,2373,2423,-50,0,103,0,6
1,2360,2554,-194,0,105,0,6
1,2493,2387,106,0,107,0,6
1,2579,2445,134,0,110,0,6
1,2401,2371,30,4,241,0,13
1,2361,2470,-109,0,1,0,6
1,2659,2341,318,0,241,0,6
1,2502,2449,53,0,43,1,6
1,2491,2439,52,0,130,0,6
1,2465,2462,3,0,14,1,6
1,2426,2394,32,0,13,1,6
1,2446,2365,81,0,269,1,6
1,2465,2440,25,0,22,0,6
1,2453,2242,211,0,300,0,6
1,2509,2479,30,0,101,0,6
1,2432,2283,149,0,455,0,6
1,2437,2249,188,0,277,0,8
1,2400,2264,136,0,301,0,6
1,2445,2284,161,0,9,0,6
1,2457,2566,-109,0,202,0,6
1,2440,2328,112,0,0,0,6
1,2370,2485,-115,0,302,0,6
1,2422,2351,71,0,106,0,6
1,2461,2306,155,0,0,0,6
1,2429,2425,4,0,470,0,6
1,2495,2325,170,0,49,0,6
1,2449,2562,-113,0,265,0,6
1,2292,2403,-111,0,108,0,6
1,2414,2272,142,0,202,1,6
1,2451,2381,70,0,335,0,6
1,2379,2422,-43,0,73,0,6
1,2402,2372,30,0,45,1,6
1,2392,2425,-33,0,45,0,6
1,2282,2405,-123,0,132,0,8
1,2446,2291,155,0,101,1,6
1,2495,2422,73,0,118,0,6
1,2350,2529,-179,0,216,0,6
1,2351,2516,-165,0,40,1,6
1,2377,2445,-68,0,135,0,6
1,2421,2391,30,0,217,0,6
1,2330,2425,-95,0,101,0,6
1,2514,2397,117,0,44,0,6
1,2403,2487,-84,0,110,1,6
1,2525,2462,63,0,200,0,6
1,2367,2469,-102,0,133,0,6
1,2450,2284,166,0,100,0,6
1,2334,2451,-117,0,127,0,6
1,2565,2225,340,0,143,0,6
1,2435,2304,131,4,120,0,13
1,2545,2636,-91,0,127,0,6
1,2401,2323,78,0,20,0,6
1,2453,2330,123,0,127,0,6
1,2433,2404,29,0,300,0,6
1,2432,2297,135,0,42,0,6
1,2489,2421,68,0,303,0,6
1,2572,2571,1,0,301,0,6
1,2469,2344,125,0,229,0,6
1,2512,2514,-2,0,409,0,6
1,2484,2439,45,0,202,0,6
1,2420,2301,119,0,110,0,6
1,2473,2461,12,0,311,0,6
1,2467,2362,105,0,331,0,6
1,2399,2409,-10,0,56,0,6
1,2491,2408,83,0,48,0,6
1,2465,2350,115,0,106,0,6
1,2445,2448,-3,0,487,0,6
1,2408,2438,-30,0,464,0,6
1,2515,2475,40,0,101,0,6
1,2400,2370,30,0,105,0,6
1,2320,2426,-106,0,123,0,6
1,2536,2337,199,0,48,0,6
1,2456,2591,-135,0,382,0,6
1,2380,2455,-75,0,41,0,6
1,2510,2388,122,0,280,0,6
1,2351,2400,-49,0,45,1,6
1,2348,2507,-159,0,14,0,6
1,2454,2346,108,0,25,0,6
1,2599,2285,314,0,202,1,6
1,2392,2439,-47,0,313,0,6
1,2532,2559,-27,0,11,0,6
1,2418,2360,58,0,141,0,6
1,2437,2347,90,0,405,0,6
1,2533,2498,35,0,124,0,6
1,2323,2412,-89,0,2,0,6
1,2490,2291,199,0,111,0,6
1,2388,2520,-132,0,394,1,6
1,2510,2426,84,0,300,0,6
1,2498,2602,-104,0,112,0,6
1,2387,2451,-64,0,0,0,6
1,2454,2473,-19,0,236,0,6
1,2549,2214,335,0,37,1,6
1,2419,2359,60,0,200,0,6
1,2442,2403,39,0,36,1,6
1,2573,2623,-50,0,151,0,6
1,2411,2558,-147,0,1,0,6
1,2550,2381,169,0,241,0,6
1,2564,2217,347,0,248,0,6
1,2447,2476,-29,0,138,1,6
1,2260,2476,-216,4,40,0,0
1,2440,2328,112,0,240,0,6
1,2613,2627,-14,0,102,0,6
1,2511,2242,269,0,225,0,6
1,2285,2438,-153,0,303,0,6
1,2355,2447,-92,0,253,1,6
1,2308,2405,-97,0,123,0,6
1,2457,2286,171,0,10,0,6
1,2271,2422,-151,0,4,0,6
1,2535,2412,123,0,484,0,8
1,2492,2478,14,0,123,1,6
1,2419,2283,136,0,1,0,6
1,2411,2215,196,4,141,0,10
1,2545,2589,-44,0,13,1,6
1,2459,2436,23,0,108,0,6
1,2417,2208,209,0,107,1,6
1,2419,2271,148,0,1,0,6
1,2348,2476,-128,0,125,0,6
1,2485,2534,-49,0,141,0,6
1,2481,2220,261,0,101,0,6
1,2418,2385,33,0,46,1,6
1,2632,2628,4,0,46,0,6
1,2386,2436,-50,0,345,0,6
1,2556,2426,130,0,41,1,6
1,2412,2349,63,0,344,0,6
1,2472,2453,19,0,32,0,6
1,2491,2554,-63,0,45,0,6
1,2596,2470,126,0,123,0,6
1,2496,2457,39,0,122,0,6
1,2608,2561,47,0,332,0,6
1,2431,2291,140,0,205,0,6
1,2343,2400,-57,4,110,0,13
1,2216,2422,-206,4,394,0,10
1,2473,2417,56,0,263,0,8
1,2522,2217,305,0,45,1,6
1,2579,2457,122,0,53,1,6
1,2299,2465,-166,0,125,0,6
1,2583,2457,126,0,473,0,6
1,2612,2486,126,0,7,0,6
1,2449,2356,93,0,404,0,6
1,2409,2380,29,0,214,0,6
1,2426,2322,104,0,260,1,6
1,2423,2320,103,0,46,0,6
1,2525,2216,309,0,143,0,6
1,2320,2437,-117,0,190,0,6
1,2589,2566,23,0,112,1,6
1,2477,2300,177,0,172,0,6
1,2434,2281,153,0,142,1,6
1,2463,2544,-81,0,394,0,6
1,2405,2267,138,0,8,0,6
1,2534,2305,229,0,131,0,6
1,2550,2482,68,0,11,0,6
1,2417,2316,101,0,40,0,6
1,2326,2477,-151,0,110,0,6
1,2390,2455,-65,0,102,0,6
1,2419,2317,102,0,490,0,6
1,2462,2431,31,0,129,0,6
1,2468,2561,-93,0,112,0,6
1,2441,2522,-81,0,123,0,6
1,2414,2347,67,0,1,0,6
1,2234,2433,-199,0,248,0,6
1,2558,2523,35,0,107,0,6
1,2426,2431,-5,0,306,0,6
1,2480,2421,59,0,296,0,6
1,2320,2460,-140,0,405,0,6
1,2470,2539,-69,0,248,1,6
1,2403,2203,200,4,300,0,13
1,2283,2411,-128,0,27,0,6
1,2387,2414,-27,0,203,0,6
1,2396,2501,-105,0,300,0,6
1,2458,2504,-46,0,20,0,6
1,2507,2365,142,0,41,0,6
1,2443,2432,11,0,234,0,6
1,2383,2400,-17,0,483,0,6
1,2495,2475,20,0,315,0,6
1,2401,2264,137,4,46,0,13
1,2411,2308,103,0,108,1,5
1,2691,2479,212,0,49,1,6
1,2407,2258,149,0,111,1,6
1,2458,2424,34,0,46,0,6
1,2557,2330,227,0,122,0,6
1,2436,2313,123,0,315,1,6
1,2460,2414,46,0,109,0,8
1,2488,2528,-40,0,241,0,6
1,2414,2478,-64,0,127,0,6
1,2421,2339,82,0,140,0,6
1,2421,2421,0,0,11,1,6
1,2506,2378,128,0,474,1,6
1,2416,2348,68,0,211,0,6
1,2539,2474,65,0,293,0,6
1,2490,2470,20,0,408,0,6
1,2493,2338,155,0,120,1,6
1,2534,2368,166,0,300,0,6
1,2544,2524,20,0,307,0,6
1,2413,2411,2,0,1,0,6
1,2556,2473,83,0,60,1,6
1,2358,2411,-53,0,1,1,6
1,2453,2534,-81,0,43,0,6
1,2460,2531,-71,0,245,0,6
1,2516,2444,72,0,478,0,6
1,2442,2298,144,0,325,0,6
1,2437,2563,-126,0,441,0,6
1,2310,2448,-138,0,127,0,6
1,2438,2543,-105,0,330,0,6
1,2439,2457,-18,0,469,0,6
1,2464,2289,175,0,121,1,6
1,2502,2428,74,0,337,1,6
1,2372,2466,-94,0,88,0,6
1,2433,2477,-44,0,49,0,6
1,2447,2400,47,0,140,0,6
1,2408,2231,177,0,127,0,6
1,2461,2312,149,0,122,0,6
1,2457,2320,137,0,46,1,6
1,2542,2409,133,0,43,0,6
1,2656,2389,267,0,106,0,6
1,2415,2274,141,0,260,0,8
1,2408,2426,-18,0,122,0,6
1,2601,2394,207,0,40,0,6
1,2606,2572,34,0,154,0,6
1,2411,2251,160,0,311,1,6
1,2419,2255,164,0,311,0,6
1,2477,2500,-23,0,112,0,6
1,2465,2477,-12,0,46,0,6
1,2608,2570,38,0,45,0,6
1,2445,2376,69,0,14,0,6
1,2630,2443,187,0,13,0,6
1,2419,2371,48,0,484,1,6
1,2560,2328,232,0,40,0,6
1,2306,2413,-107,0,203,0,6
1,2551,2448,103,0,34,0,6
1,2325,2431,-106,0,483,0,6
1,2448,2421,27,0,152,0,6
1,2446,2482,-36,0,151,1,6
1,2518,2525,-7,0,206,1,6
1,2483,2259,224,0,331,0,6
1,2366,2545,-179,0,152,1,6
1,2458,2291,167,0,133,0,6
1,2557,2413,144,0,441,0,6
1,2594,2518,76,0,335,0,6
1,2479,2263,216,0,6,0,7
1,2653,2602,51,0,330,1,6
1,2404,2372,32,0,200,0,6
1,2321,2449,-128,4,415,0,13
1,2401,2390,11,0,4,0,6
1,2422,2266,156,0,140,0,6
1,2580,2393,187,0,223,0,6
1,2428,2400,28,0,127,1,6
1,2444,2433,11,0,4,1,6
1,2449,2281,168,0,133,0,6
1,2597,2574,23,0,0,0,6
1,2438,2417,21,0,15,0,6
1,2385,2465,-80,0,215,1,6
1,2404,2324,80,0,0,1,6
1,2413,2460,-47,0,5,0,6
1,2426,2469,-43,0,300,0,6
1,2403,2300,103,0,138,0,6
1,2442,2466,-24,0,101,0,6
1,2405,2382,23,0,278,0,6
1,2428,2456,-28,0,41,1,6
1,2423,2598,-175,0,405,0,6
1,2468,2273,195,0,43,0,6
1,2752,2674,78,0,130,0,6
1,2402,2327,75,0,250,0,6
1,2406,2338,68,0,30,0,6
1,2559,2471,88,0,333,0,6
1,2712,2595,117,0,113,0,6
1,2422,2357,65,0,40,0,6
1,2560,2512,48,0,110,1,6
1,2475,2471,4,0,131,0,6
1,2455,2472,-17,0,414,0,6
1,2629,2626,3,0,150,0,6
1,2502,2412,90,0,250,1,6
1,2453,2370,83,0,125,0,6
1,2405,2312,93,0,46,0,6
1,2447,2314,133,0,156,0,6
1,2420,2448,-28,0,333,0,6
1,2530,2363,167,0,100,1,6
1,2516,2644,-128,0,244,1,6
1,2285,2438,-153,0,107,0,8
1,2425,2413,12,0,295,0,6
1,2482,2452,30,0,462,1,6
1,2449,2421,28,0,46,0,6
1,2509,2416,93,0,302,1,6
1,2402,2381,21,0,58,1,6
1,2532,2515,17,0,300,0,6
1,2412,2374,38,0,126,0,6
1,2424,2464,-40,0,0,0,6
1,2563,2291,272,0,203,1,6
1,2366,2417,-51,0,466,1,6
1,2548,2437,111,0,131,0,6
1,2464,2407,57,0,192,0,6
1,2303,2445,-142,0,41,0,6
1,2332,2424,-92,0,46,0,6
1,2428,2421,7,0,40,1,6
1,2471,2263,208,0,108,0,6
1,2516,2454,62,0,487,1,6
1,2428,2364,64,0,130,0,6
1,2483,2313,170,0,80,0,6
1,2462,2321,141,0,300,0,6
1,2595,2430,165,0,412,0,6
1,2457,2319,138,0,214,0,6
1,2449,2332,117,0,15,0,6
1,2802,2712,90,0,150,0,6
1,2306,2411,-105,0,463,0,6
1,2402,2332,70,0,4,0,6
1,2337,2444,-107,0,41,0,6
1,2427,2374,53,0,101,1,6
1,2345,2413,-68,0,57,1,6
1,2445,2366,79,0,123,0,6
1,2404,2251,153,0,118,0,8
1,2435,2295,140,0,140,0,6
1,2462,2358,104,0,380,0,6
1,2621,2601,20,0,153,0,6
1,2401,2343,58,0,191,0,6
1,2437,2460,-23,0,338,0,6
1,2413,2339,74,0,1,0,6
1,2634,2209,425,0,196,1,6
1,2663,2646,17,0,404,0,6
1,2406,2356,50,0,200,0,6
1,2461,2438,23,0,406,0,6
1,2454,2321,133,0,106,1,6
1,2475,2315,160,0,112,0,6
1,2341,2520,-179,0,405,1,6
1,2211,2471,-260,0,123,0,6
1,2608,2698,-90,0,112,1,6
1,2405,2504,-99,0,110,0,6
1,2338,2434,-96,0,150,0,6
1,2422,2285,137,0,15,0,6
1,2385,2441,-56,0,48,1,6
1,2457,2429,28,0,366,0,6
1,2415,2327,88,0,357,0,6
1,2396,2462,-66,0,4,0,6
1,2498,2282,216,0,455,0,6
1,2614,2633,-19,0,278,0,6
1,2599,2587,12,0,0,0,6
1,2403,2387,16,0,38,0,6
1,2545,2532,13,0,258,1,6
1,2450,2373,77,0,440,1,6
1,2387,2523,-136,0,1,0,6
1,2620,2567,53,0,40,0,6
1,2497,2435,62,0,46,0,6
1,2645,2461,184,0,45,1,6
1,2592,2466,126,0,254,0,6
1,2419,2384,35,0,48,0,6
1,2545,2460,85,0,0,0,6
1,2507,2574,-67,0,40,1,6
1,2252,2405,-153,0,307,1,6
1,2618,2561,57,0,302,0,6
1,2827,2764,63,0,130,0,6
1,2492,2322,170,0,52,0,6
1,2582,2427,155,0,484,0,6
1,2504,2355,149,0,43,0,6
1,2414,2438,-24,0,204,0,6
1,2609,2468,141,0,337,0,6
1,2408,2335,73,0,1,0,6
1,2424,2481,-57,0,311,0,5
1,2442,2460,-18,0,45,0,6
1,2295,2418,-123,0,45,0,6
1,2447,2351,96,0,140,0,6
1,2421,2291,130,0,454,0,6
1,2542,2367,175,0,315,0,6
1,2352,2469,-117,0,100,0,6
1,2610,2513,97,0,151,1,6
1,2561,2554,7,0,112,0,6
1,2503,2332,171,0,308,0,6
1,2385,2435,-50,0,250,0,6
1,2466,2532,-66,0,120,0,6
1,2477,2410,67,0,8,0,6
1,2433,2318,115,0,176,0,6
1,2328,2406,-78,0,241,1,6
1,2425,2545,-120,0,102,0,6
1,2348,2419,-71,0,330,1,6
1,2487,2294,193,0,463,0,6
1,2466,2447,19,0,123,0,6
1,2491,2438,53,0,100,0,6
1,2435,2416,19,0,4,1,6
1,2300,2449,-149,0,253,0,6
1,2409,2369,40,0,346,0,8
1,2429,2296,133,0,122,0,6
1,2347,2505,-158,0,157,0,6
1,2473,2435,38,0,121,0,6
1,2439,2308,131,0,100,1,6
1,2432,2404,28,0,487,0,6
1,2603,2321,282,0,101,0,6
1,2305,2435,-130,0,17,1,6
1,2518,2669,-151,0,199,0,6
1,2403,2334,69,0,48,0,6
1,2405,2352,53,0,216,0,6
1,2431,2473,-42,0,312,1,6
1,2683,2513,170,0,112,0,6
1,2454,2607,-153,0,383,0,6
1,2275,2445,-170,0,245,0,8
1,2416,2354,62,0,255,1,6
1,2423,2715,-292,0,151,0,6
1,2287,2455,-168,0,184,0,6
1,2579,2453,126,0,405,1,6
1,2363,2410,-47,0,3,1,6
1,2499,2393,106,0,101,0,6
1,2428,2402,26,0,31,1,6
1,2408,2564,-156,0,337,0,6
1,2273,2402,-129,0,113,0,6
1,2444,2340,104,0,380,0,6
1,2435,2454,-19,0,250,1,6
1,2473,2285,188,0,40,0,6
1,2402,2278,124,0,0,0,6
1,2528,2430,98,0,331,0,6
1,2403,2242,161,0,122,0,6
1,2410,2409,1,0,252,0,6
1,2504,2352,152,0,128,1,6
1,2566,2565,1,0,4,0,6
1,2407,2227,180,0,200,0,6
1,2431,2389,42,0,58,1,6
1,2369,2434,-65,0,43,0,6
1,2360,2456,-96,0,123,0,6
1,2535,2563,-28,0,45,0,6
1,2386,2416,-30,0,140,0,6
1,2462,2503,-41,0,112,0,6
1,2586,2263,323,0,85,0,6
1,2428,2297,131,0,50,1,6
1,2444,2442,2,0,4,0,6
1,2430,2669,-239,0,4,1,6
1,2369,2424,-55,0,45,0,6
1,2556,2548,8,0,241,0,6
1,2460,2375,85,0,40,0,6
1,2464,2319,145,2,18,0,18
1,2359,2460,-101,0,225,0,6
1,2579,2633,-54,0,101,0,6
1,2445,2312,133,0,200,0,6
1,2358,2449,-91,0,8,0,6
1,2619,2410,209,0,335,0,6
1,2403,2329,74,0,250,0,6
1,2510,2348,162,0,80,0,6
1,2443,2474,-31,0,10,0,6
1,2387,2516,-129,0,204,0,6
1,2518,2499,19,0,310,0,6
1,2392,2466,-74,0,141,1,6
1,2333,2439,-106,0,112,0,6
1,2605,2590,15,0,46,0,6
1,2481,2333,148,0,132,1,6
1,2329,2434,-105,0,118,1,6
1,2681,2559,122,0,46,1,6
1,2483,2484,-1,0,306,0,6
1,2290,2469,-179,0,40,0,6
1,2347,2442,-95,0,300,0,6
1,2411,2440,-29,0,334,0,6
1,2558,2592,-34,0,110,1,6
1,2395,2546,-151,0,3,0,6
1,2405,2451,-46,0,123,0,6
1,2445,2278,167,0,156,0,6
1,2395,2478,-83,0,45,1,6
1,2469,2467,2,0,1,1,6
1,2473,2239,234,4,108,0,0
1,2321,2404,-83,0,31,0,6
1,2430,2386,44,0,152,0,6
1,2412,2232,180,0,46,0,6
1,2454,2357,97,0,40,0,6
1,2410,2349,61,0,300,0,6
1,2357,2402,-45,0,180,0,6
1,2636,2431,205,0,385,0,6
1,2496,2445,51,0,110,0,6
1,2272,2444,-172,0,382,1,6
1,2521,2411,110,0,15,0,6
1,2442,2392,50,0,485,0,6
1,2647,2623,24,0,130,0,6
1,2464,2566,-102,0,172,1,6
1,2407,2424,-17,0,413,1,6
1,2673,2470,203,0,101,1,6
1,2550,2586,-36,0,305,0,6
1,2544,2565,-21,0,398,0,6
1,2446,2319,127,0,345,0,6
1,2436,2510,-74,0,15,0,6
1,2462,2213,249,0,1,0,8
1,2629,2479,150,0,210,0,6
1,2500,2464,36,0,337,0,6
1,2502,2539,-37,0,42,0,6
1,2424,2473,-49,0,247,1,6
1,2446,2355,91,0,73,0,6
1,2491,2458,33,0,45,0,6
1,2402,2222,180,0,5,0,8
1,2522,2413,109,0,474,0,6
1,2410,2306,104,0,43,1,6
1,2405,2270,135,0,45,0,6
1,2366,2433,-67,0,176,0,6
1,2618,2323,295,0,102,0,6
1,2580,2571,9,0,200,0,6
1,2510,2338,172,0,131,0,6
1,2440,2356,84,0,80,0,6
1,2336,2460,-124,0,140,0,6
1,2476,2417,59,0,215,1,6
1,2403,2365,38,0,47,1,6
1,2447,2527,-80,0,306,0,6
1,2494,2701,-207,0,300,0,6
1,2325,2414,-89,0,48,0,6
1,2471,2389,82,0,130,0,6
1,2553,2414,139,0,80,0,6
1,2473,2410,63,0,107,0,6
1,2489,2561,-72,0,344,1,6
1,2405,2409,-4,0,106,0,5
1,2408,2307,101,0,360,1,6
1,2529,2522,7,0,103,0,6
1,2533,2477,56,0,43,0,6
1,2388,2456,-68,0,278,0,6
1,2524,2489,35,0,121,1,6
1,2469,2545,-76,0,190,0,6
1,2392,2479,-87,0,25,1,6
1,2390,2489,-99,0,300,0,6
1,2458,2449,9,0,46,0,6
1,2366,2632,-266,0,106,0,6
1,2558,2564,-6,0,45,0,6
1,2413,2329,84,0,16,1,6
1,2398,2501,-103,0,45,0,6
1,2482,2412,70,0,15,1,6
1,2267,2419,-152,0,412,0,6
1,2471,2461,10,0,1,0,6
1,2398,2460,-62,0,103,0,6
1,2624,2370,254,0,57,0,8
1,2447,2438,9,0,80,0,6
1,2440,2206,234,0,4,0,5
1,2521,2423,98,0,200,0,6
1,2804,2538,266,0,101,0,6
1,2461,2283,178,0,13,0,6
1,2524,2421,103,0,0,0,6
1,2413,2396,17,0,191,1,6
1,2559,2618,-59,0,301,0,6
1,2357,2457,-100,0,282,0,6
1,2441,2443,-2,0,107,0,6
1,2376,2439,-63,0,4,0,6
1,2413,2392,21,0,0,0,6
1,2457,2611,-154,0,310,0,6
1,2419,2281,138,0,101,0,6
1,2476,2497,-21,0,268,0,6
1,2546,2344,202,0,14,1,6
1,2518,2492,26,0,6,1,6
1,2542,2614,-72,0,209,0,6
1,2411,2310,101,0,250,0,6
1,2431,2405,26,0,332,0,6
1,2454,2502,-48,0,7,1,6
1,2272,2432,-160,0,4,0,6
1,2320,2512,-192,0,112,0,6
1,2436,2294,142,0,10,0,6
1,2325,2489,-164,0,40,0,6
1,2493,2455,38,0,4,1,6
1,2608,2474,134,0,265,0,6
1,2487,2370,117,0,40,0,6
1,2448,2473,-25,0,147,0,6
1,2283,2432,-149,0,319,0,6
1,2403,2396,7,0,217,1,6
1,2478,2326,152,0,201,0,6
1,2375,2404,-29,0,130,0,6
1,2316,2402,-86,0,122,1,6
1,2414,2383,31,0,15,0,6
1,2413,2342,71,0,5,0,6
1,2418,2319,99,0,190,0,6
1,2359,2420,-61,0,415,0,6
1,2501,2399,102,0,263,1,6
1,2526,2396,130,0,40,0,5
1,2436,2461,-25,0,307,1,6
1,2305,2421,-116,0,300,1,6
1,2346,2429,-83,0,106,0,6
1,2470,2416,54,0,200,1,6
1,2252,2406,-154,0,45,0,6
1,2551,2462,89,0,106,0,6
1,2432,2271,161,0,107,0,8
1,2417,2363,54,0,45,0,6
1,2402,2280,122,0,42,1,6
1,2460,2525,-65,0,4,0,6
1,2521,2582,-61,0,247,0,6
1,2545,2413,132,0,250,0,6
1,2404,2293,111,0,291,1,6
1,2488,2431,57,0,411,0,6
1,2516,2645,-129,0,325,0,6
1,2364,2401,-37,0,1,0,6
1,2418,2357,61,0,205,0,6
1,2560,2452,108,0,0,0,6
1,2371,2462,-91,0,242,0,6
1,2402,2339,63,0,101,0,6
1,2484,2454,30,0,409,0,6
1,2462,2386,76,0,0,0,6
1,2431,2452,-21,0,122,1,6
1,2568,2387,181,0,4,1,6
1,2476,2389,87,0,45,1,6
1,2459,2322,137,0,310,1,6
1,2410,2306,104,0,205,0,6
1,2428,2315,113,0,13,0,6
1,2345,2467,-122,0,16,0,6
1,2482,2368,114,0,352,1,6
1,2508,2225,283,0,15,0,6
1,2564,2453,111,0,110,0,6
1,2657,2506,151,0,125,0,6
1,2422,2343,79,0,47,0,6
1,2481,2371,110,0,200,0,6
1,2431,2364,67,0,129,0,6
1,2538,2507,31,0,4,0,6
1,2492,2389,103,0,40,1,6
1,2412,2294,118,0,242,0,6
1,2588,2452,136,0,191,0,6
1,2424,2521,-97,0,45,1,6
1,2433,2391,42,0,12,1,6
1,2550,2265,285,0,125,0,6
1,2449,2441,8,0,338,1,6
1,2549,2429,120,0,415,1,6
1,2512,2351,161,0,48,0,6
1,2433,2318,115,0,455,0,6
1,2632,2542,90,0,45,0,6
1,2507,2202,305,0,101,0,7
1,2312,2557,-245,0,124,0,6
1,2559,2476,83,0,130,0,6
1,2530,2555,-25,0,202,0,6
1,2532,2572,-40,0,131,0,6
1,2554,2509,45,0,14,0,6
1,2440,2485,-45,0,110,0,6
1,2432,2400,32,0,45,0,6
1,2422,2286,136,0,140,0,6
1,2506,2361,145,0,138,0,6
1,2517,2386,131,0,121,0,6
1,2428,2367,61,0,40,0,6
1,2453,2275,178,0,226,0,6
1,2553,2601,-48,0,133,0,6
1,2467,2381,86,0,106,0,6
1,2571,2267,304,0,327,0,8
1,2375,2445,-70,0,264,0,6
1,2477,2445,32,0,15,1,6
1,2430,2351,79,0,60,0,6
1,2545,2522,23,0,1,0,6
1,2488,2315,173,0,0,0,6
1,2431,2440,-9,0,110,0,6
1,2511,2657,-146,0,6,0,6
1,2342,2442,-100,4,140,0,13
1,2507,2508,-1,0,36,0,6
1,2602,2398,204,0,1,0,6
1,2441,2514,-73,0,46,0,6
1,2482,2342,140,0,13,0,6
1,2690,2563,127,0,112,0,6
1,2322,2407,-85,0,121,0,6
1,2272,2418,-146,0,325,0,6
1,2439,2485,-46,0,1,0,6
1,2410,2409,1,0,338,1,6
1,2486,2480,6,0,253,0,6
1,2521,2461,60,0,267,0,6
1,2411,2548,-137,0,395,1,6
1,2451,2419,32,0,2,1,6
1,2630,2609,21,0,7,0,6
1,2437,2444,-7,0,307,0,6
1,2514,2489,25,0,45,0,6
1,2273,2407,-134,0,1,0,6
1,2412,2503,-91,0,270,0,6
1,2624,2506,118,0,205,0,6
1,2320,2418,-98,0,110,1,6
1,2554,2477,77,0,112,0,6
1,2518,2341,177,0,7,1,6
1,2401,2406,-5,0,132,0,6
1,2680,2549,131,0,103,1,6
1,2536,2549,-13,0,337,0,6
1,2413,2560,-147,0,330,0,6
1,2607,2220,387,0,107,0,8
1,2500,2501,-1,0,100,0,6
1,2612,2365,247,0,484,0,6
1,2383,2425,-42,0,5,0,8
1,2418,2332,86,0,1,0,6
1,2422,2288,134,0,46,0,6
1,2359,2523,-164,0,1,0,6
1,2694,2268,426,0,200,0,6
1,2553,2352,201,0,171,0,5
1,2562,2420,142,0,112,0,6
1,2509,2435,74,0,7,1,6
1,2408,2302,106,4,101,0,13
1,2428,2466,-38,0,100,0,6
1,2476,2440,36,0,13,0,6
1,2464,2337,127,0,110,0,6
1,2373,2508,-135,0,2,0,6
1,2380,2414,-34,0,0,1,6
1,2434,2347,87,0,8,0,6
1,2516,2336,180,0,310,0,6
1,2418,2273,145,0,4,0,6
1,2465,2439,26,0,57,0,6
1,2429,2348,81,0,60,0,6
1,2489,2437,52,0,101,0,6
1,2486,2467,19,0,120,0,6
1,2456,2379,77,0,14,0,6
1,2553,2451,102,0,88,0,6
1,2325,2422,-97,0,147,1,6
1,2528,2266,262,0,5,1,6
1,2483,2404,79,0,206,0,6
1,2441,2493,-52,0,121,0,6
1,2639,2664,-25,0,113,0,6
1,2400,2239,161,0,190,0,6
1,2490,2444,46,0,107,1,6
1,2379,2412,-33,0,4,0,6
1,2396,2559,-163,0,337,1,6
1,2505,2316,189,0,40,0,6
1,2524,2523,1,0,310,0,6
1,2524,2397,127,0,152,0,6
1,2724,2705,19,0,211,0,6
1,2581,2370,211,0,123,1,6
1,2654,2514,140,0,456,0,6
1,2691,2592,99,0,37,0,6
1,2349,2414,-65,0,45,0,6
1,2418,2286,132,0,0,0,6
1,2523,2373,150,0,121,0,6
1,2688,2550,138,0,491,0,6
1,2498,2504,-6,0,45,0,6
1,2377,2418,-41,0,311,0,6
1,2407,2434,-27,0,1,1,6
1,2686,2656,30,0,194,0,6
1,2260,2432,-172,0,129,0,6
1,2429,2400,29,0,45,1,6
1,2414,2307,107,0,122,0,6
1,2428,2436,-8,0,48,1,6
1,2430,2433,-3,0,62,0,6
1,2346,2406,-60,0,302,1,6
1,2327,2432,-105,0,302,0,6
1,2307,2507,-200,0,104,0,6
1,2392,2406,-14,0,102,0,6
1,2551,2383,168,0,102,0,6
1,2349,2541,-192,0,2,0,6
1,2563,2461,102,0,8,0,6
1,2573,2548,25,0,414,0,6
1,2413,2346,67,0,464,0,6
1,2481,2410,71,0,0,0,6
1,2529,2646,-117,0,7,0,6
1,2405,2367,38,0,332,0,6
1,2439,2425,14,0,45,0,6
1,2480,2522,-42,0,130,0,6
1,2457,2309,148,0,0,1,6
1,2314,2413,-99,0,330,0,6
1,2554,2361,193,0,190,0,6
1,2446,2268,178,0,387,1,8
1,2450,2302,148,0,121,0,6
1,2465,2298,167,0,13,0,6
1,2486,2444,42,0,315,0,6
1,2468,2334,134,0,156,0,6
1,2488,2418,70,0,4,1,6
1,2321,2400,-79,0,254,0,6
1,2429,2450,-21,0,380,1,6
1,2545,2372,173,0,338,0,6
1,2443,2384,59,0,464,1,6
1,2422,2386,36,0,56,0,6
1,2494,2457,37,0,400,0,6
1,2459,2256,203,0,0,0,8
1,2442,2565,-123,0,122,0,6
1,2261,2432,-171,0,254,0,6
1,2495,2505,-10,0,379,0,6
1,2425,2475,-50,0,200,0,6
1,2515,2357,158,4,9,0,13
1,2510,2468,42,0,110,0,6
1,2310,2438,-128,0,190,1,6
1,2400,2509,-109,0,484,0,6
1,2382,2416,-34,0,7,1,6
1,2492,2389,103,0,201,0,6
1,2496,2478,18,0,57,0,6
1,2374,2424,-50,0,414,0,6
1,2472,2390,82,0,409,0,6
1,2399,2459,-60,0,45,0,6
1,2342,2428,-86,0,122,0,6
1,2321,2516,-195,0,226,0,6
1,2401,2288,113,0,21,0,6
1,2237,2401,-164,0,153,1,6
1,2557,2460,97,0,49,1,6
1,2531,2456,75,0,218,0,6
1,2439,2332,107,0,330,0,6
1,2454,2370,84,0,1,0,6
1,2421,2445,-24,0,21,0,6
1,2562,2448,114,0,400,0,6
1,2344,2484,-140,0,454,0,6
1,2426,2308,118,0,115,0,6
1,2422,2408,14,0,101,0,6
1,2520,2502,18,0,373,0,6
1,2460,2459,1,0,190,0,6
1,2517,2699,-182,0,485,0,6
1,2518,2472,46,0,386,1,6
1,2576,2401,175,0,200,0,6
1,2595,2470,125,0,426,0,6
1,2427,2502,-75,0,107,1,6
1,2538,2501,37,0,46,0,6
1,2412,2369,43,0,305,0,6
1,2543,2454,89,0,250,0,6
1,2372,2408,-36,0,27,0,6
1,2439,2398,41,0,14,0,6
1,2386,2413,-27,0,212,1,6
1,2426,2351,75,0,0,1,6
1,2424,2397,27,0,138,1,6
1,2316,2427,-111,0,200,0,6
1,2542,2396,146,0,113,0,6
1,2475,2425,50,0,200,0,6
1,2390,2424,-34,0,211,0,6
1,2351,2418,-67,0,106,0,6
1,2445,2370,75,0,85,0,6
1,2420,2423,-3,0,201,0,6
1,2278,2453,-175,0,195,0,6
1,2403,2454,-51,0,3,1,6
1,2463,2460,3,0,46,0,6
1,2543,2535,8,0,4,1,6
1,2524,2584,-60,0,300,1,6
1,2432,2471,-39,0,190,1,6
1,2537,2471,66,0,409,0,6
1,2417,2373,44,0,302,0,6
1,2311,2446,-135,2,138,0,28
1,2482,2439,43,0,70,1,6
1,2265,2417,-152,0,337,0,8
1,2284,2478,-194,0,189,0,6
1,2590,2516,74,0,255,1,6
1,2419,2460,-41,0,1,1,6
1,2533,2554,-21,0,130,1,6
1,2444,2361,83,0,40,0,6
1,2599,2574,25,0,107,0,6
1,2524,2367,157,0,242,0,6
1,2368,2450,-82,0,1,1,6
1,2305,2421,-116,0,42,1,8
1,2471,2455,16,0,2,0,6
1,2533,2475,58,0,419,0,6
1,2485,2565,-80,0,300,0,6
1,2496,2217,279,0,107,1,6
1,2261,2443,-182,0,140,1,8
1,2490,2344,146,0,302,0,6
1,2599,2427,172,0,373,0,8
1,2576,2461,115,0,122,0,6
1,2448,2258,190,0,187,0,6
1,2650,2603,47,0,202,1,6
1,2353,2514,-161,0,196,0,6
1,2440,2388,52,0,45,1,6
1,2412,2357,55,0,133,1,6
1,2508,2331,177,0,117,0,6
1,2397,2542,-145,0,264,0,6
1,2476,2239,237,0,302,0,6
1,2377,2505,-128,0,300,0,6
1,2618,2479,139,0,115,0,6
1,2309,2422,-113,0,300,0,6
1,2506,2228,278,0,211,0,6
1,2423,2409,14,0,150,0,8
1,2466,2426,40,0,130,1,6
1,2372,2425,-53,0,387,0,7
1,2535,2389,146,0,112,0,6
1,2422,2277,145,0,106,1,6
1,2536,2240,296,0,101,0,6
1,2457,2484,-27,0,190,0,6
1,2495,2433,62,0,373,0,6
1,2419,2412,7,0,130,0,6
1,2604,2463,141,0,116,0,6
1,2553,2569,-16,0,311,0,6
1,2417,2227,190,0,46,0,6
1,2478,2500,-22,0,102,0,6
1,2425,2366,59,0,310,0,6
1,2404,2453,-49,0,112,0,6
1,2514,2455,59,0,118,0,6
1,2404,2256,148,0,400,0,6
1,2239,2407,-168,0,0,1,6
1,2421,2397,24,0,122,0,6
1,2419,2620,-201,0,48,0,6
1,2297,2488,-191,0,264,0,6
1,2399,2459,-60,0,4,1,6
1,2396,2401,-5,0,49,0,6
1,2581,2593,-12,0,193,1,6
1,2460,2472,-12,0,426,0,6
1,2395,2441,-46,0,352,1,6
1,2484,2318,166,0,310,1,6
1,2358,2455,-97,0,46,0,6
1,2497,2534,-37,0,248,0,6
1,2562,2390,172,0,241,0,6
1,2409,2328,81,0,405,0,6
1,2428,2349,79,0,438,0,6
1,2514,2430,84,0,378,0,6
1,2437,2304,133,0,0,0,8
1,2422,2380,42,0,49,0,6
1,2354,2415,-61,0,461,0,6
1,2394,2544,-150,0,267,0,6
1,2408,2269,139,0,302,1,6
1,2502,2422,80,0,61,0,8
1,2615,2458,157,0,0,0,6
1,2378,2612,-234,0,15,0,6
1,2690,2600,90,0,130,0,6
1,2330,2482,-152,0,190,0,6
1,2593,2237,356,0,120,1,6
1,2546,2563,-17,0,153,0,6
1,2627,2629,-2,0,50,0,6
1,2508,2500,8,0,374,0,8
1,2351,2425,-74,0,0,0,6
1,2672,2560,112,0,152,0,6
1,2442,2410,32,0,0,0,6
1,2400,2360,40,0,410,0,6
1,2261,2493,-232,0,302,1,6
1,2533,2415,118,0,360,0,6
1,2395,2422,-27,0,437,0,6
1,2568,2562,6,0,43,0,6
1,2400,2243,157,0,13,0,6
1,2439,2349,90,0,208,1,6
1,2279,2452,-173,0,125,0,6
1,2459,2351,108,0,456,0,6
1,2428,2293,135,0,0,0,6
1,2545,2376,169,0,455,0,6
1,2424,2495,-71,0,101,0,6
1,2404,2257,147,0,100,1,6
1,2578,2650,-72,0,23,1,8
1,2547,2626,-79,0,140,0,6
1,2450,2520,-70,0,145,1,6
1,2467,2534,-67,0,380,0,6
1,2478,2250,228,0,106,0,8
1,2689,2552,137,0,46,0,6
1,2503,2426,77,0,320,0,6
1,2454,2480,-26,0,415,1,6
1,2437,2458,-21,0,324,1,6
1,2562,2719,-157,0,112,0,6
1,2515,2360,155,0,302,0,6
1,2362,2435,-73,0,8,0,6
1,2463,2436,27,0,300,0,6
1,2517,2383,134,0,92,0,6
1,2517,2316,201,0,251,0,6
1,2426,2378,48,0,123,0,6
1,2422,2211,211,0,310,0,6
1,2404,2423,-19,0,190,0,6
1,2469,2379,90,0,335,1,6
1,2401,2346,55,0,0,1,6
1,2571,2376,195,0,491,0,6
1,2464,2367,97,0,345,0,6
1,2455,2594,-139,0,101,0,6
1,2393,2405,-12,0,0,0,6
1,2505,2296,209,0,380,0,6
1,2363,2424,-61,0,415,1,6
1,2414,2566,-152,0,113,1,6
1,2445,2373,72,0,110,1,6
1,2344,2407,-63,0,40,0,6
1,2271,2420,-149,0,142,0,6
1,2400,2412,-12,0,101,0,6
1,2533,2408,125,0,311,0,6
1,2702,2595,107,0,41,0,6
1,2292,2425,-133,0,258,1,6
1,2437,2426,11,0,130,0,6
1,2262,2403,-141,0,10,1,6
1,2289,2409,-120,0,102,0,6
1,2474,2401,73,0,151,0,6
1,2697,2430,267,0,311,0,6
1,2428,2408,20,0,264,0,6
1,2608,2728,-120,0,110,0,6
1,2509,2509,0,0,41,0,6
1,2221,2427,-206,0,46,1,6
1,2433,2368,65,0,25,0,6
1,2519,2393,126,0,300,0,6
1,2288,2429,-141,0,302,1,6
1,2465,2464,1,0,107,1,6
1,2200,2424,-224,0,107,0,6
1,2408,2261,147,0,56,1,6
1,2542,2409,133,0,302,0,6
1,2467,2542,-75,0,106,0,6
1,2490,2255,235,0,16,0,6
1,2423,2424,-1,0,13,0,6
1,2571,2391,180,0,310,0,6
1,2403,2362,41,0,46,0,6
1,2617,2600,17,0,345,0,6
1,2435,2385,50,0,13,0,6
1,2438,2469,-31,0,127,0,6
1,2661,2565,96,0,395,0,6
1,2541,2437,104,0,312,0,6
1,2420,2320,100,0,315,0,6
1,2492,2484,8,0,5,0,6
1,2563,2425,138,0,454,0,6
1,2626,2542,84,0,300,0,6
1,2433,2325,108,0,456,1,6
1,2520,2461,59,0,0,0,6
1,2455,2457,-2,0,380,0,6
1,2403,2404,-1,0,225,0,6
1,2581,2460,121,4,8,0,13
1,2500,2380,120,0,441,1,6
1,2370,2478,-108,0,122,0,6
1,2337,2402,-65,0,330,0,6
1,2424,2296,128,0,311,0,6
1,2408,2366,42,0,48,0,6
1,2495,2482,13,0,200,1,6
1,2432,2446,-14,0,50,1,6
1,2675,2564,111,0,132,0,6
1,2456,2638,-182,0,140,0,6
1,2464,2395,69,0,249,0,6
1,2321,2425,-104,0,267,0,6
1,2441,2277,164,0,43,0,6
1,2470,2247,223,0,110,0,6
1,2410,2458,-48,0,111,0,8
1,2502,2574,-72,0,0,0,6
1,2416,2242,174,0,151,0,8
1,2348,2468,-120,0,43,0,6
1,2381,2424,-43,0,49,0,6
1,2454,2468,-14,0,484,0,6
1,2415,2322,93,0,119,0,6
1,2286,2431,-145,0,48,0,6
1,2488,2413,75,0,442,0,6
1,2312,2420,-108,0,125,0,6
1,2414,2364,50,0,0,0,6
1,2521,2400,121,0,58,0,8
1,2342,2420,-78,4,476,1,13
1,2393,2401,-8,0,380,0,6
1,2478,2513,-35,0,43,0,6
1,2630,2292,338,0,101,1,6
1,2280,2470,-190,0,434,0,6
1,2597,2546,51,0,4,0,6
1,2316,2431,-115,0,62,0,6
1,2326,2422,-96,0,126,0,6
1,2550,2426,124,0,110,1,6
1,2426,2254,172,0,2,0,6
1,2496,2533,-37,0,200,1,6
1,2412,2379,33,0,101,0,6
1,2498,2413,85,0,45,1,6
1,2707,2491,216,0,46,0,6
1,2435,2319,116,0,44,0,6
1,2403,2421,-18,0,315,0,6
1,2585,2462,123,0,45,0,6
1,2389,2435,-46,0,200,0,6
1,2301,2429,-128,4,300,0,13
1,2451,2316,135,0,205,1,6
1,2487,2309,178,0,140,0,6
1,2455,2356,99,0,1,0,6
1,2729,2336,393,0,12,0,6
1,2433,2410,23,0,148,1,6
1,2403,2370,33,0,48,0,6
1,2532,2416,116,0,1,0,6
1,2565,2517,48,0,102,1,6
1,2501,2480,21,0,398,0,6
1,2365,2401,-36,0,109,1,6
1,2424,2329,95,0,49,1,6
1,2451,2343,108,0,6,1,6
1,2413,2387,26,0,107,0,6
1,2569,2416,153,0,338,0,6
1,2421,2365,56,0,37,0,6
1,2247,2544,-297,0,57,0,6
1,2542,2429,113,0,241,0,6
1,2417,2459,-42,0,357,0,6
1,2269,2676,-407,0,45,0,6
1,2413,2350,63,4,255,0,13
1,2407,2434,-27,0,106,0,6
1,2532,2396,136,0,373,0,6
1,2400,2330,70,0,4,0,6
1,2545,2463,82,0,146,1,6
1,2382,2427,-45,0,203,0,6
1,2591,2352,239,0,4,1,6
1,2419,2264,155,0,200,0,6
1,2527,2554,-27,0,45,0,6
1,2553,2490,63,0,4,0,6
1,2406,2412,-6,0,106,0,6
1,2403,2468,-65,0,113,0,6
1,2618,2588,30,0,40,0,6
1,2407,2364,43,0,180,0,6
1,2374,2456,-82,0,102,0,6
1,2431,2358,73,0,200,0,6
1,2440,2311,129,0,335,0,6
1,2306,2454,-148,0,390,0,8
1,2411,2565,-154,0,4,1,6
1,2534,2524,10,0,244,0,6
1,2474,2493,-19,0,302,0,6
1,2413,2366,47,0,106,0,6
1,2248,2404,-156,0,61,1,6
1,2717,2210,507,0,1,0,6
1,2407,2353,54,0,40,0,6
1,2414,2406,8,0,110,0,6
1,2502,2649,-147,0,4,0,6
1,2248,2418,-170,0,45,0,6
1,2412,2252,160,0,195,0,6
1,2491,2327,164,0,114,1,6
1,2477,2252,225,0,112,0,6
1,2444,2264,180,0,15,0,6
1,2645,2645,0,0,382,0,6
1,2412,2282,130,0,141,0,6
1,2292,2432,-140,0,28,0,6
1,2670,2630,40,0,152,0,6
1,2356,2405,-49,0,50,0,6
1,2436,2379,57,0,268,0,6
1,2453,2517,-64,0,409,0,6
1,2455,2397,58,0,48,1,6
1,2551,2515,36,0,21,1,6
1,2412,2535,-123,0,281,1,6
1,2392,2427,-35,0,140,0,6
1,2556,2430,126,0,0,0,6
1,2568,2473,95,0,335,0,6
1,2464,2327,137,0,145,1,6
1,2391,2426,-35,0,103,0,6
1,2524,2496,28,0,110,0,6
1,2391,2456,-65,0,122,1,6
1,2400,2379,21,0,246,0,6
1,2449,2429,20,0,52,0,6
1,2466,2360,106,0,0,0,6
1,2382,2484,-102,0,5,1,6
1,2410,2398,12,0,46,0,6
1,2407,2286,121,0,6,0,6
1,2415,2543,-128,0,3,1,6
1,2470,2317,153,0,30,0,6
1,2455,2367,88,0,42,0,6
1,2328,2438,-110,0,122,0,6
1,2386,2432,-46,0,153,0,6
1,2708,2671,37,0,177,0,6
1,2315,2420,-105,0,120,0,6
1,2282,2414,-132,0,301,0,6
1,2437,2342,95,0,43,1,6
1,2414,2314,100,0,200,0,8
1,2421,2268,153,0,302,0,5
1,2366,2486,-120,0,115,1,6
1,2381,2401,-20,0,300,0,6
1,2458,2317,141,0,245,0,6
1,2435,2442,-7,0,310,1,6
1,2785,2619,166,0,341,0,6
1,2402,2289,113,0,101,0,6
1,2407,2324,83,0,128,0,6
1,2324,2446,-122,0,40,0,6
1,2309,2444,-135,0,301,0,6
1,2503,2302,201,0,14,0,6
1,2559,2488,71,0,110,0,6
1,2461,2411,50,0,300,0,6
1,2495,2353,142,0,336,0,6
1,2415,2412,3,0,112,0,6
1,2596,2415,181,0,307,0,6
1,2565,2481,84,0,300,0,6
1,2425,2327,98,0,61,0,6
1,2424,2307,117,0,46,0,6
1,2470,2299,171,4,49,0,0
1,2429,2445,-16,0,90,0,6
1,2386,2447,-61,0,151,0,6
1,2571,2408,163,0,13,0,6
1,2483,2315,168,0,8,0,6
1,2594,2458,136,0,49,0,6
1,2390,2440,-50,0,247,1,6
1,2473,2425,48,0,121,0,6
1,2401,2412,-11,0,380,1,6
1,2553,2348,205,0,269,0,6
1,2562,2217,345,0,244,0,6
1,2437,2505,-68,0,131,0,6
1,2608,2620,-12,0,101,0,6
1,2483,2458,25,0,331,0,6
1,2460,2403,57,0,45,0,6
1,2525,2425,100,0,406,0,6
1,2457,2277,180,0,200,0,8
1,2522,2432,90,0,0,0,6
1,2361,2528,-167,0,247,0,6
1,2487,2417,70,0,57,1,6
1,2305,2490,-185,0,177,0,6
1,2400,2384,16,0,331,1,6
1,2382,2529,-147,0,5,0,6
1,2483,2348,135,0,15,0,6
1,2437,2471,-34,0,45,1,6
1,2203,2440,-237,0,1,0,6
1,2413,2416,-3,0,101,0,6
1,2414,2392,22,0,40,0,6
1,2666,2724,-58,0,487,1,6
1,2295,2403,-108,0,302,1,6
1,2591,2335,256,0,327,0,8
1,2478,2220,258,0,190,0,5
1,2378,2485,-107,0,277,0,6
1,2450,2333,117,0,40,0,6
1,2387,2435,-48,0,264,1,6
1,2770,2655,115,0,345,1,6
1,2438,2463,-25,0,400,0,6
1,2467,2379,88,0,0,0,6
1,2438,2345,93,0,250,0,6
1,2645,2563,82,0,202,0,6
1,2258,2432,-174,0,195,0,8
1,2461,2321,140,0,250,0,6
1,2570,2531,39,0,140,0,6
1,2573,2564,9,0,41,0,6
1,2339,2406,-67,0,15,0,6
1,2445,2333,112,0,110,0,6
1,2416,2338,78,0,118,0,6
1,2458,2428,30,0,453,0,6
1,2456,2420,36,0,311,0,6
1,2502,2485,17,0,0,0,6
1,2308,2410,-102,0,311,0,6
1,2404,2472,-68,0,111,0,6
1,2309,2445,-136,0,28,1,6
1,2433,2267,166,0,48,1,6
1,2580,2480,100,0,229,0,6
1,2400,2342,58,0,56,1,6
1,2476,2581,-105,0,41,0,6
1,2405,2343,62,0,100,0,6
1,2526,2231,295,0,45,0,6
1,2265,2422,-157,0,9,0,6
1,2509,2431,78,0,200,0,6
1,2520,2457,63,0,200,0,6
1,2414,2486,-72,0,354,0,6
1,2313,2417,-104,0,80,0,6
1,2494,2586,-92,0,40,0,6
1,2359,2450,-91,0,135,0,6
1,2476,2504,-28,0,56,0,6
1,2308,2446,-138,0,130,0,6
1,2401,2425,-24,0,300,0,6
1,2401,2402,-1,0,58,1,6
1,2450,2230,220,0,277,1,6
1,2405,2386,19,0,414,0,6
1,2441,2280,161,0,207,0,6
1,2523,2467,56,0,43,1,6
1,2391,2411,-20,0,101,0,8
1,2412,2317,95,0,265,1,6
1,2402,2274,128,0,178,0,6
1,2593,2587,6,0,110,0,6
1,2603,2588,15,0,156,0,6
1,2334,2465,-131,0,242,1,6
1,2436,2485,-49,0,1,1,6
1,2573,2478,95,0,5,1,6
1,2220,2408,-188,0,40,0,6
1,2424,2340,84,0,297,1,6
1,2344,2405,-61,0,190,0,6
1,2353,2401,-48,0,300,0,6
1,2465,2487,-22,0,15,1,6
1,2476,2329,147,0,441,0,6
1,2532,2566,-34,0,215,0,6
1,2390,2543,-153,0,40,1,6
1,2440,2426,14,0,45,0,6
1,2455,2393,62,0,406,0,6
1,2424,2492,-68,0,107,0,6
1,2370,2497,-127,0,100,0,6
1,2397,2400,-3,0,251,0,6
1,2416,2351,65,0,4,0,6
1,2513,2531,-18,0,302,0,6
1,2578,2485,93,0,12,0,5
1,2489,2399,90,0,192,0,6
1,2417,2326,91,0,143,0,6
1,2361,2544,-183,0,45,0,6
1,2247,2409,-162,4,40,0,13
1,2548,2363,185,0,330,0,6
1,2546,2542,4,0,391,0,6
1,2441,2413,28,0,45,0,6
1,2537,2403,134,0,55,0,6
1,2453,2467,-14,0,242,0,6
1,2335,2477,-142,0,130,0,6
1,2426,2234,192,0,23,0,6
1,2429,2280,149,0,15,0,6
1,2435,2224,211,0,335,0,6
1,2576,2513,63,0,45,1,6
1,2530,2547,-17,0,426,1,6
1,2821,2436,385,0,205,0,6
1,2428,2402,26,0,40,0,6
1,2407,2242,165,0,302,0,6
1,2795,2645,150,0,106,0,6
1,2400,2364,36,0,67,0,6
1,2473,2472,1,0,46,0,6
1,2432,2293,139,0,310,0,6
1,2626,2287,339,0,448,1,6
1,2534,2506,28,0,45,0,6
1,2465,2304,161,0,153,0,6
1,2434,2469,-35,0,46,0,6
1,2474,2494,-20,0,4,0,6
1,2376,2463,-87,0,9,1,6
1,2407,2479,-72,0,100,0,6
1,2405,2410,-5,0,49,1,6
1,2578,2456,122,0,45,1,6
1,2360,2405,-45,0,244,0,6
1,2714,2295,419,0,264,0,6
1,2473,2430,43,0,302,0,6
1,2449,2300,149,0,40,0,8
1,2444,2518,-74,0,45,0,6
1,2394,2530,-136,0,487,0,6
1,2291,2419,-128,0,300,0,6
1,2390,2509,-119,0,302,0,6
1,2538,2429,109,0,300,1,6
1,2582,2462,120,0,190,0,6
1,2495,2379,116,0,107,1,6
1,2467,2279,188,0,43,0,6
1,2566,2397,169,0,469,0,6
1,2572,2454,118,0,302,1,6
1,2486,2389,97,0,259,0,6
1,2488,2404,84,0,258,0,6
1,2651,2660,-9,0,405,0,6
1,2609,2363,246,0,344,0,6
1,2326,2444,-118,0,154,0,6
1,2511,2427,84,0,215,1,6
1,2571,2359,212,0,112,0,6
1,2270,2583,-313,0,253,1,6
1,2370,2441,-71,0,400,0,6
1,2582,2364,218,0,41,0,6
1,2397,2429,-32,0,248,1,6
1,2552,2270,282,0,335,0,6
1,2408,2375,33,0,392,0,6
1,2402,2488,-86,0,13,1,6
1,2474,2463,11,0,110,0,6
1,2441,2287,154,0,45,0,6
1,2499,2354,145,0,311,0,6
1,2478,2410,68,0,11,0,6
1,2412,2374,38,0,106,0,6
1,2481,2487,-6,0,4,0,6
1,2479,2474,5,0,131,0,6
1,2480,2399,81,0,212,0,6
1,2421,2292,129,0,45,0,6
1,2471,2470,1,0,315,0,6
1,2561,2417,144,0,134,0,6
1,2419,2484,-65,0,201,0,6
1,2812,2552,260,0,7,0,6
1,2423,2423,0,0,354,0,6
1,2590,2735,-145,0,335,0,6
1,2408,2568,-160,0,302,0,6
1,2534,2251,283,0,106,0,6
1,2707,2564,143,0,46,0,6
1,2410,2413,-3,0,45,0,6
1,2420,2433,-13,0,218,1,6
1,2515,2558,-43,0,200,0,6
1,2611,2373,238,0,15,0,6
1,2245,2433,-188,0,125,1,6
1,2457,2325,132,0,107,0,6
1,2431,2317,114,0,40,1,6
1,2674,2390,284,0,4,0,6
1,2297,2424,-127,0,246,0,8
1,2417,2326,91,0,315,0,6
1,2594,2679,-85,0,121,0,6
1,2264,2431,-167,0,125,0,6
1,2411,2218,193,0,112,0,8
1,2617,2473,144,0,306,0,6
1,2365,2535,-170,0,107,1,6
1,2488,2499,-11,0,111,1,6
1,2401,2320,81,0,343,1,6
1,2449,2560,-111,0,56,0,6
1,2463,2516,-53,0,221,0,6
1,2441,2484,-43,0,260,0,6
1,2430,2387,43,0,201,0,6
1,2407,2372,35,0,140,0,6
1,2402,2388,14,0,102,1,6
1,2476,2633,-157,0,474,0,6
1,2510,2421,89,0,123,0,6
1,2427,2524,-97,0,11,0,6
1,2383,2411,-28,0,335,0,6
1,2446,2419,27,0,436,0,6
1,2553,2623,-70,0,102,0,6
1,2510,2340,170,0,151,0,6
1,2537,2374,163,0,212,0,6
1,2589,2393,196,0,190,0,6
1,2429,2391,38,0,200,1,6
1,2552,2553,-1,0,0,0,6
1,2552,2623,-71,0,157,0,6
1,2417,2411,6,0,145,0,6
1,2550,2395,155,0,0,0,6
1,2464,2296,168,0,172,0,6
1,2300,2454,-154,0,106,1,6
1,2591,2483,108,0,253,0,6
1,2433,2425,8,0,212,1,6
1,2401,2379,22,0,255,0,6
1,2541,2399,142,0,202,0,6
1,2226,2415,-189,0,45,0,6
1,2410,2308,102,0,150,0,6
1,2485,2515,-30,0,112,1,6
1,2412,2398,14,0,43,0,6
1,2454,2405,49,0,442,0,6
1,2640,2670,-30,0,192,0,6
1,2403,2425,-22,0,40,1,6
1,2465,2391,74,0,483,0,6
1,2447,2271,176,0,345,0,8
1,2406,2308,98,0,106,0,6
1,2338,2405,-67,0,1,0,6
1,2469,2421,48,0,250,0,6
1,2463,2584,-121,0,265,0,6
1,2461,2511,-50,0,2,0,6
1,2427,2438,-11,0,313,0,6
1,2300,2401,-101,0,344,0,6
1,2582,2592,-10,0,150,0,6
1,2489,2378,111,0,40,0,6
1,2546,2486,60,0,325,0,6
1,2253,2403,-150,0,110,1,8
1,2366,2401,-35,0,380,0,6
1,2455,2504,-49,0,330,1,6
1,2310,2491,-181,0,301,0,6
1,2472,2497,-25,0,55,0,6
1,2360,2459,-99,0,306,1,6
1,2557,2403,154,0,45,0,6
1,2624,2574,50,0,116,0,6
1,2256,2426,-170,0,242,1,6
1,2536,2515,21,0,45,1,6
1,2508,2404,104,0,109,0,6
1,2410,2359,51,0,45,1,6
1,2655,2477,178,0,331,0,6
1,2411,2465,-54,0,303,1,6
1,2577,2313,264,0,40,1,8
1,2522,2414,108,0,70,0,6
1,2577,2605,-28,0,211,0,6
1,2415,2255,160,0,485,0,6
1,2444,2281,163,0,100,0,6
1,2607,2591,16,0,101,0,6
1,2428,2505,-77,0,6,0,6
1,2287,2469,-182,0,120,1,8
1,2604,2488,116,0,140,0,6
1,2554,2467,87,0,111,0,6
1,2404,2402,2,0,110,1,6
1,2432,2320,112,0,459,0,6
1,2606,2561,45,0,101,0,6
1,2461,2417,44,0,80,0,6
1,2552,2417,135,0,289,0,6
1,2604,2283,321,4,223,0,13
1,2470,2241,229,0,330,0,6
1,2660,2431,229,0,474,0,6
1,2491,2359,132,0,213,0,6
1,2357,2402,-45,0,411,0,6
1,2511,2398,113,0,48,1,6
1,2522,2468,54,0,265,0,6
1,2338,2400,-62,0,13,1,6
1,2401,2407,-6,0,192,0,6
1,2394,2400,-6,0,45,0,6
1,2507,2479,28,0,40,0,6
1,2564,2538,26,0,106,0,6
1,2544,2387,157,0,312,0,6
1,2457,2333,124,0,112,0,6
1,2397,2451,-54,0,123,1,6
1,2473,2457,16,0,254,0,6
1,2645,2578,67,0,4,0,6
1,2447,2446,1,0,453,1,6
1,2573,2470,103,0,207,0,6
1,2748,2662,86,0,107,1,6
1,2432,2419,13,0,292,0,6
1,2428,2391,37,0,45,1,6
1,2401,2223,178,0,241,0,6
1,2451,2502,-51,0,109,0,8
1,2595,2610,-15,0,194,0,6
1,2334,2436,-102,0,120,0,6
1,2727,2414,313,0,130,0,6
1,2571,2532,39,0,27,1,6
1,2488,2353,135,0,45,0,6
1,2540,2504,36,0,0,0,6
1,2475,2407,68,0,45,0,6
1,2436,2433,3,0,45,0,6
1,2462,2431,31,0,15,0,6
1,2330,2474,-144,0,122,0,6
1,2415,2320,95,0,0,1,6
1,2510,2360,150,0,4,0,6
1,2480,2550,-70,0,120,1,6
1,2439,2417,22,0,37,0,6
1,2430,2455,-25,0,112,0,6
1,2656,2451,205,0,151,0,6
1,2344,2419,-75,0,152,0,6
1,2400,2361,39,0,49,1,6
1,2412,2369,43,0,241,1,6
1,2423,2285,138,0,101,0,6
1,2477,2406,71,0,101,0,6
1,2387,2403,-16,0,122,0,6
1,2488,2423,65,0,140,1,6
1,2522,2706,-184,0,106,0,6
1,2583,2461,122,0,4,0,6
1,2491,2390,101,0,310,0,6
1,2536,2372,164,0,201,0,6
1,2543,2372,171,0,250,0,6
1,2441,2455,-14,0,1,1,6
1,2557,2592,-35,0,46,0,6
1,2406,2348,58,0,117,1,6
1,2491,2471,20,0,48,1,6
1,2566,2300,266,0,201,0,6
1,2331,2474,-143,0,1,1,6
1,2405,2273,132,4,310,1,13
1,2585,2429,156,0,343,0,6
1,2635,2224,411,4,134,0,11
1,2408,2351,57,0,278,1,6
1,2485,2451,34,0,101,0,6
1,2350,2434,-84,0,201,0,6
1,2498,2475,23,0,411,0,6
1,2427,2421,6,0,4,0,6
1,2292,2427,-135,4,211,0,8
1,2455,2296,159,0,15,1,6
1,2607,2322,285,0,201,0,8
1,2257,2464,-207,0,253,1,6
1,2422,2416,6,0,474,0,6
1,2454,2491,-37,0,110,0,6
1,2557,2498,59,0,45,0,6
1,2373,2420,-47,0,107,0,6
1,2696,2470,226,0,331,0,6
1,2497,2519,-22,0,314,0,6
1,2505,2351,154,0,41,0,6
1,2621,2587,34,0,306,0,6
1,2731,2578,153,0,0,1,6
1,2459,2360,99,0,302,0,6
1,2441,2332,109,0,200,0,6
1,2678,2534,144,0,280,0,6
1,2479,2540,-61,0,30,1,6
1,2666,2479,187,0,127,0,6
1,2607,2284,323,0,338,0,6
1,2517,2355,162,0,188,1,6
1,2412,2380,32,0,13,1,6
1,2582,2500,82,0,13,0,5
1,2519,2208,311,0,302,0,6
1,2344,2424,-80,0,152,1,6
1,2731,2615,116,0,267,1,6
1,2467,2490,-23,0,331,0,6
1,2768,2660,108,0,404,0,6
1,2361,2400,-39,0,197,0,8
1,2226,2590,-364,0,3,1,6
1,2462,2400,62,0,334,0,6
1,2382,2523,-141,0,414,0,6
1,2416,2533,-117,0,4,1,6
1,2374,2437,-63,0,60,1,6
1,2517,2457,60,0,90,0,6
1,2515,2398,117,0,100,0,6
1,2492,2417,75,0,320,0,6
1,2430,2260,170,0,101,1,6
1,2407,2359,48,0,101,0,6
1,2272,2510,-238,0,200,0,6
1,2461,2397,64,0,101,0,6
1,2402,2243,159,0,20,0,6
1,2498,2320,178,0,332,0,6
1,2451,2402,49,0,357,0,6
1,2480,2480,0,0,46,0,6
1,2405,2348,57,0,106,0,6
1,2379,2418,-39,0,152,0,6
1,2368,2419,-51,0,45,0,6
1,2462,2287,175,0,158,0,6
1,2488,2428,60,0,31,0,6
1,2408,2411,-3,0,202,0,6
1,2451,2387,64,0,315,0,6
1,2822,2625,197,0,333,0,6
1,2290,2411,-121,0,45,0,6
1,2364,2444,-80,0,0,0,6
1,2501,2421,80,0,151,0,6
1,2451,2467,-16,0,242,0,6
1,2588,2388,200,0,123,0,6
1,2286,2446,-160,0,84,0,6
1,2615,2555,60,0,406,0,6
1,2313,2427,-114,0,184,1,6
1,2409,2294,115,0,45,0,8
1,2430,2543,-113,0,202,1,6
1,2356,2468,-112,0,106,1,6
1,2489,2519,-30,0,301,0,6
1,2401,2226,175,0,264,0,6
1,2568,2438,130,0,122,1,6
1,2508,2381,127,0,200,0,6
1,2529,2488,41,0,210,0,6
1,2467,2485,-18,0,310,0,6
1,2486,2367,119,0,122,0,6
1,2310,2407,-97,0,33,0,6
1,2587,2679,-92,0,4,0,6
1,2413,2428,-15,0,110,0,6
1,2613,2497,116,0,253,0,6
1,2589,2603,-14,0,250,0,6
1,2622,2585,37,0,453,0,6
1,2624,2271,353,0,43,0,6
1,2422,2416,6,0,200,0,6
1,2618,2268,350,0,311,0,6
1,2327,2478,-151,0,45,0,8
1,2492,2439,53,0,124,0,6
1,2362,2422,-60,0,106,1,6
1,2744,2658,86,0,110,0,6
1,2427,2241,186,0,100,1,8
1,2376,2431,-55,0,202,1,6
1,2445,2413,32,0,268,0,6
1,2445,2451,-6,0,42,0,6
1,2277,2477,-200,0,337,0,5
1,2406,2243,163,0,40,0,6
1,2439,2360,79,0,106,0,6
1,2480,2305,175,0,241,1,6
1,2462,2408,54,0,106,1,6
1,2424,2263,161,0,42,0,6
1,2438,2330,108,0,15,0,6
1,2551,2298,253,0,101,0,8
1,2406,2467,-61,0,112,0,6
1,2416,2354,62,0,6,0,6
1,2470,2314,156,0,41,0,6
1,2416,2340,76,0,193,0,6
1,2489,2693,-204,0,120,1,6
1,2446,2402,44,0,310,0,6
1,2500,2354,146,0,85,1,6
1,2414,2352,62,0,400,0,6
1,2326,2405,-79,0,180,1,6
1,2516,2540,-24,0,214,0,6
1,2590,2497,93,0,130,0,6
1,2454,2357,97,0,106,0,6
1,2343,2421,-78,0,202,0,6
1,2476,2446,30,0,89,0,6
1,2256,2407,-151,0,192,0,8
1,2526,2421,105,0,464,0,6
1,2441,2270,171,0,1,0,6
1,2523,2517,6,0,233,0,6
1,2429,2400,29,0,103,0,6
1,2515,2353,162,0,14,1,6
1,2526,2625,-99,0,132,0,6
1,2328,2463,-135,0,107,0,8
1,2458,2508,-50,0,380,0,6
1,2475,2298,177,0,50,1,6
1,2487,2390,97,0,40,0,6
1,2621,2337,284,0,154,0,8
1,2407,2575,-168,0,352,0,6
1,2457,2507,-50,0,374,1,6
1,2589,2440,149,0,300,0,6
1,2495,2454,41,0,206,0,6
1,2422,2402,20,0,380,0,6
1,2406,2389,17,0,130,0,6
1,2594,2509,85,0,64,1,6
1,2643,2492,151,0,101,0,6
1,2497,2405,92,0,435,0,6
1,2564,2433,131,0,123,1,6
1,2493,2352,141,0,11,0,6
1,2543,2382,161,0,333,0,6
1,2354,2400,-46,0,228,1,6
1,2409,2272,137,0,0,0,6
1,2485,2487,-2,0,0,0,6
1,2313,2446,-133,0,3,0,6
1,2416,2442,-26,0,15,1,6
1,2397,2490,-93,0,104,0,6
1,2458,2272,186,0,389,0,6
1,2464,2548,-84,0,300,0,6
1,2415,2211,204,0,133,0,8
1,2595,2527,68,0,228,0,6
1,2451,2474,-23,0,1,0,6
1,2522,2469,53,0,102,1,6
1,2499,2406,93,0,45,1,6
1,2584,2582,2,0,40,0,6
1,2590,2505,85,0,106,0,6
1,2530,2349,181,0,1,0,6
1,2474,2353,121,0,40,0,6
1,2527,2492,35,0,196,0,6
1,2405,2314,91,0,110,0,6
1,2347,2477,-130,0,91,0,6
1,2720,2499,221,0,341,0,6
1,2441,2370,71,0,16,1,6
1,2310,2461,-151,0,315,0,6
1,2604,2646,-42,0,302,0,6
1,2515,2531,-16,0,473,1,6
1,2408,2409,-1,0,302,0,6
1,2466,2436,30,0,180,0,6
1,2328,2408,-80,0,113,0,6
1,2419,2270,149,0,45,0,8
1,2413,2407,6,0,352,0,6
1,2454,2486,-32,0,10,1,6
1,2559,2451,108,0,128,0,6
1,2371,2419,-48,0,200,0,6
1,2391,2432,-41,0,455,0,8
1,2406,2372,34,0,201,0,6
1,2579,2516,63,0,123,0,6
1,2359,2415,-56,0,490,0,6
1,2434,2295,139,0,115,0,6
1,2740,2626,114,0,241,0,6
1,2544,2657,-113,0,122,1,6
1,2454,2355,99,0,178,0,6
1,2434,2246,188,0,178,0,6
1,2486,2442,44,0,485,0,6
1,2309,2459,-150,0,36,0,6
1,2415,2409,6,0,40,0,6
1,2551,2497,54,0,150,0,6
1,2437,2521,-84,0,88,0,6
1,2503,2403,100,0,120,0,6
1,2531,2387,144,0,245,1,6
1,2458,2464,-6,0,42,0,6
1,2430,2449,-19,0,132,0,6
1,2622,2680,-58,0,320,0,6
1,2494,2523,-29,0,461,0,6
1,2434,2313,121,0,306,0,6
1,2539,2312,227,0,40,0,6
1,2486,2310,176,0,302,0,6
1,2408,2408,0,0,343,0,6
1,2407,2372,35,0,6,0,6
1,2438,2355,83,0,101,0,6
1,2431,2438,-7,0,49,1,6
1,2507,2406,101,0,392,0,6
1,2475,2428,47,0,106,0,6
1,2407,2424,-17,0,463,1,6
1,2518,2645,-127,0,0,0,6
1,2405,2464,-59,0,265,1,6
1,2341,2417,-76,0,468,1,6
1,2520,2523,-3,0,124,1,6
1,2450,2463,-13,0,250,0,6
1,2477,2301,176,0,211,0,6
1,2374,2415,-41,0,2,1,6
1,2387,2463,-76,0,43,0,6
1,2357,2466,-109,0,112,0,6
1,2267,2489,-222,0,354,1,6
1,2463,2440,23,0,210,0,6
1,2482,2371,111,0,4,0,6
1,2411,2245,166,0,101,1,8
1,2232,2401,-169,0,133,0,5
1,2666,2267,399,2,147,0,24
1,2426,2365,61,0,46,0,6
1,2557,2369,188,0,300,0,6
1,2583,2396,187,0,45,0,6
1,2528,2455,73,0,320,0,6
1,2640,2649,-9,0,0,0,6
1,2351,2450,-99,0,320,0,6
1,2361,2409,-48,0,147,0,6
1,2548,2467,81,0,150,0,6
1,2642,2463,179,0,487,0,6
1,2238,2464,-226,0,112,1,6
1,2250,2408,-158,0,474,0,6
1,2485,2555,-70,0,302,0,6
1,2486,2228,258,0,330,1,6
1,2560,2541,19,0,464,1,6
1,2407,2314,93,0,302,0,10
1,2433,2344,89,0,302,0,6
1,2453,2416,37,0,303,1,6
1,2377,2423,-46,0,338,1,6
1,2429,2384,45,0,30,0,6
1,2510,2504,6,0,8,0,6
1,2604,2490,114,0,469,1,6
1,2421,2455,-34,0,277,0,6
1,2303,2410,-107,0,337,1,6
1,2571,2450,121,0,300,0,6
1,2405,2463,-58,0,260,0,6
1,2474,2465,9,0,102,0,6
1,2528,2448,80,0,7,0,6
1,2434,2440,-6,0,335,0,6
1,2449,2476,-27,0,46,0,5
1,2438,2400,38,0,345,1,6
1,2609,2427,182,0,126,0,6
1,2459,2545,-86,0,202,0,6
1,2452,2524,-72,0,46,0,6
1,2446,2357,89,0,0,0,6
1,2466,2395,71,0,107,1,6
1,2449,2302,147,0,100,0,6
1,2549,2482,67,0,120,0,6
1,2665,2642,23,0,39,0,6
1,2770,2599,171,0,335,0,6
1,2383,2441,-58,0,385,1,6
1,2427,2346,81,0,140,0,6
1,2487,2438,49,0,45,0,6
1,2385,2464,-79,0,398,1,6
1,2557,2424,133,0,242,0,6
1,2439,2452,-13,0,7,0,6
1,2389,2408,-19,0,20,0,6
1,2418,2348,70,0,4,0,6
1,2632,2539,93,0,327,0,6
1,2450,2357,93,0,331,0,6
1,2440,2244,196,0,15,0,6
1,2431,2537,-106,0,1,1,6
1,2425,2359,66,0,13,1,6
1,2441,2264,177,4,229,1,13
1,2429,2322,107,0,8,0,6
1,2369,2485,-116,0,40,0,6
1,2287,2439,-152,0,15,0,6
1,2530,2581,-51,0,112,1,6
1,2401,2389,12,0,144,0,8
1,2449,2398,51,0,38,0,8
1,2450,2275,175,0,101,0,6
1,2449,2408,41,0,302,1,6
1,2381,2525,-144,0,123,1,6
1,2436,2279,157,4,101,1,13
1,2501,2482,19,0,348,0,6
1,2470,2467,3,0,310,0,6
1,2508,2453,55,0,453,0,6
1,2674,2792,-118,0,132,0,6
1,2400,2223,177,0,0,0,6
1,2407,2391,16,0,45,0,6
1,2425,2258,167,4,245,0,13
1,2479,2306,173,0,190,0,6
1,2455,2401,54,0,300,0,6
1,2411,2321,90,0,122,0,6
1,2511,2569,-58,0,112,0,6
1,2571,2479,92,0,45,0,6
1,2234,2447,-213,0,463,1,6
1,2402,2401,1,0,0,0,6
1,2647,2636,11,0,113,0,6
1,2318,2470,-152,0,278,0,6
1,2418,2448,-30,0,461,0,6
1,2418,2357,61,0,200,0,6
1,2440,2432,8,0,207,0,6
1,2662,2600,62,0,311,0,6
1,2374,2405,-31,0,70,1,6
1,2326,2401,-75,0,100,0,6
1,2307,2571,-264,0,110,0,6
1,2330,2423,-93,0,344,0,6
1,2453,2402,51,0,128,1,6
1,2595,2387,208,0,46,0,6
1,2405,2442,-37,0,311,1,6
1,2422,2399,23,0,0,0,6
1,2552,2545,7,0,62,0,6
1,2347,2459,-112,0,201,0,6
1,2422,2314,108,0,301,0,6
1,2614,2529,85,0,398,0,6
1,2351,2444,-93,0,107,0,6
1,2484,2388,96,0,112,1,6
1,2457,2313,144,0,25,0,6
1,2404,2427,-23,0,40,1,6
1,2412,2542,-130,0,307,0,6
1,2303,2412,-109,0,337,1,6
1,2513,2391,122,0,398,0,6
1,2612,2513,99,0,45,0,6
1,2360,2504,-144,0,9,0,6
1,2556,2612,-56,0,208,0,6
1,2642,2627,15,0,190,0,6
1,2336,2452,-116,0,45,0,6
1,2476,2258,218,0,205,0,6
1,2475,2404,71,0,40,0,6
1,2436,2484,-48,0,112,0,6
1,2365,2431,-66,0,207,0,8
1,2550,2487,63,0,31,0,6
1,2488,2369,119,0,311,0,6
1,2445,2319,126,0,44,0,6
1,2489,2521,-32,0,46,0,6
1,2432,2358,74,0,466,0,6
1,2408,2322,86,0,0,0,6
1,2414,2532,-118,0,55,0,6
1,2499,2425,74,0,1,0,6
1,2489,2526,-37,0,4,1,6
1,2435,2471,-36,0,218,0,6
1,2408,2284,124,0,8,1,6
1,2475,2389,86,0,106,0,6
1,2402,2461,-59,0,58,0,6
1,2747,2658,89,0,110,0,6
1,2401,2288,113,0,200,0,6
1,2455,2517,-62,0,106,0,6
1,2548,2528,20,0,13,0,6
1,2386,2412,-26,0,156,1,6
1,2474,2424,50,0,187,0,6
1,2366,2462,-96,0,194,0,6
1,2629,2646,-17,0,0,0,6
1,2565,2569,-4,0,338,0,6
1,2545,2564,-19,0,0,1,6
1,2661,2385,276,0,300,0,6
1,2611,2793,-182,0,4,1,6
1,2453,2329,124,0,41,0,6
1,2459,2480,-21,0,373,0,6
1,2518,2470,48,0,110,1,6
1,2290,2444,-154,0,50,0,8
1,2542,2596,-54,0,301,1,6
1,2422,2560,-138,0,40,0,6
1,2368,2470,-102,0,40,1,6
1,2413,2237,176,0,46,0,6
1,2533,2418,115,0,100,0,6
1,2314,2492,-178,0,0,0,6
1,2430,2361,69,0,112,0,6
1,2489,2230,259,0,257,0,6
1,2464,2312,152,0,192,0,6
1,2505,2523,-18,0,138,0,6
1,2344,2442,-98,0,101,1,6
1,2560,2556,4,0,248,1,6
1,2409,2207,202,0,213,0,6
1,2514,2345,169,0,101,0,6
1,2528,2364,164,0,10,0,6
1,2436,2388,48,0,48,0,6
1,2520,2627,-107,0,4,0,6
1,2473,2335,138,0,112,0,6
1,2512,2542,-30,0,0,0,6
1,2453,2306,147,0,28,0,6
1,2520,2219,301,0,45,0,6
1,2324,2418,-94,0,43,0,6
1,2449,2303,146,0,110,0,6
1,2255,2405,-150,0,114,1,6
1,2378,2412,-34,0,26,0,6
1,2627,2329,298,0,1,0,6
1,2406,2428,-22,0,380,0,6
1,2347,2411,-64,0,302,0,6
1,2680,2540,140,0,142,0,6
1,2499,2392,107,0,263,0,6
1,2553,2576,-23,0,101,0,6
1,2397,2403,-6,0,190,0,6
1,2444,2377,67,0,50,0,6
1,2567,2567,0,0,300,0,6
1,2433,2270,163,0,131,1,6
1,2315,2451,-136,0,122,0,6
1,2467,2442,25,0,300,1,6
1,2464,2470,-6,0,123,0,6
1,2807,2479,328,0,454,0,6
1,2505,2456,49,0,200,0,6
1,2447,2457,-10,0,112,0,6
1,2589,2832,-243,0,302,1,6
1,2499,2391,108,0,338,0,6
1,2484,2350,134,0,106,0,6
1,2500,2428,72,0,375,0,6
1,2425,2354,71,0,403,0,6
1,2467,2361,106,0,4,0,6
1,2415,2404,11,0,302,0,6
1,2465,2597,-132,0,122,0,6
1,2383,2439,-56,0,2,0,6
1,2409,2335,74,0,248,1,6
1,2429,2367,62,0,335,0,6
1,2558,2602,-44,0,211,0,6
1,2735,2406,329,0,5,0,6
1,2498,2225,273,0,380,0,6
1,2398,2551,-153,0,265,1,6
1,2405,2293,112,0,302,1,6
1,2504,2365,139,0,13,0,6
1,2386,2470,-84,0,129,0,6
1,2596,2429,167,0,410,0,6
1,2542,2577,-35,0,10,0,6
1,2380,2458,-78,0,61,0,6
1,2446,2374,72,0,200,0,6
1,2340,2419,-79,0,45,0,6
1,2336,2435,-99,0,178,0,6
1,2691,2559,132,0,438,0,6
1,2341,2414,-73,0,119,0,6
1,2339,2480,-141,0,40,0,6
1,2408,2502,-94,0,410,0,6
1,2500,2452,48,0,123,1,6
1,2576,2616,-40,0,24,0,6
1,2416,2514,-98,0,106,1,6
1,2334,2409,-75,0,11,0,8
1,2465,2419,46,0,454,0,6
1,2489,2314,175,4,300,1,13
1,2551,2496,55,0,15,0,6
1,2561,2476,85,0,45,1,6
1,2279,2432,-153,0,142,0,6
1,2806,2595,211,0,190,1,6
1,2672,2564,108,0,142,0,6
1,2334,2400,-66,0,213,1,6
1,2258,2408,-150,0,466,1,6
1,2610,2531,79,0,45,1,6
1,2499,2541,-42,0,308,0,6
1,2282,2406,-124,0,46,0,6
1,2461,2302,159,0,302,0,8
1,2547,2604,-57,0,300,0,6
1,2442,2354,88,0,241,0,6
1,2314,2409,-95,0,20,0,6
1,2385,2528,-143,0,311,0,6
1,2427,2253,174,0,120,0,8
1,2285,2437,-152,0,203,0,6
1,2648,2478,170,0,125,0,6
1,2448,2377,71,0,15,0,6
1,2586,2563,23,0,107,0,6
1,2441,2351,90,0,106,0,6
1,2402,2435,-33,0,10,0,6
1,2382,2435,-53,0,302,0,6
1,2511,2356,155,0,404,0,6
1,2471,2368,103,0,302,0,6
1,2409,2355,54,0,58,0,6
1,2463,2335,128,0,39,0,6
1,2418,2259,159,0,140,1,6
1,2508,2515,-7,0,46,1,6
1,2506,2432,74,0,140,0,6
1,2394,2430,-36,0,43,0,6
1,2422,2287,135,0,4,0,6
1,2465,2335,130,0,335,0,6
1,2468,2410,58,0,132,0,6
1,2460,2377,83,0,202,0,6
1,2433,2393,40,0,300,0,8
1,2433,2412,21,0,250,1,6
1,2514,2332,182,0,132,0,6
1,2412,2299,113,0,38,0,6
1,2412,2252,160,0,45,0,6
1,2491,2399,92,0,440,1,6
1,2468,2460,8,0,211,0,6
1,2465,2431,34,0,43,1,6
1,2664,2491,173,0,469,1,6
1,2399,2564,-165,0,3,0,6
1,2394,2478,-84,0,241,1,8
1,2404,2422,-18,0,10,0,6
1,2426,2287,139,0,43,1,6
1,2474,2516,-42,0,427,1,6
1,2549,2560,-11,0,112,0,6
1,2548,2506,42,0,4,0,6
1,2437,2257,180,0,152,0,6
1,2449,2370,79,0,106,0,6
1,2497,2265,232,0,102,0,6
1,2451,2332,119,0,241,0,8
1,2425,2258,167,0,102,1,6
1,2490,2400,90,0,300,1,6
1,2436,2380,56,0,0,1,6
1,2452,2416,36,0,416,0,6
1,2604,2348,256,0,248,0,6
1,2437,2299,138,0,328,0,6
1,2404,2556,-152,0,1,0,6
1,2407,2533,-126,0,308,0,6
1,2418,2243,175,0,382,0,6
1,2216,2400,-184,0,122,1,6
1,2400,2284,116,0,104,1,6
1,2278,2446,-168,0,0,0,6
1,2560,2432,128,0,150,0,6
1,2405,2445,-40,0,310,0,6
1,2434,2499,-65,0,206,1,6
1,2438,2281,157,0,150,0,6
1,2298,2476,-178,0,302,0,6
1,2572,2426,146,0,115,1,6
1,2405,2337,68,0,15,0,5
1,2547,2429,118,0,120,0,6
1,2449,2301,148,0,123,0,6
1,2684,2581,103,0,101,1,6
1,2592,2509,83,0,45,0,6
1,2460,2272,188,0,107,0,6
1,2324,2409,-85,0,454,0,6
1,2435,2420,15,0,100,1,6
1,2521,2441,80,0,269,0,6
1,2576,2564,12,0,300,0,6
1,2420,2361,59,0,90,0,6
1,2386,2550,-164,0,41,0,6
1,2459,2334,125,0,156,0,6
1,2349,2452,-103,0,1,0,6
1,2424,2371,53,0,212,0,6
1,2433,2249,184,0,40,1,6
1,2521,2489,32,0,140,0,6
1,2352,2400,-48,0,345,0,6
1,2350,2524,-174,0,126,0,6
1,2235,2410,-175,0,107,0,6
1,2442,2385,57,0,463,0,6
1,2417,2427,-10,0,133,0,6
1,2457,2341,116,0,152,0,8
1,2482,2476,6,0,10,0,6
1,2450,2366,84,0,307,1,6
1,2595,2518,77,0,10,0,6
1,2461,2399,62,0,5,0,6
1,2418,2438,-20,0,106,1,6
1,2437,2368,69,0,101,0,6
1,2516,2472,44,0,316,0,6
1,2407,2239,168,0,210,0,6
1,2421,2316,105,0,6,1,6
1,2579,2578,1,0,45,1,6
1,2418,2402,16,0,37,0,6
1,2410,2409,1,0,30,1,6
1,2492,2353,139,0,484,1,6
1,2572,2355,217,0,341,1,6
1,2438,2526,-88,0,380,0,6
1,2441,2390,51,0,200,0,6
1,2409,2305,104,0,145,0,6
1,2655,2668,-13,0,45,0,6
1,2478,2559,-81,0,359,0,6
1,2356,2418,-62,0,54,0,6
1,2437,2310,127,0,102,0,6
1,2449,2363,86,0,106,1,6
1,2435,2383,52,0,240,1,6
1,2369,2536,-167,0,277,0,6
1,2546,2703,-157,0,310,1,6
1,2491,2421,70,0,40,1,6
1,2423,2329,94,0,107,1,6
1,2571,2507,64,0,37,0,6
1,2348,2446,-98,0,46,0,6
1,2512,2423,89,0,45,0,6
1,2494,2558,-64,0,206,0,6
1,2439,2260,179,0,111,1,6
1,2475,2588,-113,0,271,0,6
1,2482,2316,166,0,267,1,6
1,2367,2478,-111,0,345,1,5
1,2436,2394,42,0,112,1,6
1,2472,2335,137,0,132,1,6
1,2590,2368,222,0,107,0,8
1,2490,2285,205,0,398,0,6
1,2489,2430,59,0,142,0,6
1,2535,2693,-158,0,0,0,6
1,2412,2445,-33,0,302,0,6
1,2608,2407,201,0,311,0,6
1,2410,2389,21,0,46,0,6
1,2507,2406,101,0,151,0,6
1,2469,2352,117,0,432,0,6
1,2493,2424,69,0,324,0,6
1,2618,2401,217,0,278,0,6
1,2483,2427,56,0,331,0,6
1,2477,2356,121,0,40,0,6
1,2421,2458,-37,0,313,1,6
1,2375,2442,-67,0,245,0,6
1,2624,2522,102,0,427,0,6
1,2415,2309,106,0,62,0,6
1,2419,2262,157,0,122,0,6
1,2402,2459,-57,0,330,0,6
1,2467,2524,-57,0,21,1,6
1,2396,2405,-9,0,458,0,6
1,2431,2341,90,0,335,1,6
1,2473,2414,59,0,201,0,6
1,2470,2343,127,0,4,0,6
1,2511,2391,120,0,144,1,6
1,2372,2469,-97,0,4,1,6
1,2278,2435,-157,0,190,0,6
1,2513,2484,29,0,359,0,6
1,2496,2471,25,4,1,0,13
1,2351,2546,-195,0,106,0,6
1,2367,2401,-34,0,44,0,6
1,2479,2326,153,0,146,0,6
1,2473,2460,13,0,302,0,6
1,2492,2309,183,0,385,0,6
1,2663,2447,216,0,463,1,6
1,2480,2323,157,0,324,0,6
1,2475,2339,136,0,338,0,6
1,2560,2552,8,0,278,0,6
1,2347,2449,-102,0,35,0,6
1,2480,2414,66,0,101,0,6
1,2582,2394,188,0,1,0,6
1,2572,2538,34,0,13,1,6
1,2369,2455,-86,0,325,0,6
1,2350,2466,-116,0,4,0,6
1,2335,2426,-91,0,9,0,6
1,2332,2412,-80,0,107,0,6
1,2407,2395,12,0,332,0,6
1,2495,2557,-62,0,190,0,6
1,2577,2541,36,0,140,0,6
1,2451,2431,20,0,409,1,6
1,2505,2453,52,0,190,0,6
1,2456,2348,108,0,83,1,5
1,2304,2442,-138,0,106,1,6
1,2461,2526,-65,0,0,0,6
1,2681,2589,92,0,398,0,6
1,2404,2315,89,0,130,0,6
1,2450,2387,63,0,123,0,6
1,2243,2487,-244,0,45,0,6
1,2586,2655,-69,0,325,1,6
1,2482,2425,57,0,4,0,6
1,2802,2681,121,0,248,0,6
1,2392,2449,-57,0,106,1,6
1,2331,2409,-78,0,331,0,8
1,2408,2407,1,0,315,0,6
1,2507,2443,64,0,306,0,6
1,2627,2620,7,0,455,0,6
1,2414,2459,-45,0,337,1,6
1,2493,2424,69,0,122,0,6
1,2681,2505,176,0,45,1,6
1,2307,2412,-105,0,484,1,6
1,2502,2484,18,0,120,0,6
1,2626,2464,162,0,331,0,6
1,2606,2438,168,0,38,1,6
1,2524,2469,55,0,215,1,6
1,2527,2347,180,0,245,0,6
1,2435,2438,-3,0,270,0,6
1,2388,2461,-73,0,245,1,6
1,2495,2562,-67,0,107,0,6
1,2469,2387,82,0,16,0,6
1,2558,2539,19,0,228,0,6
1,2420,2413,7,0,297,0,6
1,2393,2418,-25,0,133,0,6
1,2355,2455,-100,0,5,0,8
1,2561,2403,158,0,335,0,6
1,2463,2374,89,0,311,1,6
1,2570,2241,329,0,345,0,6
1,2531,2554,-23,0,16,1,6
1,2524,2426,98,0,110,0,6
1,2434,2283,151,4,110,0,13
1,2369,2418,-49,0,106,0,6
1,2406,2432,-26,0,320,0,6
1,2307,2432,-125,0,389,0,6
1,2623,2582,41,0,302,0,6
1,2410,2259,151,0,405,0,8
1,2536,2600,-64,0,200,0,6
1,2427,2417,10,0,463,0,6
1,2432,2402,30,0,145,0,6
1,2481,2377,104,0,70,0,6
1,2455,2429,26,0,331,1,6
1,2409,2391,18,0,0,0,6
1,2244,2435,-191,0,45,0,6
1,2386,2465,-79,0,300,0,6
1,2396,2463,-67,0,200,0,6
1,2457,2359,98,0,300,0,6
1,2475,2467,8,0,100,1,6
1,2429,2432,-3,0,247,1,6
1,2426,2310,116,0,4,0,6
1,2576,2386,190,0,345,0,6
1,2393,2509,-116,0,2,0,6
1,2423,2433,-10,0,310,1,6
1,2417,2348,69,0,110,1,8
1,2568,2565,3,0,200,0,6
1,2430,2251,179,0,0,0,6
1,2482,2478,4,0,250,0,6
1,2482,2396,86,0,248,1,6
1,2414,2338,76,0,120,0,6
1,2519,2353,166,0,244,0,6
1,2439,2322,117,0,254,0,6
1,2358,2409,-51,4,190,0,13
1,2419,2321,98,0,414,1,6
1,2430,2263,167,0,395,0,6
1,2504,2507,-3,0,312,1,6
1,2510,2515,-5,0,311,0,6
1,2418,2383,35,0,253,0,6
1,2417,2515,-98,0,101,0,6
1,2412,2273,139,0,130,0,6
1,2421,2393,28,0,405,1,6
1,2431,2417,14,0,253,0,6
1,2402,2451,-49,0,480,0,6
1,2738,2581,157,0,301,0,6
1,2599,2643,-44,0,190,1,6
1,2496,2389,107,0,190,0,6
1,2492,2432,60,0,51,1,6
1,2459,2363,96,0,132,0,6
1,2301,2424,-123,0,101,0,6
1,2434,2371,63,0,70,0,6
1,2480,2473,7,0,125,0,6
1,2365,2467,-102,0,41,0,8
1,2330,2583,-253,0,3,0,6
1,2350,2427,-77,0,300,0,6
1,2434,2360,74,0,17,0,6
1,2475,2360,115,0,315,1,6
1,2288,2428,-140,0,426,0,6
1,2415,2592,-177,0,319,0,6
1,2237,2423,-186,0,415,0,6
1,2439,2496,-57,0,112,1,6
1,2418,2344,74,0,107,0,6
1,2487,2455,32,0,245,0,6
1,2577,2472,105,0,303,0,6
1,2472,2604,-132,0,130,1,6
1,2341,2544,-203,0,13,1,6
1,2448,2335,113,0,223,1,6
1,2408,2247,161,0,337,0,6
1,2512,2523,-11,0,46,1,6
1,2278,2449,-171,0,113,0,6
1,2410,2306,104,0,341,0,8
1,2482,2454,28,0,0,0,6
1,2514,2367,147,0,45,0,6
1,2470,2569,-99,0,218,0,6
1,2285,2541,-256,0,122,0,6
1,2564,2505,59,0,211,0,6
1,2402,2230,172,0,111,0,6
1,2208,2585,-377,0,123,0,6
1,2496,2312,184,0,45,0,6
1,2442,2489,-47,0,105,0,6
1,2466,2338,128,0,336,0,6
1,2566,2384,182,0,38,0,6
1,2265,2428,-163,0,56,0,6
1,2282,2684,-402,0,101,0,6
1,2503,2452,51,0,369,0,6
1,2556,2459,97,0,152,1,6
1,2424,2376,48,0,247,0,6
1,2501,2375,126,0,416,0,8
1,2280,2461,-181,0,101,0,6
1,2421,2293,128,0,463,0,5
1,2357,2471,-114,0,46,0,6
1,2318,2462,-144,0,110,1,8
1,2513,2439,74,0,263,0,6
1,2463,2313,150,0,300,0,6
1,2530,2564,-34,0,215,0,6
1,2511,2332,179,0,478,1,6
1,2521,2512,9,0,40,0,6
1,2498,2386,112,0,107,0,6
1,2652,2737,-85,0,41,1,6
1,2433,2406,27,0,171,0,6
1,2384,2407,-23,0,40,0,6
1,2715,2548,167,0,200,0,6
1,2312,2496,-184,0,389,0,6
1,2491,2616,-125,0,345,0,6
1,2414,2429,-15,0,49,0,6
1,2421,2208,213,0,36,0,5
1,2444,2260,184,0,300,1,6
1,2407,2318,89,0,0,0,6
1,2388,2413,-25,0,4,0,6
1,2400,2433,-33,0,100,0,6
1,2563,2417,146,0,113,0,6
1,2410,2371,39,0,415,0,6
1,2492,2234,258,0,130,0,6
1,2315,2409,-94,0,129,0,6
1,2352,2428,-76,0,102,1,6
1,2660,2477,183,0,28,0,6
1,2401,2394,7,0,0,0,6
1,2412,2404,8,0,247,1,6
1,2393,2403,-10,0,463,1,6
1,2415,2336,79,0,106,1,6
1,2378,2432,-54,0,242,0,6
1,2465,2334,131,0,212,0,6
1,2291,2403,-112,0,204,0,6
1,2497,2295,202,0,211,0,6
1,2255,2534,-279,0,269,0,6
1,2436,2605,-169,0,1,0,6
1,2566,2575,-9,0,190,0,6
1,2422,2281,141,0,380,0,6
1,2493,2317,176,0,105,0,6
1,2421,2292,129,0,114,0,6
1,2519,2376,143,0,454,0,6
1,2382,2418,-36,0,200,0,6
1,2326,2448,-122,0,28,0,6
1,2403,2379,24,0,332,1,6
1,2550,2398,152,0,40,0,6
1,2344,2448,-104,0,373,1,6
1,2408,2323,85,0,247,0,8
1,2423,2417,6,0,112,0,6
1,2795,2666,129,0,33,0,6
1,2385,2559,-174,0,300,0,6
1,2392,2449,-57,0,305,1,6
1,2463,2403,60,0,58,1,6
1,2520,2376,144,0,241,0,6
1,2494,2431,63,0,128,0,6
1,2295,2478,-183,0,207,0,6
1,2478,2366,112,0,394,0,6
1,2439,2244,195,0,7,0,6
1,2453,2368,85,0,110,0,6
1,2481,2529,-48,0,380,1,6
1,2428,2437,-9,0,45,1,6
1,2382,2573,-191,0,385,1,6
1,2418,2324,94,0,459,0,6
1,2422,2422,0,0,338,0,6
1,2517,2646,-129,0,469,0,6
1,2410,2400,10,0,157,1,6
1,2517,2444,73,0,337,0,6
1,2435,2355,80,0,205,0,6
1,2431,2258,173,0,245,0,6
1,2410,2450,-40,0,80,0,6
1,2584,2523,61,0,200,1,6
1,2424,2405,19,0,112,0,6
1,2560,2556,4,0,200,0,6
1,2404,2335,69,0,124,0,6
1,2334,2518,-184,0,125,0,6
1,2443,2452,-9,0,123,0,6
1,2437,2407,30,0,218,0,8
1,2515,2399,116,0,123,0,6
1,2466,2382,84,0,103,1,6
1,2685,2438,247,0,375,1,6
1,2383,2453,-70,0,253,0,6
1,2453,2485,-32,0,311,1,6
1,2558,2302,256,0,103,0,6
1,2428,2347,81,0,40,0,6
1,2442,2263,179,0,49,0,6
1,2412,2406,6,0,351,0,6
1,2453,2457,-4,0,2,1,6
1,2462,2468,-6,0,107,1,6
1,2467,2330,137,0,131,1,8
1,2452,2366,86,0,40,1,6
1,2209,2443,-234,0,428,0,6
1,2755,2254,501,0,134,0,6
1,2484,2346,138,0,203,1,6
1,2487,2460,27,0,31,0,6
1,2425,2404,21,0,13,0,6
1,2687,2467,220,0,112,0,6
1,2513,2349,164,0,104,0,6
1,2323,2425,-102,0,207,0,6
1,2481,2400,81,0,308,0,6
1,2372,2490,-118,0,4,0,6
1,2427,2409,18,0,226,0,6
1,2258,2400,-142,0,110,0,8
1,2335,2404,-69,0,43,0,6
1,2415,2343,72,0,110,0,8
1,2521,2521,0,0,302,1,6
1,2483,2497,-14,0,242,0,6
1,2600,2440,160,0,55,0,6
1,2575,2242,333,0,130,0,6
1,2478,2451,27,0,199,0,6
1,2444,2379,65,0,265,0,6
1,2601,2456,145,0,405,1,6
1,2448,2419,29,0,311,0,6
1,2400,2418,-18,0,337,0,6
1,2606,2585,21,0,398,1,6
1,2297,2429,-132,0,207,0,6
1,2493,2318,175,0,344,0,6
1,2463,2512,-49,0,120,0,6
1,2512,2414,98,0,15,0,6
1,2369,2446,-77,0,253,1,6
1,2763,2382,381,0,302,0,6
1,2748,2691,57,0,302,0,6
1,2407,2223,184,0,242,0,8
1,2432,2329,103,4,115,1,13
1,2565,2529,36,0,414,0,6
1,2540,2421,119,0,325,0,6
1,2431,2330,101,0,112,1,6
1,2483,2340,143,0,107,0,6
1,2482,2346,136,0,2,0,6
1,2437,2455,-18,0,133,1,6
1,2583,2388,195,0,241,0,5
1,2564,2319,245,0,11,0,6
1,2371,2454,-83,0,133,1,6
1,2504,2345,159,0,246,0,6
1,2446,2322,124,0,45,1,6
1,2439,2288,151,0,49,0,6
1,2568,2450,118,0,386,0,6
1,2447,2286,161,0,16,0,6
1,2267,2442,-175,0,128,1,6
1,2440,2253,187,0,107,0,6
1,2543,2541,2,0,40,0,6
1,2567,2560,7,0,100,0,6
1,2453,2428,25,0,142,0,6
1,2501,2400,101,0,40,1,8
1,2537,2355,182,0,100,0,6
1,2373,2435,-62,0,107,0,6
1,2466,2344,122,0,127,0,6
1,2424,2303,121,0,113,0,6
1,2601,2365,236,0,121,0,6
1,2426,2340,86,0,46,0,6
1,2299,2489,-190,0,343,0,6
1,2421,2270,151,0,242,0,6
1,2262,2427,-165,0,107,0,8
1,2526,2507,19,0,284,0,6
1,2508,2402,106,0,210,0,6
1,2401,2327,74,0,404,0,8
1,2519,2309,210,0,131,0,6
1,2523,2491,32,0,345,1,6
1,2425,2404,21,0,244,0,6
1,2408,2425,-17,0,40,0,6
1,2432,2360,72,0,100,0,6
1,2406,2252,154,0,121,0,6
1,2524,2441,83,0,202,0,6
1,2454,2360,94,0,373,0,6
1,2475,2457,18,0,246,1,6
1,2494,2580,-86,0,398,0,6
1,2396,2483,-87,0,10,0,6
1,2407,2310,97,0,405,1,6
1,2444,2320,124,0,100,1,6
1,2485,2374,111,0,80,0,6
1,2462,2398,64,0,131,0,6
1,2375,2425,-50,0,211,0,6
1,2386,2443,-57,0,106,1,6
1,2301,2407,-106,0,112,0,6
1,2386,2439,-53,0,4,0,6
1,2425,2238,187,0,227,0,6
1,2649,2565,84,0,414,1,6
1,2414,2356,58,0,45,1,6
1,2455,2375,80,0,46,0,8
1,2383,2467,-84,0,398,0,6
1,2520,2472,48,0,124,0,6
1,2529,2414,115,0,0,0,6
1,2435,2460,-25,0,346,0,6
1,2496,2391,105,0,207,0,6
1,2551,2477,74,0,45,0,6
1,2269,2468,-199,0,43,0,6
1,2478,2299,179,0,3,1,6
1,2448,2456,-8,0,302,1,6
1,2296,2486,-190,0,216,0,6
1,2401,2458,-57,0,200,0,6
1,2424,2246,178,0,111,1,6
1,2402,2551,-149,0,311,0,6
1,2521,2528,-7,0,5,1,6
1,2545,2366,179,0,254,0,6
1,2429,2330,99,0,45,0,6
1,2276,2429,-153,0,302,0,6
1,2419,2448,-29,0,133,0,6
1,2347,2418,-71,0,5,0,6
1,2520,2505,15,0,48,0,6
1,2419,2354,65,0,302,1,6
1,2462,2284,178,0,30,1,6
1,2534,2620,-86,0,120,0,6
1,2484,2339,145,0,0,0,6
1,2389,2419,-30,0,476,0,6
1,2481,2415,66,0,45,0,6
1,2401,2351,50,0,386,0,6
1,2405,2382,23,0,205,0,6
1,2465,2443,22,0,120,0,6
1,2382,2448,-66,0,365,0,6
1,2594,2462,132,0,461,0,6
1,2424,2302,122,0,211,0,6
1,2699,2404,295,0,487,0,6
1,2500,2404,96,0,40,1,6
1,2320,2431,-111,0,1,0,6
1,2445,2545,-100,0,200,0,6
1,2454,2395,59,0,123,0,6
1,2474,2481,-7,0,4,0,6
1,2504,2400,104,0,307,0,6
1,2483,2315,168,0,302,0,8
1,2329,2478,-149,0,0,0,6
1,2419,2400,19,0,205,0,6
1,2410,2249,161,0,121,0,6
1,2557,2535,22,0,57,0,6
1,2530,2219,311,0,21,0,6
1,2548,2545,3,0,300,0,6
1,2468,2453,15,0,487,0,6
1,2435,2326,109,0,466,1,6
1,2615,2577,38,0,43,1,6
1,2467,2335,132,0,57,0,6
1,2435,2491,-56,0,255,0,6
1,2433,2545,-112,0,17,1,6
1,2472,2334,138,0,143,0,6
1,2616,2419,197,0,301,0,6
1,2448,2301,147,0,188,0,6
1,2539,2551,-12,0,378,0,6
1,2409,2295,114,0,245,0,6
1,2460,2245,215,0,80,1,6
1,2465,2239,226,0,334,0,6
1,2319,2409,-90,0,150,0,8
1,2440,2396,44,0,90,0,6
1,2552,2231,321,0,255,1,6
1,2505,2410,95,0,301,0,6
1,2425,2536,-111,0,306,1,6
1,2429,2407,22,0,4,0,6
1,2566,2589,-23,0,386,1,6
1,2486,2447,39,0,10,1,6
1,2422,2249,173,0,48,0,6
1,2404,2401,3,0,106,0,6
1,2400,2463,-63,0,277,0,6
1,2454,2652,-198,0,107,1,6
1,2445,2299,146,0,121,1,6
1,2457,2368,89,0,122,1,6
1,2412,2422,-10,0,331,1,6
1,2548,2575,-27,0,101,0,6
1,2376,2403,-27,0,278,0,6
1,2456,2410,46,0,277,0,6
1,2693,2261,432,0,101,0,6
1,2452,2397,55,0,123,0,6
1,2541,2489,52,0,0,1,6
1,2487,2417,70,0,40,1,6
1,2502,2234,268,0,281,0,6
1,2402,2229,173,0,128,1,6
1,2459,2302,157,0,48,0,6
1,2496,2525,-29,0,4,1,6
1,2525,2533,-8,0,5,0,6
1,2414,2490,-76,0,133,1,6
1,2486,2368,118,0,95,0,6
1,2465,2497,-32,0,413,1,6
1,2418,2377,41,0,45,1,6
1,2465,2257,208,0,11,0,6
1,2434,2512,-78,0,101,1,6
1,2487,2347,140,0,330,0,6
1,2451,2372,79,0,6,0,6
1,2427,2289,138,0,69,0,6
1,2498,2278,220,0,152,1,6
1,2515,2411,104,0,277,0,6
1,2427,2386,41,0,110,0,6
1,2535,2299,236,0,337,0,6
1,2655,2500,155,0,374,0,6
1,2647,2635,12,0,123,0,6
1,2405,2397,8,0,45,1,6
1,2488,2316,172,0,310,0,6
1,2648,2452,196,0,90,0,6
1,2508,2499,9,0,463,0,6
1,2408,2429,-21,0,57,0,6
1,2421,2380,41,0,313,0,6
1,2424,2322,102,0,210,0,6
1,2515,2480,35,0,260,1,6
1,2515,2386,129,0,125,0,6
1,2449,2320,129,0,120,0,6
1,2389,2463,-74,0,302,1,6
1,2408,2315,93,0,0,1,6
1,2295,2400,-105,0,337,0,6
1,2543,2384,159,0,5,0,6
1,2535,2270,265,0,153,0,6
1,2481,2407,74,4,40,0,13
1,2447,2319,128,0,140,0,6
1,2411,2231,180,0,131,0,8
1,2585,2457,128,0,260,0,6
1,2420,2342,78,0,398,0,6
1,2382,2432,-50,0,331,0,6
1,2480,2543,-63,0,260,0,6
1,2454,2298,156,0,22,1,8
1,2384,2449,-65,0,16,0,6
1,2403,2399,4,0,415,1,6
1,2433,2416,17,0,200,0,6
1,2286,2447,-161,0,302,0,8
1,2399,2479,-80,0,132,0,6
1,2409,2390,19,0,334,0,6
1,2615,2389,226,0,304,0,6
1,2467,2219,248,0,22,0,6
1,2593,2313,280,0,132,0,6
1,2515,2374,141,0,300,1,6
1,2287,2417,-130,0,101,0,6
1,2552,2405,147,0,334,0,6
1,2565,2364,201,0,306,1,6
1,2488,2485,3,0,250,1,6
1,2575,2444,131,0,16,0,6
1,2412,2227,185,0,131,0,6
1,2292,2412,-120,0,40,0,6
1,2450,2478,-28,0,46,1,6
1,2430,2262,168,0,250,0,6
1,2423,2369,54,0,15,0,6
1,2486,2539,-53,0,300,1,6
1,2369,2423,-54,0,123,0,6
1,2438,2429,9,0,347,0,6
1,2543,2619,-76,0,157,0,6
1,2457,2468,-11,0,490,0,6
1,2365,2498,-133,0,3,0,6
1,2372,2417,-45,0,15,0,6
1,2646,2558,88,0,295,0,6
1,2432,2480,-48,0,118,1,6
1,2423,2418,5,0,405,0,6
1,2343,2426,-83,0,110,0,6
1,2310,2469,-159,0,132,0,6
1,2387,2508,-121,0,118,0,6
1,2462,2360,102,0,373,1,6
1,2420,2394,26,0,57,0,6
1,2672,2379,293,0,133,0,6
1,2365,2446,-81,0,263,0,6
1,2296,2415,-119,4,113,0,13
1,2467,2232,235,0,10,0,5
1,2444,2362,82,0,190,1,6
1,2430,2419,11,0,312,0,6
1,2389,2453,-64,0,386,0,6
1,2680,2622,58,0,330,0,6
1,2478,2431,47,0,415,0,6
1,2381,2471,-90,0,153,1,6
1,2323,2423,-100,0,10,0,6
1,2343,2428,-85,0,200,0,6
1,2649,2561,88,0,228,0,6
1,2482,2454,28,0,21,1,6
1,2473,2503,-30,0,241,0,6
1,2300,2415,-115,0,201,1,8
1,2709,2414,295,0,302,0,6
1,2419,2355,64,0,50,0,6
1,2501,2648,-147,0,244,1,6
1,2328,2406,-78,0,190,0,6
1,2426,2447,-21,0,202,0,6
1,2428,2276,152,0,218,0,6
1,2235,2500,-265,0,123,0,6
1,2381,2524,-143,0,1,0,6
1,2715,2691,24,0,50,0,6
1,2473,2381,92,0,130,1,6
1,2390,2452,-62,0,110,0,6
1,2465,2316,149,0,313,0,6
1,2343,2422,-79,0,58,0,6
1,2297,2425,-128,0,120,0,8
1,2593,2221,372,0,48,0,6
1,2506,2226,280,0,4,0,8
1,2433,2443,-10,0,415,1,6
1,2504,2464,40,0,386,0,6
1,2398,2483,-85,0,128,0,6
1,2287,2401,-114,0,300,1,6
1,2541,2540,1,0,7,0,6
1,2517,2423,94,0,120,0,6
1,2418,2442,-24,0,4,0,6
1,2545,2384,161,0,13,0,6
1,2364,2409,-45,0,388,0,6
1,2454,2519,-65,0,1,0,6
1,2329,2427,-98,0,335,0,6
1,2376,2403,-27,0,112,0,6
1,2480,2449,31,0,2,0,6
1,2538,2547,-9,0,118,0,6
1,2447,2394,53,0,330,0,6
1,2523,2422,101,0,113,0,6
1,2375,2427,-52,0,107,1,6
1,2400,2391,9,0,200,0,6
1,2438,2494,-56,0,100,0,6
1,2380,2444,-64,0,301,0,6
1,2381,2561,-180,0,101,0,6
1,2404,2405,-1,0,330,1,6
1,2475,2339,136,0,311,0,6
1,2394,2430,-36,0,13,1,6
1,2424,2325,99,0,217,0,6
1,2437,2324,113,0,130,0,5
1,2374,2422,-48,0,5,0,6
1,2544,2372,172,0,0,0,6
1,2416,2403,13,0,242,0,6
1,2436,2392,44,0,0,0,6
1,2269,2612,-343,0,38,0,6
1,2462,2219,243,4,108,0,0
1,2714,2602,112,0,380,0,6
1,2360,2408,-48,4,140,0,13
1,2743,2652,91,0,106,0,6
1,2299,2431,-132,0,107,1,6
1,2498,2461,37,0,300,0,6
1,2415,2245,170,0,121,0,6
1,2459,2406,53,0,91,1,6
1,2307,2467,-160,0,67,0,6
1,2606,2462,144,0,101,0,6
1,2543,2354,189,0,45,0,8
1,2273,2412,-139,0,46,1,6
1,2459,2388,71,0,15,0,6
1,2491,2345,146,0,59,0,6
1,2571,2407,164,0,13,0,6
1,2691,2481,210,0,302,0,6
1,2283,2412,-129,0,40,0,6
1,2676,2612,64,0,13,0,6
1,2501,2440,61,0,43,0,6
1,2428,2393,35,0,88,1,6
1,2405,2343,62,0,14,0,6
1,2451,2394,57,0,123,0,6
1,2408,2242,166,0,110,0,6
1,2477,2431,46,0,43,0,6
1,2516,2236,280,0,40,0,6
1,2677,2486,191,0,45,0,6
1,2410,2310,100,0,7,0,6
1,2539,2505,34,0,411,0,6
1,2212,2457,-245,0,201,0,6
1,2506,2520,-14,0,100,0,6
1,2434,2453,-19,0,4,0,6
1,2592,2642,-50,0,300,0,6
1,2472,2234,238,0,107,1,8
1,2743,2685,58,0,410,0,6
1,2515,2354,161,0,80,0,6
1,2427,2413,14,0,200,0,6
1,2384,2449,-65,0,122,0,8
1,2407,2310,97,0,112,0,6
1,2240,2437,-197,0,40,0,8
1,2529,2542,-13,0,101,0,6
1,2587,2367,220,0,190,0,6
1,2520,2660,-140,0,8,0,6
1,2436,2360,76,0,107,0,6
1,2420,2420,0,0,43,0,6
1,2754,2695,59,0,110,0,6
1,2428,2326,102,4,335,0,13
1,2466,2351,115,0,10,0,6
1,2685,2293,392,0,40,0,8
1,2600,2216,384,0,317,0,6
1,2643,2576,67,0,334,0,6
1,2460,2529,-69,0,8,0,6
1,2616,2560,56,0,386,0,6
1,2334,2431,-97,0,140,1,6
1,2452,2416,36,0,311,0,8
1,2394,2412,-18,0,4,1,6
1,2401,2390,11,0,429,1,6
1,2481,2412,69,0,437,0,6
1,2418,2407,11,0,426,0,6
1,2270,2405,-135,0,310,0,6
1,2533,2378,155,0,315,1,6
1,2466,2340,126,0,40,0,6
1,2465,2393,72,0,310,1,6
1,2410,2353,57,0,109,0,8
1,2405,2374,31,0,41,0,6
1,2434,2335,99,0,365,0,6
1,2416,2404,12,0,45,0,6
1,2398,2440,-42,0,470,1,6
1,2404,2209,195,0,106,0,6
1,2484,2372,112,0,330,0,6
1,2304,2428,-124,0,126,1,6
1,2402,2309,93,0,140,0,8
1,2407,2418,-11,0,105,0,6
1,2572,2294,278,0,123,0,8
1,2420,2275,145,0,110,0,6
1,2275,2446,-171,0,226,0,6
1,2447,2439,8,0,108,0,6
1,2447,2304,143,0,13,1,6
1,2552,2207,345,0,30,0,6
1,2403,2359,44,0,302,0,6
1,2409,2266,143,0,245,0,6
1,2563,2428,135,0,45,0,6
1,2580,2598,-18,0,107,0,6
1,2429,2429,0,0,162,1,6
1,2428,2323,105,0,300,0,6
1,2370,2429,-59,0,107,1,6
1,2501,2494,7,0,404,0,6
1,2455,2491,-36,0,337,0,6
1,2631,2556,75,0,123,0,6
1,2739,2562,177,0,211,0,6
1,2547,2256,291,0,112,0,6
1,2458,2302,156,0,143,0,6
1,2488,2341,147,0,110,0,6
1,2507,2405,102,0,331,1,6
1,2312,2431,-119,0,57,0,6
1,2471,2554,-83,0,60,1,6
1,2499,2371,128,0,121,1,6
1,2310,2411,-101,0,123,0,6
1,2699,2587,112,0,102,0,6
1,2579,2429,150,0,106,0,6
1,2464,2283,181,0,4,0,6
1,2454,2468,-14,0,128,1,6
1,2715,2650,65,0,301,0,6
1,2427,2498,-71,0,255,1,6
1,2530,2362,168,0,486,0,6
1,2639,2511,128,0,46,0,6
1,2367,2456,-89,0,212,0,6
1,2522,2501,21,0,123,0,6
1,2699,2664,35,0,380,0,6
1,2375,2403,-28,0,45,0,6
1,2457,2430,27,0,206,0,6
1,2451,2409,42,0,105,0,6
1,2436,2388,48,0,190,0,6
1,2452,2313,139,0,40,0,6
1,2834,2653,181,0,40,0,6
1,2278,2434,-156,0,106,0,6
1,2562,2562,0,0,331,0,6
1,2382,2404,-22,0,190,0,6
1,2460,2449,11,0,45,1,6
1,2544,2353,191,0,405,0,6
1,2352,2410,-58,0,149,0,6
1,2560,2383,177,0,85,0,6
1,2364,2537,-173,0,37,0,6
1,2455,2445,10,0,51,0,6
1,2283,2454,-171,0,6,1,6
1,2569,2523,46,0,453,0,6
1,2461,2475,-14,0,41,0,6
1,2435,2267,168,0,20,1,6
1,2448,2392,56,0,402,0,6
1,2406,2334,72,0,40,0,6
1,2421,2268,153,0,140,0,8
1,2409,2478,-69,0,268,0,6
1,2440,2360,80,0,484,0,6
1,2527,2536,-9,0,277,0,6
1,2580,2577,3,0,194,0,6
1,2361,2423,-62,0,151,0,8
1,2448,2230,218,0,225,0,6
1,2507,2450,57,0,100,1,6
1,2391,2454,-63,0,46,0,6
1,2670,2442,228,0,45,0,6
1,2400,2445,-45,0,196,1,6
1,2442,2379,63,0,414,0,6
1,2453,2392,61,0,110,0,8
1,2506,2520,-14,0,6,0,6
1,2337,2478,-141,0,123,0,6
1,2348,2467,-119,0,345,1,6
1,2851,2655,196,0,159,0,6
1,2353,2555,-202,0,105,0,6
1,2419,2430,-11,0,225,0,6
1,2466,2568,-102,0,10,1,6
1,2622,2547,75,0,111,0,6
1,2437,2322,115,0,487,0,6
1,2410,2418,-8,0,136,0,6
1,2601,2807,-206,0,101,0,6
1,2296,2443,-147,0,405,0,6
1,2409,2288,121,0,408,0,6
1,2481,2571,-90,0,300,0,6
1,2524,2583,-59,0,57,0,6
1,2627,2378,249,0,242,0,6
1,2461,2659,-198,0,45,0,6
1,2732,2668,64,0,487,0,6
1,2681,2580,101,0,301,0,6
1,2594,2363,231,0,27,1,6
1,2348,2413,-65,0,34,0,6
1,2279,2592,-313,0,113,0,6
1,2421,2348,73,0,306,0,6
1,2736,2630,106,0,492,0,6
1,2451,2484,-33,0,4,1,6
1,2587,2611,-24,0,291,0,6
1,2433,2304,129,0,83,0,6
1,2286,2443,-157,0,107,0,6
1,2435,2275,160,4,202,0,13
1,2341,2469,-128,0,106,0,6
1,2428,2415,13,0,112,0,6
1,2519,2442,77,0,15,0,8
1,2466,2334,132,0,330,0,6
1,2380,2421,-41,0,122,1,6
1,2342,2454,-112,0,122,1,6
1,2492,2509,-17,0,154,1,6
1,2400,2282,118,0,372,1,6
1,2461,2408,53,0,22,0,6
1,2601,2484,117,0,4,0,6
1,2364,2410,-46,0,9,0,6
1,2444,2408,36,0,142,1,6
1,2433,2223,210,0,108,0,6
1,2359,2436,-77,0,394,1,6
1,2488,2471,17,0,39,0,6
1,2412,2380,32,0,61,0,6
1,2421,2368,53,0,492,1,6
1,2438,2473,-35,0,418,0,6
1,2614,2745,-131,0,40,1,6
1,2699,2739,-40,0,337,0,6
1,2289,2423,-134,0,454,1,6
1,2427,2450,-23,0,246,0,6
1,2456,2323,133,0,80,0,6
1,2485,2399,86,0,246,0,6
1,2406,2505,-99,0,10,0,6
1,2539,2423,116,0,7,0,6
1,2419,2252,167,0,40,1,6
1,2698,2410,288,0,153,0,6
1,2320,2424,-104,0,140,0,6
1,2226,2431,-205,0,43,0,6
1,2485,2472,13,0,4,0,6
1,2448,2419,29,0,106,0,6
1,2433,2347,86,0,110,0,6
1,2411,2402,9,0,151,0,6
1,2427,2449,-22,0,4,1,6
1,2468,2498,-30,0,5,0,6
1,2539,2516,23,0,103,0,6
1,2311,2443,-132,0,1,0,6
1,2328,2501,-173,0,46,1,6
1,2433,2557,-124,0,10,0,6
1,2468,2522,-54,0,15,0,6
1,2454,2471,-17,0,227,1,6
1,2400,2413,-13,0,0,1,6
1,2542,2417,125,0,415,1,6
1,2510,2252,258,0,44,0,8
1,2398,2436,-38,0,11,1,6
1,2470,2432,38,0,113,0,6
1,2421,2452,-31,0,200,1,6
1,2314,2425,-111,0,253,0,6
1,2431,2361,70,0,9,0,6
1,2502,2346,156,0,330,0,6
1,2581,2216,365,0,8,0,6
1,2469,2440,29,0,46,0,6
1,2534,2366,168,0,218,0,6
1,2356,2466,-110,0,132,0,6
1,2411,2448,-37,0,1,1,6
1,2409,2293,116,0,405,0,6
1,2482,2295,187,4,101,0,13
1,2538,2466,72,0,140,0,6
1,2545,2324,221,0,57,0,6
1,2501,2403,98,0,122,1,6
1,2484,2277,207,0,150,0,6
1,2448,2320,128,0,57,1,6
1,2545,2491,54,0,462,1,6
1,2456,2419,37,0,331,1,6
1,2478,2200,278,0,300,0,6
1,2533,2550,-17,0,4,0,6
1,2418,2254,164,0,130,0,6
1,2522,2538,-16,0,316,0,6
1,2493,2505,-12,0,330,1,6
1,2499,2335,164,0,122,0,6
1,2392,2410,-18,0,291,1,6
1,2283,2419,-136,0,38,0,6
1,2327,2449,-122,0,7,1,6
1,2523,2472,51,0,13,0,6
1,2401,2292,109,0,120,1,6
1,2459,2402,57,0,131,0,8
1,2475,2453,22,0,182,0,6
1,2598,2443,155,0,0,0,6
1,2436,2410,26,0,211,1,6
1,2326,2436,-110,0,57,0,6
1,2667,2387,280,0,484,0,6
1,2582,2413,169,0,115,0,6
1,2380,2473,-93,0,255,1,6
1,2406,2330,76,0,49,0,6
1,2423,2313,110,0,45,0,6
1,2713,2394,319,0,218,0,6
1,2452,2400,52,0,485,0,6
1,2383,2438,-55,0,9,1,8
1,2468,2347,121,0,394,1,6
1,2516,2504,12,0,432,0,6
1,2452,2446,6,0,255,0,6
1,2473,2336,137,0,240,0,6
1,2479,2444,35,0,200,1,6
1,2310,2455,-145,0,40,1,6
1,2527,2455,72,0,335,1,5
1,2440,2430,10,0,150,0,6
1,2313,2440,-127,0,369,0,6
1,2529,2362,167,0,300,0,6
1,2492,2297,195,0,110,0,6
1,2449,2530,-81,0,200,0,6
1,2549,2386,163,0,40,0,6
1,2601,2523,78,0,108,0,6
1,2504,2347,157,0,334,0,6
1,2400,2580,-180,0,302,0,6
1,2406,2566,-160,0,140,0,6
1,2407,2310,97,0,150,0,6
1,2428,2311,117,0,4,1,5
1,2249,2420,-171,0,48,0,7
1,2505,2425,80,0,113,0,6
1,2536,2521,15,0,268,0,6
1,2444,2410,34,0,484,0,6
1,2475,2351,124,0,256,1,6
1,2517,2412,105,0,57,0,6
1,2460,2516,-56,0,55,1,6
1,2454,2320,134,0,218,0,6
1,2382,2434,-52,0,112,0,6
1,2405,2507,-102,0,100,0,6
1,2534,2524,10,0,265,1,6
1,2484,2439,45,0,484,1,6
1,2722,2325,397,0,104,0,6
1,2446,2429,17,0,230,0,6
1,2292,2454,-162,0,211,0,6
1,2484,2497,-13,0,8,0,6
1,2419,2252,167,0,241,0,6
1,2381,2431,-50,0,106,0,6
1,2470,2410,60,0,310,0,6
1,2458,2475,-17,0,11,0,6
1,2381,2405,-24,0,119,0,6
1,2434,2351,83,0,6,0,6
1,2494,2312,182,0,48,0,6
1,2337,2470,-133,0,5,0,6
1,2521,2331,190,0,101,0,6
1,2389,2507,-118,0,140,0,6
1,2505,2553,-48,0,21,0,6
1,2332,2502,-170,0,454,0,6
1,2352,2458,-106,0,122,0,6
1,2857,2555,302,0,46,1,6
1,2564,2265,299,0,315,1,6
1,2457,2426,31,0,414,0,6
1,2283,2400,-117,4,36,0,13
1,2410,2414,-4,0,154,0,6
1,2498,2446,52,0,458,0,6
1,2382,2504,-122,0,395,0,6
1,2402,2415,-13,0,101,0,6
1,2468,2372,96,0,45,1,6
1,2420,2425,-5,0,405,1,6
1,2389,2461,-72,0,45,0,6
1,2615,2505,110,0,4,0,6
1,2462,2341,121,0,202,0,6
1,2448,2307,141,0,107,0,6
1,2464,2379,85,0,46,0,6
1,2557,2496,61,0,216,0,6
1,2432,2462,-30,0,216,0,6
1,2570,2284,286,0,4,0,6
1,2428,2397,31,0,5,0,6
1,2502,2247,255,0,101,0,6
1,2467,2290,177,0,46,0,6
1,2412,2413,-1,0,175,0,6
1,2632,2490,142,0,311,1,6
1,2341,2426,-85,0,45,1,6
1,2508,2383,125,0,45,0,6
1,2468,2362,106,0,254,1,6
1,2335,2610,-275,0,106,1,6
1,2445,2555,-110,0,301,0,6
1,2447,2252,195,0,57,0,6
1,2619,2523,96,0,142,0,6
1,2430,2422,8,0,43,0,6
1,2474,2470,4,0,255,1,6
1,2475,2354,121,0,313,0,5
1,2404,2481,-77,0,101,1,6
1,2341,2508,-167,0,106,1,6
1,2471,2502,-31,0,201,0,6
1,2537,2421,116,0,301,0,6
1,2488,2628,-140,0,16,0,6
1,2406,2577,-171,0,0,0,6
1,2420,2509,-89,0,101,0,6
1,2472,2476,-4,0,107,0,6
1,2471,2512,-41,0,101,0,6
1,2352,2448,-96,0,45,0,6
1,2385,2449,-64,0,315,0,6
1,2263,2400,-137,0,376,0,6
1,2365,2448,-83,0,121,0,6
1,2483,2449,34,0,445,0,6
1,2415,2450,-35,0,241,0,8
1,2486,2462,24,0,200,1,6
1,2408,2201,207,0,112,0,6
1,2507,2472,35,0,16,0,6
1,2375,2433,-58,0,207,0,8
1,2535,2558,-23,0,43,0,6
1,2378,2418,-40,0,34,0,6
1,2239,2401,-162,0,285,0,6
1,2449,2508,-59,0,202,1,6
1,2432,2387,45,0,140,1,6
1,2460,2325,135,0,120,1,6
1,2548,2547,1,0,211,0,6
1,2512,2555,-43,0,32,0,6
1,2408,2465,-57,0,200,0,6
1,2558,2510,48,0,61,0,6
1,2607,2472,135,0,215,0,6
1,2498,2306,192,0,303,0,6
1,2434,2455,-21,0,140,0,6
1,2432,2255,177,0,106,0,6
1,2631,2612,19,0,4,1,6
1,2527,2516,11,0,101,0,6
1,2484,2523,-39,0,310,0,5
1,2388,2471,-83,0,40,0,6
1,2472,2504,-32,0,131,0,6
1,2607,2561,46,0,220,0,6
1,2415,2330,85,0,113,0,6
1,2425,2300,125,4,330,0,13
1,2442,2419,23,0,46,0,6
1,2500,2512,-12,0,100,0,6
1,2497,2525,-28,0,0,0,6
1,2517,2462,55,0,40,0,6
1,2402,2526,-124,0,40,0,6
1,2476,2287,189,0,4,0,6
1,2466,2300,166,0,320,0,6
1,2411,2483,-72,0,96,0,6
1,2419,2415,4,0,110,0,6
1,2453,2314,139,0,106,0,6
1,2317,2426,-109,0,474,0,6
1,2453,2377,76,0,186,0,6
1,2444,2350,94,0,335,0,6
1,2687,2559,128,0,141,0,6
1,2427,2323,104,0,354,0,6
1,2439,2409,30,0,140,0,6
1,2311,2433,-122,0,58,1,6
1,2469,2428,41,0,127,0,6
1,2411,2291,120,0,40,0,6
1,2339,2408,-69,0,211,0,6
1,2554,2485,69,0,11,1,6
1,2572,2519,53,0,201,0,6
1,2600,2615,-15,0,49,0,6
1,2409,2361,48,0,49,1,6
1,2521,2572,-51,0,45,0,6
1,2413,2312,101,0,455,0,6
1,2502,2569,-67,0,267,0,6
1,2358,2438,-80,0,40,0,6
1,2525,2504,21,0,224,0,6
1,2381,2426,-45,0,67,0,6
1,2572,2279,293,0,84,0,6
1,2603,2412,191,0,0,0,6
1,2451,2408,43,0,326,0,6
1,2475,2430,45,0,491,0,6
1,2510,2353,157,0,245,1,8
1,2433,2389,44,0,463,0,6
1,2460,2416,44,0,307,0,6
1,2452,2412,40,0,214,0,6
1,2420,2431,-11,0,106,0,6
1,2386,2589,-203,0,111,0,8
1,2587,2399,188,0,113,0,6
1,2590,2472,118,0,345,0,6
1,2532,2315,217,0,406,1,6
1,2293,2406,-113,0,36,1,6
1,2495,2321,174,0,190,1,6
1,2322,2421,-99,0,45,0,8
1,2462,2473,-11,0,300,0,6
1,2450,2626,-176,0,120,0,6
1,2576,2467,109,0,57,0,6
1,2382,2471,-89,0,40,0,6
1,2491,2465,26,0,100,0,6
1,2497,2391,106,0,4,0,6
1,2557,2627,-70,0,112,0,6
1,2410,2238,172,0,255,0,8
1,2445,2302,143,0,80,0,6
1,2558,2540,18,0,103,0,6
1,2289,2439,-150,0,302,0,6
1,2527,2472,55,0,490,0,6
1,2427,2402,25,0,202,0,6
1,2393,2438,-45,0,152,0,6
1,2420,2480,-60,0,112,0,6
1,2528,2337,191,0,200,1,6
1,2428,2423,5,0,101,0,6
1,2444,2326,118,0,156,0,6
1,2284,2447,-163,0,125,1,6
1,2421,2426,-5,0,453,0,6
1,2355,2479,-124,0,106,0,6
1,2403,2336,67,0,40,0,6
1,2739,2570,169,0,303,0,6
1,2428,2339,89,0,378,0,6
1,2237,2405,-168,0,106,0,6
1,2493,2428,65,0,18,0,6
1,2410,2482,-72,0,6,0,6
1,2556,2327,229,0,338,0,6
1,2472,2310,162,0,190,0,6
1,2808,2719,89,0,5,1,6
1,2673,2775,-102,0,246,0,6
1,2366,2449,-83,0,2,0,6
1,2424,2369,55,0,45,1,6
1,2588,2533,55,0,107,0,6
1,2450,2445,5,0,190,0,6
1,2690,2478,212,0,108,0,6
1,2492,2384,108,0,315,0,6
1,2469,2340,129,0,48,0,6
1,2464,2492,-28,0,4,0,6
1,2452,2205,247,0,43,1,6
1,2568,2472,96,0,136,0,6
1,2582,2320,262,0,8,1,6
1,2443,2459,-16,0,196,1,6
1,2483,2370,113,0,84,0,6
1,2421,2351,70,0,40,0,6
1,2342,2496,-154,0,100,0,6
1,2442,2320,122,0,0,1,6
1,2437,2343,94,0,217,0,6
1,2278,2423,-145,0,110,0,6
1,2482,2535,-53,0,0,0,6
1,2538,2414,124,0,306,1,6
1,2492,2444,48,0,127,0,6
1,2377,2537,-160,0,106,0,6
1,2508,2225,283,0,211,0,6
1,2414,2414,0,0,253,1,6
1,2440,2385,55,0,350,0,8
1,2430,2450,-20,0,244,0,6
1,2672,2439,233,0,46,0,6
1,2417,2303,114,0,200,0,5
1,2433,2273,160,0,0,0,6
1,2356,2520,-164,0,44,1,6
1,2444,2440,4,0,426,1,6
1,2419,2316,103,0,123,0,6
1,2434,2372,62,0,49,1,6
1,2684,2611,73,0,211,0,6
1,2431,2268,163,0,45,0,6
1,2519,2484,35,0,211,0,6
1,2530,2457,73,0,35,0,6
1,2449,2356,93,0,0,0,6
1,2361,2410,-49,0,5,0,6
1,2541,2344,197,0,12,0,6
1,2494,2374,120,0,45,0,6
1,2270,2424,-154,0,123,0,6
1,2561,2582,-21,0,113,0,6
1,2592,2389,203,0,125,0,6
1,2582,2371,211,0,12,1,6
1,2701,2516,185,0,263,0,6
1,2494,2352,142,0,44,0,6
1,2439,2305,134,0,84,0,6
1,2553,2365,188,0,107,0,6
1,2323,2437,-114,0,228,1,6
1,2480,2343,137,0,80,0,6
1,2412,2424,-12,0,45,0,6
1,2304,2496,-192,0,141,1,6
1,2757,2701,56,0,301,0,6
1,2561,2519,42,0,112,0,6
1,2631,2400,231,0,460,0,6
1,2447,2316,131,0,10,0,6
1,2408,2314,94,4,245,0,13
1,2467,2419,48,0,46,0,6
1,2511,2416,95,0,41,0,6
1,2392,2401,-9,0,305,0,6
1,2460,2437,23,0,112,0,6
1,2453,2436,17,0,4,0,6
1,2421,2378,43,0,13,0,6
1,2751,2660,91,0,101,0,6
1,2330,2522,-192,0,110,0,6
1,2366,2503,-137,0,202,1,6
1,2417,2311,106,0,330,0,6
1,2439,2333,106,0,123,1,6
1,2551,2414,137,0,112,0,6
1,2284,2448,-164,0,0,0,6
1,2273,2485,-212,0,200,0,6
1,2655,2774,-119,0,192,0,6
1,2412,2325,87,0,336,0,6
1,2428,2550,-122,0,35,0,6
1,2604,2342,262,4,455,0,10
1,2439,2249,190,0,310,0,6
1,2461,2437,24,0,406,0,6
1,2522,2449,73,0,351,0,6
1,2562,2672,-110,0,253,0,6
1,2520,2558,-38,0,151,0,6
1,2508,2630,-122,0,134,0,6
1,2391,2404,-13,0,210,0,6
1,2570,2384,186,0,138,0,6
1,2526,2472,54,0,345,0,6
1,2480,2289,191,0,311,0,6
1,2523,2394,129,0,3,0,6
1,2432,2592,-160,0,490,0,6
1,2449,2374,75,0,190,0,6
1,2532,2356,176,0,101,0,6
1,2628,2383,245,0,201,1,6
1,2391,2414,-23,0,297,0,6
1,2483,2445,38,0,190,0,6
1,2482,2307,175,0,1,0,6
1,2535,2590,-55,0,400,0,6
1,2443,2231,212,0,46,0,6
1,2411,2360,51,0,302,1,6
1,2488,2418,70,0,107,1,6
1,2381,2527,-146,0,304,0,6
1,2427,2396,31,0,49,0,6
1,2221,2414,-193,0,300,0,6
1,2405,2395,10,0,16,0,6
1,2433,2475,-42,0,1,1,6
1,2477,2453,24,0,250,0,6
1,2396,2485,-89,0,45,1,6
1,2403,2314,89,0,45,0,6
1,2466,2393,73,0,42,0,6
1,2537,2292,245,0,133,0,6
1,2350,2452,-102,0,302,0,6
1,2514,2551,-37,0,4,0,6
1,2481,2541,-60,0,145,1,6
1,2630,2538,92,0,331,0,6
1,2446,2506,-60,0,264,0,6
1,2545,2480,65,0,359,0,6
1,2532,2535,-3,0,258,1,6
1,2422,2413,9,0,123,0,6
1,2410,2315,95,0,48,0,6
1,2535,2499,36,0,314,0,6
1,2384,2416,-32,0,122,0,6
1,2348,2408,-60,0,113,1,6
1,2400,2360,40,0,123,0,6
1,2527,2589,-62,0,0,0,6
1,2440,2460,-20,0,300,0,6
1,2531,2295,236,0,218,0,6
1,2467,2568,-101,0,484,0,6
1,2439,2236,203,0,145,0,6
1,2409,2456,-47,0,48,0,6
1,2591,2390,201,0,181,0,6
1,2423,2364,59,0,45,1,6
1,2476,2511,-35,0,335,0,6
1,2432,2408,24,0,200,0,6
1,2433,2409,24,0,40,0,6
1,2414,2420,-6,0,432,0,6
1,2406,2267,139,0,4,0,6
1,2459,2255,204,0,255,0,6
1,2449,2211,238,0,302,0,8
1,2450,2303,147,0,110,0,6
1,2303,2424,-121,0,6,0,6
1,2438,2482,-44,0,4,0,6
1,2409,2421,-12,0,484,1,6
1,2470,2447,23,0,140,0,6
1,2738,2587,151,0,122,0,6
1,2407,2353,54,0,330,0,6
1,2423,2535,-112,0,202,0,6
1,2430,2350,80,0,277,0,6
1,2492,2450,42,0,100,0,6
1,2370,2409,-39,0,41,0,6
1,2329,2493,-164,0,106,0,6
1,2392,2438,-46,0,485,0,6
1,2391,2420,-29,0,211,1,6
1,2502,2201,301,0,133,0,6
1,2735,2448,287,0,128,0,6
1,2520,2413,107,0,145,0,6
1,2564,2710,-146,0,190,0,6
1,2416,2406,10,0,200,0,6
1,2565,2503,62,0,122,1,6
1,2559,2451,108,0,80,1,6
1,2550,2444,106,0,331,1,6
1,2424,2565,-141,0,103,1,6
1,2474,2355,119,0,410,1,6
1,2377,2406,-29,0,107,0,6
1,2453,2467,-14,0,242,1,6
1,2670,2358,312,0,218,1,6
1,2446,2520,-74,0,48,0,6
1,2494,2348,146,0,194,0,6
1,2728,2597,131,0,413,0,6
1,2542,2493,49,0,250,0,6
1,2430,2221,209,4,58,0,13
1,2455,2554,-99,0,190,0,6
1,2425,2271,154,0,121,0,6
1,2398,2426,-28,0,46,0,6
1,2475,2313,162,0,193,1,6
1,2414,2409,5,0,3,0,6
1,2411,2312,99,0,40,0,8
1,2723,2704,19,0,122,0,6
1,2473,2288,185,0,459,0,6
1,2477,2508,-31,0,302,0,6
1,2323,2456,-133,0,100,0,6
1,2561,2437,124,0,312,0,6
1,2528,2352,176,0,453,0,5
1,2567,2546,21,0,13,0,6
1,2264,2427,-163,0,46,0,6
1,2443,2364,79,0,176,0,6
1,2423,2339,84,0,297,0,6
1,2555,2418,137,0,459,1,6
1,2696,2480,216,0,127,0,6
1,2406,2266,140,0,143,0,6
1,2446,2462,-16,0,113,1,6
1,2514,2637,-123,0,267,0,6
1,2437,2417,20,0,1,0,6
1,2490,2359,131,0,94,0,6
1,2396,2436,-40,0,61,0,6
1,2433,2374,59,0,405,0,6
1,2442,2377,65,0,43,0,6
1,2316,2457,-141,0,255,0,6
1,2496,2467,29,0,326,1,6
1,2523,2480,43,0,331,0,6
1,2424,2417,7,0,120,1,6
1,2484,2359,125,0,106,0,6
1,2387,2475,-88,0,409,0,6
1,2365,2417,-52,0,385,0,6
1,2406,2445,-39,0,42,0,6
1,2402,2378,24,0,112,0,6
1,2482,2478,4,0,45,0,6
1,2430,2301,129,0,1,0,6
1,2545,2384,161,0,302,0,6
1,2437,2381,56,0,103,0,6
1,2442,2333,109,0,4,0,6
1,2652,2731,-79,0,400,0,6
1,2362,2408,-46,0,45,1,6
1,2569,2498,71,0,121,0,6
1,2400,2364,36,0,106,0,6
1,2375,2471,-96,0,46,0,8
1,2353,2403,-50,0,344,1,6
1,2582,2555,27,0,101,0,6
1,2651,2607,44,0,40,1,6
1,2433,2392,41,0,111,0,6
1,2398,2429,-31,0,1,0,6
1,2469,2346,123,0,13,0,8
1,2407,2378,29,0,337,0,6
1,2430,2312,118,0,485,0,6
1,2445,2229,216,4,45,1,13
1,2437,2257,180,0,300,0,6
1,2449,2337,112,0,130,0,6
1,2518,2376,142,0,224,0,6
1,2448,2315,133,0,40,1,6
1,2364,2481,-117,0,308,0,8
1,2451,2462,-11,0,394,1,6
1,2512,2462,50,0,46,0,6
1,2605,2600,5,0,196,1,6
1,2379,2400,-21,0,145,0,6
1,2311,2434,-123,0,213,0,6
1,2489,2554,-65,0,409,1,8
1,2578,2482,96,0,308,1,6
1,2452,2283,169,0,52,0,6
1,2425,2308,117,0,118,0,6
1,2476,2365,111,0,300,0,6
1,2421,2245,176,0,206,0,6
1,2296,2408,-112,0,107,0,6
1,2378,2453,-75,0,303,0,6
1,2272,2446,-174,0,152,0,6
1,2600,2436,164,0,100,0,6
1,2474,2402,72,0,112,0,6
1,2485,2384,101,0,411,0,6
1,2427,2419,8,0,249,0,6
1,2431,2380,51,0,241,1,6
1,2457,2397,60,0,127,0,6
1,2454,2384,70,0,132,0,6
1,2504,2213,291,0,10,0,6
1,2391,2401,-10,0,345,0,6
1,2420,2433,-13,0,4,0,6
1,2432,2303,129,0,0,0,6
1,2495,2401,94,0,122,1,6
1,2415,2429,-14,0,0,0,6
1,2469,2455,14,0,40,0,6
1,2491,2564,-73,0,345,1,6
1,2668,2312,356,0,190,0,6
1,2476,2540,-64,0,101,0,6
1,2381,2417,-36,0,219,0,6
1,2521,2552,-31,0,300,0,6
1,2282,2470,-188,0,140,1,6
1,2381,2550,-169,0,45,0,6
1,2600,2529,71,0,15,1,6
1,2492,2304,188,0,463,0,6
1,2409,2300,109,0,107,0,6
1,2393,2475,-82,0,152,0,6
1,2292,2412,-120,0,300,1,8
1,2587,2597,-10,0,37,0,6
1,2438,2353,85,0,255,0,6
1,2427,2436,-9,0,386,0,6
1,2409,2371,38,0,100,0,6
1,2425,2288,137,0,85,0,6
1,2511,2358,153,0,15,0,6
1,2419,2317,102,0,102,1,6
1,2619,2423,196,0,112,0,6
1,2533,2244,289,0,25,0,6
1,2300,2460,-160,0,156,0,6
1,2350,2429,-79,0,205,0,8
1,2451,2377,74,0,40,0,6
1,2341,2400,-59,0,37,1,6
1,2445,2331,114,0,331,0,6
1,2540,2388,152,0,244,1,6
1,2431,2267,164,0,0,0,6
1,2674,2712,-38,0,253,0,6
1,2431,2361,70,0,0,0,8
1,2391,2425,-34,0,45,0,6
1,2305,2461,-156,0,134,0,6
1,2537,2564,-27,0,46,0,6
1,2452,2368,84,0,15,0,6
1,2418,2352,66,0,240,1,6
1,2436,2362,74,0,43,0,6
1,2498,2284,214,0,80,0,6
1,2355,2402,-47,0,403,0,6
1,2752,2340,412,0,335,1,6
1,2509,2455,54,0,89,0,6
1,2385,2427,-42,0,107,1,6
1,2484,2408,76,0,112,0,6
1,2298,2568,-270,0,200,0,6
1,2606,2434,172,0,311,0,6
1,2474,2468,6,0,300,0,6
1,2528,2570,-42,0,403,0,6
1,2431,2431,0,0,6,0,6
1,2463,2287,176,0,7,1,6
1,2412,2363,49,0,4,0,6
1,2535,2403,132,0,108,0,6
1,2607,2558,49,0,113,1,6
1,2460,2318,142,0,128,0,6
1,2579,2562,17,0,459,1,6
1,2411,2441,-30,0,4,0,6
1,2542,2501,41,0,132,1,6
1,2645,2469,176,0,0,0,6
1,2630,2579,51,0,7,0,6
1,2753,2518,235,0,0,0,6
1,2338,2528,-190,0,0,0,6
1,2549,2258,291,0,176,0,6
1,2421,2348,73,0,115,0,6
1,2577,2509,68,0,0,0,6
1,2489,2478,11,0,50,0,6
1,2342,2406,-64,0,204,0,6
1,2469,2625,-156,0,101,0,6
1,2458,2238,220,0,411,1,6
1,2695,2569,126,0,405,0,6
1,2632,2646,-14,0,461,0,6
1,2344,2438,-94,0,180,0,6
1,2419,2434,-15,0,101,0,6
1,2327,2479,-152,0,117,0,6
1,2391,2432,-41,0,151,0,6
1,2421,2337,84,0,46,1,6
1,2752,2225,527,0,125,0,6
1,2488,2576,-88,0,4,0,6
1,2549,2495,54,0,123,0,6
1,2437,2391,46,0,319,0,6
1,2402,2392,10,0,40,0,6
1,2424,2470,-46,0,211,0,6
1,2249,2580,-331,0,134,0,6
1,2648,2629,19,0,45,0,6
1,2738,2527,211,0,46,0,6
1,2668,2531,137,0,106,0,6
1,2589,2412,177,0,1,0,6
1,2244,2401,-157,0,29,0,6
1,2457,2406,51,0,115,0,6
1,2463,2320,143,0,1,1,6
1,2401,2227,174,0,310,0,6
1,2399,2612,-213,0,302,1,6
1,2361,2515,-154,0,331,0,6
1,2445,2434,11,0,102,0,6
1,2437,2355,82,0,426,0,6
1,2500,2555,-55,0,8,0,6
1,2454,2377,77,0,411,0,6
1,2452,2431,21,0,47,1,6
1,2356,2478,-122,0,335,0,8
1,2444,2546,-102,0,301,0,6
1,2448,2311,137,0,128,0,6
1,2498,2341,157,0,40,0,6
1,2445,2440,5,0,414,0,6
1,2402,2416,-14,0,45,0,6
1,2400,2235,165,0,57,0,6
1,2473,2347,126,0,46,0,6
1,2499,2427,72,0,40,1,6
1,2645,2450,195,0,406,0,6
1,2453,2330,123,0,223,0,6
1,2414,2419,-5,0,41,0,6
1,2513,2486,27,0,119,1,6
1,2498,2516,-18,0,314,0,6
1,2622,2612,10,0,202,0,6
1,2565,2431,134,0,4,1,6
1,2412,2332,80,0,130,1,8
1,2378,2500,-122,0,1,0,6
1,2502,2547,-45,0,310,0,6
1,2404,2272,132,4,267,0,13
1,2418,2378,40,0,353,0,6
1,2428,2293,135,0,487,0,6
1,2446,2304,142,0,125,0,6
1,2466,2409,57,0,106,0,6
1,2488,2389,99,0,483,0,6
1,2487,2425,62,0,192,0,6
1,2654,2437,217,0,436,0,6
1,2416,2242,174,0,200,0,6
1,2473,2380,93,0,115,1,6
1,2467,2293,174,0,0,0,6
1,2616,2590,26,0,405,0,6
1,2434,2405,29,0,460,1,6
1,2448,2357,91,0,400,0,6
1,2424,2355,69,0,267,1,6
1,2426,2389,37,0,112,1,6
1,2433,2340,93,0,132,0,6
1,2639,2530,109,0,302,0,6
1,2383,2470,-87,0,414,0,8
1,2497,2315,182,0,338,0,6
1,2489,2493,-4,0,115,0,6
1,2446,2393,53,0,202,1,6
1,2462,2427,35,0,202,0,6
1,2541,2449,92,0,1,0,6
1,2415,2240,175,0,101,0,6
1,2417,2432,-15,0,456,0,6
1,2432,2326,106,0,300,1,6
1,2403,2466,-63,0,45,1,6
1,2336,2416,-80,0,253,0,6
1,2422,2441,-19,0,150,0,6
1,2584,2481,103,0,220,0,6
1,2610,2425,185,0,45,0,6
1,2464,2510,-46,0,200,1,6
1,2458,2487,-29,0,8,0,6
1,2545,2625,-80,0,40,0,6
1,2577,2474,103,0,190,0,6
1,2410,2431,-21,0,0,0,6
1,2432,2335,97,0,240,0,6
1,2446,2309,137,0,100,1,6
1,2435,2522,-87,0,241,0,6
1,2657,2512,145,0,1,0,6
1,2467,2331,136,0,8,0,6
1,2504,2382,122,0,331,0,6
1,2404,2358,46,0,386,0,6
1,2398,2457,-59,0,45,1,6
1,2545,2509,36,0,4,0,6
1,2439,2513,-74,0,200,0,6
1,2398,2412,-14,0,466,0,6
1,2588,2429,159,0,45,0,6
1,2410,2362,48,0,0,0,6
1,2402,2401,1,0,162,0,6
1,2446,2443,3,0,414,0,6
1,2450,2377,73,0,21,0,6
1,2727,2504,223,0,240,0,6
1,2537,2323,214,0,42,0,6
1,2427,2509,-82,0,85,0,6
1,2407,2411,-4,0,334,1,6
1,2470,2444,26,0,46,0,6
1,2351,2523,-172,0,128,1,6
1,2426,2283,143,0,41,0,6
1,2382,2407,-25,0,404,0,6
1,2429,2441,-12,0,109,1,6
1,2218,2428,-210,0,108,0,8
1,2481,2403,78,0,245,1,6
1,2481,2428,53,0,411,1,6
1,2592,2574,18,0,46,0,6
1,2413,2279,134,0,201,0,6
1,2415,2417,-2,0,20,0,6
1,2480,2213,267,0,202,0,8
1,2424,2289,135,0,43,0,6
1,2413,2307,106,0,130,0,6
1,2428,2560,-132,0,205,0,6
1,2555,2498,57,0,45,0,6
1,2375,2400,-25,0,140,0,6
1,2408,2417,-9,0,145,1,6
1,2414,2296,118,0,46,0,6
1,2404,2336,68,0,108,0,6
1,2318,2401,-83,0,337,0,6
1,2488,2571,-83,0,1,1,6
1,2500,2534,-34,0,113,0,6
1,2405,2311,94,0,302,0,6
1,2287,2424,-137,0,16,0,6
1,2529,2309,220,4,278,0,8
1,2403,2266,137,0,135,1,6
1,2527,2551,-24,0,41,0,6
1,2435,2628,-193,0,347,0,6
1,2445,2420,25,0,11,0,6
1,2349,2477,-128,0,1,1,6
1,2563,2532,31,0,7,0,6
1,2479,2593,-114,0,131,0,6
1,2492,2484,8,0,485,0,6
1,2493,2411,82,0,4,0,6
1,2504,2509,-5,0,211,0,6
1,2505,2502,3,0,153,0,6
1,2423,2260,163,0,6,0,6
1,2522,2590,-68,0,37,0,6
1,2449,2292,157,0,201,0,6
1,2613,2624,-11,0,154,0,6
1,2449,2387,62,0,100,0,6
1,2403,2322,81,0,210,0,6
1,2493,2502,-9,0,200,0,6
1,2293,2448,-155,0,242,0,6
1,2500,2353,147,0,90,0,6
1,2555,2360,195,0,0,0,6
1,2374,2424,-50,0,57,0,6
1,2392,2404,-12,0,205,0,6
1,2540,2457,83,0,200,0,6
1,2363,2426,-63,0,190,0,6
1,2570,2600,-30,0,483,1,6
1,2381,2463,-82,0,14,0,6
1,2614,2585,29,0,203,0,6
1,2234,2532,-298,0,9,1,6
1,2508,2339,169,0,46,1,6
1,2477,2374,103,0,308,0,6
1,2440,2375,65,0,398,0,6
1,2559,2573,-14,0,308,0,6
1,2434,2238,196,0,115,0,6
1,2515,2576,-61,0,10,0,6
1,2436,2454,-18,0,90,1,6
1,2428,2373,55,0,426,0,6
1,2506,2444,62,0,312,0,6
1,2481,2489,-8,0,45,1,6
1,2333,2425,-92,0,335,0,8
1,2685,2284,401,0,0,0,8
1,2472,2544,-72,0,262,0,6
1,2429,2286,143,0,269,0,6
1,2414,2431,-17,0,22,1,6
1,2313,2471,-158,0,57,1,6
1,2429,2334,95,0,483,0,6
1,2437,2343,94,0,0,0,6
1,2499,2346,153,0,240,0,6
1,2498,2282,216,0,1,0,6
1,2480,2490,-10,0,3,0,6
1,2504,2528,-24,0,233,0,6
1,2446,2346,100,0,56,1,8
1,2653,2450,203,0,302,0,6
1,2572,2456,116,0,345,0,6
1,2304,2432,-128,4,302,0,13
1,2519,2607,-88,0,207,1,6
1,2288,2463,-175,0,110,0,6
1,2453,2344,109,0,115,1,6
1,2464,2284,180,0,484,1,6
1,2406,2409,-3,0,245,0,8
1,2523,2630,-107,0,20,1,6
1,2425,2262,163,0,200,1,6
1,2394,2554,-160,0,128,0,6
1,2675,2526,149,0,167,1,6
1,2491,2502,-11,0,240,0,6
1,2549,2393,156,0,1,0,6
1,2495,2376,119,0,337,0,6
1,2402,2285,117,0,280,1,8
1,2437,2358,79,0,485,0,6
1,2495,2368,127,0,230,0,6
1,2409,2367,42,0,426,0,8
1,2629,2495,134,0,0,1,6
1,2514,2423,91,0,123,0,6
1,2448,2380,68,0,45,1,6
1,2596,2642,-46,0,46,0,6
1,2403,2296,107,0,152,0,6
1,2414,2350,64,0,107,1,6
1,2472,2402,70,0,138,0,6
1,2328,2417,-89,0,41,0,6
1,2432,2390,42,0,110,1,6
1,2485,2480,5,0,6,1,6
1,2364,2533,-169,0,45,1,6
1,2445,2321,124,0,190,0,6
1,2451,2443,8,0,190,1,6
1,2349,2445,-96,0,110,0,6
1,2730,2656,74,0,150,0,6
1,2459,2322,137,4,102,0,13
1,2486,2395,91,0,426,0,6
1,2488,2385,103,0,20,0,6
1,2425,2281,144,0,40,0,6
1,2502,2539,-37,0,0,0,6
1,2598,2394,204,4,7,0,13
1,2459,2287,172,0,253,0,6
1,2470,2358,112,0,201,1,6
1,2474,2427,47,0,5,0,6
1,2418,2368,50,0,40,0,6
1,2416,2318,98,0,122,0,6
1,2673,2704,-31,0,15,0,6
1,2488,2302,186,0,453,0,6
1,2558,2514,44,0,253,0,6
1,2542,2405,137,0,265,0,6
1,2400,2224,176,4,150,0,13
1,2377,2403,-26,0,0,1,6
1,2279,2405,-126,0,123,1,6
1,2377,2412,-35,0,310,0,6
1,2466,2383,83,0,400,0,6
1,2608,2375,233,0,335,0,6
1,2403,2254,149,0,0,1,6
1,2453,2491,-38,0,11,0,6
1,2289,2400,-111,0,107,0,5
1,2504,2412,92,0,109,0,6
1,2562,2485,77,0,4,0,6
1,2228,2417,-189,0,246,1,6
1,2473,2395,78,4,0,0,13
1,2443,2368,75,0,106,0,6
1,2601,2530,71,0,45,0,6
1,2400,2385,15,0,202,1,6
1,2521,2544,-23,0,80,0,6
1,2446,2562,-116,0,15,0,6
1,2592,2645,-53,0,178,0,6
1,2468,2462,6,0,462,0,8
1,2704,2499,205,0,133,0,6
1,2722,2561,161,0,101,0,6
1,2454,2373,81,0,7,0,6
1,2537,2565,-28,0,121,1,6
1,2573,2546,27,0,16,1,6
1,2402,2290,112,0,41,0,6
1,2415,2388,27,0,132,0,6
1,2538,2374,164,0,45,0,6
1,2284,2401,-117,0,194,1,6
1,2416,2416,0,0,278,1,6
1,2554,2281,273,0,110,0,6
1,2564,2538,26,0,196,0,6
1,2406,2410,-4,0,4,1,6
1,2492,2515,-23,0,405,0,6
1,2377,2434,-57,0,202,0,6
1,2323,2411,-88,0,45,0,6
1,2522,2465,57,0,40,0,6
1,2423,2470,-47,0,122,1,6
1,2484,2477,7,0,487,1,6
1,2472,2481,-9,0,302,0,6
1,2447,2345,102,0,6,0,10
1,2384,2443,-59,0,311,0,6
1,2519,2344,175,0,229,1,6
1,2628,2503,125,0,101,1,6
1,2441,2335,106,0,46,0,6
1,2407,2401,6,0,301,0,6
1,2440,2457,-17,0,301,0,6
1,2346,2493,-147,0,113,0,6
1,2457,2304,153,0,310,0,6
1,2498,2495,3,0,40,0,6
1,2425,2479,-54,0,107,0,6
1,2439,2377,62,0,153,0,6
1,2463,2339,124,0,142,1,6
1,2560,2523,37,0,288,0,6
1,2524,2386,138,0,302,1,6
1,2558,2272,286,0,338,0,8
1,2464,2448,16,0,211,0,6
1,2469,2262,207,0,107,1,6
1,2419,2330,89,0,0,0,6
1,2528,2258,270,0,2,0,6
1,2414,2274,140,0,1,0,6
1,2375,2439,-64,0,211,0,6
1,2262,2425,-163,0,470,0,6
1,2293,2520,-227,0,110,0,8
1,2390,2418,-28,0,190,0,6
1,2449,2357,92,0,4,0,6
1,2382,2416,-34,0,107,0,6
1,2584,2509,75,0,102,1,6
1,2523,2358,165,0,188,1,6
1,2449,2320,129,0,120,0,6
1,2441,2266,175,0,313,0,6
1,2563,2493,70,0,302,1,6
1,2425,2265,160,0,221,1,5
1,2478,2246,232,0,4,1,6
1,2379,2417,-38,0,320,1,6
1,2634,2685,-51,0,7,0,6
1,2405,2432,-27,0,40,1,6
1,2474,2412,62,0,455,1,6
1,2563,2568,-5,0,300,0,6
1,2519,2419,100,0,415,0,6
1,2486,2351,135,0,154,0,6
1,2403,2276,127,0,45,0,8
1,2433,2450,-17,0,58,1,6
1,2572,2309,263,0,300,0,6
1,2248,2400,-152,0,122,0,6
1,2459,2387,72,0,210,1,6
1,2348,2407,-59,0,110,0,6
1,2317,2508,-191,0,106,1,6
1,2444,2432,12,0,419,0,6
1,2379,2417,-38,0,133,1,6
1,2484,2323,161,0,102,0,6
1,2304,2428,-124,0,415,0,8
1,2473,2363,110,0,4,0,6
1,2440,2471,-31,0,11,1,6
1,2473,2338,135,0,4,0,6
1,2555,2266,289,0,490,0,6
1,2404,2258,146,0,389,0,6
1,2328,2527,-199,0,120,1,6
1,2498,2471,27,0,355,0,6
1,2311,2545,-234,0,115,1,6
1,2369,2411,-42,0,218,1,6
1,2419,2420,-1,0,300,0,6
1,2466,2437,29,0,50,0,6
1,2512,2391,121,0,424,0,6
1,2312,2492,-180,0,159,0,6
1,2670,2222,448,0,190,1,6
1,2302,2423,-121,0,123,0,6
1,2334,2423,-89,0,313,1,6
1,2421,2447,-26,0,106,0,6
1,2412,2277,135,0,108,1,6
1,2514,2502,12,0,301,1,6
1,2406,2255,151,0,4,1,6
1,2452,2622,-170,0,253,0,6
1,2500,2227,273,0,343,0,6
1,2510,2353,157,0,300,0,6
1,2400,2214,186,0,151,0,6
1,2696,2534,162,0,135,0,6
1,2201,2455,-254,0,228,0,6
1,2593,2657,-64,0,106,0,6
1,2431,2608,-177,0,109,0,6
1,2462,2449,13,0,40,0,6
1,2617,2495,122,0,0,0,6
1,2430,2420,10,0,106,0,6
1,2481,2578,-97,0,202,0,6
1,2555,2383,172,0,45,0,6
1,2377,2408,-31,0,49,0,6
1,2665,2510,155,0,20,0,6
1,2400,2278,122,0,343,0,8
1,2404,2278,126,0,52,0,6
1,2633,2414,219,0,400,0,6
1,2528,2563,-35,0,4,0,6
1,2609,2642,-33,0,177,0,6
1,2413,2337,76,0,131,0,6
1,2242,2409,-167,0,380,1,6
1,2424,2385,39,0,191,0,6
1,2413,2296,117,0,20,1,6
1,2518,2475,43,0,330,0,6
1,2330,2414,-84,0,253,0,6
1,2404,2393,11,0,4,0,6
1,2263,2415,-152,0,310,0,8
1,2704,2561,143,0,201,0,6
1,2432,2423,9,0,211,1,6
1,2587,2462,125,0,394,1,6
1,2409,2299,110,0,359,0,6
1,2499,2386,113,0,202,1,6
1,2486,2297,189,0,0,0,6
1,2556,2339,217,0,253,0,6
1,2443,2385,58,0,112,0,6
1,2476,2333,143,0,138,0,6
1,2335,2464,-129,4,147,0,13
1,2452,2419,33,0,107,0,6
1,2491,2352,139,0,16,0,6
1,2451,2527,-76,0,300,1,6
1,2504,2337,167,0,41,1,6
1,2275,2432,-157,0,302,0,6
1,2429,2355,74,0,4,0,6
1,2362,2445,-83,0,180,1,6
1,2433,2358,75,0,326,0,6
1,2381,2482,-101,0,302,1,6
1,2482,2511,-29,0,7,0,6
1,2576,2627,-51,0,110,0,6
1,2563,2590,-27,0,346,1,6
1,2425,2498,-73,0,0,0,6
1,2436,2299,137,0,190,1,6
1,2450,2412,38,0,7,0,6
1,2457,2406,51,0,205,0,6
1,2439,2345,94,0,100,0,6
1,2345,2559,-214,0,40,0,6
1,2395,2476,-81,0,106,0,6
1,2452,2364,88,0,45,0,6
1,2327,2419,-92,0,335,1,6
1,2371,2416,-45,0,307,0,6
1,2400,2398,2,0,100,0,6
1,2568,2248,320,0,143,1,6
1,2477,2346,131,0,360,0,6
1,2408,2481,-73,0,310,1,6
1,2604,2544,60,0,3,1,6
1,2752,2612,140,0,125,0,6
1,2496,2328,168,0,106,0,6
1,2471,2232,239,0,41,0,6
1,2495,2567,-72,0,487,0,6
1,2420,2423,-3,0,45,1,6
1,2530,2355,175,0,180,0,6
1,2453,2436,17,0,484,0,6
1,2543,2406,137,0,0,0,6
1,2558,2369,189,0,15,0,6
1,2315,2432,-117,0,0,1,6
1,2298,2432,-134,0,131,0,6
1,2560,2685,-125,0,152,0,6
1,2449,2453,-4,0,41,1,6
1,2555,2449,106,0,4,0,6
1,2448,2356,92,0,306,1,6
1,2415,2351,64,0,0,0,6
1,2427,2403,24,0,302,0,6
1,2354,2416,-62,0,147,0,6
1,2414,2454,-40,0,49,1,6
1,2564,2580,-16,0,331,0,6
1,2623,2618,5,0,106,1,6
1,2361,2442,-81,0,150,0,6
1,2542,2521,21,0,120,0,6
1,2431,2324,107,0,1,0,6
1,2419,2459,-40,0,15,0,6
1,2566,2432,134,0,295,0,6
1,2348,2422,-74,0,103,0,6
1,2477,2460,17,0,44,0,6
1,2378,2546,-168,0,106,0,6
1,2577,2568,9,0,111,0,6
1,2333,2417,-84,0,419,0,6
1,2432,2407,25,0,132,1,6
1,2429,2399,30,0,106,0,6
1,2519,2306,213,0,5,0,8
1,2420,2347,73,0,209,1,6
1,2484,2318,166,0,45,0,6
1,2478,2316,162,0,172,0,6
1,2713,2395,318,0,215,0,6
1,2471,2359,112,0,338,0,6
1,2250,2421,-171,0,414,1,6
1,2434,2445,-11,0,31,0,6
1,2412,2327,85,0,483,0,6
1,2450,2561,-111,0,306,0,6
1,2467,2304,163,0,101,0,6
1,2549,2410,139,0,0,0,6
1,2541,2413,128,0,110,1,6
1,2513,2440,73,0,101,0,7
1,2583,2459,124,0,100,0,6
1,2618,2548,70,0,45,0,6
1,2417,2477,-60,0,15,1,6
1,2435,2375,60,0,1,0,6
1,2515,2614,-99,0,211,0,6
1,2404,2463,-59,0,120,0,6
1,2385,2413,-28,0,152,0,6
1,2598,2465,133,0,2,0,6
1,2489,2483,6,0,7,0,6
1,2321,2401,-80,0,123,1,6
1,2576,2656,-80,0,140,0,6
1,2395,2544,-149,0,2,0,6
1,2414,2367,47,0,343,0,8
1,2614,2560,54,0,9,0,6
1,2401,2282,119,0,157,1,6
1,2574,2413,161,0,30,0,6
1,2378,2449,-71,0,227,0,6
1,2485,2405,80,0,58,0,6
1,2525,2450,75,0,45,1,6
1,2430,2255,175,4,8,0,13
1,2419,2286,133,0,211,0,6
1,2428,2371,57,0,45,0,6
1,2454,2389,65,0,13,1,6
1,2441,2353,88,0,373,0,6
1,2410,2343,67,0,106,0,6
1,2487,2271,216,0,405,1,8
1,2421,2481,-60,0,300,0,6
1,2239,2416,-177,0,107,1,8
1,2521,2369,152,0,190,1,6
1,2414,2391,23,0,0,0,6
1,2452,2311,141,0,226,0,6
1,2415,2284,131,0,101,0,6
1,2489,2526,-37,0,15,0,6
1,2301,2423,-122,0,46,1,6
1,2528,2453,75,0,373,0,6
1,2401,2313,88,0,250,0,8
1,2444,2424,20,0,7,1,6
1,2381,2405,-24,0,67,0,6
1,2202,2447,-245,0,101,0,6
1,2412,2450,-38,0,145,0,6
1,2725,2542,183,0,146,1,6
1,2475,2372,103,0,302,1,6
1,2416,2294,122,0,202,0,8
1,2526,2252,274,0,55,0,6
1,2436,2539,-103,0,242,0,6
1,2418,2411,7,0,33,0,6
1,2514,2339,175,0,141,0,6
1,2423,2356,67,0,301,0,6
1,2497,2446,51,0,201,0,6
1,2406,2300,106,0,123,0,6
1,2448,2308,140,0,112,0,6
1,2377,2500,-123,0,48,1,6
1,2413,2441,-28,0,110,0,6
1,2450,2307,143,0,119,0,6
1,2442,2424,18,0,0,0,6
1,2369,2423,-54,0,133,0,6
1,2436,2245,191,0,0,1,6
1,2426,2580,-154,0,240,0,6
1,2440,2316,124,0,1,0,6
1,2335,2420,-85,0,81,0,6
1,2570,2510,60,0,302,0,6
1,2614,2526,88,0,400,0,6
1,2427,2365,62,0,334,0,6
1,2621,2464,157,0,15,0,6
1,2622,2443,179,0,170,0,6
1,2581,2555,26,0,103,0,6
1,2501,2441,60,0,49,1,6
1,2403,2373,30,0,56,0,6
1,2407,2365,42,0,118,0,6
1,2355,2448,-93,0,320,0,6
1,2516,2347,169,0,40,0,6
1,2501,2409,92,0,155,0,6
1,2345,2476,-131,0,123,0,6
1,2335,2434,-99,0,112,1,6
1,2478,2296,182,0,400,0,6
1,2503,2474,29,0,4,1,6
1,2524,2450,74,0,347,1,6
1,2522,2393,129,0,45,0,6
1,2406,2327,79,0,302,0,6
1,2483,2402,81,0,261,0,6
1,2478,2444,34,0,40,0,6
1,2442,2357,85,0,486,1,6
1,2536,2552,-16,0,143,0,6
1,2433,2280,153,0,45,0,8
1,2462,2534,-72,0,125,0,6
1,2573,2500,73,0,330,0,6
1,2414,2345,69,0,357,0,6
1,2503,2479,24,0,139,0,6
1,2503,2527,-24,0,398,0,6
1,2441,2330,111,0,200,0,6
1,2323,2416,-93,0,45,0,6
1,2690,2685,5,0,113,0,6
1,2422,2281,141,0,101,0,6
1,2492,2406,86,0,265,0,6
1,2282,2401,-119,0,207,0,6
1,2504,2333,171,0,45,0,6
1,2435,2426,9,0,301,0,6
1,2494,2518,-24,0,462,0,6
1,2452,2634,-182,0,50,0,6
1,2474,2279,195,0,41,1,6
1,2451,2391,60,4,221,0,13
1,2397,2496,-99,0,13,1,6
1,2460,2443,17,0,311,1,6
1,2516,2216,300,0,411,1,6
1,2516,2418,98,0,459,0,6
1,2444,2491,-47,0,332,0,6
1,2473,2357,116,0,49,1,6
1,2472,2429,43,0,123,1,6
1,2399,2447,-48,0,455,0,6
1,2457,2433,24,0,241,0,8
1,2533,2531,2,0,394,0,6
1,2285,2400,-115,0,122,0,6
1,2410,2355,55,0,122,0,6
1,2416,2443,-27,0,380,0,6
1,2675,2552,123,0,132,0,6
1,2421,2316,105,0,202,0,6
1,2647,2485,162,0,218,1,5
1,2409,2242,167,0,119,0,8
1,2475,2325,150,0,403,0,6
1,2457,2279,178,0,112,0,6
1,2418,2350,68,0,138,1,6
1,2490,2442,48,0,460,0,6
1,2390,2495,-105,0,0,0,6
1,2479,2570,-91,0,335,0,6
1,2291,2419,-128,0,436,0,6
1,2405,2397,8,0,211,1,6
1,2381,2591,-210,0,100,1,6
1,2516,2500,16,0,101,1,6
1,2421,2497,-76,0,233,1,6
1,2642,2479,163,0,337,0,6
1,2556,2402,154,0,109,0,6
1,2438,2373,65,0,205,0,6
1,2414,2347,67,0,83,0,6
1,2429,2280,149,0,101,0,6
1,2397,2506,-109,0,45,0,6
1,2505,2526,-21,0,302,1,6
1,2446,2202,244,0,112,0,6
1,2600,2457,143,0,246,0,6
1,2410,2342,68,0,112,1,6
1,2339,2417,-78,0,454,0,6
1,2467,2339,128,4,300,0,13
1,2436,2256,180,0,211,1,6
1,2425,2360,65,0,45,0,6
1,2430,2334,96,0,101,0,6
1,2433,2405,28,0,484,1,6
1,2635,2491,144,0,245,0,6
1,2404,2383,21,0,400,1,6
1,2476,2425,51,0,339,0,8
1,2435,2295,140,0,145,1,6
1,2485,2509,-24,0,101,0,6
1,2293,2408,-115,0,16,1,8
1,2527,2491,36,0,101,0,6
1,2417,2249,168,0,112,0,6
1,2521,2429,92,0,130,0,6
1,2527,2543,-16,0,44,0,6
1,2396,2403,-7,0,0,0,6
1,2548,2685,-137,0,101,0,6
1,2416,2290,126,0,120,0,6
1,2528,2501,27,0,120,0,6
1,2429,2464,-35,0,101,1,6
1,2469,2568,-99,0,103,0,6
1,2363,2460,-97,0,1,0,6
1,2517,2220,297,0,122,0,6
1,2382,2466,-84,0,415,1,6
1,2540,2564,-24,0,205,0,6
1,2524,2430,94,0,200,0,6
1,2425,2292,133,0,311,0,6
1,2673,2309,364,0,330,0,6
1,2204,2434,-230,0,112,0,8
1,2423,2313,110,0,102,1,6
1,2430,2281,149,0,4,0,6
1,2445,2460,-15,0,216,1,6
1,2279,2420,-141,0,344,0,6
1,2446,2400,46,0,142,0,6
1,2608,2674,-66,0,150,0,6
1,2581,2290,291,0,4,0,6
1,2516,2401,115,0,46,0,6
1,2498,2326,172,0,6,1,6
1,2531,2231,300,0,17,0,6
1,2276,2402,-126,0,414,0,6
1,2568,2413,155,0,4,0,6
1,2400,2295,105,0,300,0,6
1,2381,2400,-19,0,310,0,6
1,2621,2525,96,0,314,1,6
1,2411,2374,37,0,426,0,6
1,2545,2402,143,0,265,0,6
1,2526,2252,274,0,45,0,6
1,2535,2468,67,0,80,0,6
1,2552,2539,13,0,106,1,6
1,2491,2355,136,0,343,0,6
1,2407,2369,38,0,1,0,6
1,2570,2427,143,0,201,0,6
1,2439,2271,168,0,190,1,6
1,2408,2354,54,0,122,0,6
1,2590,2565,25,0,100,0,6
1,2447,2406,41,0,141,0,6
1,2429,2247,182,0,302,1,6
1,2458,2414,44,0,45,1,6
1,2311,2405,-94,4,211,0,10
1,2400,2290,110,0,305,0,8
1,2469,2444,25,0,103,0,6
1,2417,2375,42,0,485,0,6
1,2336,2424,-88,0,6,0,6
1,2336,2436,-100,0,233,0,6
1,2556,2502,54,0,4,0,6
1,2516,2278,238,0,45,0,6
1,2449,2406,43,0,133,0,6
1,2557,2343,214,0,307,0,6
1,2496,2215,281,4,46,0,8
1,2413,2280,133,0,43,0,6
1,2468,2337,131,0,40,0,6
1,2658,2317,341,0,150,0,6
1,2476,2475,1,0,210,0,6
1,2406,2320,86,0,43,1,6
1,2515,2326,189,0,200,0,6
1,2345,2434,-89,0,123,0,6
1,2362,2456,-94,0,201,0,6
1,2479,2330,149,0,48,0,6
1,2516,2450,66,0,435,0,6
1,2502,2394,108,0,157,0,6
1,2404,2333,71,0,123,0,6
1,2444,2225,219,0,16,0,5
1,2412,2549,-137,0,441,0,6
1,2535,2548,-13,0,270,1,6
1,2451,2404,47,0,128,0,6
1,2421,2351,70,0,102,0,6
1,2537,2433,104,0,177,0,6
1,2518,2336,182,0,311,0,6
1,2423,2305,118,0,106,1,6
1,2384,2425,-41,0,45,1,6
1,2688,2528,160,0,7,0,6
1,2396,2502,-106,0,120,1,6
1,2397,2478,-81,0,112,1,6
1,2309,2493,-184,0,101,0,6
1,2442,2309,133,0,101,0,6
1,2443,2473,-30,0,141,0,6
1,2488,2305,183,0,110,0,6
1,2451,2500,-49,0,103,1,6
1,2450,2397,53,0,394,0,6
1,2506,2428,78,0,337,1,6
1,2392,2587,-195,0,306,0,6
1,2523,2384,139,0,10,0,6
1,2424,2212,212,0,264,0,6
1,2486,2581,-95,0,40,0,6
1,2308,2438,-130,0,45,1,6
1,2539,2620,-81,0,196,0,6
1,2534,2567,-33,0,302,0,6
1,2420,2327,93,0,103,0,6
1,2372,2506,-134,0,310,0,6
1,2408,2260,148,0,202,0,6
1,2822,2699,123,0,110,0,6
1,2646,2625,21,0,100,0,6
1,2443,2382,61,0,4,0,6
1,2450,2233,217,0,0,0,8
1,2365,2460,-95,0,203,1,6
1,2438,2288,150,0,123,0,6
1,2525,2318,207,0,45,0,6
1,2355,2480,-125,4,110,0,8
1,2434,2299,135,0,122,1,10
1,2439,2403,36,0,135,0,6
1,2675,2487,188,0,4,0,6
1,2446,2312,134,0,106,1,6
1,2335,2407,-72,0,277,0,6
1,2479,2494,-15,0,45,0,6
1,2503,2291,212,0,112,0,8
1,2336,2404,-68,0,354,0,6
1,2452,2298,154,0,4,0,6
1,2408,2442,-34,0,70,0,6
1,2515,2421,94,0,338,0,6
1,2418,2290,128,0,301,1,6
1,2543,2438,105,0,4,1,6
1,2398,2405,-7,0,335,0,6
1,2480,2532,-52,0,101,0,6
1,2406,2396,10,0,120,0,6
1,2595,2579,16,0,1,0,6
1,2402,2301,101,0,5,0,6
1,2519,2244,275,0,4,0,6
1,2448,2411,37,0,30,0,6
1,2382,2497,-115,0,150,1,6
1,2432,2268,164,0,140,0,6
1,2450,2521,-71,0,216,0,6
1,2436,2424,12,0,255,0,6
1,2456,2395,61,0,415,0,6
1,2451,2260,191,0,123,0,6
1,2409,2423,-14,0,211,0,6
1,2230,2430,-200,0,100,1,6
1,2417,2310,107,0,46,0,6
1,2270,2427,-157,0,40,0,6
1,2502,2452,50,0,344,0,6
1,2406,2403,3,0,302,1,6
1,2650,2447,203,0,0,0,6
1,2417,2498,-81,0,28,0,6
1,2466,2362,104,0,0,0,6
1,2440,2354,86,0,1,0,6
1,2438,2406,32,0,330,0,6
1,2471,2411,60,0,9,0,6
1,2490,2502,-12,0,4,1,6
1,2471,2463,8,0,124,0,6
1,2390,2461,-71,0,3,1,6
1,2471,2441,30,0,343,0,6
1,2380,2440,-60,0,9,0,5
1,2418,2348,70,4,219,0,13
1,2587,2527,60,0,326,1,6
1,2344,2404,-60,0,302,0,6
1,2382,2441,-59,0,243,0,6
1,2536,2440,96,0,41,0,6
1,2354,2408,-54,0,0,0,6
1,2569,2417,152,0,101,0,6
1,2415,2305,110,0,345,0,6
1,2529,2592,-63,0,0,0,6
1,2388,2464,-76,0,295,0,6
1,2421,2511,-90,0,454,0,6
1,2561,2501,60,0,105,0,6
1,2518,2369,149,0,378,0,6
1,2368,2411,-43,0,43,0,6
1,2412,2345,67,0,130,0,5
1,2466,2570,-104,0,122,1,6
1,2384,2456,-72,0,4,1,6
1,2469,2389,80,0,84,1,6
1,2282,2446,-164,0,108,0,6
1,2619,2447,172,0,300,1,6
1,2474,2491,-17,0,100,0,6
1,2548,2246,302,0,490,0,6
1,2452,2204,248,0,138,0,6
1,2351,2437,-86,0,132,1,6
1,2470,2215,255,0,107,0,6
1,2465,2381,84,0,190,0,6
1,2401,2432,-31,4,31,0,13
1,2537,2613,-76,0,151,0,6
1,2393,2403,-10,0,150,0,6
1,2424,2498,-74,0,463,0,6
1,2543,2441,102,0,200,0,6
1,2542,2382,160,0,80,1,6
1,2557,2507,50,0,392,1,6
1,2519,2475,44,0,45,0,6
1,2633,2496,137,0,461,0,6
1,2471,2346,125,0,1,0,6
1,2428,2381,47,0,4,0,6
1,2489,2364,125,0,130,0,6
1,2463,2536,-73,0,43,1,6
1,2443,2439,4,0,60,1,6
1,2433,2341,92,0,122,0,6
1,2486,2333,153,0,15,0,6
1,2728,2688,40,0,426,0,6
1,2558,2483,75,0,100,0,5
1,2429,2241,188,4,43,0,13
1,2453,2462,-9,0,140,0,6
1,2770,2641,129,0,305,0,6
1,2477,2336,141,0,205,0,6
1,2451,2434,17,0,17,1,6
1,2460,2457,3,0,60,0,6
1,2571,2608,-37,0,200,1,6
1,2359,2422,-63,0,255,0,6
1,2533,2327,206,0,41,1,6
1,2410,2440,-30,0,101,0,6
1,2349,2466,-117,0,101,0,6
1,2398,2426,-28,0,103,0,6
1,2533,2395,138,0,303,0,6
1,2448,2415,33,0,302,0,6
1,2819,2660,159,0,40,1,6
1,2572,2261,311,0,311,0,6
1,2441,2416,25,0,145,0,6
1,2455,2544,-89,0,295,0,6
1,2408,2339,69,0,150,0,6
1,2443,2441,2,0,300,1,6
1,2326,2411,-85,0,106,0,6
1,2470,2346,124,0,139,0,6
1,2604,2491,113,0,141,0,6
1,2387,2423,-36,0,310,0,6
1,2420,2363,57,0,278,1,6
1,2559,2411,148,0,115,0,6
1,2411,2350,61,0,154,1,6
1,2440,2464,-24,0,202,0,6
1,2404,2359,45,0,45,1,6
1,2474,2697,-223,0,245,0,6
1,2408,2442,-34,0,102,0,6
1,2474,2351,123,0,243,0,6
1,2421,2365,56,0,248,1,6
1,2414,2328,86,0,300,0,6
1,2639,2287,352,0,4,0,6
1,2429,2373,56,0,40,0,6
1,2312,2400,-88,4,8,0,13
1,2414,2238,176,0,325,1,6
1,2362,2434,-72,0,101,0,6
1,2449,2320,129,0,106,0,6
1,2677,2545,132,0,122,1,6
1,2568,2549,19,0,121,0,6
1,2570,2593,-23,0,332,1,6
1,2419,2461,-42,0,200,0,6
1,2544,2547,-3,0,200,0,6
1,2490,2440,50,0,484,1,6
1,2263,2429,-166,0,46,0,6
1,2700,2449,251,0,196,0,6
1,2526,2529,-3,0,459,0,6
1,2486,2455,31,0,10,1,6
1,2332,2417,-85,0,189,0,8
1,2609,2628,-19,0,464,0,6
1,2387,2428,-41,0,40,0,6
1,2424,2425,-1,0,301,1,6
1,2215,2481,-266,0,0,0,6
1,2439,2299,140,0,143,0,6
1,2466,2459,7,0,246,0,6
1,2444,2501,-57,0,300,0,6
1,2380,2430,-50,0,241,0,6
1,2519,2400,119,0,263,0,6
1,2710,2606,104,0,106,0,6
1,2442,2424,18,0,152,1,6
1,2431,2401,30,0,177,0,6
1,2477,2456,21,0,335,0,6
1,2966,2733,233,0,110,0,6
1,2331,2413,-82,0,27,0,6
1,2377,2476,-99,0,402,0,6
1,2456,2461,-5,0,0,1,6
1,2405,2258,147,4,385,0,13
1,2523,2417,106,0,45,0,6
1,2501,2606,-105,0,302,0,6
1,2528,2403,125,0,134,0,6
1,2513,2432,81,0,121,0,6
1,2380,2512,-132,0,200,0,6
1,2363,2494,-131,0,101,1,6
1,2473,2237,236,0,107,1,6
1,2590,2501,89,0,398,0,6
1,2568,2406,162,0,200,0,6
1,2463,2457,6,0,44,0,6
1,2406,2482,-76,0,484,0,6
1,2493,2497,-4,0,13,0,6
1,2285,2404,-119,0,48,0,6
1,2497,2486,11,0,110,1,6
1,2410,2312,98,0,5,0,6
1,2465,2439,26,0,107,0,6
1,2301,2443,-142,0,133,0,6
1,2464,2340,124,0,4,1,6
1,2551,2309,242,0,25,0,6
1,2440,2205,235,0,200,0,6
1,2454,2387,67,0,17,0,6
1,2408,2496,-88,0,107,1,6
1,2474,2200,274,0,0,0,6
1,2452,2294,158,0,260,1,6
1,2523,2349,174,0,311,0,6
1,2439,2428,11,0,101,1,8
1,2664,2426,238,0,133,0,6
1,2239,2414,-175,0,20,1,8
1,2461,2313,148,0,332,0,6
1,2534,2325,209,0,45,1,6
1,2434,2523,-89,0,43,0,6
1,2416,2257,159,0,1,1,6
1,2529,2524,5,0,491,0,6
1,2412,2337,75,0,122,0,6
1,2487,2622,-135,0,7,0,6
1,2372,2447,-75,0,419,1,5
1,2428,2413,15,0,337,0,6
1,2499,2462,37,0,413,0,6
1,2498,2365,133,0,445,0,6
1,2464,2479,-15,0,454,0,6
1,2302,2421,-119,0,134,0,6
1,2487,2444,43,0,484,0,6
1,2418,2412,6,0,210,0,6
1,2427,2372,55,0,323,1,6
1,2455,2446,9,0,462,1,6
1,2402,2283,119,0,101,0,6
1,2632,2487,145,0,100,0,6
1,2443,2431,12,0,487,1,6
1,2543,2414,129,0,4,0,6
1,2275,2411,-136,0,288,0,8
1,2448,2551,-103,0,43,0,6
1,2505,2503,2,0,40,0,6
1,2415,2318,97,0,303,0,6
1,2455,2553,-98,0,331,0,6
1,2281,2437,-156,0,100,0,6
1,2435,2298,137,0,40,0,6
1,2332,2416,-84,0,199,1,6
1,2488,2511,-23,0,1,0,6
1,2381,2497,-116,0,0,0,6
1,2448,2479,-31,0,140,0,6
1,2507,2275,232,0,261,0,6
1,2424,2576,-152,0,125,0,6
1,2401,2360,41,0,4,0,6
1,2421,2464,-43,0,255,0,6
1,2460,2417,43,0,265,1,6
1,2453,2279,174,0,485,1,6
1,2433,2433,0,0,101,0,6
1,2572,2575,-3,0,136,1,6
1,2530,2701,-171,0,248,0,6
1,2419,2320,99,0,59,0,6
1,2448,2437,11,0,190,0,6
1,2358,2426,-68,0,138,0,6
1,2418,2300,118,0,414,0,6
1,2348,2497,-149,0,19,0,6
1,2587,2512,75,0,70,0,6
1,2513,2422,91,0,302,0,6
1,2432,2400,32,0,42,0,6
1,2562,2440,122,0,311,0,6
1,2419,2300,119,0,16,0,6
1,2480,2450,30,0,55,1,6
1,2436,2203,233,0,101,1,6
1,2731,2416,315,0,40,0,6
1,2449,2443,6,0,337,0,6
1,2412,2388,24,0,360,0,6
1,2282,2438,-156,0,46,0,6
1,2411,2270,141,0,107,0,6
1,2401,2377,24,0,40,0,6
1,2438,2322,116,0,310,1,6
1,2473,2295,178,0,107,0,8
1,2381,2427,-46,0,143,0,6
1,2359,2425,-66,0,255,0,6
1,2455,2335,120,0,454,0,6
1,2555,2492,63,0,200,0,6
1,2315,2453,-138,0,239,0,6
1,2575,2472,103,0,110,0,6
1,2340,2480,-140,0,265,1,6
1,2436,2294,142,0,4,0,6
1,2548,2339,209,0,151,0,6
1,2516,2611,-95,0,4,0,6
1,2566,2617,-51,0,253,0,6
1,2497,2468,29,0,45,0,6
1,2406,2413,-7,0,4,0,6
1,2416,2339,77,0,84,0,6
1,2616,2559,57,0,41,0,6
1,2493,2521,-28,0,46,0,6
1,2402,2475,-73,0,241,0,6
1,2505,2331,174,0,106,0,6
1,2403,2314,89,0,4,0,6
1,2402,2231,171,0,4,1,6
1,2461,2443,18,0,340,0,6
1,2440,2278,162,0,131,0,6
1,2551,2430,121,0,242,1,6
1,2459,2406,53,0,485,0,6
1,2413,2317,96,0,1,0,6
1,2541,2397,144,0,39,1,6
1,2328,2507,-179,0,45,1,6
1,2490,2366,124,0,250,0,6
1,2535,2575,-40,0,4,0,6
1,2441,2281,160,0,1,0,6
1,2469,2366,103,0,267,0,6
1,2553,2441,112,0,256,0,6
1,2426,2345,81,0,101,0,6
1,2500,2450,50,0,241,0,6
1,2421,2315,106,0,43,0,6
1,2426,2493,-67,0,466,0,6
1,2406,2277,129,0,242,1,5
1,2534,2455,79,0,354,1,6
1,2418,2271,147,0,49,0,6
1,2425,2412,13,0,123,0,6
1,2454,2437,17,0,318,0,6
1,2271,2426,-155,0,15,0,6
1,2437,2309,128,0,104,0,6
1,2463,2464,-1,0,4,0,6
1,2266,2423,-157,0,80,0,6
1,2456,2426,30,0,45,0,6
1,2620,2350,270,0,122,0,6
1,2452,2377,75,0,111,0,6
1,2785,2568,217,0,101,0,6
1,2414,2306,108,0,426,1,6
1,2473,2378,95,0,20,0,6
1,2406,2425,-19,0,331,0,6
1,2409,2264,145,0,409,1,6
1,2419,2327,92,0,400,0,6
1,2462,2438,24,0,300,0,6
1,2414,2414,0,0,246,0,6
1,2421,2564,-143,0,487,0,6
1,2604,2282,322,0,455,0,6
1,2547,2396,151,0,228,0,6
1,2578,2537,41,0,409,0,6
1,2470,2407,63,0,200,0,6
1,2487,2390,97,0,15,0,5
1,2531,2405,126,0,202,0,6
1,2646,2256,390,0,315,0,6
1,2512,2412,100,0,337,0,6
1,2409,2390,19,0,111,0,6
1,2449,2417,32,0,243,1,6
1,2427,2272,155,0,394,0,6
1,2577,2548,29,0,463,0,6
1,2298,2464,-166,0,315,0,6
1,2404,2417,-13,0,46,0,6
1,2339,2467,-128,0,20,1,8
1,2353,2460,-107,0,40,0,6
1,2486,2466,20,0,125,0,6
1,2425,2317,108,0,382,0,6
1,2393,2411,-18,0,310,0,6
1,2345,2521,-176,0,2,1,6
1,2442,2490,-48,0,41,1,6
1,2401,2288,113,0,463,1,6
1,2540,2434,106,0,406,1,6
1,2413,2224,189,0,107,0,6
1,2543,2405,138,0,406,0,6
1,2460,2325,135,0,303,0,6
1,2438,2513,-75,0,150,0,6
1,2452,2276,176,0,46,1,6
1,2554,2489,65,0,120,0,6
1,2408,2360,48,0,415,0,6
1,2375,2425,-50,0,130,1,6
1,2685,2587,98,0,112,0,6
1,2463,2395,68,0,16,0,8
1,2580,2617,-37,0,156,0,6
1,2401,2438,-37,0,1,0,6
1,2297,2458,-161,0,415,0,6
1,2425,2304,121,0,112,0,6
1,2416,2362,54,0,301,0,6
1,2445,2251,194,0,40,0,5
1,2515,2201,314,0,8,1,6
1,2403,2397,6,0,4,0,6
1,2505,2540,-35,0,112,0,6
1,2524,2539,-15,0,490,0,6
1,2535,2299,236,0,131,0,6
1,2423,2270,153,0,4,1,6
1,2541,2430,111,0,136,0,6
1,2522,2572,-50,0,311,0,6
1,2496,2251,245,0,354,0,6
1,2415,2370,45,0,128,0,6
1,2636,2538,98,0,112,0,6
1,2497,2481,16,0,4,1,6
1,2389,2401,-12,0,45,0,6
1,2411,2446,-35,0,337,1,6
1,2453,2444,9,0,227,1,6
1,2388,2437,-49,0,453,0,6
1,2402,2295,107,0,101,0,6
1,2435,2575,-140,0,20,0,6
1,2562,2520,42,0,27,1,6
1,2659,2534,125,0,130,0,6
1,2325,2402,-77,0,140,1,6
1,2459,2472,-13,0,64,1,6
1,2554,2525,29,0,62,0,6
1,2418,2401,17,0,374,0,6
1,2552,2533,19,0,62,0,6
1,2276,2413,-137,0,305,0,6
1,2444,2296,148,0,173,0,6
1,2321,2462,-141,0,418,0,6
1,2496,2606,-110,0,324,0,6
1,2485,2298,187,0,245,0,6
1,2443,2253,190,0,102,0,6
1,2602,2439,163,0,373,0,6
1,2531,2235,296,0,135,0,6
1,2554,2476,78,0,115,0,6
1,2624,2358,266,0,14,0,6
1,2556,2365,191,0,177,0,6
1,2425,2435,-10,0,30,1,6
1,2427,2340,87,0,152,1,6
1,2548,2546,2,0,228,0,6
1,2403,2528,-125,0,2,1,6
1,2560,2459,101,0,57,0,6
1,2549,2573,-24,0,45,0,6
1,2348,2468,-120,0,121,0,6
1,2399,2422,-23,0,101,0,6
1,2396,2444,-48,0,291,0,6
1,2319,2415,-96,0,46,0,8
1,2388,2415,-27,0,385,1,6
1,2505,2234,271,0,46,0,6
1,2328,2464,-136,0,40,1,6
1,2424,2397,27,0,80,0,6
1,2350,2453,-103,0,43,0,6
1,2387,2493,-106,0,45,1,6
1,2435,2363,72,0,109,0,6
1,2539,2532,7,0,4,0,6
1,2458,2462,-4,0,319,0,6
1,2506,2440,66,0,5,0,6
1,2332,2401,-69,0,454,0,6
1,2427,2317,110,0,381,0,8
1,2455,2524,-69,0,40,1,6
1,2398,2414,-16,0,16,0,6
1,2410,2255,155,0,418,0,6
1,2407,2339,68,0,336,0,6
1,2389,2449,-60,0,228,0,6
1,2518,2538,-20,0,456,0,6
1,2439,2259,180,0,303,0,6
1,2485,2513,-28,0,341,1,6
1,2408,2333,75,0,41,1,6
1,2453,2451,2,0,191,0,6
1,2575,2435,140,0,202,1,6
1,2410,2300,110,0,112,0,6
1,2601,2307,294,0,123,0,6
1,2328,2470,-142,0,224,1,6
1,2406,2299,107,0,8,0,6
1,2460,2425,35,0,226,0,6
1,2579,2590,-11,0,277,0,6
1,2431,2311,120,0,305,1,6
1,2490,2490,0,0,101,0,6
1,2479,2325,154,0,207,0,6
1,2516,2426,90,0,310,0,6
1,2360,2412,-52,0,308,0,6
1,2578,2512,66,0,107,0,6
1,2654,2484,170,0,120,0,6
1,2422,2483,-61,0,45,0,6
1,2612,2669,-57,0,5,1,6
1,2605,2479,126,0,16,0,6
1,2383,2479,-96,0,4,0,6
1,2321,2466,-145,0,100,0,6
1,2420,2295,125,0,45,0,6
1,2467,2383,84,0,13,0,6
1,2456,2311,145,0,152,1,8
1,2407,2458,-51,0,250,1,6
1,2475,2348,127,0,453,0,6
1,2419,2385,34,0,101,1,6
1,2276,2427,-151,0,178,0,6
1,2498,2412,86,0,484,0,6
1,2433,2531,-98,0,218,0,8
1,2351,2485,-134,0,125,0,6
1,2503,2345,158,0,20,1,6
1,2329,2408,-79,0,10,0,6
1,2272,2400,-128,0,45,0,6
1,2240,2401,-161,0,140,0,6
1,2429,2400,29,0,110,0,6
1,2499,2365,134,0,150,0,6
1,2499,2405,94,0,15,0,6
1,2443,2496,-53,0,4,0,6
1,2410,2404,6,0,309,0,6
1,2440,2421,19,0,107,0,6
1,2585,2419,166,0,30,1,6
1,2481,2222,259,0,103,0,6
1,2371,2436,-65,0,25,0,6
1,2445,2380,65,0,100,0,6
1,2400,2283,117,0,151,0,6
1,2444,2325,119,0,27,0,6
1,2446,2302,144,0,234,1,6
1,2428,2495,-67,0,211,0,6
1,2326,2461,-135,0,255,0,6
1,2441,2461,-20,0,170,0,6
1,2465,2421,44,0,335,0,6
1,2424,2419,5,0,113,0,6
1,2585,2613,-28,0,132,0,6
1,2620,2603,17,0,4,0,6
1,2402,2232,170,0,142,0,6
1,2430,2338,92,0,455,0,6
1,2416,2282,134,0,122,0,6
1,2506,2351,155,0,45,0,6
1,2550,2616,-66,0,474,0,6
1,2312,2417,-105,0,58,0,6
1,2496,2467,29,0,102,1,6
1,2539,2409,130,0,46,0,6
1,2765,2514,251,0,10,0,6
1,2548,2377,171,0,106,0,6
1,2503,2405,98,0,129,1,6
1,2434,2588,-154,0,301,1,6
1,2402,2264,138,0,246,0,6
1,2414,2430,-16,0,18,0,6
1,2400,2252,148,0,302,1,6
1,2405,2311,94,4,241,1,13
1,2469,2376,93,0,102,0,6
1,2575,2621,-46,0,246,0,6
1,2294,2420,-126,0,56,0,6
1,2327,2404,-77,0,130,0,6
1,2417,2577,-160,0,4,0,6
1,2394,2454,-60,0,122,0,6
1,2465,2519,-54,0,121,0,6
1,2331,2424,-93,0,225,0,6
1,2430,2432,-2,0,42,0,6
1,2428,2376,52,0,133,1,6
1,2462,2353,109,0,1,0,6
1,2455,2502,-47,0,4,0,6
1,2761,2394,367,0,112,0,6
1,2337,2478,-141,0,200,0,6
1,2621,2701,-80,0,131,1,6
1,2563,2488,75,0,254,1,6
1,2420,2390,30,0,40,0,6
1,2472,2445,27,0,101,0,6
1,2457,2312,145,0,42,1,6
1,2401,2398,3,0,203,0,6
1,2440,2449,-9,0,4,0,6
1,2654,2346,308,0,47,1,6
1,2439,2231,208,0,101,0,6
1,2485,2379,106,0,110,0,6
1,2731,2509,222,0,108,1,6
1,2404,2402,2,0,112,0,6
1,2466,2456,10,0,463,0,6
1,2425,2324,101,0,0,0,6
1,2479,2484,-5,0,153,0,6
1,2408,2462,-54,0,45,0,6
1,2660,2387,273,0,49,0,6
1,2484,2301,183,0,200,0,5
1,2357,2409,-52,0,193,0,6
1,2410,2495,-85,0,113,0,6
1,2422,2392,30,0,335,0,6
1,2479,2374,105,0,44,0,6
1,2593,2494,99,0,125,0,6
1,2432,2400,32,0,48,0,6
1,2494,2358,136,0,106,0,6
1,2225,2400,-175,0,201,0,6
1,2400,2239,161,0,484,0,6
1,2457,2423,34,0,335,0,6
1,2453,2496,-43,0,4,0,6
1,2369,2444,-75,0,49,0,6
1,2521,2402,119,0,0,0,8
1,2271,2406,-135,0,300,0,8
1,2508,2486,22,0,10,1,6
1,2403,2299,104,0,338,1,6
1,2428,2527,-99,0,115,0,6
1,2532,2512,20,0,53,0,6
1,2293,2452,-159,0,112,0,6
1,2306,2444,-138,0,50,1,6
1,2409,2394,15,0,11,1,6
1,2425,2478,-53,0,301,1,6
1,2704,2351,353,0,265,0,6
1,2493,2524,-31,0,145,0,6
1,2570,2462,108,0,138,1,6
1,2417,2386,31,0,13,1,6
1,2491,2311,180,2,202,0,24
1,2549,2310,239,0,7,0,6
1,2635,2563,72,0,101,0,6
1,2449,2317,132,0,455,0,6
1,2574,2412,162,0,110,0,6
1,2546,2490,56,0,0,0,6
1,2526,2481,45,0,56,1,6
1,2278,2421,-143,0,49,0,6
1,2394,2426,-32,0,121,1,6
1,2338,2430,-92,0,264,0,6
1,2425,2362,63,0,205,0,6
1,2424,2557,-133,0,30,0,6
1,2566,2222,344,0,21,0,6
1,2211,2557,-346,0,110,1,6
1,2404,2281,123,0,90,0,6
1,2411,2366,45,0,200,0,6
1,2409,2315,94,0,180,0,8
1,2523,2486,37,0,138,0,6
1,2544,2548,-4,0,332,0,6
1,2520,2496,24,0,187,1,6
1,2551,2583,-32,0,190,0,6
1,2502,2599,-97,0,241,0,6
1,2289,2431,-142,0,331,1,6
1,2364,2469,-105,0,110,0,6
1,2343,2436,-93,0,110,1,6
1,2457,2395,62,0,122,0,6
1,2422,2474,-52,0,40,0,6
1,2427,2404,23,0,106,0,6
1,2566,2466,100,0,40,0,6
1,2499,2348,151,0,45,0,6
1,2364,2421,-57,0,150,0,8
1,2425,2312,113,0,200,0,6
1,2451,2467,-16,0,31,0,6
1,2289,2420,-131,0,49,0,6
1,2334,2412,-78,0,446,1,6
1,2532,2537,-5,0,110,1,6
1,2367,2460,-93,0,159,0,6
1,2551,2571,-20,0,302,0,6
1,2423,2244,179,0,31,0,6
1,2284,2402,-118,0,125,0,6
1,2556,2499,57,0,107,0,6
1,2451,2415,36,0,101,0,8
1,2428,2386,42,0,106,0,6
1,2333,2407,-74,0,45,1,6
1,2388,2411,-23,0,9,0,6
1,2379,2470,-91,0,288,0,6
1,2409,2295,114,0,125,0,6
1,2290,2418,-128,0,123,0,6
1,2476,2211,265,0,41,0,6
1,2555,2630,-75,0,106,1,6
1,2437,2500,-63,0,100,0,6
1,2470,2469,1,0,4,0,6
1,2429,2367,62,0,240,0,6
1,2441,2347,94,0,228,0,6
1,2602,2533,69,0,311,0,6
1,2267,2483,-216,0,123,0,6
1,2521,2361,160,0,4,0,6
1,2407,2441,-34,0,114,0,6
1,2425,2521,-96,0,4,0,6
1,2491,2492,-1,0,267,0,6
1,2420,2352,68,0,152,0,6
1,2412,2295,117,4,4,1,13
1,2502,2385,117,0,125,0,6
1,2402,2294,108,0,0,0,6
1,2445,2426,19,0,16,0,6
1,2518,2459,59,0,124,0,6
1,2420,2409,11,0,205,0,6
1,2375,2468,-93,0,45,0,6
1,2495,2415,80,0,106,0,6
1,2421,2243,178,0,321,0,6
1,2427,2331,96,0,110,1,6
1,2375,2562,-187,0,307,0,6
1,2525,2516,9,0,14,0,6
1,2451,2524,-73,0,122,0,6
1,2465,2526,-61,0,303,0,6
1,2547,2458,89,0,4,0,6
1,2285,2407,-122,0,45,1,6
1,2491,2425,66,0,106,1,6
1,2508,2412,96,0,25,0,6
1,2541,2464,77,0,187,1,6
1,2370,2484,-114,0,70,1,6
1,2402,2349,53,0,40,0,6
1,2460,2384,76,0,380,0,6
1,2467,2415,52,0,268,1,6
1,2354,2436,-82,0,109,0,6
1,2348,2443,-95,0,153,0,6
1,2463,2235,228,4,16,0,11
1,2504,2408,96,0,391,0,6
1,2544,2577,-33,0,21,0,6
1,2411,2420,-9,0,308,1,6
1,2322,2422,-100,0,302,0,6
1,2281,2424,-143,4,485,0,8
1,2732,2594,138,0,80,0,6
1,2468,2629,-161,0,140,0,6
1,2451,2460,-9,0,110,0,6
1,2461,2388,73,0,110,0,6
1,2393,2487,-94,0,414,0,6
1,2352,2423,-71,0,90,1,6
1,2430,2331,99,0,260,0,6
1,2527,2497,30,0,405,0,6
1,2435,2420,15,0,128,0,6
1,2247,2410,-163,0,48,1,6
1,2566,2536,30,0,404,0,6
1,2443,2476,-33,0,115,1,6
1,2453,2397,56,0,485,1,6
1,2444,2277,167,0,1,0,6
1,2479,2508,-29,0,143,0,6
1,2451,2395,56,0,310,1,6
1,2437,2455,-18,0,380,1,6
1,2581,2646,-65,0,253,0,6
1,2427,2408,19,0,310,0,6
1,2398,2439,-41,0,123,0,6
1,2537,2731,-194,0,124,0,6
1,2424,2501,-77,0,200,0,6
1,2471,2336,135,0,110,0,6
1,2308,2464,-156,0,40,1,6
1,2429,2438,-9,0,200,0,6
1,2462,2325,137,0,128,0,5
1,2500,2560,-60,0,250,0,6
1,2421,2350,71,0,200,0,6
1,2326,2441,-115,0,255,0,6
1,2254,2452,-198,0,20,0,6
1,2558,2561,-3,0,170,0,6
1,2540,2384,156,0,8,0,6
1,2396,2412,-16,0,269,1,8
1,2549,2648,-99,0,4,1,6
1,2407,2341,66,0,197,0,6
1,2500,2362,138,0,301,0,6
1,2601,2704,-103,0,0,0,6
1,2544,2252,292,0,40,0,6
1,2440,2317,123,0,40,0,6
1,2215,2462,-247,0,1,1,5
1,2426,2415,11,0,101,0,6
1,2407,2496,-89,0,46,1,6
1,2562,2412,150,0,344,0,6
1,2377,2486,-109,0,231,0,6
1,2412,2351,61,0,150,0,6
1,2400,2382,18,0,202,0,6
1,2458,2439,19,0,205,0,6
1,2704,2762,-58,0,380,0,6
1,2593,2476,117,0,118,1,6
1,2372,2430,-58,0,200,0,6
1,2440,2401,39,0,4,0,6
1,2424,2420,4,0,163,0,6
1,2432,2382,50,0,112,0,6
1,2401,2362,39,0,436,0,6
1,2507,2362,145,0,49,0,6
1,2485,2255,230,0,400,0,6
1,2744,2705,39,0,414,0,6
1,2382,2406,-24,0,113,0,6
1,2409,2363,46,0,212,0,6
1,2512,2548,-36,0,152,0,6
1,2533,2421,112,0,300,0,6
1,2449,2372,77,0,4,0,6
1,2635,2555,80,0,43,0,6
1,2323,2443,-120,0,0,1,6
1,2428,2218,210,0,1,0,6
1,2443,2284,159,0,302,0,6
1,2601,2615,-14,0,125,0,6
1,2388,2429,-41,0,244,0,6
1,2548,2480,68,0,388,0,6
1,2406,2376,30,0,122,0,6
1,2534,2526,8,0,131,0,6
1,2401,2419,-18,0,265,0,6
1,2546,2401,145,0,85,0,6
1,2400,2459,-59,0,80,0,6
1,2473,2396,77,0,325,1,6
1,2444,2357,87,0,45,0,6
1,2594,2510,84,0,106,0,6
1,2507,2532,-25,0,241,0,6
1,2237,2407,-170,0,115,1,8
1,2679,2548,131,0,398,0,6
1,2403,2244,159,0,354,0,6
1,2553,2453,100,0,242,0,6
1,2407,2395,12,0,277,0,6
1,2584,2454,130,0,45,0,6
1,2456,2323,133,4,29,0,16
1,2271,2418,-147,0,40,0,6
1,2489,2471,18,0,7,0,6
1,2432,2378,54,0,386,1,6
1,2455,2399,56,0,46,1,6
1,2581,2392,189,0,132,0,6
1,2559,2348,211,0,128,0,6
1,2482,2351,131,0,218,1,6
1,2524,2467,57,0,386,0,6
1,2384,2416,-32,4,49,0,13
1,2428,2255,173,0,380,0,6
1,2517,2333,184,0,50,0,8
1,2369,2401,-32,0,43,0,6
1,2396,2475,-79,0,400,1,6
1,2434,2416,18,0,343,1,6
1,2574,2464,110,0,260,1,6
1,2264,2440,-176,0,127,0,6
1,2405,2253,152,0,205,0,8
1,2415,2410,5,0,102,0,6
1,2420,2324,96,0,487,0,6
1,2437,2612,-175,0,402,0,6
1,2376,2400,-24,0,112,0,6
1,2481,2405,76,0,453,0,6
1,2507,2467,40,0,106,0,6
1,2417,2428,-11,0,112,0,6
1,2522,2527,-5,0,301,0,6
1,2394,2406,-12,0,113,1,6
1,2348,2420,-72,0,154,0,6
1,2442,2430,12,0,490,0,6
1,2446,2281,165,4,47,1,13
1,2443,2453,-10,0,112,0,6
1,2356,2414,-58,0,244,0,6
1,2450,2443,7,0,220,0,6
1,2436,2282,154,0,104,0,6
1,2451,2429,22,0,331,0,6
1,2523,2282,241,0,40,0,6
1,2483,2316,167,0,46,0,6
1,2543,2395,148,0,242,0,6
1,2358,2409,-51,0,110,0,8
1,2448,2441,7,0,128,0,6
1,2593,2540,53,0,120,0,6
1,2282,2450,-168,0,40,0,6
1,2637,2547,90,0,152,0,6
1,2346,2442,-96,0,40,0,6
1,2449,2446,3,0,201,0,6
1,2419,2270,149,0,309,0,6
1,2421,2247,174,0,145,0,6
1,2402,2511,-109,0,200,0,6
1,2427,2255,172,0,53,1,6
1,2479,2349,130,0,453,1,6
1,2508,2349,159,0,225,0,6
1,2390,2408,-18,0,15,0,6
1,2576,2577,-1,0,101,0,6
1,2337,2420,-83,0,114,0,6
1,2579,2594,-15,0,21,1,6
1,2438,2483,-45,0,15,0,6
1,2469,2370,99,0,302,0,6
1,2409,2433,-24,0,272,0,6
1,2492,2304,188,0,300,0,6
1,2558,2317,241,0,123,0,6
1,2497,2530,-33,0,31,0,6
1,2597,2403,194,0,410,0,6
1,2474,2423,51,0,112,1,6
1,2452,2641,-189,0,483,0,6
1,2620,2590,30,0,301,0,6
1,2429,2360,69,0,6,1,6
1,2471,2309,162,0,46,1,6
1,2589,2628,-39,0,40,0,6
1,2435,2228,207,0,344,0,6
1,2543,2365,178,0,120,0,6
1,2444,2441,3,0,205,0,6
1,2547,2266,281,0,45,0,6
1,2453,2341,112,0,100,1,6
1,2483,2327,156,0,492,1,6
1,2323,2433,-110,0,4,0,6
1,2418,2327,91,0,45,1,6
1,2689,2580,109,0,43,0,6
1,2403,2306,97,0,302,1,6
1,2503,2604,-101,0,101,1,6
1,2412,2384,28,0,311,0,6
1,2407,2235,172,0,45,1,8
1,2600,2674,-74,0,6,0,6
1,2657,2640,17,0,123,0,6
1,2454,2481,-27,0,15,1,6
1,2341,2495,-154,0,474,1,6
1,2293,2425,-132,0,123,1,6
1,2367,2424,-57,0,316,0,6
1,2305,2430,-125,0,0,0,6
1,2428,2530,-102,0,111,0,6
1,2499,2464,35,0,188,1,6
1,2555,2573,-18,0,115,0,6
1,2418,2288,130,0,131,0,6
1,2408,2391,17,0,40,0,8
1,2249,2404,-155,0,470,0,6
1,2546,2581,-35,0,337,1,6
1,2577,2208,369,4,220,0,13
1,2423,2404,19,0,415,0,6
1,2500,2705,-205,0,344,0,6
1,2432,2443,-11,0,88,1,6
1,2497,2363,134,0,200,0,6
1,2485,2519,-34,0,221,1,6
1,2465,2303,162,0,331,1,6
1,2441,2369,72,0,302,0,6
1,2419,2410,9,0,45,0,6
1,2514,2331,183,0,130,1,6
1,2394,2449,-55,0,123,1,6
1,2532,2403,129,0,110,0,6
1,2311,2499,-188,0,80,0,6
1,2446,2296,150,0,170,0,6
1,2472,2601,-129,0,123,0,6
1,2391,2421,-30,0,205,1,6
1,2605,2677,-72,0,4,0,6
1,2609,2483,126,0,133,0,6
1,2448,2314,134,0,402,0,6
1,2325,2447,-122,0,311,0,6
1,2586,2579,7,0,101,0,6
1,2539,2400,139,0,201,0,6
1,2547,2482,65,0,136,0,6
1,2489,2386,103,0,100,0,6
1,2438,2395,43,0,468,0,6
1,2487,2470,17,0,302,0,6
1,2417,2354,63,0,398,0,6
1,2504,2512,-8,0,40,0,6
1,2705,2427,278,0,130,0,6
1,2460,2329,131,0,40,0,6
1,2400,2344,56,0,41,0,6
1,2731,2650,81,0,115,0,6
1,2650,2676,-26,0,123,0,6
1,2694,2338,356,0,404,0,6
1,2411,2418,-7,0,139,1,6
1,2502,2325,177,0,115,1,6
1,2506,2406,100,0,120,0,6
1,2379,2412,-33,0,84,0,6
1,2445,2478,-33,0,40,1,6
1,2444,2273,171,0,4,0,6
1,2584,2497,87,0,4,1,6
1,2396,2424,-28,0,226,1,6
1,2466,2502,-36,0,487,1,6
1,2429,2378,51,0,103,0,6
1,2548,2587,-39,0,15,1,6
1,2265,2436,-171,0,176,0,6
1,2412,2365,47,0,57,1,6
1,2370,2433,-63,0,10,1,6
1,2481,2385,96,0,453,0,6
1,2417,2351,66,0,189,0,6
1,2381,2504,-123,0,4,1,6
1,2673,2726,-53,0,289,1,6
1,2476,2466,10,0,242,0,6
1,2290,2525,-235,0,395,1,6
1,2490,2536,-46,0,43,0,6
1,2629,2507,122,0,21,0,6
1,2466,2302,164,0,45,1,6
1,2576,2454,122,0,483,0,6
1,2650,2646,4,0,125,0,6
1,2406,2407,-1,0,102,1,6
1,2484,2472,12,0,138,1,6
1,2501,2470,31,0,112,1,6
1,2487,2444,43,0,315,0,6
1,2482,2448,34,0,128,0,6
1,2503,2501,2,0,57,0,6
1,2392,2429,-37,0,41,0,6
1,2388,2567,-179,0,8,0,6
1,2217,2416,-199,0,4,0,6
1,2392,2400,-8,0,463,1,6
1,2394,2558,-164,0,122,0,6
1,2395,2486,-91,0,461,0,6
1,2494,2386,108,0,40,0,6
1,2631,2435,196,0,100,1,8
1,2560,2473,87,0,140,1,6
1,2569,2564,5,0,270,1,6
1,2249,2411,-162,0,4,1,6
1,2381,2411,-30,0,334,0,6
1,2483,2400,83,4,337,1,13
1,2495,2470,25,0,1,0,6
1,2544,2458,86,0,15,0,6
1,2387,2400,-13,0,50,0,6
1,2464,2318,146,0,200,0,8
1,2435,2491,-56,0,302,0,6
1,2608,2574,34,0,49,0,6
1,2462,2368,94,0,310,1,6
1,2260,2416,-156,0,40,0,6
1,2203,2453,-250,0,168,0,6
1,2556,2271,285,0,325,0,6
1,2564,2230,334,0,15,0,6
1,2485,2680,-195,0,100,0,6
1,2404,2304,100,0,255,1,6
1,2434,2430,4,0,302,0,6
1,2414,2253,161,0,133,1,6
1,2474,2251,223,0,13,1,6
1,2240,2589,-349,0,40,0,6
1,2472,2481,-9,0,102,0,6
1,2401,2408,-7,0,490,0,6
1,2497,2238,259,0,107,1,6
1,2429,2412,17,0,200,1,6
1,2537,2388,149,0,101,0,6
1,2449,2356,93,0,102,1,6
1,2423,2355,68,0,4,0,8
1,2633,2564,69,0,106,0,6
1,2558,2526,32,0,115,1,6
1,2562,2213,349,0,45,0,6
1,2560,2338,222,0,43,1,6
1,2455,2435,20,0,10,0,6
1,2448,2552,-104,0,210,0,6
1,2338,2480,-142,0,45,1,6
1,2462,2502,-40,0,190,0,6
1,2521,2367,154,0,380,0,6
1,2611,2430,181,0,11,0,6
1,2514,2593,-79,0,134,0,6
1,2494,2581,-87,0,265,0,6
1,2423,2286,137,0,474,1,6
1,2496,2500,-4,0,41,0,6
1,2463,2402,61,0,125,0,6
1,2495,2335,160,0,4,0,6
1,2411,2350,61,0,57,1,6
1,2418,2256,162,0,122,1,8
1,2509,2521,-12,0,2,0,6
1,2450,2557,-107,0,45,0,6
1,2602,2245,357,0,122,0,6
1,2628,2547,81,0,115,1,6
1,2472,2373,99,0,383,1,6
1,2422,2459,-37,0,200,0,6
1,2512,2347,165,0,1,0,8
1,2463,2476,-13,0,405,1,6
1,2571,2385,186,0,405,0,6
1,2466,2345,121,0,345,0,6
1,2558,2631,-73,0,0,1,6
1,2471,2414,57,0,114,0,6
1,2408,2326,82,0,190,0,6
1,2421,2424,-3,4,113,1,13
1,2486,2438,48,0,302,1,6
1,2481,2337,144,0,205,0,6
1,2490,2530,-40,0,15,0,6
1,2430,2513,-83,0,387,0,6
1,2458,2384,74,0,122,0,6
1,2438,2274,164,0,101,0,6
1,2455,2545,-90,0,41,0,6
1,2406,2278,128,0,311,1,6
1,2378,2436,-58,0,10,0,6
1,2677,2645,32,0,194,0,6
1,2414,2237,177,0,0,0,8
1,2513,2334,179,0,306,0,6
1,2462,2488,-26,0,43,1,6
1,2617,2488,129,0,131,0,6
1,2641,2488,153,0,107,0,6
1,2410,2276,134,0,43,0,6
1,2473,2376,97,0,455,0,6
1,2434,2350,84,0,255,1,6
1,2457,2358,99,0,345,0,6
1,2449,2393,56,0,483,0,6
1,2542,2532,10,0,200,0,6
1,2529,2541,-12,0,16,1,6
1,2386,2436,-50,0,386,1,6
1,2736,2269,467,0,218,0,6
1,2406,2408,-2,0,131,0,6
1,2573,2377,196,0,462,0,6
1,2458,2436,22,0,112,1,6
1,2638,2528,110,0,115,1,6
1,2402,2364,38,0,46,0,6
1,2410,2401,9,0,200,0,6
1,2364,2432,-68,0,101,0,6
1,2589,2564,25,0,131,1,6
1,2420,2302,118,0,300,1,6
1,2454,2329,125,0,177,0,6
1,2488,2482,6,0,152,1,6
1,2462,2444,18,0,107,0,6
1,2437,2269,168,0,142,0,6
1,2707,2562,145,0,236,0,6
1,2515,2405,110,0,121,0,6
1,2492,2473,19,0,101,1,6
1,2471,2279,192,0,130,1,6
1,2493,2455,38,0,288,0,8
1,2418,2236,182,0,202,0,6
1,2417,2457,-40,0,200,1,6
1,2538,2570,-32,0,177,0,6
1,2505,2391,114,0,64,1,6
1,2525,2329,196,0,245,0,6
1,2413,2416,-3,0,45,0,6
1,2404,2316,88,0,327,0,6
1,2516,2568,-52,0,107,0,6
1,2389,2417,-28,0,380,1,6
1,2439,2242,197,0,141,0,6
1,2452,2437,15,0,0,0,6
1,2718,2472,246,0,332,0,6
1,2611,2471,140,0,325,0,6
1,2482,2361,121,0,412,0,6
1,2431,2287,144,0,15,0,6
1,2526,2325,201,0,41,0,6
1,2481,2591,-110,0,324,0,6
1,2408,2431,-23,0,45,0,6
1,2500,2315,185,0,313,0,6
1,2375,2428,-53,0,40,0,6
1,2466,2473,-7,0,14,1,6
1,2425,2416,9,0,200,0,6
1,2324,2480,-156,0,107,1,6
1,2474,2259,215,0,127,1,5
1,2452,2369,83,0,0,0,6
1,2669,2481,188,0,436,0,6
1,2444,2339,105,4,49,0,13
1,2430,2295,135,0,4,0,6
1,2508,2209,299,0,373,0,6
1,2530,2557,-27,0,312,0,6
1,2324,2431,-107,0,8,1,6
1,2673,2508,165,0,335,1,6
1,2442,2684,-242,0,9,0,6
1,2444,2408,36,0,335,0,6
1,2502,2618,-116,0,325,0,6
1,2403,2220,183,0,140,0,6
1,2489,2694,-205,0,180,1,6
1,2531,2379,152,0,121,0,6
1,2544,2613,-69,0,5,0,6
1,2487,2474,13,0,120,0,8
1,2416,2355,61,0,43,1,6
1,2299,2436,-137,0,337,0,6
1,2478,2403,75,0,45,0,6
1,2509,2278,231,0,253,0,5
1,2298,2460,-162,0,302,0,6
1,2526,2252,274,0,49,0,6
1,2647,2468,179,0,218,0,6
1,2484,2313,171,0,486,0,6
1,2406,2403,3,0,302,0,6
1,2628,2529,99,0,302,0,6
1,2435,2275,160,0,469,1,6
1,2470,2431,39,0,45,0,6
1,2350,2458,-108,0,460,0,6
1,2401,2268,133,0,107,0,6
1,2534,2486,48,0,4,0,6
1,2579,2437,142,0,134,1,6
1,2456,2270,186,0,302,0,6
1,2309,2425,-116,0,303,0,6
1,2576,2582,-6,0,103,0,6
1,2402,2326,76,0,122,1,6
1,2440,2351,89,0,113,0,6
1,2581,2425,156,0,123,0,6
1,2392,2428,-36,0,300,1,6
1,2539,2203,336,0,7,0,6
1,2474,2301,173,0,114,0,6
1,2522,2318,204,0,50,1,6
1,2424,2444,-20,0,152,1,6
1,2529,2513,16,0,0,1,6
1,2661,2510,151,0,167,0,6
1,2377,2484,-107,0,40,0,6
1,2493,2459,34,0,133,0,6
1,2595,2479,116,0,108,0,6
1,2371,2417,-46,0,336,1,6
1,2557,2443,114,0,45,0,6
1,2397,2497,-100,0,15,0,6
1,2402,2490,-88,0,300,0,6
1,2667,2661,6,0,110,1,6
1,2591,2450,141,0,101,0,6
1,2456,2477,-21,0,474,1,6
1,2457,2325,132,0,101,0,8
1,2401,2325,76,0,109,0,6
1,2528,2501,27,0,45,0,6
1,2417,2260,157,0,201,0,6
1,2427,2219,208,0,45,0,6
1,2429,2416,13,0,45,0,6
1,2510,2301,209,0,302,1,8
1,2430,2224,206,0,130,0,6
1,2426,2351,75,0,247,1,6
1,2497,2340,157,0,110,0,6
1,2491,2344,147,0,302,0,6
1,2436,2409,27,0,127,1,6
1,2547,2455,92,0,406,0,6
1,2684,2599,85,0,253,0,6
1,2476,2310,166,0,304,0,6
1,2497,2332,165,0,0,0,6
1,2429,2462,-33,0,130,1,6
1,2561,2573,-12,0,255,0,6
1,2479,2428,51,0,45,0,6
1,2595,2642,-47,0,152,0,6
1,2410,2340,70,0,3,0,6
1,2701,2601,100,0,106,0,6
1,2470,2397,73,0,149,0,6
1,2307,2432,-125,0,45,0,6
1,2401,2345,56,0,300,0,6
1,2525,2209,316,0,45,0,6
1,2300,2449,-149,0,45,1,6
1,2403,2387,16,0,100,0,6
1,2402,2317,85,0,0,0,6
1,2527,2275,252,0,343,0,6
1,2635,2531,104,0,41,0,6
1,2428,2284,144,0,123,0,6
1,2531,2369,162,0,49,0,6
1,2420,2581,-161,0,112,1,6
1,2283,2407,-124,0,242,0,6
1,2430,2305,125,0,4,0,6
1,2446,2465,-19,0,40,1,6
1,2420,2350,70,0,0,0,6
1,2467,2451,16,0,107,1,6
1,2434,2307,127,0,454,1,6
1,2406,2413,-7,0,211,1,6
1,2506,2455,51,0,106,0,6
1,2606,2590,16,0,0,1,6
1,2430,2484,-54,0,241,0,6
1,2336,2503,-167,0,1,0,6
1,2441,2280,161,0,102,0,6
1,2657,2508,149,0,1,0,6
1,2535,2403,132,0,100,0,8
1,2418,2537,-119,0,150,0,6
1,2473,2300,173,0,343,0,6
1,2419,2438,-19,0,453,0,6
1,2475,2295,180,0,106,1,6
1,2414,2307,107,0,344,1,6
1,2440,2455,-15,0,304,0,6
1,2400,2431,-31,0,307,0,6
1,2549,2408,141,0,209,0,6
1,2573,2596,-23,0,4,0,6
1,2440,2441,-1,0,192,1,6
1,2510,2404,106,0,330,0,6
1,2458,2371,87,0,115,0,6
1,2511,2419,92,0,200,0,6
1,2463,2476,-13,0,474,0,6
1,2414,2431,-17,0,477,0,6
1,2537,2570,-33,0,106,0,6
1,2405,2248,157,0,226,0,8
1,2501,2529,-28,0,112,0,6
1,2409,2415,-6,0,102,1,6
1,2451,2376,75,0,35,1,6
1,2646,2586,60,0,373,0,5
1,2420,2415,5,0,4,0,6
1,2429,2485,-56,0,120,1,6
1,2420,2482,-62,0,49,1,6
1,2455,2383,72,0,392,0,6
1,2603,2212,391,0,278,1,6
1,2403,2413,-10,0,338,0,8
1,2417,2352,65,0,43,0,6
1,2316,2556,-240,0,305,0,6
1,2351,2418,-67,0,409,0,6
1,2507,2415,92,0,265,0,6
1,2531,2346,185,0,4,1,8
1,2521,2342,179,0,244,0,6
1,2477,2327,150,0,4,0,6
1,2471,2455,16,0,38,0,6
1,2547,2501,46,0,1,0,6
1,2384,2492,-108,0,465,0,6
1,2488,2530,-42,0,5,0,6
1,2621,2522,99,0,7,0,6
1,2401,2403,-2,0,203,0,6
1,2516,2442,74,0,357,0,6
1,2753,2701,52,0,301,0,6
1,2538,2637,-99,0,380,0,6
1,2496,2311,185,0,0,0,6
1,2457,2506,-49,0,52,0,6
1,2439,2335,104,0,210,0,6
1,2419,2414,5,0,48,1,6
1,2401,2234,167,0,484,0,6
1,2273,2420,-147,0,250,0,6
1,2420,2416,4,0,83,0,6
1,2416,2328,88,0,45,1,6
1,2422,2447,-25,0,211,1,6
1,2486,2438,48,0,20,0,6
1,2495,2351,144,0,13,1,5
1,2545,2522,23,0,398,0,6
1,2512,2209,303,0,245,0,6
1,2424,2355,69,0,253,1,6
1,2402,2302,100,0,127,0,6
1,2685,2446,239,0,0,1,6
1,2418,2425,-7,0,140,1,6
1,2620,2673,-53,0,40,0,6
1,2252,2404,-152,0,34,0,6
1,2558,2379,179,0,241,0,6
1,2621,2477,144,0,0,0,6
1,2503,2551,-48,0,110,0,6
1,2260,2427,-167,0,0,0,6
1,2348,2469,-121,0,200,1,6
1,2546,2466,80,0,270,0,6
1,2530,2450,80,0,455,0,6
1,2408,2375,33,0,241,0,6
1,2333,2527,-194,0,300,0,6
1,2315,2403,-88,0,257,0,6
1,2502,2524,-22,0,301,0,6
1,2375,2425,-50,0,4,1,6
1,2317,2436,-119,0,487,1,6
1,2567,2600,-33,0,110,0,6
1,2545,2513,32,0,205,1,6
1,2378,2552,-174,0,0,0,6
1,2440,2521,-81,0,300,0,6
1,2475,2253,222,0,123,1,6
1,2422,2436,-14,0,110,0,6
1,2533,2506,27,0,110,0,6
1,2680,2443,237,0,492,0,6
1,2481,2462,19,0,255,0,6
1,2534,2456,78,0,0,0,6
1,2707,2470,237,0,153,0,6
1,2409,2315,94,0,245,1,8
1,2461,2319,142,0,107,0,6
1,2453,2320,133,0,1,0,6
1,2525,2303,222,0,111,0,6
1,2677,2600,77,0,4,0,6
1,2400,2283,117,0,0,0,6
1,2461,2405,56,0,335,0,6
1,2283,2453,-170,0,49,1,6
1,2439,2554,-115,0,200,0,6
1,2476,2349,127,0,101,0,6
1,2403,2545,-142,0,382,0,6
1,2406,2305,101,4,380,0,13
1,2407,2335,72,0,301,0,6
1,2495,2412,83,0,120,0,6
1,2601,2268,333,0,129,0,6
1,2502,2481,21,0,146,0,6
1,2442,2374,68,4,200,0,13
1,2426,2462,-36,0,88,1,6
1,2480,2252,228,4,56,0,13
1,2383,2451,-68,0,102,0,6
1,2410,2441,-31,0,333,0,6
1,2581,2580,1,0,194,0,6
1,2260,2407,-147,0,0,0,6
1,2455,2465,-10,0,15,0,6
1,2365,2427,-62,0,220,0,6
1,2506,2476,30,0,40,0,6
1,2351,2401,-50,0,401,0,6
1,2531,2371,160,0,131,0,6
1,2498,2375,123,0,106,0,6
1,2519,2428,91,0,70,0,6
1,2481,2604,-123,0,325,1,6
1,2765,2605,160,0,300,0,6
1,2418,2383,35,0,454,0,6
1,2567,2588,-21,0,106,1,8
1,2369,2417,-48,0,244,0,6
1,2470,2531,-61,0,241,0,6
1,2476,2481,-5,0,12,0,6
1,2545,2425,120,0,113,1,6
1,2375,2540,-165,0,483,0,6
1,2507,2552,-45,0,253,0,6
1,2675,2603,72,0,133,0,6
1,2359,2406,-47,0,13,0,6
1,2489,2453,36,0,123,0,6
1,2475,2384,91,0,311,1,6
1,2407,2345,62,0,386,0,6
1,2469,2438,31,0,200,1,6
1,2432,2224,208,0,217,1,6
1,2246,2507,-261,0,80,0,6
1,2349,2415,-66,0,121,1,6
1,2629,2554,75,0,406,0,6
1,2538,2590,-52,0,156,0,6
1,2438,2424,14,0,130,0,6
1,2425,2380,45,0,313,0,6
1,2448,2207,241,0,40,0,6
1,2472,2585,-113,0,200,0,6
1,2393,2409,-16,0,309,0,6
1,2427,2423,4,0,202,0,6
1,2488,2497,-9,0,140,1,6
1,2439,2307,132,0,35,0,6
1,2510,2511,-1,0,309,0,8
1,2488,2337,151,4,152,1,13
1,2375,2470,-95,0,45,0,6
1,2413,2238,175,0,37,0,6
1,2476,2266,210,0,331,0,6
1,2506,2322,184,0,20,0,6
1,2406,2392,14,0,43,0,6
1,2509,2455,54,0,10,0,6
1,2405,2395,10,0,398,0,6
1,2287,2405,-118,0,4,0,6
1,2406,2467,-61,0,45,0,6
1,2334,2422,-88,0,113,0,6
1,2579,2629,-50,0,250,0,6
1,2415,2324,91,0,46,0,6
1,2417,2452,-35,0,340,0,6
1,2536,2346,190,0,307,0,6
1,2431,2288,143,0,9,0,6
1,2526,2550,-24,0,40,0,6
1,2493,2360,133,0,212,1,6
1,2484,2354,130,0,40,0,6
1,2394,2451,-57,0,241,0,6
1,2565,2430,135,0,227,0,6
1,2682,2530,152,0,43,0,6
1,2411,2444,-33,0,300,0,6
1,2397,2417,-20,0,48,0,6
1,2250,2443,-193,0,17,1,6
1,2385,2415,-30,0,107,1,6
1,2385,2532,-147,0,225,0,6
1,2437,2541,-104,0,106,0,6
1,2486,2377,109,0,249,1,6
1,2457,2329,128,0,337,0,6
1,2495,2491,4,0,150,0,6
1,2551,2584,-33,0,403,1,6
1,2533,2453,80,0,200,1,6
1,2842,2758,84,0,301,0,6
1,2503,2497,6,0,128,0,6
1,2417,2401,16,0,113,0,8
1,2485,2318,167,0,101,1,6
1,2594,2473,121,0,146,0,6
1,2250,2423,-173,0,129,0,6
1,2367,2432,-65,0,218,0,6
1,2504,2509,-5,0,101,0,6
1,2422,2395,27,0,353,1,6
1,2524,2420,104,0,311,0,6
1,2462,2564,-102,0,241,0,6
1,2389,2444,-55,0,374,1,6
1,2411,2372,39,0,241,0,6
1,2426,2410,16,0,332,0,6
1,2355,2517,-162,0,101,0,6
1,2616,2565,51,0,40,1,6
1,2554,2548,6,0,406,0,6
1,2494,2457,37,0,405,0,6
1,2575,2632,-57,0,73,0,6
1,2521,2472,49,0,40,0,6
1,2662,2494,168,0,201,0,6
1,2438,2418,20,0,1,0,6
1,2414,2470,-56,0,487,0,6
1,2370,2408,-38,0,41,0,6
1,2407,2494,-87,0,226,0,8
1,2479,2475,4,0,246,1,6
1,2414,2297,117,0,330,0,6
1,2417,2226,191,0,142,0,6
1,2339,2459,-120,0,481,0,6
1,2434,2311,123,4,31,0,13
1,2402,2298,104,0,127,0,6
1,2416,2460,-44,0,1,1,6
1,2617,2536,81,0,144,0,6
1,2624,2358,266,0,485,1,6
1,2421,2403,18,0,301,0,6
1,2422,2470,-48,0,310,1,6
1,2569,2517,52,0,20,1,6
1,2542,2450,92,0,120,0,6
1,2424,2428,-4,0,300,0,6
1,2556,2478,78,0,114,0,6
1,2495,2453,42,0,123,0,6
1,2459,2345,114,0,4,0,6
1,2378,2460,-82,0,45,1,6
1,2470,2468,2,0,112,0,6
1,2416,2280,136,0,108,0,6
1,2616,2664,-48,0,123,1,6
1,2441,2553,-112,0,122,1,6
1,2469,2405,64,0,52,1,6
1,2339,2446,-107,0,245,1,6
1,2420,2293,127,0,13,0,6
1,2450,2439,11,0,308,0,6
1,2404,2452,-48,0,40,1,6
1,2425,2496,-71,0,1,0,6
1,2420,2402,18,0,268,0,6
1,2400,2393,7,0,211,1,6
1,2448,2468,-20,0,13,0,6
1,2403,2264,139,0,310,1,6
1,2721,2689,32,0,110,1,6
1,2404,2316,88,0,210,0,6
1,2365,2439,-74,0,4,1,6
1,2403,2528,-125,0,388,0,8
1,2444,2299,145,4,40,0,10
1,2732,2441,291,0,112,0,6
1,2463,2342,121,0,127,0,6
1,2436,2262,174,0,461,0,10
1,2581,2526,55,0,331,0,6
1,2274,2424,-150,0,0,0,6
1,2493,2497,-4,0,343,0,6
1,2461,2307,154,0,249,1,8
1,2441,2468,-27,0,40,0,6
1,2450,2546,-96,0,13,0,6
1,2421,2364,57,0,106,0,6
1,2506,2489,17,0,46,1,6
1,2348,2444,-96,0,1,1,6
1,2343,2424,-81,0,21,0,6
1,2385,2551,-166,0,325,0,6
1,2490,2499,-9,0,45,0,6
1,2469,2348,121,0,141,0,6
1,2453,2399,54,0,122,0,6
1,2369,2402,-33,0,2,0,6
1,2509,2561,-52,0,311,0,6
1,2402,2406,-4,0,49,1,6
1,2593,2586,7,0,47,0,6
1,2441,2413,28,0,277,0,6
1,2659,2695,-36,0,448,1,6
1,2453,2545,-92,0,113,0,6
1,2408,2247,161,4,150,0,13
1,2504,2355,149,0,80,0,6
1,2459,2312,147,0,15,0,6
1,2383,2471,-88,0,309,0,6
1,2404,2247,157,0,2,0,6
1,2544,2367,177,0,200,0,8
1,2489,2330,159,0,107,0,6
1,2471,2277,194,0,200,0,6
1,2509,2285,224,0,337,0,6
1,2415,2346,69,0,112,0,6
1,2504,2545,-41,0,4,0,6
1,2530,2209,321,0,243,0,6
1,2416,2516,-100,0,409,0,6
1,2530,2360,170,0,122,0,6
1,2431,2361,70,0,302,0,6
1,2374,2476,-102,0,456,0,6
1,2600,2601,-1,0,40,1,6
1,2444,2409,35,0,125,1,6
1,2665,2614,51,0,107,0,6
1,2507,2326,181,0,300,0,6
1,2582,2653,-71,0,112,0,6
1,2246,2417,-171,0,331,0,6
1,2383,2420,-37,0,194,0,6
1,2447,2422,25,0,253,0,6
1,2461,2312,149,0,40,0,6
1,2477,2437,40,0,45,0,6
1,2617,2583,34,0,0,0,6
1,2799,2685,114,0,337,0,6
1,2609,2412,197,0,18,0,6
1,2304,2525,-221,0,142,1,6
1,2348,2450,-102,0,4,0,6
1,2436,2310,126,0,121,0,6
1,2534,2543,-9,0,277,1,6
1,2446,2338,108,0,300,0,6
1,2453,2303,150,0,4,0,6
1,2423,2494,-71,0,45,0,6
1,2672,2491,181,0,0,0,6
1,2279,2447,-168,0,211,0,6
1,2464,2498,-34,0,453,0,6
1,2436,2313,123,0,205,0,6
1,2517,2579,-62,0,46,0,6
1,2531,2429,102,0,143,0,6
1,2416,2323,93,0,49,1,6
1,2418,2386,32,0,140,0,6
1,2593,2352,241,0,121,0,6
1,2607,2585,22,0,37,1,6
1,2657,2450,207,0,301,0,6
1,2410,2446,-36,0,4,0,6
1,2400,2305,95,0,40,1,6
1,2479,2362,117,0,153,0,6
1,2403,2352,51,0,177,0,6
1,2568,2560,8,0,9,0,6
1,2444,2264,180,0,48,0,6
1,2443,2426,17,0,335,0,6
1,2596,2573,23,0,45,0,6
1,2570,2541,29,0,120,0,6
1,2499,2415,84,0,12,0,6
1,2399,2413,-14,0,107,1,6
1,2455,2420,35,0,127,0,6
1,2547,2546,1,0,175,0,6
1,2526,2388,138,0,87,0,6
1,2618,2592,26,0,190,0,6
1,2458,2215,243,0,135,1,6
1,2406,2344,62,0,190,0,6
1,2372,2430,-58,0,45,0,6
1,2459,2309,150,0,133,1,6
1,2456,2282,174,0,41,0,6
1,2533,2435,98,0,108,0,6
1,2241,2469,-228,0,143,0,6
1,2409,2348,61,0,4,1,6
1,2572,2439,133,0,13,1,6
1,2528,2458,70,0,45,0,6
1,2405,2407,-2,0,103,0,6
1,2416,2284,132,0,103,1,6
1,2545,2463,82,0,45,0,6
1,2566,2230,336,0,469,0,6
1,2411,2361,50,0,115,0,6
1,2595,2660,-65,0,106,0,6
1,2501,2308,193,0,469,0,6
1,2511,2325,186,0,10,0,6
1,2424,2308,116,0,300,0,6
1,2439,2605,-166,0,200,0,6
1,2629,2471,158,0,45,0,6
1,2535,2279,256,0,241,0,6
1,2428,2424,4,0,483,0,6
1,2388,2471,-83,0,122,0,6
1,2363,2437,-74,0,111,1,6
1,2403,2380,23,4,8,0,13
1,2385,2416,-31,0,151,0,6
1,2546,2567,-21,0,406,0,6
1,2492,2408,84,0,10,0,5
1,2485,2429,56,0,6,0,6
1,2471,2337,134,0,254,0,6
1,2406,2397,9,0,4,0,6
1,2537,2626,-89,0,380,0,6
1,2581,2566,15,0,306,1,6
1,2480,2410,70,0,121,0,6
1,2567,2405,162,0,107,0,6
1,2472,2413,59,0,255,1,6
1,2409,2265,144,0,3,0,6
1,2517,2601,-84,0,37,0,6
1,2443,2353,90,0,380,1,6
1,2302,2417,-115,0,470,0,6
1,2444,2410,34,0,13,0,6
1,2499,2469,30,0,100,0,6
1,2385,2416,-31,0,110,0,6
1,2310,2456,-146,0,106,0,6
1,2515,2637,-122,0,106,0,6
1,2483,2422,61,0,40,1,6
1,2530,2566,-36,0,46,0,6
1,2334,2420,-86,0,278,1,6
1,2563,2551,12,0,132,0,6
1,2385,2457,-72,0,80,0,6
1,2502,2545,-43,0,48,1,6
1,2472,2425,47,0,487,0,6
1,2531,2504,27,0,45,0,6
1,2527,2492,35,0,130,0,6
1,2419,2273,146,0,102,0,6
1,2436,2371,65,0,45,0,6
1,2459,2480,-21,0,170,0,6
1,2484,2491,-7,0,12,0,6
1,2526,2293,233,0,40,0,5
1,2334,2465,-131,0,206,0,6
1,2262,2451,-189,0,28,0,6
1,2415,2204,211,0,1,0,6
1,2424,2270,154,0,100,0,6
1,2801,2648,153,0,190,0,6
1,2240,2411,-171,0,311,1,6
1,2463,2387,76,0,300,0,6
1,2448,2278,170,0,201,0,6
1,2277,2415,-138,4,200,1,13
1,2538,2406,132,0,0,0,6
1,2466,2456,10,0,4,0,6
1,2462,2338,124,0,315,0,8
1,2454,2429,25,0,412,0,6
1,2474,2391,83,0,211,0,6
1,2502,2326,176,0,344,0,6
1,2374,2534,-160,0,300,1,6
1,2381,2406,-25,0,42,0,6
1,2482,2211,271,4,120,0,13
1,2426,2366,60,0,128,0,6
1,2413,2428,-15,0,426,0,6
1,2413,2313,100,0,0,0,6
1,2410,2402,8,0,7,0,6
1,2612,2280,332,0,121,0,6
1,2505,2321,184,0,57,0,6
1,2723,2620,103,0,409,0,6
1,2472,2443,29,0,11,0,6
1,2380,2413,-33,0,200,0,6
1,2429,2466,-37,0,127,0,6
1,2536,2408,128,0,181,0,6
1,2533,2523,10,0,405,0,6
1,2330,2498,-168,0,245,1,8
1,2459,2298,161,4,125,0,13
1,2530,2370,160,0,8,0,8
1,2706,2629,77,0,300,0,6
1,2576,2383,193,0,304,0,6
1,2332,2420,-88,0,130,1,6
1,2461,2500,-39,0,326,0,6
1,2327,2425,-98,0,46,0,6
1,2627,2557,70,0,406,0,6
1,2370,2462,-92,0,43,1,6
1,2402,2402,0,0,51,0,6
1,2454,2561,-107,0,288,1,6
1,2411,2455,-44,0,45,0,6
1,2355,2463,-108,0,201,0,6
1,2407,2450,-43,0,40,0,6
1,2595,2655,-60,0,170,0,6
1,2482,2345,137,0,20,0,6
1,2546,2622,-76,0,112,0,6
1,2475,2560,-85,0,4,0,6
1,2450,2281,169,0,338,0,6
1,2454,2371,83,0,190,0,6
1,2290,2462,-172,0,130,1,6
1,2493,2376,117,0,53,0,6
1,2582,2580,2,0,6,1,6
1,2815,2565,250,0,43,0,6
1,2555,2304,251,0,135,0,8
1,2462,2636,-174,0,220,0,6
1,2246,2438,-192,0,112,0,6
1,2480,2535,-55,0,404,0,6
1,2586,2396,190,0,15,0,8
1,2432,2388,44,0,217,0,6
1,2502,2450,52,0,45,0,6
1,2408,2366,42,0,206,1,6
1,2463,2370,93,4,45,0,13
1,2452,2357,95,0,43,0,6
1,2452,2359,93,0,106,0,6
1,2436,2371,65,0,150,0,6
1,2408,2263,145,0,122,0,6
1,2446,2379,67,0,277,0,6
1,2292,2440,-148,0,157,1,6
1,2423,2306,117,0,1,0,6
1,2288,2416,-128,0,110,0,6
1,2604,2508,96,0,117,0,6
1,2626,2424,202,0,253,0,6
1,2459,2496,-37,0,201,0,6
1,2535,2510,25,0,4,1,6
1,2491,2419,72,0,40,0,6
1,2421,2318,103,0,201,0,6
1,2298,2492,-194,0,171,0,6
1,2357,2407,-50,0,300,1,6
1,2299,2470,-171,0,218,0,6
1,2565,2460,105,0,128,0,6
1,2544,2514,30,0,311,0,6
1,2441,2442,-1,0,41,0,6
1,2223,2502,-279,0,30,0,5
1,2407,2422,-15,0,225,0,6
1,2419,2439,-20,0,110,0,6
1,2228,2402,-174,0,103,0,6
1,2413,2338,75,0,40,0,6
1,2425,2275,150,0,50,0,6
1,2455,2362,93,0,140,0,6
1,2405,2413,-8,0,28,0,6
1,2425,2344,81,0,343,0,6
1,2451,2480,-29,0,106,0,6
1,2613,2504,109,0,210,0,6
1,2755,2711,44,0,395,0,6
1,2545,2454,91,0,464,1,6
1,2446,2358,88,0,111,0,6
1,2271,2445,-174,0,101,0,6
1,2412,2504,-92,0,128,0,6
1,2427,2254,173,0,140,0,6
1,2447,2314,133,0,411,0,6
1,2507,2335,172,0,330,0,6
1,2449,2431,18,0,4,1,6
1,2416,2334,82,0,7,1,8
1,2487,2359,128,0,0,0,6
1,2549,2474,75,0,115,0,6
1,2549,2346,203,0,4,0,6
1,2401,2386,15,0,106,0,6
1,2421,2440,-19,0,258,0,6
1,2654,2533,121,0,103,1,6
1,2626,2401,225,0,0,0,6
1,2357,2435,-78,0,145,0,6
1,2377,2420,-43,0,45,1,6
1,2475,2410,65,0,210,0,6
1,2670,2514,156,0,138,1,6
1,2478,2218,260,0,62,0,6
1,2580,2417,163,0,39,0,6
1,2564,2484,80,0,14,1,6
1,2327,2410,-83,0,247,0,6
1,2426,2492,-66,0,288,0,6
1,2399,2462,-63,0,10,1,6
1,2607,2633,-26,0,241,0,6
1,2554,2623,-69,0,37,1,6
1,2415,2553,-138,0,320,0,6
1,2345,2415,-70,0,36,0,6
1,2510,2374,136,0,43,0,6
1,2414,2283,131,0,101,0,6
1,2561,2507,54,0,45,0,6
1,2492,2442,50,0,302,0,6
1,2606,2330,276,0,13,0,6
1,2375,2464,-89,0,46,0,6
1,2430,2390,40,0,243,0,6
1,2483,2536,-53,0,31,1,6
1,2287,2454,-167,0,200,0,6
1,2373,2429,-56,0,245,0,6
1,2453,2382,71,0,335,0,6
1,2430,2284,146,0,15,0,6
1,2426,2402,24,0,43,1,6
1,2443,2409,34,0,292,0,6
1,2405,2378,27,0,15,0,6
1,2491,2465,26,0,250,0,6
1,2463,2459,4,0,111,0,6
1,2566,2672,-106,0,45,0,6
1,2440,2328,112,0,8,0,6
1,2451,2305,146,0,306,0,8
1,2450,2388,62,0,406,1,6
1,2581,2526,55,0,331,0,6
1,2426,2372,54,0,203,0,6
1,2626,2639,-13,0,228,0,6
1,2555,2562,-7,0,7,0,6
1,2459,2367,92,0,354,1,6
1,2479,2322,157,0,311,0,6
1,2575,2493,82,0,398,0,6
1,2510,2454,56,0,315,0,6
1,2382,2553,-171,0,110,1,6
1,2406,2206,200,4,132,1,13
1,2452,2518,-66,0,202,0,6
1,2404,2556,-152,0,202,0,6
1,2546,2513,33,0,112,1,6
1,2304,2452,-148,0,244,0,6
1,2527,2404,123,0,49,0,6
1,2558,2337,221,0,45,0,0
1,2321,2498,-177,0,380,1,6
1,2682,2328,354,0,453,0,6
1,2398,2413,-15,0,185,0,6
1,2346,2414,-68,0,151,0,6
1,2346,2428,-82,0,247,0,6
1,2560,2555,5,0,310,0,6
1,2336,2449,-113,0,0,0,6
1,2491,2350,141,0,326,0,6
1,2441,2522,-81,0,131,1,6
1,2431,2397,34,0,0,0,6
1,2427,2408,19,0,112,0,6
1,2520,2517,3,0,80,1,6
1,2542,2517,25,0,302,0,6
1,2456,2480,-24,0,103,1,5
1,2470,2305,165,0,485,0,6
1,2471,2430,41,0,140,0,6
1,2300,2410,-110,0,9,0,6
1,2447,2462,-15,0,45,0,6
1,2441,2417,24,0,201,0,6
1,2625,2495,130,0,202,0,6
1,2427,2470,-43,0,5,1,6
1,2424,2311,113,0,140,1,6
1,2400,2393,7,4,45,0,13
1,2359,2452,-93,0,107,0,8
1,2468,2324,144,0,10,1,6
1,2448,2479,-31,0,121,0,6
1,2426,2334,92,0,374,0,6
1,2605,2538,67,0,104,0,6
1,2531,2392,139,0,200,0,6
1,2505,2299,206,0,225,0,6
1,2413,2262,151,0,45,1,6
1,2410,2296,114,0,455,0,6
1,2379,2420,-41,0,101,0,6
1,2432,2290,142,0,4,0,8
1,2457,2436,21,0,125,1,6
1,2499,2230,269,0,46,0,6
1,2410,2432,-22,0,15,1,6
1,2544,2227,317,0,0,0,6
1,2552,2397,155,0,45,0,6
1,2483,2361,122,0,380,0,6
1,2518,2272,246,0,456,0,6
1,2499,2510,-11,0,107,1,6
1,2483,2515,-32,0,302,1,6
1,2476,2477,-1,0,201,0,6
1,2419,2322,97,0,45,0,8
1,2465,2325,140,0,46,0,6
1,2357,2478,-121,0,43,1,6
1,2520,2358,162,0,331,1,6
1,2624,2588,36,0,111,0,6
1,2321,2437,-116,0,333,0,6
1,2424,2548,-124,0,102,0,6
1,2376,2455,-79,0,300,0,6
1,2480,2480,0,0,1,0,6
1,2679,2533,146,0,100,0,6
1,2407,2331,76,0,456,0,6
1,2428,2268,160,0,332,0,6
1,2576,2579,-3,0,398,0,6
1,2382,2410,-28,0,484,1,6
1,2454,2457,-3,0,242,0,6
1,2511,2270,241,0,112,0,6
1,2409,2246,163,0,85,1,6
1,2393,2487,-94,0,45,0,6
1,2410,2274,136,0,302,1,6
1,2503,2331,172,0,13,0,6
1,2435,2333,102,0,141,0,6
1,2582,2543,39,0,106,0,6
1,2514,2330,184,0,101,0,6
1,2388,2437,-49,0,453,0,6
1,2383,2416,-33,0,167,0,6
1,2370,2410,-40,0,405,1,6
1,2407,2237,170,0,140,0,6
1,2405,2349,56,0,302,1,6
1,2517,2278,239,0,45,0,6
1,2292,2400,-108,0,41,1,6
1,2777,2620,157,0,278,1,6
1,2493,2537,-44,0,123,0,6
1,2456,2314,142,0,56,0,6
1,2539,2459,80,0,453,0,6
1,2728,2522,206,0,297,0,6
1,2415,2282,133,0,41,0,6
1,2523,2553,-30,0,184,1,6
1,2540,2520,20,0,301,1,6
1,2494,2431,63,0,341,0,6
1,2668,2496,172,0,0,0,6
1,2428,2371,57,0,45,0,6
1,2636,2431,205,0,0,0,6
1,2538,2360,178,0,291,0,6
1,2566,2459,107,0,226,1,6
1,2602,2286,316,0,15,0,6
1,2424,2282,142,4,50,0,13
1,2418,2413,5,0,331,0,6
1,2494,2557,-63,0,5,0,6
1,2467,2457,10,0,43,1,6
1,2418,2252,166,0,485,0,6
1,2433,2397,36,0,101,0,6
1,2524,2369,155,0,2,0,6
1,2435,2485,-50,0,167,0,6
1,2646,2389,257,0,13,0,6
1,2420,2361,59,4,28,0,13
1,2563,2228,335,0,202,0,8
1,2303,2405,-102,0,45,1,6
1,2432,2386,46,0,40,0,6
1,2671,2536,135,0,306,0,6
1,2292,2458,-166,0,262,1,6
1,2483,2396,87,0,426,0,6
1,2425,2466,-41,0,33,1,6
1,2576,2376,200,0,56,0,6
1,2486,2628,-142,0,326,0,6
1,2345,2480,-135,0,44,0,6
1,2244,2421,-177,0,256,0,6
1,2582,2426,156,0,300,0,6
1,2660,2518,142,0,210,0,6
1,2512,2446,66,0,46,0,6
1,2603,2491,112,0,45,0,6
1,2462,2287,175,0,120,0,6
1,2446,2461,-15,0,130,0,6
1,2536,2398,138,0,7,0,6
1,2610,2231,379,0,109,0,6
1,2568,2464,104,0,320,0,6
1,2334,2436,-102,0,475,0,6
1,2483,2511,-28,0,113,0,6
1,2534,2613,-79,0,4,0,6
1,2325,2423,-98,0,46,0,6
1,2365,2438,-73,0,250,0,6
1,2478,2465,13,0,107,0,6
1,2402,2483,-81,0,264,0,6
1,2432,2432,0,0,16,0,6
1,2639,2513,126,0,202,0,6
1,2640,2587,53,0,302,0,6
1,2477,2312,165,0,106,0,6
1,2522,2394,128,0,285,0,6
1,2658,2451,207,0,267,0,6
1,2409,2295,114,0,113,0,6
1,2588,2441,147,0,143,0,6
1,2580,2492,88,0,143,0,6
1,2546,2469,77,0,68,0,6
1,2449,2386,63,0,241,1,6
1,2496,2249,247,0,123,0,6
1,2439,2406,33,0,405,0,6
1,2418,2421,-3,0,1,0,6
1,2413,2222,191,0,412,0,8
1,2222,2445,-223,0,121,0,6
1,2410,2374,36,0,145,0,6
1,2286,2405,-119,0,262,0,6
1,2222,2405,-183,0,112,0,6
1,2451,2488,-37,0,190,0,6
1,2550,2451,99,0,463,0,6
1,2413,2460,-47,0,45,0,6
1,2510,2400,110,0,0,1,6
1,2403,2334,69,0,2,0,6
1,2520,2418,102,0,302,0,6
1,2606,2558,48,0,123,1,6
1,2306,2535,-229,0,302,0,6
1,2441,2387,54,0,1,0,6
1,2382,2569,-187,0,101,0,6
1,2449,2423,26,0,334,0,6
1,2519,2487,32,0,148,1,6
1,2448,2377,71,0,5,0,5
1,2459,2335,124,0,4,0,6
1,2454,2363,91,0,102,1,6
1,2441,2347,94,0,132,1,6
1,2416,2433,-17,0,132,1,6
1,2409,2234,175,0,107,0,10
1,2442,2442,0,0,152,0,6
1,2410,2242,168,0,4,0,6
1,2364,2449,-85,0,214,0,6
1,2355,2406,-51,0,152,0,6
1,2430,2315,115,0,111,0,6
1,2573,2662,-89,0,474,0,6
1,2479,2329,150,0,150,1,6
1,2618,2399,219,0,167,0,6
1,2524,2659,-135,0,414,0,6
1,2319,2548,-229,0,210,0,6
1,2811,2206,605,0,307,0,6
1,2531,2401,130,0,302,0,6
1,2409,2385,24,0,200,0,6
1,2554,2384,170,0,4,0,6
1,2456,2359,97,0,126,0,6
1,2637,2613,24,0,354,0,6
1,2532,2477,55,0,57,0,6
1,2556,2441,115,0,150,1,6
1,2632,2520,112,0,30,1,6
1,2447,2456,-9,0,9,0,6
1,2415,2355,60,0,302,1,6
1,2589,2357,232,0,49,0,6
1,2534,2599,-65,0,106,1,6
1,2297,2403,-106,0,45,0,6
1,2777,2652,125,0,335,0,6
1,2281,2502,-221,0,102,1,6
1,2503,2300,203,0,13,0,6
1,2406,2426,-20,0,43,1,6
1,2404,2337,67,0,5,0,6
1,2361,2424,-63,0,200,0,6
1,2458,2377,81,0,438,0,6
1,2634,2462,172,0,241,1,6
1,2373,2484,-111,0,387,0,6
1,2506,2555,-49,0,225,0,6
1,2504,2419,85,0,150,0,6
1,2476,2440,36,0,10,1,6
1,2460,2417,43,0,106,0,6
1,2406,2260,146,0,0,1,6
1,2527,2596,-69,0,227,1,6
1,2383,2448,-65,0,344,0,6
1,2641,2641,0,0,245,0,6
1,2462,2450,12,0,203,0,6
1,2454,2321,133,0,121,0,6
1,2305,2409,-104,0,455,1,6
1,2342,2450,-108,0,6,0,6
1,2519,2424,95,0,45,0,6
1,2305,2446,-141,0,150,0,6
1,2412,2432,-20,0,11,0,6
1,2427,2273,154,0,112,0,6
1,2476,2435,41,0,302,0,6
1,2325,2608,-283,0,48,0,6
1,2395,2438,-43,0,264,1,6
1,2467,2282,185,0,205,0,6
1,2547,2392,155,0,190,0,6
1,2445,2256,189,0,7,0,6
1,2499,2278,221,0,101,0,6
1,2416,2522,-106,0,210,0,6
1,2531,2458,73,0,45,0,6
1,2418,2250,168,0,4,0,6
1,2431,2335,96,0,106,0,6
1,2576,2536,40,0,341,0,6
1,2419,2432,-13,0,470,0,6
1,2411,2352,59,0,302,1,6
1,2517,2431,86,0,115,0,6
1,2483,2511,-28,0,311,1,6
1,2467,2264,203,0,45,0,6
1,2426,2440,-14,0,395,0,6
1,2369,2460,-91,0,228,0,6
1,2467,2456,11,4,47,0,0
1,2411,2265,146,0,253,0,6
1,2367,2445,-78,0,330,0,6
1,2478,2542,-64,0,243,0,6
1,2216,2438,-222,0,212,0,6
1,2288,2440,-152,0,250,0,6
1,2399,2437,-38,0,150,1,6
1,2763,2687,76,0,316,1,6
1,2470,2426,44,0,46,1,6
1,2381,2429,-48,0,121,0,6
1,2543,2403,140,0,178,0,6
1,2302,2415,-113,0,125,0,6
1,2458,2452,6,0,332,1,6
1,2732,2620,112,0,116,0,6
1,2390,2498,-108,0,120,0,6
1,2297,2436,-139,0,227,0,6
1,2526,2382,144,0,45,0,6
1,2682,2548,134,0,104,0,6
1,2554,2307,247,0,211,0,6
1,2517,2436,81,0,106,0,6
1,2481,2423,58,0,4,0,6
1,2443,2365,78,0,207,0,6
1,2460,2374,86,0,46,0,6
1,2547,2546,1,0,140,0,6
1,2379,2492,-113,0,3,1,6
1,2444,2287,157,0,106,0,6
1,2452,2341,111,0,6,0,6
1,2420,2380,40,0,131,0,6
1,2469,2331,138,0,46,0,6
1,2577,2638,-61,0,338,0,6
1,2501,2523,-22,0,43,1,6
1,2424,2293,131,0,52,0,6
1,2422,2267,155,0,112,1,8
1,2632,2524,108,0,101,0,6
1,2223,2474,-251,0,335,1,6
1,2421,2383,38,0,45,0,6
1,2288,2407,-119,0,4,1,8
1,2473,2325,148,0,343,0,6
1,2384,2410,-26,0,45,0,6
1,2660,2664,-4,0,398,0,6
1,2739,2394,345,0,267,0,6
1,2492,2396,96,0,36,1,6
1,2582,2433,149,0,454,0,6
1,2443,2588,-145,0,2,1,6
1,2400,2397,3,0,270,0,6
1,2407,2420,-13,0,151,1,6
1,2417,2437,-20,0,0,0,6
1,2410,2285,125,0,61,0,6
1,2453,2338,115,0,11,0,6
1,2525,2347,178,0,244,0,6
1,2544,2597,-53,0,301,0,6
1,2507,2249,258,0,124,0,6
1,2475,2303,172,0,4,0,6
1,2328,2445,-117,0,475,0,6
1,2455,2487,-32,0,300,1,6
1,2417,2355,62,0,41,0,6
1,2372,2407,-35,0,43,0,6
1,2621,2576,45,0,34,0,6
1,2402,2343,59,0,313,0,8
1,2415,2366,49,0,65,0,6
1,2528,2473,55,0,255,0,6
1,2438,2579,-141,0,115,0,6
1,2603,2348,255,0,131,0,6
1,2374,2410,-36,0,41,0,6
1,2293,2606,-313,2,113,0,24
1,2443,2356,87,0,101,0,6
1,2452,2431,21,0,130,0,6
1,2561,2529,32,0,110,0,6
1,2544,2655,-111,0,0,0,6
1,2754,2211,543,0,107,0,6
1,2446,2356,90,0,102,0,6
1,2525,2245,280,0,18,0,6
1,2528,2562,-34,0,7,0,6
1,2455,2378,77,0,131,0,6
1,2407,2326,81,0,331,0,6
1,2533,2427,106,0,310,0,6
1,2540,2371,169,0,40,0,6
1,2544,2571,-27,0,143,1,6
1,2668,2519,149,0,4,0,6
1,2436,2273,163,0,7,0,6
1,2542,2545,-3,0,302,1,6
1,2420,2520,-100,0,127,0,6
1,2548,2566,-18,0,101,0,6
1,2408,2304,104,0,106,1,6
1,2447,2407,40,0,36,0,6
1,2470,2332,138,0,125,0,6
1,2611,2613,-2,0,43,0,6
1,2416,2428,-12,0,112,1,6
1,2411,2446,-35,0,48,0,8
1,2437,2417,20,0,245,0,6
1,2352,2424,-72,0,241,0,6
1,2215,2402,-187,0,48,0,6
1,2405,2291,114,0,100,1,6
1,2423,2443,-20,0,48,0,6
1,2400,2414,-14,0,102,0,6
1,2329,2407,-78,0,248,1,6
1,2633,2629,4,0,123,0,6
1,2359,2549,-190,0,483,0,6
1,2331,2451,-120,0,300,0,6
1,2476,2318,158,0,457,0,6
1,2453,2325,128,0,15,0,6
1,2423,2360,63,0,0,0,6
1,2611,2274,337,0,315,0,6
1,2627,2445,182,0,421,0,6
1,2424,2397,27,0,4,1,6
1,2357,2403,-46,0,37,0,6
1,2595,2445,150,0,333,1,6
1,2588,2490,98,0,113,0,6
1,2437,2240,197,0,405,1,6
1,2456,2286,170,0,432,0,6
1,2360,2404,-44,0,140,0,6
1,2649,2398,251,0,447,0,6
1,2433,2421,12,0,216,0,6
1,2406,2383,23,0,292,0,6
1,2484,2309,175,0,215,0,6
1,2336,2450,-114,0,100,0,6
1,2421,2214,207,0,315,0,6
1,2400,2333,67,0,210,0,6
1,2422,2317,105,0,5,0,6
1,2500,2386,114,0,301,0,6
1,2498,2375,123,0,338,0,6
1,2412,2335,77,0,13,0,6
1,2482,2334,148,0,41,0,6
1,2295,2448,-153,0,310,0,6
1,2464,2433,31,0,302,0,6
1,2430,2300,130,0,145,0,6
1,2502,2212,290,0,300,0,6
1,2371,2503,-132,0,46,1,6
1,2486,2391,95,0,0,0,6
1,2427,2363,64,0,112,0,6
1,2446,2449,-3,0,320,0,6
1,2540,2416,124,0,428,0,6
1,2395,2417,-22,0,110,0,6
1,2407,2258,149,0,461,0,6
1,2487,2526,-39,0,301,0,6
1,2587,2430,157,0,312,1,6
1,2404,2499,-95,0,123,0,6
1,2401,2354,47,0,380,0,6
1,2507,2340,167,0,106,1,6
1,2554,2392,162,0,357,0,6
1,2589,2362,227,0,487,0,6
1,2591,2436,155,0,111,0,6
1,2461,2336,125,0,102,0,6
1,2428,2308,120,0,106,0,6
1,2494,2389,105,0,57,0,6
1,2395,2598,-203,0,45,0,6
1,2538,2454,84,0,4,0,6
1,2543,2602,-59,0,45,1,6
1,2419,2278,141,0,353,1,6
1,2514,2504,10,0,345,0,6
1,2279,2706,-427,0,141,0,6
1,2435,2411,24,0,344,0,6
1,2488,2379,109,0,140,0,6
1,2547,2535,12,0,40,0,6
1,2500,2453,47,0,190,0,6
1,2449,2470,-21,0,20,1,6
1,2276,2422,-146,0,41,1,6
1,2485,2393,92,0,125,1,6
1,2432,2368,64,0,111,0,6
1,2389,2455,-66,0,106,0,6
1,2480,2311,169,0,8,0,6
1,2454,2445,9,0,1,0,6
1,2496,2401,95,0,335,0,6
1,2597,2442,155,0,47,0,6
1,2346,2461,-115,0,113,0,6
1,2498,2500,-2,0,148,0,6
1,2354,2400,-46,0,47,0,6
1,2691,2790,-99,0,278,1,6
1,2509,2428,81,0,115,0,6
1,2405,2224,181,0,365,1,6
1,2477,2364,113,0,490,0,6
1,2516,2320,196,0,45,0,6
1,2496,2364,132,0,45,0,6
1,2451,2363,88,0,102,0,6
1,2365,2433,-68,0,61,1,6
1,2474,2483,-9,0,350,0,6
1,2398,2461,-63,0,300,1,6
1,2592,2625,-33,0,57,0,6
1,2415,2293,122,0,337,1,6
1,2430,2443,-13,0,7,0,6
1,2459,2501,-42,0,250,0,6
1,2515,2552,-37,0,43,1,6
1,2540,2538,2,0,310,0,6
1,2424,2420,4,0,8,1,6
1,2431,2633,-202,0,405,0,6
1,2370,2423,-53,0,352,0,6
1,2266,2431,-165,0,409,0,8
1,2431,2383,48,0,115,0,6
1,2437,2256,181,0,176,0,6
1,2510,2298,212,0,278,0,6
1,2423,2540,-117,0,40,0,6
1,2442,2296,146,0,190,0,8
1,2526,2518,8,0,311,0,6
1,2673,2573,100,0,122,0,6
1,2456,2343,113,0,1,1,6
1,2439,2290,149,0,277,0,6
1,2331,2466,-135,0,463,1,6
1,2306,2460,-154,0,41,0,6
1,2430,2237,193,0,310,1,6
1,2516,2257,259,0,354,0,6
1,2468,2556,-88,0,303,0,6
1,2449,2463,-14,0,0,0,6
1,2586,2425,161,0,100,0,6
1,2604,2499,105,0,0,1,6
1,2500,2579,-79,0,120,1,6
1,2414,2403,11,0,253,0,6
1,2572,2468,104,0,403,0,6
1,2385,2549,-164,0,201,1,6
1,2522,2336,186,0,455,0,6
1,2515,2469,46,0,200,0,6
1,2215,2442,-227,0,241,0,6
1,2677,2343,334,0,4,0,6
1,2468,2622,-154,0,106,0,6
1,2524,2288,236,0,225,0,6
1,2411,2244,167,0,302,0,6
1,2428,2444,-16,0,147,0,6
1,2466,2292,174,4,21,0,11
1,2541,2398,143,0,106,0,6
1,2483,2503,-20,0,108,0,6
1,2407,2243,164,0,7,0,6
1,2468,2321,147,0,123,0,6
1,2205,2436,-231,0,128,1,6
1,2412,2301,111,0,110,0,6
1,2593,2554,39,0,267,0,6
1,2464,2421,43,0,201,0,6
1,2442,2415,27,0,278,0,6
1,2480,2244,236,0,300,0,5
1,2469,2325,144,0,40,0,6
1,2438,2462,-24,0,121,0,6
1,2473,2382,91,0,112,0,6
1,2466,2563,-97,0,206,0,6
1,2361,2412,-51,0,463,0,6
1,2531,2609,-78,0,236,0,8
1,2407,2372,35,0,455,0,6
1,2406,2315,91,0,303,0,6
1,2572,2507,65,0,380,0,6
1,2550,2520,30,0,258,1,6
1,2481,2474,7,0,400,0,6
1,2419,2313,106,0,200,0,6
1,2566,2740,-174,0,265,1,6
1,2491,2439,52,0,45,0,6
1,2461,2362,99,0,181,0,6
1,2459,2352,107,0,201,0,6
1,2707,2532,175,0,50,0,6
1,2565,2577,-12,0,58,0,6
1,2577,2412,165,0,206,0,6
1,2558,2451,107,0,112,0,6
1,2580,2497,83,0,295,0,6
1,2536,2509,27,0,132,0,6
1,2435,2216,219,0,144,0,8
1,2485,2698,-213,0,5,0,6
1,2430,2413,17,0,320,0,6
1,2226,2473,-247,0,45,1,6
1,2616,2714,-98,0,100,0,6
1,2457,2302,155,0,43,0,6
1,2490,2433,57,0,107,0,6
1,2514,2384,130,0,302,1,6
1,2450,2292,158,0,12,1,6
1,2284,2457,-173,0,242,0,6
1,2331,2433,-102,0,7,1,6
1,2444,2307,137,0,335,0,6
1,2429,2464,-35,0,184,0,6
1,2480,2299,181,0,120,0,6
1,2384,2461,-77,0,245,0,6
1,2583,2624,-41,0,352,0,6
1,2474,2377,97,0,43,1,6
1,2427,2442,-15,0,331,0,6
1,2458,2486,-28,0,409,0,6
1,2499,2317,182,0,222,1,6
1,2390,2411,-21,0,405,1,6
1,2384,2436,-52,0,4,1,6
1,2246,2435,-189,0,261,1,6
1,2363,2401,-38,0,46,0,6
1,2451,2285,166,0,40,0,8
1,2552,2482,70,0,100,0,6
1,2455,2367,88,0,455,0,6
1,2406,2357,49,0,4,0,6
1,2489,2353,136,0,40,0,6
1,2532,2428,104,0,456,0,6
1,2439,2317,122,0,40,1,6
1,2454,2324,130,0,14,1,6
1,2235,2495,-260,0,140,0,6
1,2417,2424,-7,0,453,0,6
1,2411,2288,123,0,103,0,6
1,2466,2273,193,0,48,1,8
1,2634,2693,-59,0,310,0,6
1,2537,2557,-20,0,45,0,6
1,2475,2476,-1,0,200,0,6
1,2420,2464,-44,0,484,0,6
1,2484,2329,155,0,57,0,6
1,2411,2321,90,0,331,0,6
1,2411,2342,69,0,385,0,6
1,2437,2443,-6,0,44,1,6
1,2293,2415,-122,0,260,0,6
1,2495,2635,-140,0,125,0,6
1,2451,2339,112,0,128,0,6
1,2380,2421,-41,0,80,0,6
1,2552,2525,27,0,103,0,6
1,2627,2562,65,0,270,0,6
1,2612,2437,175,0,43,1,6
1,2294,2422,-128,0,57,1,6
1,2262,2400,-138,4,330,1,13
1,2461,2492,-31,0,300,0,6
1,2539,2418,121,0,121,0,6
1,2366,2411,-45,0,140,0,6
1,2558,2484,74,0,394,1,6
1,2585,2499,86,0,30,0,6
1,2407,2242,165,0,107,1,6
1,2479,2205,274,0,140,0,6
1,2409,2470,-61,0,228,0,6
1,2437,2329,108,0,6,0,6
1,2453,2447,6,0,10,0,6
1,2216,2409,-193,0,202,0,6
1,2361,2449,-88,0,113,0,6
1,2446,2368,78,0,100,0,6
1,2400,2215,185,0,135,0,6
1,2375,2498,-123,0,45,0,6
1,2620,2503,117,0,300,0,6
1,2422,2400,22,0,170,0,6
1,2448,2242,206,0,300,0,6
1,2556,2560,-4,0,140,0,6
1,2446,2426,20,0,152,1,6
1,2450,2368,82,0,151,0,6
1,2442,2354,88,0,104,0,6
1,2632,2476,156,0,48,1,6
1,2509,2328,181,0,43,0,6
1,2626,2389,237,0,163,0,6
1,2528,2421,107,0,112,0,6
1,2503,2391,112,0,320,1,6
1,2666,2503,163,0,112,1,6
1,2598,2481,117,0,307,1,6
1,2385,2522,-137,0,231,0,6
1,2545,2234,311,0,314,0,6
1,2246,2407,-161,0,0,0,6
1,2439,2512,-73,0,8,1,6
1,2462,2397,65,0,118,0,6
1,2588,2585,3,0,241,0,6
1,2412,2526,-114,0,15,0,6
1,2614,2365,249,0,211,0,6
1,2276,2440,-164,0,253,0,6
1,2513,2339,174,0,250,0,6
1,2524,2562,-38,0,122,0,6
1,2493,2481,12,0,135,0,6
1,2315,2485,-170,0,200,0,6
1,2460,2432,28,0,202,0,6
1,2423,2424,-1,0,337,0,6
1,2627,2405,222,0,343,0,6
1,2557,2502,55,0,4,0,6
1,2457,2385,72,0,300,0,6
1,2422,2282,140,0,108,0,8
1,2493,2262,231,0,150,0,6
1,2438,2384,54,0,331,0,6
1,2557,2306,251,0,41,0,6
1,2534,2411,123,0,456,0,6
1,2422,2411,11,0,43,0,6
1,2412,2358,54,0,374,0,6
1,2425,2383,42,0,190,1,6
1,2318,2406,-88,0,132,0,6
1,2425,2404,21,0,106,0,6
1,2462,2312,150,0,58,0,6
1,2459,2426,33,0,263,0,5
1,2529,2404,125,0,218,0,6
1,2415,2405,10,0,113,0,6
1,2407,2417,-10,0,58,0,6
1,2459,2444,15,0,247,0,6
1,2767,2521,246,0,385,0,6
1,2559,2274,285,0,115,0,6
1,2421,2450,-29,0,49,0,6
1,2543,2285,258,0,45,1,8
1,2451,2488,-37,4,236,0,13
1,2534,2528,6,0,200,1,6
1,2493,2374,119,0,42,0,6
1,2433,2410,23,0,331,1,6
1,2448,2341,107,0,121,0,6
1,2466,2439,27,0,112,0,6
1,2598,2560,38,0,125,1,6
1,2496,2589,-93,0,253,0,6
1,2383,2551,-168,0,302,0,6
1,2486,2450,36,0,43,1,6
1,2461,2480,-19,0,112,0,6
1,2463,2388,75,0,315,1,6
1,2483,2321,162,0,302,0,6
1,2447,2469,-22,0,456,0,6
1,2535,2400,135,0,203,0,6
1,2474,2367,107,0,0,0,6
1,2430,2385,45,0,244,0,6
1,2615,2656,-41,0,45,0,6
1,2362,2468,-106,0,338,0,6
1,2422,2513,-91,0,331,0,6
1,2492,2490,2,0,405,1,6
1,2403,2497,-94,0,461,1,6
1,2464,2372,92,0,426,0,6
1,2440,2458,-18,0,394,0,6
1,2419,2413,6,0,405,1,6
1,2488,2349,139,0,190,0,6
1,2209,2418,-209,0,415,1,6
1,2473,2263,210,4,302,0,13
1,2318,2539,-221,0,0,1,6
1,2401,2278,123,0,15,0,8
1,2324,2422,-98,0,316,0,6
1,2522,2430,92,0,3,0,6
1,2472,2360,112,0,241,0,6
1,2415,2444,-29,0,53,1,6
1,2415,2416,-1,0,138,1,6
1,2556,2514,42,0,125,0,6
1,2406,2251,155,0,17,0,6
1,2381,2463,-82,0,43,0,5
1,2430,2331,99,0,198,0,6
1,2421,2365,56,0,146,0,6
1,2469,2443,26,0,202,0,6
1,2383,2402,-19,0,106,0,6
1,2538,2221,317,0,41,1,6
1,2435,2373,62,0,201,0,6
1,2401,2358,43,0,310,0,6
1,2435,2430,5,0,100,1,6
1,2445,2539,-94,0,265,0,6
1,2328,2485,-157,0,365,0,6
1,2438,2523,-85,0,128,1,6
1,2358,2414,-56,0,200,0,6
1,2686,2598,88,0,312,0,6
1,2426,2371,55,0,412,0,6
1,2224,2404,-180,0,121,0,6
1,2501,2605,-104,0,310,0,6
1,2445,2349,96,0,4,1,6
1,2487,2231,256,0,45,0,6
1,2417,2332,85,0,1,0,6
1,2273,2431,-158,0,302,1,6
1,2435,2462,-27,0,41,0,6
1,2357,2441,-84,0,343,0,6
1,2667,2570,97,0,5,1,6
1,2414,2465,-51,0,300,1,6
1,2492,2391,101,0,200,0,6
1,2471,2348,123,0,41,0,6
1,2435,2445,-10,0,107,0,6
1,2430,2365,65,0,110,0,6
1,2358,2453,-95,0,107,0,6
1,2559,2640,-81,0,269,0,6
1,2569,2376,193,0,153,0,6
1,2543,2388,155,0,220,1,6
1,2497,2283,214,0,48,0,6
1,2305,2403,-98,0,41,0,6
1,2549,2424,125,0,213,0,6
1,2516,2424,92,0,107,0,6
1,2513,2577,-64,0,46,0,6
1,2391,2453,-62,0,300,1,6
1,2452,2422,30,0,57,0,6
1,2631,2590,41,0,153,0,6
1,2418,2485,-67,0,302,0,6
1,2425,2490,-65,0,118,0,6
1,2440,2420,20,0,40,0,6
1,2301,2414,-113,0,414,0,6
1,2519,2498,21,0,302,0,6
1,2508,2511,-3,0,113,1,6
1,2422,2276,146,0,4,0,6
1,2469,2436,33,0,47,1,6
1,2411,2455,-44,0,101,0,6
1,2488,2429,59,0,301,0,6
1,2327,2406,-79,0,41,0,6
1,2263,2538,-275,0,123,0,6
1,2522,2437,85,0,337,0,6
1,2508,2279,229,0,405,0,6
1,2425,2408,17,0,321,0,6
1,2415,2266,149,0,51,0,6
1,2399,2525,-126,0,43,0,6
1,2448,2401,47,0,112,1,6
1,2639,2544,95,0,315,0,6
1,2458,2282,176,0,131,0,8
1,2465,2302,163,0,107,0,6
1,2502,2522,-20,0,45,0,6
1,2330,2517,-187,0,117,0,6
1,2482,2477,5,0,106,1,6
1,2553,2415,138,0,331,0,6
1,2218,2486,-268,0,324,0,6
1,2646,2674,-28,0,380,1,6
1,2403,2324,79,0,147,0,6
1,2561,2439,122,0,100,1,6
1,2502,2339,163,0,241,1,6
1,2482,2310,172,0,101,1,6
1,2400,2298,102,0,300,0,6
1,2460,2363,97,0,45,0,6
1,2527,2451,76,0,151,1,6
1,2220,2418,-198,0,300,1,6
1,2335,2427,-92,0,330,1,6
1,2205,2415,-210,0,100,1,6
1,2515,2455,60,0,241,0,6
1,2444,2409,35,0,311,0,6
1,2521,2418,103,0,330,1,6
1,2419,2427,-8,0,112,0,6
1,2496,2473,23,0,45,0,6
1,2387,2446,-59,0,122,1,6
1,2419,2254,165,0,0,0,6
1,2522,2503,19,0,13,0,6
1,2453,2531,-78,0,118,0,6
1,2627,2516,111,0,241,1,6
1,2389,2479,-90,0,308,0,6
1,2429,2450,-21,0,112,0,6
1,2401,2278,123,0,0,0,6
1,2487,2300,187,0,110,0,6
1,2496,2297,199,0,123,0,6
1,2544,2414,130,0,133,0,6
1,2497,2532,-35,0,380,1,6
1,2436,2412,24,0,455,0,6
1,2465,2406,59,0,217,1,6
1,2441,2282,159,0,40,0,6
1,2457,2382,75,0,152,0,6
1,2481,2502,-21,0,405,0,6
1,2431,2287,144,4,250,0,13
1,2424,2276,148,0,45,0,6
1,2361,2461,-100,0,1,0,6
1,2412,2456,-44,0,112,1,8
1,2232,2449,-217,0,45,1,6
1,2439,2361,78,0,456,1,6
1,2512,2232,280,0,201,0,6
1,2546,2400,146,0,140,0,6
1,2512,2410,102,0,0,0,6
1,2471,2467,4,0,136,0,6
1,2410,2274,136,0,404,0,6
1,2364,2490,-126,0,142,1,6
1,2693,2559,134,0,161,0,6
1,2446,2406,40,0,370,0,6
1,2454,2425,29,0,210,0,6
1,2462,2490,-28,0,46,0,6
1,2442,2311,131,0,43,1,6
1,2598,2633,-35,0,125,0,6
1,2389,2404,-15,0,101,1,6
1,2409,2283,126,0,148,1,6
1,2475,2443,32,0,45,1,6
1,2440,2285,155,0,315,0,6
1,2390,2486,-96,0,101,1,6
1,2459,2324,135,0,41,0,6
1,2397,2511,-114,0,132,0,6
1,2545,2556,-11,0,125,0,6
1,2442,2402,40,0,415,0,6
1,2429,2283,146,0,41,0,6
1,2596,2389,207,0,412,0,6
1,2683,2623,60,0,13,0,6
1,2574,2559,15,0,255,1,6
1,2328,2407,-79,0,100,1,6
1,2429,2308,121,0,110,1,6
1,2440,2371,69,0,311,0,6
1,2538,2511,27,0,233,0,6
1,2330,2448,-118,0,50,1,6
1,2506,2380,126,0,473,1,6
1,2542,2357,185,0,108,0,5
1,2411,2396,15,0,146,0,8
1,2387,2440,-53,0,101,0,6
1,2339,2416,-77,0,102,0,6
1,2347,2414,-67,0,42,1,6
1,2490,2404,86,0,132,1,6
1,2254,2413,-159,0,400,0,6
1,2326,2435,-109,0,144,1,6
1,2398,2453,-55,0,11,0,6
1,2545,2484,61,0,45,1,6
1,2560,2625,-65,0,247,0,6
1,2467,2331,136,0,117,0,6
1,2740,2742,-2,0,233,0,6
1,2445,2340,105,0,106,0,6
1,2400,2370,30,0,145,0,6
1,2433,2561,-128,0,302,0,6
1,2446,2448,-2,0,45,0,6
1,2455,2374,81,0,202,0,6
1,2225,2429,-204,0,131,0,6
1,2600,2435,165,0,373,0,6
1,2509,2454,55,0,365,0,8
1,2474,2341,133,0,288,0,6
1,2321,2468,-147,0,84,0,6
1,2417,2526,-109,0,101,1,6
1,2424,2323,101,0,120,0,8
1,2585,2398,187,0,277,0,6
1,2476,2413,63,4,40,0,13
1,2407,2407,0,0,123,0,6
1,2462,2378,84,0,10,0,6
1,2441,2425,16,0,37,0,6
1,2350,2454,-104,0,375,0,8
1,2507,2454,53,0,440,0,6
1,2291,2468,-177,0,302,0,6
1,2455,2452,3,0,245,0,6
1,2608,2496,112,0,43,1,6
1,2478,2385,93,0,301,1,6
1,2218,2588,-370,0,310,0,6
1,2284,2464,-180,0,1,0,6
1,2547,2490,57,0,106,0,6
1,2687,2644,43,0,107,1,6
1,2570,2661,-91,0,386,0,6
1,2533,2592,-59,0,80,1,6
1,2524,2625,-101,0,56,0,6
1,2606,2242,364,0,4,0,6
1,2523,2349,174,0,133,0,6
1,2481,2506,-25,0,201,0,6
1,2409,2254,155,0,242,0,6
1,2438,2336,102,0,455,0,6
1,2532,2468,64,0,120,0,6
1,2436,2375,61,0,18,0,6
1,2405,2355,50,0,331,0,6
1,2623,2433,190,0,387,0,6
1,2470,2470,0,0,9,1,6
1,2413,2352,61,0,6,1,6
1,2518,2397,121,0,110,0,6
1,2443,2397,46,0,277,1,6
1,2556,2525,31,0,172,0,6
1,2587,2542,45,0,463,0,6
1,2499,2336,163,0,41,0,6
1,2652,2429,223,0,23,0,6
1,2416,2347,69,0,106,0,6
1,2496,2432,64,0,203,0,6
1,2561,2306,255,0,7,0,6
1,2283,2406,-123,0,190,0,6
1,2411,2342,69,0,0,0,6
1,2566,2538,28,0,157,1,6
1,2514,2501,13,0,112,0,6
1,2392,2419,-27,0,10,0,6
1,2427,2326,101,0,312,0,6
1,2521,2326,195,0,61,1,6
1,2496,2375,121,0,110,0,6
1,2424,2506,-82,0,241,0,6
1,2541,2612,-71,0,305,0,6
1,2445,2274,171,0,211,0,6
1,2420,2507,-87,0,315,0,6
1,2515,2458,57,0,300,0,6
1,2393,2431,-38,0,302,0,6
1,2494,2368,126,0,22,0,6
1,2403,2258,145,0,331,1,6
1,2439,2495,-56,0,40,0,6
1,2294,2414,-120,0,47,0,6
1,2418,2502,-84,0,12,0,6
1,2327,2407,-80,0,127,0,6
1,2248,2569,-321,0,172,0,6
1,2379,2434,-55,0,57,1,6
1,2442,2535,-93,0,242,0,6
1,2512,2500,12,0,302,1,6
1,2473,2334,139,0,224,0,6
1,2463,2480,-17,0,120,0,6
1,2431,2203,228,0,483,0,6
1,2440,2500,-60,0,50,1,6
1,2395,2448,-53,0,122,0,6
1,2403,2371,32,0,151,0,6
1,2409,2346,63,0,458,0,6
1,2498,2341,157,0,202,0,6
1,2453,2351,102,0,123,0,6
1,2375,2423,-48,0,199,0,6
1,2547,2421,126,0,8,0,6
1,2467,2373,94,0,40,0,6
1,2612,2427,185,0,190,0,6
1,2350,2577,-227,0,43,0,6
1,2444,2521,-77,0,190,0,6
1,2426,2533,-107,0,4,1,6
1,2361,2405,-44,0,101,0,6
1,2343,2424,-81,0,40,0,6
1,2454,2389,65,0,103,0,6
1,2493,2442,51,0,296,0,6
1,2508,2558,-50,0,103,1,6
1,2476,2562,-86,0,228,0,6
1,2232,2420,-188,0,337,1,6
1,2500,2229,271,0,201,0,6
1,2505,2506,-1,0,45,0,6
1,2436,2375,61,0,84,1,6
1,2324,2403,-79,0,56,1,6
1,2437,2334,103,0,46,0,6
1,2453,2494,-41,0,140,0,6
1,2471,2460,11,0,7,0,6
1,2406,2292,114,0,0,1,6
1,2409,2301,108,0,80,0,6
1,2411,2372,39,0,210,0,6
1,2399,2431,-32,0,241,1,6
1,2551,2431,120,0,202,1,6
1,2441,2413,28,0,200,1,8
1,2458,2520,-62,0,203,0,6
1,2318,2429,-111,0,212,0,6
1,2564,2409,155,0,415,0,6
1,2300,2442,-142,0,10,1,6
1,2413,2260,153,0,138,0,6
1,2366,2431,-65,0,57,0,6
1,2547,2609,-62,0,130,0,6
1,2621,2606,15,0,127,0,6
1,2386,2422,-36,0,176,1,6
1,2411,2252,159,0,180,0,6
1,2501,2440,61,0,200,1,6
1,2405,2359,46,0,123,1,6
1,2417,2339,78,0,110,0,6
1,2676,2401,275,0,42,1,6
1,2421,2417,4,0,394,0,6
1,2368,2427,-59,0,1,0,6
1,2476,2273,203,0,100,0,6
1,2405,2264,141,0,310,0,6
1,2436,2248,188,0,120,1,6
1,2478,2469,9,0,0,0,6
1,2497,2377,120,0,352,1,6
1,2518,2532,-14,0,292,1,6
1,2462,2355,107,0,70,0,6
1,2405,2269,136,0,112,0,6
1,2491,2482,9,0,490,0,6
1,2492,2445,47,0,205,1,6
1,2513,2300,213,0,8,0,6
1,2427,2397,30,0,152,0,6
1,2393,2421,-28,0,13,1,6
1,2466,2367,99,0,300,1,6
1,2302,2411,-109,0,338,0,6
1,2408,2483,-75,0,143,0,6
1,2459,2298,161,0,141,0,6
1,2370,2462,-92,0,103,0,6
1,2525,2411,114,0,40,0,6
1,2433,2363,70,0,190,0,6
1,2650,2639,11,0,280,0,6
1,2242,2433,-191,0,4,1,6
1,2488,2491,-3,0,300,1,6
1,2518,2443,75,0,135,0,6
1,2422,2428,-6,0,310,1,6
1,2432,2446,-14,0,10,1,6
1,2421,2275,146,0,107,0,6
1,2547,2571,-24,0,460,1,6
1,2436,2456,-20,0,210,0,6
1,2421,2449,-28,0,245,0,6
1,2412,2400,12,0,5,0,6
1,2419,2263,156,0,335,0,6
1,2407,2227,180,0,121,0,6
1,2467,2501,-34,0,6,0,6
1,2509,2359,150,0,40,0,6
1,2307,2535,-228,0,110,0,6
1,2501,2478,23,0,115,0,6
1,2378,2411,-33,0,4,0,6
1,2443,2360,83,0,115,0,6
1,2435,2343,92,0,190,0,6
1,2603,2608,-5,0,58,0,6
1,2452,2411,41,0,409,0,6
1,2352,2437,-85,0,46,1,6
1,2547,2362,185,0,250,0,6
1,2386,2475,-89,0,250,1,6
1,2494,2491,3,0,190,0,6
1,2469,2488,-19,4,129,1,13
1,2554,2339,215,0,100,0,6
1,2467,2385,82,0,398,0,6
1,2423,2478,-55,0,306,0,6
1,2586,2542,44,0,132,0,6
1,2699,2611,88,0,111,0,6
1,2541,2346,195,0,141,0,6
1,2545,2395,150,0,80,0,6
1,2474,2484,-10,0,200,0,6
1,2274,2422,-148,0,405,0,6
1,2294,2474,-180,0,121,1,6
1,2395,2400,-5,0,0,0,6
1,2509,2387,122,0,1,1,6
1,2529,2439,90,0,301,0,6
1,2477,2331,146,0,106,0,8
1,2344,2478,-134,0,128,0,6
1,2498,2256,242,0,45,1,6
1,2560,2523,37,0,15,0,6
1,2440,2360,80,0,100,0,6
1,2401,2472,-71,0,474,0,6
1,2402,2408,-6,0,234,0,6
1,2703,2699,4,0,104,0,6
1,2317,2418,-101,0,36,1,6
1,2534,2444,90,0,336,0,6
1,2400,2309,91,0,301,1,6
1,2451,2405,46,0,320,1,6
1,2469,2252,217,0,341,0,5
1,2431,2403,28,0,136,0,6
2,2391,2488,-97,0,241,0,6
2,2399,2635,-236,0,112,0,6
2,2397,2496,-99,0,106,0,6
2,2325,2519,-194,0,302,0,6
2,2436,2367,69,0,45,0,6
2,2440,2348,92,0,118,0,6
2,2400,2397,3,0,189,0,6
2,2251,2416,-165,0,40,0,6
2,2355,2412,-57,0,16,0,6
2,2508,2596,-88,0,333,0,6
2,2494,2427,67,0,37,0,6
2,2628,2486,142,0,100,0,6
2,2470,2555,-85,0,124,1,6
2,2557,2449,108,0,40,0,6
2,2290,2476,-186,0,120,0,6
2,2442,2478,-36,0,90,0,6
2,2361,2463,-102,0,107,1,6
2,2569,2477,92,0,13,0,6
2,2277,2421,-144,0,307,1,6
2,2518,2614,-96,0,35,1,6
2,2375,2492,-117,0,112,0,6
2,2426,2385,41,0,385,0,6
2,2496,2388,108,0,311,0,6
2,2472,2581,-109,0,242,0,6
2,2572,2588,-16,0,454,0,6
2,2417,2203,214,4,110,0,13
2,2231,2422,-191,0,453,0,6
2,2470,2408,62,0,200,0,6
2,2296,2414,-118,4,279,0,13
2,2456,2398,58,0,163,0,6
2,2441,2454,-13,0,260,0,6
2,2381,2463,-82,0,224,0,6
2,2380,2555,-175,0,202,0,8
2,2542,2574,-32,0,101,0,6
2,2424,2388,36,0,43,0,6
2,2345,2444,-99,0,115,1,6
2,2330,2518,-188,0,335,0,6
2,2302,2469,-167,0,200,1,6
2,2403,2540,-137,0,13,1,6
2,2433,2566,-133,0,300,0,6
2,2356,2676,-320,0,200,0,6
2,2406,2482,-76,0,100,0,6
2,2501,2511,-10,0,49,0,6
2,2430,2379,51,0,100,0,6
2,2283,2423,-140,0,405,1,6
2,2530,2475,55,0,236,0,6
2,2536,2516,20,0,106,1,6
2,2473,2439,34,0,50,0,6
2,2274,2420,-146,0,405,0,6
2,2670,2693,-23,0,302,0,6
2,2427,2275,152,0,300,0,8
2,2329,2493,-164,0,45,0,6
2,2451,2328,123,0,88,0,6
2,2510,2576,-66,0,464,0,6
2,2285,2424,-139,0,46,1,6
2,2606,2585,21,0,150,0,6
2,2358,2410,-52,0,45,0,6
2,2443,2378,65,0,278,0,6
2,2296,2633,-337,0,414,0,6
2,2419,2392,27,0,81,0,6
2,2340,2438,-98,0,346,0,6
2,2431,2565,-134,0,112,0,6
2,2449,2283,166,0,469,0,8
2,2515,2493,22,0,80,0,6
2,2402,2285,117,0,133,0,6
2,2384,2484,-100,0,300,0,6
2,2511,2276,235,0,45,0,6
2,2527,2368,159,0,455,0,6
2,2372,2400,-28,0,122,0,6
2,2387,2505,-118,0,40,0,6
2,2434,2395,39,0,80,0,6
2,2244,2459,-215,4,311,0,13
2,2466,2317,149,0,45,0,6
2,2354,2450,-96,0,45,0,6
2,2408,2335,73,0,107,0,6
2,2563,2445,118,0,106,1,6
2,2424,2393,31,0,7,1,6
2,2330,2466,-136,0,136,1,6
2,2346,2407,-61,0,38,0,6
2,2644,2345,299,0,205,0,6
2,2486,2418,68,0,15,1,6
2,2402,2303,99,0,41,0,6
2,2282,2455,-173,0,45,0,6
2,2479,2495,-16,0,342,0,6
2,2326,2433,-107,0,152,0,6
2,2478,2336,142,0,140,1,6
2,2213,2483,-270,0,14,0,6
2,2615,2479,136,0,58,0,6
2,2415,2411,4,0,112,0,6
2,2558,2418,140,0,207,0,6
2,2265,2630,-365,0,200,0,6
2,2408,2521,-113,0,40,0,6
2,2404,2423,-19,0,113,0,6
2,2624,2607,17,0,150,0,6
2,2394,2625,-231,0,10,0,6
2,2404,2392,12,0,181,0,6
2,2239,2404,-165,0,43,0,6
2,2359,2417,-58,0,0,1,6
2,2475,2491,-16,0,103,0,6
2,2657,2486,171,0,103,0,6
2,2254,2416,-162,0,41,0,6
2,2406,2411,-5,0,100,1,6
2,2491,2392,99,0,123,0,6
2,2366,2607,-241,0,401,0,6
2,2546,2457,89,0,205,0,6
2,2437,2428,9,0,331,0,6
2,2337,2475,-138,0,145,0,6
2,2509,2429,80,0,141,0,6
2,2437,2657,-220,0,1,0,6
2,2452,2458,-6,0,190,0,6
2,2622,2477,145,0,120,0,6
2,2545,2528,17,0,101,0,6
2,2470,2388,82,0,466,0,6
2,2298,2410,-112,0,304,0,6
2,2304,2422,-118,0,1,0,6
2,2484,2434,50,0,45,0,6
2,2467,2446,21,0,414,0,6
2,2444,2523,-79,0,300,1,6
2,2445,2500,-55,0,300,0,6
2,2425,2430,-5,0,140,0,6
2,2417,2409,8,0,110,0,6
2,2411,2338,73,0,41,1,6
2,2273,2428,-155,0,469,0,6
2,2539,2274,265,0,40,0,6
2,2366,2412,-46,0,138,0,6
2,2487,2370,117,0,345,0,6
2,2403,2291,112,0,158,1,6
2,2417,2355,62,0,381,0,6
2,2370,2428,-58,0,40,0,6
2,2494,2526,-32,0,46,0,6
2,2444,2439,5,4,13,1,13
2,2275,2407,-132,4,192,0,13
2,2559,2738,-179,0,120,0,6
2,2279,2410,-131,0,48,1,6
2,2334,2601,-267,0,310,0,8
2,2232,2418,-186,4,173,0,13
2,2344,2430,-86,0,8,0,6
2,2425,2563,-138,0,101,0,6
2,2443,2339,104,0,426,0,6
2,2459,2526,-67,0,88,0,6
2,2468,2498,-30,0,215,1,6
2,2617,2569,48,0,40,0,6
2,2832,2814,18,0,462,0,6
2,2430,2551,-121,0,7,0,6
2,2237,2420,-183,4,247,0,13
2,2698,2604,94,0,0,0,6
2,2384,2472,-88,0,127,1,6
2,2442,2287,155,0,424,0,6
2,2485,2485,0,0,45,0,6
2,2382,2461,-79,0,122,1,8
2,2302,2481,-179,0,2,0,6
2,2257,2518,-261,0,381,0,6
2,2469,2561,-92,0,152,0,6
2,2373,2430,-57,0,122,1,6
2,2454,2462,-8,0,13,1,6
2,2338,2498,-160,0,453,0,6
2,2341,2505,-164,0,46,0,6
2,2301,2427,-126,4,25,0,13
2,2405,2382,23,0,201,1,6
2,2282,2612,-330,0,30,0,6
2,2437,2466,-29,0,230,0,6
2,2412,2429,-17,0,43,1,6
2,2408,2402,6,0,310,0,6
2,2686,2665,21,0,110,0,6
2,2438,2424,14,0,190,1,6
2,2491,2330,161,0,13,0,6
2,2239,2558,-319,0,106,0,6
2,2508,2558,-50,0,34,0,6
2,2311,2468,-157,0,278,0,6
2,2459,2450,9,0,410,1,6
2,2475,2537,-62,0,120,0,6
2,2457,2411,46,0,343,0,6
2,2308,2596,-288,0,153,0,7
2,2459,2249,210,0,150,0,6
2,2522,2493,29,0,56,0,6
2,2442,2460,-18,0,130,0,6
2,2232,2448,-216,0,127,1,6
2,2203,2492,-289,0,40,0,6
2,2461,2280,181,0,302,0,6
2,2231,2439,-208,0,47,0,6
2,2414,2459,-45,0,9,0,6
2,2340,2424,-84,0,40,0,6
2,2463,2448,15,0,132,0,6
2,2293,2437,-144,0,40,0,6
2,2503,2477,26,2,319,0,30
2,2561,2530,31,0,180,0,6
2,2570,2563,7,0,10,0,6
2,2433,2411,22,0,150,0,6
2,2437,2431,6,0,455,0,6
2,2458,2545,-87,0,30,1,6
2,2210,2435,-225,0,257,0,6
2,2420,2459,-39,0,297,0,6
2,2325,2518,-193,0,131,0,6
2,2549,2398,151,0,45,0,6
2,2513,2542,-29,0,310,1,6
2,2383,2409,-26,0,152,0,6
2,2425,2408,17,0,200,0,6
2,2467,2596,-129,0,300,0,6
2,2406,2380,26,0,31,0,6
2,2414,2385,29,0,102,0,6
2,2441,2491,-50,0,46,1,6
2,2298,2423,-125,0,310,0,8
2,2312,2401,-89,0,140,0,6
2,2231,2475,-244,0,302,0,6
2,2439,2520,-81,0,44,0,6
2,2309,2428,-119,0,242,1,6
2,2554,2555,-1,0,211,0,6
2,2333,2428,-95,0,335,0,6
2,2467,2370,97,0,1,1,6
2,2638,2706,-68,0,40,0,6
2,2564,2454,110,0,490,0,6
2,2395,2444,-49,0,102,0,6
2,2405,2607,-202,0,106,0,6
2,2272,2415,-143,0,17,0,6
2,2436,2458,-22,0,211,1,6
2,2375,2559,-184,0,302,0,6
2,2447,2464,-17,0,250,0,6
2,2425,2277,148,0,46,0,6
2,2422,2361,61,0,45,1,6
2,2528,2764,-236,0,302,0,6
2,2225,2476,-251,0,258,0,6
2,2434,2334,100,0,190,0,6
2,2508,2458,50,0,43,0,6
2,2402,2404,-2,0,337,0,6
2,2354,2524,-170,0,40,0,6
2,2495,2706,-211,0,122,0,6
2,2247,2418,-171,0,226,0,6
2,2405,2532,-127,0,118,0,6
2,2509,2397,112,0,107,0,6
2,2376,2435,-59,0,255,0,6
2,2243,2445,-202,4,42,0,13
2,2351,2435,-84,0,386,0,6
2,2409,2308,101,0,103,0,6
2,2732,2707,25,0,20,0,6
2,2506,2599,-93,0,243,0,6
2,2602,2456,146,0,244,1,6
2,2368,2503,-135,0,320,0,6
2,2359,2478,-119,0,40,0,6
2,2554,2566,-12,0,300,0,6
2,2602,2546,56,0,201,1,6
2,2496,2282,214,0,200,0,5
2,2406,2289,117,0,249,1,6
2,2322,2476,-154,0,200,0,6
2,2480,2323,157,0,122,0,6
2,2450,2623,-173,0,100,0,6
2,2330,2452,-122,0,1,0,6
2,2360,2445,-85,0,107,0,6
2,2410,2526,-116,0,301,0,6
2,2564,2598,-34,0,266,1,6
2,2540,2626,-86,0,324,0,6
2,2410,2393,17,0,89,1,6
2,2242,2410,-168,0,459,1,8
2,2252,2409,-157,4,194,0,13
2,2330,2439,-109,0,113,0,6
2,2511,2593,-82,0,9,0,6
2,2460,2374,86,0,485,1,6
2,2464,2460,4,0,241,0,6
2,2476,2476,0,0,90,0,6
2,2410,2348,62,0,463,0,6
2,2514,2683,-169,0,6,0,6
2,2419,2326,93,0,210,0,6
2,2422,2452,-30,0,4,0,6
2,2404,2416,-12,0,21,1,6
2,2328,2425,-97,0,40,0,6
2,2413,2524,-111,0,138,0,6
2,2395,2417,-22,0,216,1,6
2,2473,2329,144,0,80,0,6
2,2416,2472,-56,0,20,0,6
2,2454,2557,-103,0,225,0,6
2,2445,2494,-49,0,244,0,8
2,2307,2510,-203,0,40,0,6
2,2445,2505,-60,0,46,0,6
2,2521,2381,140,0,301,1,6
2,2585,2521,64,0,400,0,6
2,2211,2413,-202,0,102,0,6
2,2562,2581,-19,0,241,0,6
2,2502,2479,23,0,45,0,6
2,2456,2462,-6,0,190,0,6
2,2521,2524,-3,0,106,0,6
2,2458,2510,-52,0,405,1,6
2,2299,2440,-141,0,300,1,6
2,2501,2621,-120,0,45,1,6
2,2669,2698,-29,0,113,1,6
2,2400,2312,88,0,106,0,6
2,2343,2499,-156,0,107,1,6
2,2524,2490,34,0,302,0,6
2,2440,2361,79,0,13,1,6
2,2421,2411,10,0,454,0,6
2,2423,2372,51,0,335,0,6
2,2321,2516,-195,0,36,0,6
2,2471,2453,18,0,260,0,6
2,2430,2268,162,0,484,0,6
2,2462,2353,109,0,248,1,8
2,2238,2645,-407,0,454,0,6
2,2410,2391,19,0,357,0,6
2,2253,2452,-199,4,133,0,13
2,2396,2403,-7,0,257,0,6
2,2257,2409,-152,0,16,0,8
2,2407,2569,-162,0,202,0,6
2,2273,2594,-321,0,135,0,6
2,2293,2403,-110,0,202,0,6
2,2507,2606,-99,0,316,0,6
2,2329,2460,-131,0,46,0,8
2,2554,2678,-124,0,335,1,6
2,2466,2509,-43,0,102,0,6
2,2333,2493,-160,0,107,1,6
2,2337,2500,-163,0,1,0,6
2,2446,2522,-76,0,131,0,6
2,2253,2516,-263,0,37,0,6
2,2318,2407,-89,0,212,0,6
2,2286,2561,-275,0,378,0,6
2,2419,2510,-91,0,110,1,6
2,2427,2421,6,0,121,1,6
2,2523,2541,-18,0,6,0,6
2,2555,2535,20,0,317,0,6
2,2278,2430,-152,0,487,0,6
2,2440,2409,31,0,344,0,6
2,2259,2500,-241,0,40,0,6
2,2424,2374,50,0,250,0,6
2,2710,2729,-19,0,337,0,6
2,2465,2536,-71,0,46,0,6
2,2493,2560,-67,0,101,1,6
2,2288,2447,-159,0,152,0,6
2,2553,2678,-125,0,4,0,6
2,2366,2505,-139,0,110,1,6
2,2538,2473,65,0,122,0,6
2,2449,2647,-198,0,112,0,6
2,2676,2511,165,0,404,0,6
2,2437,2360,77,0,265,0,6
2,2358,2487,-129,0,441,0,6
2,2364,2452,-88,4,103,0,13
2,2328,2423,-95,0,57,0,6
2,2425,2272,153,0,46,1,6
2,2401,2335,66,0,36,0,6
2,2398,2514,-116,0,4,0,6
2,2416,2607,-191,0,151,0,6
2,2201,2625,-424,0,200,0,6
2,2403,2440,-37,0,138,0,6
2,2324,2409,-85,0,463,0,6
2,2366,2501,-135,0,101,0,6
2,2575,2376,199,0,244,1,6
2,2277,2426,-149,0,162,1,6
2,2543,2599,-56,0,110,1,6
2,2431,2532,-101,0,301,1,6
2,2358,2423,-65,0,245,1,6
2,2454,2310,144,0,57,0,6
2,2342,2510,-168,0,101,0,6
2,2402,2426,-24,0,337,0,6
2,2228,2402,-174,0,121,0,6
2,2308,2423,-115,0,44,0,6
2,2426,2433,-7,0,15,1,6
2,2281,2463,-182,0,317,1,6
2,2556,2649,-93,0,228,0,6
2,2434,2383,51,0,4,1,6
2,2216,2402,-186,0,45,0,6
2,2546,2562,-16,0,112,0,6
2,2359,2405,-46,0,310,0,6
2,2408,2246,162,0,302,0,8
2,2316,2429,-113,0,45,1,6
2,2383,2503,-120,0,211,0,6
2,2312,2438,-126,0,48,1,6
2,2400,2500,-100,0,440,0,6
2,2264,2512,-248,0,46,0,6
2,2514,2498,16,0,0,1,6
2,2273,2406,-133,0,0,0,6
2,2451,2391,60,0,335,0,6
2,2440,2425,15,0,45,0,6
2,2378,2462,-84,0,54,0,6
2,2556,2439,117,0,43,1,6
2,2401,2489,-88,0,302,1,6
2,2413,2354,59,0,302,0,6
2,2255,2414,-159,0,127,0,6
2,2266,2485,-219,0,278,0,6
2,2456,2322,134,0,487,0,6
2,2414,2535,-121,0,46,0,6
2,2486,2318,168,0,127,0,6
2,2547,2534,13,0,4,1,6
2,2242,2524,-282,0,8,0,6
2,2300,2408,-108,0,311,0,6
2,2493,2320,173,0,485,0,6
2,2586,2638,-52,0,101,0,6
2,2469,2430,39,0,208,1,6
2,2361,2522,-161,0,278,0,8
2,2325,2425,-100,0,46,0,6
2,2414,2560,-146,0,46,0,6
2,2413,2244,169,0,57,0,6
2,2474,2515,-41,0,41,0,6
2,2629,2670,-41,0,45,0,6
2,2550,2646,-96,0,486,0,6
2,2443,2363,80,0,300,1,6
2,2493,2500,-7,0,43,0,6
2,2448,2498,-50,0,207,1,6
2,2373,2680,-307,0,106,0,6
2,2417,2412,5,0,247,0,6
2,2644,2520,124,0,65,1,6
2,2409,2370,39,0,112,1,6
2,2298,2575,-277,0,113,0,6
2,2681,2455,226,0,41,0,6
2,2427,2444,-17,0,300,0,6
2,2452,2409,43,0,300,0,6
2,2341,2437,-96,0,147,0,6
2,2410,2470,-60,0,140,0,6
2,2381,2462,-81,0,18,0,6
2,2485,2341,144,0,138,1,6
2,2240,2403,-163,0,132,0,6
2,2323,2441,-118,0,260,0,6
2,2307,2444,-137,0,200,0,6
2,2505,2491,14,0,260,1,6
2,2581,2514,67,0,28,0,6
2,2308,2536,-228,0,102,1,6
2,2413,2359,54,0,118,1,6
2,2400,2479,-79,0,133,1,6
2,2542,2556,-14,0,151,0,6
2,2510,2388,122,0,36,0,6
2,2440,2580,-140,0,301,0,6
2,2606,2645,-39,0,9,0,6
2,2462,2448,14,0,411,0,6
2,2418,2362,56,0,46,0,6
2,2379,2554,-175,0,5,0,6
2,2319,2424,-105,0,56,1,6
2,2512,2341,171,0,207,0,6
2,2292,2403,-111,0,380,0,6
2,2559,2554,5,0,213,0,6
2,2370,2546,-176,0,195,0,6
2,2447,2558,-111,0,107,0,6
2,2460,2578,-118,0,43,0,6
2,2228,2401,-173,0,40,1,6
2,2319,2476,-157,0,464,0,6
2,2600,2425,175,0,45,0,6
2,2403,2441,-38,0,200,0,6
2,2276,2557,-281,0,10,0,6
2,2407,2365,42,0,242,0,6
2,2346,2464,-118,0,1,0,6
2,2511,2463,48,0,448,0,6
2,2568,2532,36,0,405,1,6
2,2571,2507,64,0,43,0,6
2,2536,2585,-49,0,80,0,6
2,2413,2441,-28,0,296,0,6
2,2495,2618,-123,0,212,0,6
2,2344,2438,-94,0,123,0,6
2,2290,2469,-179,0,131,1,8
2,2434,2429,5,0,11,0,6
2,2455,2341,114,0,414,0,6
2,2311,2467,-156,0,323,1,6
2,2374,2506,-132,0,106,0,6
2,2546,2400,146,0,337,0,6
2,2262,2400,-138,0,49,0,6
2,2414,2565,-151,0,114,0,6
2,2393,2420,-27,0,306,0,8
2,2505,2386,119,0,426,0,6
2,2369,2509,-140,0,102,0,6
2,2386,2434,-48,0,310,0,6
2,2458,2441,17,0,15,1,6
2,2533,2594,-61,0,112,0,6
2,2431,2397,34,0,11,1,6
2,2416,2403,13,0,131,1,6
2,2381,2560,-179,0,4,0,6
2,2388,2411,-23,0,7,0,6
2,2488,2591,-103,0,43,1,6
2,2368,2494,-126,0,40,0,6
2,2405,2427,-22,0,463,0,6
2,2489,2379,110,0,386,0,6
2,2448,2431,17,0,102,0,6
2,2522,2479,43,0,45,0,6
2,2525,2522,3,0,215,1,6
2,2491,2438,53,0,115,0,6
2,2353,2423,-70,0,21,0,6
2,2338,2445,-107,0,15,0,6
2,2421,2574,-153,0,112,0,6
2,2445,2514,-69,0,120,0,6
2,2386,2426,-40,0,45,0,6
2,2330,2440,-110,0,157,0,6
2,2520,2411,109,0,140,0,6
2,2363,2446,-83,0,330,0,6
2,2419,2466,-47,0,45,0,6
2,2290,2404,-114,0,70,0,6
2,2358,2402,-44,0,330,1,8
2,2268,2474,-206,0,46,0,6
2,2406,2314,92,0,120,1,6
2,2433,2471,-38,0,40,0,8
2,2500,2468,32,0,469,0,6
2,2409,2263,146,0,241,0,6
2,2346,2499,-153,0,241,0,6
2,2413,2462,-49,0,20,1,6
2,2409,2279,130,0,112,1,6
2,2405,2353,52,0,302,1,6
2,2435,2538,-103,0,7,0,6
2,2435,2233,202,0,122,1,8
2,2421,2458,-37,0,485,0,6
2,2379,2421,-42,0,112,0,6
2,2408,2390,18,0,40,0,6
2,2600,2598,2,0,133,1,6
2,2436,2298,138,0,40,0,6
2,2388,2541,-153,0,105,1,6
2,2443,2416,27,0,121,0,6
2,2406,2351,55,0,346,0,6
2,2384,2608,-224,0,140,0,6
2,2420,2597,-177,0,15,0,6
2,2394,2501,-107,0,0,0,6
2,2424,2475,-51,0,4,0,6
2,2315,2457,-142,0,140,0,6
2,2477,2313,164,0,4,0,6
2,2405,2408,-3,0,334,0,6
2,2448,2558,-110,0,45,0,6
2,2387,2485,-98,0,10,0,6
2,2534,2581,-47,0,400,1,6
2,2504,2520,-16,0,394,1,6
2,2530,2395,135,0,110,0,6
2,2531,2475,56,0,125,0,6
2,2526,2524,2,0,113,0,6
2,2303,2511,-208,0,106,0,6
2,2405,2366,39,0,153,1,6
2,2488,2419,69,0,373,1,6
2,2434,2492,-58,0,88,1,6
2,2432,2384,48,0,203,0,6
2,2372,2438,-66,0,4,0,6
2,2489,2478,11,0,300,0,6
2,2273,2414,-141,0,303,0,6
2,2428,2329,99,0,88,0,6
2,2472,2476,-4,0,302,0,6
2,2481,2526,-45,0,345,1,6
2,2460,2447,13,0,48,0,6
2,2242,2572,-330,0,114,0,8
2,2445,2322,123,0,45,1,6
2,2390,2425,-35,0,177,0,6
2,2546,2525,21,0,113,0,6
2,2431,2437,-6,0,40,0,6
2,2575,2544,31,0,45,0,6
2,2221,2516,-295,0,116,0,6
2,2357,2439,-82,0,225,0,6
2,2411,2343,68,0,488,1,6
2,2335,2421,-86,0,14,1,6
2,2621,2546,75,0,112,0,6
2,2402,2576,-174,0,345,0,8
2,2275,2595,-320,0,241,1,6
2,2502,2350,152,0,127,0,6
2,2264,2404,-140,0,43,1,6
2,2420,2311,109,0,4,1,6
2,2255,2480,-225,0,210,0,6
2,2218,2490,-272,0,49,0,6
2,2335,2529,-194,0,110,0,6
2,2460,2557,-97,0,10,0,6
2,2378,2406,-28,0,311,0,6
2,2397,2407,-10,0,335,0,6
2,2505,2553,-48,0,306,1,6
2,2405,2527,-122,0,268,0,6
2,2349,2438,-89,0,4,1,6
2,2504,2507,-3,0,135,1,6
2,2454,2284,170,0,45,0,6
2,2654,2430,224,0,1,0,6
2,2412,2476,-64,0,278,0,6
2,2607,2666,-59,0,4,0,6
2,2521,2765,-244,0,110,0,6
2,2449,2239,210,0,200,0,6
2,2333,2413,-80,0,190,0,6
2,2482,2439,43,0,269,1,6
2,2207,2478,-271,0,18,0,6
2,2457,2408,49,0,30,0,6
2,2451,2376,75,0,120,1,6
2,2319,2450,-131,0,123,1,6
2,2246,2559,-313,0,113,1,6
2,2496,2537,-41,0,411,1,6
2,2412,2454,-42,0,301,1,6
2,2485,2363,122,0,490,0,6
2,2381,2425,-44,0,455,0,6
2,2504,2573,-69,0,246,0,6
2,2423,2330,93,0,96,0,6
2,2348,2425,-77,0,56,0,6
2,2404,2446,-42,0,225,0,6
2,2441,2745,-304,0,5,0,6
2,2257,2408,-151,0,10,0,8
2,2424,2484,-60,0,240,0,6
2,2251,2401,-150,4,255,0,13
2,2409,2369,40,0,300,0,6
2,2420,2403,17,0,245,0,6
2,2308,2502,-194,0,301,0,6
2,2319,2510,-191,0,110,0,6
2,2392,2458,-66,0,407,1,6
2,2473,2428,45,0,57,0,6
2,2499,2392,107,0,80,0,6
2,2409,2436,-27,0,211,0,6
2,2410,2355,55,0,49,0,6
2,2227,2566,-339,0,107,1,6
2,2392,2416,-24,0,120,0,6
2,2380,2416,-36,0,145,0,6
2,2552,2588,-36,0,4,0,6
2,2296,2466,-170,0,300,0,6
2,2371,2407,-36,0,40,0,6
2,2361,2407,-46,0,122,1,6
2,2258,2425,-167,0,200,0,6
2,2250,2420,-170,0,380,0,8
2,2400,2402,-2,0,245,0,6
2,2380,2458,-78,0,55,0,6
2,2318,2476,-158,0,40,0,6
2,2589,2725,-136,0,250,0,6
2,2440,2447,-7,0,6,0,6
2,2407,2447,-40,0,310,0,6
2,2428,2342,86,0,200,0,6
2,2428,2351,77,0,45,1,6
2,2318,2409,-91,0,130,1,6
2,2650,2579,71,0,109,0,6
2,2427,2323,104,0,112,0,6
2,2574,2573,1,0,414,1,6
2,2497,2373,124,0,115,0,6
2,2298,2430,-132,0,107,0,6
2,2349,2495,-146,0,1,1,6
2,2314,2447,-133,0,113,0,6
2,2403,2408,-5,0,150,0,6
2,2277,2425,-148,0,4,0,8
2,2448,2509,-61,0,242,1,6
2,2434,2310,124,0,43,1,6
2,2512,2525,-13,0,40,0,6
2,2329,2437,-108,0,40,1,6
2,2478,2454,24,0,4,0,6
2,2407,2426,-19,0,150,0,6
2,2643,2522,121,0,300,0,6
2,2350,2417,-67,0,60,1,6
2,2408,2414,-6,0,36,0,6
2,2241,2418,-177,0,118,0,6
2,2279,2418,-139,0,205,0,6
2,2600,2535,65,0,244,0,6
2,2358,2553,-195,0,490,0,6
2,2416,2531,-115,0,101,0,6
2,2372,2409,-37,0,184,0,6
2,2651,2586,65,0,190,0,6
2,2341,2453,-112,0,0,1,6
2,2374,2431,-57,0,210,0,6
2,2426,2358,68,0,106,0,6
2,2521,2529,-8,0,33,0,6
2,2340,2441,-101,0,127,1,6
2,2509,2654,-145,0,133,0,6
2,2418,2443,-25,0,4,1,6
2,2674,2474,200,0,15,0,6
2,2500,2678,-178,0,0,0,6
2,2533,2477,56,0,108,0,6
2,2484,2567,-83,0,18,0,6
2,2495,2341,154,0,10,0,6
2,2408,2471,-63,0,46,0,6
2,2374,2437,-63,0,9,0,6
2,2436,2257,179,0,113,1,6
2,2431,2304,127,0,96,0,6
2,2451,2358,93,0,20,0,6
2,2495,2335,160,0,80,0,6
2,2390,2447,-57,0,488,0,6
2,2428,2383,45,0,454,0,6
2,2287,2419,-132,0,100,0,6
2,2418,2581,-163,0,386,0,6
2,2400,2336,64,0,120,0,6
2,2458,2335,123,0,37,0,6
2,2441,2296,145,0,1,0,6
2,2424,2365,59,0,301,0,6
2,2674,2787,-113,0,278,0,6
2,2333,2460,-127,0,200,0,6
2,2297,2408,-111,0,331,1,6
2,2453,2423,30,0,4,0,6
2,2239,2407,-168,0,196,0,6
2,2405,2526,-121,0,18,1,6
2,2465,2391,74,0,335,0,6
2,2450,2495,-45,0,345,0,6
2,2388,2559,-171,0,297,0,5
2,2427,2283,144,0,107,0,6
2,2353,2504,-151,0,2,0,6
2,2401,2287,114,0,113,0,6
2,2461,2369,92,0,214,0,6
2,2478,2213,265,0,4,0,6
2,2434,2437,-3,0,49,0,6
2,2553,2645,-92,0,14,0,6
2,2408,2258,150,0,300,0,6
2,2340,2407,-67,0,377,0,6
2,2462,2454,8,0,101,1,6
2,2380,2400,-20,0,487,1,6
2,2372,2496,-124,0,45,0,6
2,2416,2452,-36,0,418,0,6
2,2550,2509,41,0,123,1,6
2,2497,2525,-28,0,0,0,6
2,2214,2422,-208,0,16,1,6
2,2206,2449,-243,0,100,0,6
2,2462,2431,31,0,134,0,6
2,2488,2415,73,0,20,0,5
2,2464,2469,-5,0,267,0,6
2,2619,2378,241,0,455,1,6
2,2425,2310,115,0,109,0,6
2,2207,2421,-214,4,380,0,13
2,2420,2430,-10,0,112,1,6
2,2541,2677,-136,0,409,0,6
2,2446,2553,-107,0,10,0,6
2,2607,2663,-56,0,7,0,6
2,2424,2545,-121,0,2,0,6
2,2462,2570,-108,0,113,1,6
2,2499,2502,-3,0,49,1,6
2,2420,2333,87,0,80,0,6
2,2624,2606,18,0,1,0,6
2,2439,2465,-26,0,312,0,6
2,2475,2410,65,0,40,0,6
2,2403,2451,-48,0,120,0,6
2,2200,2524,-324,0,8,1,6
2,2303,2447,-144,0,1,0,6
2,2313,2482,-169,0,312,0,6
2,2588,2563,25,0,45,0,6
2,2528,2512,16,0,345,0,6
2,2361,2449,-88,0,40,0,6
2,2491,2395,96,0,127,0,6
2,2504,2483,21,0,202,0,6
2,2218,2558,-340,0,43,0,6
2,2302,2462,-160,0,302,0,6
2,2439,2436,3,0,250,0,6
2,2406,2269,137,0,246,0,6
2,2536,2519,17,0,300,0,6
2,2520,2271,249,0,415,0,6
2,2444,2518,-74,0,4,0,5
2,2512,2630,-118,0,241,0,6
2,2438,2563,-125,0,300,0,6
2,2364,2538,-174,0,128,0,6
2,2328,2676,-348,0,190,0,8
2,2362,2505,-143,0,122,1,6
2,2377,2412,-35,0,106,1,6
2,2554,2525,29,0,127,0,6
2,2725,2633,92,0,4,0,6
2,2267,2507,-240,0,332,1,6
2,2476,2597,-121,0,250,0,6
2,2471,2333,138,0,8,1,6
2,2295,2491,-196,0,207,0,6
2,2301,2413,-112,4,65,0,13
2,2318,2464,-146,0,453,1,6
2,2249,2428,-179,0,255,1,6
2,2435,2522,-87,0,123,0,6
2,2519,2496,23,0,41,0,6
2,2337,2492,-155,0,291,1,6
2,2543,2396,147,0,332,1,6
2,2412,2313,99,0,111,0,6
2,2458,2462,-4,0,132,1,6
2,2539,2436,103,0,16,0,6
2,2403,2205,198,0,258,1,6
2,2477,2523,-46,0,85,1,6
2,2392,2452,-60,0,43,1,6
2,2442,2310,132,0,56,0,6
2,2496,2384,112,0,300,0,6
2,2358,2431,-73,0,40,0,6
2,2462,2290,172,0,131,0,6
2,2463,2495,-32,0,158,0,6
2,2507,2578,-71,0,207,0,6
2,2462,2484,-22,0,330,0,6
2,2421,2420,1,0,382,0,6
2,2716,2689,27,0,130,0,6
2,2404,2383,21,0,241,0,8
2,2400,2360,40,0,269,0,6
2,2411,2476,-65,0,386,0,6
2,2314,2448,-134,0,310,0,6
2,2326,2401,-75,0,176,0,6
2,2303,2455,-152,0,302,0,6
2,2403,2366,37,0,302,0,6
2,2264,2428,-164,0,268,0,6
2,2564,2557,7,0,15,0,6
2,2413,2262,151,0,357,0,6
2,2574,2526,48,0,0,0,6
2,2401,2627,-226,0,180,0,6
2,2323,2434,-111,0,311,0,6
2,2369,2477,-108,0,487,0,6
2,2471,2438,33,0,107,0,6
2,2416,2410,6,0,302,1,6
2,2433,2311,122,0,404,1,6
2,2490,2353,137,0,101,0,6
2,2229,2407,-178,0,115,0,5
2,2506,2461,45,0,107,0,6
2,2472,2512,-40,0,0,0,6
2,2334,2508,-174,0,1,0,6
2,2327,2451,-124,0,40,0,6
2,2247,2449,-202,0,313,0,6
2,2324,2523,-199,0,114,0,8
2,2454,2370,84,0,110,0,6
2,2458,2443,15,0,105,1,6
2,2511,2485,26,0,332,0,6
2,2410,2456,-46,0,400,0,6
2,2492,2331,161,0,335,1,6
2,2284,2463,-179,0,152,0,6
2,2483,2472,11,0,405,0,6
2,2404,2430,-26,0,104,0,6
2,2386,2488,-102,0,117,1,6
2,2426,2475,-49,0,300,0,6
2,2428,2341,87,0,140,0,6
2,2304,2439,-135,0,123,1,6
2,2578,2622,-44,0,4,0,6
2,2601,2620,-19,0,335,0,6
2,2515,2549,-34,0,338,0,6
2,2401,2351,50,0,41,0,6
2,2244,2447,-203,0,304,1,6
2,2414,2422,-8,0,2,0,6
2,2280,2431,-151,0,1,0,6
2,2392,2568,-176,0,277,0,6
2,2200,2448,-248,0,100,0,6
2,2500,2360,140,0,341,0,6
2,2204,2449,-245,0,315,1,6
2,2430,2280,150,0,107,1,6
2,2304,2415,-111,0,242,0,6
2,2553,2401,152,0,300,0,6
2,2485,2460,25,0,302,0,6
2,2432,2400,32,0,110,0,6
2,2422,2379,43,0,326,1,6
2,2420,2334,86,0,46,0,6
2,2518,2410,108,0,485,1,6
2,2447,2535,-88,0,40,0,6
2,2444,2612,-168,0,200,0,6
2,2511,2499,12,0,128,1,6
2,2515,2795,-280,0,2,1,6
2,2448,2311,137,0,46,0,6
2,2494,2661,-167,0,5,0,6
2,2437,2351,86,0,113,0,6
2,2522,2416,106,0,398,1,6
2,2401,2296,105,0,40,1,6
2,2313,2440,-127,0,248,0,6
2,2419,2338,81,0,400,1,6
2,2660,2612,48,0,15,0,6
2,2523,2413,110,0,46,0,6
2,2441,2359,82,0,106,0,6
2,2217,2510,-293,0,343,0,6
2,2417,2450,-33,0,106,0,6
2,2437,2465,-28,0,302,1,6
2,2220,2463,-243,0,0,0,5
2,2446,2467,-21,0,118,0,6
2,2430,2318,112,4,260,0,13
2,2499,2378,121,0,395,1,6
2,2475,2453,22,0,245,0,6
2,2426,2502,-76,0,210,0,6
2,2310,2422,-112,0,136,0,6
2,2407,2428,-21,0,108,1,6
2,2326,2449,-123,0,335,0,6
2,2410,2303,107,0,200,0,6
2,2275,2506,-231,0,45,0,6
2,2404,2322,82,0,101,0,6
2,2257,2423,-166,0,456,1,6
2,2469,2557,-88,0,122,0,6
2,2392,2401,-9,0,335,1,6
2,2420,2208,212,0,83,0,6
2,2203,2702,-499,0,201,0,6
2,2400,2487,-87,0,61,0,6
2,2435,2424,11,0,109,0,6
2,2517,2589,-72,0,0,0,6
2,2448,2386,62,0,43,0,6
2,2469,2543,-74,0,138,0,6
2,2398,2532,-134,0,15,1,6
2,2376,2420,-44,0,49,0,6
2,2359,2407,-48,4,211,0,13
2,2628,2744,-116,0,156,0,6
2,2416,2599,-183,0,112,0,6
2,2428,2314,114,0,101,0,6
2,2418,2472,-54,0,302,0,6
2,2314,2619,-305,0,46,0,6
2,2418,2515,-97,0,304,0,6
2,2305,2449,-144,0,124,0,6
2,2213,2541,-328,4,122,0,13
2,2381,2426,-45,0,46,0,6
2,2368,2529,-161,0,128,1,6
2,2404,2434,-30,0,300,0,6
2,2286,2426,-140,0,47,0,6
2,2391,2435,-44,0,113,0,6
2,2431,2434,-3,0,143,0,6
2,2448,2429,19,0,1,0,6
2,2389,2575,-186,0,213,0,6
2,2292,2426,-134,0,312,0,6
2,2605,2603,2,0,40,0,6
2,2437,2369,68,0,112,0,6
2,2389,2582,-193,0,438,0,6
2,2379,2513,-134,0,343,0,8
2,2528,2427,101,0,100,1,6
2,2450,2416,34,0,404,1,6
2,2430,2536,-106,0,312,1,6
2,2534,2496,38,0,15,0,6
2,2393,2411,-18,0,8,1,6
2,2222,2416,-194,0,140,0,6
2,2359,2407,-48,0,140,1,6
2,2510,2526,-16,0,45,0,6
2,2554,2519,35,0,0,1,6
2,2423,2401,22,0,249,0,6
2,2307,2501,-194,0,83,0,6
2,2487,2496,-9,0,110,1,6
2,2556,2367,189,0,108,1,6
2,2384,2419,-35,0,406,0,6
2,2427,2478,-51,0,4,0,6
2,2492,2251,241,0,4,0,6
2,2425,2379,46,0,40,1,6
2,2508,2673,-165,0,245,0,6
2,2423,2435,-12,0,107,0,6
2,2419,2458,-39,0,200,0,6
2,2529,2619,-90,0,11,0,6
2,2499,2503,-4,0,13,0,6
2,2443,2374,69,0,461,0,6
2,2340,2572,-232,0,8,0,6
2,2258,2579,-321,0,45,0,5
2,2221,2456,-235,0,252,1,6
2,2374,2411,-37,0,10,0,6
2,2470,2355,115,0,45,1,6
2,2279,2416,-137,0,106,0,6
2,2379,2459,-80,0,2,0,6
2,2648,2640,8,0,280,1,6
2,2247,2416,-169,0,201,0,6
2,2470,2477,-7,0,13,0,6
2,2459,2383,76,0,112,0,6
2,2471,2506,-35,0,101,0,6
2,2522,2575,-53,0,87,1,6
2,2241,2445,-204,0,211,1,6
2,2518,2232,286,0,140,0,6
2,2364,2536,-172,0,45,0,6
2,2370,2415,-45,0,491,1,8
2,2453,2519,-66,0,345,0,6
2,2477,2533,-56,0,45,1,6
2,2407,2476,-69,0,485,0,6
2,2576,2571,5,0,40,0,6
2,2246,2664,-418,0,484,0,6
2,2544,2407,137,0,121,1,6
2,2448,2274,174,0,300,0,6
2,2450,2350,100,0,45,1,6
2,2390,2416,-26,0,150,0,6
2,2278,2613,-335,0,305,0,6
2,2499,2692,-193,0,4,0,6
2,2578,2434,144,0,58,0,6
2,2451,2396,55,0,311,1,6
2,2377,2531,-154,0,358,0,6
2,2483,2413,70,0,318,0,6
2,2505,2573,-68,0,101,0,6
2,2455,2411,44,0,277,0,6
2,2537,2604,-67,0,145,0,6
2,2661,2635,26,0,372,0,6
2,2458,2492,-34,0,54,0,6
2,2271,2422,-151,0,112,0,6
2,2712,2981,-269,0,143,0,6
2,2296,2400,-104,0,12,0,6
2,2431,2426,5,0,46,0,6
2,2373,2534,-161,0,56,0,6
2,2236,2446,-210,0,200,1,6
2,2417,2255,162,0,102,0,6
2,2335,2499,-164,0,1,0,6
2,2440,2449,-9,0,302,1,6
2,2441,2639,-198,0,315,1,6
2,2482,2445,37,0,20,1,6
2,2333,2639,-306,0,2,1,6
2,2268,2406,-138,4,45,0,13
2,2331,2509,-178,0,300,0,6
2,2605,2592,13,0,398,0,6
2,2391,2479,-88,0,426,1,6
2,2625,2575,50,0,337,0,6
2,2233,2412,-179,0,230,1,6
2,2433,2396,37,0,21,0,6
2,2429,2448,-19,0,485,0,6
2,2455,2576,-121,0,113,0,6
2,2453,2372,81,0,16,0,6
2,2409,2352,57,0,414,0,6
2,2413,2574,-161,0,300,0,6
2,2231,2462,-231,0,483,1,6
2,2329,2502,-173,0,487,0,6
2,2503,2685,-182,0,228,0,6
2,2402,2511,-109,0,40,0,6
2,2434,2332,102,0,10,1,6
2,2545,2296,249,0,308,0,6
2,2416,2538,-122,0,302,0,6
2,2390,2520,-130,0,474,0,6
2,2454,2454,0,0,204,0,6
2,2474,2513,-39,0,0,0,6
2,2307,2411,-104,0,246,0,5
2,2471,2387,84,0,115,0,6
2,2384,2402,-18,0,45,1,6
2,2369,2509,-140,0,96,0,6
2,2297,2457,-160,0,4,1,6
2,2403,2437,-34,0,10,1,6
2,2593,2569,24,0,194,0,6
2,2692,2623,69,0,103,0,6
2,2331,2407,-76,0,400,0,6
2,2556,2622,-66,0,101,1,6
2,2517,2770,-253,0,106,0,6
2,2484,2607,-123,0,107,0,6
2,2317,2415,-98,0,245,0,6
2,2478,2443,35,0,292,0,6
2,2471,2233,238,0,127,1,8
2,2445,2369,76,0,4,0,6
2,2268,2425,-157,0,373,0,8
2,2396,2451,-55,0,300,0,6
2,2632,2549,83,0,54,0,6
2,2442,2418,24,0,46,0,6
2,2456,2603,-147,0,241,1,6
2,2405,2578,-173,0,484,0,6
2,2535,2552,-17,0,337,0,6
2,2441,2580,-139,0,455,1,6
2,2432,2291,141,0,130,1,6
2,2452,2530,-78,0,330,0,6
2,2471,2446,25,0,191,0,6
2,2477,2378,99,0,311,0,6
2,2402,2538,-136,0,90,1,6
2,2531,2446,85,0,100,1,6
2,2370,2513,-143,0,211,1,6
2,2330,2429,-99,0,190,0,6
2,2239,2401,-162,0,10,0,6
2,2389,2422,-33,0,122,0,8
2,2257,2411,-154,0,43,1,6
2,2505,2668,-163,0,3,1,6
2,2343,2442,-99,0,132,0,6
2,2421,2356,65,0,106,0,8
2,2479,2265,214,0,300,0,6
2,2497,2616,-119,0,10,0,6
2,2662,2536,126,0,331,0,6
2,2278,2402,-124,0,57,0,6
2,2440,2447,-7,0,132,0,6
2,2360,2489,-129,0,151,0,6
2,2319,2406,-87,0,330,1,8
2,2448,2447,1,0,409,0,6
2,2434,2367,67,0,210,0,6
2,2509,2432,77,0,145,0,6
2,2606,2737,-131,0,45,0,6
2,2571,2598,-27,0,80,1,6
2,2393,2411,-18,0,15,1,6
2,2380,2573,-193,0,130,0,6
2,2236,2481,-245,0,121,1,6
2,2280,2429,-149,0,133,0,6
2,2463,2330,133,0,84,0,6
2,2458,2408,50,0,106,1,6
2,2375,2477,-102,0,101,0,6
2,2468,2332,136,0,254,0,6
2,2512,2574,-62,0,143,1,6
2,2297,2458,-161,0,40,0,8
2,2419,2608,-189,0,241,1,6
2,2467,2332,135,0,40,0,6
2,2473,2533,-60,0,120,0,6
2,2284,2423,-139,0,40,1,6
2,2411,2378,33,0,302,1,6
2,2301,2404,-103,0,330,0,6
2,2355,2552,-197,0,45,0,6
2,2346,2426,-80,0,409,0,6
2,2420,2447,-27,0,58,1,6
2,2225,2587,-362,0,192,0,6
2,2461,2464,-3,0,13,0,6
2,2408,2359,49,0,113,0,6
2,2467,2476,-9,0,251,0,6
2,2528,2607,-79,0,112,0,6
2,2486,2350,136,0,44,0,6
2,2333,2429,-96,0,114,1,6
2,2348,2487,-139,0,304,0,6
2,2602,2328,274,0,13,0,6
2,2418,2474,-56,0,352,1,6
2,2453,2437,16,0,398,1,6
2,2417,2375,42,0,335,1,6
2,2403,2337,66,0,139,0,8
2,2523,2205,318,0,211,1,6
2,2349,2408,-59,0,0,1,6
2,2448,2307,141,0,303,0,6
2,2347,2421,-74,0,45,1,6
2,2612,2759,-147,0,61,0,6
2,2473,2668,-195,0,112,0,6
2,2458,2498,-40,0,201,0,6
2,2396,2425,-29,0,454,0,6
2,2412,2220,192,0,119,0,6
2,2316,2575,-259,0,130,0,6
2,2400,2415,-15,0,132,0,6
2,2447,2411,36,0,313,1,6
2,2337,2419,-82,0,225,0,6
2,2648,2685,-37,0,46,1,6
2,2407,2474,-67,0,216,0,6
2,2478,2484,-6,0,267,0,6
2,2366,2445,-79,0,310,0,6
2,2419,2390,29,0,302,0,6
2,2385,2419,-34,0,40,0,6
2,2235,2489,-254,0,200,0,6
2,2690,2584,106,0,455,0,6
2,2393,2463,-70,0,136,0,6
2,2402,2453,-51,0,10,0,6
2,2516,2344,172,0,111,0,6
2,2397,2729,-332,0,45,0,6
2,2492,2360,132,0,0,0,6
2,2271,2418,-147,4,308,0,13
2,2306,2594,-288,0,302,1,6
2,2470,2462,8,0,7,0,6
2,2284,2635,-351,0,302,0,6
2,2335,2427,-92,0,43,0,6
2,2272,2426,-154,0,202,1,6
2,2664,2555,109,0,130,0,6
2,2411,2391,20,0,120,0,6
2,2418,2322,96,0,312,0,8
2,2606,2690,-84,0,260,1,6
2,2393,2405,-12,0,245,0,6
2,2385,2481,-96,0,46,0,6
2,2425,2341,84,0,0,0,6
2,2399,2409,-10,0,10,0,6
2,2514,2401,113,0,258,0,6
2,2387,2418,-31,0,118,0,6
2,2408,2318,90,0,300,0,6
2,2400,2272,128,0,172,0,6
2,2465,2430,35,0,107,0,6
2,2483,2326,157,0,10,0,6
2,2462,2322,140,0,4,0,6
2,2486,2738,-252,0,103,1,6
2,2662,2643,19,0,247,0,6
2,2499,2404,95,0,101,0,6
2,2432,2440,-8,0,40,0,6
2,2453,2413,40,0,102,1,6
2,2207,2553,-346,0,110,0,5
2,2363,2400,-37,0,330,0,6
2,2473,2507,-34,0,4,0,6
2,2306,2407,-101,0,45,1,6
2,2576,2509,67,0,143,1,6
2,2463,2463,0,0,120,0,6
2,2463,2311,152,0,484,0,6
2,2465,2413,52,0,409,1,6
2,2217,2423,-206,0,101,0,6
2,2418,2375,43,0,52,0,6
2,2474,2642,-168,0,106,1,6
2,2582,2540,42,0,429,0,6
2,2401,2414,-13,0,241,0,6
2,2203,2414,-211,0,20,0,6
2,2227,2553,-326,0,43,0,6
2,2466,2284,182,2,101,0,25
2,2411,2481,-70,0,318,0,6
2,2463,2509,-46,0,300,0,6
2,2423,2272,151,0,45,0,6
2,2498,2328,170,0,249,1,6
2,2384,2614,-230,0,2,0,6
2,2488,2471,17,0,45,0,6
2,2567,2398,169,0,101,1,6
2,2293,2449,-156,0,220,0,6
2,2425,2363,62,0,40,0,6
2,2356,2467,-111,0,250,0,8
2,2377,2438,-61,0,199,0,6
2,2288,2433,-145,0,133,0,6
2,2350,2404,-54,0,218,1,6
2,2420,2585,-165,0,37,1,6
2,2446,2510,-64,0,4,0,6
2,2425,2366,59,0,15,0,6
2,2312,2478,-166,0,110,0,6
2,2445,2530,-85,0,250,0,6
2,2591,2507,84,0,260,0,6
2,2448,2410,38,0,47,0,6
2,2438,2485,-47,0,303,1,6
2,2360,2463,-103,0,241,0,6
2,2445,2396,49,0,50,0,6
2,2357,2439,-82,0,344,0,6
2,2437,2250,187,0,247,0,6
2,2269,2422,-153,0,107,0,6
2,2441,2445,-4,0,80,0,6
2,2271,2542,-271,0,260,0,6
2,2519,2434,85,0,485,0,6
2,2349,2408,-59,0,40,0,6
2,2425,2364,61,0,8,1,6
2,2294,2409,-115,0,113,0,6
2,2480,2316,164,0,219,0,6
2,2431,2511,-80,0,110,0,6
2,2351,2620,-269,0,10,0,6
2,2274,2417,-143,0,405,0,5
2,2461,2455,6,0,0,0,6
2,2377,2480,-103,0,101,1,6
2,2408,2376,32,0,112,0,6
2,2216,2432,-216,0,300,0,6
2,2408,2498,-90,0,146,0,6
2,2438,2462,-24,0,483,1,6
2,2200,2509,-309,0,409,0,6
2,2488,2393,95,0,17,1,6
2,2468,2503,-35,0,121,1,6
2,2298,2508,-210,0,122,1,6
2,2365,2474,-109,0,406,0,6
2,2393,2485,-92,0,45,0,6
2,2436,2408,28,0,150,1,6
2,2609,2645,-36,0,335,0,6
2,2452,2460,-8,0,46,1,6
2,2338,2453,-115,0,337,0,6
2,2256,2401,-145,0,333,0,6
2,2593,2521,72,0,241,0,6
2,2389,2460,-71,0,311,0,6
2,2295,2475,-180,0,0,0,6
2,2497,2411,86,0,58,0,6
2,2284,2422,-138,0,85,0,6
2,2567,2689,-122,0,202,0,6
2,2357,2485,-128,0,203,0,6
2,2426,2274,152,0,133,0,6
2,2436,2393,43,0,15,0,6
2,2485,2563,-78,0,35,1,6
2,2470,2610,-140,0,112,0,6
2,2341,2527,-186,0,101,0,6
2,2434,2269,165,0,107,0,6
2,2500,2407,93,0,5,0,6
2,2494,2468,26,0,58,1,6
2,2306,2470,-164,0,18,0,6
2,2447,2465,-18,0,124,1,6
2,2504,2483,21,0,250,0,6
2,2419,2518,-99,0,40,0,6
2,2436,2347,89,0,40,0,6
2,2461,2527,-66,0,37,0,6
2,2417,2467,-50,0,301,0,6
2,2323,2496,-173,0,207,0,6
2,2442,2312,130,0,207,0,6
2,2366,2449,-83,0,62,0,6
2,2353,2426,-73,0,48,0,6
2,2284,2431,-147,0,121,1,6
2,2405,2346,59,0,45,1,6
2,2412,2268,144,0,122,0,6
2,2320,2468,-148,4,45,0,11
2,2433,2389,44,0,487,0,6
2,2370,2406,-36,0,4,0,6
2,2432,2398,34,4,143,0,13
2,2776,2654,122,0,474,0,6
2,2386,2494,-108,0,200,0,6
2,2495,2432,63,4,460,0,10
2,2602,2298,304,0,39,1,6
2,2301,2423,-122,0,202,0,6
2,2234,2517,-283,0,135,0,6
2,2440,2423,17,0,123,0,6
2,2478,2463,15,0,103,0,6
2,2401,2495,-94,0,415,1,6
2,2489,2434,55,0,102,0,6
2,2309,2569,-260,0,50,0,8
2,2372,2413,-41,0,4,0,6
2,2385,2429,-44,0,250,0,6
2,2392,2436,-44,0,14,0,6
2,2389,2411,-22,0,54,1,6
2,2411,2325,86,0,106,1,6
2,2538,2465,73,0,43,0,6
2,2296,2425,-129,0,40,0,6
2,2400,2337,63,0,100,1,6
2,2417,2258,159,0,40,0,6
2,2448,2475,-27,0,15,0,6
2,2429,2360,69,0,85,1,6
2,2397,2498,-101,0,107,0,6
2,2494,2556,-62,0,4,0,6
2,2488,2348,140,0,106,1,8
2,2433,2453,-20,0,40,1,6
2,2251,2414,-163,0,0,0,6
2,2311,2434,-123,0,46,0,6
2,2505,2510,-5,0,300,0,6
2,2393,2410,-17,0,46,0,6
2,2273,2458,-185,0,330,0,6
2,2484,2300,184,0,108,0,6
2,2285,2402,-117,0,288,0,8
2,2435,2436,-1,0,101,0,6
2,2563,2632,-69,0,201,0,6
2,2433,2425,8,0,10,0,6
2,2311,2429,-118,0,48,0,6
2,2464,2309,155,0,100,0,6
2,2447,2424,23,0,474,0,6
2,2442,2287,155,0,167,0,6
2,2473,2411,62,0,190,1,6
2,2430,2476,-46,0,200,0,6
2,2462,2355,107,0,200,1,6
2,2423,2372,51,0,45,0,6
2,2619,2508,111,0,331,0,6
2,2508,2304,204,0,112,1,6
2,2464,2454,10,0,100,0,6
2,2432,2422,10,0,297,1,6
2,2690,2584,106,0,311,1,6
2,2381,2427,-46,0,192,0,6
2,2436,2719,-283,0,225,0,6
2,2435,2450,-15,0,40,0,6
2,2349,2514,-165,0,330,0,6
2,2495,2550,-55,0,490,0,6
2,2652,2667,-15,0,103,0,6
2,2421,2517,-96,0,490,0,6
2,2468,2293,175,0,105,0,8
2,2484,2393,91,0,6,1,6
2,2405,2231,174,0,0,0,6
2,2412,2402,10,0,245,0,6
2,2395,2582,-187,0,106,0,6
2,2546,2496,50,0,120,1,6
2,2578,2503,75,0,140,0,6
2,2431,2474,-43,0,202,0,6
2,2293,2534,-241,0,41,0,6
2,2449,2383,66,0,107,0,6
2,2357,2511,-154,0,140,0,6
2,2392,2553,-161,0,0,0,6
2,2330,2456,-126,0,45,0,6
2,2576,2674,-98,0,110,0,6
2,2492,2415,77,0,112,1,6
2,2456,2525,-69,0,150,0,6
2,2496,2432,64,0,112,0,6
2,2412,2354,58,0,228,0,8
2,2492,2416,76,0,45,0,6
2,2519,2671,-152,0,110,0,6
2,2231,2406,-175,0,100,0,6
2,2433,2392,41,0,52,0,6
2,2312,2421,-109,0,49,0,6
2,2368,2408,-40,0,394,0,6
2,2235,2443,-208,0,45,1,6
2,2294,2410,-116,0,302,1,6
2,2486,2504,-18,0,40,0,6
2,2258,2525,-267,0,0,1,6
2,2376,2410,-34,0,131,1,6
2,2436,2351,85,0,103,0,6
2,2552,2543,9,0,311,1,6
2,2315,2422,-107,0,106,0,6
2,2372,2416,-44,0,40,0,6
2,2463,2478,-15,0,263,0,6
2,2444,2436,8,0,302,1,6
2,2352,2426,-74,0,46,0,6
2,2547,2597,-50,0,300,0,6
2,2340,2484,-144,0,110,1,8
2,2354,2421,-67,0,4,0,6
2,2384,2484,-100,0,106,0,6
2,2484,2396,88,0,5,1,6
2,2465,2405,60,0,102,0,6
2,2310,2437,-127,0,115,0,5
2,2605,2396,209,0,219,1,6
2,2220,2587,-367,0,46,0,6
2,2393,2622,-229,0,12,0,6
2,2437,2350,87,0,100,0,6
2,2421,2420,1,0,107,0,6
2,2279,2479,-200,0,414,1,6
2,2419,2503,-84,0,46,0,6
2,2389,2574,-185,0,429,1,6
2,2277,2407,-130,0,48,0,6
2,2456,2516,-60,0,131,0,6
2,2309,2402,-93,0,320,0,6
2,2411,2486,-75,0,394,1,6
2,2525,2491,34,0,302,0,6
2,2308,2431,-123,0,43,0,6
2,2493,2434,59,0,341,0,6
2,2441,2629,-188,0,125,0,6
2,2453,2388,65,0,130,1,6
2,2370,2426,-56,0,40,0,6
2,2416,2248,168,0,344,0,8
2,2413,2425,-12,0,113,1,6
2,2403,2415,-12,0,122,0,6
2,2475,2433,42,0,35,0,6
2,2531,2502,29,0,453,0,6
2,2322,2413,-91,0,454,0,6
2,2440,2505,-65,0,158,0,6
2,2538,2445,93,0,4,0,6
2,2447,2542,-95,0,40,0,6
2,2635,2620,15,0,190,0,6
2,2422,2247,175,0,153,0,8
2,2628,2494,134,0,302,0,6
2,2548,2675,-127,0,115,0,6
2,2381,2502,-121,0,45,0,6
2,2324,2644,-320,0,196,0,6
2,2473,2308,165,0,4,0,6
2,2724,2629,95,0,112,0,6
2,2379,2412,-33,0,311,0,6
2,2530,2436,94,0,153,0,6
2,2296,2416,-120,0,264,0,6
2,2366,2514,-148,0,41,1,6
2,2307,2407,-100,0,300,0,6
2,2372,2465,-93,0,301,1,6
2,2300,2561,-261,0,140,1,6
2,2493,2433,60,0,112,0,6
2,2436,2455,-19,0,190,0,6
2,2445,2600,-155,0,120,0,6
2,2300,2432,-132,0,251,0,6
2,2240,2408,-168,4,150,1,13
2,2430,2265,165,0,4,0,6
2,2429,2439,-10,0,331,0,6
2,2353,2467,-114,0,63,0,6
2,2440,2485,-45,0,205,0,6
2,2482,2455,27,0,143,1,6
2,2486,2407,79,0,211,0,6
2,2425,2399,26,0,245,0,6
2,2418,2465,-47,0,247,0,6
2,2365,2408,-43,0,380,0,6
2,2503,2481,22,0,216,0,6
2,2416,2422,-6,0,226,0,8
2,2397,2492,-95,0,4,0,6
2,2260,2473,-213,0,57,0,6
2,2493,2397,96,0,120,1,6
2,2365,2412,-47,0,255,1,6
2,2488,2388,100,0,306,1,6
2,2436,2657,-221,0,242,1,6
2,2401,2418,-17,0,107,1,6
2,2714,2426,288,0,268,0,6
2,2415,2213,202,4,28,0,13
2,2434,2253,181,0,353,0,6
2,2445,2357,88,0,153,0,6
2,2485,2411,74,0,108,0,6
2,2407,2556,-149,0,140,0,6
2,2475,2512,-37,0,218,0,6
2,2448,2441,7,0,7,1,6
2,2527,2581,-54,0,485,0,6
2,2478,2485,-7,0,123,0,6
2,2377,2414,-37,0,4,0,6
2,2396,2524,-128,0,0,0,6
2,2446,2454,-8,0,184,0,6
2,2462,2480,-18,0,113,0,6
2,2378,2565,-187,0,46,0,6
2,2439,2530,-91,0,46,0,6
2,2432,2562,-130,0,38,0,6
2,2467,2434,33,0,46,0,6
2,2408,2477,-69,0,106,0,6
2,2602,2567,35,0,7,0,6
2,2506,2308,198,0,40,0,6
2,2380,2538,-158,0,300,0,6
2,2365,2429,-64,0,80,0,6
2,2290,2618,-328,0,123,0,6
2,2413,2388,25,0,13,1,6
2,2416,2351,65,0,369,0,6
2,2344,2419,-75,0,1,1,6
2,2352,2415,-63,0,265,0,6
2,2436,2472,-36,0,110,1,6
2,2407,2410,-3,0,202,0,6
2,2542,2469,73,0,310,1,6
2,2556,2393,163,0,8,0,6
2,2437,2309,128,4,115,0,13
2,2592,2477,115,0,398,1,6
2,2443,2506,-63,0,2,0,6
2,2329,2513,-184,0,436,0,6
2,2486,2369,117,0,122,0,6
2,2572,2557,15,0,0,0,6
2,2533,2603,-70,0,255,1,6
2,2545,2593,-48,0,315,0,6
2,2469,2533,-64,0,202,0,6
2,2576,2617,-41,0,175,0,6
2,2370,2466,-96,0,11,0,6
2,2338,2440,-102,0,70,0,6
2,2535,2591,-56,0,133,0,6
2,2398,2408,-10,0,330,0,6
2,2502,2487,15,0,4,0,6
2,2687,2620,67,0,194,0,6
2,2355,2429,-74,0,110,1,6
2,2374,2531,-157,0,101,0,6
2,2323,2452,-129,0,264,0,6
2,2608,2645,-37,0,335,1,6
2,2379,2499,-120,0,101,0,6
2,2322,2437,-115,0,190,0,6
2,2337,2493,-156,0,242,0,6
2,2359,2556,-197,0,201,1,6
2,2345,2413,-68,0,302,0,6
2,2380,2477,-97,0,242,1,6
2,2359,2513,-154,0,148,0,6
2,2469,2435,34,0,151,0,6
2,2591,2561,30,0,110,0,6
2,2558,2345,213,0,115,0,6
2,2553,2478,75,0,7,0,6
2,2559,2403,156,0,40,0,6
2,2439,2323,116,0,151,0,6
2,2236,2448,-212,0,400,0,8
2,2491,2508,-17,0,270,1,6
2,2475,2539,-64,0,190,0,6
2,2260,2516,-256,0,80,0,6
2,2404,2434,-30,0,135,1,6
2,2364,2405,-41,0,304,0,6
2,2300,2481,-181,0,302,0,6
2,2458,2557,-99,0,118,0,6
2,2308,2411,-103,0,344,0,3
2,2402,2479,-77,0,382,0,6
2,2428,2416,12,0,45,0,6
2,2463,2373,90,0,0,1,6
2,2686,2530,156,0,46,1,6
2,2471,2329,142,0,171,0,6
2,2495,2578,-83,0,106,0,6
2,2239,2475,-236,0,46,0,6
2,2436,2508,-72,0,207,0,6
2,2442,2264,178,0,41,0,6
2,2477,2307,170,0,35,0,6
2,2385,2407,-22,4,140,0,13
2,2369,2522,-153,0,106,0,6
2,2241,2419,-178,0,240,0,6
2,2470,2590,-120,0,455,0,6
2,2574,2760,-186,0,352,1,6
2,2318,2476,-158,0,106,0,5
2,2478,2393,85,0,242,1,6
2,2419,2299,120,0,302,1,8
2,2530,2670,-140,0,154,0,6
2,2422,2575,-153,0,41,0,6
2,2477,2573,-96,0,310,0,6
2,2427,2428,-1,0,147,0,6
2,2419,2379,40,0,107,0,6
2,2413,2371,42,0,484,0,6
2,2235,2410,-175,0,11,1,6
2,2468,2495,-27,0,101,0,6
2,2434,2590,-156,0,42,0,6
2,2381,2549,-168,0,118,0,6
2,2426,2465,-39,0,300,0,6
2,2389,2454,-65,0,211,0,5
2,2306,2461,-155,0,309,0,6
2,2376,2513,-137,0,1,0,6
2,2251,2401,-150,0,5,0,6
2,2379,2503,-124,0,131,0,6
2,2402,2475,-73,0,198,0,6
2,2495,2463,32,0,338,0,6
2,2616,2464,152,0,386,1,6
2,2503,2333,170,0,207,0,6
2,2232,2427,-195,0,102,0,6
2,2479,2613,-134,0,344,0,6
2,2377,2403,-26,0,4,0,6
2,2448,2222,226,4,243,0,13
2,2244,2484,-240,0,113,0,6
2,2563,2479,84,0,15,1,6
2,2385,2445,-60,0,40,0,6
2,2538,2553,-15,0,327,0,6
2,2442,2595,-153,0,51,1,6
2,2462,2450,12,0,46,0,6
2,2437,2450,-13,0,107,0,6
2,2437,2318,119,0,426,0,6
2,2516,2482,34,0,135,0,6
2,2396,2459,-63,0,22,1,6
2,2424,2468,-44,0,46,1,6
2,2517,2460,57,0,464,1,6
2,2652,2854,-202,0,111,0,6
2,2317,2499,-182,0,338,0,6
2,2482,2441,41,0,4,0,6
2,2420,2405,15,0,2,1,6
2,2338,2412,-74,0,113,0,6
2,2257,2534,-277,0,302,0,6
2,2423,2399,24,0,461,1,6
2,2238,2408,-170,0,56,0,6
2,2246,2400,-154,0,470,1,8
2,2385,2463,-78,0,127,0,6
2,2488,2476,12,0,409,0,6
2,2422,2574,-152,0,43,0,6
2,2348,2438,-90,0,266,0,10
2,2410,2417,-7,0,45,0,6
2,2444,2271,173,0,143,0,6
2,2371,2531,-160,0,391,0,6
2,2470,2445,25,0,103,0,6
2,2274,2482,-208,0,192,0,6
2,2375,2411,-36,0,247,0,6
2,2432,2386,46,0,286,1,6
2,2297,2401,-104,0,1,0,6
2,2435,2379,56,0,11,0,6
2,2458,2374,84,0,123,0,6
2,2575,2587,-12,0,247,0,6
2,2475,2290,185,0,130,1,6
2,2409,2386,23,0,124,0,6
2,2292,2441,-149,0,122,0,6
2,2547,2556,-9,0,228,0,6
2,2403,2380,23,0,245,0,6
2,2426,2437,-11,0,120,0,8
2,2421,2375,46,0,324,0,6
2,2430,2413,17,0,120,0,6
2,2648,2438,210,0,201,0,6
2,2519,2526,-7,0,120,1,6
2,2381,2415,-34,0,45,1,6
2,2525,2506,19,0,4,0,6
2,2435,2509,-74,0,4,0,6
2,2678,2706,-28,0,120,0,6
2,2354,2523,-169,0,395,1,6
2,2502,2483,19,0,253,0,6
2,2289,2455,-166,0,45,1,6
2,2519,2709,-190,0,117,0,6
2,2414,2460,-46,0,109,1,6
2,2510,2289,221,0,303,0,6
2,2472,2486,-14,0,400,0,6
2,2234,2479,-245,0,80,0,6
2,2246,2433,-187,0,8,0,6
2,2283,2400,-117,0,466,0,6
2,2316,2482,-166,0,43,0,5
2,2374,2417,-43,0,190,0,6
2,2221,2485,-264,0,347,0,6
2,2387,2538,-151,0,113,0,6
2,2331,2597,-266,0,45,0,8
2,2310,2457,-147,0,107,0,6
2,2481,2360,121,0,80,0,6
2,2261,2408,-147,0,158,1,6
2,2282,2585,-303,0,10,0,6
2,2422,2399,23,0,113,0,6
2,2266,2425,-159,0,107,1,8
2,2346,2460,-114,0,106,0,6
2,2581,2572,9,0,129,0,6
2,2407,2584,-177,0,41,1,8
2,2399,2415,-16,0,13,0,6
2,2383,2496,-113,0,394,0,6
2,2331,2547,-216,0,113,0,6
2,2327,2496,-169,0,201,0,6
2,2422,2363,59,0,40,0,6
2,2349,2497,-148,0,310,0,6
2,2438,2620,-182,0,113,0,6
2,2693,2783,-90,0,250,0,6
2,2379,2456,-77,0,455,0,6
2,2309,2405,-96,0,16,0,6
2,2357,2458,-101,0,10,1,6
2,2313,2493,-180,0,41,0,6
2,2292,2435,-143,0,0,0,6
2,2412,2470,-58,0,100,0,6
2,2439,2488,-49,0,7,0,6
2,2327,2472,-145,0,229,0,6
2,2507,2453,54,0,483,0,6
2,2337,2447,-110,0,2,1,6
2,2229,2412,-183,4,218,1,8
2,2270,2437,-167,0,120,0,6
2,2516,2776,-260,0,474,0,6
2,2659,2426,233,0,244,0,6
2,2404,2256,148,0,107,0,6
2,2434,2447,-13,0,0,0,6
2,2323,2492,-169,0,33,0,6
2,2273,2404,-131,0,250,0,6
2,2435,2453,-18,0,106,0,6
2,2616,2577,39,0,152,0,6
2,2277,2574,-297,0,10,0,6
2,2457,2352,105,0,40,0,6
2,2274,2525,-251,0,41,0,6
2,2293,2424,-131,0,65,0,6
2,2377,2400,-23,0,111,1,6
2,2406,2332,74,0,190,1,6
2,2569,2437,132,0,262,0,6
2,2485,2271,214,0,400,0,5
2,2567,2679,-112,0,301,1,6
2,2312,2576,-264,0,375,0,6
2,2382,2474,-92,0,245,0,6
2,2573,2590,-17,0,45,1,6
2,2373,2497,-124,0,180,0,6
2,2300,2418,-118,0,278,1,6
2,2432,2345,87,0,49,0,6
2,2333,2475,-142,0,415,0,6
2,2493,2568,-75,0,247,0,6
2,2302,2478,-176,0,140,0,6
2,2288,2462,-174,0,107,0,6
2,2519,2458,61,0,0,0,6
2,2319,2408,-89,0,302,0,8
2,2572,2455,117,0,132,0,6
2,2386,2476,-90,0,240,0,6
2,2545,2383,162,0,122,0,6
2,2481,2469,12,0,136,0,6
2,2431,2498,-67,0,80,0,6
2,2238,2516,-278,0,131,0,6
2,2202,2520,-318,0,113,0,6
2,2413,2408,5,0,330,1,6
2,2579,2595,-16,0,10,0,6
2,2384,2554,-170,0,113,0,6
2,2414,2399,15,0,202,0,6
2,2515,2513,2,0,45,0,6
2,2460,2319,141,0,310,0,6
2,2415,2408,7,0,432,1,6
2,2492,2468,24,0,311,0,6
2,2281,2467,-186,0,311,0,6
2,2587,2402,185,0,50,0,8
2,2594,2498,96,0,459,0,6
2,2461,2488,-27,0,145,0,6
2,2508,2479,29,0,158,1,6
2,2626,2487,139,0,140,0,6
2,2508,2505,3,0,130,0,6
2,2411,2339,72,0,462,0,6
2,2280,2427,-147,0,210,1,8
2,2348,2427,-79,0,0,0,6
2,2464,2437,27,0,130,0,6
2,2441,2343,98,0,112,0,6
2,2405,2468,-63,0,193,1,6
2,2445,2550,-105,0,226,1,6
2,2460,2476,-16,0,125,0,6
2,2544,2426,118,0,16,1,6
2,2408,2286,122,0,101,0,6
2,2381,2544,-163,0,301,0,6
2,2470,2400,70,0,101,0,6
2,2341,2589,-248,0,45,0,6
2,2616,2632,-16,0,110,1,6
2,2273,2433,-160,0,336,1,6
2,2429,2495,-66,0,255,0,6
2,2330,2423,-93,0,8,0,6
2,2394,2497,-103,0,101,0,6
2,2368,2551,-183,0,315,0,6
2,2513,2503,10,0,4,0,6
2,2465,2382,83,0,112,0,8
2,2419,2371,48,0,197,1,6
2,2557,2589,-32,0,122,1,6
2,2288,2444,-156,0,400,0,6
2,2440,2298,142,0,111,0,6
2,2393,2463,-70,0,456,0,6
2,2606,2844,-238,0,387,0,6
2,2640,2386,254,0,140,0,6
2,2462,2365,97,0,5,0,6
2,2312,2430,-118,0,318,0,6
2,2438,2429,9,0,8,0,6
2,2433,2336,97,0,143,0,6
2,2391,2572,-181,0,45,0,6
2,2366,2448,-82,0,46,0,6
2,2405,2289,116,0,128,0,6
2,2612,2357,255,0,7,0,6
2,2429,2317,112,0,80,0,6
2,2609,2657,-48,0,45,0,6
2,2476,2427,49,0,320,1,6
2,2387,2401,-14,0,4,0,6
2,2476,2333,143,0,302,1,6
2,2515,2456,59,0,303,1,6
2,2312,2575,-263,0,107,1,6
2,2473,2506,-33,0,331,0,6
2,2404,2448,-44,0,190,1,6
2,2401,2475,-74,0,330,1,6
2,2420,2423,-3,0,310,0,6
2,2348,2452,-104,0,254,0,6
2,2322,2403,-81,0,0,1,6
2,2329,2473,-144,0,140,0,6
2,2422,2583,-161,0,204,0,6
2,2387,2500,-113,0,404,0,6
2,2586,2588,-2,0,462,1,6
2,2604,2644,-40,0,153,0,6
2,2305,2429,-124,0,302,0,8
2,2589,2426,163,0,241,0,6
2,2416,2416,0,0,255,0,6
2,2416,2353,63,0,474,0,6
2,2373,2436,-63,0,49,0,6
2,2392,2418,-26,0,322,0,6
2,2408,2465,-57,0,244,0,8
2,2408,2361,47,0,100,0,6
2,2357,2462,-105,0,1,0,6
2,2472,2556,-84,0,40,0,6
2,2468,2509,-41,0,20,0,6
2,2484,2347,137,0,300,0,6
2,2332,2462,-130,0,0,0,6
2,2474,2523,-49,0,154,0,6
2,2467,2391,76,0,6,0,6
2,2430,2331,99,0,101,0,6
2,2445,2398,47,0,80,0,6
2,2442,2267,175,0,46,1,6
2,2452,2430,22,0,388,1,6
2,2265,2531,-266,0,120,0,6
2,2439,2483,-44,0,53,0,6
2,2406,2426,-20,0,300,0,6
2,2392,2547,-155,0,45,0,6
2,2305,2479,-174,0,45,1,6
2,2454,2498,-44,0,300,0,6
2,2583,2434,149,0,213,1,6
2,2276,2408,-132,0,45,0,6
2,2299,2531,-232,0,57,0,6
2,2507,2577,-70,0,337,1,6
2,2431,2463,-32,4,335,0,13
2,2246,2556,-310,0,40,0,6
2,2405,2433,-28,0,453,0,6
2,2481,2300,181,0,210,1,6
2,2495,2438,57,0,490,0,6
2,2424,2479,-55,0,318,0,6
2,2609,2746,-137,0,37,0,6
2,2497,2541,-44,0,302,1,6
2,2501,2321,180,0,300,0,6
2,2425,2417,8,0,483,1,6
2,2416,2447,-31,0,286,1,6
2,2381,2438,-57,0,242,0,6
2,2457,2417,40,0,101,1,6
2,2337,2417,-80,0,315,0,5
2,2462,2343,119,0,320,0,6
2,2429,2420,9,0,105,0,6
2,2422,2319,103,0,122,0,8
2,2431,2413,18,0,41,0,6
2,2493,2454,39,0,105,0,6
2,2476,2468,8,0,112,0,6
2,2395,2464,-69,0,300,0,6
2,2573,2735,-162,0,112,1,6
2,2421,2406,15,0,133,0,6
2,2408,2362,46,0,427,0,6
2,2311,2419,-108,0,200,0,6
2,2421,2440,-19,0,4,1,6
2,2513,2511,2,0,13,0,6
2,2526,2567,-41,0,18,0,6
2,2411,2327,84,0,104,0,6
2,2412,2435,-23,0,336,1,6
2,2640,2594,46,0,101,1,6
2,2431,2466,-35,0,7,0,6
2,2437,2495,-58,0,190,0,6
2,2488,2335,153,0,315,0,6
2,2380,2451,-71,4,201,0,13
2,2563,2566,-3,0,309,1,6
2,2556,2671,-115,0,130,0,6
2,2321,2467,-146,0,101,0,6
2,2685,2543,142,0,103,0,6
2,2579,2372,207,0,222,0,6
2,2445,2331,114,0,101,1,6
2,2515,2603,-88,0,36,0,6
2,2340,2449,-109,0,37,1,6
2,2280,2573,-293,0,440,0,6
2,2376,2421,-45,0,4,0,6
2,2310,2458,-148,0,205,0,6
2,2418,2455,-37,0,380,0,6
2,2222,2465,-243,0,0,0,6
2,2428,2269,159,0,267,0,6
2,2373,2469,-96,0,119,0,5
2,2559,2543,16,0,7,0,6
2,2219,2604,-385,0,305,0,8
2,2437,2524,-87,0,40,0,6
2,2431,2423,8,0,455,0,6
2,2522,2549,-27,0,345,1,6
2,2539,2444,95,0,242,0,6
2,2368,2535,-167,0,150,0,6
2,2338,2673,-335,0,106,0,6
2,2389,2521,-132,0,300,0,8
2,2277,2494,-217,0,27,1,6
2,2332,2492,-160,0,40,1,6
2,2335,2447,-112,0,414,0,6
2,2437,2538,-101,0,241,1,6
2,2486,2373,113,0,202,1,6
2,2410,2309,101,0,4,0,6
2,2581,2516,65,0,117,0,6
2,2532,2459,73,0,404,1,6
2,2421,2473,-52,0,112,0,6
2,2377,2421,-44,0,45,0,6
2,2446,2333,113,0,218,0,6
2,2583,2536,47,0,312,0,6
2,2632,2623,9,0,60,0,6
2,2415,2419,-4,0,337,0,6
2,2351,2414,-63,0,1,0,6
2,2420,2480,-60,0,45,0,6
2,2392,2400,-8,4,380,1,13
2,2624,2696,-72,0,25,0,6
2,2552,2422,130,0,135,0,6
2,2510,2325,185,0,128,0,6
2,2457,2600,-143,0,330,0,6
2,2502,2385,117,0,45,0,6
2,2380,2410,-30,0,9,1,6
2,2429,2448,-19,0,106,0,6
2,2363,2440,-77,0,120,0,8
2,2402,2444,-42,0,131,0,8
2,2406,2451,-45,0,132,0,6
2,2478,2402,76,0,200,0,6
2,2251,2586,-335,0,61,0,6
2,2603,2542,61,0,0,0,6
2,2337,2414,-77,0,50,0,6
2,2469,2489,-20,0,48,1,6
2,2427,2373,54,0,115,0,6
2,2444,2338,106,0,474,0,6
2,2645,2523,122,0,241,1,6
2,2303,2462,-159,0,157,0,6
2,2399,2528,-129,0,150,0,6
2,2284,2426,-142,0,102,0,6
2,2561,2523,38,0,157,1,6
2,2412,2391,21,0,40,0,6
2,2437,2379,58,0,338,0,6
2,2487,2458,29,0,0,0,6
2,2408,2403,5,0,15,1,6
2,2296,2637,-341,0,190,0,6
2,2445,2486,-41,0,190,0,6
2,2328,2410,-82,0,100,1,6
2,2372,2411,-39,0,463,0,6
2,2536,2411,125,0,112,0,6
2,2389,2422,-33,0,111,0,6
2,2488,2383,105,0,310,1,6
2,2538,2480,58,0,48,0,6
2,2585,2544,41,0,100,0,6
2,2630,2621,9,0,190,0,6
2,2375,2420,-45,0,320,0,6
2,2264,2675,-411,2,45,0,24
2,2525,2401,124,0,404,0,6
2,2548,2493,55,0,202,0,6
2,2291,2407,-116,0,40,1,6
2,2553,2384,169,0,477,0,6
2,2237,2485,-248,0,101,0,6
2,2497,2337,160,0,20,0,6
2,2283,2601,-318,4,285,0,8
2,2437,2365,72,0,40,0,8
2,2439,2554,-115,0,246,0,6
2,2396,2484,-88,0,234,0,6
2,2520,2473,47,0,335,0,6
2,2425,2453,-28,0,45,0,6
2,2361,2423,-62,0,106,0,6
2,2491,2388,103,0,46,0,6
2,2432,2434,-2,0,190,1,6
2,2464,2471,-7,0,41,0,6
2,2219,2555,-336,0,344,0,6
2,2353,2455,-102,0,3,0,6
2,2430,2295,135,0,45,0,6
2,2381,2553,-172,0,132,0,6
2,2251,2541,-290,0,302,0,6
2,2222,2417,-195,0,269,0,5
2,2510,2627,-117,0,88,1,6
2,2204,2514,-310,0,332,0,7
2,2416,2393,23,0,4,0,6
2,2269,2421,-152,0,45,0,6
2,2437,2420,17,0,22,0,6
2,2402,2415,-13,0,345,0,6
2,2424,2403,21,0,247,0,6
2,2444,2411,33,0,2,0,6
2,2500,2254,246,0,305,0,6
2,2396,2463,-67,0,8,0,6
2,2599,2478,121,0,40,0,6
2,2379,2470,-91,0,485,1,6
2,2268,2446,-178,0,113,0,6
2,2411,2402,9,0,40,0,6
2,2394,2454,-60,0,172,0,6
2,2396,2465,-69,0,40,1,6
2,2323,2415,-92,0,45,0,8
2,2342,2447,-105,0,345,1,6
2,2457,2464,-7,0,288,0,6
2,2513,2503,10,0,45,0,6
2,2339,2404,-65,0,7,1,6
2,2396,2560,-164,0,40,0,6
2,2389,2471,-82,0,200,0,6
2,2429,2377,52,0,315,0,6
2,2393,2411,-18,0,178,0,6
2,2403,2406,-3,0,15,0,6
2,2437,2480,-43,0,45,1,6
2,2522,2398,124,0,49,0,6
2,2324,2414,-90,0,123,0,8
2,2458,2507,-49,0,110,0,6
2,2340,2496,-156,0,131,1,6
2,2597,2616,-19,0,112,0,6
2,2470,2427,43,0,242,0,6
2,2220,2407,-187,0,8,0,8
2,2336,2471,-135,0,22,1,6
2,2515,2772,-257,0,103,0,6
2,2397,2526,-129,0,405,0,6
2,2545,2434,111,0,300,0,6
2,2447,2456,-9,0,14,0,6
2,2433,2374,59,0,46,0,6
2,2205,2425,-220,0,102,0,6
2,2248,2422,-174,0,15,0,6
2,2434,2278,156,0,205,0,6
2,2448,2566,-118,0,250,0,6
2,2271,2431,-160,0,125,0,6
2,2393,2400,-7,0,40,0,6
2,2439,2424,15,0,190,0,6
2,2262,2705,-443,0,487,1,6
2,2433,2451,-18,0,4,0,6
2,2476,2489,-13,0,5,1,6
2,2420,2442,-22,0,152,0,6
2,2445,2435,10,0,260,0,6
2,2329,2423,-94,0,133,0,6
2,2292,2662,-370,0,120,0,6
2,2466,2528,-62,0,180,0,6
2,2447,2595,-148,0,115,0,6
2,2388,2533,-145,0,452,0,6
2,2335,2506,-171,0,430,0,6
2,2398,2488,-90,0,45,1,6
2,2539,2418,121,0,90,0,6
2,2343,2468,-125,0,1,0,6
2,2309,2432,-123,0,41,0,6
2,2421,2489,-68,0,0,0,6
2,2463,2275,188,0,132,0,6
2,2473,2477,-4,0,341,0,6
2,2433,2352,81,0,110,0,6
2,2512,2332,180,0,40,1,6
2,2427,2336,91,0,125,0,6
2,2343,2481,-138,4,101,0,8
2,2448,2269,179,0,140,1,6
2,2457,2524,-67,0,428,0,6
2,2378,2412,-34,0,127,1,6
2,2355,2574,-219,0,221,0,6
2,2473,2468,5,0,112,0,6
2,2438,2426,12,0,45,1,6
2,2228,2450,-222,0,117,0,6
2,2486,2499,-13,0,4,1,6
2,2339,2419,-80,0,100,0,6
2,2406,2376,30,0,40,0,6
2,2503,2367,136,0,200,0,6
2,2404,2348,56,0,133,0,6
2,2450,2536,-86,0,125,1,6
2,2453,2265,188,0,345,0,6
2,2478,2319,159,0,20,0,6
2,2555,2400,155,0,277,1,6
2,2401,2421,-20,0,100,0,6
2,2297,2407,-110,0,0,0,6
2,2282,2453,-171,0,302,0,6
2,2383,2493,-110,0,278,0,6
2,2413,2334,79,0,353,0,6
2,2520,2511,9,0,149,0,6
2,2384,2467,-83,0,245,1,6
2,2417,2400,17,0,36,0,6
2,2366,2405,-39,0,92,0,6
2,2604,2648,-44,0,13,0,6
2,2259,2557,-298,0,6,0,6
2,2329,2510,-181,0,129,0,6
2,2563,2547,16,0,45,0,6
2,2401,2356,45,0,106,0,6
2,2509,2458,51,0,123,1,6
2,2390,2453,-63,0,395,1,6
2,2427,2416,11,0,107,0,6
2,2322,2454,-132,0,20,0,6
2,2577,2389,188,0,131,1,6
2,2400,2349,51,0,57,0,6
2,2423,2343,80,0,200,0,6
2,2256,2553,-297,0,40,0,6
2,2479,2504,-25,0,40,0,8
2,2213,2562,-349,0,4,0,6
2,2441,2337,104,0,123,1,6
2,2441,2300,141,0,118,0,6
2,2516,2521,-5,0,256,0,6
2,2366,2418,-52,0,112,0,6
2,2401,2397,4,0,80,0,8
2,2310,2424,-114,0,65,0,6
2,2507,2462,45,0,210,0,6
2,2459,2285,174,0,101,1,6
2,2435,2499,-64,0,112,0,6
2,2379,2554,-175,0,145,0,6
2,2346,2414,-68,0,277,0,6
2,2408,2337,71,0,4,0,6
2,2457,2494,-37,0,249,0,6
2,2290,2413,-123,0,1,0,6
2,2566,2531,35,0,140,0,6
2,2719,2588,131,0,241,0,6
2,2418,2428,-10,0,46,1,6
2,2451,2444,7,0,105,0,6
2,2477,2425,52,0,288,0,6
2,2315,2403,-88,0,4,1,6
2,2381,2548,-167,0,302,0,6
2,2276,2444,-168,0,16,1,6
2,2533,2545,-12,0,343,0,6
2,2402,2322,80,0,484,0,6
2,2320,2490,-170,0,464,0,6
2,2550,2533,17,0,190,0,6
2,2515,2540,-25,0,310,0,6
2,2421,2350,71,0,47,0,6
2,2407,2451,-44,0,106,0,6
2,2570,2566,4,0,13,0,6
2,2478,2474,4,0,0,0,6
2,2460,2296,164,0,15,0,6
2,2261,2407,-146,0,46,0,6
2,2315,2567,-252,0,58,0,6
2,2456,2536,-80,0,43,0,6
2,2384,2424,-40,0,1,0,6
2,2501,2306,195,0,150,1,8
2,2405,2274,131,0,4,0,6
2,2300,2402,-102,0,302,0,6
2,2479,2433,46,0,306,0,6
2,2413,2444,-31,0,88,0,6
2,2433,2376,57,0,53,0,6
2,2533,2568,-35,0,141,0,6
2,2404,2431,-27,0,100,0,6
2,2497,2565,-68,0,15,1,6
2,2390,2534,-144,0,122,0,6
2,2531,2391,140,0,300,0,6
2,2450,2298,152,0,46,0,6
2,2433,2538,-105,0,40,0,6
2,2256,2409,-153,0,141,1,6
2,2593,2486,107,0,302,0,6
2,2365,2452,-87,0,112,1,6
2,2433,2434,-1,0,53,0,6
2,2373,2416,-43,0,454,0,6
2,2536,2370,166,0,20,1,6
2,2268,2505,-237,0,143,0,6
2,2308,2413,-105,0,41,0,6
2,2334,2408,-74,0,0,0,6
2,2407,2529,-122,0,114,0,6
2,2424,2416,8,0,424,0,6
2,2220,2510,-290,0,36,0,6
2,2424,2462,-38,0,10,0,6
2,2491,2443,48,0,11,0,6
2,2474,2353,121,0,448,1,6
2,2424,2242,182,0,15,1,8
2,2413,2245,168,0,261,1,6
2,2477,2729,-252,0,106,1,6
2,2297,2434,-137,0,125,0,6
2,2294,2415,-121,0,5,0,6
2,2417,2337,80,0,112,0,6
2,2441,2308,133,0,11,0,6
2,2616,2774,-158,0,386,0,6
2,2679,2524,155,0,210,1,6
2,2359,2415,-56,0,41,0,6
2,2469,2495,-26,0,315,1,6
2,2464,2394,70,0,200,0,6
2,2466,2408,58,0,167,0,6
2,2293,2678,-385,0,40,0,6
2,2355,2412,-57,0,122,0,6
2,2448,2486,-38,0,9,0,6
2,2277,2579,-302,0,10,1,6
2,2426,2419,7,0,138,0,8
2,2317,2472,-155,0,0,0,6
2,2435,2499,-64,0,123,0,6
2,2422,2521,-99,0,241,0,6
2,2406,2363,43,0,310,0,8
2,2383,2503,-120,0,134,0,6
2,2398,2558,-160,0,284,0,6
2,2549,2276,273,0,43,0,6
2,2310,2432,-122,0,194,0,6
2,2445,2474,-29,0,102,1,6
2,2323,2507,-184,0,132,0,6
2,2254,2476,-222,0,101,0,6
2,2441,2425,16,0,207,0,8
2,2352,2452,-100,0,389,0,6
2,2425,2312,113,0,8,1,6
2,2459,2513,-54,0,2,1,6
2,2478,2491,-13,0,241,1,6
2,2274,2476,-202,0,288,0,8
2,2397,2461,-64,0,150,0,6
2,2468,2362,106,0,330,1,6
2,2541,2539,2,0,246,0,6
2,2524,2632,-108,0,300,1,6
2,2458,2409,49,0,201,0,6
2,2243,2400,-157,0,140,0,6
2,2399,2475,-76,0,200,0,6
2,2386,2474,-88,0,123,0,6
2,2580,2528,52,0,40,0,6
2,2570,2530,40,0,122,0,6
2,2623,2582,41,0,341,1,6
2,2467,2450,17,0,100,1,6
2,2583,2477,106,0,111,0,6
2,2440,2524,-84,0,45,0,6
2,2287,2402,-115,0,242,0,6
2,2303,2508,-205,0,15,0,6
2,2313,2461,-148,0,52,1,6
2,2378,2523,-145,0,21,0,6
2,2213,2401,-188,0,304,0,8
2,2407,2218,189,0,121,0,6
2,2417,2328,89,0,301,0,6
2,2272,2419,-147,0,114,1,6
2,2517,2420,97,0,15,0,6
2,2381,2410,-29,0,45,0,6
2,2425,2412,13,4,335,0,13
2,2406,2224,182,0,284,0,6
2,2582,2556,26,0,103,0,6
2,2311,2520,-209,0,134,0,6
2,2476,2414,62,0,398,1,6
2,2385,2447,-62,0,245,0,6
2,2378,2452,-74,0,4,1,6
2,2367,2415,-48,0,288,1,6
2,2459,2424,35,0,115,1,6
2,2423,2436,-13,0,15,0,6
2,2439,2321,118,0,30,0,8
2,2372,2452,-80,0,113,0,6
2,2463,2403,60,0,90,0,6
2,2366,2457,-91,0,1,0,6
2,2511,2558,-47,0,326,0,6
2,2339,2656,-317,0,0,1,6
2,2415,2467,-52,0,140,1,6
2,2439,2479,-40,0,205,0,6
2,2535,2621,-86,0,45,0,6
2,2453,2481,-28,0,201,0,6
2,2387,2445,-58,0,56,0,6
2,2529,2609,-80,0,112,0,6
2,2692,2618,74,0,106,1,6
2,2458,2442,16,0,395,1,6
2,2484,2436,48,0,80,1,6
2,2290,2414,-124,0,201,0,6
2,2428,2488,-60,0,106,1,6
2,2829,2508,321,0,216,0,6
2,2656,2417,239,0,10,0,6
2,2425,2815,-390,0,258,0,6
2,2365,2438,-73,0,16,0,6
2,2333,2410,-77,0,140,0,6
2,2532,2487,45,0,141,0,6
2,2308,2491,-183,0,140,0,6
2,2454,2393,61,0,11,0,6
2,2455,2578,-123,0,120,0,6
2,2448,2354,94,0,337,0,6
2,2425,2453,-28,0,191,0,6
2,2563,2504,59,0,267,0,6
2,2330,2444,-114,0,46,0,6
2,2421,2324,97,0,306,1,6
2,2654,2488,166,0,103,0,6
2,2447,2368,79,0,140,0,6
2,2491,2550,-59,0,380,0,6
2,2323,2610,-287,0,125,0,6
2,2295,2459,-164,0,110,0,6
2,2663,2726,-63,0,122,0,6
2,2282,2547,-265,0,132,1,6
2,2347,2401,-54,0,33,0,6
2,2671,2552,119,0,7,0,6
2,2433,2433,0,0,3,0,6
2,2416,2352,64,0,47,0,6
2,2382,2450,-68,0,3,0,6
2,2460,2503,-43,0,130,0,6
2,2385,2405,-20,0,125,0,6
2,2257,2421,-164,0,5,0,6
2,2595,2500,95,0,43,1,6
2,2374,2412,-38,0,143,1,6
2,2566,2507,59,0,411,1,6
2,2580,2536,44,0,123,0,6
2,2419,2395,24,0,41,0,6
2,2305,2608,-303,0,20,1,6
2,2438,2389,49,0,225,0,6
2,2582,2464,118,0,304,0,6
2,2402,2285,117,0,118,0,8
2,2457,2459,-2,0,106,0,6
2,2482,2549,-67,0,123,0,6
2,2341,2469,-128,0,375,0,6
2,2408,2443,-35,0,135,0,6
2,2323,2473,-150,0,5,1,8
2,2367,2552,-185,0,40,0,6
2,2280,2439,-159,0,483,0,6
2,2454,2635,-181,0,415,1,6
2,2420,2309,111,0,333,0,6
2,2575,2457,118,0,43,1,6
2,2342,2437,-95,0,220,0,6
2,2432,2508,-76,0,400,1,6
2,2441,2251,190,0,100,1,6
2,2491,2387,104,0,483,0,6
2,2230,2405,-175,0,101,0,6
2,2296,2456,-160,0,269,0,6
2,2244,2516,-272,0,111,1,6
2,2507,2424,83,0,112,0,6
2,2722,2557,165,0,202,1,6
2,2431,2473,-42,0,453,0,6
2,2429,2408,21,0,40,0,6
2,2450,2501,-51,0,121,1,6
2,2412,2471,-59,0,216,0,6
2,2416,2556,-140,0,101,0,6
2,2543,2602,-59,0,106,1,6
2,2462,2447,15,0,107,0,6
2,2260,2489,-229,0,103,0,8
2,2248,2500,-252,0,80,0,6
2,2557,2412,145,0,4,1,6
2,2716,2792,-76,0,267,0,6
2,2265,2557,-292,0,46,0,6
2,2349,2504,-155,0,107,0,6
2,2298,2429,-131,0,311,0,6
2,2450,2468,-18,0,158,1,6
2,2420,2426,-6,0,9,0,6
2,2418,2412,6,0,7,1,6
2,2231,2422,-191,0,41,1,6
2,2528,2347,181,0,8,1,6
2,2324,2427,-103,0,20,0,6
2,2381,2467,-86,0,196,0,6
2,2347,2420,-73,0,337,0,6
2,2375,2421,-46,0,40,1,6
2,2451,2433,18,0,301,0,6
2,2489,2602,-113,0,45,0,6
2,2366,2405,-39,0,339,0,6
2,2466,2455,11,0,4,0,6
2,2352,2473,-121,0,310,0,6
2,2775,2513,262,0,190,0,6
2,2493,2569,-76,0,338,1,6
2,2427,2508,-81,0,267,0,6
2,2341,2437,-96,0,107,1,6
2,2523,2439,84,0,45,0,6
2,2272,2412,-140,0,414,0,6
2,2566,2568,-2,0,151,0,6
2,2561,2508,53,0,45,0,6
2,2284,2472,-188,0,0,1,6
2,2295,2416,-121,0,106,1,6
2,2226,2401,-175,0,319,0,6
2,2468,2439,29,0,105,0,6
2,2422,2533,-111,0,110,0,6
2,2703,2694,9,0,257,0,6
2,2351,2454,-103,0,359,0,6
2,2415,2308,107,0,40,0,6
2,2443,2387,56,0,406,0,6
2,2462,2476,-14,0,154,1,6
2,2426,2426,0,0,194,0,6
2,2271,2420,-149,0,332,0,6
2,2474,2247,227,0,106,1,6
2,2501,2265,236,0,115,0,6
2,2324,2403,-79,0,131,1,6
2,2333,2406,-73,0,302,1,8
2,2411,2426,-15,0,59,0,6
2,2283,2503,-220,0,200,0,6
2,2505,2418,87,0,476,0,6
2,2383,2456,-73,0,40,0,6
2,2306,2464,-158,0,48,0,6
2,2395,2520,-125,0,4,0,6
2,2509,2539,-30,0,63,1,6
2,2489,2393,96,0,101,0,6
2,2443,2438,5,0,122,0,6
2,2477,2508,-31,0,16,1,6
2,2344,2411,-67,0,80,0,6
2,2327,2402,-75,0,130,0,6
2,2425,2423,2,0,40,1,6
2,2453,2588,-135,0,106,0,6
2,2510,2457,53,0,45,1,6
2,2509,2373,136,0,43,1,6
2,2296,2410,-114,0,130,1,6
2,2319,2541,-222,0,176,0,6
2,2364,2536,-172,0,20,0,6
2,2404,2451,-47,0,114,0,6
2,2326,2425,-99,0,317,0,6
2,2445,2514,-69,0,190,0,6
2,2293,2463,-170,0,101,1,6
2,2458,2316,142,0,122,0,6
2,2508,2456,52,0,315,1,6
2,2536,2692,-156,0,14,0,6
2,2474,2480,-6,0,244,0,6
2,2592,2806,-214,0,125,0,6
2,2506,2532,-26,0,145,0,6
2,2254,2489,-235,4,308,1,8
2,2287,2405,-118,0,277,0,6
2,2317,2477,-160,0,300,1,6
2,2522,2619,-97,0,265,0,6
2,2440,2310,130,0,130,0,6
2,2449,2412,37,0,310,1,6
2,2420,2351,69,0,20,0,6
2,2422,2367,55,0,15,0,6
2,2362,2423,-61,0,40,0,6
2,2474,2465,9,0,30,0,6
2,2426,2601,-175,0,101,1,6
2,2506,2574,-68,0,314,0,6
2,2511,2451,60,0,330,1,6
2,2460,2487,-27,0,394,0,6
2,2352,2410,-58,0,130,0,6
2,2456,2503,-47,0,265,0,6
2,2241,2442,-201,0,218,0,6
2,2336,2415,-79,4,202,0,13
2,2599,2406,193,0,109,0,6
2,2439,2455,-16,0,112,0,6
2,2439,2445,-6,0,320,0,6
2,2529,2518,11,0,168,0,6
2,2562,2306,256,0,255,0,6
2,2408,2394,14,0,200,0,6
2,2409,2346,63,0,267,0,6
2,2365,2411,-46,0,106,0,6
2,2548,2454,94,0,318,0,6
2,2427,2296,131,0,15,0,6
2,2498,2594,-96,0,373,0,6
2,2519,2483,36,0,122,1,6
2,2226,2582,-356,0,448,0,5
2,2278,2486,-208,0,4,0,6
2,2413,2523,-110,0,102,0,6
2,2312,2411,-99,0,3,0,6
2,2390,2492,-102,0,260,0,6
2,2346,2520,-174,0,107,1,6
2,2456,2586,-130,0,140,0,6
2,2230,2428,-198,0,41,0,6
2,2424,2569,-145,0,102,0,6
2,2339,2423,-84,0,45,0,6
2,2357,2405,-48,0,65,0,6
2,2466,2545,-79,0,427,0,6
2,2564,2348,216,0,45,0,6
2,2396,2455,-59,0,311,0,6
2,2627,2635,-8,0,112,0,6
2,2401,2390,11,0,102,0,6
2,2539,2527,12,0,148,0,6
2,2230,2400,-170,0,335,0,6
2,2408,2501,-93,0,190,0,6
2,2401,2371,30,0,453,1,6
2,2632,2588,44,0,216,1,6
2,2578,2439,139,0,101,0,6
2,2643,2303,340,0,131,0,6
2,2512,2491,21,0,101,0,6
2,2417,2362,55,0,463,0,6
2,2406,2312,94,0,27,0,6
2,2523,2442,81,0,101,0,6
2,2385,2402,-17,0,115,1,6
2,2495,2477,18,0,31,0,6
2,2432,2486,-54,4,133,0,13
2,2449,2302,147,0,45,1,6
2,2376,2476,-100,0,255,0,6
2,2547,2477,70,0,101,0,6
2,2509,2595,-86,0,343,0,6
2,2389,2571,-182,0,3,0,6
2,2414,2473,-59,0,302,0,6
2,2458,2380,78,0,218,0,6
2,2494,2500,-6,0,1,1,6
2,2392,2624,-232,0,474,1,6
2,2587,2403,184,0,200,0,6
2,2266,2431,-165,0,389,0,6
2,2443,2508,-65,0,484,1,6
2,2478,2376,102,0,192,0,6
2,2677,2505,172,0,337,0,6
2,2365,2510,-145,0,101,1,6
2,2565,2511,54,0,111,0,6
2,2454,2471,-17,0,225,0,6
2,2552,2617,-65,0,15,0,6
2,2313,2539,-226,0,176,0,6
2,2240,2500,-260,0,302,0,6
2,2368,2414,-46,0,1,0,6
2,2415,2285,130,0,13,0,6
2,2662,2202,460,0,144,1,6
2,2272,2522,-250,0,351,1,6
2,2310,2410,-100,0,36,1,6
2,2377,2407,-30,0,302,0,6
2,2647,2431,216,0,100,0,6
2,2284,2402,-118,0,118,0,6
2,2362,2452,-90,0,201,0,6
2,2338,2468,-130,0,341,0,6
2,2422,2438,-16,0,46,0,6
2,2340,2405,-65,0,374,0,6
2,2368,2430,-62,0,411,0,6
2,2218,2413,-195,0,257,0,8
2,2570,2403,167,0,45,0,6
2,2420,2436,-16,0,112,0,8
2,2419,2661,-242,0,133,0,6
2,2391,2455,-64,0,380,0,6
2,2541,2404,137,0,45,0,6
2,2409,2369,40,0,25,1,6
2,2564,2415,149,0,242,0,6
2,2528,2514,14,0,245,0,6
2,2414,2332,82,0,140,0,6
2,2560,2607,-47,0,213,1,6
2,2341,2454,-113,0,106,0,6
2,2315,2480,-165,0,15,1,6
2,2273,2423,-150,0,102,0,6
2,2287,2419,-132,0,45,0,6
2,2529,2444,85,0,337,0,6
2,2413,2358,55,0,315,0,6
2,2414,2329,85,0,100,0,6
2,2451,2404,47,0,0,1,6
2,2435,2383,52,0,190,0,6
2,2408,2435,-27,0,220,1,6
2,2454,2521,-67,0,40,0,6
2,2488,2543,-55,0,211,1,6
2,2392,2468,-76,0,101,0,6
2,2557,2578,-21,0,0,0,6
2,2434,2452,-18,0,150,0,6
2,2310,2413,-103,0,247,0,6
2,2442,2483,-41,0,373,0,6
2,2267,2405,-138,0,47,0,6
2,2547,2528,19,0,403,0,6
2,2321,2471,-150,0,193,0,6
2,2622,2472,150,0,41,0,6
2,2391,2494,-103,0,205,0,6
2,2413,2418,-5,0,398,0,6
2,2584,2643,-59,0,45,1,6
2,2514,2496,18,0,389,0,6
2,2430,2441,-11,0,122,1,6
2,2488,2556,-68,0,6,0,6
2,2491,2536,-45,0,244,0,6
2,2306,2494,-188,0,122,0,6
2,2277,2437,-160,0,392,1,6
2,2596,2620,-24,0,454,0,6
2,2263,2425,-162,0,122,0,6
2,2507,2549,-42,0,344,0,6
2,2508,2497,11,0,311,0,6
2,2544,2530,14,0,197,0,6
2,2289,2454,-165,0,41,0,6
2,2436,2337,99,0,150,0,6
2,2313,2401,-88,0,48,0,6
2,2204,2476,-272,0,40,0,6
2,2388,2433,-45,0,13,0,6
2,2415,2314,101,0,240,0,6
2,2486,2374,112,0,440,0,6
2,2382,2425,-43,0,241,0,6
2,2491,2412,79,0,104,1,6
2,2303,2459,-156,0,120,1,6
2,2530,2503,27,0,102,0,6
2,2502,2439,63,0,415,0,6
2,2393,2545,-152,0,40,0,6
2,2751,2647,104,0,277,0,6
2,2335,2449,-114,0,122,0,6
2,2402,2439,-37,0,409,0,6
2,2439,2459,-20,0,9,1,6
2,2453,2330,123,0,120,0,6
2,2321,2408,-87,0,302,0,6
2,2415,2403,12,0,101,0,6
2,2481,2525,-44,0,45,0,6
2,2247,2448,-201,0,58,0,6
2,2427,2331,96,0,112,0,6
2,2333,2464,-131,0,140,1,6
2,2301,2418,-117,0,132,0,8
2,2322,2450,-128,0,31,0,6
2,2341,2409,-68,0,300,0,6
2,2279,2466,-187,0,330,0,6
2,2281,2410,-129,0,200,0,6
2,2380,2401,-21,0,40,0,6
2,2624,2606,18,0,0,0,6
2,2437,2443,-6,0,0,0,6
2,2259,2411,-152,0,200,0,6
2,2440,2535,-95,0,40,0,6
2,2677,2687,-10,0,88,0,6
2,2264,2456,-192,0,6,0,6
2,2401,2306,95,0,492,0,6
2,2468,2370,98,0,301,0,6
2,2332,2413,-81,0,45,1,6
2,2414,2580,-166,0,292,1,6
2,2261,2823,-562,0,4,0,6
2,2602,2604,-2,0,209,0,6
2,2476,2572,-96,0,2,0,6
2,2308,2435,-127,0,474,0,6
2,2535,2433,102,0,153,0,6
2,2434,2547,-113,0,196,0,6
2,2410,2229,181,0,302,0,6
2,2380,2489,-109,0,487,0,6
2,2221,2460,-239,0,310,0,6
2,2359,2415,-56,0,3,1,6
2,2444,2358,86,0,102,0,6
2,2418,2441,-23,0,4,0,6
2,2692,2759,-67,0,107,0,6
2,2510,2677,-167,0,300,0,6
2,2482,2546,-64,0,145,0,6
2,2671,2646,25,0,466,0,6
2,2427,2287,140,0,213,0,6
2,2256,2429,-173,0,45,0,6
2,2572,2509,63,0,150,0,6
2,2336,2436,-100,0,43,0,6
2,2351,2530,-179,0,28,0,6
2,2480,2496,-16,0,147,0,6
2,2423,2405,18,0,46,0,6
2,2569,2617,-48,0,278,0,6
2,2415,2401,14,0,196,1,6
2,2423,2526,-103,0,207,0,6
2,2438,2488,-50,0,45,0,6
2,2511,2458,53,0,100,0,6
2,2453,2419,34,0,112,0,6
2,2230,2401,-171,0,122,0,6
2,2285,2450,-165,0,9,0,6
2,2591,2834,-243,0,474,1,6
2,2471,2304,167,0,302,0,6
2,2412,2436,-24,0,36,0,6
2,2404,2567,-163,0,309,1,6
2,2405,2490,-85,0,250,0,6
2,2284,2668,-384,0,302,0,6
2,2503,2547,-44,0,45,0,6
2,2414,2425,-11,0,4,0,6
2,2390,2457,-67,0,336,1,6
2,2393,2418,-25,0,29,0,6
2,2372,2440,-68,0,40,0,8
2,2250,2406,-156,0,278,0,6
2,2392,2463,-71,0,4,1,6
2,2501,2360,141,0,225,0,6
2,2467,2613,-146,0,41,0,6
2,2415,2452,-37,0,123,1,6
2,2329,2449,-120,0,46,0,6
2,2477,2536,-59,0,41,0,6
2,2433,2520,-87,0,13,1,6
2,2542,2463,79,0,56,0,6
2,2238,2412,-174,0,20,0,8
2,2436,2256,180,0,311,0,6
2,2382,2458,-76,0,104,0,6
2,2511,2553,-42,0,140,0,6
2,2525,2494,31,0,45,0,6
2,2399,2442,-43,0,45,0,6
2,2484,2413,71,0,128,0,6
2,2403,2477,-74,0,312,0,6
2,2323,2449,-126,0,306,1,6
2,2307,2403,-96,0,110,0,8
2,2224,2403,-179,0,59,0,6
2,2351,2412,-61,0,255,0,6
2,2275,2424,-149,0,46,1,6
2,2298,2426,-128,0,123,0,6
2,2436,2407,29,0,150,0,6
2,2244,2425,-181,0,453,0,6
2,2402,2398,4,0,337,0,6
2,2518,2442,76,0,8,0,6
2,2409,2507,-98,0,143,1,6
2,2663,2625,38,0,1,0,6
2,2355,2499,-144,0,300,0,6
2,2449,2284,165,0,487,0,6
2,2308,2442,-134,0,200,0,6
2,2330,2447,-117,0,25,0,6
2,2467,2479,-12,0,121,0,6
2,2388,2497,-109,0,141,0,6
2,2330,2485,-155,0,460,0,8
2,2622,2623,-1,0,122,0,6
2,2450,2381,69,0,72,0,6
2,2471,2510,-39,0,300,0,6
2,2294,2423,-129,0,57,0,8
2,2287,2403,-116,0,245,1,6
2,2411,2375,36,0,4,0,6
2,2431,2454,-23,0,15,0,6
2,2498,2466,32,0,150,1,6
2,2535,2402,133,0,4,1,6
2,2514,2520,-6,0,353,0,6
2,2403,2364,39,0,138,0,6
2,2458,2535,-77,0,141,1,6
2,2345,2433,-88,0,121,0,6
2,2537,2274,263,0,2,0,6
2,2432,2300,132,0,470,1,6
2,2489,2415,74,0,331,1,6
2,2421,2574,-153,0,40,0,6
2,2267,2605,-338,0,457,0,6
2,2481,2243,238,0,140,0,6
2,2391,2472,-81,0,129,1,5
2,2468,2432,36,0,145,1,6
2,2794,2609,185,0,45,1,6
2,2442,2569,-127,0,304,0,6
2,2477,2600,-123,0,0,1,6
2,2309,2436,-127,0,45,0,6
2,2536,2637,-101,0,40,0,6
2,2239,2499,-260,0,45,0,8
2,2465,2449,16,0,49,1,6
2,2341,2568,-227,0,101,1,6
2,2488,2452,36,0,4,0,6
2,2454,2373,81,0,455,1,6
2,2297,2418,-121,0,112,0,6
2,2400,2277,123,0,354,0,8
2,2390,2430,-40,0,20,1,6
2,2467,2494,-27,0,102,0,6
2,2491,2498,-7,0,113,0,6
2,2407,2428,-21,0,40,1,6
2,2411,2310,101,0,108,1,6
2,2271,2413,-142,0,211,0,6
2,2469,2445,24,0,40,0,6
2,2770,2694,76,0,22,1,6
2,2437,2366,71,0,415,1,6
2,2511,2454,57,0,4,0,6
2,2430,2399,31,0,0,0,6
2,2543,2398,145,0,113,0,6
2,2602,2465,137,0,345,0,6
2,2365,2411,-46,0,48,0,6
2,2397,2471,-74,0,315,0,6
2,2396,2542,-146,0,435,0,6
2,2347,2516,-169,0,40,1,6
2,2404,2660,-256,0,13,0,6
2,2374,2436,-62,0,250,1,6
2,2308,2433,-125,0,208,0,6
2,2636,2478,158,0,15,0,6
2,2453,2432,21,0,459,0,6
2,2451,2620,-169,0,150,0,6
2,2569,2506,63,0,260,0,6
2,2584,2521,63,0,80,0,6
2,2321,2426,-105,0,105,0,6
2,2406,2378,28,0,0,1,6
2,2385,2515,-130,0,80,0,6
2,2538,2609,-71,0,380,0,6
2,2493,2343,150,0,43,0,6
2,2253,2516,-263,0,40,0,6
2,2463,2487,-24,0,15,1,6
2,2565,2536,29,0,300,1,6
2,2442,2472,-30,0,380,0,6
2,2437,2439,-2,0,436,0,6
2,2269,2481,-212,0,255,0,6
2,2420,2560,-140,0,101,0,6
2,2778,2688,90,0,28,0,6
2,2396,2429,-33,0,201,0,8
2,2473,2363,110,0,106,0,6
2,2412,2284,128,0,400,1,6
2,2435,2390,45,0,114,0,6
2,2406,2388,18,0,115,0,8
2,2264,2421,-157,0,45,0,6
2,2367,2556,-189,0,60,0,6
2,2512,2421,91,0,45,0,6
2,2475,2499,-24,0,115,0,6
2,2438,2320,118,0,1,0,6
2,2420,2309,111,0,106,1,8
2,2405,2673,-268,0,3,0,6
2,2439,2368,71,0,122,0,6
2,2436,2545,-109,0,192,0,6
2,2601,2674,-73,0,4,0,6
2,2435,2367,68,0,15,0,6
2,2490,2376,114,0,106,0,6
2,2334,2438,-104,0,327,0,6
2,2523,2333,190,0,4,0,6
2,2210,2405,-195,0,43,0,5
2,2688,2671,17,0,101,0,6
2,2385,2464,-79,0,45,1,6
2,2730,2354,376,0,1,0,6
2,2463,2511,-48,0,301,0,6
2,2508,2526,-18,0,331,0,6
2,2334,2416,-82,0,300,0,6
2,2281,2405,-124,0,106,0,6
2,2560,2524,36,0,45,0,6
2,2387,2455,-68,0,101,1,6
2,2421,2423,-2,0,58,0,6
2,2427,2408,19,0,142,1,8
2,2336,2420,-84,0,190,0,8
2,2313,2404,-91,0,156,0,6
2,2445,2374,71,0,15,1,6
2,2405,2399,6,0,4,0,6
2,2273,2405,-132,0,115,0,6
2,2360,2431,-71,0,302,1,6
2,2451,2321,130,0,300,1,6
2,2523,2472,51,0,380,1,6
2,2345,2529,-184,0,131,1,6
2,2569,2616,-47,0,13,1,6
2,2443,2415,28,0,45,0,6
2,2422,2380,42,0,395,0,6
2,2290,2440,-150,0,8,0,6
2,2246,2450,-204,0,49,0,6
2,2379,2440,-61,0,229,0,6
2,2444,2460,-16,0,123,0,6
2,2501,2388,113,0,107,0,6
2,2288,2536,-248,0,301,0,6
2,2499,2639,-140,0,106,1,6
2,2468,2441,27,0,242,0,6
2,2447,2420,27,0,40,0,6
2,2492,2476,16,0,210,0,6
2,2395,2413,-18,0,11,0,6
2,2561,2611,-50,0,253,1,6
2,2415,2437,-22,0,303,0,6
2,2447,2473,-26,0,14,1,6
2,2445,2473,-28,0,242,0,6
2,2371,2418,-47,0,80,0,6
2,2446,2423,23,0,381,0,6
2,2402,2427,-25,0,479,0,6
2,2539,2497,42,0,101,0,6
2,2460,2385,75,0,40,0,6
2,2322,2445,-123,0,41,0,6
2,2424,2501,-77,0,241,0,6
2,2313,2449,-136,0,337,0,6
2,2412,2329,83,0,414,0,6
2,2408,2384,24,0,15,0,6
2,2440,2295,145,0,453,1,6
2,2388,2448,-60,0,190,0,6
2,2382,2439,-57,0,190,0,6
2,2365,2488,-123,0,154,0,6
2,2684,2600,84,0,487,0,6
2,2325,2472,-147,0,148,0,6
2,2522,2586,-64,0,110,1,6
2,2424,2419,5,0,242,0,6
2,2383,2420,-37,0,241,0,6
2,2400,2393,7,0,395,0,6
2,2428,2402,26,0,177,0,6
2,2354,2420,-66,0,197,1,6
2,2315,2517,-202,0,145,0,6
2,2421,2550,-129,0,10,0,6
2,2523,2533,-10,0,392,0,6
2,2557,2470,87,0,247,0,6
2,2360,2432,-72,0,45,0,6
2,2420,2523,-103,0,286,0,6
2,2395,2402,-7,0,122,1,6
2,2392,2529,-137,0,242,1,6
2,2327,2418,-91,0,260,0,6
2,2401,2329,72,0,45,0,6
2,2567,2370,197,0,200,0,6
2,2402,2295,107,0,213,0,6
2,2505,2489,16,0,112,1,6
2,2399,2456,-57,0,335,1,6
2,2287,2516,-229,0,4,0,6
2,2399,2482,-83,0,40,0,6
2,2413,2438,-25,0,101,1,6
2,2365,2476,-111,0,301,1,6
2,2225,2528,-303,0,58,0,6
2,2391,2418,-27,0,0,1,6
2,2365,2403,-38,0,255,0,6
2,2398,2451,-53,0,115,0,6
2,2380,2482,-102,0,330,1,6
2,2439,2423,16,0,117,0,6
2,2467,2478,-11,0,8,0,6
2,2329,2488,-159,0,45,0,6
2,2483,2533,-50,0,49,0,6
2,2513,2481,32,0,17,0,6
2,2344,2449,-105,0,4,0,6
2,2457,2424,33,0,302,0,6
2,2422,2377,45,0,310,1,6
2,2459,2343,116,0,335,0,6
2,2395,2486,-91,0,143,0,6
2,2401,2544,-143,0,79,0,6
2,2463,2287,176,0,140,0,6
2,2460,2402,58,0,3,0,6
2,2422,2398,24,0,43,0,6
2,2690,2510,180,0,200,0,6
2,2522,2467,55,0,0,0,6
2,2356,2482,-126,0,245,0,5
2,2429,2456,-27,0,244,0,6
2,2252,2432,-180,0,40,0,6
2,2409,2373,36,0,71,0,6
2,2491,2608,-117,0,326,0,6
2,2423,2517,-94,0,245,0,6
2,2419,2421,-2,0,414,0,6
2,2350,2536,-186,0,389,0,6
2,2408,2318,90,0,189,0,6
2,2556,2668,-112,0,323,1,6
2,2467,2458,9,0,6,0,6
2,2355,2501,-146,0,302,0,8
2,2346,2600,-254,0,457,1,5
2,2550,2517,33,0,49,0,6
2,2485,2390,95,0,0,0,6
2,2384,2449,-65,0,222,0,6
2,2404,2424,-20,0,217,0,6
2,2427,2254,173,0,110,1,6
2,2459,2307,152,0,203,0,6
2,2611,2495,116,0,245,1,6
2,2405,2234,171,0,140,1,6
2,2403,2484,-81,0,0,0,6
2,2482,2420,62,0,303,0,6
2,2383,2480,-97,0,331,0,6
2,2325,2545,-220,0,395,0,6
2,2463,2555,-92,0,46,1,6
2,2517,2494,23,0,341,0,6
2,2469,2511,-42,0,28,0,6
2,2644,2697,-53,0,270,0,6
2,2448,2371,77,0,213,0,6
2,2353,2481,-128,0,0,1,6
2,2584,2427,157,0,406,0,6
2,2422,2483,-61,0,115,0,6
2,2368,2451,-83,0,188,0,6
2,2422,2446,-24,0,278,0,6
2,2243,2592,-349,0,461,0,8
2,2279,2446,-167,0,463,0,6
2,2333,2408,-75,0,347,1,6
2,2362,2433,-71,0,106,0,6
2,2350,2411,-61,0,302,0,6
2,2212,2543,-331,0,9,0,6
2,2409,2461,-52,0,256,1,6
2,2435,2537,-102,0,6,0,6
2,2233,2416,-183,0,107,0,6
2,2397,2681,-284,0,3,0,6
2,2271,2457,-186,0,3,1,6
2,2495,2524,-29,0,49,1,6
2,2418,2317,101,0,1,0,6
2,2368,2430,-62,0,112,1,6
2,2341,2464,-123,0,198,0,6
2,2528,2463,65,0,110,0,6
2,2338,2471,-133,0,85,0,6
2,2210,2530,-320,0,380,0,6
2,2486,2518,-32,0,31,0,6
2,2413,2392,21,0,306,1,6
2,2366,2425,-59,0,151,0,6
2,2412,2396,16,0,265,0,6
2,2400,2566,-166,0,9,0,6
2,2524,2432,92,0,2,0,6
2,2440,2491,-51,0,112,1,6
2,2429,2507,-78,0,461,0,6
2,2485,2240,245,0,288,0,6
2,2496,2450,46,0,230,0,6
2,2294,2478,-184,0,125,0,6
2,2547,2587,-40,0,9,0,6
2,2344,2447,-103,0,107,0,6
2,2307,2468,-161,0,100,0,8
2,2534,2563,-29,0,0,1,6
2,2381,2484,-103,0,88,0,6
2,2566,2612,-46,0,101,1,6
2,2451,2341,110,0,144,1,6
2,2468,2467,1,0,453,0,6
2,2299,2414,-115,0,200,0,6
2,2554,2552,2,0,429,0,6
2,2447,2554,-107,0,101,0,6
2,2527,2458,69,0,301,1,6
2,2341,2532,-191,0,49,0,6
2,2399,2694,-295,0,4,0,6
2,2282,2405,-123,0,27,0,6
2,2467,2512,-45,0,45,0,6
2,2438,2446,-8,0,453,0,6
2,2344,2520,-176,0,349,1,8
2,2457,2574,-117,0,13,0,6
2,2339,2407,-68,0,1,0,6
2,2364,2527,-163,0,301,0,6
2,2202,2422,-220,0,304,0,6
2,2594,2607,-13,0,406,0,6
2,2385,2482,-97,0,102,1,6
2,2435,2549,-114,0,409,0,6
2,2464,2375,89,0,203,0,6
2,2374,2505,-131,0,34,0,6
2,2539,2524,15,0,409,0,6
2,2251,2508,-257,4,255,0,8
2,2468,2545,-77,0,302,0,6
2,2461,2464,-3,0,106,0,6
2,2258,2415,-157,0,245,1,6
2,2607,2596,11,0,469,1,6
2,2276,2454,-178,0,405,0,6
2,2593,2551,42,0,3,0,6
2,2466,2478,-12,0,206,0,6
2,2444,2369,75,0,406,0,6
2,2402,2536,-134,0,211,0,6
2,2484,2502,-18,0,151,0,6
2,2412,2220,192,0,343,0,6
2,2415,2499,-84,0,45,0,6
2,2471,2327,144,0,311,0,6
2,2337,2442,-105,0,4,0,6
2,2341,2503,-162,0,45,0,6
2,2374,2421,-47,0,144,0,6
2,2432,2443,-11,0,46,1,6
2,2429,2232,197,0,414,0,6
2,2210,2487,-277,0,112,0,6
2,2401,2488,-87,0,301,0,6
2,2618,2431,187,0,0,0,6
2,2440,2410,30,0,108,0,6
2,2418,2470,-52,0,270,0,8
2,2205,2402,-197,0,487,0,6
2,2504,2500,4,0,28,0,6
2,2508,2371,137,0,101,0,6
2,2524,2402,122,0,36,0,6
2,2453,2365,88,0,49,0,6
2,2330,2432,-102,0,301,1,6
2,2410,2267,143,0,112,1,5
2,2506,2533,-27,0,107,0,6
2,2227,2520,-293,0,45,0,6
2,2361,2439,-78,0,130,0,6
2,2401,2365,36,0,211,1,6
2,2686,2681,5,0,265,0,6
2,2401,2401,0,0,0,0,6
2,2533,2593,-60,0,37,0,6
2,2643,2673,-30,0,192,0,6
2,2297,2432,-135,0,45,0,6
2,2328,2426,-98,0,306,0,6
2,2494,2440,54,0,143,0,6
2,2269,2464,-195,0,120,0,6
2,2226,2550,-324,0,13,1,6
2,2492,2495,-3,0,200,0,6
2,2366,2444,-78,0,242,0,6
2,2465,2451,14,0,311,0,6
2,2231,2564,-333,0,170,1,6
2,2319,2558,-239,0,112,0,6
2,2446,2614,-168,0,107,0,6
2,2314,2588,-274,0,343,0,6
2,2376,2520,-144,0,143,1,6
2,2339,2402,-63,0,113,1,6
2,2382,2529,-147,0,210,0,6
2,2648,2386,262,0,426,0,6
2,2500,2362,138,0,190,0,6
2,2436,2353,83,0,241,0,6
2,2308,2452,-144,0,41,0,6
2,2418,2517,-99,0,45,1,6
2,2413,2316,97,0,42,1,6
2,2438,2230,208,0,4,0,6
2,2610,2534,76,0,151,0,6
2,2267,2400,-133,0,107,0,6
2,2472,2440,32,0,45,1,6
2,2428,2430,-2,0,4,0,6
2,2423,2433,-10,0,302,0,6
2,2346,2418,-72,0,476,0,6
2,2272,2401,-129,4,10,1,13
2,2528,2703,-175,0,48,0,6
2,2401,2443,-42,0,45,0,6
2,2359,2418,-59,0,1,0,6
2,2261,2432,-171,0,122,0,6
2,2443,2331,112,0,190,0,6
2,2394,2696,-302,0,245,0,6
2,2309,2433,-124,0,302,1,6
2,2326,2501,-175,0,300,1,6
2,2410,2395,15,0,485,0,6
2,2400,2386,14,0,131,0,6
2,2318,2482,-164,0,41,0,6
2,2448,2484,-36,0,42,0,6
2,2379,2541,-162,0,193,1,6
2,2324,2419,-95,0,13,0,6
2,2572,2664,-92,0,100,0,6
2,2335,2503,-168,0,110,0,6
2,2490,2514,-24,0,302,0,6
2,2476,2341,135,0,115,0,6
2,2437,2278,159,4,277,0,13
2,2232,2418,-186,0,455,1,6
2,2488,2401,87,0,10,0,6
2,2433,2312,121,0,101,0,6
2,2330,2410,-80,0,1,0,6
2,2368,2492,-124,0,45,0,6
2,2330,2468,-138,0,301,0,6
2,2405,2429,-24,0,123,0,6
2,2410,2404,6,0,40,0,6
2,2253,2444,-191,0,106,0,6
2,2483,2422,61,0,10,0,6
2,2403,2478,-75,0,476,1,6
2,2413,2461,-48,0,242,0,6
2,2418,2561,-143,0,134,0,6
2,2677,2563,114,0,4,0,6
2,2311,2492,-181,0,0,1,6
2,2677,2643,34,0,167,0,6
2,2419,2388,31,4,485,0,13
2,2345,2421,-76,0,380,0,6
2,2290,2413,-123,0,20,0,6
2,2438,2280,158,0,422,0,6
2,2480,2517,-37,0,122,0,6
2,2432,2411,21,0,45,0,5
2,2421,2407,14,0,110,1,6
2,2626,2641,-15,0,45,0,6
2,2440,2260,180,0,400,0,5
2,2390,2537,-147,0,3,0,6
2,2526,2418,108,0,46,0,6
2,2435,2412,23,0,245,0,6
2,2408,2374,34,0,101,1,6
2,2600,2621,-21,0,302,0,6
2,2429,2500,-71,0,107,0,6
2,2369,2479,-110,0,0,0,6
2,2420,2467,-47,0,303,0,6
2,2440,2322,118,0,40,0,6
2,2423,2373,50,0,153,0,6
2,2450,2460,-10,0,41,1,6
2,2434,2425,9,0,4,0,6
2,2399,2548,-149,0,40,0,6
2,2353,2498,-145,0,141,0,6
2,2270,2616,-346,0,302,0,6
2,2264,2420,-156,0,211,1,6
2,2209,2485,-276,0,45,0,6
2,2459,2555,-96,0,45,0,6
2,2511,2356,155,0,200,1,6
2,2494,2548,-54,0,15,1,6
2,2304,2495,-191,0,106,0,6
2,2332,2563,-231,0,345,0,6
2,2606,2622,-16,0,300,0,6
2,2362,2448,-86,0,120,0,6
2,2348,2407,-59,0,45,0,6
2,2370,2550,-180,0,40,0,6
2,2533,2512,21,0,200,0,6
2,2421,2259,162,0,335,0,6
2,2388,2611,-223,0,382,1,6
2,2338,2548,-210,0,245,0,6
2,2456,2532,-76,0,414,0,6
2,2374,2497,-123,0,153,0,6
2,2482,2333,149,0,37,0,6
2,2438,2386,52,0,311,0,6
2,2466,2313,153,0,246,0,6
2,2323,2429,-106,0,27,1,6
2,2388,2566,-178,0,306,0,6
2,2250,2406,-156,0,115,0,6
2,2341,2502,-161,0,41,1,6
2,2368,2588,-220,0,113,0,8
2,2535,2603,-68,0,3,1,6
2,2382,2509,-127,0,249,1,6
2,2420,2475,-55,0,5,0,6
2,2328,2518,-190,0,205,1,6
2,2422,2461,-39,0,112,0,6
2,2540,2478,62,0,120,1,6
2,2575,2576,-1,0,345,0,6
2,2490,2506,-16,0,269,0,6
2,2243,2433,-190,0,133,0,6
2,2510,2544,-34,0,22,0,6
2,2339,2463,-124,0,121,1,6
2,2232,2408,-176,0,40,0,6
2,2505,2531,-26,0,111,0,6
2,2431,2486,-55,0,101,0,6
2,2383,2571,-188,0,440,0,6
2,2386,2421,-35,0,41,0,6
2,2396,2408,-12,0,101,0,6
2,2329,2569,-240,0,60,0,6
2,2500,2545,-45,0,208,0,6
2,2404,2574,-170,0,3,0,6
2,2392,2537,-145,0,245,0,6
2,2355,2442,-87,0,347,1,6
2,2460,2520,-60,0,131,0,6
2,2400,2441,-41,0,101,0,6
2,2456,2336,120,0,102,0,6
2,2444,2474,-30,0,483,1,6
2,2425,2322,103,0,415,1,6
2,2375,2440,-65,0,46,0,6
2,2326,2418,-92,0,9,0,6
2,2445,2462,-17,0,5,1,6
2,2566,2750,-184,0,40,0,6
2,2446,2488,-42,0,16,1,6
2,2311,2412,-101,0,108,0,6
2,2271,2442,-171,0,28,1,6
2,2408,2330,78,0,172,0,6
2,2426,2430,-4,0,302,0,6
2,2423,2578,-155,0,301,0,6
2,2308,2457,-149,0,151,1,6
2,2550,2562,-12,0,61,1,6
2,2361,2413,-52,0,46,0,6
2,2335,2456,-121,0,332,0,6
2,2456,2322,134,0,150,0,6
2,2406,2443,-37,0,386,0,6
2,2333,2419,-86,0,206,0,6
2,2452,2543,-91,0,351,0,6
2,2402,2218,184,0,22,0,6
2,2676,2667,9,0,15,0,6
2,2480,2478,2,0,41,0,6
2,2523,2533,-10,0,103,0,6
2,2262,2422,-160,0,7,0,6
2,2390,2405,-15,0,290,0,6
2,2211,2421,-210,0,40,0,6
2,2473,2419,54,0,56,0,6
2,2468,2467,1,0,122,0,6
2,2355,2456,-101,0,132,1,6
2,2390,2501,-111,0,101,1,6
2,2414,2411,3,0,113,0,6
2,2568,2670,-102,0,100,1,6
2,2518,2363,155,0,140,0,6
2,2225,2414,-189,0,200,1,6
2,2339,2465,-126,0,140,0,6
2,2458,2436,22,0,131,0,6
2,2322,2428,-106,0,330,0,6
2,2571,2516,55,0,47,0,6
2,2577,2516,61,0,22,1,6
2,2637,2480,157,0,46,0,6
2,2395,2426,-31,0,200,0,6
2,2349,2514,-165,0,106,0,6
2,2453,2396,57,0,338,0,6
2,2467,2570,-103,0,151,0,6
2,2560,2469,91,0,4,0,6
2,2620,2475,145,0,243,1,6
2,2453,2320,133,0,190,0,3
2,2598,2566,32,0,106,1,6
2,2338,2400,-62,0,4,0,6
2,2521,2473,48,0,246,0,6
2,2365,2529,-164,0,143,0,6
2,2432,2570,-138,0,0,0,6
2,2218,2459,-241,0,212,0,6
2,2456,2527,-71,0,153,0,6
2,2280,2402,-122,0,11,0,6
2,2543,2450,93,0,241,1,6
2,2460,2466,-6,0,405,1,6
2,2415,2556,-141,0,211,0,6
2,2472,2444,28,0,242,1,6
2,2249,2418,-169,0,45,0,6
2,2369,2464,-95,0,344,0,6
2,2541,2445,96,0,45,0,6
2,2270,2444,-174,0,3,1,6
2,2567,2534,33,0,411,1,6
2,2413,2566,-153,0,0,0,6
2,2416,2339,77,0,4,0,6
2,2479,2554,-75,0,7,0,6
2,2366,2591,-225,0,311,0,6
2,2425,2402,23,0,46,0,6
2,2569,2731,-162,0,13,0,6
2,2432,2372,60,0,156,0,6
2,2381,2479,-98,0,461,0,6
2,2498,2656,-158,0,202,0,6
2,2404,2350,54,0,62,1,6
2,2336,2400,-64,0,331,0,6
2,2545,2555,-10,0,300,0,6
2,2373,2532,-159,0,113,0,6
2,2224,2526,-302,0,406,0,6
2,2429,2522,-93,0,459,1,6
2,2455,2454,1,0,120,0,6
2,2410,2432,-22,0,44,0,6
2,2426,2400,26,0,200,0,6
2,2383,2516,-133,0,13,0,6
2,2419,2464,-45,0,263,1,6
2,2407,2413,-6,0,113,0,6
2,2477,2266,211,0,225,0,6
2,2442,2630,-188,0,154,1,6
2,2343,2402,-59,0,21,1,6
2,2381,2438,-57,0,380,0,6
2,2394,2454,-60,0,196,0,6
2,2248,2423,-175,0,310,1,6
2,2205,2544,-339,0,0,0,6
2,2383,2418,-35,0,8,0,6
2,2462,2561,-99,0,225,0,6
2,2454,2214,240,0,4,0,6
2,2392,2483,-91,0,244,0,6
2,2470,2414,56,0,9,0,6
2,2485,2562,-77,0,54,0,6
2,2672,2339,333,0,45,0,6
2,2606,2589,17,0,115,0,6
2,2311,2431,-120,0,331,1,10
2,2458,2380,78,0,87,0,6
2,2296,2424,-128,0,130,1,6
2,2449,2503,-54,0,241,1,6
2,2418,2271,147,0,45,0,6
2,2555,2603,-48,0,310,0,6
2,2380,2499,-119,0,227,0,6
2,2370,2420,-50,0,302,0,6
2,2440,2534,-94,0,121,0,6
2,2411,2354,57,0,46,0,6
2,2425,2328,97,0,125,0,6
2,2384,2525,-141,0,112,0,6
2,2201,2629,-428,0,344,0,6
2,2427,2467,-40,0,28,0,6
2,2341,2439,-98,0,102,0,8
2,2463,2421,42,0,115,0,6
2,2302,2470,-168,0,120,0,8
2,2485,2335,150,0,65,0,6
2,2396,2436,-40,0,150,0,6
2,2248,2401,-153,0,100,0,6
2,2536,2600,-64,0,80,0,6
2,2446,2367,79,0,1,1,6
2,2364,2546,-182,0,455,1,6
2,2249,2592,-343,0,4,0,6
2,2362,2402,-40,4,302,0,13
2,2466,2497,-31,0,392,0,6
2,2211,2502,-291,0,45,0,6
2,2404,2380,24,0,167,1,6
2,2536,2517,19,0,3,0,6
2,2362,2436,-74,0,56,0,6
2,2414,2526,-112,0,255,0,6
2,2527,2501,26,0,142,0,6
2,2429,2398,31,0,0,0,6
2,2416,2249,167,0,13,0,8
2,2435,2631,-196,0,9,0,6
2,2487,2616,-129,0,3,0,6
2,2504,2524,-20,0,241,1,6
2,2524,2487,37,0,400,0,6
2,2403,2385,18,0,110,0,6
2,2389,2469,-80,0,45,0,6
2,2577,2485,92,0,278,1,6
2,2404,2393,11,0,125,0,6
2,2401,2245,156,0,338,0,6
2,2471,2500,-29,0,311,0,6
2,2423,2378,45,0,207,0,6
2,2443,2484,-41,0,48,1,6
2,2433,2534,-101,0,201,0,6
2,2351,2539,-188,0,300,0,6
2,2335,2457,-122,0,46,0,6
2,2431,2344,87,0,122,0,6
2,2527,2438,89,0,337,1,6
2,2318,2401,-83,0,302,1,6
2,2490,2351,139,0,180,0,6
2,2559,2501,58,0,151,0,6
2,2481,2467,14,0,300,0,6
2,2263,2564,-301,0,6,0,6
2,2373,2412,-39,0,304,0,6
2,2486,2565,-79,0,332,0,6
2,2521,2512,9,0,394,0,6
2,2413,2304,109,0,46,1,6
2,2531,2526,5,0,49,0,6
2,2253,2570,-317,0,344,0,6
2,2225,2400,-175,0,220,0,6
2,2417,2528,-111,0,70,0,6
2,2465,2438,27,0,268,0,6
2,2316,2423,-107,0,100,0,6
2,2477,2489,-12,0,125,0,6
2,2516,2697,-181,0,337,0,6
2,2328,2447,-119,0,200,1,6
2,2323,2466,-143,0,40,0,6
2,2420,2557,-137,0,101,0,6
2,2265,2409,-144,0,50,0,6
2,2275,2406,-131,0,226,0,6
2,2484,2521,-37,0,241,0,6
2,2421,2364,57,0,300,0,6
2,2563,2393,170,0,332,0,6
2,2413,2528,-115,0,222,0,6
2,2625,2563,62,0,13,0,6
2,2638,2449,189,0,130,0,6
2,2586,2560,26,0,103,0,6
2,2445,2432,13,0,140,0,6
2,2401,2401,0,0,41,0,6
2,2505,2507,-2,0,48,0,6
2,2511,2654,-143,0,108,1,6
2,2467,2471,-4,0,331,1,6
2,2415,2478,-63,0,311,0,6
2,2297,2683,-386,0,5,0,8
2,2403,2313,90,0,122,0,6
2,2436,2281,155,0,45,0,8
2,2507,2532,-25,0,104,0,6
2,2310,2442,-132,0,476,0,6
2,2477,2464,13,0,4,1,6
2,2400,2343,57,0,140,0,6
2,2400,2447,-47,0,105,1,6
2,2434,2295,139,0,46,0,6
2,2368,2740,-372,0,409,1,6
2,2220,2504,-284,0,4,0,6
2,2423,2404,19,0,241,1,6
2,2508,2479,29,0,331,0,6
2,2480,2565,-85,0,228,0,6
2,2318,2404,-86,0,49,0,6
2,2612,2429,183,0,4,0,6
2,2477,2382,95,0,175,1,6
2,2415,2221,194,0,210,0,6
2,2297,2584,-287,0,394,0,8
2,2550,2530,20,0,456,0,6
2,2554,2677,-123,0,7,0,6
2,2390,2565,-175,0,247,0,6
2,2378,2536,-158,0,195,0,6
2,2431,2503,-72,0,4,1,6
2,2284,2446,-162,0,414,0,6
2,2404,2302,102,0,128,1,6
2,2523,2428,95,0,312,1,6
2,2432,2457,-25,0,300,0,6
2,2404,2512,-108,0,34,0,6
2,2478,2588,-110,0,57,1,6
2,2324,2416,-92,0,241,1,6
2,2562,2502,60,0,0,0,6
2,2242,2409,-167,0,335,1,6
2,2308,2407,-99,0,101,0,6
2,2513,2668,-155,0,106,0,6
2,2462,2420,42,0,211,0,6
2,2227,2455,-228,0,121,1,6
2,2226,2469,-243,0,210,1,6
2,2433,2307,126,0,10,1,6
2,2504,2578,-74,0,453,0,6
2,2299,2433,-134,0,200,0,6
2,2557,2327,230,0,48,1,6
2,2407,2383,24,0,6,0,6
2,2568,2544,24,0,14,0,6
2,2462,2453,9,0,96,0,6
2,2399,2404,-5,0,45,0,6
2,2299,2402,-103,0,17,0,6
2,2440,2311,129,0,130,1,6
2,2341,2500,-159,0,125,1,6
2,2338,2659,-321,0,18,0,6
2,2307,2476,-169,0,145,0,6
2,2723,2631,92,0,200,0,6
2,2497,2339,158,0,484,0,6
2,2278,2424,-146,0,300,0,6
2,2233,2401,-168,0,202,1,6
2,2363,2449,-86,0,310,0,6
2,2726,2639,87,0,301,0,6
2,2359,2465,-106,0,131,0,6
2,2351,2508,-157,0,394,0,6
2,2474,2472,2,0,200,1,6
2,2616,2486,130,0,300,0,6
2,2311,2477,-166,0,130,0,6
2,2445,2453,-8,0,106,0,6
2,2208,2469,-261,0,5,1,6
2,2581,2559,22,0,455,0,6
2,2626,2568,58,0,448,0,6
2,2408,2438,-30,0,4,0,6
2,2495,2568,-73,0,441,0,6
2,2314,2402,-88,0,113,0,6
2,2586,2605,-19,0,327,1,6
2,2348,2492,-144,0,466,0,6
2,2380,2403,-23,0,142,0,6
2,2443,2423,20,0,100,0,6
2,2442,2391,51,0,16,0,6
2,2672,2562,110,0,216,1,6
2,2301,2424,-123,0,4,1,6
2,2564,2419,145,0,190,0,6
2,2206,2417,-211,0,487,0,8
2,2536,2593,-57,0,405,0,6
2,2361,2445,-84,0,207,0,6
2,2543,2514,29,0,7,1,6
2,2614,2305,309,0,50,0,6
2,2528,2430,98,0,110,0,6
2,2297,2407,-110,0,0,0,6
2,2334,2482,-148,0,317,0,6
2,2492,2354,138,0,106,0,6
2,2363,2531,-168,0,337,1,6
2,2313,2414,-101,0,343,0,6
2,2524,2508,16,0,345,0,6
2,2461,2428,33,0,9,1,6
2,2364,2687,-323,0,106,0,6
2,2448,2277,171,0,300,0,6
2,2495,2439,56,0,310,0,6
2,2298,2533,-235,0,200,0,6
2,2365,2483,-118,0,246,1,6
2,2462,2562,-100,0,106,0,6
2,2412,2248,164,0,114,0,6
2,2551,2478,73,0,300,0,6
2,2323,2431,-108,0,306,0,6
2,2447,2518,-71,0,306,0,6
2,2408,2412,-4,0,125,1,6
2,2474,2480,-6,0,454,0,6
2,2366,2445,-79,0,194,0,6
2,2512,2505,7,0,54,1,6
2,2523,2580,-57,0,330,1,6
2,2447,2341,106,0,131,0,6
2,2405,2499,-94,0,30,0,6
2,2371,2403,-32,0,228,0,6
2,2463,2419,44,0,133,1,6
2,2455,2493,-38,0,15,0,6
2,2463,2496,-33,0,220,1,6
2,2704,2837,-133,0,190,0,6
2,2204,2400,-196,0,461,0,8
2,2568,2452,116,0,150,1,6
2,2217,2856,-639,0,388,1,6
2,2392,2528,-136,0,45,1,6
2,2386,2434,-48,0,15,0,6
2,2379,2477,-98,0,312,0,6
2,2388,2510,-122,0,0,0,6
2,2503,2319,184,0,103,1,6
2,2250,2417,-167,0,120,0,8
2,2560,2438,122,0,474,0,6
2,2479,2326,153,0,302,0,6
2,2435,2634,-199,0,113,0,6
2,2464,2450,14,0,122,0,6
2,2479,2325,154,0,226,0,6
2,2308,2442,-134,0,120,0,6
2,2220,2534,-314,0,40,0,6
2,2467,2218,249,0,0,1,6
2,2301,2413,-112,0,8,0,6
2,2393,2426,-33,0,40,0,6
2,2426,2599,-173,0,385,0,6
2,2221,2445,-224,0,1,0,6
2,2345,2487,-142,0,120,1,6
2,2523,2505,18,0,387,0,6
2,2333,2460,-127,0,112,0,6
2,2598,2459,139,0,250,0,6
2,2419,2480,-61,0,265,0,6
2,2415,2578,-163,0,28,0,6
2,2768,2631,137,0,207,0,6
2,2250,2476,-226,0,57,0,6
2,2495,2473,22,0,45,0,6
2,2371,2436,-65,0,102,1,6
2,2469,2298,171,0,0,0,6
2,2472,2368,104,0,15,1,6
2,2427,2450,-23,0,331,0,6
2,2297,2425,-128,0,269,0,6
2,2455,2446,9,0,123,0,6
2,2446,2456,-10,0,302,1,6
2,2467,2347,120,0,13,0,6
2,2319,2436,-117,0,128,1,6
2,2461,2527,-66,0,302,1,6
2,2653,2672,-19,0,233,0,6
2,2316,2520,-204,0,203,0,6
2,2311,2424,-113,0,6,1,6
2,2433,2460,-27,0,101,1,6
2,2453,2510,-57,0,80,0,6
2,2610,2564,46,0,301,0,6
2,2525,2564,-39,0,49,0,6
2,2263,2508,-245,0,140,0,6
2,2490,2398,92,0,206,0,6
2,2593,2612,-19,0,200,0,6
2,2217,2482,-265,0,200,0,6
2,2401,2553,-152,0,25,0,6
2,2394,2458,-64,0,319,0,6
2,2589,2730,-141,0,106,0,6
2,2320,2430,-110,0,205,0,6
2,2570,2606,-36,0,123,1,6
2,2331,2480,-149,0,1,0,6
2,2581,2612,-31,0,9,0,6
2,2299,2446,-147,0,4,0,6
2,2217,2516,-299,0,335,0,6
2,2460,2455,5,0,102,1,6
2,2543,2456,87,0,220,0,6
2,2658,2612,46,0,100,0,6
2,2553,2342,211,0,163,0,6
2,2492,2554,-62,0,315,0,6
2,2327,2475,-148,0,300,0,6
2,2583,2333,250,0,40,0,6
2,2455,2324,131,0,211,1,6
2,2394,2429,-35,0,200,0,6
2,2542,2529,13,0,404,0,6
2,2596,2374,222,0,270,0,6
2,2457,2390,67,0,414,0,6
2,2354,2474,-120,0,145,1,6
2,2473,2565,-92,0,480,1,6
2,2429,2335,94,0,4,0,6
2,2277,2426,-149,0,1,1,6
2,2223,2401,-178,4,120,0,13
2,2404,2434,-30,0,112,0,6
2,2554,2569,-15,0,45,0,6
2,2311,2424,-113,0,337,1,6
2,2509,2370,139,0,315,0,6
2,2458,2673,-215,0,343,0,6
2,2343,2514,-171,0,101,0,6
2,2537,2771,-234,0,28,0,6
2,2473,2420,53,0,253,1,6
2,2348,2417,-69,0,4,0,6
2,2492,2324,168,0,302,1,8
2,2444,2410,34,0,428,0,6
2,2405,2441,-36,0,17,0,6
2,2313,2402,-89,0,54,0,6
2,2423,2474,-51,0,303,0,6
2,2383,2540,-157,0,241,0,6
2,2376,2478,-102,0,127,0,6
2,2557,2549,8,0,150,0,6
2,2281,2432,-151,0,106,0,6
2,2450,2421,29,0,408,1,6
2,2449,2478,-29,0,200,0,6
2,2285,2506,-221,0,409,0,6
2,2418,2429,-11,0,194,0,6
2,2489,2586,-97,0,36,0,6
2,2530,2476,54,0,65,0,6
2,2363,2501,-138,0,128,0,6
2,2471,2409,62,0,151,1,6
2,2436,2485,-49,0,144,0,6
2,2404,2428,-24,0,300,0,6
2,2507,2675,-168,0,221,0,6
2,2267,2432,-165,0,344,0,6
2,2615,2653,-38,0,184,1,6
2,2377,2523,-146,0,153,0,6
2,2341,2435,-94,0,46,1,6
2,2411,2389,22,0,45,0,6
2,2201,2462,-261,0,140,1,6
2,2459,2543,-84,0,485,1,6
2,2461,2487,-26,0,136,0,6
2,2415,2221,194,0,140,0,6
2,2296,2685,-389,0,247,0,6
2,2331,2401,-70,0,194,0,6
2,2382,2428,-46,0,43,0,6
2,2456,2456,0,0,199,1,6
2,2372,2413,-41,0,16,1,6
2,2422,2405,17,0,300,0,8
2,2290,2447,-157,0,302,1,6
2,2507,2526,-19,0,60,0,6
2,2591,2574,17,0,308,0,6
2,2421,2350,71,0,487,0,6
2,2372,2452,-80,0,312,0,6
2,2284,2409,-125,0,4,0,6
2,2480,2460,20,0,145,0,6
2,2587,2303,284,0,40,1,6
2,2426,2457,-31,0,40,0,6
2,2468,2435,33,0,241,0,6
2,2525,2510,15,0,302,1,6
2,2294,2436,-142,0,9,1,6
2,2402,2365,37,0,200,0,8
2,2405,2402,3,0,405,1,6
2,2425,2418,7,0,103,0,6
2,2437,2428,9,0,96,1,6
2,2674,2716,-42,0,487,0,6
2,2588,2731,-143,0,4,0,6
2,2399,2454,-55,0,38,0,6
2,2443,2486,-43,0,300,0,6
2,2236,2401,-165,0,245,0,6
2,2579,2466,113,0,120,1,6
2,2545,2647,-102,0,242,0,6
2,2585,2670,-85,0,115,0,6
2,2363,2442,-79,0,35,0,6
2,2233,2445,-212,0,115,1,6
2,2359,2434,-75,0,448,0,6
2,2273,2422,-149,0,4,0,6
2,2597,2634,-37,0,33,0,6
2,2596,2597,-1,0,8,0,6
2,2627,2517,110,0,106,0,6
2,2454,2296,158,0,141,0,6
2,2452,2589,-137,0,421,1,6
2,2399,2512,-113,0,40,1,6
2,2527,2597,-70,0,46,0,6
2,2358,2453,-95,0,296,1,6
2,2407,2457,-50,0,300,0,6
2,2429,2475,-46,0,267,1,6
2,2475,2539,-64,0,48,1,6
2,2455,2450,5,0,331,1,6
2,2317,2446,-129,0,426,0,6
2,2213,2537,-324,0,45,0,6
2,2385,2546,-161,0,123,0,6
2,2447,2464,-17,0,267,0,6
2,2427,2487,-60,0,45,0,6
2,2574,2638,-64,0,0,0,6
2,2599,2449,150,0,133,0,6
2,2542,2483,59,0,380,1,6
2,2238,2521,-283,0,125,0,6
2,2501,2407,94,0,131,0,6
2,2574,2505,69,0,300,0,6
2,2506,2458,48,0,386,0,6
2,2366,2420,-54,0,1,0,6
2,2314,2554,-240,0,126,0,6
2,2469,2468,1,0,335,1,6
2,2575,2536,39,0,106,0,6
2,2447,2465,-18,0,7,0,6
2,2204,2544,-340,0,414,0,6
2,2260,2419,-159,0,322,0,8
2,2400,2395,5,0,487,0,6
2,2657,2690,-33,0,254,0,6
2,2316,2428,-112,0,264,0,6
2,2538,2435,103,0,57,1,6
2,2401,2384,17,0,140,0,6
2,2390,2463,-73,0,153,0,6
2,2456,2444,12,0,125,0,6
2,2406,2305,101,0,487,0,6
2,2409,2365,44,0,132,0,6
2,2425,2286,139,4,140,0,13
2,2400,2474,-74,4,106,0,13
2,2642,2799,-157,0,57,0,6
2,2209,2492,-283,0,131,0,6
2,2599,2577,22,0,210,0,6
2,2417,2339,78,0,15,0,6
2,2429,2434,-5,0,5,1,6
2,2443,2444,-1,0,490,0,6
2,2296,2409,-113,0,115,0,6
2,2400,2384,16,0,487,0,6
2,2271,2401,-130,0,89,0,6
2,2510,2434,76,0,121,0,6
2,2420,2593,-173,0,106,0,6
2,2476,2460,16,0,60,0,6
2,2417,2440,-23,0,310,0,6
2,2230,2400,-170,0,250,0,6
2,2413,2489,-76,0,45,1,5
2,2520,2509,11,0,200,0,6
2,2424,2580,-156,0,13,1,6
2,2395,2494,-99,0,40,0,6
2,2390,2594,-204,0,180,0,6
2,2471,2456,15,0,6,0,6
2,2269,2420,-151,0,45,1,6
2,2487,2537,-50,0,211,0,6
2,2306,2411,-105,0,127,0,6
2,2311,2469,-158,0,10,0,6
2,2402,2294,108,0,302,0,6
2,2284,2445,-161,0,121,1,6
2,2526,2520,6,0,131,0,6
2,2392,2430,-38,0,3,1,6
2,2394,2423,-29,0,45,0,6
2,2347,2432,-85,0,107,0,6
2,2459,2301,158,0,43,0,6
2,2670,2732,-62,0,9,0,6
2,2277,2443,-166,0,123,0,6
2,2369,2474,-105,0,151,0,6
2,2327,2486,-159,0,242,0,6
2,2330,2487,-157,0,143,1,6
2,2356,2453,-97,0,190,0,6
2,2288,2455,-167,0,241,0,6
2,2297,2423,-126,0,102,1,6
2,2465,2490,-25,0,107,1,6
2,2308,2417,-109,0,140,1,6
2,2419,2266,153,0,300,0,6
2,2410,2398,12,0,106,0,6
2,2618,2529,89,0,106,0,6
2,2449,2514,-65,0,317,0,6
2,2464,2495,-31,0,49,1,6
2,2328,2506,-178,0,101,0,6
2,2402,2444,-42,0,0,0,6
2,2526,2518,8,0,45,1,6
2,2331,2427,-96,0,106,1,6
2,2386,2429,-43,0,43,1,6
2,2493,2349,144,0,200,0,6
2,2373,2431,-58,0,46,1,6
2,2455,2473,-18,0,175,0,6
2,2334,2615,-281,0,245,1,6
2,2457,2211,246,0,241,0,6
2,2563,2538,25,0,152,0,6
2,2420,2410,10,0,200,0,6
2,2394,2487,-93,0,145,0,6
2,2555,2453,102,0,375,0,6
2,2428,2421,7,0,45,0,6
2,2514,2553,-39,0,107,0,6
2,2319,2513,-194,0,45,1,6
2,2471,2349,122,0,106,0,6
2,2429,2310,119,0,107,1,6
2,2359,2441,-82,0,65,1,6
2,2395,2584,-189,0,241,0,6
2,2466,2416,50,0,122,0,6
2,2738,2684,54,0,354,0,6
2,2220,2429,-209,0,10,0,6
2,2259,2497,-238,0,102,1,6
2,2543,2580,-37,0,130,0,6
2,2383,2499,-116,0,311,0,6
2,2489,2446,43,0,298,0,6
2,2424,2606,-182,0,302,0,6
2,2451,2349,102,0,47,0,6
2,2490,2672,-182,0,302,0,6
2,2363,2428,-65,0,278,0,6
2,2299,2410,-111,0,143,0,6
2,2427,2396,31,0,175,0,6
2,2425,2371,54,0,121,0,6
2,2427,2467,-40,0,103,1,6
2,2472,2536,-64,0,187,0,6
2,2441,2525,-84,0,6,0,6
2,2364,2401,-37,0,40,0,6
2,2362,2433,-71,0,151,0,6
2,2419,2310,109,0,335,0,6
2,2537,2486,51,0,10,0,6
2,2418,2413,5,0,131,0,6
2,2570,2543,27,0,200,0,6
2,2427,2420,7,0,40,0,6
2,2369,2511,-142,0,206,0,6
2,2412,2322,90,0,311,0,6
2,2349,2437,-88,0,106,0,6
2,2362,2454,-92,0,125,1,6
2,2256,2603,-347,0,43,0,6
2,2493,2461,32,0,201,0,6
2,2446,2667,-221,0,101,0,6
2,2439,2617,-178,0,227,0,6
2,2420,2368,52,0,301,0,6
2,2405,2319,86,0,485,0,6
2,2306,2496,-190,0,6,1,6
2,2285,2414,-129,0,110,0,6
2,2229,2498,-269,0,352,0,6
2,2455,2428,27,0,288,1,6
2,2312,2433,-121,0,142,0,6
2,2321,2403,-82,0,0,0,6
2,2410,2256,154,0,352,0,8
2,2417,2473,-56,0,469,0,6
2,2449,2439,10,0,113,1,6
2,2454,2401,53,0,4,1,6
2,2318,2504,-186,0,145,0,6
2,2468,2443,25,0,224,0,6
2,2240,2438,-198,0,312,0,6
2,2313,2430,-117,0,117,1,6
2,2496,2244,252,0,231,0,6
2,2456,2432,24,0,310,1,6
2,2224,2407,-183,0,268,0,6
2,2409,2385,24,0,382,0,6
2,2664,2701,-37,0,20,1,6
2,2396,2428,-32,0,40,1,6
2,2438,2449,-11,0,15,0,6
2,2217,2429,-212,0,100,1,6
2,2413,2243,170,0,48,1,6
2,2466,2390,76,0,256,1,6
2,2291,2456,-165,0,202,0,6
2,2470,2537,-67,0,109,0,6
2,2521,2533,-12,0,15,0,6
2,2311,2570,-259,0,374,0,6
2,2471,2337,134,0,145,0,6
2,2283,2427,-144,0,200,1,6
2,2485,2636,-151,0,52,0,6
2,2275,2614,-339,0,150,0,6
2,2628,2784,-156,0,426,0,6
2,2409,2420,-11,0,40,1,6
2,2464,2569,-105,0,45,0,6
2,2431,2580,-149,0,301,1,6
2,2409,2447,-38,0,0,0,6
2,2426,2331,95,0,303,0,6
2,2290,2443,-153,0,288,0,8
2,2460,2523,-63,0,405,0,6
2,2423,2263,160,0,404,0,6
2,2416,2483,-67,0,268,1,6
2,2519,2363,156,0,131,0,6
2,2459,2420,39,0,28,0,6
2,2439,2413,26,0,20,0,6
2,2438,2385,53,0,205,0,6
2,2438,2449,-11,0,40,0,6
2,2403,2468,-65,0,311,0,6
2,2406,2259,147,0,20,1,6
2,2285,2416,-131,0,20,1,6
2,2517,2502,15,0,145,0,6
2,2541,2451,90,0,45,0,6
2,2483,2458,25,0,331,0,6
2,2226,2469,-243,0,114,0,5
2,2470,2499,-29,0,101,1,6
2,2422,2352,70,0,4,0,6
2,2418,2257,161,0,4,0,6
2,2417,2354,63,0,200,0,6
2,2341,2462,-121,0,140,0,6
2,2420,2510,-90,0,122,0,6
2,2418,2452,-34,0,129,0,6
2,2268,2402,-134,0,221,0,6
2,2642,2471,171,0,131,0,6
2,2374,2457,-83,0,57,1,6
2,2249,2477,-228,0,278,0,6
2,2412,2547,-135,0,7,0,6
2,2243,2417,-174,0,106,1,6
2,2462,2485,-23,0,122,0,6
2,2471,2713,-242,0,123,0,6
2,2388,2427,-39,0,58,0,6
2,2471,2593,-122,0,110,0,6
2,2573,2561,12,0,207,0,6
2,2305,2450,-145,0,301,0,6
2,2319,2410,-91,0,410,1,6
2,2426,2510,-84,0,240,1,6
2,2485,2488,-3,0,310,1,6
2,2292,2437,-145,0,311,0,6
2,2245,2419,-174,0,473,0,6
2,2317,2405,-88,0,343,0,8
2,2342,2444,-102,0,133,0,6
2,2406,2314,92,0,241,0,6
2,2479,2449,30,0,106,0,6
2,2498,2618,-120,0,327,0,6
2,2595,2551,44,0,245,1,6
2,2400,2539,-139,0,250,0,6
2,2424,2314,110,0,122,0,6
2,2380,2445,-65,0,245,0,6
2,2440,2483,-43,0,301,0,6
2,2392,2520,-128,0,109,0,6
2,2457,2302,155,0,154,0,6
2,2324,2402,-78,0,110,0,6
2,2317,2450,-133,0,352,0,6
2,2270,2697,-427,0,215,1,6
2,2568,2448,120,0,261,1,6
2,2337,2475,-138,0,36,0,6
2,2396,2408,-12,0,70,1,6
2,2608,2719,-111,0,1,0,6
2,2349,2414,-65,0,130,1,6
2,2455,2440,15,0,8,0,6
2,2514,2448,66,0,246,0,6
2,2429,2340,89,0,176,0,6
2,2403,2415,-12,0,270,0,6
2,2416,2333,83,0,5,0,6
2,2437,2446,-9,0,462,0,6
2,2498,2522,-24,0,237,0,6
2,2304,2434,-130,0,36,0,6
2,2470,2332,138,0,45,0,6
2,2426,2312,114,0,200,0,6
2,2401,2399,2,0,410,0,6
2,2445,2457,-12,0,385,0,6
2,2516,2521,-5,0,288,0,6
2,2378,2435,-57,0,2,1,6
2,2404,2539,-135,0,308,0,6
2,2439,2420,19,0,6,0,6
2,2422,2381,41,0,101,0,6
2,2327,2423,-96,0,438,0,6
2,2318,2514,-196,0,115,0,6
2,2536,2453,83,0,56,0,6
2,2335,2412,-77,0,277,0,6
2,2237,2484,-247,0,106,0,8
2,2344,2444,-100,0,132,0,6
2,2423,2437,-14,0,320,1,6
2,2409,2515,-106,0,3,0,6
2,2260,2453,-193,0,49,0,6
2,2516,2438,78,0,110,1,6
2,2374,2507,-133,0,168,0,6
2,2389,2455,-66,0,130,0,6
2,2465,2285,180,0,121,0,6
2,2380,2405,-25,0,15,0,6
2,2421,2514,-93,0,307,0,6
2,2432,2454,-22,0,15,1,6
2,2454,2435,19,0,25,0,6
2,2377,2422,-45,0,40,0,6
2,2422,2390,32,0,201,0,6
2,2396,2603,-207,0,135,0,6
2,2410,2411,-1,0,200,0,6
2,2528,2460,68,0,106,0,6
2,2393,2552,-159,0,211,0,6
2,2333,2438,-105,0,300,1,6
2,2464,2601,-137,0,112,1,6
2,2431,2446,-15,0,302,0,6
2,2432,2350,82,0,43,0,6
2,2246,2444,-198,0,0,1,6
2,2462,2442,20,0,49,1,6
2,2402,2402,0,0,145,1,6
2,2554,2503,51,0,112,0,6
2,2356,2473,-117,0,112,0,6
2,2468,2505,-37,0,302,0,6
2,2327,2492,-165,0,404,0,6
2,2451,2416,35,0,320,0,6
2,2551,2532,19,0,5,1,6
2,2401,2433,-32,0,130,0,6
2,2241,2427,-186,0,100,0,6
2,2388,2420,-32,0,200,0,6
2,2272,2414,-142,0,406,0,6
2,2423,2373,50,0,485,0,6
2,2392,2513,-121,0,129,0,6
2,2496,2367,129,0,463,0,6
2,2529,2435,94,0,216,0,6
2,2404,2375,29,0,205,0,6
2,2594,2610,-16,0,194,0,6
2,2462,2357,105,0,4,0,6
2,2434,2406,28,0,41,0,6
2,2372,2456,-84,0,101,0,6
2,2385,2486,-101,0,0,0,6
2,2564,2569,-5,0,140,0,6
2,2607,2672,-65,0,5,0,6
2,2299,2431,-132,0,210,0,6
2,2417,2311,106,0,484,0,6
2,2386,2453,-67,0,146,0,6
2,2403,2326,77,0,300,0,6
2,2510,2647,-137,0,9,0,6
2,2215,2497,-282,0,300,0,6
2,2473,2660,-187,0,200,0,6
2,2616,2668,-52,0,120,1,6
2,2460,2399,61,0,0,0,6
2,2404,2542,-138,0,418,1,6
2,2331,2458,-127,0,48,1,6
2,2500,2558,-58,0,125,1,6
2,2426,2406,20,0,260,0,6
2,2451,2503,-52,0,43,0,6
2,2486,2472,14,0,100,0,6
2,2363,2443,-80,0,28,1,6
2,2587,2561,26,0,188,0,6
2,2411,2413,-2,0,200,0,6
2,2462,2442,20,0,45,0,6
2,2401,2497,-96,0,272,0,6
2,2524,2385,139,0,4,1,6
2,2415,2355,60,0,150,1,6
2,2427,2332,95,0,306,1,6
2,2410,2426,-16,0,324,0,6
2,2756,2661,95,0,246,0,6
2,2307,2434,-127,0,46,1,6
2,2526,2500,26,0,45,0,6
2,2497,2569,-72,0,109,0,6
2,2204,2556,-352,2,57,0,28
2,2481,2535,-54,0,4,0,6
2,2433,2408,25,0,196,1,6
2,2425,2381,44,0,140,0,6
2,2507,2370,137,0,315,0,6
2,2350,2406,-56,0,122,0,6
2,2249,2428,-179,0,133,0,6
2,2430,2551,-121,0,196,0,6
2,2417,2258,159,0,110,1,6
2,2293,2452,-159,0,270,0,6
2,2316,2446,-130,0,0,1,6
2,2349,2411,-62,0,375,1,6
2,2356,2493,-137,0,57,0,6
2,2509,2490,19,0,474,0,6
2,2338,2541,-203,0,242,0,6
2,2431,2305,126,0,266,1,6
2,2397,2538,-141,0,1,0,6
2,2422,2492,-70,0,302,0,6
2,2455,2265,190,0,4,0,6
2,2279,2417,-138,0,303,0,6
2,2286,2404,-118,0,4,0,6
2,2370,2416,-46,0,4,0,6
2,2610,2508,102,0,312,0,6
2,2459,2213,246,0,111,0,6
2,2662,2652,10,0,455,1,6
2,2436,2260,176,0,45,0,6
2,2305,2408,-103,0,70,0,6
2,2528,2464,64,0,45,0,6
2,2414,2536,-122,0,48,0,6
2,2266,2643,-377,0,301,0,6
2,2393,2456,-63,0,196,0,6
2,2653,2679,-26,0,89,1,6
2,2252,2448,-196,0,112,0,6
2,2470,2339,131,0,335,0,6
2,2461,2388,73,0,130,0,6
2,2364,2402,-38,0,213,0,6
2,2432,2467,-35,0,264,0,6
2,2307,2442,-135,0,267,1,8
2,2330,2442,-112,0,101,0,6
2,2380,2412,-32,0,152,1,6
2,2406,2396,10,0,105,0,6
2,2461,2529,-68,0,106,0,6
2,2546,2465,81,0,0,0,6
2,2237,2415,-178,0,5,1,6
2,2418,2316,102,0,490,0,6
2,2516,2370,146,0,133,1,6
2,2429,2433,-4,0,320,0,6
2,2498,2458,40,0,247,0,6
2,2430,2391,39,0,112,0,6
2,2449,2298,151,0,45,1,6
2,2316,2468,-152,0,456,0,6
2,2272,2401,-129,0,4,0,6
2,2407,2314,93,0,45,1,6
2,2211,2530,-319,0,112,0,6
2,2318,2432,-114,0,151,0,6
2,2420,2383,37,0,127,0,6
2,2546,2612,-66,0,177,0,6
2,2442,2409,33,0,415,0,6
2,2286,2413,-127,0,1,0,6
2,2537,2418,119,0,15,1,6
2,2457,2234,223,0,0,0,6
2,2449,2460,-11,0,13,1,6
2,2221,2403,-182,2,12,0,18
2,2432,2412,20,0,13,1,6
2,2432,2235,197,0,395,0,6
2,2406,2443,-37,0,250,0,6
2,2417,2389,28,0,1,0,6
2,2608,2452,156,0,154,0,6
2,2396,2487,-91,0,35,0,6
2,2379,2421,-42,0,122,0,6
2,2589,2374,215,0,112,1,6
2,2387,2453,-66,0,132,0,6
2,2468,2440,28,0,31,0,6
2,2358,2441,-83,0,4,1,6
2,2397,2412,-15,0,57,1,6
2,2303,2413,-110,0,2,1,6
2,2386,2518,-132,0,40,1,6
2,2453,2254,199,0,142,1,6
2,2517,2673,-156,0,130,0,6
2,2345,2534,-189,0,484,0,0
2,2566,2513,53,0,40,0,6
2,2593,2525,68,0,215,1,6
2,2485,2394,91,0,37,0,6
2,2507,2533,-26,0,45,0,6
2,2359,2411,-52,4,302,0,13
2,2435,2402,33,0,315,1,6
2,2505,2507,-2,0,301,0,6
2,2452,2289,163,0,121,1,6
2,2483,2562,-79,0,224,1,6
2,2307,2426,-119,0,1,0,6
2,2565,2549,16,0,200,0,6
2,2593,2536,57,0,52,0,6
2,2418,2447,-29,0,398,0,6
2,2410,2436,-26,0,19,0,6
2,2551,2405,146,0,200,0,6
2,2454,2313,141,0,88,0,6
2,2424,2346,78,0,201,0,6
2,2400,2461,-61,0,123,1,6
2,2311,2401,-90,0,45,0,6
2,2387,2420,-33,0,44,0,6
2,2242,2405,-163,0,14,0,6
2,2417,2401,16,0,120,1,6
2,2350,2454,-104,0,207,0,6
2,2422,2266,156,0,404,0,8
2,2502,2516,-14,0,45,0,6
2,2485,2455,30,0,485,0,6
2,2361,2486,-125,0,2,0,6
2,2500,2544,-44,0,45,1,6
2,2346,2423,-77,0,382,0,6
2,2517,2467,50,0,206,0,6
2,2423,2426,-3,0,337,0,6
2,2465,2441,24,0,310,0,6
2,2481,2536,-55,0,31,0,6
2,2531,2518,13,0,114,0,6
2,2322,2513,-191,0,414,0,6
2,2304,2433,-129,0,315,1,6
2,2479,2550,-71,0,373,0,6
2,2547,2389,158,0,331,0,6
2,2453,2353,100,0,151,0,6
2,2372,2466,-94,0,217,0,6
2,2592,2441,151,0,15,0,6
2,2332,2416,-84,0,102,0,6
2,2552,2601,-49,0,0,0,6
2,2414,2493,-79,0,341,0,6
2,2458,2387,71,0,380,0,6
2,2407,2405,2,0,27,0,6
2,2568,2679,-111,0,65,0,6
2,2483,2621,-138,0,123,0,6
2,2334,2457,-123,0,40,0,6
2,2406,2365,41,0,1,0,6
2,2422,2535,-113,0,304,0,6
2,2304,2460,-156,0,21,1,6
2,2522,2517,5,0,41,1,6
2,2553,2512,41,0,101,1,6
2,2419,2448,-29,0,58,0,6
2,2458,2293,165,0,320,0,6
2,2324,2450,-126,0,16,1,6
2,2443,2433,10,0,343,1,6
2,2431,2306,125,0,57,0,6
2,2496,2495,1,0,108,0,6
2,2500,2569,-69,0,110,1,6
2,2432,2292,140,4,335,0,13
2,2444,2497,-53,0,45,0,6
2,2468,2436,32,0,400,1,6
2,2442,2632,-190,0,45,0,6
2,2448,2551,-103,0,40,0,6
2,2445,2503,-58,0,201,0,6
2,2554,2502,52,0,260,0,6
2,2250,2466,-216,0,300,0,6
2,2243,2414,-171,0,16,0,6
2,2298,2458,-160,0,25,0,6
2,2678,2783,-105,0,300,0,6
2,2471,2209,262,0,57,1,6
2,2506,2462,44,0,46,0,6
2,2371,2477,-106,0,130,0,6
2,2235,2543,-308,0,141,0,6
2,2656,2579,77,0,140,0,6
2,2463,2457,6,0,106,1,6
2,2367,2529,-162,0,302,0,6
2,2454,2553,-99,0,115,1,6
2,2334,2552,-218,0,42,0,6
2,2308,2415,-107,0,405,0,6
2,2519,2264,255,0,415,0,6
2,2554,2573,-19,0,59,0,6
2,2371,2404,-33,0,245,0,6
2,2461,2466,-5,0,10,1,6
2,2469,2382,87,0,184,0,6
2,2391,2463,-72,0,123,0,6
2,2524,2439,85,0,106,0,6
2,2501,2570,-69,0,2,0,6
2,2474,2372,102,0,0,1,6
2,2286,2434,-148,0,128,1,6
2,2369,2423,-54,0,46,1,6
2,2595,2509,86,0,490,0,6
2,2270,2593,-323,0,40,0,6
2,2469,2436,33,0,20,0,6
2,2458,2426,32,4,111,1,13
2,2407,2342,65,0,106,0,6
2,2484,2542,-58,0,85,0,6
2,2275,2414,-139,4,202,0,13
2,2423,2369,54,0,6,0,6
2,2319,2444,-125,0,196,0,6
2,2417,2424,-7,0,1,0,6
2,2434,2350,84,0,21,0,6
2,2248,2411,-163,0,232,1,6
2,2427,2490,-63,0,35,0,6
2,2445,2328,117,0,15,1,6
2,2517,2531,-14,0,14,0,6
2,2685,2773,-88,0,21,0,6
2,2421,2386,35,0,0,1,6
2,2421,2489,-68,0,301,0,6
2,2207,2441,-234,0,389,0,6
2,2505,2759,-254,0,107,0,6
2,2478,2377,101,0,11,0,6
2,2424,2516,-92,0,241,0,6
2,2570,2558,12,0,143,0,6
2,2608,2632,-24,0,315,0,6
2,2312,2468,-156,0,46,1,6
2,2406,2286,120,0,107,0,6
2,2211,2430,-219,0,255,0,6
2,2557,2437,120,0,80,0,6
2,2423,2314,109,0,200,1,6
2,2588,2496,92,0,218,0,6
2,2306,2411,-105,0,228,0,6
2,2591,2651,-60,0,226,0,6
2,2501,2393,108,0,278,1,6
2,2474,2331,143,0,107,0,6
2,2274,2426,-152,0,8,0,6
2,2562,2627,-65,0,4,0,6
2,2355,2446,-91,0,483,0,6
2,2307,2425,-118,0,269,1,6
2,2275,2448,-173,0,143,0,6
2,2498,2473,25,0,265,0,6
2,2318,2406,-88,0,20,1,6
2,2401,2514,-113,0,101,0,6
2,2478,2278,200,0,302,0,5
2,2460,2354,106,0,106,0,6
2,2398,2415,-17,0,247,1,6
2,2476,2435,41,0,43,1,6
2,2492,2427,65,0,0,0,6
2,2282,2411,-129,0,106,1,6
2,2538,2473,65,0,265,0,6
2,2549,2503,46,0,156,0,6
2,2267,2583,-316,0,101,0,6
2,2367,2512,-145,0,2,1,6
2,2243,2403,-160,0,310,1,6
2,2439,2374,65,0,213,1,6
2,2485,2379,106,0,300,0,6
2,2343,2450,-107,0,123,0,6
2,2422,2485,-63,0,311,0,6
2,2248,2407,-159,0,190,0,8
2,2618,2686,-68,0,129,0,6
2,2436,2386,50,0,302,0,6
2,2341,2534,-193,0,221,1,6
2,2435,2423,12,0,156,0,6
2,2339,2441,-102,0,106,1,6
2,2542,2512,30,0,140,0,6
2,2532,2490,42,0,315,1,6
2,2466,2377,89,0,13,0,6
2,2535,2511,24,0,140,0,6
2,2523,2334,189,0,61,0,6
2,2436,2267,169,0,0,0,6
2,2359,2554,-195,0,305,0,6
2,2601,2674,-73,0,1,0,6
2,2293,2591,-298,0,142,1,6
2,2274,2442,-168,0,8,0,6
2,2592,2585,7,0,43,1,6
2,2522,2617,-95,0,151,0,6
2,2476,2486,-10,0,310,0,6
2,2353,2461,-108,0,216,1,6
2,2519,2518,1,0,103,0,6
2,2224,2507,-283,0,46,0,6
2,2654,2594,60,0,278,1,6
2,2521,2378,143,0,119,0,6
2,2342,2411,-69,0,40,0,6
2,2432,2440,-8,0,312,0,6
2,2291,2453,-162,0,11,0,6
2,2253,2404,-151,0,106,0,6
2,2403,2371,32,0,40,0,6
2,2462,2597,-135,0,41,0,6
2,2456,2458,-2,0,313,0,6
2,2400,2570,-170,0,327,0,6
2,2495,2525,-30,0,334,0,6
2,2594,2675,-81,0,404,0,8
2,2531,2368,163,0,106,0,6
2,2424,2491,-67,0,310,0,6
2,2468,2578,-110,0,0,0,6
2,2384,2463,-79,0,103,0,6
2,2671,2637,34,0,121,0,6
2,2377,2445,-68,0,5,0,7
2,2656,2749,-93,0,267,0,6
2,2539,2342,197,0,202,0,6
2,2401,2607,-206,0,45,0,6
2,2524,2531,-7,0,241,0,6
2,2507,2533,-26,0,220,0,6
2,2434,2475,-41,0,46,0,6
2,2324,2404,-80,0,100,0,6
2,2316,2401,-85,0,253,0,6
2,2369,2454,-85,0,100,0,6
2,2303,2431,-128,0,202,0,6
2,2418,2451,-33,0,370,1,6
2,2427,2391,36,0,100,1,6
2,2549,2598,-49,0,150,0,6
2,2235,2404,-169,0,100,0,6
2,2505,2505,0,0,46,1,6
2,2519,2446,73,0,110,1,6
2,2432,2307,125,0,269,1,6
2,2408,2388,20,0,253,0,8
2,2474,2423,51,0,45,0,6
2,2474,2555,-81,0,243,0,6
2,2461,2295,166,0,242,0,6
2,2426,2450,-24,0,4,0,6
2,2668,2585,83,0,310,0,6
2,2535,2571,-36,0,112,0,6
2,2269,2444,-175,0,106,0,6
2,2341,2420,-79,0,38,0,6
2,2358,2456,-98,0,304,0,6
2,2375,2446,-71,0,54,0,6
2,2356,2407,-51,0,1,1,6
2,2327,2422,-95,0,303,1,6
2,2439,2299,140,0,241,1,6
2,2511,2472,39,0,347,0,6
2,2450,2416,34,0,153,1,6
2,2420,2448,-28,0,1,0,6
2,2412,2505,-93,0,8,0,6
2,2442,2486,-44,0,85,1,6
2,2477,2475,2,0,242,0,6
2,2466,2359,107,0,426,0,6
2,2401,2543,-142,0,245,1,6
2,2400,2344,56,0,135,0,6
2,2499,2374,125,0,254,1,6
2,2445,2563,-118,0,201,1,6
2,2510,2473,37,0,213,0,6
2,2297,2443,-146,0,45,0,6
2,2327,2472,-145,0,391,1,6
2,2398,2451,-53,0,4,0,6
2,2316,2457,-141,0,16,1,6
2,2485,2474,11,0,45,0,6
2,2306,2407,-101,0,301,0,6
2,2257,2412,-155,0,15,0,6
2,2298,2410,-112,0,106,1,6
2,2371,2552,-181,0,200,0,6
2,2557,2433,124,0,7,0,6
2,2750,2487,263,0,216,1,6
2,2422,2474,-52,0,40,0,6
2,2543,2417,126,0,1,0,6
2,2484,2509,-25,0,48,1,6
2,2400,2288,112,0,112,0,6
2,2588,2577,11,0,48,0,6
2,2405,2364,41,0,110,0,6
2,2591,2538,53,0,16,0,6
2,2475,2422,53,0,190,0,6
2,2387,2413,-26,0,302,0,6
2,2468,2509,-41,0,213,0,6
2,2399,2494,-95,0,107,0,6
2,2425,2469,-44,0,484,0,6
2,2389,2472,-83,0,40,0,6
2,2544,2579,-35,0,46,0,6
2,2393,2466,-73,0,44,1,6
2,2515,2525,-10,0,307,0,6
2,2326,2402,-76,0,488,0,6
2,2253,2461,-208,0,121,0,6
2,2404,2240,164,4,200,0,13
2,2446,2305,141,0,111,0,6
2,2273,2476,-203,0,85,0,6
2,2604,2584,20,0,300,0,6
2,2459,2365,94,0,107,0,6
2,2388,2481,-93,0,306,1,6
2,2576,2520,56,0,112,0,6
2,2337,2516,-179,0,306,0,6
2,2355,2436,-81,0,156,0,6
2,2450,2480,-30,0,389,0,6
2,2336,2421,-85,0,109,0,6
2,2440,2531,-91,0,156,0,6
2,2403,2431,-28,0,207,0,6
2,2413,2491,-78,0,45,0,6
2,2307,2435,-128,0,151,0,6
2,2442,2434,8,0,211,1,6
2,2375,2417,-42,0,337,1,6
2,2413,2305,108,0,0,0,6
2,2320,2501,-181,0,400,1,6
2,2497,2534,-37,0,205,0,6
2,2496,2452,44,0,463,1,6
2,2347,2430,-83,0,136,0,6
2,2244,2442,-198,0,16,0,6
2,2405,2355,50,0,125,0,6
2,2364,2551,-187,0,0,0,6
2,2460,2527,-67,0,15,0,6
2,2401,2305,96,0,253,0,8
2,2486,2569,-83,0,347,0,6
2,2666,2570,96,0,106,0,6
2,2493,2428,65,0,310,1,6
2,2355,2428,-73,0,41,0,6
2,2534,2373,161,0,34,0,6
2,2478,2569,-91,0,311,0,6
2,2327,2480,-153,0,177,0,6
2,2486,2267,219,0,130,0,8
2,2581,2424,157,0,7,0,6
2,2406,2232,174,0,4,0,6
2,2537,2400,137,0,484,1,6
2,2538,2542,-4,0,112,1,6
2,2435,2369,66,0,462,0,6
2,2275,2487,-212,0,121,0,6
2,2376,2412,-36,0,106,0,6
2,2400,2238,162,0,263,0,6
2,2482,2523,-41,0,130,0,6
2,2569,2492,77,0,267,0,6
2,2381,2527,-146,0,101,1,6
2,2415,2552,-137,0,112,0,6
2,2384,2457,-73,0,36,1,6
2,2384,2469,-85,0,433,0,6
2,2209,2501,-292,0,0,0,6
2,2430,2283,147,0,61,1,6
2,2620,2480,140,0,122,1,6
2,2442,2465,-23,0,121,1,6
2,2406,2548,-142,0,111,0,6
2,2549,2598,-49,0,245,1,6
2,2405,2592,-187,0,4,0,6
2,2324,2472,-148,0,123,0,6
2,2411,2373,38,0,201,0,6
2,2402,2550,-148,0,168,0,6
2,2416,2321,95,0,245,0,6
2,2506,2432,74,0,190,0,6
2,2523,2657,-134,0,414,1,6
2,2332,2403,-71,0,45,0,6
2,2436,2368,68,0,325,0,6
2,2310,2501,-191,0,27,0,6
2,2407,2409,-2,0,474,0,6
2,2407,2568,-161,0,49,0,6
2,2503,2525,-22,0,306,1,6
2,2420,2271,149,0,127,1,6
2,2287,2408,-121,0,201,0,6
2,2307,2475,-168,0,310,0,6
2,2423,2429,-6,0,241,1,6
2,2562,2560,2,0,401,1,6
2,2425,2577,-152,0,80,0,6
2,2411,2383,28,0,240,0,6
2,2440,2520,-80,0,20,0,6
2,2467,2598,-131,0,122,0,6
2,2415,2249,166,0,176,0,6
2,2381,2422,-41,0,207,1,6
2,2358,2427,-69,0,302,0,6
2,2532,2570,-38,0,170,0,6
2,2402,2419,-17,0,40,1,6
2,2487,2544,-57,0,201,0,6
2,2494,2458,36,0,101,0,6
2,2610,2556,54,0,113,0,6
2,2358,2433,-75,0,45,0,6
2,2372,2426,-54,0,140,0,6
2,2405,2373,32,0,252,0,6
2,2369,2608,-239,0,92,0,8
2,2434,2287,147,0,392,1,6
2,2423,2559,-136,0,115,0,6
2,2491,2525,-34,0,141,0,6
2,2663,2671,-8,0,152,0,6
2,2546,2530,16,0,17,1,6
2,2286,2431,-145,0,4,0,6
2,2439,2522,-83,0,123,0,6
2,2269,2486,-217,0,131,0,6
2,2381,2496,-115,0,108,0,6
2,2406,2439,-33,0,41,0,6
2,2251,2401,-150,0,241,0,8
2,2402,2366,36,0,15,0,6
2,2357,2405,-48,0,28,0,6
2,2478,2564,-86,0,247,0,6
2,2201,2466,-265,0,414,0,6
2,2400,2333,67,0,90,0,6
2,2326,2404,-78,0,0,0,6
2,2580,2559,21,0,25,0,6
2,2432,2344,88,0,315,1,6
2,2416,2468,-52,0,123,0,6
2,2507,2659,-152,0,40,0,6
2,2580,2291,289,0,5,0,6
2,2434,2324,110,0,153,0,6
2,2344,2495,-151,0,15,0,6
2,2305,2437,-132,0,484,1,6
2,2252,2410,-158,0,45,1,6
2,2592,2506,86,0,7,1,6
2,2327,2424,-97,0,380,0,6
2,2534,2359,175,0,43,0,6
2,2423,2503,-80,0,102,1,6
2,2390,2439,-49,0,40,0,6
2,2420,2408,12,0,107,0,6
2,2335,2438,-103,0,40,0,6
2,2653,2650,3,0,455,0,6
2,2387,2554,-167,0,101,0,6
2,2391,2497,-106,0,75,1,6
2,2534,2419,115,0,332,0,6
2,2311,2405,-94,0,10,0,6
2,2406,2476,-70,0,192,0,6
2,2297,2400,-103,0,108,0,6
2,2403,2407,-4,0,40,0,6
2,2434,2392,42,0,45,0,6
2,2639,2682,-43,0,150,0,6
2,2406,2482,-76,0,117,0,6
2,2423,2366,57,0,15,0,6
2,2358,2455,-97,0,8,0,6
2,2436,2412,24,0,110,0,6
2,2481,2435,46,0,100,0,6
2,2505,2377,128,0,205,0,6
2,2435,2353,82,0,245,0,6
2,2402,2331,71,0,2,0,6
2,2477,2354,123,0,4,1,6
2,2414,2434,-20,0,241,1,6
2,2247,2493,-246,0,203,0,6
2,2405,2541,-136,0,256,0,6
2,2580,2558,22,0,301,0,6
2,2563,2326,237,0,8,0,6
2,2345,2410,-65,0,100,0,6
2,2628,2654,-26,0,113,0,6
2,2410,2492,-82,0,241,1,6
2,2342,2400,-58,0,43,1,6
2,2531,2542,-11,0,249,0,6
2,2439,2438,1,0,128,0,6
2,2564,2557,7,0,22,1,6
2,2425,2425,0,0,15,0,6
2,2550,2483,67,0,40,0,6
2,2542,2626,-84,0,130,0,6
2,2465,2581,-116,0,100,0,6
2,2496,2373,123,0,45,0,6
2,2233,2410,-177,0,28,0,6
2,2328,2437,-109,0,41,1,8
2,2538,2450,88,0,255,0,6
2,2456,2303,153,0,150,0,6
2,2528,2570,-42,0,148,0,6
2,2397,2580,-183,0,110,0,6
2,2352,2422,-70,0,12,0,5
2,2245,2430,-185,0,311,1,6
2,2426,2522,-96,0,131,0,6
2,2462,2416,46,0,33,0,6
2,2443,2525,-82,0,301,0,6
2,2477,2351,126,0,56,1,6
2,2503,2465,38,0,211,1,6
2,2218,2408,-190,0,300,1,8
2,2289,2547,-258,0,112,0,6
2,2403,2345,58,0,331,0,6
2,2490,2562,-72,0,272,1,6
2,2460,2335,125,0,40,0,6
2,2361,2449,-88,0,193,1,6
2,2499,2652,-153,0,414,0,6
2,2321,2437,-116,0,253,0,6
2,2298,2461,-163,0,147,1,6
2,2415,2427,-12,0,120,0,6
2,2517,2414,103,0,338,0,6
2,2430,2423,7,0,220,0,8
2,2411,2437,-26,0,303,0,6
2,2535,2476,59,0,5,0,6
2,2308,2423,-115,0,143,0,6
2,2474,2293,181,0,0,0,6
2,2419,2477,-58,0,307,1,6
2,2451,2468,-17,0,40,1,6
2,2656,2228,428,0,345,0,6
2,2557,2479,78,0,320,1,6
2,2404,2360,44,0,135,0,6
2,2512,2378,134,0,40,0,6
2,2541,2342,199,0,483,0,6
2,2431,2527,-96,0,414,0,6
2,2533,2481,52,0,216,0,6
2,2411,2301,110,0,106,0,6
2,2422,2376,46,0,45,0,6
2,2523,2533,-10,0,301,0,6
2,2536,2512,24,0,31,0,6
2,2310,2436,-126,0,45,0,6
2,2495,2557,-62,0,405,1,6
2,2471,2364,107,0,331,0,6
2,2403,2289,114,0,255,0,6
2,2476,2474,2,0,140,0,6
2,2362,2517,-155,0,453,0,6
2,2205,2480,-275,0,463,1,6
2,2432,2378,54,0,5,1,6
2,2316,2512,-196,0,20,0,6
2,2342,2434,-92,0,40,0,6
2,2592,2635,-43,0,167,0,6
2,2441,2583,-142,0,15,0,6
2,2483,2662,-179,0,253,0,6
2,2375,2444,-69,0,46,0,6
2,2464,2500,-36,0,102,0,6
2,2575,2655,-80,0,398,0,6
2,2410,2402,8,0,107,0,6
2,2443,2420,23,0,108,0,6
2,2500,2627,-127,0,15,0,6
2,2458,2345,113,0,4,0,6
2,2583,2553,30,0,50,1,6
2,2382,2415,-33,0,38,0,6
2,2327,2421,-94,0,45,0,6
2,2576,2548,28,0,13,0,6
2,2296,2527,-231,0,302,1,6
2,2440,2430,10,0,110,0,6
2,2467,2412,55,0,107,0,6
2,2306,2427,-121,0,140,0,6
2,2409,2410,-1,0,43,0,6
2,2482,2478,4,0,300,0,6
2,2403,2335,68,0,61,0,6
2,2521,2422,99,0,315,1,6
2,2568,2471,97,0,150,1,6
2,2402,2404,-2,0,1,0,6
2,2337,2400,-63,0,121,0,6
2,2467,2472,-5,0,241,1,6
2,2454,2307,147,0,158,0,6
2,2621,2630,-9,0,426,0,6
2,2266,2424,-158,0,48,1,6
2,2366,2424,-58,0,107,0,6
2,2417,2664,-247,0,101,0,6
2,2368,2441,-73,0,1,0,6
2,2508,2542,-34,0,246,0,6
2,2551,2477,74,0,11,0,6
2,2405,2480,-75,0,384,0,6
2,2342,2517,-175,0,240,0,6
2,2258,2533,-275,0,122,0,6
2,2379,2420,-41,0,46,1,6
2,2571,2567,4,0,101,0,6
2,2330,2583,-253,0,123,0,6
2,2452,2399,53,0,414,0,6
2,2422,2347,75,0,45,0,6
2,2428,2303,125,0,5,1,6
2,2301,2500,-199,0,247,0,6
2,2438,2427,11,0,104,0,6
2,2402,2313,89,0,265,0,6
2,2251,2429,-178,0,343,0,5
2,2432,2409,23,0,466,1,6
2,2290,2417,-127,0,146,0,6
2,2371,2409,-38,0,307,0,6
2,2355,2463,-108,0,140,1,6
2,2463,2374,89,0,338,0,6
2,2318,2457,-139,0,301,0,6
2,2421,2411,10,0,202,0,6
2,2475,2438,37,0,125,0,6
2,2431,2392,39,0,50,0,6
2,2363,2489,-126,0,207,1,6
2,2254,2401,-147,0,123,1,6
2,2398,2454,-56,0,212,1,6
2,2313,2416,-103,0,268,1,6
2,2499,2445,54,0,279,0,6
2,2498,2349,149,0,101,1,6
2,2284,2506,-222,0,132,1,6
2,2512,2465,47,0,115,0,6
2,2359,2473,-114,0,249,1,6
2,2515,2540,-25,0,327,0,6
2,2344,2417,-73,0,302,0,6
2,2362,2602,-240,0,249,0,6
2,2260,2433,-173,0,347,1,6
2,2458,2491,-33,0,301,1,6
2,2463,2499,-36,0,4,0,6
2,2298,2424,-126,0,139,0,7
2,2382,2460,-78,0,269,0,6
2,2298,2486,-188,4,117,0,13
2,2369,2534,-165,0,130,1,6
2,2436,2598,-162,0,27,1,6
2,2437,2485,-48,0,45,0,6
2,2368,2405,-37,0,124,0,6
2,2293,2404,-111,0,454,1,6
2,2610,2444,166,0,246,0,6
2,2409,2473,-64,0,200,1,6
2,2340,2400,-60,0,120,1,6
2,2438,2398,40,0,212,0,6
2,2437,2417,20,0,16,0,6
2,2433,2505,-72,0,241,1,6
2,2650,2630,20,0,460,1,6
2,2439,2449,-10,0,7,0,6
2,2443,2551,-108,0,132,0,6
2,2266,2400,-134,0,148,1,6
2,2229,2424,-195,0,13,0,6
2,2383,2431,-48,0,324,0,6
2,2285,2442,-157,0,40,0,6
2,2570,2467,103,0,107,0,6
2,2369,2413,-44,0,1,0,6
2,2255,2404,-149,0,100,1,6
2,2441,2433,8,0,102,0,6
2,2537,2481,56,0,337,0,6
2,2487,2468,19,0,49,0,6
2,2409,2271,138,0,0,0,6
2,2484,2442,42,0,128,0,6
2,2511,2462,49,0,120,0,6
2,2425,2521,-96,0,121,0,6
2,2671,2634,37,0,49,0,6
2,2618,2716,-98,0,7,1,6
2,2410,2341,69,0,455,0,6
2,2287,2442,-155,0,190,0,6
2,2432,2409,23,0,0,0,6
2,2323,2583,-260,2,145,1,24
2,2364,2474,-110,0,113,0,6
2,2409,2424,-15,0,108,0,6
2,2512,2504,8,0,302,1,6
2,2430,2559,-129,0,4,0,6
2,2368,2455,-87,0,119,0,6
2,2581,2439,142,0,469,0,6
2,2218,2421,-203,0,252,0,6
2,2409,2422,-13,0,143,0,6
2,2420,2607,-187,0,321,0,6
2,2443,2388,55,0,463,0,6
2,2549,2570,-21,0,121,0,6
2,2456,2513,-57,0,133,0,6
2,2306,2408,-102,0,484,0,6
2,2536,2406,130,0,311,1,6
2,2459,2393,66,0,302,0,6
2,2447,2345,102,0,40,0,6
2,2298,2481,-183,0,13,0,6
2,2427,2431,-4,0,177,0,6
2,2550,2535,15,0,40,0,6
2,2297,2412,-115,0,133,0,6
2,2499,2481,18,0,113,0,6
2,2413,2362,51,0,110,0,6
2,2308,2476,-168,4,129,1,13
2,2486,2547,-61,0,123,1,6
2,2499,2358,141,0,45,0,6
2,2486,2323,163,0,52,0,6
2,2350,2411,-61,0,121,0,6
2,2335,2417,-82,0,46,0,6
2,2400,2417,-17,0,120,0,6
2,2571,2516,55,0,103,0,6
2,2301,2508,-207,0,207,0,6
2,2417,2503,-86,0,453,0,6
2,2542,2467,75,0,267,0,6
2,2527,2566,-39,0,469,1,6
2,2462,2469,-7,0,114,1,6
2,2399,2413,-14,0,115,0,6
2,2402,2489,-87,0,102,0,6
2,2554,2481,73,0,148,0,6
2,2300,2422,-122,0,103,1,6
2,2435,2378,57,0,30,0,6
2,2333,2423,-90,0,58,0,8
2,2225,2473,-248,0,295,1,6
2,2418,2261,157,0,301,1,6
2,2256,2435,-179,0,131,0,6
2,2440,2416,24,0,150,0,6
2,2408,2455,-47,0,107,0,6
2,2240,2412,-172,0,123,0,6
2,2356,2407,-51,0,262,0,6
2,2509,2445,64,0,40,0,6
2,2297,2449,-152,0,302,0,6
2,2527,2438,89,0,426,0,6
2,2482,2464,18,0,396,1,6
2,2450,2506,-56,0,7,0,6
2,2489,2557,-68,0,300,0,6
2,2424,2328,96,0,302,0,6
2,2360,2464,-104,0,4,0,6
2,2540,2596,-56,0,246,0,6
2,2362,2440,-78,0,45,0,6
2,2549,2658,-109,0,344,0,6
2,2216,2521,-305,0,31,0,6
2,2397,2434,-37,0,0,1,6
2,2497,2676,-179,0,123,1,6
2,2358,2409,-51,0,46,0,8
2,2238,2447,-209,0,144,0,6
2,2438,2415,23,0,129,0,6
2,2350,2457,-107,0,2,0,6
2,2203,2421,-218,0,310,0,6
2,2328,2406,-78,0,11,0,6
2,2404,2282,122,0,41,1,6
2,2487,2382,105,0,53,0,6
2,2386,2606,-220,0,21,0,6
2,2439,2623,-184,0,112,0,6
2,2428,2246,182,0,46,1,6
2,2322,2554,-232,0,343,0,6
2,2430,2481,-51,0,242,0,6
2,2449,2389,60,0,108,0,6
2,2441,2453,-12,0,45,1,6
2,2419,2472,-53,0,491,0,6
2,2362,2413,-51,0,225,0,6
2,2562,2674,-112,0,10,0,6
2,2342,2410,-68,0,200,0,8
2,2577,2426,151,0,469,0,6
2,2360,2409,-49,0,254,0,6
2,2347,2683,-336,0,236,0,6
2,2507,2519,-12,0,140,1,6
2,2413,2385,28,0,484,0,6
2,2604,2445,159,0,261,0,6
2,2559,2742,-183,0,201,0,6
2,2215,2411,-196,0,40,0,6
2,2662,2528,134,0,130,1,6
2,2265,2403,-138,0,236,1,6
2,2276,2509,-233,0,420,0,6
2,2517,2450,67,0,221,0,6
2,2548,2574,-26,0,106,0,6
2,2238,2405,-167,0,385,0,6
2,2447,2496,-49,0,327,1,6
2,2410,2409,1,0,250,1,6
2,2416,2421,-5,0,44,0,8
2,2354,2453,-99,4,46,0,13
2,2258,2412,-154,0,130,1,6
2,2360,2415,-55,0,8,0,6
2,2566,2447,119,0,201,0,6
2,2337,2437,-100,0,106,0,6
2,2239,2495,-256,0,113,0,6
2,2307,2515,-208,0,151,1,6
2,2594,2315,279,0,41,1,6
2,2214,2440,-226,0,203,0,6
2,2479,2466,13,0,40,0,6
2,2427,2453,-26,0,15,0,6
2,2434,2334,100,0,337,0,6
2,2464,2417,47,0,484,0,6
2,2346,2492,-146,0,106,1,6
2,2585,2523,62,0,5,1,6
2,2433,2386,47,0,302,1,6
2,2421,2343,78,0,373,1,6
2,2492,2440,52,0,46,0,6
2,2596,2530,66,0,0,0,6
2,2408,2359,49,0,1,1,6
2,2433,2631,-198,0,448,0,6
2,2343,2458,-115,0,210,0,6
2,2378,2403,-25,0,45,1,6
2,2310,2424,-114,0,30,1,6
2,2313,2479,-166,0,106,0,6
2,2527,2320,207,0,5,1,6
2,2329,2429,-100,0,121,1,6
2,2506,2426,80,0,327,0,6
2,2487,2226,261,0,142,1,8
2,2359,2401,-42,0,112,0,6
2,2411,2330,81,0,56,1,6
2,2357,2411,-54,0,46,1,6
2,2402,2716,-314,0,225,0,6
2,2372,2428,-56,0,0,0,6
2,2443,2410,33,0,40,1,6
2,2444,2667,-223,0,45,1,6
2,2501,2570,-69,0,330,0,6
2,2281,2540,-259,0,106,0,6
2,2422,2483,-61,0,15,1,6
2,2353,2503,-150,0,211,0,6
2,2562,2257,305,0,115,0,6
2,2444,2507,-63,0,11,0,6
2,2453,2312,141,0,310,0,6
2,2456,2401,55,0,456,1,6
2,2492,2479,13,0,5,1,6
2,2383,2439,-56,0,107,0,6
2,2221,2459,-238,0,460,0,6
2,2492,2600,-108,0,278,0,6
2,2576,2640,-64,0,245,0,6
2,2451,2419,32,0,190,0,6
2,2514,2549,-35,0,302,0,6
2,2559,2601,-42,0,249,1,6
2,2540,2450,90,0,302,0,6
2,2418,2471,-53,0,145,0,6
2,2355,2451,-96,0,11,0,6
2,2287,2462,-175,0,5,0,6
2,2398,2481,-83,0,373,1,6
2,2335,2492,-157,0,80,0,6
2,2430,2470,-40,0,190,0,6
2,2338,2459,-121,0,34,0,6
2,2373,2419,-46,0,1,0,6
2,2588,2666,-78,0,57,0,6
2,2235,2475,-240,0,113,0,8
2,2444,2422,22,0,278,0,6
2,2433,2232,201,0,40,0,6
2,2438,2409,29,0,102,1,6
2,2544,2699,-155,0,130,1,6
2,2445,2366,79,0,49,0,6
2,2426,2466,-40,0,331,0,6
2,2518,2493,25,0,246,0,6
2,2575,2602,-27,0,101,0,6
2,2543,2406,137,0,45,0,6
2,2462,2361,101,0,140,0,6
2,2307,2405,-98,0,194,0,6
2,2425,2390,35,0,67,0,6
2,2463,2483,-20,0,147,0,6
2,2431,2494,-63,0,130,0,6
2,2433,2571,-138,0,277,0,6
2,2303,2425,-122,0,307,1,6
2,2386,2428,-42,0,302,1,6
2,2349,2478,-129,0,10,0,6
2,2432,2405,27,0,178,0,6
2,2346,2434,-88,0,80,1,6
2,2327,2477,-150,0,144,1,6
2,2275,2429,-154,0,340,0,8
2,2302,2621,-319,0,405,0,6
2,2438,2369,69,0,106,0,6
2,2485,2483,2,0,4,0,6
2,2426,2480,-54,0,53,0,6
2,2438,2313,125,0,123,0,6
2,2531,2397,134,0,140,0,6
2,2539,2622,-83,0,112,0,6
2,2412,2340,72,0,271,1,6
2,2289,2430,-141,0,1,0,6
2,2477,2372,105,0,479,0,6
2,2481,2244,237,0,210,1,6
2,2426,2441,-15,0,343,1,6
2,2650,2671,-21,0,150,1,6
2,2287,2449,-162,0,40,0,6
2,2446,2273,173,0,320,1,6
2,2428,2381,47,0,302,0,6
2,2463,2230,233,0,241,0,8
2,2342,2457,-115,0,300,1,6
2,2313,2492,-179,0,4,0,6
2,2358,2491,-133,0,43,0,6
2,2293,2452,-159,0,202,1,6
2,2387,2541,-154,0,41,0,6
2,2476,2410,66,0,302,0,6
2,2439,2571,-132,0,101,0,6
2,2479,2515,-36,0,6,1,6
2,2445,2438,7,0,106,0,6
2,2515,2287,228,0,0,1,6
2,2410,2407,3,0,44,0,6
2,2578,2488,90,0,45,0,6
2,2399,2504,-105,0,140,0,6
2,2490,2487,3,0,140,0,6
2,2413,2481,-68,0,5,0,6
2,2466,2519,-53,0,10,0,6
2,2405,2310,95,0,41,1,8
2,2574,2389,185,0,464,0,6
2,2405,2478,-73,0,15,0,6
2,2405,2446,-41,0,103,1,6
2,2442,2443,-1,0,10,0,6
2,2404,2394,10,0,309,0,6
2,2660,2616,44,0,404,0,6
2,2404,2374,30,0,127,0,6
2,2363,2473,-110,0,40,0,6
2,2402,2413,-11,4,310,0,13
2,2463,2466,-3,0,207,1,6
2,2442,2387,55,0,241,0,6
2,2421,2463,-42,0,338,0,6
2,2451,2238,213,0,4,0,8
2,2330,2458,-128,0,300,0,6
2,2297,2454,-157,0,315,0,6
2,2460,2415,45,0,487,0,6
2,2446,2489,-43,0,110,0,6
2,2403,2409,-6,0,114,0,6
2,2513,2522,-9,0,187,0,6
2,2424,2439,-15,0,469,0,6
2,2321,2492,-171,0,255,0,6
2,2663,2642,21,0,247,1,6
2,2423,2561,-138,0,1,1,6
2,2511,2489,22,0,268,0,6
2,2351,2505,-154,0,484,0,6
2,2532,2452,80,0,28,1,6
2,2456,2497,-41,0,311,0,6
2,2466,2357,109,0,123,0,6
2,2325,2401,-76,0,102,0,6
2,2364,2480,-116,0,53,0,6
2,2438,2614,-176,0,100,0,6
2,2415,2473,-58,0,103,0,6
2,2398,2504,-106,0,132,1,6
2,2519,2487,32,0,48,0,8
2,2560,2559,1,0,101,0,6
2,2367,2425,-58,0,130,0,6
2,2379,2419,-40,0,406,0,6
2,2537,2538,-1,0,46,0,6
2,2476,2509,-33,0,41,0,6
2,2449,2430,19,0,200,1,6
2,2533,2414,119,0,273,0,8
2,2235,2417,-182,0,110,1,6
2,2347,2413,-66,0,9,0,6
2,2415,2384,31,0,337,0,6
2,2338,2409,-71,0,140,0,6
2,2425,2253,172,0,177,1,6
2,2513,2563,-50,0,0,1,6
2,2425,2439,-14,0,198,1,6
2,2219,2581,-362,0,143,0,8
2,2480,2351,129,0,40,0,6
2,2593,2754,-161,0,40,0,6
2,2447,2289,158,0,435,0,6
2,2396,2456,-60,0,127,0,6
2,2330,2459,-129,0,487,0,6
2,2405,2321,84,0,40,1,6
2,2390,2532,-142,0,113,0,6
2,2517,2578,-61,0,453,0,6
2,2471,2372,99,0,300,0,6
2,2483,2434,49,0,102,0,6
2,2357,2408,-51,0,123,0,6
2,2435,2441,-6,0,373,0,6
2,2452,2556,-104,0,55,0,6
2,2211,2442,-231,0,45,0,6
2,2286,2458,-172,0,140,0,6
2,2353,2493,-140,0,310,0,6
2,2490,2450,40,0,10,0,6
2,2544,2444,100,0,45,0,6
2,2555,2549,6,0,4,0,6
2,2554,2462,92,0,0,0,6
2,2560,2487,73,0,248,0,6
2,2356,2481,-125,0,331,0,6
2,2341,2446,-105,0,111,1,6
2,2363,2430,-67,0,134,0,6
2,2314,2409,-95,0,303,1,6
2,2461,2361,100,0,44,0,6
2,2390,2421,-31,0,140,1,6
2,2358,2459,-101,0,215,0,6
2,2321,2508,-187,0,381,0,6
2,2400,2313,87,0,151,0,6
2,2407,2498,-91,0,414,0,6
2,2347,2429,-82,4,140,0,13
2,2257,2407,-150,0,112,0,8
2,2358,2444,-86,0,311,0,6
2,2422,2463,-41,0,204,0,6
2,2606,2504,102,0,255,0,6
2,2516,2822,-306,0,49,0,6
2,2306,2419,-113,0,122,0,6
2,2449,2387,62,0,1,0,6
2,2338,2425,-87,0,241,0,8
2,2426,2418,8,0,409,0,6
2,2246,2429,-183,0,107,0,6
2,2223,2488,-265,4,13,0,13
2,2252,2407,-155,4,123,0,13
2,2522,2651,-129,0,120,0,6
2,2386,2438,-52,0,268,0,6
2,2218,2475,-257,0,127,0,6
2,2406,2308,98,0,4,0,6
2,2362,2408,-46,0,469,0,6
2,2345,2419,-74,0,315,1,6
2,2540,2648,-108,0,46,0,6
2,2454,2410,44,0,205,0,6
2,2336,2404,-68,0,46,1,6
2,2468,2433,35,0,127,0,6
2,2394,2520,-126,0,170,0,6
2,2325,2411,-86,0,42,1,6
2,2399,2441,-42,0,217,0,6
2,2244,2449,-205,0,190,0,6
2,2397,2549,-152,0,457,0,6
2,2391,2470,-79,0,140,0,6
2,2578,2566,12,0,101,0,6
2,2360,2427,-67,0,133,0,6
2,2430,2505,-75,0,117,1,6
2,2359,2416,-57,0,5,0,6
2,2291,2425,-134,0,200,0,6
2,2518,2520,-2,0,45,0,6
2,2408,2240,168,0,101,1,6
2,2493,2207,286,0,120,0,6
2,2515,2382,133,0,211,1,6
2,2301,2405,-104,0,466,1,8
2,2402,2441,-39,0,246,0,6
2,2474,2412,62,0,106,0,6
2,2718,2500,218,0,1,0,6
2,2447,2403,44,0,6,0,6
2,2407,2354,53,0,20,1,6
2,2467,2249,218,0,106,0,6
2,2450,2428,22,0,15,1,6
2,2552,2564,-12,0,306,0,6
2,2261,2417,-156,0,131,0,6
2,2277,2433,-156,0,184,0,6
2,2602,2395,207,0,117,0,6
2,2582,2557,25,0,8,0,6
2,2607,2468,139,0,46,0,6
2,2403,2632,-229,0,45,0,6
2,2462,2442,20,0,245,0,6
2,2432,2368,64,0,205,0,6
2,2363,2451,-88,0,202,0,6
2,2565,2433,132,0,310,0,6
2,2361,2516,-155,0,122,0,6
2,2580,2743,-163,0,48,0,6
2,2412,2344,68,0,101,1,6
2,2574,2621,-47,0,112,1,6
2,2531,2541,-10,0,211,1,6
2,2374,2431,-57,0,129,0,6
2,2269,2467,-198,0,106,0,6
2,2637,2708,-71,0,190,1,6
2,2224,2477,-253,0,13,0,6
2,2455,2467,-12,0,260,0,6
2,2383,2555,-172,0,49,0,6
2,2506,2546,-40,0,101,0,6
2,2431,2650,-219,0,6,0,6
2,2598,2637,-39,0,303,0,6
2,2464,2473,-9,0,15,1,6
2,2486,2502,-16,0,7,0,6
2,2371,2528,-157,0,205,1,6
2,2433,2391,42,0,310,1,6
2,2414,2472,-58,0,40,0,6
2,2301,2440,-139,4,210,1,13
2,2457,2418,39,0,46,0,6
2,2491,2468,23,0,485,0,6
2,2317,2453,-136,0,310,0,5
2,2434,2409,25,0,131,0,6
2,2354,2403,-49,4,302,0,13
2,2324,2410,-86,0,40,0,6
2,2515,2305,210,0,178,1,6
2,2345,2477,-132,0,1,1,6
2,2388,2541,-153,0,106,0,6
2,2275,2445,-170,0,301,1,6
2,2434,2253,181,0,122,0,6
2,2355,2451,-96,0,156,0,6
2,2546,2503,43,0,5,0,6
2,2406,2336,70,0,109,0,6
2,2444,2397,47,0,190,0,6
2,2598,2676,-78,0,1,1,6
2,2351,2525,-174,0,338,0,6
2,2530,2382,148,0,140,0,6
2,2499,2589,-90,0,40,1,6
2,2428,2496,-68,0,240,0,6
2,2288,2424,-136,0,459,0,6
2,2441,2600,-159,0,45,0,6
2,2453,2429,24,0,105,0,6
2,2326,2457,-131,0,201,0,6
2,2255,2424,-169,0,444,1,6
2,2405,2344,61,0,131,0,6
2,2294,2400,-106,0,302,1,6
2,2404,2495,-91,0,138,0,6
2,2387,2639,-252,0,404,0,6
2,2445,2513,-68,0,442,0,6
2,2456,2364,92,0,96,0,6
2,2318,2471,-153,0,464,0,6
2,2422,2402,20,0,43,1,6
2,2559,2767,-208,0,20,0,6
2,2254,2532,-278,0,130,0,6
2,2519,2423,96,0,121,1,6
2,2467,2486,-19,0,115,0,6
2,2411,2438,-27,0,100,1,6
2,2349,2475,-126,0,101,0,6
2,2475,2500,-25,0,5,1,6
2,2304,2440,-136,0,45,1,6
2,2474,2489,-15,0,117,0,6
2,2553,2402,151,0,3,0,6
2,2210,2419,-209,0,101,0,6
2,2342,2549,-207,0,311,1,6
2,2727,2690,37,0,122,0,6
2,2328,2450,-122,0,4,0,6
2,2289,2432,-143,0,45,0,8
2,2430,2380,50,0,454,1,6
2,2345,2448,-103,0,3,1,6
2,2284,2436,-152,0,211,0,6
2,2392,2512,-120,0,43,0,6
2,2411,2372,39,0,43,0,6
2,2247,2419,-172,0,101,0,6
2,2354,2431,-77,0,354,0,6
2,2230,2433,-203,0,20,1,6
2,2422,2275,147,0,335,1,6
2,2379,2474,-95,0,142,0,6
2,2554,2576,-22,0,228,0,6
2,2432,2514,-82,0,301,1,6
2,2432,2475,-43,0,113,1,6
2,2444,2368,76,0,102,0,6
2,2557,2422,135,0,22,1,6
2,2488,2590,-102,0,45,0,6
2,2256,2433,-177,0,31,0,6
2,2354,2529,-175,0,2,0,6
2,2460,2373,87,0,40,0,8
2,2241,2405,-164,4,330,0,13
2,2465,2488,-23,0,106,0,6
2,2510,2527,-17,0,211,0,6
2,2294,2423,-129,0,46,1,6
2,2513,2442,71,0,326,0,6
2,2484,2547,-63,0,320,0,6
2,2220,2415,-195,0,300,0,6
2,2335,2453,-118,0,107,0,8
2,2469,2404,65,0,113,0,6
2,2266,2554,-288,0,306,0,6
2,2472,2633,-161,0,302,0,6
2,2245,2417,-172,0,40,0,8
2,2445,2438,7,0,247,0,6
2,2391,2496,-105,0,484,0,6
2,2338,2441,-103,0,211,0,6
2,2412,2468,-56,4,20,0,13
2,2383,2504,-121,0,143,0,6
2,2480,2514,-34,0,211,1,6
2,2226,2446,-220,0,110,0,6
2,2428,2333,95,0,230,0,6
2,2765,2612,153,0,150,1,6
2,2642,2498,144,0,121,0,6
2,2461,2462,-1,0,243,1,6
2,2501,2536,-35,0,243,0,6
2,2427,2257,170,0,311,1,6
2,2363,2457,-94,0,302,1,6
2,2345,2451,-106,0,107,0,6
2,2366,2656,-290,0,5,1,6
2,2319,2418,-99,0,20,0,6
2,2429,2452,-23,0,331,0,6
2,2348,2484,-136,0,301,0,6
2,2368,2429,-61,0,302,1,6
2,2515,2695,-180,0,84,0,6
2,2251,2481,-230,0,147,1,6
2,2376,2461,-85,0,268,0,6
2,2362,2439,-77,0,30,0,6
2,2463,2442,21,0,40,0,6
2,2405,2308,97,0,260,0,6
2,2452,2463,-11,0,487,1,6
2,2474,2616,-142,0,132,0,6
2,2449,2374,75,0,138,1,6
2,2414,2273,141,0,123,1,6
2,2319,2576,-257,0,247,0,6
2,2437,2560,-123,0,132,0,6
2,2312,2421,-109,0,150,0,6
2,2502,2386,116,0,107,0,6
2,2337,2417,-80,0,25,0,6
2,2548,2466,82,0,2,0,6
2,2455,2487,-32,0,245,0,6
2,2365,2418,-53,0,196,0,6
2,2415,2408,7,0,4,0,6
2,2502,2546,-44,0,333,0,6
2,2423,2419,4,0,415,0,6
2,2370,2444,-74,0,22,1,6
2,2610,2546,64,0,490,0,6
2,2401,2397,4,0,41,0,6
2,2413,2585,-172,0,178,0,6
2,2410,2462,-52,0,48,0,6
2,2505,2599,-94,0,0,0,6
2,2416,2421,-5,0,101,0,8
2,2403,2728,-325,0,12,0,6
2,2312,2437,-125,0,40,0,8
2,2532,2458,74,0,4,0,6
2,2411,2514,-103,0,122,0,6
2,2204,2524,-320,0,331,0,6
2,2339,2431,-92,0,250,0,6
2,2356,2470,-114,0,319,1,6
2,2314,2637,-323,0,122,0,8
2,2544,2597,-53,0,337,1,6
2,2587,2524,63,0,215,1,6
2,2404,2475,-71,0,242,0,6
2,2546,2498,48,0,265,1,6
2,2337,2491,-154,0,40,0,6
2,2429,2379,50,0,115,0,6
2,2374,2476,-102,0,122,0,6
2,2403,2396,7,0,265,0,6
2,2439,2407,32,0,302,0,6
2,2350,2450,-100,0,46,0,6
2,2434,2348,86,0,167,0,6
2,2443,2322,121,0,4,1,6
2,2404,2457,-53,0,300,0,6
2,2430,2291,139,0,337,0,6
2,2539,2582,-43,0,313,1,6
2,2400,2457,-57,0,241,0,6
2,2434,2380,54,0,140,0,6
2,2326,2400,-74,0,277,0,6
2,2672,2717,-45,0,31,0,6
2,2543,2459,84,0,311,1,6
2,2443,2351,92,0,46,0,6
2,2499,2469,30,0,5,0,6
2,2383,2405,-22,0,209,0,6
2,2371,2400,-29,0,110,0,6
2,2263,2433,-170,0,255,1,6
2,2335,2432,-97,0,454,0,6
2,2365,2402,-37,0,200,0,6
2,2416,2345,71,0,306,0,6
2,2365,2491,-126,0,49,0,6
2,2419,2355,64,0,5,0,6
2,2273,2537,-264,0,112,0,6
2,2401,2225,176,0,207,1,6
2,2339,2402,-63,0,115,1,6
2,2596,2398,198,0,49,0,6
2,2331,2428,-97,0,386,1,6
2,2453,2382,71,0,49,0,6
2,2379,2409,-30,0,320,0,6
2,2335,2449,-114,0,326,0,6
2,2402,2415,-13,0,325,0,6
2,2254,2411,-157,0,31,0,6
2,2323,2535,-212,0,103,0,5
2,2663,2661,2,0,7,0,6
2,2483,2501,-18,0,241,0,6
2,2423,2318,105,0,145,0,6
2,2388,2577,-189,0,2,0,6
2,2422,2492,-70,0,100,0,6
2,2412,2373,39,0,6,0,6
2,2568,2518,50,0,0,0,6
2,2245,2440,-195,0,40,0,6
2,2654,2532,122,0,107,1,6
2,2507,2826,-319,0,101,0,6
2,2333,2419,-86,0,326,0,6
2,2528,2581,-53,0,134,0,6
2,2508,2503,5,0,52,1,6
2,2416,2578,-162,0,43,0,6
2,2404,2362,42,0,106,0,6
2,2366,2532,-166,0,49,0,6
2,2358,2499,-141,0,380,0,6
2,2435,2424,11,0,140,0,6
2,2590,2615,-25,0,277,0,6
2,2459,2378,81,0,49,0,6
2,2333,2517,-184,0,1,0,6
2,2616,2502,114,0,115,1,6
2,2328,2523,-195,0,40,1,6
2,2537,2557,-20,0,338,1,6
2,2351,2520,-169,0,310,0,6
2,2264,2671,-407,0,4,0,8
2,2446,2452,-6,0,14,0,6
2,2365,2405,-40,0,110,0,6
2,2529,2472,57,0,120,0,6
2,2508,2459,49,0,311,0,6
2,2421,2377,44,0,42,1,6
2,2349,2414,-65,0,133,0,6
2,2329,2495,-166,0,3,0,6
2,2281,2454,-173,0,115,1,6
2,2407,2271,136,0,310,0,6
2,2482,2456,26,0,101,0,6
2,2275,2410,-135,0,314,0,6
2,2293,2417,-124,0,121,0,6
2,2474,2608,-134,0,120,0,6
2,2453,2449,4,0,269,0,6
2,2407,2307,100,0,53,0,6
2,2452,2599,-147,0,106,0,6
2,2363,2526,-163,0,133,0,6
2,2302,2441,-139,0,45,0,6
2,2483,2437,46,0,190,0,6
2,2411,2415,-4,0,106,0,5
2,2422,2382,40,0,300,1,6
2,2461,2442,19,0,1,0,6
2,2452,2403,49,0,344,1,6
2,2264,2433,-169,0,106,0,6
2,2585,2332,253,0,100,0,6
2,2306,2416,-110,0,228,0,6
2,2339,2450,-111,0,101,0,6
2,2372,2521,-149,0,103,0,6
2,2537,2487,50,0,131,0,6
2,2415,2408,7,0,170,1,6
2,2410,2441,-31,0,70,0,6
2,2501,2365,136,0,106,0,6
2,2382,2424,-42,0,250,0,6
2,2479,2486,-7,0,360,1,6
2,2474,2498,-24,0,295,0,6
2,2431,2509,-78,0,241,0,6
2,2451,2567,-116,0,40,0,6
2,2373,2416,-43,0,46,1,6
2,2438,2293,145,0,255,0,6
2,2374,2495,-121,0,0,0,6
2,2625,2465,160,0,341,1,6
2,2294,2422,-128,0,40,0,6
2,2433,2392,41,0,170,0,6
2,2368,2481,-113,0,250,0,6
2,2513,2411,102,0,331,0,6
2,2339,2580,-241,0,414,0,6
2,2286,2639,-353,0,200,0,6
2,2407,2379,28,0,487,1,6
2,2846,2622,224,0,404,0,6
2,2361,2402,-41,0,45,1,6
2,2650,2624,26,0,200,1,6
2,2411,2205,206,0,135,0,6
2,2410,2485,-75,0,200,0,6
2,2415,2359,56,0,50,0,6
2,2584,2549,35,0,148,0,6
2,2359,2535,-176,0,102,0,6
2,2417,2275,142,0,253,0,6
2,2492,2496,-4,0,306,0,6
2,2595,2595,0,0,4,0,6
2,2387,2426,-39,0,311,1,6
2,2468,2433,35,0,6,0,6
2,2367,2579,-212,0,40,0,6
2,2485,2477,8,0,4,0,6
2,2421,2358,63,0,400,1,6
2,2231,2419,-188,0,112,0,6
2,2539,2542,-3,0,80,1,6
2,2491,2359,132,0,153,0,6
2,2257,2601,-344,0,337,0,6
2,2308,2486,-178,4,22,0,13
2,2486,2567,-81,0,265,0,6
2,2423,2368,55,0,117,1,6
2,2431,2393,38,0,245,0,5
2,2442,2453,-11,0,1,0,6
2,2427,2476,-49,0,302,1,6
2,2393,2462,-69,0,121,0,6
2,2443,2396,47,0,9,0,6
2,2521,2314,207,0,176,0,6
2,2457,2691,-234,0,250,1,6
2,2544,2481,63,0,386,0,6
2,2550,2545,5,0,45,0,6
2,2230,2431,-201,0,250,0,6
2,2318,2437,-119,0,313,0,6
2,2472,2393,79,0,337,0,6
2,2538,2526,12,0,20,0,6
2,2454,2473,-19,0,341,1,6
2,2412,2323,89,0,4,0,6
2,2235,2449,-214,0,250,0,6
2,2405,2373,32,0,491,1,6
2,2518,2427,91,0,15,0,6
2,2427,2519,-92,0,101,0,6
2,2776,2606,170,0,382,0,6
2,2327,2404,-77,0,385,0,6
2,2551,2495,56,0,455,0,6
2,2364,2411,-47,0,130,0,6
2,2386,2459,-73,0,133,0,6
2,2235,2427,-192,0,302,0,7
2,2538,2545,-7,0,96,0,6
2,2411,2481,-70,0,40,0,6
2,2341,2410,-69,0,1,0,6
2,2424,2485,-61,0,10,0,6
2,2519,2566,-47,0,301,1,6
2,2461,2374,87,0,457,0,8
2,2495,2440,55,0,109,0,6
2,2537,2531,6,0,311,0,6
2,2458,2323,135,0,5,1,6
2,2608,2514,94,0,302,0,6
2,2721,2689,32,0,6,0,6
2,2444,2390,54,0,300,0,6
2,2426,2415,11,0,474,0,6
2,2423,2336,87,0,43,0,6
2,2422,2264,158,0,15,0,6
2,2461,2565,-104,0,40,0,6
2,2423,2527,-104,0,7,0,8
2,2277,2456,-179,0,120,0,6
2,2332,2679,-347,0,1,0,6
2,2356,2487,-131,0,15,0,6
2,2279,2454,-175,0,101,1,6
2,2501,2534,-33,0,0,0,6
2,2501,2363,138,0,13,0,6
2,2343,2409,-66,0,49,0,6
2,2360,2529,-169,0,21,0,6
2,2441,2455,-14,0,247,0,6
2,2453,2501,-48,0,40,0,6
2,2506,2655,-149,0,335,0,6
2,2411,2279,132,0,45,0,6
2,2425,2492,-67,0,123,1,6
2,2702,2388,314,0,45,0,8
2,2371,2540,-169,0,278,0,6
2,2339,2522,-183,0,8,1,8
2,2539,2476,63,0,120,0,6
2,2411,2460,-49,0,200,0,6
2,2536,2280,256,0,0,0,6
2,2296,2425,-129,4,51,0,13
2,2495,2320,175,0,300,0,6
2,2443,2422,21,0,60,1,6
2,2495,2395,100,0,35,1,6
2,2245,2428,-183,0,382,0,6
2,2518,2586,-68,0,343,0,6
2,2463,2339,124,0,241,0,6
2,2504,2467,37,0,302,1,6
2,2460,2498,-38,0,4,0,6
2,2402,2539,-137,0,311,1,6
2,2567,2428,139,0,325,0,6
2,2512,2533,-21,0,201,1,6
2,2533,2213,320,0,10,0,6
2,2385,2553,-168,0,271,0,6
2,2417,2474,-57,0,112,1,6
2,2294,2687,-393,0,212,1,6
2,2358,2409,-51,0,120,0,6
2,2422,2287,135,0,20,1,6
2,2371,2416,-45,0,2,0,6
2,2425,2345,80,0,13,0,6
2,2387,2416,-29,0,200,1,6
2,2503,2543,-40,0,344,0,6
2,2675,2706,-31,0,404,1,6
2,2324,2411,-87,0,312,0,6
2,2420,2450,-30,4,405,1,13
2,2506,2577,-71,0,484,1,6
2,2607,2630,-23,0,80,1,6
2,2499,2451,48,0,55,0,6
2,2279,2416,-137,0,253,0,6
2,2387,2476,-89,0,125,1,6
2,2413,2411,2,0,103,0,6
2,2540,2449,91,0,45,0,6
2,2554,2527,27,0,310,0,6
2,2416,2423,-7,0,247,0,6
2,2266,2438,-172,0,8,1,6
2,2772,2826,-54,0,310,0,6
2,2250,2427,-177,0,2,1,6
2,2411,2395,16,0,138,1,6
2,2479,2460,19,0,16,0,6
2,2241,2401,-160,0,122,0,6
2,2433,2354,79,0,241,1,6
2,2287,2436,-149,0,311,1,6
2,2402,2445,-43,0,109,0,6
2,2636,2419,217,0,341,0,6
2,2406,2488,-82,0,152,0,8
2,2432,2376,56,0,211,0,6
2,2641,2641,0,0,111,1,6
2,2436,2580,-144,0,331,0,6
2,2415,2449,-34,0,45,0,6
2,2440,2673,-233,0,107,0,6
2,2606,2593,13,0,395,0,6
2,2413,2454,-41,0,101,0,6
2,2509,2540,-31,0,302,0,6
2,2555,2685,-130,0,426,0,6
2,2466,2360,106,0,10,1,6
2,2455,2396,59,0,0,0,6
2,2616,2561,55,0,302,0,6
2,2348,2474,-126,0,128,0,6
2,2505,2606,-101,0,80,1,6
2,2426,2380,46,0,200,0,6
2,2414,2485,-71,0,330,0,6
2,2511,2504,7,0,0,0,6
2,2283,2412,-129,0,311,0,6
2,2348,2425,-77,0,123,0,6
2,2429,2394,35,0,310,0,6
2,2396,2532,-136,0,226,1,6
2,2441,2454,-13,0,242,1,6
2,2427,2410,17,0,176,0,6
2,2356,2439,-83,0,102,1,6
2,2317,2432,-115,0,380,0,6
2,2536,2414,122,0,258,1,6
2,2346,2486,-140,0,0,0,6
2,2423,2293,130,0,405,0,6
2,2428,2427,1,0,46,0,6
2,2469,2312,157,0,200,0,6
2,2473,2370,103,0,242,0,6
2,2206,2413,-207,0,118,0,6
2,2525,2396,129,0,330,0,6
2,2406,2285,121,0,45,1,6
2,2425,2270,155,0,385,0,6
2,2296,2401,-105,0,45,1,6
2,2410,2379,31,0,229,0,6
2,2296,2401,-105,0,10,0,6
2,2585,2567,18,0,16,0,6
2,2395,2682,-287,0,3,0,6
2,2455,2546,-91,0,211,0,6
2,2345,2431,-86,0,136,0,6
2,2411,2504,-93,0,80,0,6
2,2438,2426,12,0,104,1,6
2,2435,2534,-99,0,280,0,6
2,2393,2430,-37,0,311,1,6
2,2445,2400,45,0,245,0,6
2,2446,2370,76,0,112,0,6
2,2348,2414,-66,0,211,0,6
2,2471,2369,102,0,404,0,6
2,2493,2277,216,0,140,0,6
2,2505,2572,-67,0,248,0,6
2,2574,2576,-2,0,300,0,6
2,2420,2557,-137,0,311,0,6
2,2483,2442,41,0,122,0,6
2,2299,2489,-190,0,101,0,6
2,2444,2303,141,0,0,0,6
2,2557,2552,5,0,300,0,6
2,2378,2434,-56,0,315,0,6
2,2384,2425,-41,0,247,0,6
2,2398,2584,-186,0,123,0,6
2,2553,2541,12,0,145,0,6
2,2396,2427,-31,0,200,0,6
2,2425,2510,-85,0,150,0,6
2,2250,2450,-200,0,140,0,6
2,2432,2407,25,0,302,0,6
2,2407,2388,19,0,111,1,6
2,2409,2424,-15,0,6,0,6
2,2364,2472,-108,0,148,1,6
2,2425,2377,48,0,247,0,6
2,2384,2429,-45,0,172,0,6
2,2530,2562,-32,0,45,0,6
2,2414,2284,130,0,131,0,6
2,2372,2400,-28,0,106,0,6
2,2256,2539,-283,0,120,0,6
2,2526,2377,149,0,118,0,6
2,2347,2595,-248,0,405,0,6
2,2323,2449,-126,0,463,0,6
2,2511,2581,-70,0,103,0,6
2,2566,2719,-153,0,331,0,6
2,2531,2565,-34,0,120,0,6
2,2512,2513,-1,0,335,0,6
2,2416,2542,-126,0,213,1,6
2,2265,2467,-202,0,100,0,8
2,2475,2495,-20,0,269,0,6
2,2467,2617,-150,0,484,0,6
2,2571,2575,-4,0,108,0,6
2,2532,2506,26,0,45,1,6
2,2435,2376,59,0,302,1,6
2,2464,2460,4,0,484,0,6
2,2281,2550,-269,0,45,0,6
2,2506,2626,-120,0,196,0,6
2,2452,2467,-15,0,345,1,6
2,2419,2463,-44,0,453,0,6
2,2496,2477,19,0,129,0,6
2,2467,2588,-121,0,202,0,6
2,2462,2521,-59,0,28,0,6
2,2632,2531,101,0,123,0,6
2,2363,2512,-149,0,253,0,6
2,2578,2510,68,0,101,1,6
2,2391,2409,-18,0,267,0,6
2,2419,2426,-7,0,248,0,6
2,2456,2393,63,0,10,0,6
2,2546,2499,47,0,118,1,6
2,2413,2259,154,0,429,0,6
2,2381,2413,-32,0,0,1,6
2,2486,2448,38,0,107,0,6
2,2402,2470,-68,0,118,0,6
2,2410,2332,78,0,331,0,6
2,2282,2674,-392,0,483,0,6
2,2647,2672,-25,0,247,0,6
2,2352,2471,-119,0,245,0,6
2,2311,2434,-123,0,330,0,6
2,2250,2434,-184,4,40,0,13
2,2456,2419,37,0,265,0,6
2,2416,2362,54,0,45,0,6
2,2578,2751,-173,0,300,0,6
2,2340,2454,-114,0,343,0,6
2,2414,2320,94,0,0,0,6
2,2413,2273,140,0,84,0,6
2,2632,2433,199,0,320,0,6
2,2286,2432,-146,0,27,0,6
2,2375,2489,-114,0,411,0,6
2,2272,2561,-289,0,50,0,6
2,2419,2385,34,0,40,0,6
2,2625,2617,8,0,57,0,6
2,2412,2314,98,0,31,1,6
2,2449,2403,46,2,310,0,23
2,2391,2407,-16,0,202,0,6
2,2358,2401,-43,0,4,0,6
2,2600,2608,-8,0,457,0,6
2,2431,2234,197,0,40,0,6
2,2563,2486,77,0,333,0,6
2,2335,2445,-110,0,398,0,6
2,2347,2418,-71,0,45,0,6
2,2464,2375,89,0,308,0,6
2,2255,2468,-213,0,382,0,6
2,2258,2410,-152,0,129,1,6
2,2256,2403,-147,0,40,1,6
2,2391,2496,-105,0,485,1,6
2,2620,2588,32,0,4,1,6
2,2489,2405,84,0,301,1,6
2,2458,2518,-60,0,46,0,6
2,2401,2397,4,0,386,1,6
2,2480,2383,97,0,140,0,6
2,2442,2291,151,0,151,0,6
2,2272,2428,-156,0,123,0,6
2,2330,2459,-129,0,0,0,6
2,2411,2427,-16,0,132,0,6
2,2495,2358,137,0,202,0,6
2,2274,2403,-129,0,255,0,6
2,2441,2359,82,0,115,1,6
2,2452,2483,-31,0,201,1,6
2,2380,2400,-20,0,16,0,6
2,2487,2477,10,0,302,0,6
2,2261,2507,-246,0,202,0,8
2,2404,2418,-14,0,201,0,6
2,2402,2445,-43,0,0,0,6
2,2539,2490,49,0,140,0,6
2,2503,2473,30,0,100,0,6
2,2420,2527,-107,0,377,0,6
2,2384,2468,-84,0,255,0,6
2,2406,2473,-67,0,23,0,6
2,2437,2485,-48,0,107,0,6
2,2414,2329,85,0,135,0,6
2,2436,2349,87,0,130,1,6
2,2462,2393,69,0,394,0,6
2,2405,2256,149,0,100,1,6
2,2293,2505,-212,0,108,1,6
2,2472,2378,94,0,49,1,6
2,2420,2403,17,0,456,0,6
2,2485,2308,177,0,8,0,0
2,2221,2459,-238,0,49,0,6
2,2295,2469,-174,0,143,1,6
2,2473,2451,22,0,241,0,6
2,2499,2305,194,0,112,0,6
2,2498,2266,232,0,365,0,6
2,2546,2656,-110,0,325,0,6
2,2230,2412,-182,0,40,0,6
2,2637,2549,88,0,190,0,6
2,2781,2738,43,0,295,0,6
2,2320,2407,-87,0,44,0,6
2,2376,2568,-192,0,140,1,6
2,2341,2458,-117,0,45,0,6
2,2342,2473,-131,0,1,1,6
2,2282,2421,-139,0,156,1,6
2,2391,2471,-80,0,210,0,6
2,2626,2594,32,0,315,0,6
2,2500,2464,36,0,107,0,6
2,2555,2616,-61,0,8,0,6
2,2461,2541,-80,0,46,1,6
2,2274,2438,-164,4,41,0,13
2,2514,2678,-164,0,331,0,6
2,2413,2527,-114,0,127,1,6
2,2635,2509,126,0,4,0,6
2,2429,2254,175,0,211,0,6
2,2411,2592,-181,0,114,0,6
2,2720,2423,297,0,143,0,6
2,2433,2359,74,0,40,1,6
2,2431,2474,-43,0,306,0,6
2,2378,2507,-129,0,1,0,6
2,2324,2469,-145,4,18,1,13
2,2427,2325,102,0,300,0,6
2,2474,2344,130,0,40,0,6
2,2358,2403,-45,0,45,1,6
2,2456,2404,52,0,46,0,6
2,2400,2406,-6,0,112,0,6
2,2496,2568,-72,0,300,0,6
2,2445,2339,106,0,192,0,6
2,2450,2480,-30,0,1,0,6
2,2248,2710,-462,0,0,0,8
2,2402,2389,13,0,366,1,6
2,2699,2601,98,0,45,0,6
2,2437,2506,-69,0,150,1,6
2,2439,2393,46,0,106,0,6
2,2401,2477,-76,0,4,0,6
2,2455,2512,-57,0,380,0,6
2,2430,2341,89,0,310,0,6
2,2235,2405,-170,0,173,0,8
2,2338,2442,-104,0,4,1,6
2,2433,2381,52,0,21,0,6
2,2457,2594,-137,0,304,0,6
2,2549,2518,31,0,373,1,6
2,2396,2536,-140,0,45,1,6
2,2676,2473,203,0,1,0,6
2,2432,2324,108,0,41,1,6
2,2512,2390,122,0,170,0,6
2,2408,2430,-22,0,241,0,6
2,2495,2644,-149,0,152,0,6
2,2433,2484,-51,0,56,0,6
2,2388,2454,-66,0,125,0,6
2,2515,2572,-57,0,341,1,6
2,2480,2446,34,0,4,0,6
2,2476,2592,-116,0,405,0,6
2,2390,2560,-170,0,106,0,6
2,2394,2493,-99,0,102,1,6
2,2485,2479,6,0,415,0,6
2,2478,2592,-114,0,4,0,6
2,2451,2467,-16,0,141,0,6
2,2549,2229,320,0,0,0,6
2,2456,2449,7,0,100,0,6
2,2402,2505,-103,0,45,0,6
2,2370,2495,-125,0,160,0,6
2,2404,2516,-112,0,1,0,6
2,2451,2290,161,0,111,0,6
2,2231,2409,-178,0,245,0,6
2,2207,2415,-208,0,202,0,6
2,2426,2506,-80,0,436,0,6
2,2508,2464,44,0,133,0,6
2,2470,2370,100,0,36,0,6
2,2543,2555,-12,0,200,1,6
2,2409,2496,-87,0,300,0,6
2,2478,2448,30,0,140,0,6
2,2533,2431,102,0,122,1,6
2,2352,2438,-86,0,300,1,6
2,2277,2449,-172,0,136,0,6
2,2309,2468,-159,0,302,0,8
2,2491,2407,84,0,106,0,6
2,2464,2449,15,0,241,0,6
2,2380,2400,-20,0,415,1,6
2,2301,2419,-118,0,190,0,6
2,2429,2550,-121,0,229,0,8
2,2429,2329,100,0,111,1,6
2,2403,2266,137,0,202,0,8
2,2447,2636,-189,0,113,0,6
2,2524,2650,-126,0,4,0,6
2,2302,2411,-109,0,202,0,6
2,2369,2478,-109,0,3,0,6
2,2535,2549,-14,0,341,0,6
2,2463,2600,-137,0,242,1,6
2,2334,2491,-157,0,300,1,6
2,2411,2413,-2,0,130,0,6
2,2595,2494,101,0,45,0,6
2,2499,2627,-128,0,484,0,6
2,2503,2516,-13,0,10,0,6
2,2475,2302,173,0,335,0,6
2,2447,2457,-10,0,314,0,6
2,2315,2435,-120,0,203,0,6
2,2539,2403,136,0,400,0,6
2,2362,2437,-75,0,302,0,6
2,2314,2479,-165,0,0,0,6
2,2475,2567,-92,0,469,1,6
2,2416,2463,-47,0,113,1,6
2,2483,2525,-42,0,260,1,6
2,2472,2350,122,0,101,0,6
2,2517,2370,147,0,8,0,6
2,2480,2314,166,0,213,1,6
2,2460,2585,-125,0,301,0,6
2,2452,2434,18,0,398,0,6
2,2420,2311,109,0,80,0,6
2,2377,2405,-28,0,41,0,6
2,2451,2448,3,0,331,0,6
2,2274,2533,-259,0,210,0,6
2,2525,2378,147,0,426,1,6
2,2350,2598,-248,0,214,1,6
2,2318,2444,-126,0,50,0,6
2,2445,2459,-14,0,100,0,6
2,2489,2536,-47,0,440,0,6
2,2507,2470,37,0,213,0,6
2,2495,2356,139,0,106,1,6
2,2342,2496,-154,0,308,1,6
2,2435,2419,16,0,7,0,6
2,2312,2459,-147,0,269,0,8
2,2421,2671,-250,0,253,0,6
2,2455,2457,-2,0,411,0,6
2,2421,2393,28,0,200,0,6
2,2222,2450,-228,4,468,0,13
2,2455,2462,-7,0,127,1,6
2,2491,2476,15,0,331,0,6
2,2401,2379,22,0,302,1,6
2,2400,2517,-117,0,45,1,6
2,2491,2455,36,0,142,1,6
2,2430,2481,-51,0,201,0,6
2,2409,2383,26,0,147,0,6
2,2358,2488,-130,0,483,0,6
2,2502,2468,34,0,210,1,6
2,2381,2466,-85,0,30,0,6
2,2335,2451,-116,0,0,1,6
2,2515,2480,35,0,46,1,6
2,2536,2441,95,0,15,0,6
2,2458,2438,20,0,455,0,6
2,2236,2412,-176,0,107,0,6
2,2281,2436,-155,0,107,1,6
2,2541,2509,32,0,102,1,6
2,2444,2548,-104,0,331,0,6
2,2323,2416,-93,0,101,0,6
2,2271,2506,-235,0,34,0,6
2,2400,2241,159,4,88,0,13
2,2403,2400,3,0,272,0,6
2,2422,2236,186,0,102,1,6
2,2492,2507,-15,0,46,0,6
2,2215,2525,-310,0,317,0,6
2,2579,2455,124,0,102,0,6
2,2307,2489,-182,0,43,0,6
2,2478,2405,73,0,40,1,6
2,2361,2437,-76,0,15,0,6
2,2288,2451,-163,0,106,1,6
2,2351,2401,-50,0,4,0,6
2,2498,2590,-92,0,300,0,6
2,2269,2442,-173,0,200,0,6
2,2325,2510,-185,0,201,0,6
2,2530,2507,23,0,107,0,6
2,2448,2367,81,0,302,0,6
2,2265,2400,-135,0,200,1,8
2,2421,2359,62,0,6,0,6
2,2278,2417,-139,0,58,0,6
2,2408,2468,-60,0,113,1,6
2,2433,2402,31,0,476,0,6
2,2433,2558,-125,0,113,0,6
2,2201,2480,-279,0,143,0,6
2,2429,2296,133,0,303,0,6
2,2307,2435,-128,0,11,0,6
2,2438,2387,51,0,31,0,6
2,2518,2493,25,0,3,0,6
2,2325,2450,-125,0,172,0,6
2,2474,2450,24,0,113,0,6
2,2305,2412,-107,0,157,0,6
2,2379,2423,-44,0,203,1,6
2,2371,2439,-68,0,46,0,8
2,2415,2555,-140,0,45,0,6
2,2431,2512,-81,0,484,0,6
2,2478,2477,1,0,45,0,6
2,2396,2434,-38,0,0,0,6
2,2260,2413,-153,0,190,1,8
2,2536,2426,110,0,6,0,6
2,2427,2398,29,0,462,0,6
2,2417,2243,174,0,4,1,6
2,2539,2550,-11,0,136,0,6
2,2255,2547,-292,0,38,1,6
2,2440,2388,52,0,200,0,6
2,2504,2386,118,0,315,0,6
2,2484,2301,183,0,301,0,6
2,2387,2421,-34,0,44,0,6
2,2707,2759,-52,0,302,0,6
2,2497,2478,19,0,112,0,6
2,2488,2452,36,0,200,0,6
2,2418,2451,-33,0,123,0,6
2,2218,2489,-271,0,7,1,6
2,2335,2459,-124,0,1,0,6
2,2328,2596,-268,0,107,0,6
2,2392,2420,-28,0,265,0,6
2,2478,2485,-7,0,55,0,6
2,2283,2401,-118,0,484,0,6
2,2292,2426,-134,0,45,1,6
2,2376,2520,-144,0,108,1,6
2,2423,2437,-14,0,321,0,6
2,2648,2588,60,0,335,0,6
2,2405,2233,172,0,311,0,6
2,2585,2427,158,0,115,1,6
2,2488,2470,18,0,0,0,6
2,2316,2452,-136,0,123,0,6
2,2507,2548,-41,0,45,1,6
2,2420,2487,-67,0,131,0,6
2,2227,2455,-228,0,106,0,6
2,2428,2239,189,0,40,0,6
2,2334,2405,-71,0,120,0,6
2,2401,2303,98,0,224,0,6
2,2324,2402,-78,0,106,0,6
2,2450,2493,-43,0,5,0,6
2,2402,2397,5,0,133,0,6
2,2304,2572,-268,0,343,1,6
2,2357,2493,-136,0,3,0,6
2,2405,2545,-140,0,277,0,6
2,2381,2498,-117,0,277,0,6
2,2577,2512,65,0,466,0,8
2,2448,2415,33,0,308,1,8
2,2476,2672,-196,0,151,0,6
2,2400,2397,3,0,45,1,6
2,2469,2434,35,0,426,0,6
2,2514,2563,-49,0,302,0,6
2,2409,2411,-2,0,112,0,6
2,2295,2460,-165,0,43,0,6
2,2464,2463,1,0,4,0,6
2,2432,2414,18,0,150,1,6
2,2407,2369,38,0,211,0,6
2,2659,2532,127,0,406,0,6
2,2415,2632,-217,0,194,0,6
2,2401,2277,124,0,243,1,6
2,2239,2411,-172,0,133,1,6
2,2362,2473,-111,0,57,0,6
2,2530,2444,86,0,132,0,6
2,2400,2348,52,0,40,1,6
2,2366,2550,-184,0,326,0,6
2,2308,2644,-336,0,0,0,6
2,2391,2424,-33,0,118,0,6
2,2384,2409,-25,0,10,0,6
2,2333,2405,-72,0,1,0,6
2,2464,2468,-4,0,100,1,6
2,2432,2518,-86,0,102,0,6
2,2371,2552,-181,0,300,0,6
2,2437,2273,164,0,43,0,6
2,2289,2436,-147,0,320,0,6
2,2262,2412,-150,0,331,0,6
2,2309,2474,-165,0,48,0,6
2,2357,2413,-56,0,1,0,6
2,2436,2451,-15,0,20,1,6
2,2339,2502,-163,0,211,0,6
2,2376,2400,-24,0,1,0,6
2,2462,2439,23,0,201,1,6
2,2269,2402,-133,0,7,0,8
2,2316,2425,-109,0,120,0,6
2,2508,2709,-201,0,140,0,6
2,2367,2452,-85,0,312,0,6
2,2277,2471,-194,0,404,0,6
2,2590,2585,5,0,302,0,6
2,2491,2568,-77,0,200,0,6
2,2473,2514,-41,0,113,1,6
2,2330,2442,-112,0,206,0,6
2,2364,2405,-41,0,45,0,6
2,2482,2523,-41,0,210,1,6
2,2408,2436,-28,0,225,0,6
2,2231,2457,-226,0,0,0,6
2,2394,2433,-39,0,202,0,6
2,2485,2546,-61,0,119,0,9
2,2549,2733,-184,0,151,0,6
2,2324,2422,-98,0,107,0,6
2,2369,2400,-31,0,335,0,6
2,2353,2451,-98,0,331,0,6
2,2375,2450,-75,0,394,0,6
2,2218,2453,-235,0,45,0,6
2,2439,2361,78,0,13,0,6
2,2458,2404,54,0,84,1,6
2,2426,2311,115,0,46,1,6
2,2240,2416,-176,0,151,0,6
2,2316,2491,-175,0,307,0,6
2,2413,2271,142,0,48,0,6
2,2403,2483,-80,0,394,0,6
2,2490,2385,105,0,302,0,6
2,2571,2472,99,0,310,0,6
2,2409,2334,75,0,122,0,6
2,2363,2423,-60,0,1,0,6
2,2388,2403,-15,0,7,0,6
2,2315,2409,-94,0,0,0,6
2,2360,2408,-48,0,110,0,6
2,2365,2521,-156,0,3,0,6
2,2444,2408,36,0,4,0,6
2,2251,2657,-406,0,200,0,6
2,2451,2509,-58,0,223,0,6
2,2419,2400,19,0,302,1,6
2,2452,2311,141,0,142,0,6
2,2385,2452,-67,0,3,0,6
2,2486,2468,18,0,80,1,6
2,2435,2367,68,0,4,0,6
2,2290,2539,-249,0,40,1,6
2,2470,2446,24,0,241,0,6
2,2397,2434,-37,0,245,0,6
2,2480,2616,-136,0,256,0,6
2,2541,2472,69,0,132,0,6
2,2536,2532,4,0,102,0,6
2,2362,2443,-81,0,337,0,6
2,2449,2458,-9,0,200,0,6
2,2402,2522,-120,0,4,0,6
2,2407,2503,-96,0,1,0,6
2,2250,2437,-187,0,123,0,6
2,2372,2492,-120,0,487,0,6
2,2292,2593,-301,0,112,0,6
2,2215,2481,-266,0,180,0,6
2,2472,2499,-27,0,140,0,6
2,2563,2564,-1,0,15,1,6
2,2402,2362,40,0,106,1,6
2,2441,2524,-83,0,200,0,6
2,2387,2465,-78,0,300,1,6
2,2321,2454,-133,0,8,0,6
2,2427,2298,129,0,152,0,6
2,2478,2427,51,0,491,0,6
2,2388,2493,-105,0,151,0,6
2,2467,2521,-54,0,101,0,6
2,2397,2491,-94,0,487,0,6
2,2441,2357,84,0,122,0,6
2,2478,2202,276,0,237,0,6
2,2446,2432,14,0,1,1,6
2,2348,2504,-156,0,330,0,6
2,2336,2477,-141,0,5,0,8
2,2404,2316,88,0,216,0,6
2,2411,2424,-13,0,127,0,6
2,2372,2403,-31,0,162,0,6
2,2416,2201,215,0,314,0,8
2,2341,2432,-91,0,466,0,6
2,2428,2550,-122,0,113,0,6
2,2567,2554,13,0,127,1,6
2,2254,2481,-227,0,45,0,6
2,2419,2328,91,0,111,0,8
2,2383,2526,-143,0,107,0,6
2,2215,2413,-198,4,150,0,13
2,2392,2645,-253,0,300,0,6
2,2516,2565,-49,0,315,0,6
2,2330,2407,-77,4,113,0,13
2,2369,2451,-82,0,160,1,6
2,2476,2413,63,0,337,1,6
2,2239,2504,-265,0,0,1,6
2,2285,2413,-128,0,113,0,6
2,2360,2493,-133,0,133,0,6
2,2377,2459,-82,0,144,0,6
2,2559,2481,78,0,202,0,6
2,2428,2406,22,0,150,1,6
2,2426,2437,-11,0,244,0,6
2,2444,2438,6,0,42,1,6
2,2425,2335,90,0,426,0,6
2,2332,2419,-87,0,0,0,6
2,2332,2417,-85,0,1,0,6
2,2498,2475,23,0,248,0,6
2,2580,2546,34,0,208,0,6
2,2439,2538,-99,0,4,0,6
2,2509,2632,-123,0,400,0,6
2,2304,2467,-163,0,322,1,6
2,2274,2441,-167,0,46,0,6
2,2398,2432,-34,0,101,0,6
2,2441,2369,72,0,242,0,6
2,2358,2530,-172,0,101,0,6
2,2322,2459,-137,4,280,0,13
2,2336,2616,-280,0,150,0,6
2,2491,2483,8,0,43,0,6
2,2691,2745,-54,0,47,0,6
2,2451,2252,199,0,84,0,6
2,2278,2661,-383,0,331,0,6
2,2734,2965,-231,0,486,0,6
2,2464,2543,-79,0,243,0,6
2,2276,2430,-154,0,380,0,6
2,2278,2516,-238,0,145,0,6
2,2583,2572,11,0,202,0,6
2,2583,2530,53,0,125,0,6
2,2418,2408,10,0,265,0,6
2,2245,2416,-171,0,45,0,6
2,2356,2441,-85,0,441,1,6
2,2453,2462,-9,0,415,0,6
2,2384,2586,-202,0,380,0,6
2,2547,2531,16,0,49,0,6
2,2472,2502,-30,0,18,1,6
2,2565,2548,17,0,398,1,6
2,2373,2511,-138,0,130,1,6
2,2493,2291,202,0,100,0,6
2,2402,2478,-76,0,201,1,6
2,2218,2452,-234,0,40,0,6
2,2283,2454,-171,0,45,0,6
2,2568,2556,12,0,140,0,6
2,2392,2454,-62,0,138,0,6
2,2287,2407,-120,0,143,0,6
2,2378,2422,-44,0,7,0,6
2,2473,2485,-12,0,45,1,6
2,2421,2600,-179,0,143,0,6
2,2401,2511,-110,0,0,1,6
2,2239,2473,-234,0,4,0,6
2,2355,2560,-205,0,1,0,6
2,2410,2391,19,0,46,0,6
2,2466,2395,71,0,142,1,6
2,2479,2521,-42,0,388,0,6
2,2392,2429,-37,0,45,1,6
2,2235,2408,-173,0,45,0,6
2,2390,2483,-93,0,9,0,6
2,2321,2419,-98,0,123,1,6
2,2390,2499,-109,0,122,1,6
2,2432,2513,-81,0,101,0,6
2,2442,2379,63,0,135,0,6
2,2449,2514,-65,0,49,0,6
2,2497,2428,69,0,7,0,6
2,2454,2397,57,0,85,1,6
2,2410,2545,-135,0,112,0,6
2,2400,2376,24,0,300,1,6
2,2264,2461,-197,0,36,0,6
2,2470,2436,34,0,315,0,6
2,2344,2480,-136,0,145,0,6
2,2488,2572,-84,0,40,1,6
2,2379,2454,-75,0,331,0,6
2,2290,2442,-152,0,302,0,6
2,2388,2418,-30,0,122,0,6
2,2245,2484,-239,0,85,0,6
2,2563,2532,31,0,7,0,6
2,2573,2560,13,0,207,1,6
2,2495,2545,-50,0,5,0,6
2,2339,2469,-130,0,25,0,6
2,2393,2544,-151,0,218,0,6
2,2455,2389,66,0,315,1,6
2,2414,2395,19,0,487,0,6
2,2532,2528,4,0,453,0,6
2,2387,2508,-121,0,143,1,6
2,2532,2552,-20,0,201,0,6
2,2223,2520,-297,0,132,0,6
2,2320,2515,-195,0,454,0,6
2,2391,2423,-32,0,111,0,6
2,2390,2423,-33,0,120,0,8
2,2482,2501,-19,0,246,0,6
2,2539,2547,-8,0,302,1,6
2,2280,2445,-165,0,45,0,6
2,2407,2337,70,0,101,0,6
2,2301,2418,-117,0,132,0,6
2,2446,2422,24,0,143,0,6
2,2434,2420,14,0,45,0,6
2,2509,2585,-76,0,300,1,6
2,2442,2448,-6,0,142,0,6
2,2399,2558,-159,0,200,0,6
2,2476,2469,7,0,400,0,6
2,2431,2517,-86,0,463,1,6
2,2281,2545,-264,0,127,1,6
2,2437,2393,44,0,131,0,6
2,2466,2483,-17,0,5,0,6
2,2396,2451,-55,0,466,0,6
2,2537,2441,96,0,42,0,6
2,2326,2440,-114,0,45,0,6
2,2452,2383,69,0,310,0,6
2,2316,2415,-99,0,4,0,6
2,2220,2443,-223,0,107,0,6
2,2386,2437,-51,0,302,0,6
2,2265,2428,-163,0,302,1,6
2,2291,2434,-143,0,210,0,6
2,2452,2245,207,0,112,0,6
2,2204,2426,-222,0,106,1,6
2,2221,2572,-351,0,300,0,6
2,2246,2578,-332,0,110,1,6
2,2413,2381,32,0,212,0,8
2,2454,2252,202,0,112,1,6
2,2265,2540,-275,0,45,0,6
2,2390,2402,-12,0,106,1,6
2,2254,2404,-150,0,40,0,6
2,2542,2458,84,0,469,0,6
2,2590,2574,16,0,18,0,6
2,2455,2386,69,0,45,0,8
2,2464,2500,-36,0,190,1,6
2,2378,2417,-39,0,0,0,6
2,2336,2442,-106,0,487,1,6
2,2283,2542,-259,0,101,0,6
2,2403,2405,-2,0,10,1,6
2,2391,2501,-110,0,270,0,6
2,2454,2453,1,0,28,0,6
2,2243,2416,-173,0,134,0,6
2,2618,2527,91,0,343,0,6
2,2538,2604,-66,0,0,0,6
2,2391,2576,-185,0,200,0,6
2,2511,2495,16,0,365,0,6
2,2462,2559,-97,0,40,1,6
2,2431,2411,20,0,101,0,6
2,2512,2589,-77,0,302,1,6
2,2426,2403,23,0,474,0,6
2,2401,2382,19,0,44,0,8
2,2699,2729,-30,0,0,1,6
2,2523,2492,31,0,56,1,6
2,2300,2456,-156,0,106,0,6
2,2423,2396,27,0,242,0,6
2,2431,2381,50,0,151,0,6
2,2524,2596,-72,0,6,1,6
2,2551,2368,183,0,273,0,6
2,2465,2361,104,0,310,0,6
2,2471,2543,-72,0,15,0,6
2,2452,2451,1,0,1,1,6
2,2247,2462,-215,0,50,1,6
2,2512,2652,-140,0,40,0,6
2,2531,2590,-59,0,217,0,6
2,2319,2423,-104,0,148,0,6
2,2448,2488,-40,0,255,1,6
2,2384,2649,-265,0,255,0,5
2,2363,2412,-49,0,19,0,6
2,2215,2505,-290,0,101,0,8
2,2403,2609,-206,0,140,0,8
2,2278,2435,-157,0,485,0,6
2,2281,2410,-129,0,41,1,6
2,2391,2448,-57,0,2,0,6
2,2322,2579,-257,0,300,0,5
2,2414,2376,38,0,280,0,6
2,2549,2371,178,0,411,0,6
2,2305,2442,-137,0,1,0,6
2,2456,2365,91,0,202,1,6
2,2334,2564,-230,0,394,0,6
2,2257,2406,-149,0,80,0,6
2,2408,2366,42,0,263,0,6
2,2323,2471,-148,0,374,0,6
2,2419,2426,-7,0,80,0,6
2,2207,2433,-226,0,45,0,6
2,2492,2416,76,0,148,1,6
2,2501,2454,47,0,331,0,6
2,2395,2435,-40,0,122,1,6
2,2599,2613,-14,0,321,0,6
2,2496,2472,24,0,8,0,6
2,2288,2433,-145,0,40,0,6
2,2516,2451,65,0,353,0,6
2,2450,2598,-148,0,45,1,6
2,2419,2371,48,0,140,0,6
2,2470,2687,-217,0,100,0,6
2,2448,2576,-128,0,247,1,6
2,2528,2413,115,0,301,1,6
2,2357,2491,-134,0,0,0,6
2,2432,2592,-160,0,4,0,6
2,2501,2642,-141,0,106,0,6
2,2421,2423,-2,0,58,0,6
2,2524,2500,24,0,124,0,6
2,2404,2523,-119,0,3,0,6
2,2557,2475,82,0,0,0,6
2,2534,2500,34,0,103,0,6
2,2364,2423,-59,0,211,0,6
2,2574,2560,14,0,280,0,6
2,2267,2424,-157,0,4,0,6
2,2468,2430,38,0,80,1,6
2,2446,2497,-51,0,102,0,6
2,2459,2322,137,0,242,0,6
2,2448,2545,-97,0,300,0,6
2,2422,2358,64,0,315,0,6
2,2245,2412,-167,0,50,1,6
2,2299,2425,-126,0,153,0,6
2,2550,2551,-1,0,100,1,6
2,2381,2482,-101,0,4,1,6
2,2593,2340,253,0,15,0,8
2,2499,2517,-18,0,46,1,6
2,2443,2355,88,0,373,0,6
2,2406,2419,-13,0,49,0,6
2,2458,2530,-72,0,156,0,6
2,2423,2429,-6,0,207,0,6
2,2431,2539,-108,0,300,0,6
2,2404,2495,-91,0,205,0,6
2,2477,2461,16,0,28,0,6
2,2476,2427,49,0,210,0,6
2,2246,2432,-186,4,111,0,8
2,2259,2520,-261,0,210,0,6
2,2321,2425,-104,0,241,0,6
2,2343,2411,-68,0,51,0,6
2,2583,2552,31,0,129,0,6
2,2257,2426,-169,0,111,1,6
2,2480,2365,115,0,46,1,6
2,2423,2484,-61,0,40,0,6
2,2405,2566,-161,0,112,0,6
2,2410,2490,-80,0,265,0,6
2,2352,2465,-113,0,220,0,6
2,2524,2573,-49,0,46,0,6
2,2351,2401,-50,0,41,0,6
2,2459,2653,-194,0,251,0,6
2,2437,2450,-13,0,156,0,6
2,2487,2641,-154,0,193,1,6
2,2209,2705,-496,0,20,0,6
2,2365,2435,-70,0,253,1,6
2,2519,2357,162,0,5,0,6
2,2401,2247,154,0,0,0,6
2,2445,2421,24,0,300,1,6
2,2283,2464,-181,0,46,0,6
2,2431,2314,117,0,154,0,6
2,2322,2522,-200,0,413,1,6
2,2365,2519,-154,0,113,0,6
2,2357,2444,-87,0,102,1,6
2,2431,2416,15,0,58,0,6
2,2366,2431,-65,0,118,0,6
2,2431,2350,81,0,107,0,6
2,2431,2445,-14,0,303,0,6
2,2459,2352,107,0,48,1,6
2,2210,2447,-237,0,11,0,6
2,2420,2470,-50,0,140,0,6
2,2427,2446,-19,0,300,0,6
2,2543,2472,71,0,106,1,6
2,2452,2522,-70,0,106,0,6
2,2393,2427,-34,0,1,1,6
2,2494,2398,96,0,485,0,6
2,2417,2418,-1,0,234,0,6
2,2516,2392,124,0,102,0,6
2,2460,2577,-117,0,40,0,6
2,2393,2468,-75,0,1,0,6
2,2251,2433,-182,0,111,0,6
2,2374,2471,-97,0,129,1,6
2,2390,2411,-21,0,147,0,6
2,2456,2594,-138,0,4,1,6
2,2201,2520,-319,0,30,0,6
2,2374,2507,-133,0,211,0,6
2,2351,2513,-162,0,30,1,6
2,2404,2449,-45,0,130,0,6
2,2700,2589,111,0,106,0,6
2,2416,2532,-116,0,200,0,6
2,2279,2439,-160,0,45,0,6
2,2460,2313,147,0,190,1,6
2,2462,2389,73,0,484,1,6
2,2554,2526,28,0,107,0,6
2,2612,2446,166,0,190,0,6
2,2291,2416,-125,4,21,1,13
2,2718,2673,45,0,295,0,6
2,2204,2445,-241,0,0,0,8
2,2370,2558,-188,0,113,0,6
2,2370,2411,-41,0,312,0,6
2,2461,2428,33,0,4,0,6
2,2592,2799,-207,0,440,0,6
2,2487,2533,-46,0,112,0,6
2,2408,2426,-18,0,346,0,6
2,2484,2642,-158,0,4,0,6
2,2436,2339,97,0,373,1,6
2,2515,2549,-34,0,40,0,6
2,2447,2452,-5,0,150,1,6
2,2446,2419,27,0,332,0,6
2,2244,2596,-352,0,123,0,6
2,2518,2514,4,0,45,1,6
2,2294,2547,-253,0,113,1,6
2,2483,2505,-22,0,249,0,6
2,2409,2420,-11,0,131,0,6
2,2249,2465,-216,0,100,0,6
2,2393,2477,-84,0,4,0,6
2,2399,2423,-24,0,27,0,6
2,2379,2422,-43,0,46,1,6
2,2406,2422,-16,0,13,1,6
2,2354,2416,-62,0,278,0,6
2,2329,2450,-121,0,45,0,6
2,2442,2364,78,0,202,1,6
2,2265,2403,-138,0,461,0,6
2,2371,2450,-79,0,267,0,6
2,2328,2482,-154,0,1,1,6
2,2442,2351,91,0,1,1,6
2,2255,2402,-147,0,31,1,6
2,2305,2469,-164,0,110,1,6
2,2539,2587,-48,0,241,1,6
2,2495,2507,-12,0,0,1,6
2,2562,2507,55,0,256,0,6
2,2404,2358,46,0,101,0,6
2,2433,2422,11,0,14,0,6
2,2307,2495,-188,0,128,0,6
2,2415,2421,-6,0,348,0,6
2,2520,2492,28,0,140,1,6
2,2506,2599,-93,0,300,0,6
2,2623,2611,12,0,345,0,6
2,2516,2570,-54,0,225,0,5
2,2591,2555,36,0,267,0,6
2,2386,2411,-25,0,45,0,6
2,2288,2482,-194,0,5,0,6
2,2383,2414,-31,0,146,0,6
2,2537,2508,29,0,242,0,6
2,2256,2403,-147,0,190,0,6
2,2488,2413,75,0,106,0,6
2,2585,2489,96,0,40,0,6
2,2419,2512,-93,0,302,0,6
2,2420,2266,154,0,131,0,6
2,2248,2408,-160,0,101,0,6
2,2499,2349,150,0,40,1,6
2,2357,2466,-109,0,56,0,6
2,2299,2412,-113,0,315,0,6
2,2487,2444,43,0,246,0,6
2,2392,2557,-165,0,5,0,6
2,2410,2562,-152,0,347,1,6
2,2448,2539,-91,0,40,0,6
2,2259,2444,-185,0,300,0,6
2,2485,2532,-47,0,106,1,6
2,2389,2523,-134,0,350,0,6
2,2475,2382,93,0,14,0,6
2,2451,2397,54,0,242,0,6
2,2461,2507,-46,0,15,0,6
2,2576,2510,66,0,40,1,6
2,2572,2581,-9,0,312,0,6
2,2433,2424,9,0,4,1,6
2,2507,2564,-57,0,144,1,6
2,2448,2390,58,0,250,0,6
2,2435,2580,-145,0,242,0,6
2,2374,2439,-65,0,49,1,6
2,2400,2524,-124,0,267,0,6
2,2502,2448,54,0,45,0,6
2,2418,2277,141,0,80,1,6
2,2411,2384,27,0,405,0,6
2,2309,2414,-105,0,365,0,6
2,2588,2447,141,0,15,1,8
2,2555,2604,-49,0,145,0,6
2,2285,2470,-185,0,394,0,6
2,2573,2651,-78,0,115,0,6
2,2612,2533,79,0,247,0,6
2,2597,2655,-58,0,106,0,6
2,2430,2401,29,0,456,1,6
2,2298,2462,-164,0,302,0,6
2,2424,2422,2,0,398,0,6
2,2511,2501,10,0,211,0,6
2,2538,2462,76,0,122,1,6
2,2470,2482,-12,0,40,1,6
2,2294,2693,-399,0,120,0,6
2,2445,2446,-1,0,110,0,6
2,2533,2472,61,0,147,0,6
2,2342,2485,-143,0,106,0,6
2,2419,2336,83,0,14,1,6
2,2460,2457,3,0,60,0,6
2,2322,2443,-121,0,115,0,6
2,2455,2511,-56,0,300,1,6
2,2490,2463,27,0,201,0,6
2,2532,2486,46,0,201,0,6
2,2462,2579,-117,0,215,0,6
2,2532,2601,-69,0,48,1,6
2,2488,2418,70,0,46,1,6
2,2427,2419,8,0,122,0,6
2,2417,2536,-119,0,288,1,6
2,2449,2422,27,0,337,0,6
2,2324,2471,-147,0,473,0,6
2,2367,2519,-152,0,216,0,6
2,2365,2514,-149,0,80,0,8
2,2474,2461,13,0,107,1,6
2,2515,2431,84,0,107,1,6
2,2398,2445,-47,0,113,0,6
2,2458,2386,72,0,130,0,6
2,2303,2475,-172,0,459,1,6
2,2446,2558,-112,0,128,0,6
2,2236,2592,-356,0,317,0,6
2,2579,2666,-87,0,10,0,6
2,2250,2573,-323,0,21,0,6
2,2329,2486,-157,0,217,0,6
2,2409,2329,80,0,241,0,6
2,2452,2372,80,0,16,0,6
2,2450,2438,12,0,133,0,6
2,2440,2264,176,0,43,0,6
2,2617,2593,24,0,464,0,6
2,2514,2489,25,0,300,0,6
2,2565,2413,152,0,4,1,6
2,2493,2566,-73,0,41,0,6
2,2435,2509,-74,0,13,0,6
2,2421,2385,36,0,100,0,6
2,2254,2403,-149,0,315,1,8
2,2595,2803,-208,0,395,0,6
2,2438,2346,92,0,302,0,6
2,2421,2486,-65,0,383,0,6
2,2324,2417,-93,0,1,0,6
2,2455,2251,204,0,266,1,6
2,2391,2405,-14,0,133,1,6
2,2474,2532,-58,0,101,0,6
2,2448,2297,151,0,301,0,6
2,2333,2488,-155,0,120,0,6
2,2413,2317,96,0,57,0,6
2,2404,2304,100,0,302,0,6
2,2408,2204,204,0,210,1,6
2,2294,2423,-129,0,190,0,8
2,2550,2520,30,0,200,1,6
2,2298,2478,-180,0,321,0,6
2,2357,2409,-52,0,476,0,6
2,2468,2438,30,0,332,0,6
2,2374,2459,-85,0,147,0,6
2,2532,2694,-162,0,300,1,6
2,2465,2406,59,0,0,0,6
2,2682,2504,178,0,345,1,6
2,2699,2494,205,0,242,0,6
2,2477,2339,138,0,40,0,6
2,2447,2436,11,0,41,0,6
2,2547,2365,182,0,112,0,6
2,2367,2403,-36,0,106,0,5
2,2451,2433,18,0,44,0,6
2,2409,2375,34,0,45,1,6
2,2644,2544,100,0,233,0,6
2,2306,2428,-122,0,110,0,6
2,2247,2508,-261,0,40,0,6
2,2508,2500,8,0,120,0,6
2,2586,2567,19,0,1,0,6
2,2386,2568,-182,0,244,0,6
2,2219,2407,-188,0,0,0,6
2,2501,2512,-11,0,453,1,6
2,2428,2580,-152,0,302,1,6
2,2451,2564,-113,0,106,1,6
2,2233,2505,-272,0,132,1,6
2,2447,2554,-107,0,1,0,6
2,2551,2457,94,0,302,0,6
2,2402,2293,109,0,0,0,6
2,2440,2325,115,0,111,1,6
2,2425,2342,83,0,458,0,6
2,2415,2605,-190,0,4,1,6
2,2404,2303,101,0,17,0,6
2,2381,2512,-131,0,43,0,6
2,2434,2368,66,0,242,1,6
2,2435,2470,-35,0,140,0,6
2,2483,2729,-246,0,142,0,6
2,2450,2468,-18,0,463,0,6
2,2450,2488,-38,0,130,0,6
2,2421,2299,122,0,246,1,6
2,2238,2401,-163,0,122,0,6
2,2469,2353,116,0,106,1,6
2,2270,2421,-151,0,25,0,6
2,2396,2621,-225,0,401,0,6
2,2552,2509,43,0,140,0,6
2,2451,2311,140,0,311,0,6
2,2349,2462,-113,0,455,0,6
2,2366,2422,-56,0,121,1,6
2,2275,2436,-161,0,47,0,6
2,2539,2489,50,0,4,1,6
2,2407,2519,-112,0,315,0,6
2,2309,2463,-154,0,15,1,6
2,2406,2440,-34,0,16,0,6
2,2418,2437,-19,0,190,0,6
2,2403,2503,-100,0,45,0,6
2,2520,2389,131,0,307,0,6
2,2507,2427,80,0,43,0,6
2,2432,2301,131,0,101,0,6
2,2521,2521,0,0,258,0,6
2,2429,2452,-23,0,123,0,6
2,2534,2539,-5,0,302,0,6
2,2445,2340,105,0,100,1,6
2,2427,2316,111,0,320,0,6
2,2820,2766,54,0,130,0,6
2,2421,2455,-34,0,86,0,6
2,2532,2381,151,0,304,1,6
2,2261,2412,-151,0,311,0,6
2,2402,2354,48,0,46,0,8
2,2459,2416,43,0,44,0,6
2,2544,2627,-83,0,457,0,6
2,2426,2426,0,0,111,0,6
2,2282,2455,-173,0,256,1,6
2,2500,2428,72,0,190,0,6
2,2239,2402,-163,0,119,0,6
2,2405,2423,-18,0,218,0,6
2,2296,2474,-178,4,112,1,13
2,2343,2470,-127,4,310,1,0
2,2380,2465,-85,0,348,0,6
2,2487,2501,-14,0,212,0,6
2,2421,2472,-51,0,101,0,6
2,2559,2553,6,0,134,0,6
2,2393,2450,-57,0,394,0,6
2,2286,2408,-122,0,205,0,6
2,2223,2554,-331,0,45,0,6
2,2427,2338,89,0,15,0,6
2,2425,2452,-27,0,10,0,6
2,2411,2402,9,0,31,0,6
2,2537,2554,-17,0,107,0,6
2,2523,2506,17,0,265,0,6
2,2408,2431,-23,0,4,0,6
2,2338,2417,-79,0,305,0,6
2,2328,2540,-212,0,354,0,6
2,2592,2292,300,0,13,0,6
2,2501,2445,56,0,107,0,6
2,2520,2387,133,0,426,0,6
2,2633,2635,-2,0,123,0,6
2,2465,2510,-45,0,400,0,6
2,2391,2505,-114,0,133,1,6
2,2491,2421,70,0,445,1,6
2,2367,2429,-62,0,110,0,6
2,2294,2409,-115,0,414,1,8
2,2290,2407,-117,0,40,0,6
2,2464,2512,-48,0,30,0,6
2,2582,2464,118,0,466,0,6
2,2304,2538,-234,0,202,1,8
2,2393,2477,-84,0,170,0,6
2,2425,2702,-277,0,255,0,6
2,2394,2488,-94,0,62,0,6
2,2551,2492,59,0,302,0,6
2,2201,2409,-208,0,43,0,6
2,2461,2741,-280,0,202,1,6
2,2297,2422,-125,0,1,0,6
2,2550,2433,117,0,41,0,6
2,2536,2549,-13,0,40,1,6
2,2475,2498,-23,0,104,0,6
2,2476,2492,-16,0,1,0,6
2,2530,2379,151,0,211,1,6
2,2436,2644,-208,0,302,0,6
2,2390,2406,-16,0,414,1,6
2,2433,2423,10,0,47,0,6
2,2432,2437,-5,0,10,0,6
2,2411,2393,18,0,332,1,6
2,2347,2538,-191,0,84,0,6
2,2551,2460,91,0,45,0,6
2,2409,2325,84,0,404,1,6
2,2410,2472,-62,0,415,0,6
2,2319,2455,-136,0,15,0,6
2,2315,2403,-88,0,150,0,6
2,2398,2539,-141,0,315,1,6
2,2429,2292,137,0,300,1,6
2,2838,2662,176,0,331,0,6
2,2690,2539,151,0,102,0,6
2,2294,2493,-199,0,33,0,6
2,2388,2687,-299,0,46,0,6
2,2382,2458,-76,0,106,0,6
2,2416,2401,15,0,123,0,6
2,2410,2516,-106,0,0,0,6
2,2334,2421,-87,0,10,1,6
2,2384,2408,-24,0,202,0,6
2,2636,2653,-17,0,112,0,6
2,2292,2406,-114,0,150,0,8
2,2283,2431,-148,0,312,0,6
2,2430,2362,68,0,404,1,6
2,2583,2497,86,0,100,0,6
2,2417,2215,202,0,45,0,6
2,2545,2514,31,0,42,0,6
2,2476,2400,76,0,40,1,6
2,2414,2402,12,0,7,0,6
2,2295,2406,-111,4,253,0,13
2,2584,2524,60,0,120,0,6
2,2287,2428,-141,0,40,0,6
2,2543,2540,3,0,0,0,6
2,2389,2434,-45,0,80,0,6
2,2400,2414,-14,0,260,0,6
2,2391,2411,-20,0,490,0,6
2,2330,2447,-117,0,4,0,6
2,2270,2402,-132,0,295,1,6
2,2553,2494,59,0,484,1,6
2,2566,2385,181,0,5,1,6
2,2339,2507,-168,0,4,0,8
2,2358,2488,-130,0,245,0,5
2,2252,2450,-198,0,150,0,6
2,2474,2353,121,0,242,1,5
2,2304,2419,-115,0,305,0,6
2,2225,2583,-358,0,142,0,8
2,2448,2365,83,0,45,0,6
2,2541,2567,-26,0,300,0,6
2,2536,2567,-31,0,46,0,6
2,2461,2331,130,0,112,0,6
2,2370,2481,-111,0,240,1,6
2,2411,2418,-7,0,302,0,6
2,2274,2561,-287,0,120,0,6
2,2630,2592,38,0,202,0,6
2,2287,2439,-152,0,114,0,6
2,2223,2605,-382,0,154,0,6
2,2321,2410,-89,0,122,0,6
2,2459,2489,-30,0,151,0,6
2,2437,2380,57,0,440,0,6
2,2442,2452,-10,0,200,1,6
2,2554,2435,119,0,41,0,6
2,2290,2432,-142,0,0,0,6
2,2438,2370,68,0,464,0,6
2,2378,2559,-181,0,3,0,6
2,2359,2451,-92,0,54,0,6
2,2448,2327,121,0,140,0,6
2,2277,2430,-153,0,113,1,8
2,2406,2370,36,0,241,0,6
2,2564,2514,50,0,147,0,6
2,2470,2298,172,0,459,0,6
2,2559,2504,55,0,46,0,6
2,2459,2431,28,0,406,0,6
2,2423,2595,-172,0,317,0,6
2,2443,2548,-105,0,211,0,6
2,2542,2372,170,0,84,1,6
2,2558,2544,14,0,46,0,6
2,2428,2394,34,0,145,0,6
2,2323,2437,-114,0,202,0,6
2,2272,2481,-209,0,245,0,6
2,2424,2435,-11,0,216,0,6
2,2409,2509,-100,0,250,0,6
2,2431,2586,-155,0,15,0,6
2,2432,2387,45,0,453,1,6
2,2409,2385,24,0,200,0,6
2,2434,2444,-10,0,101,0,6
2,2495,2598,-103,0,317,0,6
2,2409,2577,-168,0,264,0,6
2,2455,2582,-127,0,106,1,6
2,2407,2397,10,0,352,0,6
2,2428,2419,9,0,394,1,6
2,2304,2408,-104,0,211,0,6
2,2538,2560,-22,0,101,1,6
2,2345,2403,-58,0,190,0,6
2,2398,2412,-14,0,8,0,6
2,2399,2463,-64,0,337,1,6
2,2619,2411,208,0,304,0,6
2,2444,2539,-95,0,277,0,6
2,2447,2317,130,0,27,1,6
2,2392,2410,-18,0,242,1,6
2,2313,2433,-120,0,2,0,6
2,2452,2432,20,0,257,0,6
2,2544,2509,35,0,113,0,8
2,2413,2539,-126,0,131,0,6
2,2223,2615,-392,0,36,0,6
2,2441,2463,-22,0,143,0,6
2,2545,2584,-39,0,106,1,6
2,2585,2541,44,0,104,0,6
2,2558,2682,-124,0,33,0,6
2,2525,2353,172,0,330,0,6
2,2404,2420,-16,0,80,0,6
2,2492,2480,12,0,31,1,6
2,2358,2418,-60,0,31,0,6
2,2497,2525,-28,0,241,0,6
2,2715,2747,-32,0,57,0,6
2,2279,2468,-189,0,389,0,6
2,2316,2442,-126,0,1,0,6
2,2456,2658,-202,0,130,0,6
2,2457,2300,157,0,125,0,6
2,2486,2447,39,0,216,0,6
2,2295,2412,-117,0,190,1,6
2,2411,2363,48,0,130,1,6
2,2377,2561,-184,0,43,0,6
2,2321,2418,-97,0,300,0,6
2,2306,2419,-113,0,331,0,6
2,2384,2437,-53,0,332,0,6
2,2349,2408,-59,0,1,0,6
2,2521,2536,-15,0,2,1,6
2,2532,2479,53,0,307,0,6
2,2334,2415,-81,0,58,0,6
2,2601,2725,-124,0,302,0,6
2,2540,2554,-14,0,107,1,6
2,2401,2459,-58,0,330,1,6
2,2543,2381,162,0,40,0,6
2,2360,2447,-87,0,253,0,6
2,2405,2434,-29,0,152,0,6
2,2291,2459,-168,4,302,0,13
2,2388,2404,-16,0,336,0,6
2,2518,2546,-28,0,101,0,6
2,2520,2553,-33,0,249,0,6
2,2317,2486,-169,0,7,0,8
2,2556,2424,132,0,242,0,6
2,2203,2492,-289,0,7,0,6
2,2299,2411,-112,0,224,1,6
2,2331,2444,-113,0,120,0,6
2,2433,2534,-101,0,1,0,6
2,2418,2494,-76,0,271,0,6
2,2513,2337,176,0,102,1,6
2,2441,2473,-32,0,426,0,6
2,2346,2437,-91,0,211,0,6
2,2487,2417,70,0,110,0,5
2,2503,2524,-21,0,46,0,6
2,2356,2412,-56,0,100,0,6
2,2397,2524,-127,0,107,1,6
2,2295,2460,-165,0,295,1,6
2,2373,2411,-38,0,107,0,6
2,2439,2432,7,0,380,0,6
2,2347,2418,-71,0,331,0,6
2,2274,2441,-167,4,360,1,13
2,2374,2491,-117,0,112,0,6
2,2389,2625,-236,0,107,0,6
2,2581,2633,-52,0,201,0,6
2,2608,2424,184,0,0,0,6
2,2575,2469,106,0,49,0,6
2,2321,2411,-90,0,307,0,6
2,2470,2440,30,0,123,1,6
2,2482,2535,-53,0,8,0,6
2,2358,2491,-133,0,55,0,6
2,2401,2403,-2,0,405,0,6
2,2399,2437,-38,0,105,0,6
2,2423,2360,63,0,151,0,6
2,2408,2319,89,0,302,0,6
2,2519,2615,-96,0,100,0,6
2,2448,2453,-5,0,2,0,6
2,2402,2456,-54,0,106,0,6
2,2347,2506,-159,0,464,1,8
2,2518,2669,-151,0,278,0,6
2,2559,2730,-171,0,110,0,6
2,2248,2493,-245,0,229,0,8
2,2440,2454,-14,0,304,0,6
2,2507,2578,-71,0,30,0,6
2,2422,2623,-201,0,255,0,6
2,2312,2502,-190,0,140,1,6
2,2501,2377,124,0,0,0,6
2,2577,2394,183,0,113,1,6
2,2394,2554,-160,0,144,1,6
2,2477,2351,126,0,44,0,6
2,2416,2418,-2,0,301,1,6
2,2454,2426,28,0,48,0,6
2,2532,2440,92,0,200,1,6
2,2250,2403,-153,0,103,0,8
2,2288,2416,-128,0,133,0,6
2,2337,2446,-109,0,337,0,6
2,2455,2441,14,0,140,1,6
2,2492,2487,5,0,464,0,6
2,2263,2440,-177,4,250,0,13
2,2480,2476,4,0,143,0,6
2,2273,2445,-172,0,250,0,6
2,2314,2453,-139,4,135,1,13
2,2383,2411,-28,0,123,0,6
2,2540,2511,29,0,103,0,6
2,2421,2429,-8,0,140,0,6
2,2461,2554,-93,0,300,1,6
2,2419,2250,169,0,20,0,6
2,2416,2450,-34,0,242,1,6
2,2541,2590,-49,0,112,1,6
2,2285,2460,-175,0,200,1,6
2,2433,2412,21,0,101,0,6
2,2351,2562,-211,0,52,1,6
2,2407,2319,88,0,140,0,6
2,2431,2391,40,0,178,0,6
2,2388,2421,-33,0,1,1,6
2,2428,2487,-59,0,106,0,6
2,2248,2572,-324,0,1,0,6
2,2406,2409,-3,0,28,1,6
2,2233,2464,-231,0,404,0,6
2,2649,2331,318,0,106,0,5
2,2413,2568,-155,0,43,0,6
2,2454,2419,35,0,112,0,6
2,2429,2615,-186,0,250,0,6
2,2318,2410,-92,0,81,1,6
2,2262,2430,-168,0,302,0,6
2,2385,2456,-71,0,80,0,8
2,2302,2586,-284,0,320,0,6
2,2455,2391,64,0,40,0,6
2,2455,2548,-93,0,140,0,6
2,2425,2397,28,0,106,1,6
2,2297,2412,-115,0,4,0,6
2,2488,2497,-9,0,4,1,6
2,2471,2431,40,0,45,0,6
2,2441,2423,18,0,241,0,6
2,2381,2428,-47,0,1,0,6
2,2556,2404,152,0,200,1,6
2,2405,2375,30,0,264,0,6
2,2550,2578,-28,0,43,0,6
2,2345,2526,-181,0,140,0,6
2,2485,2353,132,0,135,0,6
2,2407,2316,91,0,470,0,6
2,2439,2272,167,0,113,1,6
2,2296,2454,-158,0,247,1,6
2,2638,2647,-9,0,190,0,6
2,2607,2200,407,0,466,0,6
2,2563,2671,-108,0,474,0,6
2,2500,2591,-91,0,45,0,6
2,2292,2457,-165,0,151,0,6
2,2300,2411,-111,0,320,1,6
2,2525,2466,59,0,100,0,6
2,2507,2538,-31,0,270,1,6
2,2464,2620,-156,0,331,0,6
2,2495,2621,-126,0,370,1,6
2,2416,2327,89,0,331,0,6
2,2210,2432,-222,0,220,0,6
2,2538,2375,163,0,40,1,6
2,2410,2559,-149,0,45,1,6
2,2551,2572,-21,0,7,0,6
2,2467,2220,247,0,311,1,6
2,2262,2442,-180,0,132,0,6
2,2396,2429,-33,0,277,0,6
2,2546,2543,3,0,211,0,6
2,2485,2482,3,0,11,0,6
2,2673,2787,-114,0,101,0,6
2,2434,2401,33,0,208,0,6
2,2529,2499,30,0,308,1,8
2,2532,2752,-220,0,13,0,6
2,2406,2334,72,0,18,1,6
2,2524,2464,60,0,200,0,6
2,2326,2411,-85,0,101,0,6
2,2425,2225,200,0,4,0,6
2,2392,2468,-76,0,240,0,6
2,2521,2400,121,0,0,0,6
2,2399,2437,-38,0,135,1,6
2,2585,2474,111,0,335,0,6
2,2343,2406,-63,0,1,0,6
2,2445,2490,-45,0,56,0,6
2,2337,2408,-71,0,265,0,6
2,2269,2439,-170,0,7,1,6
2,2392,2404,-12,0,143,0,6
2,2500,2372,128,0,409,1,6
2,2522,2435,87,0,37,0,6
2,2226,2408,-182,0,80,1,8
2,2496,2528,-32,0,300,1,6
2,2431,2433,-2,0,70,0,6
2,2269,2412,-143,0,302,0,6
2,2503,2415,88,0,300,0,6
2,2414,2525,-111,0,0,0,6
2,2273,2413,-140,0,0,0,6
2,2456,2443,13,0,130,0,6
2,2528,2399,129,0,395,1,6
2,2567,2356,211,0,338,0,6
2,2486,2540,-54,0,230,0,6
2,2302,2409,-107,0,330,1,6
2,2465,2506,-41,0,436,0,6
2,2414,2385,29,0,54,0,6
2,2586,2557,29,0,40,1,6
2,2420,2408,12,0,110,0,6
2,2252,2425,-173,0,341,0,6
2,2314,2420,-106,0,106,0,6
2,2324,2405,-81,0,113,0,6
2,2554,2573,-19,0,15,1,6
2,2361,2748,-387,0,108,0,6
2,2515,2500,15,0,436,0,6
2,2430,2453,-23,0,218,0,6
2,2520,2317,203,0,41,0,6
2,2609,2532,77,0,248,0,6
2,2413,2373,40,0,112,0,6
2,2407,2536,-129,0,341,0,6
2,2259,2446,-187,0,326,0,8
2,2535,2404,131,0,334,0,6
2,2249,2419,-170,0,115,0,6
2,2349,2438,-89,0,30,0,6
2,2409,2305,104,0,255,0,8
2,2463,2279,184,0,122,1,6
2,2590,2548,42,0,154,1,6
2,2561,2550,11,0,107,0,6
2,2620,2524,96,0,265,0,6
2,2286,2425,-139,0,311,0,6
2,2568,2370,198,0,45,0,6
2,2486,2373,113,0,113,0,6
2,2285,2435,-150,0,80,0,6
2,2204,2455,-251,0,140,0,6
2,2513,2591,-78,0,247,0,6
2,2269,2419,-150,0,405,1,6
2,2561,2582,-21,0,101,0,6
2,2461,2347,114,0,106,0,6
2,2299,2480,-181,0,57,0,6
2,2257,2421,-164,0,101,1,6
2,2479,2477,2,0,434,1,6
2,2356,2450,-94,0,288,1,6
2,2275,2410,-135,0,46,0,6
2,2479,2352,127,0,125,1,6
2,2422,2286,136,0,406,0,6
2,2353,2540,-187,0,245,0,6
2,2408,2358,50,0,300,0,6
2,2453,2371,82,0,127,0,6
2,2529,2392,137,0,210,0,6
2,2475,2485,-10,0,445,1,6
2,2488,2364,124,0,30,0,6
2,2413,2497,-84,0,107,0,6
2,2301,2653,-352,0,202,0,6
2,2410,2694,-284,0,404,0,6
2,2529,2556,-27,0,330,0,6
2,2508,2650,-142,0,7,1,6
2,2481,2512,-31,0,420,0,6
2,2227,2410,-183,0,122,0,6
2,2443,2420,23,0,196,0,6
2,2570,2700,-130,0,17,0,6
2,2526,2467,59,0,200,1,6
2,2529,2569,-40,0,404,1,6
2,2361,2419,-58,0,1,0,6
2,2377,2425,-48,0,106,0,6
2,2314,2405,-91,0,127,1,6
2,2535,2605,-70,0,112,0,6
2,2442,2569,-127,0,106,0,6
2,2395,2463,-68,0,14,0,8
2,2579,2398,181,0,123,0,6
2,2668,2537,131,0,104,0,6
2,2433,2536,-103,0,4,1,6
2,2457,2655,-198,0,193,0,6
2,2305,2445,-140,0,81,1,6
2,2424,2470,-46,0,100,1,6
2,2396,2469,-73,0,46,0,8
2,2445,2539,-94,0,202,1,6
2,2471,2455,16,0,300,0,6
2,2584,2559,25,0,100,0,6
2,2539,2495,44,0,226,0,6
2,2340,2551,-211,0,58,0,6
2,2295,2472,-177,0,151,0,6
2,2428,2251,177,0,230,1,6
2,2460,2499,-39,0,106,0,6
2,2439,2394,45,0,311,0,6
2,2323,2465,-142,0,0,0,6
2,2493,2569,-76,0,302,1,6
2,2510,2566,-56,0,336,0,6
2,2414,2552,-138,0,409,0,6
2,2592,2497,95,0,45,1,6
2,2426,2332,94,0,110,1,6
2,2394,2440,-46,0,45,0,6
2,2464,2467,-3,0,20,1,6
2,2361,2451,-90,0,300,1,6
2,2248,2543,-295,0,43,0,6
2,2211,2447,-236,0,110,0,7
2,2268,2449,-181,0,132,1,6
2,2497,2666,-169,0,310,0,6
2,2432,2421,11,0,4,1,6
2,2484,2273,211,0,140,0,6
2,2397,2547,-150,0,2,1,6
2,2510,2680,-170,0,130,1,6
2,2480,2453,27,0,7,1,6
2,2326,2473,-147,0,103,1,6
2,2542,2577,-35,0,7,0,6
2,2383,2560,-177,0,100,0,6
2,2448,2361,87,0,46,0,8
2,2363,2460,-97,0,1,0,6
2,2352,2405,-53,0,30,0,6
2,2239,2598,-359,0,302,0,8
2,2371,2444,-73,0,201,0,6
2,2408,2274,134,4,202,1,13
2,2506,2363,143,0,490,1,6
2,2355,2439,-84,0,6,0,6
2,2425,2439,-14,0,242,0,6
2,2393,2460,-67,0,487,0,6
2,2314,2434,-120,0,337,1,6
2,2536,2397,139,0,101,0,6
2,2460,2597,-137,0,1,0,6
2,2510,2491,19,0,110,0,6
2,2337,2402,-65,0,124,0,6
2,2435,2316,119,0,463,0,6
2,2458,2439,19,0,200,0,6
2,2456,2586,-130,0,130,1,6
2,2636,2605,31,0,463,0,6
2,2418,2375,43,0,263,0,6
2,2613,2422,191,0,398,0,6
2,2442,2299,143,0,40,1,6
2,2388,2401,-13,0,100,0,6
2,2448,2457,-9,0,40,0,6
2,2340,2442,-102,0,309,0,6
2,2476,2504,-28,0,123,0,6
2,2442,2465,-23,0,43,1,6
2,2483,2581,-98,0,120,0,6
2,2395,2453,-58,0,0,0,6
2,2630,2476,154,0,311,0,6
2,2215,2475,-260,0,300,0,6
2,2463,2392,71,0,123,1,6
2,2329,2458,-129,0,102,0,6
2,2423,2484,-61,0,305,0,6
2,2308,2418,-110,4,40,0,13
2,2419,2410,9,0,311,0,6
2,2421,2378,43,0,40,1,6
2,2398,2489,-91,0,101,0,6
2,2458,2467,-9,0,107,1,6
2,2361,2412,-51,0,80,0,6
2,2446,2443,3,0,141,0,6
2,2435,2417,18,0,90,0,6
2,2446,2385,61,0,167,0,6
2,2452,2419,33,0,167,1,6
2,2314,2434,-120,0,343,0,6
2,2431,2293,138,0,40,0,6
2,2341,2443,-102,0,33,1,8
2,2414,2268,146,0,57,1,6
2,2485,2458,27,0,100,1,6
2,2291,2542,-251,0,46,0,6
2,2399,2577,-178,0,107,0,6
2,2462,2216,246,0,4,0,6
2,2613,2610,3,0,133,0,6
2,2350,2412,-62,0,202,0,6
2,2444,2424,20,0,190,0,6
2,2391,2590,-199,0,107,1,6
2,2362,2453,-91,0,380,0,6
2,2330,2539,-209,0,47,0,6
2,2406,2508,-102,0,49,1,6
2,2374,2403,-29,0,122,0,6
2,2403,2212,191,0,196,0,6
2,2412,2470,-58,0,482,0,6
2,2545,2521,24,0,200,0,6
2,2501,2488,13,0,40,0,6
2,2564,2543,21,0,201,1,6
2,2503,2619,-116,0,341,1,6
2,2456,2320,136,0,13,0,6
2,2605,2433,172,0,330,0,8
2,2420,2461,-41,0,31,0,6
2,2291,2473,-182,0,123,0,8
2,2545,2381,164,0,404,0,6
2,2412,2341,71,0,106,0,6
2,2469,2379,90,0,4,0,6
2,2552,2602,-50,0,45,0,6
2,2386,2426,-40,0,305,0,6
2,2553,2738,-185,0,190,1,6
2,2524,2682,-158,0,341,0,6
2,2503,2466,37,0,154,0,6
2,2415,2419,-4,0,3,0,6
2,2400,2539,-139,0,3,0,6
2,2415,2332,83,0,152,1,6
2,2413,2553,-140,0,247,1,6
2,2339,2514,-175,0,101,0,6
2,2456,2480,-24,0,118,0,6
2,2460,2503,-43,0,310,0,6
2,2463,2366,97,0,50,0,6
2,2463,2373,90,0,107,0,6
2,2388,2470,-82,0,302,0,6
2,2487,2499,-12,0,162,1,6
2,2342,2416,-74,0,49,0,6
2,2457,2647,-190,0,4,0,6
2,2447,2406,41,0,192,1,6
2,2430,2423,7,0,301,1,6
2,2411,2302,109,0,15,0,6
2,2336,2457,-121,0,40,0,6
2,2425,2372,53,0,3,0,6
2,2379,2410,-31,0,302,0,6
2,2357,2412,-55,0,109,0,6
2,2285,2411,-126,0,56,0,6
2,2415,2555,-140,0,302,0,6
2,2577,2278,299,0,101,1,6
2,2498,2507,-9,0,197,0,6
2,2400,2348,52,0,45,0,6
2,2366,2421,-55,0,123,0,6
2,2325,2423,-98,0,211,0,6
2,2276,2594,-318,0,404,1,7
2,2251,2412,-161,0,414,0,6
2,2401,2350,51,0,117,0,6
2,2287,2409,-122,0,4,0,6
2,2513,2590,-77,0,337,0,6
2,2404,2319,85,0,101,0,6
2,2212,2415,-203,4,52,0,13
2,2478,2562,-84,0,123,1,6
2,2461,2417,44,0,46,0,6
2,2209,2403,-194,0,110,0,6
2,2481,2418,63,0,216,0,6
2,2476,2447,29,0,45,1,6
2,2508,2533,-25,0,242,0,6
2,2436,2500,-64,0,102,0,6
2,2434,2429,5,0,405,0,6
2,2398,2452,-54,0,315,1,6
2,2217,2408,-191,0,106,1,6
2,2276,2419,-143,0,15,1,6
2,2735,2704,31,0,305,0,6
2,2531,2513,18,0,160,1,6
2,2413,2308,105,0,125,0,6
2,2504,2484,20,0,310,0,6
2,2417,2400,17,0,43,1,6
2,2422,2400,22,0,70,1,6
2,2469,2414,55,0,151,0,6
2,2385,2528,-143,0,140,0,6
2,2258,2433,-175,0,108,0,6
2,2399,2489,-90,0,142,0,6
2,2562,2550,12,0,102,0,6
2,2389,2658,-269,0,110,0,6
2,2433,2561,-128,0,485,0,6
2,2538,2595,-57,0,335,0,6
2,2243,2410,-167,0,20,0,8
2,2413,2432,-19,0,251,0,6
2,2379,2609,-230,0,224,0,6
2,2408,2414,-6,0,304,1,6
2,2312,2447,-135,0,484,0,6
2,2362,2411,-49,0,40,0,6
2,2407,2577,-170,0,2,0,6
2,2275,2401,-126,0,330,1,6
2,2456,2478,-22,0,249,0,6
2,2438,2369,69,0,127,0,6
2,2332,2456,-124,0,45,0,5
2,2410,2402,8,0,15,1,6
2,2492,2616,-124,0,39,0,6
2,2498,2421,77,0,315,0,6
2,2536,2621,-85,0,463,1,6
2,2343,2437,-94,0,49,0,6
2,2450,2466,-16,0,134,0,6
2,2392,2680,-288,0,193,1,6
2,2518,2386,132,0,300,0,6
2,2391,2537,-146,0,4,1,6
2,2489,2557,-68,0,484,1,6
2,2350,2408,-58,0,2,0,6
2,2426,2439,-13,0,112,0,6
2,2419,2470,-51,0,134,1,6
2,2469,2482,-13,0,128,1,6
2,2486,2376,110,0,464,0,6
2,2397,2556,-159,0,46,0,8
2,2603,2612,-9,0,101,0,6
2,2352,2436,-84,0,152,0,6
2,2417,2469,-52,0,335,1,6
2,2562,2566,-4,0,401,1,6
2,2536,2567,-31,0,200,0,6
2,2423,2406,17,0,133,0,6
2,2393,2753,-360,0,103,0,6
2,2411,2310,101,0,15,1,6
2,2446,2372,74,0,148,1,6
2,2251,2553,-302,0,10,0,6
2,2439,2545,-106,0,4,1,6
2,2377,2405,-28,0,222,0,6
2,2483,2527,-44,0,85,0,6
2,2469,2490,-21,0,310,0,6
2,2324,2424,-100,0,120,1,6
2,2378,2452,-74,0,88,0,6
2,2303,2464,-161,0,130,0,6
2,2448,2707,-259,0,45,0,6
2,2319,2435,-116,0,464,1,6
2,2551,2540,11,0,250,0,6
2,2391,2494,-103,0,189,0,6
2,2426,2374,52,0,106,0,6
2,2400,2520,-120,0,2,0,6
2,2247,2496,-249,0,201,0,6
2,2542,2487,55,0,80,0,6
2,2437,2404,33,0,45,1,6
2,2403,2439,-36,0,113,0,6
2,2276,2406,-130,0,215,0,8
2,2616,2615,1,0,200,0,6
2,2391,2415,-24,0,307,1,6
2,2527,2445,82,0,246,1,6
2,2358,2422,-64,0,435,0,6
2,2507,2509,-2,0,45,1,6
2,2356,2446,-90,0,153,1,6
2,2420,2510,-90,0,18,0,6
2,2450,2394,56,0,300,0,6
2,2449,2430,19,0,205,1,6
2,2343,2410,-67,0,300,1,6
2,2395,2424,-29,0,40,0,6
2,2335,2416,-81,0,469,1,6
2,2481,2466,15,0,211,0,6
2,2322,2491,-169,0,5,0,6
2,2289,2474,-185,0,130,0,6
2,2353,2482,-129,0,120,0,6
2,2516,2506,10,0,101,0,6
2,2531,2495,36,0,114,0,6
2,2396,2459,-63,0,106,0,6
2,2253,2567,-314,0,453,0,6
2,2353,2411,-58,0,245,0,6
2,2527,2448,79,0,253,1,6
2,2469,2457,12,0,205,0,6
2,2312,2442,-130,0,184,0,6
2,2490,2449,41,0,124,0,6
2,2341,2406,-65,0,143,0,8
2,2580,2407,173,0,4,0,6
2,2283,2485,-202,0,101,1,6
2,2415,2503,-88,0,310,0,6
2,2412,2351,61,0,123,0,8
2,2503,2431,72,0,112,0,6
2,2428,2350,78,0,122,0,6
2,2365,2413,-48,0,46,1,6
2,2405,2499,-94,0,3,0,6
2,2398,2427,-29,0,106,1,6
2,2509,2467,42,0,463,1,6
2,2492,2359,133,0,40,0,6
2,2488,2500,-12,0,470,1,6
2,2405,2446,-41,0,270,1,8
2,2410,2416,-6,0,202,1,6
2,2365,2440,-75,0,150,0,5
2,2272,2457,-185,0,301,0,6
2,2448,2453,-5,0,219,0,6
2,2374,2521,-147,0,315,1,6
2,2538,2489,49,0,8,0,6
2,2348,2403,-55,0,40,0,6
2,2329,2488,-159,0,4,1,6
2,2485,2366,119,0,130,1,6
2,2425,2370,55,0,466,0,6
2,2261,2563,-302,0,277,1,6
2,2450,2480,-30,0,56,1,6
2,2407,2541,-134,0,40,0,6
2,2486,2350,136,0,4,0,6
2,2486,2532,-46,0,129,0,6
2,2454,2392,62,0,256,0,6
2,2397,2535,-138,0,332,1,6
2,2502,2415,87,0,120,0,6
2,2557,2657,-100,0,154,0,6
2,2350,2493,-143,0,107,0,6
2,2375,2477,-102,0,102,0,6
2,2244,2411,-167,0,261,0,6
2,2428,2427,1,0,242,0,6
2,2571,2677,-106,0,249,0,6
2,2403,2369,34,0,344,1,6
2,2387,2582,-195,0,123,0,6
2,2248,2450,-202,0,198,1,6
2,2237,2406,-169,0,354,0,6
2,2433,2420,13,0,330,0,6
2,2405,2312,93,0,150,0,6
2,2322,2435,-113,0,180,0,6
2,2501,2478,23,0,244,0,6
2,2336,2410,-74,0,106,0,6
2,2508,2449,59,0,310,0,6
2,2434,2355,79,0,201,0,6
2,2350,2401,-51,0,302,0,6
2,2508,2413,95,0,102,0,6
2,2339,2473,-134,0,429,0,6
2,2503,2352,151,0,120,0,6
2,2625,2665,-40,0,191,1,6
2,2440,2414,26,0,487,0,6
2,2258,2429,-171,0,123,0,6
2,2458,2456,2,0,106,1,6
2,2563,2593,-30,0,13,0,6
2,2410,2348,62,0,205,1,6
2,2471,2334,137,0,120,0,6
2,2433,2396,37,0,210,1,6
2,2436,2320,116,0,315,1,6
2,2485,2235,250,0,120,0,6
2,2213,2402,-189,0,45,0,6
2,2581,2406,175,0,119,0,6
2,2480,2481,-1,0,109,0,6
2,2411,2514,-103,0,115,0,6
2,2532,2413,119,0,178,1,6
2,2454,2294,160,0,133,0,6
2,2364,2410,-46,0,331,1,6
2,2323,2410,-87,0,40,0,6
2,2520,2454,66,0,40,1,6
2,2449,2626,-177,0,16,0,6
2,2485,2496,-11,0,122,0,6
2,2388,2514,-126,0,280,0,6
2,2606,2677,-71,0,333,0,6
2,2391,2404,-13,0,201,0,6
2,2312,2417,-105,0,140,0,6
2,2310,2426,-116,0,121,0,6
2,2236,2403,-167,0,300,1,6
2,2289,2477,-188,0,52,0,5
2,2450,2447,3,0,100,0,6
2,2391,2434,-43,0,110,0,6
2,2462,2562,-100,0,16,0,6
2,2411,2736,-325,0,112,0,6
2,2530,2685,-155,0,406,1,6
2,2499,2453,46,0,200,1,6
2,2343,2500,-157,0,43,1,6
2,2405,2439,-34,0,277,0,6
2,2452,2477,-25,0,106,0,6
2,2358,2446,-88,0,172,1,6
2,2384,2451,-67,0,112,0,6
2,2272,2434,-162,0,45,0,6
2,2374,2479,-105,0,226,0,6
2,2465,2417,48,0,405,0,6
2,2406,2513,-107,0,41,0,6
2,2261,2489,-228,0,123,0,6
2,2278,2406,-128,0,100,1,6
2,2384,2526,-142,0,45,1,6
2,2408,2447,-39,0,14,0,6
2,2390,2403,-13,0,50,0,6
2,2480,2493,-13,0,301,1,6
2,2226,2429,-203,0,117,0,6
2,2287,2438,-151,0,200,0,6
2,2403,2391,12,0,122,0,6
2,2317,2546,-229,0,201,1,6
2,2232,2400,-168,4,106,0,13
2,2323,2464,-141,0,365,0,6
2,2394,2405,-11,0,211,1,6
2,2404,2312,92,0,302,1,6
2,2201,2637,-436,0,104,0,6
2,2442,2355,87,0,40,0,6
2,2403,2461,-58,0,45,0,6
2,2361,2425,-64,0,0,0,6
2,2259,2437,-178,0,453,0,6
2,2476,2399,77,0,40,0,6
2,2463,2301,162,0,253,1,6
2,2412,2468,-56,0,140,0,6
2,2415,2338,77,0,140,0,6
2,2461,2436,25,0,6,0,6
2,2467,2386,81,0,153,0,6
2,2414,2323,91,0,7,1,6
2,2438,2264,174,0,5,0,6
2,2319,2458,-139,0,343,0,6
2,2381,2407,-26,0,123,0,6
2,2371,2401,-30,0,176,0,6
2,2200,2409,-209,0,122,0,6
2,2570,2687,-117,0,80,0,6
2,2331,2489,-158,0,100,0,6
2,2412,2265,147,0,343,0,6
2,2423,2333,90,0,0,0,6
2,2427,2432,-5,0,106,0,6
2,2452,2476,-24,0,10,1,6
2,2477,2309,168,0,353,0,6
2,2488,2249,239,4,101,0,13
2,2271,2424,-153,0,454,0,6
2,2547,2561,-14,0,80,0,6
2,2340,2469,-129,0,245,0,6
2,2296,2417,-121,4,211,0,13
2,2482,2628,-146,0,317,0,6
2,2596,2547,49,0,122,0,6
2,2540,2658,-118,0,39,0,6
2,2408,2426,-18,0,0,0,6
2,2422,2433,-11,0,233,0,6
2,2545,2571,-26,0,152,1,6
2,2435,2443,-8,0,415,0,6
2,2370,2477,-107,0,151,0,6
2,2517,2583,-66,0,133,0,6
2,2490,2485,5,0,190,1,6
2,2459,2584,-125,0,201,0,6
2,2416,2470,-54,0,100,0,6
2,2390,2500,-110,0,255,0,6
2,2353,2402,-49,0,41,1,6
2,2580,2586,-6,0,102,0,6
2,2308,2407,-99,0,122,0,6
2,2400,2371,29,0,331,0,6
2,2202,2445,-243,0,101,0,6
2,2325,2487,-162,0,111,0,6
2,2489,2511,-22,0,200,0,6
2,2378,2454,-76,0,380,0,6
2,2602,2554,48,0,110,0,6
2,2485,2538,-53,0,112,0,6
2,2432,2414,18,0,107,0,6
2,2282,2496,-214,0,203,1,6
2,2424,2381,43,0,16,1,6
2,2440,2317,123,0,341,0,6
2,2597,2556,41,0,380,0,6
2,2497,2493,4,0,46,0,6
2,2448,2468,-20,0,381,1,6
2,2335,2477,-142,0,16,0,6
2,2386,2454,-68,0,485,0,6
2,2504,2493,11,0,120,0,6
2,2438,2511,-73,0,301,0,6
2,2407,2386,21,0,334,0,6
2,2482,2462,20,0,200,0,6
2,2391,2487,-96,0,30,0,6
2,2425,2337,88,0,110,0,6
2,2408,2538,-130,0,106,0,6
2,2386,2509,-123,0,448,0,6
2,2470,2389,81,0,4,1,6
2,2377,2402,-25,0,323,1,6
2,2428,2409,19,0,84,0,6
2,2584,2395,189,0,106,1,6
2,2427,2327,100,0,40,0,6
2,2312,2430,-118,0,241,0,6
2,2379,2563,-184,0,326,0,6
2,2520,2489,31,0,405,0,6
2,2697,2717,-20,0,115,0,6
2,2305,2426,-121,0,454,0,6
2,2495,2550,-55,0,123,1,6
2,2358,2464,-106,0,102,0,6
2,2292,2412,-120,0,484,1,6
2,2400,2388,12,0,144,0,6
2,2398,2526,-128,0,4,0,6
2,2274,2440,-166,0,310,0,6
2,2402,2438,-36,0,4,0,6
2,2445,2340,105,0,302,0,6
2,2351,2422,-71,0,101,0,6
2,2294,2455,-161,0,120,0,6
2,2250,2408,-158,0,150,0,6
2,2324,2569,-245,0,115,0,6
2,2404,2422,-18,0,112,1,6
2,2339,2566,-227,0,277,1,6
2,2661,2482,179,0,4,1,6
2,2455,2467,-12,0,56,1,6
2,2408,2275,133,0,250,0,6
2,2706,2636,70,0,162,0,6
2,2249,2455,-206,0,484,0,6
2,2407,2407,0,0,40,0,6
2,2262,2612,-350,0,225,1,6
2,2348,2463,-115,0,419,0,5
2,2647,2641,6,0,46,0,6
2,2473,2465,8,0,3,0,6
2,2376,2430,-54,0,385,0,6
2,2355,2451,-96,0,30,0,6
2,2493,2466,27,0,46,0,6
2,2355,2454,-99,0,219,0,6
2,2578,2391,187,0,101,0,6
2,2675,2602,73,0,405,0,6
2,2527,2438,89,0,190,0,6
2,2365,2527,-162,0,454,0,6
2,2263,2423,-160,0,40,0,6
2,2513,2534,-21,0,45,0,6
2,2353,2498,-145,0,200,1,6
2,2407,2352,55,0,46,1,6
2,2381,2463,-82,0,141,1,6
2,2360,2432,-72,0,43,1,6
2,2436,2448,-12,0,1,0,6
2,2453,2283,170,0,202,0,6
2,2483,2420,63,0,413,1,6
2,2513,2461,52,0,344,0,6
2,2440,2357,83,0,43,0,6
2,2351,2442,-91,0,205,0,6
2,2517,2453,64,0,103,1,6
2,2451,2504,-53,0,147,0,6
2,2338,2437,-99,0,43,1,6
2,2681,2605,76,0,106,0,6
2,2269,2525,-256,0,131,1,6
2,2336,2448,-112,0,40,0,6
2,2513,2257,256,4,338,0,13
2,2264,2412,-148,0,292,0,6
2,2409,2404,5,0,118,0,6
2,2478,2366,112,0,373,0,6
2,2376,2407,-31,0,301,0,5
2,2401,2340,61,0,271,1,6
2,2296,2486,-190,0,131,0,6
2,2372,2425,-53,0,302,0,6
2,2326,2435,-109,0,218,0,6
2,2363,2447,-84,0,5,0,6
2,2506,2350,156,0,306,0,6
2,2291,2439,-148,0,40,0,6
2,2404,2430,-26,0,337,0,6
2,2403,2278,125,0,0,0,6
2,2519,2393,126,0,345,0,6
2,2483,2488,-5,0,302,0,6
2,2236,2415,-179,0,108,0,6
2,2446,2488,-42,0,123,1,6
2,2375,2410,-35,0,101,0,6
2,2446,2532,-86,0,300,0,6
2,2317,2417,-100,0,369,0,6
2,2651,2653,-2,0,130,0,6
2,2692,2779,-87,0,101,0,6
2,2244,2417,-173,0,141,1,6
2,2343,2454,-111,0,241,0,6
2,2483,2539,-56,0,101,0,6
2,2262,2566,-304,0,141,0,6
2,2360,2446,-86,0,130,1,6
2,2358,2513,-155,0,4,0,6
2,2491,2346,145,0,302,1,6
2,2420,2578,-158,0,0,1,6
2,2385,2509,-124,0,101,0,6
2,2468,2430,38,0,244,0,6
2,2433,2457,-24,0,16,0,6
2,2224,2435,-211,4,171,0,13
2,2233,2435,-202,0,427,0,6
2,2374,2420,-46,0,202,0,8
2,2447,2435,12,0,13,0,5
2,2589,2554,35,0,245,0,6
2,2487,2358,129,0,300,0,6
2,2446,2434,12,0,205,0,6
2,2438,2652,-214,0,121,0,6
2,2416,2350,66,0,45,0,6
2,2545,2524,21,0,46,0,6
2,2459,2497,-38,0,100,0,6
2,2854,2559,295,0,4,0,6
2,2566,2601,-35,0,0,0,6
2,2420,2583,-163,0,60,0,6
2,2500,2543,-43,0,312,0,6
2,2444,2398,46,0,40,0,6
2,2447,2489,-42,0,145,0,6
2,2254,2430,-176,0,135,0,6
2,2454,2523,-69,0,41,0,6
2,2498,2470,28,0,302,1,6
2,2381,2402,-21,0,115,0,6
2,2404,2326,78,4,107,0,13
2,2407,2330,77,0,402,1,6
2,2465,2407,58,0,9,0,6
2,2370,2414,-44,0,15,0,6
2,2277,2432,-155,0,248,1,6
2,2481,2665,-184,0,292,1,6
2,2481,2613,-132,0,10,0,6
2,2442,2279,163,0,45,1,6
2,2525,2545,-20,0,54,0,6
2,2378,2495,-117,0,48,0,6
2,2402,2426,-24,0,424,1,6
2,2515,2690,-175,0,0,1,6
2,2577,2428,149,0,338,1,6
2,2327,2432,-105,0,1,0,6
2,2414,2310,104,0,313,0,6
2,2447,2446,1,0,345,1,6
2,2409,2222,187,0,153,0,6
2,2450,2274,176,0,380,0,6
2,2363,2463,-100,0,404,0,6
2,2390,2568,-178,0,106,1,6
2,2393,2415,-22,0,16,1,6
2,2458,2426,32,0,130,1,6
2,2372,2438,-66,0,211,0,6
2,2667,2375,292,0,455,0,5
2,2411,2378,33,0,312,0,6
2,2339,2406,-67,0,424,0,6
2,2351,2405,-54,4,45,0,13
2,2422,2288,134,0,140,1,6
2,2385,2559,-174,0,45,1,6
2,2267,2445,-178,0,255,0,6
2,2418,2349,69,0,106,0,6
2,2489,2445,44,0,411,0,6
2,2521,2668,-147,0,112,1,6
2,2387,2456,-69,0,255,0,6
2,2394,2668,-274,0,170,1,6
2,2417,2474,-57,0,49,0,6
2,2427,2423,4,0,0,0,6
2,2353,2462,-109,0,106,1,6
2,2239,2415,-176,0,245,0,6
2,2478,2551,-73,0,320,0,6
2,2274,2455,-181,0,210,0,6
2,2709,2729,-20,0,335,0,6
2,2387,2465,-78,0,487,0,6
2,2337,2433,-96,0,301,0,6
2,2452,2487,-35,0,242,0,6
2,2366,2516,-150,0,1,0,6
2,2340,2522,-182,0,409,1,6
2,2480,2675,-195,0,80,0,6
2,2499,2476,23,0,48,0,6
2,2382,2469,-87,0,45,0,6
2,2309,2477,-168,4,428,0,13
2,2488,2366,122,0,131,1,6
2,2401,2527,-126,0,145,0,6
2,2437,2423,14,0,112,0,6
2,2324,2442,-118,0,490,0,6
2,2461,2602,-141,0,405,0,6
2,2334,2423,-89,0,150,0,6
2,2725,2728,-3,0,144,1,6
2,2456,2484,-28,0,405,0,6
2,2505,2442,63,0,41,1,6
2,2532,2546,-14,0,45,0,6
2,2341,2438,-97,0,101,0,6
2,2405,2393,12,4,176,0,13
2,2543,2598,-55,0,461,0,6
2,2451,2412,39,0,205,0,6
2,2431,2408,23,0,130,1,6
2,2266,2679,-413,0,7,0,6
2,2497,2417,80,0,242,1,6
2,2474,2533,-59,0,48,0,6
2,2399,2401,-2,0,181,1,6
2,2380,2420,-40,0,40,1,6
2,2440,2462,-22,0,101,0,6
2,2443,2621,-178,0,4,0,6
2,2425,2238,187,0,122,0,6
2,2442,2398,44,0,320,1,6
2,2539,2422,117,0,123,0,8
2,2504,2526,-22,0,245,0,6
2,2388,2404,-16,0,46,0,6
2,2202,2450,-248,0,218,1,6
2,2430,2481,-51,0,331,0,6
2,2487,2419,68,0,0,0,6
2,2583,2576,7,0,5,0,6
2,2441,2404,37,0,190,0,6
2,2462,2508,-46,0,36,0,6
2,2647,2648,-1,0,50,0,6
2,2403,2549,-146,0,42,0,6
2,2453,2443,10,0,463,0,6
2,2565,2483,82,0,404,0,6
2,2306,2445,-139,0,112,1,6
2,2407,2370,37,4,201,0,13
2,2339,2492,-153,0,277,0,6
2,2534,2505,29,0,335,0,6
2,2269,2491,-222,0,123,0,6
2,2457,2437,20,0,153,0,6
2,2408,2406,2,0,200,0,6
2,2428,2432,-4,0,300,1,6
2,2449,2481,-32,0,15,0,6
2,2405,2345,60,0,337,1,6
2,2456,2302,154,0,56,1,6
2,2614,2290,324,0,338,0,6
2,2575,2546,29,0,201,0,6
2,2275,2515,-240,0,347,0,6
2,2403,2548,-145,0,354,0,6
2,2417,2405,12,0,0,0,6
2,2415,2320,95,4,143,0,13
2,2350,2402,-52,0,15,0,6
2,2302,2412,-110,0,141,0,6
2,2481,2283,198,4,456,0,13
2,2368,2426,-58,0,270,0,6
2,2292,2434,-142,0,454,0,6
2,2322,2480,-158,0,48,0,6
2,2367,2449,-82,0,474,1,6
2,2235,2403,-168,0,0,0,6
2,2388,2440,-52,0,211,1,6
2,2582,2381,201,0,11,0,6
2,2353,2440,-87,0,1,0,6
2,2415,2318,97,0,106,0,6
2,2430,2553,-123,0,16,0,6
2,2344,2456,-112,0,200,0,7
2,2666,2588,78,0,133,1,6
2,2402,2479,-77,0,268,1,6
2,2473,2230,243,0,118,0,6
2,2353,2412,-59,0,105,0,6
2,2453,2449,4,0,216,1,6
2,2351,2474,-123,0,190,0,6
2,2438,2371,67,0,335,0,6
2,2469,2351,118,0,44,0,6
2,2497,2403,94,0,222,0,6
2,2479,2448,31,0,200,0,6
2,2401,2285,116,0,310,1,6
2,2404,2443,-39,0,211,1,6
2,2547,2646,-99,0,344,0,6
2,2275,2414,-139,0,143,1,6
2,2231,2407,-176,0,50,0,6
2,2452,2499,-47,0,43,0,6
2,2477,2458,19,0,254,0,6
2,2559,2542,17,0,244,0,6
2,2339,2525,-186,4,200,0,13
2,2369,2577,-208,0,484,0,6
2,2325,2406,-81,0,6,1,6
2,2430,2387,43,0,354,0,6
2,2381,2524,-143,0,132,0,6
2,2593,2439,154,0,57,1,6
2,2475,2350,125,0,183,0,6
2,2355,2541,-186,0,250,1,8
2,2340,2590,-250,0,4,0,6
2,2400,2677,-277,0,106,0,6
2,2433,2466,-33,0,112,0,6
2,2334,2406,-72,0,249,1,6
2,2323,2407,-84,0,332,0,6
2,2424,2505,-81,0,1,0,6
2,2408,2385,23,0,40,0,6
2,2443,2312,131,0,250,0,6
2,2394,2417,-23,0,135,1,6
2,2380,2428,-48,0,331,1,6
2,2304,2404,-100,0,113,0,6
2,2534,2546,-12,0,4,1,6
2,2483,2353,130,0,255,0,6
2,2678,2783,-105,0,242,1,6
2,2379,2482,-103,0,244,0,6
2,2477,2423,54,0,46,1,6
2,2452,2482,-30,0,411,0,6
2,2354,2411,-57,0,245,0,6
2,2413,2249,164,0,101,0,8
2,2351,2538,-187,0,46,1,6
2,2316,2407,-91,0,4,0,6
2,2415,2483,-68,0,90,0,6
2,2357,2444,-87,0,485,0,6
2,2512,2663,-151,0,122,0,6
2,2496,2435,61,0,107,0,6
2,2463,2460,3,0,48,1,6
2,2627,2662,-35,0,347,0,6
2,2280,2667,-387,0,464,0,6
2,2479,2420,59,0,112,0,6
2,2454,2465,-11,0,46,0,6
2,2417,2382,35,0,112,0,6
2,2208,2412,-204,0,5,0,6
2,2484,2348,136,0,40,0,6
2,2448,2313,135,0,308,0,6
2,2586,2511,75,0,0,1,6
2,2443,2418,25,0,100,1,6
2,2389,2592,-203,0,45,0,6
2,2291,2459,-168,0,112,0,8
2,2328,2448,-120,0,249,1,6
2,2400,2349,51,0,84,0,6
2,2301,2413,-112,0,253,0,6
2,2241,2446,-205,4,218,0,13
2,2333,2508,-175,0,249,0,6
2,2407,2390,17,0,200,0,6
2,2338,2400,-62,0,135,1,6
2,2353,2473,-120,0,45,0,6
2,2438,2448,-10,0,112,0,6
2,2490,2434,56,0,268,0,6
2,2408,2406,2,0,40,0,6
2,2436,2369,67,0,40,0,6
2,2436,2510,-74,0,128,1,6
2,2456,2578,-122,0,242,1,6
2,2418,2605,-187,0,140,0,6
2,2350,2589,-239,0,200,1,6
2,2434,2346,88,0,200,0,8
2,2298,2462,-164,0,121,0,6
2,2483,2514,-31,0,388,0,6
2,2537,2444,93,0,4,0,6
2,2384,2411,-27,0,469,0,6
2,2453,2614,-161,2,140,0,24
2,2291,2452,-161,0,107,0,5
2,2249,2444,-195,0,36,0,6
2,2513,2510,3,0,317,1,6
2,2448,2420,28,0,321,0,6
2,2287,2571,-284,0,255,0,6
2,2470,2577,-107,0,414,0,6
2,2579,2435,144,0,190,0,6
2,2263,2427,-164,0,7,1,6
2,2320,2412,-92,0,2,0,6
2,2376,2454,-78,0,487,0,6
2,2452,2436,16,0,4,0,6
2,2306,2468,-162,0,48,0,6
2,2362,2428,-66,0,310,0,6
2,2267,2415,-148,0,456,0,6
2,2292,2464,-172,0,292,1,6
2,2518,2540,-22,0,343,0,6
2,2427,2580,-153,0,302,0,6
2,2493,2552,-59,0,45,1,6
2,2431,2324,107,0,6,0,6
2,2418,2432,-14,0,107,0,6
2,2475,2494,-19,0,123,0,6
2,2432,2578,-146,0,101,1,6
2,2445,2426,19,0,45,0,6
2,2423,2527,-104,0,4,0,6
2,2388,2406,-18,0,40,0,8
2,2424,2419,5,0,140,1,6
2,2472,2524,-52,0,101,0,6
2,2349,2476,-127,0,46,0,6
2,2321,2417,-96,0,5,0,8
2,2580,2521,59,0,262,0,6
2,2610,2490,120,0,242,1,6
2,2704,2732,-28,0,426,0,6
2,2480,2550,-70,0,132,0,6
2,2488,2590,-102,0,388,1,6
2,2393,2459,-66,0,131,1,6
2,2577,2513,64,0,248,1,6
2,2385,2403,-18,0,41,0,6
2,2374,2441,-67,0,106,1,6
2,2424,2321,103,0,109,1,6
2,2478,2495,-17,0,16,0,6
2,2533,2497,36,0,192,0,6
2,2440,2629,-189,0,195,0,6
2,2430,2393,37,0,106,1,6
2,2512,2401,111,0,306,0,6
2,2381,2524,-143,0,260,0,6
2,2434,2340,94,4,136,0,13
2,2265,2437,-172,0,202,0,6
2,2470,2469,1,0,325,0,6
2,2471,2323,148,0,106,0,6
2,2480,2474,6,0,112,1,6
2,2402,2361,41,0,150,0,6
2,2324,2428,-104,0,365,0,6
2,2417,2321,96,4,123,0,13
2,2341,2547,-206,0,9,0,6
2,2471,2387,84,0,200,0,6
2,2502,2587,-85,0,354,0,6
2,2202,2570,-368,0,300,0,6
2,2404,2354,50,0,202,1,6
2,2296,2409,-113,0,4,0,6
2,2575,2416,159,0,45,0,6
2,2436,2424,12,0,107,0,6
2,2393,2422,-29,0,409,0,6
2,2538,2500,38,0,40,0,6
2,2328,2576,-248,0,104,0,6
2,2325,2442,-117,0,0,0,6
2,2212,2456,-244,0,120,0,6
2,2608,2559,49,0,398,0,6
2,2368,2411,-43,0,45,0,6
2,2242,2460,-218,0,267,0,6
2,2457,2294,163,4,120,0,13
2,2583,2550,33,0,277,0,6
2,2464,2433,31,0,48,0,6
2,2486,2390,96,0,110,0,6
2,2378,2527,-149,0,45,0,6
2,2401,2509,-108,0,41,0,6
2,2472,2392,80,0,241,0,6
2,2494,2557,-63,0,453,0,6
2,2325,2572,-247,0,58,0,6
2,2407,2390,17,0,52,0,6
2,2376,2419,-43,0,107,1,6
2,2401,2480,-79,0,196,1,6
2,2364,2542,-178,0,157,0,6
2,2472,2393,79,0,380,1,6
2,2405,2490,-85,0,16,0,6
2,2341,2437,-96,0,1,0,6
2,2447,2257,190,0,301,0,8
2,2325,2498,-173,0,300,0,6
2,2438,2267,171,0,45,0,8
2,2311,2417,-106,0,49,1,6
2,2423,2338,85,0,112,0,6
2,2406,2386,20,4,67,0,13
2,2435,2344,91,0,152,0,6
2,2269,2415,-146,0,302,0,6
2,2357,2499,-142,0,40,0,6
2,2446,2559,-113,0,4,0,6
2,2336,2505,-169,0,201,1,6
2,2537,2519,18,0,241,0,6
2,2274,2417,-143,0,35,0,6
2,2393,2569,-176,0,43,0,6
2,2411,2595,-184,0,45,0,6
2,2395,2499,-104,0,80,0,6
2,2443,2278,165,0,1,0,8
2,2449,2359,90,0,457,1,6
2,2330,2571,-241,0,43,0,8
2,2479,2345,134,0,20,0,6
2,2450,2435,15,0,176,0,6
2,2395,2518,-123,0,101,0,6
2,2599,2607,-8,0,245,1,6
2,2495,2348,147,0,122,1,6
2,2488,2535,-47,0,102,0,6
2,2248,2607,-359,0,248,0,6
2,2504,2458,46,0,426,0,6
2,2463,2516,-53,0,8,0,6
2,2438,2446,-8,0,190,0,6
2,2239,2431,-192,0,107,0,6
2,2659,2669,-10,0,113,1,6
2,2581,2478,103,0,253,1,6
2,2464,2417,47,0,112,1,6
2,2596,2803,-207,0,267,0,6
2,2489,2499,-10,0,3,1,6
2,2638,2641,-3,0,338,0,6
2,2332,2413,-81,0,211,0,6
2,2434,2396,38,0,277,0,6
2,2269,2439,-170,4,122,0,13
2,2404,2440,-36,0,114,0,6
2,2417,2358,59,0,308,0,6
2,2369,2454,-85,0,1,0,6
2,2442,2550,-108,0,301,0,6
2,2361,2472,-111,0,267,0,6
2,2426,2365,61,0,245,0,6
2,2391,2400,-9,0,43,0,6
2,2241,2549,-308,0,107,0,6
2,2480,2297,183,0,1,0,6
2,2273,2406,-133,0,115,0,10
2,2420,2537,-117,0,3,0,6
2,2422,2226,196,0,247,0,6
2,2422,2360,62,0,45,0,6
2,2559,2375,184,0,311,0,6
2,2459,2521,-62,0,224,0,6
2,2477,2336,141,0,147,0,6
2,2422,2373,49,0,106,0,6
2,2451,2431,20,0,142,0,6
2,2456,2377,79,0,302,1,6
2,2340,2435,-95,0,101,0,6
2,2489,2511,-22,0,242,0,6
2,2394,2409,-15,0,11,1,8
2,2314,2467,-153,0,123,0,6
2,2405,2445,-40,0,100,0,6
2,2488,2667,-179,0,72,0,6
2,2423,2378,45,0,491,0,6
2,2557,2629,-72,0,107,0,6
2,2439,2478,-39,0,18,0,6
2,2315,2404,-89,0,46,1,6
2,2499,2219,280,0,102,0,6
2,2369,2541,-172,0,0,0,6
2,2295,2433,-138,0,13,0,6
2,2500,2514,-14,0,50,0,6
2,2364,2517,-153,0,487,0,6
2,2383,2520,-137,0,4,1,6
2,2345,2408,-63,0,4,0,6
2,2681,2783,-102,0,101,0,6
2,2229,2448,-219,0,123,0,6
2,2407,2407,0,0,321,0,6
2,2423,2536,-113,0,133,0,6
2,2412,2430,-18,0,146,1,6
2,2446,2603,-157,0,203,0,6
2,2454,2358,96,0,133,0,6
2,2574,2251,323,0,46,0,6
2,2393,2449,-56,0,190,1,6
2,2413,2529,-116,0,45,0,6
2,2384,2428,-44,0,135,1,6
2,2512,2385,127,0,140,0,6
2,2476,2472,4,0,302,0,6
2,2274,2412,-138,0,112,0,8
2,2418,2471,-53,0,46,0,6
2,2427,2334,93,0,20,0,6
2,2381,2515,-134,0,3,0,6
2,2381,2454,-73,0,195,0,6
2,2443,2393,50,0,15,0,6
2,2447,2396,51,0,106,1,6
2,2305,2466,-161,0,224,1,6
2,2405,2447,-42,0,100,0,6
2,2413,2464,-51,0,3,1,6
2,2278,2687,-409,0,302,0,6
2,2478,2562,-84,0,101,1,8
2,2455,2336,119,0,247,0,6
2,2322,2437,-115,0,0,1,6
2,2290,2423,-133,0,46,1,6
2,2608,2680,-72,0,0,0,6
2,2425,2339,86,0,46,1,6
2,2434,2330,104,0,4,0,6
2,2333,2412,-79,0,1,0,6
2,2404,2362,42,0,151,1,6
2,2488,2758,-270,0,277,0,6
2,2485,2214,271,0,125,0,7
2,2459,2382,77,0,106,0,6
2,2418,2487,-69,0,110,0,6
2,2254,2546,-292,0,4,0,6
2,2446,2422,24,0,110,1,6
2,2456,2399,57,0,4,1,6
2,2448,2417,31,0,300,0,6
2,2370,2454,-84,0,57,0,6
2,2409,2510,-101,0,104,1,6
2,2556,2554,2,0,345,0,6
2,2363,2427,-64,0,40,0,6
2,2503,2404,99,0,46,0,6
2,2260,2631,-371,0,453,0,6
2,2288,2432,-144,0,122,1,6
2,2419,2412,7,0,45,0,6
2,2428,2334,94,0,455,0,6
2,2485,2500,-15,0,331,0,6
2,2611,2820,-209,0,418,1,6
2,2388,2461,-73,0,245,0,6
2,2438,2364,74,0,459,0,6
2,2405,2408,-3,0,101,0,6
2,2576,2590,-14,0,45,0,6
2,2571,2675,-104,0,4,0,6
2,2224,2508,-284,0,194,0,8
2,2441,2407,34,0,103,0,6
2,2336,2424,-88,0,41,0,6
2,2277,2423,-146,0,1,0,6
2,2359,2463,-104,0,9,0,6
2,2263,2419,-156,0,300,1,6
2,2449,2409,40,0,100,1,6
2,2310,2471,-161,0,130,0,6
2,2504,2442,62,0,7,0,6
2,2366,2427,-61,0,101,1,6
2,2346,2419,-73,0,120,0,6
2,2405,2446,-41,0,352,0,6
2,2415,2591,-176,0,115,0,6
2,2519,2496,23,0,122,0,6
2,2419,2314,105,0,135,0,6
2,2422,2355,67,0,4,0,6
2,2502,2570,-68,0,241,0,6
2,2259,2515,-256,0,110,0,6
2,2283,2444,-161,0,106,0,6
2,2516,2476,40,0,83,0,6
2,2515,2530,-15,0,40,0,6
2,2405,2216,189,0,46,0,6
2,2413,2511,-98,0,400,0,6
2,2593,2680,-87,0,398,0,6
2,2445,2581,-136,0,123,0,6
2,2607,2535,72,0,101,0,6
2,2412,2378,34,0,106,0,6
2,2540,2545,-5,0,311,0,6
2,2238,2541,-303,0,15,0,6
2,2567,2439,128,0,43,0,6
2,2441,2238,203,0,303,1,6
2,2364,2416,-52,0,40,0,6
2,2333,2434,-101,0,0,1,6
2,2443,2467,-24,0,58,0,6
2,2358,2407,-49,0,15,1,8
2,2413,2445,-32,0,25,0,6
2,2259,2414,-155,0,200,0,6
2,2464,2483,-19,0,454,1,6
2,2376,2539,-163,0,245,0,6
2,2255,2419,-164,0,46,0,6
2,2403,2457,-54,0,101,0,6
2,2435,2371,64,0,0,1,6
2,2436,2517,-81,0,308,0,6
2,2373,2493,-120,0,40,0,6
2,2417,2358,59,0,100,0,6
2,2452,2386,66,0,455,0,6
2,2283,2434,-151,0,110,1,6
2,2498,2459,39,0,101,0,6
2,2485,2527,-42,0,31,1,6
2,2551,2518,33,0,315,0,6
2,2358,2427,-69,0,317,0,6
2,2216,2435,-219,0,288,1,6
2,2244,2739,-495,0,306,0,6
2,2412,2263,149,0,11,0,6
2,2401,2466,-65,0,121,0,6
2,2297,2455,-158,0,148,1,6
2,2495,2480,15,0,455,0,6
2,2275,2539,-264,0,61,0,6
2,2516,2560,-44,0,405,1,6
2,2452,2326,126,0,43,1,6
2,2331,2448,-117,0,128,0,6
2,2470,2420,50,0,267,1,6
2,2399,2449,-50,0,40,0,6
2,2386,2502,-116,0,105,0,6
2,2364,2436,-72,0,140,0,6
2,2430,2461,-31,0,140,0,6
2,2401,2592,-191,0,40,0,6
2,2372,2569,-197,0,126,0,6
2,2401,2388,13,0,5,1,6
2,2522,2266,256,0,46,1,6
2,2449,2365,84,0,40,0,6
2,2326,2410,-84,0,242,0,8
2,2419,2413,6,0,40,1,6
2,2260,2421,-161,0,4,0,6
2,2540,2571,-31,0,18,0,6
2,2446,2387,59,0,414,1,6
2,2447,2596,-149,0,80,0,6
2,2288,2432,-144,0,115,0,6
2,2483,2344,139,0,40,0,6
2,2415,2324,91,0,150,0,6
2,2380,2481,-101,0,102,0,6
2,2236,2620,-384,0,212,0,6
2,2508,2488,20,0,110,1,6
2,2489,2448,41,0,315,1,6
2,2302,2418,-116,0,201,0,6
2,2383,2441,-58,0,40,1,6
2,2512,2499,13,0,126,0,6
2,2536,2480,56,0,241,0,6
2,2591,2639,-48,0,253,0,6
2,2292,2444,-152,0,101,0,6
2,2320,2411,-91,0,150,1,6
2,2425,2499,-74,0,45,0,6
2,2469,2521,-52,0,245,0,6
2,2380,2423,-43,0,330,0,6
2,2521,2588,-67,0,410,0,6
2,2224,2498,-274,0,36,1,6
2,2371,2440,-69,0,373,0,6
2,2292,2525,-233,0,45,0,6
2,2468,2359,109,0,0,0,6
2,2452,2528,-76,0,202,0,6
2,2314,2408,-94,0,40,1,6
2,2369,2477,-108,0,30,1,6
2,2419,2534,-115,0,492,0,6
2,2299,2477,-178,0,267,1,5
2,2328,2512,-184,0,374,0,6
2,2452,2473,-21,0,46,0,6
2,2442,2552,-110,0,101,0,6
2,2581,2535,46,0,122,0,6
2,2339,2446,-107,0,0,0,6
2,2527,2582,-55,0,40,1,6
2,2345,2414,-69,0,102,0,6
2,2427,2386,41,0,278,0,6
2,2390,2410,-20,0,140,0,6
2,2395,2425,-30,0,140,0,6
2,2488,2353,135,0,241,0,6
2,2354,2445,-91,0,3,0,6
2,2374,2475,-101,0,106,0,6
2,2442,2615,-173,0,3,0,6
2,2491,2505,-14,0,454,1,6
2,2515,2504,11,0,41,1,6
2,2550,2551,-1,0,54,0,6
2,2450,2401,49,0,295,1,6
2,2393,2405,-12,0,470,1,6
2,2276,2460,-184,0,45,1,6
2,2521,2365,156,0,4,1,6
2,2316,2537,-221,0,0,0,6
2,2209,2445,-236,0,101,0,6
2,2423,2458,-35,0,260,0,6
2,2282,2446,-164,0,241,0,6
2,2620,2556,64,0,47,0,6
2,2291,2455,-164,0,331,1,6
2,2418,2416,2,0,100,1,6
2,2570,2398,172,0,153,0,6
2,2200,2416,-216,0,492,0,6
2,2457,2423,34,0,308,0,6
2,2278,2501,-223,0,40,0,6
2,2287,2489,-202,0,144,0,6
2,2403,2624,-221,0,113,0,6
2,2448,2539,-91,0,65,0,6
2,2368,2474,-106,0,410,0,6
2,2454,2620,-166,0,123,0,6
2,2437,2515,-78,0,45,0,6
2,2379,2501,-122,0,41,1,6
2,2318,2413,-95,0,380,0,6
2,2392,2454,-62,0,242,1,6
2,2507,2456,51,0,46,1,6
2,2527,2392,135,0,106,0,6
2,2458,2484,-26,0,310,1,6
2,2568,2612,-44,0,138,0,6
2,2347,2572,-225,0,300,0,6
2,2379,2565,-186,0,118,0,6
2,2250,2476,-226,0,106,0,6
2,2428,2553,-125,0,192,0,6
2,2395,2546,-151,0,153,0,6
2,2296,2413,-117,0,485,0,6
2,2568,2489,79,0,5,0,6
2,2440,2485,-45,0,103,0,6
2,2324,2465,-141,0,104,1,8
2,2408,2444,-36,0,270,0,6
2,2675,2361,314,0,337,0,6
2,2307,2409,-102,0,395,0,6
2,2447,2349,98,0,193,0,6
2,2239,2443,-204,0,271,1,6
2,2369,2469,-100,0,1,0,6
2,2280,2411,-131,0,102,0,6
2,2616,2589,27,0,196,0,6
2,2429,2254,175,0,4,0,6
2,2311,2407,-96,0,250,0,6
2,2459,2439,20,0,111,0,6
2,2525,2345,180,0,247,0,6
2,2387,2542,-155,0,327,1,6
2,2449,2391,58,0,414,0,6
2,2358,2440,-82,0,25,1,6
2,2337,2457,-120,0,101,1,6
2,2421,2497,-76,0,313,0,6
2,2526,2559,-33,0,101,0,6
2,2408,2477,-69,0,40,0,6
2,2452,2432,20,0,50,1,6
2,2386,2500,-114,0,109,0,6
2,2281,2608,-327,0,331,0,6
2,2393,2483,-90,0,211,1,6
2,2418,2535,-117,0,190,0,6
2,2507,2233,274,0,206,0,6
2,2464,2432,32,0,123,0,6
2,2372,2474,-102,0,13,0,6
2,2465,2512,-47,0,9,0,6
2,2406,2260,146,0,0,0,6
2,2417,2450,-33,0,265,0,6
2,2577,2525,52,0,458,0,5
2,2413,2448,-35,0,49,0,6
2,2443,2432,11,0,152,0,6
2,2475,2475,0,0,109,1,6
2,2428,2522,-94,0,245,1,6
2,2464,2383,81,0,4,0,6
2,2256,2441,-185,0,14,1,6
2,2292,2447,-155,0,301,0,6
2,2462,2449,13,0,325,0,6
2,2270,2523,-253,0,265,0,6
2,2414,2493,-79,0,250,0,6
2,2456,2372,84,0,123,0,6
2,2478,2497,-19,0,268,0,6
2,2441,2483,-42,0,104,1,6
2,2449,2372,77,0,8,0,6
2,2530,2509,21,0,40,0,6
2,2521,2391,130,0,455,0,6
2,2325,2408,-83,0,230,0,6
2,2365,2415,-50,0,315,1,6
2,2557,2471,86,0,106,0,6
2,2226,2474,-248,0,81,0,6
2,2455,2480,-25,0,6,0,6
2,2323,2447,-124,4,302,0,13
2,2518,2472,46,0,18,0,6
2,2434,2441,-7,0,138,1,6
2,2584,2625,-41,0,45,0,6
2,2244,2443,-199,0,106,0,6
2,2415,2446,-31,0,9,0,6
2,2270,2406,-136,0,110,0,6
2,2480,2424,56,0,415,1,6
2,2366,2418,-52,0,409,1,6
2,2461,2484,-23,0,28,0,6
2,2541,2438,103,0,100,0,6
2,2224,2551,-327,0,115,0,6
2,2338,2453,-115,0,460,1,6
2,2344,2519,-175,0,404,1,6
2,2423,2567,-144,0,300,0,6
2,2423,2396,27,0,41,0,6
2,2524,2443,81,0,100,1,6
2,2472,2385,87,0,143,0,5
2,2555,2477,78,0,331,1,6
2,2309,2485,-176,0,302,0,6
2,2329,2407,-78,0,325,1,6
2,2403,2488,-85,0,115,1,6
2,2340,2415,-75,0,302,0,6
2,2456,2610,-154,0,3,0,6
2,2427,2384,43,0,301,1,6
2,2475,2629,-154,0,120,0,6
2,2476,2463,13,0,113,0,6
2,2595,2430,165,0,394,1,6
2,2465,2270,195,0,130,0,6
2,2263,2457,-194,4,146,0,13
2,2443,2536,-93,0,17,1,6
2,2446,2543,-97,0,101,0,6
2,2595,2660,-65,0,112,0,6
2,2357,2422,-65,0,115,0,6
2,2379,2579,-200,0,1,0,6
2,2563,2580,-17,0,31,1,6
2,2459,2418,41,0,375,0,6
2,2523,2297,226,0,254,0,6
2,2428,2441,-13,0,4,0,6
2,2362,2433,-71,0,313,0,6
2,2427,2366,61,0,302,1,6
2,2410,2476,-66,0,242,0,6
2,2357,2436,-79,0,302,1,6
2,2450,2332,118,0,334,1,6
2,2420,2422,-2,0,101,0,6
2,2420,2416,4,0,84,0,6
2,2464,2462,2,0,113,0,6
2,2537,2676,-139,0,100,0,6
2,2262,2450,-188,0,123,0,6
2,2313,2424,-111,4,202,0,13
2,2247,2414,-167,0,419,1,6
2,2207,2491,-284,0,40,1,6
2,2455,2487,-32,0,8,0,6
2,2297,2415,-118,4,80,0,13
2,2689,2737,-48,0,247,0,6
2,2372,2479,-107,0,20,0,6
2,2443,2458,-15,0,300,0,6
2,2324,2467,-143,0,123,0,6
2,2726,2311,415,0,225,1,6
2,2403,2338,65,0,113,1,6
2,2425,2380,45,0,4,0,6
2,2497,2682,-185,0,335,0,6
2,2278,2419,-141,0,250,0,10
2,2487,2381,106,0,52,0,6
2,2266,2506,-240,0,253,0,6
2,2419,2427,-8,0,8,0,6
2,2447,2423,24,0,130,1,6
2,2405,2366,39,0,15,0,6
2,2392,2518,-126,0,311,0,6
2,2454,2496,-42,0,216,0,6
2,2631,2508,123,0,104,1,6
2,2406,2325,81,0,150,1,6
2,2616,2400,216,0,85,0,8
2,2464,2467,-3,0,140,0,6
2,2410,2573,-163,0,2,0,6
2,2484,2539,-55,0,345,0,6
2,2438,2388,50,0,181,0,6
2,2428,2526,-98,0,101,1,6
2,2314,2415,-101,0,56,0,6
2,2499,2706,-207,0,190,0,5
2,2358,2409,-51,0,225,0,6
2,2471,2347,124,0,136,0,6
2,2354,2411,-57,0,106,0,6
2,2460,2415,45,0,34,1,6
2,2467,2481,-14,0,315,0,6
2,2451,2366,85,0,107,0,6
2,2466,2613,-147,0,300,1,6
2,2347,2400,-53,0,244,0,6
2,2309,2445,-136,0,485,0,6
2,2400,2317,83,0,256,0,6
2,2223,2455,-232,0,126,1,6
2,2400,2521,-121,0,394,0,6
2,2415,2426,-11,0,21,0,6
2,2355,2662,-307,0,122,0,6
2,2422,2469,-47,0,11,0,6
2,2495,2543,-48,0,282,0,6
2,2237,2416,-179,0,101,0,6
2,2399,2480,-81,0,426,1,6
2,2357,2505,-148,0,337,1,6
2,2551,2621,-70,0,106,0,6
2,2221,2430,-209,0,53,0,6
2,2329,2715,-386,0,113,0,6
2,2402,2321,81,0,138,1,6
2,2437,2320,117,0,48,0,6
2,2461,2377,84,0,195,1,6
2,2461,2496,-35,0,225,0,6
2,2365,2401,-36,0,242,1,6
2,2397,2513,-116,0,9,0,6
2,2347,2465,-118,4,245,0,13
2,2410,2388,22,0,130,0,6
2,2417,2424,-7,0,115,0,6
2,2549,2540,9,0,4,0,6
2,2417,2298,119,0,48,0,6
2,2272,2409,-137,0,35,0,6
2,2431,2336,95,0,352,0,6
2,2377,2510,-133,0,110,0,6
2,2255,2514,-259,0,327,0,6
2,2561,2548,13,0,242,0,6
2,2496,2505,-9,0,250,1,6
2,2463,2623,-160,0,196,0,6
2,2307,2437,-130,0,189,1,6
2,2386,2552,-166,0,302,0,6
2,2299,2403,-104,0,228,0,6
2,2366,2472,-106,0,3,0,6
2,2310,2402,-92,0,450,0,6
2,2390,2501,-111,0,380,0,6
2,2402,2372,30,0,240,1,6
2,2310,2493,-183,0,80,0,6
2,2518,2354,164,0,40,0,6
2,2361,2443,-82,0,103,0,8
2,2514,2495,19,0,311,0,6
2,2370,2429,-59,0,227,1,8
2,2522,2485,37,0,37,0,6
2,2405,2349,56,0,113,1,6
2,2417,2465,-48,0,200,0,6
2,2407,2493,-86,0,110,1,6
2,2404,2310,94,0,133,1,6
2,2312,2472,-160,0,64,0,6
2,2482,2544,-62,0,1,0,6
2,2280,2413,-133,0,250,1,6
2,2574,2429,145,0,338,0,6
2,2526,2451,75,0,190,0,6
2,2248,2453,-205,0,335,0,6
2,2422,2444,-22,0,101,0,6
2,2486,2421,65,0,107,0,6
2,2321,2548,-227,0,42,0,6
2,2297,2601,-304,0,130,0,8
2,2419,2395,24,0,217,1,6
2,2377,2446,-69,0,10,0,6
2,2489,2408,81,0,455,0,6
2,2388,2402,-14,0,106,0,6
2,2629,2451,178,0,253,0,6
2,2312,2450,-138,0,103,0,6
2,2395,2507,-112,0,141,0,6
2,2426,2445,-19,0,112,0,6
2,2425,2414,11,0,401,1,6
2,2426,2402,24,0,115,0,6
2,2744,2428,316,0,168,0,6
2,2543,2658,-115,0,5,0,6
2,2369,2405,-36,0,132,1,6
2,2423,2541,-118,0,4,0,6
2,2468,2428,40,0,300,0,6
2,2226,2582,-356,0,202,0,6
2,2410,2443,-33,0,37,1,6
2,2253,2425,-172,0,112,0,6
2,2416,2562,-146,0,414,0,6
2,2375,2402,-27,0,334,0,6
2,2462,2290,172,0,40,0,6
2,2377,2465,-88,0,45,0,6
2,2401,2724,-323,0,337,0,6
2,2294,2426,-132,0,426,0,8
2,2579,2551,28,0,435,0,6
2,2483,2541,-58,0,45,0,6
2,2429,2239,190,0,190,0,8
2,2648,2637,11,0,142,0,6
2,2473,2480,-7,0,140,0,6
2,2553,2484,69,0,315,0,6
2,2383,2431,-48,0,258,0,10
2,2423,2313,110,0,440,1,8
2,2294,2426,-132,0,300,1,6
2,2344,2450,-106,0,127,0,6
2,2416,2457,-41,0,335,0,6
2,2258,2459,-201,4,147,1,11
2,2565,2617,-52,0,106,1,6
2,2612,2717,-105,0,123,0,6
2,2444,2314,130,0,300,0,6
2,2469,2527,-58,0,106,0,6
2,2359,2404,-45,0,241,0,6
2,2400,2376,24,0,310,0,6
2,2378,2507,-129,0,1,1,6
2,2637,2597,40,0,101,0,6
2,2257,2510,-253,0,242,0,7
2,2422,2673,-251,0,474,0,6
2,2437,2362,75,0,134,0,6
2,2405,2439,-34,0,337,0,6
2,2593,2613,-20,0,302,0,6
2,2354,2518,-164,0,120,0,6
2,2310,2453,-143,0,100,1,6
2,2325,2438,-113,0,16,0,6
2,2449,2368,81,0,101,1,6
2,2331,2497,-166,0,0,0,6
2,2437,2473,-36,0,245,0,6
2,2389,2409,-20,0,203,1,6
2,2428,2443,-15,0,331,0,6
2,2404,2242,162,0,176,0,8
2,2384,2434,-50,0,289,0,6
2,2626,2629,-3,0,41,0,6
2,2558,2560,-2,0,46,0,6
2,2237,2520,-283,0,300,0,6
2,2601,2610,-9,0,4,1,6
2,2431,2317,114,0,429,1,6
2,2224,2436,-212,0,100,0,8
2,2408,2459,-51,0,136,0,6
2,2315,2480,-165,0,132,0,6
2,2254,2430,-176,0,354,1,6
2,2426,2554,-128,0,255,1,6
2,2396,2418,-22,0,123,1,6
2,2411,2412,-1,0,45,0,6
2,2567,2537,30,0,101,0,6
2,2396,2585,-189,0,108,1,6
2,2662,2510,152,0,40,0,6
2,2672,2692,-20,0,195,1,6
2,2824,2766,58,0,113,1,6
2,2404,2355,49,0,202,1,6
2,2289,2465,-176,0,253,0,6
2,2355,2439,-84,0,271,0,6
2,2572,2572,0,0,211,0,6
2,2416,2471,-55,0,41,0,6
2,2380,2466,-86,0,477,0,6
2,2449,2625,-176,0,50,0,6
2,2345,2443,-98,0,150,0,6
2,2315,2619,-304,0,53,0,6
2,2509,2405,104,0,135,0,6
2,2326,2434,-108,0,190,1,6
2,2471,2502,-31,0,101,0,6
2,2271,2449,-178,0,315,1,6
2,2457,2284,173,0,14,0,6
2,2481,2326,155,0,107,0,6
2,2470,2277,193,4,145,0,13
2,2432,2542,-110,0,244,0,6
2,2520,2600,-80,0,143,0,6
2,2593,2532,61,0,200,0,6
2,2537,2591,-54,0,302,0,6
2,2497,2607,-110,0,106,1,6
2,2555,2461,94,0,286,0,6
2,2310,2409,-99,0,40,0,6
2,2383,2421,-38,0,241,0,6
2,2352,2471,-119,0,200,0,6
2,2421,2351,70,0,101,0,6
2,2533,2550,-17,0,101,0,6
2,2426,2445,-19,0,211,1,6
2,2448,2430,18,0,4,1,6
2,2331,2401,-70,0,48,1,6
2,2278,2474,-196,0,40,0,6
2,2508,2271,237,0,463,0,6
2,2461,2460,1,0,50,0,6
2,2400,2416,-16,0,102,1,6
2,2437,2419,18,0,278,0,6
2,2351,2607,-256,0,100,0,6
2,2519,2344,175,0,228,0,6
2,2565,2629,-64,0,118,0,6
2,2335,2539,-204,0,152,0,6
2,2240,2441,-201,0,487,0,10
2,2450,2443,7,0,278,1,6
2,2481,2393,88,0,143,0,6
2,2443,2417,26,0,65,1,6
2,2655,2712,-57,0,332,1,6
2,2524,2553,-29,0,406,0,6
2,2440,2479,-39,0,406,0,6
2,2345,2463,-118,0,40,0,6
2,2316,2508,-192,0,4,0,6
2,2480,2544,-64,0,321,0,6
2,2505,2406,99,0,107,0,6
2,2616,2347,269,0,112,0,6
2,2266,2410,-144,0,27,0,6
2,2406,2444,-38,0,301,0,6
2,2443,2469,-26,0,21,0,6
2,2434,2331,103,0,201,0,6
2,2407,2506,-99,0,44,1,6
2,2625,2676,-51,0,162,0,6
2,2336,2555,-219,0,15,1,6
2,2389,2425,-36,0,490,0,6
2,2418,2523,-105,0,45,0,6
2,2407,2419,-12,4,88,1,13
2,2521,2656,-135,0,30,0,6
2,2374,2525,-151,0,132,0,6
2,2597,2471,126,0,106,0,6
2,2638,2697,-59,0,49,0,6
2,2483,2452,31,0,253,1,6
2,2554,2277,277,0,38,0,6
2,2449,2482,-33,0,15,0,6
2,2429,2310,119,0,343,0,6
2,2334,2490,-156,0,45,0,6
2,2549,2568,-19,0,46,1,6
2,2404,2471,-67,0,40,0,6
2,2596,2377,219,0,85,0,6
2,2427,2378,49,0,88,0,6
2,2389,2502,-113,0,101,0,6
2,2400,2515,-115,0,21,0,6
2,2403,2299,104,0,190,0,6
2,2239,2527,-288,0,310,0,6
2,2384,2538,-154,0,300,1,6
2,2235,2410,-175,0,124,0,6
2,2470,2349,121,0,335,1,6
2,2633,2428,205,0,0,0,6
2,2310,2414,-104,0,15,0,6
2,2401,2440,-39,0,206,0,6
2,2539,2557,-18,0,103,1,6
2,2492,2489,3,0,244,0,6
2,2480,2420,60,0,45,0,6
2,2462,2363,99,0,337,0,6
2,2418,2366,52,0,133,0,6
2,2306,2413,-107,0,0,0,6
2,2633,2507,126,0,43,0,6
2,2454,2385,69,0,4,0,6
2,2357,2458,-101,0,42,0,6
2,2382,2427,-45,0,102,0,6
2,2533,2505,28,0,484,0,6
2,2278,2418,-140,4,80,0,11
2,2443,2425,18,0,337,0,6
2,2504,2514,-10,0,250,0,6
2,2525,2377,148,0,377,0,6
2,2506,2521,-15,0,102,0,6
2,2436,2210,226,0,241,1,8
2,2408,2355,53,0,140,0,6
2,2482,2519,-37,0,100,1,6
2,2232,2405,-173,0,305,0,6
2,2396,2503,-107,0,102,0,6
2,2389,2416,-27,0,40,0,6
2,2478,2580,-102,0,309,0,6
2,2331,2410,-79,0,40,0,6
2,2491,2515,-24,0,131,0,6
2,2226,2434,-208,4,409,0,13
2,2423,2365,58,0,43,0,6
2,2390,2564,-174,0,125,0,6
2,2389,2404,-15,0,296,0,6
2,2443,2464,-21,0,121,0,6
2,2622,2460,162,0,250,0,6
2,2558,2539,19,0,300,0,6
2,2417,2417,0,0,6,0,6
2,2299,2504,-205,0,0,0,8
2,2594,2620,-26,0,118,0,6
2,2331,2551,-220,0,336,1,6
2,2370,2431,-61,0,22,0,8
2,2421,2271,150,0,40,1,5
2,2323,2450,-127,0,1,0,6
2,2418,2319,99,0,400,0,6
2,2544,2483,61,0,112,1,6
2,2493,2499,-6,0,45,1,8
2,2567,2607,-40,0,300,1,6
2,2462,2458,4,0,40,1,6
2,2307,2502,-195,0,201,1,6
2,2269,2409,-140,0,4,0,6
2,2411,2354,57,0,13,1,6
2,2331,2413,-82,0,45,0,6
2,2292,2464,-172,0,302,0,6
2,2412,2405,7,0,454,0,6
2,2424,2436,-12,0,167,0,6
2,2598,2805,-207,0,148,0,6
2,2256,2415,-159,0,205,0,6
2,2556,2548,8,0,41,0,6
2,2496,2577,-81,0,120,0,6
2,2435,2472,-37,0,306,1,6
2,2453,2606,-153,0,106,1,6
2,2458,2375,83,0,133,1,6
2,2482,2405,77,0,120,0,6
2,2456,2432,24,0,202,0,6
2,2397,2579,-182,0,40,0,6
2,2383,2456,-73,0,115,0,6
2,2412,2416,-4,0,406,0,6
2,2242,2402,-160,0,210,0,6
2,2544,2438,106,0,311,0,6
2,2486,2591,-105,0,453,0,6
2,2533,2504,29,0,255,1,6
2,2426,2398,28,0,200,0,6
2,2301,2585,-284,0,440,0,6
2,2475,2577,-102,0,454,0,6
2,2523,2357,166,0,44,0,6
2,2439,2470,-31,0,466,0,5
2,2346,2417,-71,0,242,0,6
2,2556,2524,32,0,305,0,6
2,2387,2440,-53,0,5,0,6
2,2533,2528,5,0,103,1,6
2,2409,2373,36,0,247,0,6
2,2541,2518,23,0,110,1,6
2,2387,2489,-102,0,463,0,6
2,2368,2469,-101,0,20,0,6
2,2357,2414,-57,0,15,0,6
2,2530,2532,-2,0,300,1,6
2,2360,2400,-40,0,40,0,6
2,2501,2475,26,0,4,0,6
2,2499,2493,6,0,298,0,6
2,2292,2405,-113,0,45,1,6
2,2335,2514,-179,0,133,1,6
2,2406,2539,-133,0,247,0,6
2,2385,2434,-49,0,45,0,6
2,2548,2429,119,0,355,0,6
2,2409,2327,82,0,55,1,6
2,2526,2531,-5,0,150,1,6
2,2461,2349,112,0,338,0,6
2,2535,2531,4,0,411,0,6
2,2412,2479,-67,0,46,1,6
2,2335,2442,-107,0,448,0,6
2,2522,2766,-244,0,106,0,6
2,2534,2446,88,0,45,1,6
2,2491,2561,-70,0,355,1,6
2,2405,2459,-54,0,4,0,6
2,2710,2479,231,0,7,0,6
2,2471,2350,121,0,255,0,8
2,2411,2595,-184,0,110,0,6
2,2445,2300,145,0,268,1,6
2,2330,2443,-113,0,31,1,6
2,2374,2558,-184,0,135,0,6
2,2210,2491,-281,0,114,1,6
2,2420,2408,12,0,40,0,6
2,2279,2416,-137,0,300,1,6
2,2629,2660,-31,0,130,1,6
2,2480,2411,69,0,45,0,6
2,2669,2607,62,0,313,1,6
2,2253,2413,-160,0,438,0,6
2,2343,2446,-103,0,305,0,6
2,2365,2451,-86,0,4,0,6
2,2336,2443,-107,0,15,0,6
2,2485,2485,0,0,102,0,6
2,2308,2498,-190,0,0,0,6
2,2512,2578,-66,0,6,0,6
2,2320,2421,-101,0,8,0,6
2,2420,2428,-8,4,345,0,13
2,2497,2528,-31,0,455,0,6
2,2546,2520,26,0,216,0,6
2,2408,2421,-13,0,50,0,6
2,2373,2516,-143,0,260,0,6
2,2354,2493,-139,0,345,0,6
2,2229,2539,-310,0,416,0,6
2,2444,2453,-9,0,300,0,6
2,2398,2459,-61,0,13,0,6
2,2392,2427,-35,0,25,0,6
2,2695,2504,191,0,7,0,5
2,2363,2426,-63,0,307,0,6
2,2405,2438,-33,0,140,0,6
2,2567,2566,1,0,1,0,6
2,2403,2331,72,0,386,0,6
2,2515,2723,-208,0,373,1,6
2,2443,2423,20,0,13,1,6
2,2460,2434,26,0,46,0,6
2,2309,2424,-115,0,331,0,6
2,2280,2403,-123,0,143,1,6
2,2444,2391,53,0,122,0,6
2,2382,2401,-19,0,9,0,6
2,2450,2325,125,0,140,0,6
2,2204,2561,-357,0,27,0,6
2,2378,2463,-85,0,103,1,6
2,2394,2449,-55,0,139,0,6
2,2410,2709,-299,0,10,0,6
2,2592,2631,-39,0,466,0,6
2,2425,2328,97,0,107,0,6
2,2362,2510,-148,0,3,0,6
2,2368,2573,-205,0,250,0,6
2,2400,2474,-74,0,310,0,6
2,2401,2245,156,0,172,0,6
2,2294,2404,-110,0,34,0,6
2,2454,2355,99,0,202,0,6
2,2254,2427,-173,0,255,0,6
2,2357,2439,-82,0,0,0,6
2,2449,2492,-43,0,102,0,6
2,2407,2302,105,0,0,1,6
2,2485,2402,83,0,145,0,6
2,2320,2487,-167,0,311,0,6
2,2419,2265,154,0,150,0,6
2,2414,2318,96,0,176,0,8
2,2500,2398,102,0,45,0,6
2,2464,2446,18,0,0,0,6
2,2378,2439,-61,0,44,0,6
2,2303,2517,-214,0,3,0,8
2,2453,2319,134,0,242,0,6
2,2348,2546,-198,0,7,0,6
2,2282,2405,-123,0,45,1,8
2,2389,2402,-13,0,454,1,6
2,2413,2459,-46,0,40,0,6
2,2295,2400,-105,0,200,0,6
2,2507,2550,-43,0,46,0,6
2,2399,2612,-213,0,150,0,6
2,2402,2357,45,0,196,0,6
2,2558,2430,128,0,331,0,6
2,2437,2353,84,0,400,0,6
2,2446,2484,-38,0,300,1,6
2,2409,2400,9,0,110,0,6
2,2240,2418,-178,0,411,1,6
2,2279,2424,-145,0,132,1,6
2,2368,2439,-71,0,264,0,6
2,2596,2501,95,0,260,0,6
2,2550,2445,105,0,278,0,6
2,2457,2420,37,0,46,0,6
2,2521,2627,-106,0,305,0,6
2,2416,2324,92,0,343,1,6
2,2388,2434,-46,0,13,0,6
2,2554,2631,-77,0,20,0,6
2,2545,2533,12,0,368,0,6
2,2578,2502,76,0,378,1,6
2,2316,2418,-102,0,331,0,6
2,2364,2658,-294,0,324,0,6
2,2545,2536,9,0,302,0,6
2,2534,2396,138,0,201,0,6
2,2453,2444,9,0,101,1,6
2,2486,2481,5,0,404,0,6
2,2696,2707,-11,0,13,1,6
2,2338,2416,-78,0,117,0,6
2,2399,2415,-16,0,122,1,6
2,2417,2424,-7,0,110,0,6
2,2583,2741,-158,0,335,0,6
2,2365,2497,-132,0,2,0,6
2,2541,2460,81,0,120,0,6
2,2575,2585,-10,0,28,0,6
2,2383,2476,-93,0,10,0,6
2,2207,2491,-284,0,117,1,6
2,2565,2687,-122,0,122,0,6
2,2499,2454,45,0,190,0,6
2,2526,2511,15,0,7,0,6
2,2384,2571,-187,0,483,0,6
2,2383,2539,-156,0,40,0,6
2,2498,2501,-3,0,106,0,6
2,2506,2422,84,0,145,0,6
2,2470,2210,260,0,406,1,6
2,2403,2421,-18,0,333,0,6
2,2384,2462,-78,0,388,0,6
2,2397,2575,-178,0,3,0,6
2,2431,2421,10,0,40,0,6
2,2444,2486,-42,0,45,0,6
2,2220,2525,-305,0,10,0,6
2,2493,2304,189,0,141,1,6
2,2224,2421,-197,0,230,1,8
2,2444,2593,-149,0,247,0,6
2,2422,2492,-70,0,4,0,6
2,2384,2546,-162,0,40,0,6
2,2524,2416,108,0,45,0,6
2,2406,2296,110,0,34,1,6
2,2544,2466,78,0,246,0,6
2,2682,2805,-123,0,40,1,6
2,2423,2461,-38,0,110,1,6
2,2477,2448,29,0,302,0,6
2,2434,2436,-2,0,76,0,6
2,2420,2378,42,0,107,1,6
2,2468,2414,54,0,373,0,6
2,2413,2240,173,0,301,1,6
2,2461,2477,-16,0,41,0,6
2,2437,2298,139,4,335,0,13
2,2485,2523,-38,0,243,0,6
2,2502,2511,-9,0,265,0,6
2,2538,2543,-5,0,337,0,6
2,2478,2415,63,0,202,0,6
2,2520,2455,65,0,105,0,6
2,2429,2518,-89,0,111,0,6
2,2408,2368,40,0,46,0,6
2,2302,2418,-116,0,212,0,6
2,2355,2400,-45,0,121,0,6
2,2427,2328,99,0,222,1,6
2,2485,2431,54,0,244,0,6
2,2419,2408,11,0,40,0,6
2,2614,2508,106,0,46,0,6
2,2489,2489,0,0,8,1,6
2,2445,2520,-75,0,386,0,6
2,2317,2418,-101,4,192,1,11
2,2587,2563,24,0,243,0,6
2,2430,2482,-52,0,7,0,6
2,2472,2535,-63,0,278,0,6
2,2402,2445,-43,0,132,1,6
2,2453,2358,95,0,1,0,6
2,2647,2593,54,0,200,0,6
2,2370,2420,-50,0,311,1,6
2,2270,2440,-170,0,448,0,6
2,2509,2551,-42,0,122,1,6
2,2261,2412,-151,0,31,0,6
2,2663,2476,187,0,45,0,6
2,2373,2403,-30,0,50,0,6
2,2375,2431,-56,0,310,0,6
2,2587,2552,35,0,310,0,6
2,2451,2320,131,0,45,0,6
2,2514,2714,-200,0,248,0,6
2,2410,2451,-41,0,247,0,6
2,2534,2621,-87,0,120,0,6
2,2371,2476,-105,0,211,0,6
2,2425,2493,-68,0,151,0,6
2,2331,2473,-142,0,17,1,6
2,2569,2545,24,0,102,0,6
2,2529,2454,75,0,7,0,6
2,2465,2418,47,0,15,0,6
2,2335,2427,-92,0,400,0,6
2,2426,2374,52,0,121,0,6
2,2341,2482,-141,0,128,0,6
2,2299,2490,-191,0,4,0,6
2,2448,2567,-119,0,40,0,6
2,2472,2432,40,0,46,0,6
2,2308,2456,-148,0,387,0,6
2,2300,2430,-130,0,418,0,6
2,2565,2501,64,0,7,0,6
2,2541,2423,118,0,113,0,6
2,2628,2688,-60,0,474,0,6
2,2217,2410,-193,0,0,0,6
2,2322,2421,-99,0,150,0,6
2,2569,2612,-43,0,150,0,6
2,2417,2306,111,0,0,0,6
2,2492,2398,94,0,398,1,6
2,2431,2262,169,0,0,0,6
2,2477,2481,-4,0,339,1,6
2,2400,2420,-20,0,45,0,6
2,2402,2474,-72,0,113,0,6
2,2352,2402,-50,0,245,0,6
2,2437,2338,99,0,184,0,6
2,2430,2275,155,0,200,0,6
2,2519,2382,137,0,200,0,6
2,2544,2750,-206,0,395,1,6
2,2304,2408,-104,0,8,1,6
2,2367,2481,-114,0,1,0,6
2,2408,2430,-22,0,205,0,6
2,2425,2459,-34,0,123,0,6
2,2312,2450,-138,0,301,0,6
2,2516,2393,123,0,341,0,6
2,2598,2554,44,0,112,0,6
2,2413,2474,-61,0,300,1,6
2,2551,2536,15,0,253,0,6
2,2327,2411,-84,0,110,0,6
2,2364,2416,-52,0,323,0,6
2,2274,2402,-128,0,106,0,6
2,2681,2511,170,0,244,1,6
2,2397,2427,-30,0,455,0,6
2,2327,2474,-147,0,1,0,6
2,2502,2516,-14,0,101,0,8
2,2402,2215,187,4,278,0,13
2,2480,2538,-58,0,132,1,6
2,2485,2376,109,0,55,0,6
2,2402,2443,-41,0,101,0,6
2,2483,2449,34,0,125,1,6
2,2460,2600,-140,0,3,0,6
2,2316,2445,-129,0,40,0,6
2,2413,2447,-34,0,302,0,6
2,2575,2394,181,0,46,0,6
2,2566,2580,-14,0,125,1,6
2,2413,2401,12,0,13,0,6
2,2447,2437,10,0,20,0,6
2,2273,2443,-170,0,245,0,6
2,2468,2458,10,0,4,0,6
2,2397,2452,-55,0,160,0,6
2,2288,2494,-206,0,302,0,6
2,2438,2531,-93,0,260,0,6
2,2556,2535,21,0,245,0,6
2,2649,2680,-31,0,193,1,6
2,2378,2403,-25,0,141,1,8
2,2374,2495,-121,0,3,0,6
2,2210,2501,-291,0,45,0,6
2,2296,2424,-128,0,201,0,6
2,2567,2607,-40,0,14,0,6
2,2360,2418,-58,0,8,1,6
2,2358,2435,-77,0,123,0,6
2,2455,2403,52,0,242,0,6
2,2560,2519,41,0,456,0,6
2,2469,2327,142,0,8,0,6
2,2436,2393,43,0,101,0,6
2,2550,2335,215,0,49,0,6
2,2478,2516,-38,0,4,0,6
2,2432,2357,75,0,106,0,6
2,2424,2559,-135,0,117,0,6
2,2369,2453,-84,0,343,0,6
2,2424,2341,83,0,215,1,6
2,2287,2470,-183,0,111,0,6
2,2601,2649,-48,0,106,0,6
2,2418,2322,96,0,46,1,6
2,2417,2409,8,0,0,1,6
2,2361,2547,-186,0,5,0,6
2,2495,2493,2,0,315,0,6
2,2471,2528,-57,0,201,0,6
2,2478,2503,-25,0,120,0,6
2,2461,2463,-2,0,4,0,6
2,2625,2578,47,0,220,0,6
2,2449,2414,35,0,20,1,6
2,2574,2468,106,0,100,0,6
2,2415,2529,-114,0,218,0,6
2,2444,2452,-8,0,404,0,6
2,2450,2455,-5,0,156,0,6
2,2405,2256,149,0,115,0,6
2,2373,2585,-212,0,112,0,8
2,2284,2400,-116,0,333,1,6
2,2327,2490,-163,0,10,1,6
2,2510,2460,50,0,6,0,6
2,2440,2441,-1,0,277,0,6
2,2464,2400,64,0,110,0,6
2,2420,2363,57,0,245,0,6
2,2322,2407,-85,0,81,0,6
2,2318,2450,-132,0,300,0,8
2,2364,2431,-67,0,269,1,6
2,2352,2434,-82,0,194,0,6
2,2405,2544,-139,0,45,0,6
2,2435,2402,33,0,42,1,6
2,2738,2552,186,0,246,0,6
2,2220,2434,-214,0,110,0,8
2,2452,2469,-17,0,54,0,6
2,2316,2433,-117,0,339,0,6
2,2389,2445,-56,0,101,1,6
2,2400,2406,-6,0,207,1,6
2,2593,2401,192,0,250,0,6
2,2312,2454,-142,0,80,0,6
2,2324,2463,-139,0,111,1,6
2,2706,2567,139,0,140,0,6
2,2452,2356,96,0,400,1,6
2,2417,2350,67,0,337,0,6
2,2544,2405,139,0,101,0,6
2,2552,2637,-85,0,138,0,6
2,2444,2344,100,0,242,0,6
2,2316,2421,-105,0,311,1,6
2,2402,2280,122,0,48,0,6
2,2394,2478,-84,0,45,0,6
2,2476,2456,20,0,345,1,6
2,2498,2416,82,0,131,0,6
2,2378,2448,-70,0,310,0,6
2,2280,2430,-150,0,418,1,6
2,2412,2459,-47,0,462,0,6
2,2475,2504,-29,0,156,0,6
2,2471,2449,22,0,410,1,6
2,2349,2412,-63,0,100,0,6
2,2387,2406,-19,0,200,0,6
2,2238,2408,-170,0,212,1,6
2,2452,2456,-4,0,292,1,6
2,2428,2432,-4,0,374,0,6
2,2410,2436,-26,0,0,0,6
2,2389,2412,-23,0,190,0,6
2,2686,2568,118,0,307,0,6
2,2293,2404,-111,0,41,0,6
2,2555,2503,52,0,45,0,6
2,2396,2478,-82,0,45,1,6
2,2858,2654,204,0,380,0,6
2,2264,2433,-169,0,45,0,6
2,2452,2378,74,0,89,0,6
2,2695,2708,-13,0,13,0,6
2,2555,2477,78,0,289,1,6
2,2284,2424,-140,0,454,0,6
2,2344,2480,-136,0,300,0,6
2,2436,2415,21,0,46,0,6
2,2284,2460,-176,0,1,0,6
2,2547,2251,296,0,330,0,6
2,2355,2448,-93,0,113,0,6
2,2330,2502,-172,0,113,0,6
2,2460,2501,-41,0,41,0,6
2,2366,2422,-56,0,5,0,6
2,2459,2571,-112,0,300,0,6
2,2525,2416,109,0,1,1,6
2,2317,2467,-150,0,300,0,6
2,2549,2384,165,0,201,0,6
2,2451,2509,-58,0,45,0,6
2,2406,2309,97,0,4,1,6
2,2452,2505,-53,0,246,1,6
2,2443,2376,67,0,455,0,6
2,2421,2319,102,0,190,0,6
2,2437,2356,81,0,122,1,6
2,2406,2244,162,0,50,0,8
2,2332,2465,-133,0,335,0,6
2,2344,2439,-95,0,49,0,6
2,2407,2508,-101,0,211,0,8
2,2396,2545,-149,0,9,0,8
2,2211,2533,-322,0,120,0,6
2,2233,2501,-268,0,300,0,6
2,2366,2569,-203,0,49,0,6
2,2393,2491,-98,0,112,1,6
2,2343,2436,-93,0,455,0,6
2,2565,2459,106,0,46,0,6
2,2385,2429,-44,0,46,0,6
2,2351,2446,-95,0,6,0,6
2,2358,2493,-135,0,48,0,6
2,2298,2470,-172,0,115,0,6
2,2438,2493,-55,0,96,0,6
2,2441,2470,-29,0,335,1,6
2,2546,2513,33,0,101,0,6
2,2436,2369,67,0,110,1,6
2,2403,2491,-88,0,300,0,6
2,2421,2351,70,0,5,0,6
2,2422,2395,27,0,487,1,6
2,2302,2448,-146,0,212,1,6
2,2450,2392,58,0,9,0,6
2,2577,2546,31,0,21,0,6
2,2667,2626,41,0,4,0,6
2,2654,2623,31,0,304,0,6
2,2534,2394,140,0,302,0,6
2,2420,2546,-126,0,260,1,6
2,2566,2474,92,0,8,0,6
2,2588,2503,85,0,120,1,6
2,2359,2408,-49,0,89,0,6
2,2390,2471,-81,0,132,0,6
2,2445,2440,5,0,300,0,6
2,2252,2589,-337,0,125,0,6
2,2506,2544,-38,0,311,1,6
2,2316,2501,-185,0,373,0,6
2,2380,2432,-52,0,45,1,6
2,2448,2541,-93,0,13,1,6
2,2232,2518,-286,0,40,0,6
2,2301,2507,-206,0,101,0,6
2,2263,2419,-156,0,136,0,6
2,2431,2544,-113,0,145,0,6
2,2509,2344,165,0,310,1,6
2,2452,2453,-1,0,315,0,6
2,2677,2677,0,0,133,0,6
2,2504,2470,34,0,101,1,6
2,2410,2385,25,0,385,0,6
2,2457,2482,-25,0,277,0,6
2,2505,2348,157,0,300,0,6
2,2236,2419,-183,0,310,0,6
2,2288,2419,-131,0,13,1,6
2,2379,2429,-50,0,278,0,6
2,2294,2419,-125,0,432,0,6
2,2540,2574,-34,0,106,0,6
2,2360,2459,-99,0,218,0,6
2,2314,2411,-97,0,143,0,6
2,2432,2453,-21,0,151,0,6
2,2563,2212,351,0,45,1,6
2,2614,2716,-102,0,125,0,6
2,2283,2416,-133,0,257,0,6
2,2389,2599,-210,0,174,0,6
2,2470,2521,-51,0,128,0,6
2,2581,2586,-5,0,110,1,6
2,2409,2529,-120,0,483,0,6
2,2414,2318,96,0,250,0,6
2,2285,2466,-181,0,35,0,6
2,2345,2489,-144,0,245,0,5
2,2365,2474,-109,0,487,1,6
2,2306,2402,-96,0,66,0,6
2,2615,2660,-45,0,100,1,6
2,2521,2506,15,0,10,0,6
2,2304,2418,-114,0,115,0,6
2,2404,2272,132,0,40,0,6
2,2381,2448,-67,0,354,0,6
2,2332,2421,-89,0,122,0,6
2,2541,2626,-85,0,100,0,6
2,2389,2442,-53,0,202,0,6
2,2373,2480,-107,0,469,0,6
2,2563,2697,-134,0,151,0,6
2,2554,2549,5,0,300,1,6
2,2327,2611,-284,0,13,0,6
2,2225,2402,-177,0,110,1,6
2,2481,2603,-122,0,48,0,6
2,2340,2489,-149,0,304,0,6
2,2290,2406,-116,0,140,0,6
2,2406,2483,-77,0,226,0,6
2,2382,2468,-86,0,464,0,6
2,2502,2410,92,0,43,0,6
2,2455,2471,-16,0,359,1,6
2,2775,2832,-57,0,315,0,6
2,2419,2418,1,0,200,0,6
2,2424,2406,18,0,0,1,6
2,2459,2469,-10,0,131,0,6
2,2389,2741,-352,0,302,0,6
2,2440,2350,90,0,263,1,6
2,2480,2293,187,0,327,0,6
2,2432,2441,-9,0,453,0,6
2,2252,2406,-154,0,101,0,6
2,2530,2558,-28,0,132,1,6
2,2573,2582,-9,0,355,0,6
2,2460,2646,-186,0,107,0,6
2,2517,2559,-42,0,7,0,6
2,2434,2466,-32,0,312,0,6
2,2545,2674,-129,0,100,0,6
2,2460,2523,-63,0,115,0,6
2,2262,2423,-161,0,106,0,6
2,2385,2544,-159,0,327,0,6
2,2296,2423,-127,0,103,0,6
2,2500,2456,44,0,107,0,6
2,2464,2390,74,0,9,0,6
2,2390,2558,-168,0,21,0,6
2,2523,2310,213,0,251,1,6
2,2308,2626,-318,0,186,0,6
2,2404,2433,-29,0,105,1,6
2,2371,2409,-38,0,278,0,6
2,2412,2436,-24,0,5,0,6
2,2462,2351,111,0,210,0,6
2,2357,2458,-101,0,101,1,6
2,2418,2456,-38,0,345,0,6
2,2443,2591,-148,0,101,0,6
2,2381,2431,-50,0,45,0,6
2,2354,2407,-53,0,1,0,6
2,2350,2551,-201,0,47,1,6
2,2407,2586,-179,0,300,0,6
2,2422,2406,16,0,0,0,6
2,2461,2468,-7,0,20,0,6
2,2293,2422,-129,0,241,0,6
2,2632,2753,-121,0,101,0,6
2,2302,2415,-113,0,125,0,6
2,2484,2433,51,0,272,0,6
2,2210,2422,-212,0,101,0,6
2,2512,2433,79,0,45,0,6
2,2394,2464,-70,0,300,0,6
2,2350,2468,-118,0,474,0,8
2,2513,2426,87,0,38,0,6
2,2450,2707,-257,0,123,0,6
2,2249,2452,-203,0,172,0,6
2,2377,2630,-253,0,49,0,6
2,2260,2429,-169,0,106,0,6
2,2369,2601,-232,0,463,0,8
2,2401,2303,98,0,113,0,6
2,2524,2631,-107,0,241,1,6
2,2423,2509,-86,0,101,0,6
2,2587,2615,-28,0,106,0,6
2,2365,2481,-116,0,230,1,6
2,2439,2359,80,0,20,0,6
2,2411,2489,-78,0,330,0,6
2,2297,2438,-141,0,43,1,6
2,2417,2425,-8,0,492,0,6
2,2403,2279,124,0,0,0,6
2,2424,2496,-72,0,31,0,6
2,2697,2684,13,0,148,1,6
2,2401,2413,-12,0,130,0,6
2,2440,2355,85,0,278,0,6
2,2524,2492,32,0,490,0,6
2,2590,2610,-20,0,410,0,6
2,2365,2434,-69,0,61,0,6
2,2400,2364,36,0,308,1,6
2,2481,2543,-62,0,77,0,6
2,2349,2475,-126,0,0,0,6
2,2404,2581,-177,0,103,1,6
2,2372,2480,-108,0,304,0,6
2,2691,2594,97,0,190,0,6
2,2453,2405,48,0,132,0,6
2,2211,2421,-210,0,8,0,6
2,2336,2414,-78,0,45,1,6
2,2541,2641,-100,0,229,0,6
2,2419,2476,-57,0,132,0,6
2,2663,2398,265,0,310,0,6
2,2471,2379,92,0,200,0,6
2,2417,2549,-132,0,250,0,6
2,2368,2433,-65,0,204,0,6
2,2229,2426,-197,0,115,0,6
2,2335,2567,-232,0,123,0,6
2,2438,2471,-33,0,1,0,6
2,2550,2389,161,0,0,1,6
2,2235,2446,-211,0,113,0,6
2,2468,2473,-5,0,13,1,6
2,2407,2508,-101,0,113,0,6
2,2459,2324,135,0,225,1,6
2,2677,2698,-21,0,297,1,6
2,2297,2542,-245,0,150,0,8
2,2433,2299,134,0,112,0,6
2,2412,2286,126,0,5,1,6
2,2610,2619,-9,0,48,0,6
2,2424,2590,-166,0,140,0,6
2,2349,2430,-81,0,107,0,6
2,2451,2596,-145,0,22,0,6
2,2446,2427,19,0,151,0,6
2,2671,2651,20,0,115,0,6
2,2670,2623,47,0,13,0,6
2,2417,2413,4,0,20,1,6
2,2420,2432,-12,0,190,1,6
2,2395,2505,-110,0,415,0,6
2,2417,2416,1,0,302,0,6
2,2460,2459,1,0,244,0,6
2,2468,2475,-7,0,484,1,6
2,2294,2441,-147,0,250,0,6
2,2448,2526,-78,0,302,1,6
2,2378,2441,-63,0,112,0,6
2,2356,2485,-129,0,40,0,6
2,2381,2479,-98,0,1,0,6
2,2306,2488,-182,0,41,1,6
2,2531,2493,38,0,45,0,6
2,2470,2414,56,0,85,0,6
2,2340,2417,-77,0,45,0,6
2,2230,2508,-278,0,4,0,6
2,2526,2570,-44,0,115,0,6
2,2318,2415,-97,0,88,0,6
2,2446,2233,213,0,190,0,6
2,2328,2494,-166,0,120,0,6
2,2305,2458,-153,0,21,0,6
2,2587,2557,30,0,115,0,6
2,2448,2583,-135,0,13,0,6
2,2584,2466,118,0,330,0,6
2,2513,2304,209,0,302,0,6
2,2634,2534,100,0,398,0,6
2,2559,2457,102,0,45,1,6
2,2406,2473,-67,0,394,0,6
2,2213,2546,-333,0,331,0,6
2,2433,2366,67,0,203,0,6
2,2580,2390,190,0,43,0,6
2,2302,2490,-188,0,123,0,6
2,2354,2547,-193,0,200,0,6
2,2481,2351,130,0,305,0,6
2,2405,2375,30,0,115,0,6
2,2528,2541,-13,0,300,0,6
2,2540,2463,77,0,268,0,6
2,2620,2577,43,0,344,0,6
2,2431,2410,21,0,131,0,6
2,2401,2602,-201,0,2,0,6
2,2302,2586,-284,0,373,0,8
2,2646,2637,9,0,304,0,6
2,2424,2427,-3,0,241,0,6
2,2534,2668,-134,0,196,0,6
2,2398,2561,-163,0,304,1,6
2,2303,2471,-168,0,182,0,6
2,2455,2487,-32,0,245,1,6
2,2410,2494,-84,0,125,0,6
2,2496,2532,-36,0,123,0,6
2,2368,2501,-133,0,140,0,6
2,2539,2558,-19,0,244,0,6
2,2306,2539,-233,4,151,0,11
2,2607,2509,98,0,265,0,6
2,2447,2613,-166,0,106,0,6
2,2288,2470,-182,0,121,0,6
2,2298,2411,-113,4,150,0,18
2,2468,2316,152,0,112,0,6
2,2392,2482,-90,0,112,1,6
2,2304,2415,-111,0,144,0,6
2,2289,2465,-176,0,206,0,6
2,2371,2427,-56,0,10,1,6
2,2337,2419,-82,0,21,1,6
2,2514,2487,27,0,145,0,6
2,2464,2432,32,0,106,0,6
2,2498,2661,-163,0,115,0,6
2,2242,2535,-293,4,404,0,11
2,2468,2364,104,0,13,1,6
2,2314,2459,-145,0,302,0,6
2,2239,2569,-330,0,411,1,8
2,2414,2444,-30,0,415,1,6
2,2466,2391,75,0,400,0,6
2,2321,2474,-153,0,300,1,6
2,2590,2579,11,0,7,1,6
2,2376,2515,-139,0,101,0,6
2,2340,2412,-72,0,453,0,6
2,2569,2573,-4,0,101,0,6
2,2497,2675,-178,0,119,0,8
2,2383,2418,-35,0,212,1,6
2,2471,2545,-74,0,109,0,6
2,2632,2543,89,0,123,0,6
2,2263,2459,-196,0,310,0,6
2,2333,2453,-120,0,203,0,6
2,2395,2503,-108,0,46,0,6
2,2401,2280,121,0,12,1,6
2,2315,2409,-94,0,460,0,8
2,2438,2463,-25,0,47,0,6
2,2448,2604,-156,0,270,0,6
2,2381,2617,-236,0,45,0,6
2,2414,2542,-128,0,304,0,6
2,2553,2489,64,0,112,0,6
2,2248,2559,-311,4,374,0,10
2,2548,2466,82,0,106,1,6
2,2331,2403,-72,0,331,0,6
2,2396,2404,-8,0,115,0,6
2,2480,2581,-101,0,463,0,6
2,2373,2413,-40,0,375,0,6
2,2339,2452,-113,0,302,0,6
2,2410,2424,-14,0,112,1,6
2,2418,2366,52,0,487,1,6
2,2571,2500,71,0,250,0,6
2,2434,2630,-196,0,40,0,6
2,2370,2464,-94,0,0,0,6
2,2403,2425,-22,0,50,0,6
2,2416,2469,-53,0,45,1,6
2,2515,2609,-94,0,405,0,6
2,2598,2612,-14,0,4,0,6
2,2310,2403,-93,0,40,1,6
2,2329,2520,-191,0,101,0,6
2,2373,2409,-36,0,201,0,6
2,2518,2809,-291,0,302,0,6
2,2573,2553,20,0,394,0,6
2,2359,2482,-123,0,295,0,6
2,2304,2620,-316,0,46,0,6
2,2596,2590,6,0,0,1,6
2,2324,2423,-99,0,253,0,6
2,2407,2299,108,0,4,0,6
2,2330,2511,-181,0,40,0,6
2,2395,2409,-14,0,100,0,6
2,2441,2432,9,0,410,0,6
2,2448,2261,187,0,4,1,6
2,2386,2413,-27,0,311,0,6
2,2634,2562,72,0,442,0,6
2,2575,2696,-121,0,409,0,6
2,2255,2428,-173,0,181,1,6
2,2468,2244,224,0,301,0,8
2,2518,2527,-9,0,22,0,6
2,2502,2499,3,0,242,0,6
2,2368,2403,-35,0,80,0,6
2,2389,2493,-104,0,44,0,6
2,2426,2405,21,0,303,0,6
2,2488,2415,73,0,16,0,6
2,2361,2433,-72,0,225,1,6
2,2214,2410,-196,0,118,0,6
2,2406,2572,-166,0,338,0,6
2,2475,2367,108,0,45,1,6
2,2279,2426,-147,0,45,1,6
2,2207,2468,-261,0,45,0,6
2,2299,2413,-114,0,199,0,6
2,2514,2505,9,0,167,0,6
2,2461,2517,-56,0,7,0,6
2,2762,2585,177,0,220,1,6
2,2414,2279,135,0,331,0,6
2,2393,2566,-173,0,304,1,6
2,2496,2350,146,0,300,0,6
2,2399,2440,-41,0,246,1,6
2,2462,2471,-9,0,102,0,6
2,2584,2521,63,0,58,1,6
2,2403,2385,18,0,1,1,6
2,2297,2422,-125,0,487,0,5
2,2360,2562,-202,0,3,0,6
2,2462,2376,86,0,218,1,6
2,2522,2582,-60,0,0,0,6
2,2394,2405,-11,0,40,1,6
2,2366,2462,-96,0,106,0,6
2,2235,2460,-225,0,331,0,6
2,2467,2400,67,0,10,1,6
2,2219,2432,-213,0,490,1,6
2,2259,2414,-155,0,123,0,6
2,2455,2494,-39,0,45,0,6
2,2458,2423,35,0,201,0,6
2,2461,2409,52,4,34,1,11
2,2444,2520,-76,0,321,0,6
2,2578,2519,59,0,13,1,6
2,2443,2408,35,0,302,0,6
2,2398,2440,-42,0,181,0,6
2,2607,2568,39,0,247,0,6
2,2338,2516,-178,0,49,0,8
2,2266,2443,-177,0,15,0,6
2,2436,2427,9,0,122,0,8
2,2307,2411,-104,0,409,0,6
2,2352,2419,-67,0,4,0,6
2,2436,2360,76,0,4,0,6
2,2426,2367,59,0,345,1,6
2,2319,2448,-129,0,46,1,6
2,2632,2635,-3,0,167,0,6
2,2415,2416,-1,0,400,0,6
2,2463,2351,112,0,106,1,6
2,2298,2436,-138,0,226,0,6
2,2552,2527,25,0,241,0,6
2,2441,2382,59,0,252,1,6
2,2308,2441,-133,0,335,0,8
2,2471,2438,33,0,45,0,6
2,2407,2561,-154,0,486,0,6
2,2417,2319,98,0,1,0,6
2,2459,2406,53,0,302,0,6
2,2564,2476,88,0,371,1,6
2,2470,2556,-86,0,110,0,6
2,2509,2507,2,0,302,1,6
2,2551,2498,53,0,113,0,6
2,2331,2542,-211,0,46,0,6
2,2517,2621,-104,0,190,0,6
2,2406,2487,-81,0,300,1,6
2,2488,2413,75,0,337,0,6
2,2309,2454,-145,0,404,0,6
2,2562,2495,67,0,4,1,6
2,2528,2469,59,0,107,0,6
2,2370,2565,-195,0,118,0,6
2,2299,2469,-170,0,1,0,6
2,2290,2407,-117,0,344,0,6
2,2408,2399,9,0,315,0,6
2,2487,2533,-46,0,241,0,6
2,2436,2378,58,0,115,0,6
2,2679,2528,151,0,107,0,6
2,2340,2555,-215,0,153,0,6
2,2357,2476,-119,0,3,1,6
2,2422,2414,8,0,113,0,6
2,2380,2431,-51,0,302,0,6
2,2538,2294,244,0,380,0,8
2,2305,2453,-148,0,122,0,6
2,2501,2532,-31,0,410,0,6
2,2537,2444,93,0,101,1,6
2,2554,2391,163,0,241,1,6
2,2610,2657,-47,0,45,0,6
2,2402,2406,-4,0,200,0,6
2,2425,2326,99,0,45,0,6
2,2456,2312,144,0,211,0,6
2,2486,2495,-9,0,122,0,6
2,2321,2425,-104,0,132,1,6
2,2403,2386,17,0,7,1,6
2,2596,2626,-30,0,101,0,6
2,2610,2533,77,0,13,0,6
2,2372,2502,-130,0,453,0,6
2,2600,2557,43,0,43,0,6
2,2423,2417,6,0,112,0,6
2,2242,2459,-217,0,4,0,6
2,2411,2426,-15,0,9,0,6
2,2348,2484,-136,0,0,0,6
2,2361,2574,-213,0,36,0,6
2,2461,2507,-46,0,241,1,6
2,2425,2312,113,0,466,0,6
2,2298,2430,-132,0,106,0,6
2,2445,2573,-128,0,42,0,6
2,2291,2433,-142,0,384,0,6
2,2377,2402,-25,0,315,1,6
2,2498,2373,125,0,0,0,6
2,2405,2288,117,0,123,0,6
2,2392,2436,-44,0,148,0,6
2,2425,2471,-46,0,133,0,6
2,2464,2399,65,0,175,0,6
2,2258,2452,-194,0,106,0,6
2,2535,2552,-17,0,7,1,6
2,2477,2414,63,0,46,1,6
2,2351,2415,-64,0,3,1,6
2,2332,2425,-93,0,106,0,6
2,2571,2539,32,0,110,0,6
2,2381,2449,-68,0,123,0,6
2,2406,2355,51,0,52,1,6
2,2485,2443,42,0,30,0,6
2,2413,2580,-167,0,107,1,6
2,2318,2420,-102,0,53,1,6
2,2220,2450,-230,0,15,0,6
2,2418,2347,71,0,5,0,6
2,2342,2504,-162,0,201,0,6
2,2542,2597,-55,0,7,0,6
2,2319,2516,-197,0,343,1,6
2,2527,2489,38,0,225,1,6
2,2555,2454,101,0,337,1,6
2,2452,2587,-135,0,382,1,6
2,2342,2495,-153,0,4,0,6
2,2520,2529,-9,0,236,1,6
2,2371,2591,-220,0,255,0,6
2,2557,2554,3,0,255,0,6
2,2375,2432,-57,0,150,0,6
2,2361,2415,-54,0,0,1,6
2,2318,2463,-145,0,310,1,6
2,2750,2630,120,0,277,0,6
2,2416,2456,-40,0,127,1,6
2,2236,2423,-187,0,374,0,6
2,2333,2416,-83,0,106,0,6
2,2262,2407,-145,0,47,0,6
2,2475,2420,55,0,101,0,6
2,2425,2295,130,0,4,0,6
2,2338,2437,-99,0,100,0,8
2,2469,2458,11,0,409,0,6
2,2478,2364,114,0,70,0,6
2,2522,2282,240,0,152,0,6
2,2329,2420,-91,0,359,0,6
2,2349,2516,-167,0,10,0,6
2,2307,2409,-102,0,100,1,6
2,2449,2454,-5,0,135,1,6
2,2247,2567,-320,0,443,0,6
2,2417,2329,88,0,44,0,6
2,2437,2555,-118,0,40,0,6
2,2383,2446,-63,0,131,0,6
2,2408,2367,41,0,41,0,6
2,2414,2285,129,0,0,1,6
2,2562,2460,102,0,112,0,6
2,2402,2291,111,0,14,0,6
2,2439,2274,165,0,300,1,6
2,2470,2254,216,0,201,0,6
2,2533,2504,29,0,200,0,6
2,2445,2485,-40,0,8,1,6
2,2260,2449,-189,0,122,0,6
2,2325,2576,-251,0,255,1,6
2,2528,2486,42,0,41,0,6
2,2485,2562,-77,0,242,1,6
2,2375,2400,-25,0,205,0,6
2,2366,2445,-79,0,45,0,6
2,2410,2324,86,0,462,0,6
2,2303,2402,-99,0,302,0,8
2,2626,2485,141,0,248,0,6
2,2528,2463,65,0,476,0,6
2,2423,2262,161,0,41,0,8
2,2421,2423,-2,0,13,1,6
2,2424,2353,71,0,15,1,6
2,2336,2454,-118,0,123,1,6
2,2559,2538,21,0,120,0,6
2,2402,2359,43,0,192,0,6
2,2274,2439,-165,0,71,0,6
2,2416,2416,0,0,249,0,6
2,2569,2605,-36,0,101,1,6
2,2552,2478,74,0,112,0,6
2,2347,2630,-283,0,200,0,6
2,2368,2456,-88,0,244,0,6
2,2378,2443,-65,0,315,0,6
2,2456,2484,-28,0,106,1,6
2,2313,2442,-129,0,112,1,6
2,2407,2329,78,0,126,0,6
2,2390,2408,-18,0,43,0,6
2,2441,2442,-1,0,41,0,6
2,2555,2398,157,0,19,1,6
2,2577,2494,83,0,101,0,6
2,2218,2431,-213,0,202,0,6
2,2475,2456,19,0,302,0,6
2,2495,2350,145,0,331,0,6
2,2314,2492,-178,0,255,0,6
2,2248,2417,-169,0,40,0,6
2,2275,2471,-196,0,106,0,6
2,2444,2490,-46,0,148,0,6
2,2486,2639,-153,0,7,0,6
2,2317,2407,-90,0,122,1,6
2,2407,2410,-3,0,315,1,6
2,2397,2457,-60,0,201,0,6
2,2522,2517,5,0,107,0,6
2,2521,2569,-48,0,453,0,6
2,2404,2315,89,0,452,1,6
2,2444,2569,-125,0,106,0,6
2,2476,2407,69,0,184,0,6
2,2401,2297,104,0,40,0,8
2,2527,2633,-106,0,194,0,6
2,2251,2550,-299,0,45,0,6
2,2423,2439,-16,0,310,0,6
3,2309,2425,-116,0,213,0,6
3,2471,2373,98,0,13,0,6
3,2558,2549,9,0,45,0,6
3,2413,2324,89,0,0,0,6
3,2403,2322,81,0,140,0,6
3,2407,2342,65,0,406,0,6
3,2407,2480,-73,0,302,0,6
3,2352,2485,-133,0,394,0,6
3,2533,2433,100,0,154,0,6
3,2366,2472,-106,0,48,0,6
3,2563,2459,104,0,37,0,6
3,2432,2452,-20,0,310,0,6
3,2453,2363,90,0,243,0,6
3,2475,2367,108,0,107,0,6
3,2468,2695,-227,0,80,0,6
3,2399,2502,-103,0,0,0,6
3,2550,2415,135,0,121,0,6
3,2458,2470,-12,0,264,0,6
3,2520,2512,8,0,111,0,6
3,2356,2426,-70,0,103,0,6
3,2307,2402,-95,0,369,0,6
3,2419,2341,78,0,310,0,6
3,2239,2402,-163,0,106,0,6
3,2548,2424,124,0,121,0,6
3,2500,2472,28,0,324,0,6
3,2394,2465,-71,0,1,0,6
3,2374,2448,-74,0,250,0,6
3,2666,2517,149,0,115,0,6
3,2446,2419,27,0,270,0,6
3,2447,2375,72,0,265,0,6
3,2524,2663,-139,0,123,0,6
3,2516,2449,67,0,107,0,6
3,2406,2411,-5,0,131,0,6
3,2359,2464,-105,0,119,0,6
3,2418,2441,-23,0,140,0,6
3,2599,2609,-10,0,101,0,6
3,2331,2488,-157,0,4,0,6
3,2424,2388,36,0,0,0,6
3,2543,2463,80,0,114,0,6
3,2372,2442,-70,0,10,0,6
3,2463,2326,137,0,331,0,6
3,2358,2483,-125,0,7,0,6
3,2414,2487,-73,0,123,0,6
3,2471,2307,164,0,380,0,6
3,2477,2444,33,0,40,0,6
3,2505,2332,173,0,46,0,6
3,2354,2409,-55,0,45,0,6
3,2328,2417,-89,0,312,0,6
3,2409,2257,152,0,49,0,6
3,2361,2461,-100,0,132,0,6
3,2498,2572,-74,0,105,0,6
3,2571,2499,72,0,130,0,6
3,2500,2325,175,0,45,0,6
3,2407,2382,25,0,41,0,6
3,2360,2583,-223,0,101,0,6
3,2269,2477,-208,0,4,0,6
3,2477,2281,196,0,387,0,6
3,2500,2570,-70,0,105,0,6
3,2389,2520,-131,0,117,0,6
3,2256,2479,-223,0,109,0,6
3,2568,2406,162,0,336,0,6
3,2520,2364,156,0,154,0,6
3,2639,2583,56,0,101,0,6
3,2432,2483,-51,0,7,0,6
3,2429,2362,67,0,108,0,6
3,2490,2373,117,0,100,0,6
3,2482,2342,140,0,253,0,6
3,2503,2450,53,0,177,0,6
3,2400,2562,-162,0,12,0,6
3,2516,2432,84,0,311,0,6
3,2372,2493,-121,0,8,0,6
3,2278,2451,-173,0,133,0,6
3,2491,2402,89,0,101,0,6
3,2420,2448,-28,0,113,0,6
3,2448,2572,-124,0,414,0,6
3,2402,2413,-11,0,464,0,6
3,2507,2327,180,0,45,0,6
3,2441,2396,45,0,242,0,6
3,2597,2472,125,0,268,0,6
3,2570,2450,120,0,268,0,6
3,2373,2402,-29,0,312,0,6
3,2426,2223,203,0,110,0,6
3,2517,2398,119,0,139,0,6
3,2608,2658,-50,0,330,0,6
3,2302,2485,-183,0,6,0,6
3,2349,2463,-114,0,100,0,6
3,2513,2330,183,0,404,0,6
3,2418,2385,33,0,248,0,6
3,2546,2560,-14,0,151,0,6
3,2468,2390,78,0,254,0,6
3,2417,2586,-169,0,106,0,6
3,2420,2393,27,0,248,0,6
3,2489,2402,87,0,404,0,6
3,2616,2623,-7,0,8,0,6
3,2294,2442,-148,0,130,0,6
3,2396,2405,-9,0,241,0,6
3,2501,2602,-101,0,302,0,6
3,2496,2380,116,0,45,0,6
3,2366,2408,-42,0,17,0,6
3,2376,2444,-68,0,123,0,6
3,2502,2538,-36,0,45,0,6
3,2376,2457,-81,0,120,0,6
3,2361,2506,-145,0,119,0,6
3,2423,2455,-32,0,45,0,6
3,2494,2421,73,0,45,0,6
3,2372,2408,-36,0,107,0,6
3,2414,2213,201,0,4,0,6
3,2466,2490,-24,0,453,0,6
3,2588,2419,169,0,123,0,6
3,2473,2371,102,0,4,0,6
3,2486,2498,-12,0,327,0,6
3,2452,2586,-134,0,140,0,6
3,2670,2611,59,0,398,0,6
3,2424,2324,100,0,106,0,6
3,2559,2491,68,0,250,0,6
3,2419,2269,150,0,57,0,6
3,2501,2406,95,0,127,0,6
3,2413,2367,46,0,250,0,6
3,2448,2427,21,0,213,0,6
3,2479,2490,-11,0,305,0,6
3,2359,2434,-75,0,200,0,6
3,2658,2752,-94,0,300,0,6
3,2556,2381,175,0,254,0,6
3,2391,2402,-11,0,409,0,6
3,2456,2357,99,0,0,0,6
3,2553,2589,-36,0,153,0,6
3,2466,2554,-88,0,9,0,6
3,2402,2391,11,0,260,0,6
3,2429,2434,-5,0,110,0,6
3,2826,2764,62,0,288,0,6
3,2304,2402,-98,0,400,0,6
3,2585,2469,116,0,352,0,6
3,2370,2503,-133,0,385,0,6
3,2548,2370,178,0,381,0,6
3,2765,2825,-60,0,395,0,6
3,2259,2404,-145,0,310,0,8
3,2373,2479,-106,0,15,0,6
3,2468,2425,43,0,4,0,6
3,2436,2506,-70,0,151,0,6
3,2434,2429,5,0,140,0,6
3,2534,2426,108,0,190,0,6
3,2656,2622,34,0,80,0,6
3,2291,2430,-139,0,122,0,6
3,2505,2437,68,0,115,0,6
3,2763,2828,-65,0,395,0,6
3,2490,2469,21,0,50,0,6
3,2387,2400,-13,0,45,0,6
3,2449,2308,141,0,122,0,6
3,2434,2344,90,0,213,0,6
3,2400,2538,-138,0,104,0,6
3,2396,2467,-71,0,300,0,6
3,2458,2293,165,0,41,0,6
3,2459,2399,60,0,337,0,6
3,2401,2438,-37,0,277,0,6
3,2540,2518,22,0,211,0,6
3,2251,2518,-267,0,124,0,8
3,2465,2482,-17,0,216,0,6
3,2481,2489,-8,0,311,0,6
3,2413,2445,-32,0,100,0,6
3,2501,2469,32,0,300,0,6
3,2471,2397,74,0,57,0,6
3,2408,2409,-1,0,148,0,6
3,2524,2571,-47,0,313,0,6
3,2596,2494,102,0,5,0,6
3,2339,2419,-80,0,331,0,6
3,2483,2411,72,0,4,0,6
3,2417,2297,120,0,40,0,6
3,2425,2347,78,0,288,0,6
3,2461,2304,157,0,45,0,6
3,2536,2544,-8,0,455,0,6
3,2511,2329,182,0,335,0,6
3,2466,2408,58,0,265,0,6
3,2304,2436,-132,0,45,0,6
3,2393,2453,-60,0,335,0,6
3,2265,2403,-138,0,14,0,8
3,2364,2461,-97,0,120,0,6
3,2383,2429,-46,0,330,0,6
3,2442,2357,85,0,202,0,6
3,2411,2512,-101,0,103,0,6
3,2470,2460,10,0,6,0,6
3,2450,2397,53,0,101,0,6
3,2376,2457,-81,0,300,0,6
3,2476,2459,17,0,298,0,6
3,2485,2348,137,0,141,0,6
3,2433,2274,159,0,112,0,6
3,2439,2338,101,0,263,0,6
3,2453,2373,80,0,40,0,6
3,2362,2450,-88,0,301,0,6
3,2352,2424,-72,0,453,0,8
3,2482,2454,28,0,285,0,6
3,2450,2388,62,0,110,0,6
3,2430,2399,31,0,28,0,6
3,2431,2287,144,0,122,0,6
3,2473,2405,68,0,106,0,6
3,2444,2388,56,0,491,0,6
3,2422,2365,57,0,484,0,6
3,2378,2409,-31,0,0,0,6
3,2392,2408,-16,0,122,0,6
3,2699,2697,2,0,113,0,6
3,2503,2455,48,0,130,0,6
3,2440,2336,104,0,400,0,6
3,2447,2629,-182,0,40,0,6
3,2466,2395,71,0,201,0,6
3,2354,2425,-71,0,11,0,6
3,2365,2471,-106,0,45,0,6
3,2392,2422,-30,0,113,0,6
3,2480,2421,59,0,200,0,6
3,2317,2407,-90,0,331,0,6
3,2707,2697,10,0,301,0,6
3,2377,2421,-44,0,50,0,6
3,2469,2392,77,0,201,0,6
3,2417,2430,-13,0,131,0,6
3,2417,2300,117,0,4,0,6
3,2404,2483,-79,0,106,0,6
3,2381,2427,-46,0,140,0,6
3,2403,2362,41,0,15,0,6
3,2302,2458,-156,0,245,0,6
3,2514,2536,-22,0,320,0,6
3,2417,2428,-11,0,205,0,6
3,2425,2291,134,0,15,0,6
3,2514,2390,124,0,44,0,6
3,2605,2575,30,0,302,0,6
3,2442,2218,224,0,130,0,6
3,2439,2792,-353,4,313,0,11
3,2467,2382,85,0,310,0,6
3,2422,2356,66,0,9,0,8
3,2412,2537,-125,0,88,0,6
3,2410,2401,9,0,332,0,6
3,2339,2434,-95,0,1,0,6
3,2321,2581,-260,0,406,0,8
3,2430,2413,17,0,242,0,6
3,2471,2350,121,0,45,0,8
3,2465,2498,-33,0,190,0,6
3,2413,2399,14,0,101,0,6
3,2509,2386,123,0,380,0,6
3,2417,2361,56,0,101,0,5
3,2519,2504,15,0,300,0,6
3,2550,2581,-31,0,456,0,6
3,2506,2634,-128,0,300,0,6
3,2388,2458,-70,0,253,0,6
3,2509,2395,114,0,101,0,6
3,2618,2609,9,0,48,0,6
3,2404,2474,-70,0,210,0,6
3,2405,2341,64,0,203,0,6
3,2421,2202,219,0,112,0,5
3,2372,2430,-58,0,201,0,6
3,2446,2329,117,0,40,0,6
3,2322,2427,-105,0,46,0,6
3,2437,2791,-354,4,145,0,11
3,2589,2534,55,0,455,0,6
3,2472,2464,8,0,317,0,6
3,2408,2449,-41,0,45,0,6
3,2462,2309,153,0,80,0,8
3,2540,2517,23,0,80,0,6
3,2256,2418,-162,0,244,0,5
3,2540,2509,31,0,260,0,6
3,2446,2421,25,0,487,0,6
3,2476,2668,-192,0,338,0,6
3,2432,2354,78,0,20,0,8
3,2424,2469,-45,0,242,0,6
3,2544,2576,-32,0,338,0,6
3,2453,2586,-133,4,302,0,13
3,2421,2393,28,0,2,0,6
3,2463,2308,155,0,80,0,8
3,2575,2479,96,0,382,0,6
3,2421,2367,54,0,4,0,6
3,2519,2418,101,0,40,0,6
3,2545,2511,34,0,315,0,6
3,2504,2495,9,0,131,0,6
3,2311,2411,-100,0,311,0,6
3,2311,2461,-150,0,107,0,8
3,2469,2385,84,4,110,0,13
3,2391,2431,-40,0,369,0,8
3,2511,2544,-33,0,411,0,6
3,2472,2306,166,0,150,0,6
3,2406,2480,-74,0,167,0,6
3,2512,2379,133,0,17,0,6
3,2343,2457,-114,0,301,0,6
3,2631,2833,-202,0,113,0,6
3,2346,2457,-111,0,152,0,6
3,2452,2318,134,0,46,0,6
3,2481,2636,-155,0,343,0,6
3,2420,2303,117,0,8,0,6
3,2501,2425,76,0,45,0,6
3,2425,2463,-38,0,6,0,6
3,2508,2547,-39,0,302,0,6
3,2500,2577,-77,0,106,0,6
3,2405,2236,169,0,7,0,6
3,2426,2499,-73,0,131,0,6
3,2254,2407,-153,0,247,0,6
3,2502,2589,-87,0,88,0,6
3,2421,2403,18,0,265,0,6
3,2445,2462,-17,4,270,0,13
3,2608,2692,-84,0,330,0,6
3,2397,2459,-62,0,381,0,6
3,2412,2373,39,0,40,0,6
3,2452,2421,31,0,357,0,6
3,2386,2512,-126,0,4,0,6
3,2367,2407,-40,0,302,0,6
3,2453,2398,55,0,426,0,6
3,2435,2444,-9,0,389,0,6
3,2498,2393,105,0,338,0,8
3,2628,2564,64,0,3,0,6
3,2473,2530,-57,0,80,0,6
3,2594,2465,129,0,200,0,6
3,2405,2342,63,0,241,0,6
3,2410,2410,0,0,478,0,6
3,2479,2330,149,0,341,0,6
3,2586,2540,46,0,106,0,6
3,2420,2383,37,0,122,0,6
3,2499,2279,220,0,412,0,6
3,2423,2477,-54,0,327,0,6
3,2462,2239,223,0,107,0,8
3,2560,2694,-134,0,380,0,6
3,2461,2446,15,4,121,0,13
3,2326,2450,-124,0,426,0,6
3,2408,2448,-40,0,207,0,6
3,2390,2421,-31,0,2,0,6
3,2502,2512,-10,0,246,0,6
3,2292,2422,-130,0,330,0,6
3,2338,2646,-308,4,297,0,18
3,2444,2374,70,0,151,0,6
3,2354,2433,-79,0,0,0,6
3,2482,2641,-159,0,40,0,6
3,2413,2458,-45,0,310,0,6
3,2703,2662,41,0,106,0,6
3,2302,2463,-161,4,293,0,13
3,2639,2692,-53,0,334,0,6
3,2443,2382,61,0,300,0,6
3,2362,2460,-98,0,101,0,6
3,2449,2622,-173,0,385,0,6
3,2428,2277,151,0,131,0,6
3,2365,2434,-69,0,41,0,6
3,2432,2402,30,0,277,0,6
3,2357,2453,-96,0,101,0,6
3,2423,2356,67,0,150,0,6
3,2347,2417,-70,0,130,0,6
3,2348,2456,-108,0,9,0,6
3,2462,2452,10,0,110,0,6
3,2509,2458,51,0,36,0,6
3,2404,2432,-28,0,46,0,6
3,2359,2464,-105,0,40,0,6
3,2479,2472,7,0,400,0,6
3,2402,2417,-15,0,43,0,6
3,2459,2435,24,0,106,0,6
3,2463,2357,106,0,190,0,8
3,2415,2456,-41,0,57,0,6
3,2439,2367,72,0,153,0,6
3,2305,2411,-106,0,12,0,6
3,2498,2334,164,0,0,0,8
3,2401,2275,126,0,136,0,6
3,2454,2418,36,0,2,0,6
3,2423,2551,-128,0,4,0,6
3,2540,2544,-4,0,302,0,6
3,2387,2423,-36,0,45,0,6
3,2639,2608,31,0,113,0,6
3,2553,2648,-95,0,40,0,6
3,2454,2367,87,0,151,0,8
3,2480,2367,113,0,470,0,6
3,2447,2288,159,0,100,0,6
3,2411,2310,101,0,0,0,6
3,2459,2582,-123,0,46,0,6
3,2447,2377,70,0,210,0,6
3,2421,2495,-74,0,42,0,6
3,2434,2369,65,0,153,0,6
3,2471,2331,140,0,140,0,6
3,2270,2518,-248,0,200,0,6
3,2468,2335,133,0,300,0,6
3,2503,2640,-137,0,344,0,6
3,2362,2451,-89,0,305,0,6
3,2659,2629,30,0,308,0,6
3,2409,2450,-41,0,337,0,6
3,2347,2400,-53,0,315,0,6
3,2255,2409,-154,0,123,0,6
3,2451,2447,4,0,246,0,6
3,2339,2468,-129,4,127,0,13
3,2571,2398,173,0,210,0,6
3,2524,2527,-3,0,131,0,6
3,2300,2419,-119,0,106,0,6
3,2486,2572,-86,0,405,0,6
3,2447,2366,81,0,267,0,6
3,2475,2397,78,0,1,0,6
3,2290,2473,-183,4,40,0,0
3,2501,2465,36,0,300,0,6
3,2515,2435,80,0,306,0,6
3,2761,2590,171,0,455,0,6
3,2313,2416,-103,0,45,0,6
3,2384,2431,-47,0,44,0,6
3,2427,2386,41,0,302,0,6
3,2231,2457,-226,0,0,0,6
3,2340,2478,-138,0,14,0,6
3,2690,2500,190,0,343,0,6
3,2347,2521,-174,0,4,0,6
3,2385,2431,-46,0,324,0,6
3,2484,2295,189,0,176,0,6
3,2473,2494,-21,0,4,0,6
3,2402,2373,29,0,0,0,6
3,2307,2561,-254,0,270,0,6
3,2610,2533,77,0,210,0,6
3,2355,2442,-87,0,246,0,6
3,2428,2291,137,0,150,0,6
3,2400,2407,-7,0,0,0,6
3,2508,2608,-100,0,491,0,6
3,2404,2402,2,0,330,0,6
3,2343,2513,-170,0,122,0,6
3,2467,2336,131,0,131,0,6
3,2456,2503,-47,0,374,0,6
3,2420,2495,-75,0,148,0,6
3,2356,2466,-110,0,101,0,6
3,2440,2324,116,4,250,0,13
3,2502,2457,45,0,4,0,6
3,2370,2445,-75,0,250,0,6
3,2510,2519,-9,0,439,0,6
3,2407,2471,-64,0,0,0,6
3,2457,2502,-45,0,4,0,6
3,2513,2234,279,0,142,0,6
3,2514,2447,67,0,13,0,6
3,2487,2553,-66,0,153,0,6
3,2374,2555,-181,0,222,0,6
3,2605,2605,0,0,101,0,6
3,2453,2313,140,0,210,0,6
3,2403,2427,-24,0,352,0,6
3,2411,2411,0,0,21,0,6
3,2607,2450,157,0,80,0,6
3,2292,2444,-152,0,106,0,6
3,2389,2509,-120,0,3,0,6
3,2486,2496,-10,0,405,0,6
3,2313,2407,-94,0,387,0,6
3,2493,2420,73,0,153,0,6
3,2641,2580,61,0,0,0,6
3,2610,2507,103,0,404,0,6
3,2588,2517,71,0,4,0,6
3,2450,2486,-36,0,10,0,6
3,2536,2467,69,0,100,0,6
3,2347,2418,-71,0,1,0,6
3,2479,2370,109,0,36,0,6
3,2466,2494,-28,0,134,0,6
3,2413,2387,26,0,372,0,6
3,2385,2560,-175,0,152,0,6
3,2410,2371,39,0,205,0,6
3,2607,2645,-38,0,40,0,6
3,2344,2505,-161,0,327,0,6
3,2355,2406,-51,0,1,0,6
3,2558,2608,-50,0,176,0,6
3,2407,2257,150,0,32,0,6
3,2445,2449,-4,0,242,0,6
3,2629,2372,257,0,125,0,6
3,2479,2395,84,0,241,0,6
3,2347,2489,-142,0,332,0,6
3,2626,2411,215,0,247,0,6
3,2467,2493,-26,0,4,0,6
3,2690,2558,132,0,336,0,6
3,2529,2491,38,0,374,0,6
3,2430,2381,49,0,7,0,6
3,2419,2445,-26,0,485,0,6
3,2433,2519,-86,0,6,0,6
3,2344,2540,-196,0,132,0,6
3,2404,2270,134,0,77,0,6
3,2407,2451,-44,0,52,0,6
3,2419,2351,68,0,466,0,6
3,2533,2489,44,0,14,0,6
3,2417,2313,104,0,1,0,6
3,2382,2429,-47,0,1,0,6
3,2537,2430,107,0,253,0,6
3,2346,2623,-277,0,312,0,6
3,2463,2273,190,0,106,0,6
3,2491,2400,91,0,268,0,6
3,2543,2444,99,0,128,0,6
3,2496,2487,9,0,241,0,6
3,2299,2499,-200,0,327,0,6
3,2279,2416,-137,0,15,0,6
3,2614,2655,-41,0,106,0,6
3,2460,2308,152,0,110,0,6
3,2502,2271,231,0,30,0,6
3,2498,2406,92,0,13,0,6
3,2432,2415,17,0,254,0,6
3,2407,2442,-35,0,40,0,6
3,2380,2536,-156,0,344,0,6
3,2409,2502,-93,0,65,0,6
3,2493,2497,-4,0,327,0,6
3,2415,2495,-80,0,46,0,6
3,2371,2477,-106,0,112,0,6
3,2410,2251,159,0,330,0,8
3,2600,2582,18,0,303,0,6
3,2420,2386,34,0,50,0,6
3,2403,2429,-26,0,484,0,6
3,2376,2561,-185,0,45,0,6
3,2412,2301,111,0,41,0,6
3,2401,2435,-34,0,114,0,6
3,2463,2273,190,0,202,0,6
3,2349,2405,-56,0,22,0,6
3,2331,2457,-126,0,45,0,6
3,2488,2618,-130,0,1,0,6
3,2496,2292,204,0,30,0,6
3,2423,2537,-114,0,40,0,6
3,2409,2435,-26,0,343,0,6
3,2437,2410,27,0,254,0,6
3,2420,2382,38,0,345,0,6
3,2407,2554,-147,0,3,0,6
3,2518,2423,95,0,245,0,6
3,2507,2484,23,0,302,0,6
3,2495,2292,203,0,4,0,6
3,2402,2430,-28,0,331,0,6
3,2461,2517,-56,0,300,0,6
3,2485,2359,126,0,249,0,6
3,2593,2606,-13,0,338,0,6
3,2567,2444,123,0,303,0,6
3,2588,2636,-48,0,40,0,6
3,2442,2349,93,0,57,0,6
3,2279,2400,-121,0,167,0,8
3,2362,2613,-251,0,43,0,6
3,2433,2503,-70,0,311,0,6
3,2510,2594,-84,0,132,0,6
3,2531,2634,-103,0,250,0,6
3,2583,2445,138,0,21,0,6
3,2408,2436,-28,0,310,0,6
3,2350,2429,-79,0,255,0,6
3,2592,2511,81,0,306,0,6
3,2402,2382,20,0,395,0,6
3,2410,2377,33,0,15,0,6
3,2439,2291,148,0,83,0,6
3,2402,2331,71,0,241,0,6
3,2522,2559,-37,0,15,0,6
3,2682,2605,77,0,9,0,6
3,2415,2320,95,0,0,0,6
3,2491,2414,77,0,16,0,6
3,2596,2442,154,0,311,0,6
3,2429,2313,116,0,331,0,6
3,2330,2421,-91,0,37,0,6
3,2518,2463,55,0,45,0,6
3,2413,2287,126,4,10,0,13
3,2302,2462,-160,0,121,0,6
3,2625,2600,25,0,2,0,6
3,2290,2440,-150,0,58,0,6
3,2448,2402,46,0,265,0,6
3,2381,2421,-40,0,129,0,6
3,2418,2422,-4,0,4,0,6
3,2426,2586,-160,0,405,0,6
3,2471,2565,-94,0,245,0,6
3,2325,2465,-140,0,142,0,6
3,2350,2482,-132,0,45,0,6
3,2327,2429,-102,0,135,0,6
3,2460,2491,-31,0,302,0,6
3,2421,2365,56,0,317,0,6
3,2446,2211,235,0,57,0,6
3,2323,2491,-168,0,112,0,6
3,2298,2474,-176,0,40,0,6
3,2411,2436,-25,0,107,0,6
3,2362,2420,-58,0,101,0,6
3,2303,2479,-176,0,312,0,6
3,2411,2424,-13,0,107,0,6
3,2447,2404,43,0,315,0,6
3,2436,2411,25,0,120,0,6
3,2391,2502,-111,0,121,0,6
3,2492,2420,72,0,45,0,6
3,2401,2276,125,0,312,0,6
3,2453,2508,-55,0,133,0,6
3,2329,2480,-151,0,469,0,6
3,2402,2367,35,0,101,0,6
3,2317,2425,-108,0,129,0,6
3,2419,2289,130,0,302,0,8
3,2515,2394,121,0,154,0,6
3,2370,2498,-128,0,46,0,6
3,2495,2560,-65,0,190,0,6
3,2518,2503,15,0,212,0,6
3,2360,2424,-64,0,129,0,6
3,2316,2416,-100,0,151,0,6
3,2471,2469,2,0,150,0,6
3,2406,2377,29,0,410,0,6
3,2417,2414,3,0,335,0,6
3,2404,2391,13,0,112,0,6
3,2415,2505,-90,0,385,0,6
3,2399,2400,-1,0,227,0,6
3,2428,2204,224,0,1,0,6
3,2414,2316,98,0,40,0,8
3,2423,2448,-25,0,426,0,6
3,2357,2406,-49,0,41,0,6
3,2454,2495,-41,0,7,0,6
3,2510,2397,113,0,45,0,6
3,2462,2500,-38,0,106,0,6
3,2665,2529,136,0,101,0,6
3,2325,2482,-157,0,310,0,6
3,2417,2214,203,0,310,0,6
3,2499,2462,37,0,40,0,6
3,2426,2495,-69,0,341,0,6
3,2467,2488,-21,0,45,0,6
3,2473,2298,175,0,31,0,6
3,2459,2416,43,0,101,0,6
3,2478,2468,10,0,311,0,6
3,2456,2494,-38,0,242,0,6
3,2423,2424,-1,0,288,0,6
3,2381,2480,-99,0,115,0,6
3,2494,2392,102,0,4,0,6
3,2436,2400,36,0,172,0,6
3,2544,2361,183,0,140,0,8
3,2440,2493,-53,0,302,0,6
3,2283,2402,-119,0,140,0,6
3,2405,2381,24,0,327,0,6
3,2588,2299,289,0,152,0,6
3,2483,2429,54,0,380,0,6
3,2434,2380,54,0,39,0,6
3,2512,2214,298,0,13,0,8
3,2427,2281,146,0,457,0,8
3,2441,2271,170,0,200,0,6
3,2305,2473,-168,0,240,0,6
3,2382,2439,-57,0,200,0,6
3,2436,2351,85,0,427,0,6
3,2459,2463,-4,0,215,0,6
3,2484,2564,-80,0,335,0,6
3,2422,2340,82,0,106,0,6
3,2601,2515,86,0,140,0,6
3,2418,2421,-3,0,205,0,6
3,2405,2433,-28,0,7,0,6
3,2444,2266,178,0,303,0,6
3,2620,2616,4,0,310,0,6
3,2493,2405,88,0,330,0,6
3,2475,2296,179,0,464,0,6
3,2503,2633,-130,0,250,0,6
3,2412,2341,71,0,131,0,6
3,2443,2419,24,0,321,0,6
3,2565,2506,59,0,109,0,6
3,2361,2407,-46,0,337,0,6
3,2431,2483,-52,0,128,0,6
3,2544,2337,207,0,40,0,6
3,2555,2631,-76,0,247,0,6
3,2406,2426,-20,0,7,0,6
3,2478,2397,81,0,6,0,6
3,2523,2212,311,0,45,0,6
3,2557,2475,82,0,120,0,6
3,2386,2407,-21,0,245,0,6
3,2456,2631,-175,0,46,0,6
3,2640,2671,-31,0,469,0,6
3,2634,2621,13,0,61,0,6
3,2426,2409,17,0,247,0,6
3,2353,2422,-69,0,406,0,6
3,2268,2517,-249,0,101,0,6
3,2492,2323,169,0,130,0,8
3,2459,2444,15,0,211,0,6
3,2395,2435,-40,0,106,0,6
3,2462,2394,68,0,11,0,6
3,2299,2732,-433,0,7,0,6
3,2304,2434,-130,0,140,0,6
3,2425,2479,-54,0,121,0,6
3,2384,2524,-140,0,200,0,6
3,2390,2474,-84,0,310,0,6
3,2366,2494,-128,0,409,0,6
3,2489,2398,91,0,101,0,8
3,2341,2453,-112,0,123,0,6
3,2361,2533,-172,0,115,0,6
3,2471,2440,31,0,58,0,6
3,2413,2409,4,0,105,0,6
3,2330,2526,-196,0,115,0,6
3,2405,2363,42,0,476,0,6
3,2600,2202,398,0,3,0,8
3,2500,2471,29,0,311,0,6
3,2411,2511,-100,0,36,0,6
3,2531,2306,225,0,343,0,6
3,2327,2411,-84,0,106,0,6
3,2368,2456,-88,0,210,0,5
3,2435,2311,124,0,410,0,6
3,2438,2336,102,0,352,0,6
3,2455,2460,-5,0,18,0,6
3,2421,2399,22,0,413,0,6
3,2394,2417,-23,0,202,0,6
3,2406,2322,84,0,122,0,6
3,2260,2403,-143,0,44,0,8
3,2268,2432,-164,0,0,0,6
3,2519,2600,-81,0,312,0,6
3,2406,2305,101,4,245,0,13
3,2520,2555,-35,0,380,0,6
3,2411,2266,145,0,57,0,6
3,2599,2521,78,0,441,0,6
3,2476,2493,-17,0,6,0,6
3,2529,2489,40,0,313,0,6
3,2419,2202,217,0,213,0,6
3,2257,2449,-192,0,331,0,6
3,2429,2353,76,0,128,0,6
3,2425,2413,12,0,110,0,6
3,2446,2260,186,0,278,0,6
3,2400,2381,19,0,144,0,6
3,2396,2441,-45,0,462,0,6
3,2753,2541,212,0,398,0,6
3,2334,2412,-78,0,81,0,6
3,2342,2437,-95,0,12,0,6
3,2361,2408,-47,0,201,0,6
3,2433,2404,29,0,200,0,6
3,2381,2419,-38,0,129,0,6
3,2412,2422,-10,0,122,0,6
3,2388,2472,-84,0,250,0,6
3,2423,2464,-41,0,80,0,6
3,2422,2437,-15,0,210,0,6
3,2362,2530,-168,0,301,0,6
3,2407,2318,89,0,110,0,6
3,2257,2449,-192,0,331,0,6
3,2445,2267,178,0,100,0,6
3,2600,2520,80,0,10,0,6
3,2463,2423,40,0,3,0,6
3,2474,2441,33,0,300,0,8
3,2524,2433,91,0,40,0,6
3,2436,2424,12,0,394,0,6
3,2301,2525,-224,0,302,0,6
3,2482,2419,63,0,4,0,6
3,2471,2401,70,0,32,0,6
3,2481,2344,137,0,148,0,6
3,2257,2450,-193,0,289,0,6
3,2512,2384,128,0,0,0,6
3,2434,2271,163,0,45,0,6
3,2514,2372,142,0,367,0,6
3,2404,2373,31,0,4,0,6
3,2447,2260,187,0,278,0,6
3,2425,2274,151,0,335,0,6
3,2550,2468,82,0,90,0,6
3,2495,2518,-23,0,311,0,6
3,2301,2482,-181,0,255,0,6
3,2414,2334,80,0,190,0,6
3,2416,2406,10,0,306,0,6
3,2348,2407,-59,0,345,0,6
3,2419,2255,164,0,200,0,6
3,2447,2275,172,0,106,0,6
3,2435,2416,19,0,133,0,6
3,2333,2409,-76,0,414,0,6
3,2404,2524,-120,0,101,0,6
3,2412,2214,198,0,190,0,6
3,2456,2283,173,0,40,0,6
3,2418,2363,55,0,50,0,6
3,2425,2476,-51,0,466,0,6
3,2388,2520,-132,0,127,0,6
3,2521,2507,14,0,4,0,6
3,2413,2290,123,0,306,0,6
3,2378,2416,-38,0,300,0,6
3,2315,2477,-162,0,292,0,8
3,2363,2426,-63,4,415,0,11
3,2492,2280,212,0,127,0,8
3,2386,2744,-358,0,303,0,6
3,2507,2521,-14,0,102,0,6
3,2424,2293,131,0,42,0,6
3,2414,2391,23,0,20,0,6
3,2410,2253,157,0,213,0,6
3,2433,2281,152,0,100,0,6
3,2739,2602,137,0,46,0,6
3,2511,2395,116,0,201,0,6
3,2461,2293,168,0,1,0,6
3,2378,2527,-149,0,48,0,6
3,2604,2737,-133,0,201,0,6
3,2443,2427,16,0,127,0,6
3,2521,2375,146,0,0,0,6
3,2419,2372,47,4,110,0,11
3,2496,2258,238,0,200,0,6
3,2433,2346,87,0,106,0,6
3,2448,2439,9,0,85,0,6
3,2404,2368,36,0,434,0,6
3,2423,2233,190,0,386,0,6
3,2522,2392,130,0,45,0,6
3,2451,2387,64,0,133,0,6
3,2435,2463,-28,0,207,0,6
3,2236,2403,-167,0,109,0,6
3,2376,2427,-51,0,300,0,6
3,2404,2370,34,0,46,0,6
3,2282,2538,-256,0,110,0,6
3,2510,2510,0,0,42,0,6
3,2353,2435,-82,0,202,0,6
3,2513,2502,11,0,0,0,6
3,2506,2639,-133,0,320,0,6
3,2489,2401,88,0,46,0,6
3,2299,2421,-122,0,16,0,6
3,2521,2526,-5,0,338,0,6
3,2292,2430,-138,0,107,0,6
3,2320,2421,-101,2,110,0,25
3,2493,2321,172,0,374,0,6
3,2430,2330,100,0,200,0,6
3,2257,2407,-150,0,0,0,6
3,2526,2522,4,0,211,0,6
3,2303,2419,-116,0,146,0,6
3,2416,2466,-50,0,400,0,6
3,2562,2530,32,0,330,0,6
3,2428,2280,148,0,4,0,6
3,2599,2634,-35,0,122,0,6
3,2502,2555,-53,0,110,0,6
3,2572,2752,-180,0,335,0,6
3,2565,2647,-82,0,289,0,6
3,2610,2553,57,0,409,0,6
3,2425,2327,98,0,200,0,6
3,2421,2261,160,0,331,0,6
3,2432,2368,64,0,411,0,6
3,2382,2538,-156,0,1,0,6
3,2536,2459,77,0,96,0,6
3,2271,2428,-157,0,0,0,6
3,2375,2465,-90,0,45,0,6
3,2333,2512,-179,0,315,0,6
3,2446,2289,157,0,380,0,6
3,2520,2528,-8,0,40,0,6
3,2385,2443,-58,0,300,0,6
3,2373,2490,-117,0,202,0,6
3,2453,2661,-208,0,345,0,6
3,2367,2444,-77,0,264,0,6
3,2339,2435,-96,0,5,0,6
3,2509,2470,39,0,302,0,6
3,2515,2533,-18,0,301,0,6
3,2400,2277,123,0,15,0,6
3,2474,2321,153,0,300,0,6
3,2418,2443,-25,0,40,0,6
3,2633,2533,100,0,118,0,6
3,2419,2291,128,0,405,0,6
3,2530,2567,-37,0,9,0,6
3,2489,2392,97,0,317,0,6
3,2411,2255,156,0,101,0,6
3,2566,2483,83,0,247,0,6
3,2411,2465,-54,0,466,0,6
3,2412,2447,-35,0,106,0,6
3,2729,2580,149,0,48,0,6
3,2427,2357,70,0,337,0,6
3,2483,2428,55,0,43,0,6
3,2433,2391,42,0,45,0,6
3,2579,2565,14,0,110,0,6
3,2311,2472,-161,4,131,0,13
3,2414,2489,-75,0,330,0,6
3,2390,2442,-52,0,40,0,6
3,2519,2531,-12,0,41,0,6
3,2519,2440,79,0,313,0,6
3,2531,2675,-144,0,244,0,6
3,2383,2455,-72,0,341,0,6
3,2413,2425,-12,0,277,0,6
3,2459,2283,176,0,373,0,6
3,2431,2375,56,0,172,0,6
3,2434,2406,28,0,49,0,6
3,2360,2480,-120,0,245,0,6
3,2403,2329,74,0,43,0,6
3,2675,2751,-76,0,254,0,6
3,2569,2455,114,0,100,0,6
3,2506,2570,-64,0,302,0,6
3,2222,2424,-202,0,190,0,6
3,2421,2334,87,0,101,0,6
3,2252,2415,-163,0,49,0,6
3,2567,2750,-183,0,106,0,6
3,2523,2680,-157,0,14,0,6
3,2452,2520,-68,0,140,0,6
3,2403,2250,153,0,200,0,6
3,2406,2285,121,0,300,0,6
3,2454,2304,150,0,0,0,6
3,2499,2395,104,0,112,0,6
3,2450,2603,-153,0,345,0,6
3,2415,2479,-64,0,101,0,6
3,2600,2650,-50,0,387,0,6
3,2336,2436,-100,0,38,0,6
3,2332,2413,-81,0,40,0,6
3,2469,2373,96,4,101,0,11
3,2585,2500,85,0,331,0,6
3,2573,2402,171,0,250,0,6
3,2649,2570,79,0,101,0,6
3,2672,2513,159,0,415,0,6
3,2459,2399,60,0,115,0,6
3,2463,2406,57,0,45,0,6
3,2445,2333,112,0,39,0,6
3,2386,2478,-92,0,16,0,6
3,2416,2208,208,0,15,0,6
3,2517,2550,-33,0,313,0,6
3,2480,2386,94,0,331,0,6
3,2367,2422,-55,0,297,0,6
3,2470,2289,181,4,46,0,0
3,2403,2329,74,0,13,0,6
3,2560,2582,-22,0,40,0,6
3,2387,2479,-92,0,3,0,6
3,2484,2675,-191,0,345,0,6
3,2428,2410,18,0,253,0,6
3,2402,2526,-124,0,101,0,6
3,2487,2564,-77,0,380,0,6
3,2416,2435,-19,0,134,0,6
3,2431,2460,-29,0,106,0,6
3,2472,2441,31,0,47,0,6
3,2383,2405,-22,0,114,0,6
3,2409,2371,38,0,45,0,6
3,2384,2403,-19,0,414,0,6
3,2459,2409,50,0,101,0,8
3,2458,2463,-5,0,484,0,6
3,2428,2405,23,0,100,0,6
3,2460,2361,99,0,13,0,6
3,2471,2343,128,0,326,0,6
3,2520,2516,4,0,56,0,6
3,2666,2516,150,0,56,0,6
3,2346,2433,-87,0,110,0,6
3,2466,2410,56,0,152,0,6
3,2595,2409,186,0,45,0,6
3,2526,2527,-1,0,331,0,6
3,2545,2237,308,0,101,0,6
3,2890,2646,244,0,49,0,6
3,2353,2500,-147,0,40,0,6
3,2592,2664,-72,0,400,0,6
3,2650,2884,-234,0,151,0,6
3,2540,2239,301,0,101,0,6
3,2404,2454,-50,0,100,0,6
3,2455,2309,146,0,102,0,8
3,2419,2317,102,0,7,0,6
3,2518,2552,-34,0,432,0,6
3,2410,2500,-90,0,341,0,6
3,2581,2612,-31,0,461,0,6
3,2428,2406,22,0,7,0,6
3,2452,2383,69,0,45,0,6
3,2377,2418,-41,0,242,0,8
3,2595,2550,45,0,4,0,6
3,2357,2422,-65,0,110,0,6
3,2482,2445,37,0,3,0,6
3,2412,2323,89,0,40,0,6
3,2407,2276,131,0,115,0,6
3,2551,2540,11,0,457,0,6
3,2522,2373,149,0,13,0,6
3,2380,2450,-70,0,132,0,6
3,2537,2408,129,0,45,0,6
3,2454,2376,78,0,10,0,6
3,2437,2421,16,0,7,0,6
3,2441,2372,69,0,193,0,6
3,2269,2500,-231,0,304,0,6
3,2410,2555,-145,0,130,0,6
3,2622,2550,72,0,47,0,6
3,2357,2559,-202,0,211,0,8
3,2403,2407,-4,0,110,0,6
3,2413,2421,-8,0,111,0,6
3,2450,2341,109,0,4,0,6
3,2464,2400,64,0,107,0,6
3,2426,2254,172,0,90,0,6
3,2474,2342,132,0,314,0,6
3,2423,2312,111,0,241,0,6
3,2374,2414,-40,0,106,0,6
3,2429,2350,79,0,104,0,6
3,2360,2519,-159,0,3,0,6
3,2462,2208,254,0,90,0,6
3,2416,2420,-4,0,172,0,6
3,2406,2205,201,0,101,0,8
3,2337,2420,-83,0,34,0,6
3,2621,2473,148,0,112,0,6
3,2462,2526,-64,0,102,0,6
3,2575,2571,4,0,45,0,6
3,2613,2497,116,0,13,0,6
3,2494,2295,199,0,45,0,6
3,2413,2394,19,0,86,0,6
3,2328,2401,-73,0,120,0,6
3,2384,2413,-29,0,418,0,6
3,2356,2443,-87,0,15,0,6
3,2401,2211,190,0,43,0,6
3,2418,2256,162,0,41,0,6
3,2383,2436,-53,0,105,0,6
3,2403,2226,177,0,117,0,6
3,2405,2338,67,0,408,0,6
3,2517,2576,-59,0,470,0,6
3,2438,2294,144,0,28,0,6
3,2403,2266,137,0,115,0,6
3,2387,2451,-64,0,313,0,6
3,2495,2489,6,0,246,0,6
3,2440,2345,95,2,18,0,18
3,2248,2444,-196,0,300,0,6
3,2238,2508,-270,0,112,0,6
3,2576,2478,98,0,0,0,6
3,2449,2250,199,0,128,0,6
3,2480,2325,155,0,107,0,6
3,2552,2584,-32,0,461,0,6
3,2388,2433,-45,0,110,0,6
3,2583,2328,255,0,115,0,6
3,2501,2566,-65,0,101,0,6
3,2424,2265,159,0,4,0,6
3,2399,2464,-65,0,7,0,6
3,2409,2270,139,4,140,0,13
3,2395,2426,-31,0,123,0,6
3,2409,2592,-183,0,314,0,6
3,2517,2586,-69,0,40,0,6
3,2328,2686,-358,0,300,0,6
3,2421,2353,68,0,15,0,6
3,2430,2424,6,0,337,0,6
3,2629,2648,-19,0,7,0,6
3,2560,2597,-37,0,1,0,6
3,2324,2446,-122,0,45,0,6
3,2321,2406,-85,0,414,0,6
3,2438,2437,1,0,1,0,6
3,2419,2604,-185,0,312,0,6
3,2494,2515,-21,0,45,0,6
3,2327,2494,-167,0,131,0,6
3,2424,2436,-12,0,474,0,6
3,2497,2379,118,0,150,0,6
3,2335,2510,-175,0,153,0,6
3,2574,2606,-32,0,101,0,6
3,2511,2572,-61,0,15,0,6
3,2447,2603,-156,0,314,0,6
3,2425,2533,-108,0,123,0,6
3,2595,2553,42,0,260,0,6
3,2406,2367,39,0,4,0,6
3,2567,2561,6,0,101,0,6
3,2298,2428,-130,0,125,0,6
3,2512,2432,80,0,318,0,6
3,2609,2455,154,0,460,0,6
3,2355,2531,-176,0,4,0,6
3,2595,2455,140,0,265,0,6
3,2337,2476,-139,0,131,0,6
3,2458,2571,-113,0,4,0,6
3,2433,2511,-78,0,403,0,6
3,2569,2558,11,0,260,0,6
3,2342,2461,-119,0,335,0,6
3,2558,2473,85,0,0,0,6
3,2469,2555,-86,0,6,0,6
3,2591,2470,121,0,267,0,6
3,2384,2492,-108,0,106,0,6
3,2426,2436,-10,0,380,0,6
3,2324,2551,-227,0,45,0,6
3,2375,2478,-103,0,200,0,6
3,2486,2328,158,0,1,0,6
3,2475,2562,-87,0,6,0,6
3,2557,2295,262,0,0,0,6
3,2498,2548,-50,0,130,0,6
3,2403,2338,65,0,122,0,6
3,2416,2489,-73,0,115,0,6
3,2445,2376,69,0,44,0,6
3,2455,2549,-94,0,190,0,6
3,2407,2453,-46,0,112,0,6
3,2347,2419,-72,0,485,0,6
3,2488,2481,7,0,6,0,6
3,2507,2246,261,2,380,0,18
3,2406,2354,52,0,125,0,8
3,2401,2417,-16,0,315,0,6
3,2442,2594,-152,0,301,0,6
3,2452,2487,-35,0,310,0,6
3,2355,2405,-50,0,58,0,8
3,2327,2501,-174,0,282,0,6
3,2487,2580,-93,0,46,0,6
3,2475,2407,68,0,268,0,6
3,2262,2400,-138,0,106,0,6
3,2404,2356,48,0,125,0,8
3,2448,2324,124,0,118,0,6
3,2505,2486,19,0,0,0,6
3,2418,2390,28,0,10,0,6
3,2475,2585,-110,0,405,0,6
3,2569,2590,-21,0,46,0,6
3,2433,2446,-13,0,43,0,6
3,2426,2371,55,0,0,0,6
3,2370,2428,-58,0,18,0,6
3,2613,2466,147,0,130,0,6
3,2378,2420,-42,0,106,0,6
3,2376,2482,-106,0,337,0,6
3,2447,2467,-20,0,43,0,6
3,2533,2572,-39,0,110,0,6
3,2671,2441,230,0,46,0,6
3,2372,2460,-88,0,414,0,6
3,2539,2365,174,0,300,0,6
3,2587,2411,176,0,206,0,6
3,2588,2446,142,0,305,0,6
3,2429,2391,38,0,46,0,6
3,2464,2326,138,0,108,0,6
3,2351,2434,-83,0,300,0,6
3,2580,2578,2,0,49,0,6
3,2516,2521,-5,0,400,0,6
3,2746,2600,146,0,247,0,6
3,2552,2415,137,0,15,0,6
3,2306,2409,-103,0,101,0,6
3,2491,2403,88,0,27,0,6
3,2494,2331,163,0,300,0,6
3,2282,2442,-160,0,157,0,6
3,2618,2566,52,0,3,0,6
3,2507,2350,157,0,49,0,6
3,2300,2404,-104,0,120,0,6
3,2415,2304,111,0,106,0,6
3,2748,2836,-88,0,395,0,6
3,2327,2498,-171,0,210,0,6
3,2407,2277,130,0,130,0,6
3,2452,2514,-62,0,331,0,6
3,2545,2561,-16,0,136,0,6
3,2409,2257,152,0,46,0,6
3,2394,2407,-13,0,412,0,6
3,2477,2496,-19,0,140,0,6
3,2470,2337,133,0,228,0,6
3,2446,2454,-8,0,190,0,6
3,2486,2467,19,0,1,0,6
3,2592,2478,114,0,150,0,6
3,2451,2458,-7,0,426,0,6
3,2430,2380,50,0,267,0,6
3,2395,2623,-228,0,46,0,6
3,2468,2486,-18,0,10,0,6
3,2377,2452,-75,0,217,0,6
3,2397,2403,-6,0,103,0,6
3,2411,2357,54,0,45,0,6
3,2469,2449,20,0,122,0,6
3,2478,2402,76,0,267,0,6
3,2371,2443,-72,0,196,0,6
3,2477,2573,-96,0,303,0,6
3,2481,2490,-9,0,302,0,6
3,2448,2479,-31,0,102,0,6
3,2454,2450,4,0,6,0,6
3,2542,2324,218,0,403,0,8
3,2400,2450,-50,0,14,0,6
3,2311,2474,-163,0,101,0,6
3,2640,2649,-9,0,462,0,6
3,2536,2581,-45,0,101,0,6
3,2425,2266,159,0,245,0,6
3,2467,2494,-27,0,117,0,6
3,2401,2266,135,0,45,0,6
3,2415,2528,-113,0,320,0,6
3,2470,2384,86,0,153,0,6
3,2479,2366,113,0,45,0,6
3,2440,2617,-177,0,211,0,6
3,2513,2493,20,0,302,0,6
3,2505,2388,117,0,122,0,6
3,2371,2413,-42,0,25,0,6
3,2518,2507,11,0,53,0,6
3,2506,2492,14,0,10,0,6
3,2311,2437,-126,0,409,0,6
3,2393,2491,-98,0,1,0,6
3,2467,2460,7,0,311,0,6
3,2417,2447,-30,0,1,0,6
3,2507,2517,-10,0,110,0,6
3,2492,2671,-179,0,46,0,6
3,2435,2431,4,0,331,0,6
3,2587,2474,113,0,45,0,6
3,2407,2413,-6,0,242,0,6
3,2450,2347,103,0,41,0,6
3,2627,2631,-4,0,45,0,6
3,2472,2433,39,0,61,0,6
3,2418,2494,-76,0,7,0,6
3,2450,2467,-17,0,141,0,6
3,2400,2380,20,0,58,0,6
3,2431,2437,-6,0,133,0,6
3,2397,2406,-9,0,151,0,6
3,2429,2344,85,0,101,0,6
3,2444,2270,174,4,337,0,13
3,2406,2334,72,0,300,0,6
3,2444,2420,24,0,49,0,6
3,2427,2318,109,0,131,0,6
3,2537,2447,90,0,156,0,6
3,2510,2533,-23,0,123,0,6
3,2408,2405,3,0,138,0,6
3,2423,2508,-85,0,284,0,8
3,2489,2382,107,0,404,0,6
3,2406,2471,-65,0,13,0,6
3,2403,2407,-4,0,4,0,6
3,2432,2459,-27,0,122,0,6
3,2439,2433,6,0,112,0,6
3,2283,2448,-165,0,203,0,6
3,2391,2407,-16,0,250,0,6
3,2575,2474,101,0,300,0,6
3,2498,2669,-171,0,244,0,6
3,2400,2428,-28,0,398,0,6
3,2733,2706,27,0,304,0,6
3,2493,2388,105,0,112,0,6
3,2412,2383,29,0,4,0,6
3,2521,2623,-102,0,325,0,6
3,2415,2483,-68,0,242,0,6
3,2327,2419,-92,0,45,0,6
3,2539,2505,34,0,246,0,6
3,2355,2519,-164,0,140,0,6
3,2423,2375,48,0,43,0,6
3,2460,2545,-85,0,201,0,6
3,2535,2631,-96,0,106,0,6
3,2529,2427,102,0,207,0,6
3,2508,2416,92,0,5,0,6
3,2497,2466,31,0,256,0,6
3,2463,2328,135,0,106,0,5
3,2608,2582,26,0,202,0,6
3,2409,2298,111,0,207,0,6
3,2531,2531,0,0,320,0,6
3,2345,2468,-123,0,45,0,6
3,2531,2531,0,0,133,0,6
3,2465,2777,-312,0,121,0,6
3,2643,2489,154,0,405,0,6
3,2396,2423,-27,0,302,0,6
3,2298,2445,-147,0,492,0,6
3,2473,2429,44,0,395,0,6
3,2491,2640,-149,0,414,0,6
3,2414,2441,-27,0,121,0,6
3,2355,2470,-115,0,152,0,6
3,2638,2661,-23,0,372,0,6
3,2404,2487,-83,0,304,0,6
3,2463,2650,-187,0,253,0,6
3,2657,2693,-36,0,447,0,6
3,2636,2490,146,0,193,0,6
3,2661,2639,22,0,404,0,6
3,2568,2657,-89,0,255,0,6
3,2402,2355,47,0,115,0,6
3,2457,2313,144,0,45,0,5
3,2639,2661,-22,0,15,0,6
3,2392,2460,-68,0,354,0,6
3,2515,2659,-144,0,440,0,6
3,2639,2693,-54,0,487,0,6
3,2473,2581,-108,0,5,0,6
3,2490,2373,117,0,90,0,6
3,2500,2525,-25,0,57,0,6
3,2436,2334,102,0,210,0,6
3,2302,2403,-101,0,380,0,6
3,2375,2489,-114,0,114,0,6
3,2525,2500,25,0,434,0,6
3,2410,2470,-60,0,20,0,6
3,2647,2576,71,0,60,0,6
3,2440,2447,-7,0,301,0,6
3,2473,2718,-245,0,4,0,6
3,2400,2369,31,0,12,0,6
3,2417,2462,-45,0,13,0,6
3,2715,2681,34,0,4,0,6
3,2631,2636,-5,0,302,0,6
3,2372,2407,-35,0,201,0,6
3,2332,2409,-77,0,122,0,6
3,2406,2288,118,0,453,0,6
3,2282,2423,-141,0,469,0,6
3,2507,2526,-19,0,101,0,6
3,2426,2426,0,0,43,0,6
3,2319,2469,-150,0,48,0,6
3,2665,2635,30,0,325,0,6
3,2377,2440,-63,0,131,0,6
3,2444,2294,150,0,267,0,6
3,2304,2413,-109,0,260,0,6
3,2477,2528,-51,0,1,0,6
3,2421,2300,121,0,415,0,6
3,2342,2442,-100,0,331,0,6
3,2403,2397,6,0,484,0,6
3,2390,2400,-10,0,90,0,6
3,2440,2344,96,0,142,0,6
3,2633,2566,67,0,176,0,6
3,2386,2416,-30,0,483,0,6
3,2345,2439,-94,0,289,0,6
3,2437,2347,90,0,267,0,6
3,2443,2401,42,0,57,0,6
3,2348,2436,-88,0,289,0,6
3,2390,2636,-246,0,130,0,6
3,2550,2521,29,0,131,0,6
3,2424,2369,55,0,131,0,6
3,2434,2350,84,0,149,0,6
3,2507,2510,-3,0,123,0,6
3,2351,2433,-82,0,347,0,6
3,2629,2526,103,0,104,0,6
3,2676,2522,154,0,470,0,6
3,2437,2574,-137,0,301,0,6
3,2352,2432,-80,0,289,0,6
3,2638,2576,62,0,123,0,6
3,2475,2395,80,0,130,0,6
3,2328,2453,-125,0,107,0,8
3,2340,2417,-77,0,0,0,6
3,2448,2425,23,0,45,0,6
3,2430,2323,107,0,469,0,6
3,2385,2415,-30,0,40,0,6
3,2420,2390,30,0,101,0,6
3,2402,2378,24,0,45,0,6
3,2276,2411,-135,0,41,0,8
3,2630,2557,73,0,46,0,6
3,2491,2564,-73,0,153,0,6
3,2349,2415,-66,0,315,0,6
3,2392,2451,-59,0,211,0,6
3,2369,2531,-162,0,0,0,6
3,2438,2378,60,0,7,0,6
3,2420,2298,122,0,213,0,6
3,2326,2407,-81,0,4,0,6
3,2457,2434,23,0,101,0,6
3,2301,2431,-130,0,484,0,6
3,2619,2493,126,0,202,0,6
3,2386,2574,-188,0,31,0,6
3,2301,2415,-114,0,127,0,6
3,2370,2414,-44,0,200,0,6
3,2546,2535,11,0,190,0,6
3,2414,2206,208,0,302,0,6
3,2401,2540,-139,0,483,0,6
3,2359,2466,-107,0,415,0,6
3,2799,2621,178,0,0,0,6
3,2433,2500,-67,0,45,0,6
3,2494,2389,105,0,218,0,6
3,2570,2629,-59,0,110,0,6
3,2366,2428,-62,0,301,0,6
3,2453,2551,-98,0,56,0,6
3,2562,2458,104,0,227,0,6
3,2542,2512,30,0,321,0,6
3,2289,2423,-134,0,40,0,6
3,2262,2419,-157,0,315,0,6
3,2473,2370,103,0,85,0,6
3,2540,2658,-118,0,150,0,6
3,2456,2537,-81,0,187,0,6
3,2454,2441,13,0,409,0,6
3,2658,2543,115,0,385,0,6
3,2496,2350,146,0,252,0,6
3,2320,2494,-174,0,268,0,6
3,2356,2540,-184,0,201,0,6
3,2488,2391,97,0,108,0,6
3,2541,2360,181,0,202,0,6
3,2435,2455,-20,0,113,0,6
3,2366,2424,-58,0,46,0,6
3,2478,2477,1,0,460,0,6
3,2456,2446,10,0,105,0,6
3,2412,2417,-5,0,107,0,6
3,2444,2296,148,0,45,0,6
3,2429,2326,103,0,113,0,6
3,2312,2423,-111,0,354,0,6
3,2437,2215,222,0,8,0,6
3,2576,2611,-35,0,310,0,6
3,2372,2459,-87,0,0,0,6
3,2368,2524,-156,0,2,0,6
3,2369,2416,-47,0,103,0,6
3,2371,2451,-80,0,0,0,6
3,2236,2541,-305,0,43,0,6
3,2787,2669,118,0,380,0,6
3,2409,2442,-33,0,4,0,6
3,2410,2539,-129,0,12,0,6
3,2675,2785,-110,0,343,0,6
3,2357,2489,-132,0,311,0,6
3,2323,2538,-215,0,106,0,6
3,2395,2582,-187,0,345,0,8
3,2602,2670,-68,0,190,0,6
3,2388,2541,-153,0,1,0,6
3,2537,2661,-124,0,80,0,6
3,2784,2679,105,0,46,0,6
3,2472,2640,-168,0,123,0,6
3,2426,2375,51,0,107,0,6
3,2336,2426,-90,0,236,0,6
3,2437,2496,-59,0,162,0,6
3,2287,2400,-113,0,4,0,6
3,2407,2268,139,0,37,0,6
3,2415,2346,69,0,0,0,6
3,2341,2410,-69,0,245,0,6
3,2636,2702,-66,0,190,0,6
3,2499,2347,152,0,300,0,6
3,2536,2533,3,0,5,0,6
3,2530,2378,152,0,125,0,6
3,2428,2470,-42,0,242,0,6
3,2562,2377,185,0,335,0,6
3,2477,2361,116,0,251,0,6
3,2638,2470,168,0,4,0,6
3,2519,2390,129,0,4,0,6
3,2430,2383,47,0,485,0,6
3,2478,2647,-169,0,192,0,6
3,2428,2437,-9,0,455,0,6
3,2645,2480,165,0,145,0,6
3,2586,2429,157,0,267,0,6
3,2533,2393,140,0,320,0,6
3,2347,2502,-155,0,3,0,6
3,2460,2436,24,0,352,0,6
3,2663,2661,2,0,113,0,6
3,2336,2442,-106,0,106,0,6
3,2429,2471,-42,0,320,0,6
3,2428,2424,4,0,14,0,6
3,2420,2439,-19,0,75,0,6
3,2467,2474,-7,0,6,0,6
3,2441,2378,63,0,88,0,6
3,2403,2317,86,0,15,0,6
3,2365,2534,-169,0,311,0,8
3,2451,2207,244,0,201,0,6
3,2566,2483,83,0,45,0,6
3,2417,2482,-65,0,113,0,6
3,2557,2620,-63,0,112,0,6
3,2503,2543,-40,0,250,0,6
3,2632,2441,191,0,145,0,6
3,2433,2421,12,0,58,0,6
3,2668,2493,175,0,455,0,6
3,2309,2416,-107,0,40,0,6
3,2619,2595,24,0,132,0,6
3,2319,2420,-101,0,127,0,6
3,2414,2398,16,0,122,0,6
3,2666,2615,51,0,40,0,6
3,2364,2435,-71,0,247,0,6
3,2641,2642,-1,0,347,0,6
3,2565,2641,-76,0,265,0,6
3,2426,2255,171,0,44,0,6
3,2395,2514,-119,0,132,0,6
3,2446,2436,10,0,415,0,6
3,2335,2415,-80,0,45,0,6
3,2408,2345,63,0,352,0,6
3,2644,2490,154,0,103,0,6
3,2279,2417,-138,0,300,0,6
3,2365,2423,-58,0,302,0,6
3,2512,2446,66,0,208,0,6
3,2471,2386,85,0,312,0,6
3,2452,2412,40,0,310,0,6
3,2562,2571,-9,0,13,0,6
3,2511,2624,-113,0,106,0,6
3,2447,2392,55,0,110,0,6
3,2436,2418,18,0,106,0,6
3,2480,2299,181,4,350,0,13
3,2494,2384,110,0,30,0,6
3,2394,2455,-61,0,302,0,6
3,2490,2601,-111,0,148,0,6
3,2536,2542,-6,0,372,0,6
3,2377,2518,-141,0,487,0,6
3,2408,2399,9,0,45,0,6
3,2463,2395,68,0,300,0,8
3,2639,2613,26,0,310,0,6
3,2330,2443,-113,0,9,0,6
3,2516,2327,189,0,12,0,8
3,2281,2450,-169,0,140,0,6
3,2417,2444,-27,0,411,0,6
3,2371,2505,-134,0,250,0,6
3,2404,2347,57,0,302,0,6
3,2566,2628,-62,0,140,0,6
3,2406,2389,17,0,118,0,6
3,2381,2517,-136,0,48,0,6
3,2394,2409,-15,0,30,0,6
3,2474,2493,-19,0,90,0,6
3,2309,2401,-92,0,302,0,6
3,2446,2432,14,0,332,0,6
3,2560,2573,-13,0,300,0,6
3,2515,2383,132,0,305,0,6
3,2457,2219,238,0,107,0,6
3,2385,2431,-46,0,127,0,6
3,2482,2368,114,0,210,0,6
3,2388,2432,-44,0,45,0,8
3,2675,2473,202,0,6,0,6
3,2679,2496,183,0,15,0,8
3,2596,2521,75,0,10,0,6
3,2307,2501,-194,0,106,0,6
3,2506,2382,124,0,0,0,6
3,2481,2425,56,0,44,0,6
3,2457,2373,84,0,203,0,6
3,2534,2465,69,0,49,0,6
3,2280,2440,-160,0,153,0,6
3,2636,2602,34,0,57,0,6
3,2505,2384,121,0,1,0,6
3,2433,2519,-86,0,80,0,6
3,2481,2394,87,0,107,0,6
3,2447,2375,72,0,398,0,6
3,2441,2399,42,0,7,0,6
3,2266,2457,-191,0,41,0,6
3,2421,2321,100,0,192,0,6
3,2577,2586,-9,0,454,0,6
3,2512,2678,-166,0,27,0,8
3,2528,2473,55,0,463,0,6
3,2450,2384,66,0,43,0,6
3,2443,2421,22,0,0,0,6
3,2560,2379,181,0,40,0,6
3,2641,2572,69,0,448,0,6
3,2290,2411,-121,0,253,0,6
3,2471,2399,72,0,115,0,6
3,2306,2436,-130,0,487,0,6
3,2369,2442,-73,0,241,0,6
3,2424,2297,127,0,302,0,6
3,2346,2401,-55,0,35,0,6
3,2677,2389,288,0,40,0,8
3,2599,2481,118,0,109,0,8
3,2483,2498,-15,0,121,0,6
3,2541,2577,-36,0,40,0,6
3,2389,2467,-78,0,491,0,6
3,2569,2659,-90,0,270,0,6
3,2254,2405,-151,0,122,0,6
3,2408,2584,-176,0,255,0,6
3,2489,2382,107,0,10,0,6
3,2496,2522,-26,0,381,0,6
3,2428,2489,-61,0,0,0,8
3,2675,2532,143,0,485,0,8
3,2405,2466,-61,0,12,0,6
3,2326,2534,-208,0,0,0,8
3,2426,2261,165,0,136,0,6
3,2376,2424,-48,0,45,0,6
3,2450,2536,-86,0,45,0,6
3,2645,2510,135,0,38,0,6
3,2402,2355,47,0,100,0,6
3,2551,2582,-31,0,45,0,6
3,2650,2593,57,0,107,0,6
3,2395,2409,-14,0,45,0,8
3,2424,2409,15,0,106,0,6
3,2477,2539,-62,0,107,0,6
3,2414,2302,112,0,15,0,6
3,2363,2452,-89,0,107,0,6
3,2423,2360,63,0,150,0,6
3,2448,2366,82,0,267,0,6
3,2231,2428,-197,0,250,0,6
3,2461,2446,15,0,100,0,6
3,2526,2543,-17,0,302,0,6
3,2598,2531,67,0,20,0,6
3,2289,2423,-134,0,49,0,6
3,2422,2438,-16,0,249,0,6
3,2425,2261,164,0,250,0,6
3,2361,2530,-169,0,15,0,6
3,2430,2339,91,0,201,0,6
3,2454,2456,-2,0,253,0,6
3,2434,2522,-88,0,143,0,6
3,2429,2417,12,0,83,0,6
3,2409,2417,-8,0,90,0,8
3,2482,2591,-109,0,49,0,6
3,2554,2526,28,0,58,0,6
3,2456,2454,2,0,278,0,6
3,2526,2618,-92,0,118,0,6
3,2481,2589,-108,0,377,0,6
3,2407,2400,7,0,260,0,6
3,2551,2482,69,0,434,0,6
3,2401,2347,54,4,48,0,13
3,2436,2410,26,0,139,0,6
3,2325,2400,-75,0,119,0,6
3,2510,2604,-94,0,107,0,6
3,2378,2546,-168,0,45,0,6
3,2590,2590,0,0,242,0,6
3,2469,2366,103,0,1,0,6
3,2405,2259,146,0,202,0,6
3,2524,2550,-26,0,40,0,6
3,2590,2408,182,0,138,0,6
3,2441,2288,153,0,145,0,6
3,2421,2368,53,0,225,0,6
3,2423,2322,101,0,278,0,6
3,2292,2403,-111,0,116,0,6
3,2459,2507,-48,0,131,0,6
3,2488,2515,-27,0,45,0,6
3,2324,2422,-98,0,337,0,6
3,2564,2611,-47,0,125,0,6
3,2437,2426,11,0,4,0,6
3,2439,2445,-6,0,9,0,6
3,2439,2430,9,0,151,0,6
3,2410,2398,12,0,300,0,6
3,2502,2434,68,0,172,0,6
3,2450,2374,76,0,48,0,6
3,2532,2533,-1,0,338,0,6
3,2451,2294,157,0,153,0,6
3,2388,2401,-13,0,245,0,6
3,2419,2371,48,0,202,0,8
3,2462,2427,35,0,436,0,6
3,2457,2359,98,0,40,0,6
3,2424,2438,-14,0,250,0,6
3,2454,2353,101,0,277,0,6
3,2308,2452,-144,0,140,0,6
3,2278,2437,-159,0,128,0,6
3,2368,2493,-125,0,40,0,6
3,2401,2388,13,0,6,0,6
3,2432,2473,-41,0,400,0,6
3,2438,2425,13,0,280,0,6
3,2332,2413,-81,0,292,0,6
3,2659,2640,19,0,288,0,6
3,2576,2558,18,0,10,0,6
3,2403,2443,-40,0,45,0,6
3,2502,2534,-32,0,13,0,6
3,2399,2566,-167,0,434,0,6
3,2421,2391,30,0,300,0,6
3,2477,2660,-183,0,69,0,6
3,2426,2346,80,0,300,0,6
3,2635,2543,92,0,211,0,6
3,2348,2412,-64,0,337,0,6
3,2349,2465,-116,0,1,0,6
3,2410,2428,-18,0,345,0,6
3,2388,2449,-61,0,50,0,6
3,2349,2488,-139,0,311,0,6
3,2492,2517,-25,0,386,0,6
3,2523,2532,-9,0,150,0,8
3,2471,2425,46,0,405,0,6
3,2534,2243,291,0,45,0,6
3,2427,2300,127,0,100,0,6
3,2207,2539,-332,0,112,0,6
3,2649,2376,273,0,101,0,6
3,2444,2367,77,0,43,0,6
3,2663,2627,36,0,106,0,6
3,2532,2523,9,0,194,0,8
3,2429,2384,45,0,36,0,6
3,2407,2333,74,0,12,0,6
3,2557,2423,134,0,14,0,6
3,2273,2414,-141,0,302,0,6
3,2375,2437,-62,0,310,0,6
3,2499,2530,-31,0,381,0,6
3,2412,2401,11,0,415,0,6
3,2416,2455,-39,0,236,0,6
3,2421,2462,-41,0,288,0,6
3,2322,2435,-113,0,381,0,6
3,2331,2440,-109,0,302,0,10
3,2465,2416,49,0,46,0,6
3,2672,2605,67,0,173,0,6
3,2414,2304,110,0,158,0,6
3,2349,2425,-76,0,17,0,6
3,2559,2291,268,0,210,0,6
3,2534,2503,31,0,13,0,8
3,2384,2403,-19,0,152,0,6
3,2433,2324,109,0,357,0,6
3,2477,2365,112,0,141,0,6
3,2389,2449,-60,0,300,0,6
3,2421,2567,-146,0,131,0,6
3,2445,2422,23,0,200,0,6
3,2449,2389,60,0,154,0,6
3,2285,2420,-135,0,200,0,6
3,2428,2274,154,0,453,0,6
3,2567,2241,326,0,40,0,8
3,2273,2453,-180,0,122,0,6
3,2304,2427,-123,0,245,0,6
3,2468,2643,-175,0,428,0,6
3,2327,2434,-107,0,0,0,6
3,2437,2334,103,0,405,0,6
3,2504,2534,-30,0,142,0,8
3,2434,2348,86,0,404,0,6
3,2350,2428,-78,0,250,0,6
3,2505,2426,79,0,5,0,6
3,2451,2318,133,0,43,0,6
3,2575,2447,128,0,126,0,6
3,2577,2589,-12,0,156,0,6
3,2428,2412,16,0,41,0,6
3,2644,2547,97,0,464,0,6
3,2559,2476,83,0,110,0,6
3,2411,2288,123,0,8,0,6
3,2433,2515,-82,0,302,0,6
3,2312,2405,-93,0,101,0,6
3,2513,2423,90,0,300,0,6
3,2415,2368,47,0,15,0,6
3,2490,2464,26,0,302,0,6
3,2415,2293,122,0,300,0,6
3,2477,2354,123,0,45,0,6
3,2422,2477,-55,0,122,0,6
3,2445,2411,34,0,250,0,6
3,2404,2281,123,0,375,0,6
3,2425,2331,94,0,150,0,6
3,2224,2411,-187,0,107,0,6
3,2424,2452,-28,0,107,0,8
3,2489,2417,72,0,101,0,6
3,2378,2421,-43,0,10,0,6
3,2429,2508,-79,0,267,0,6
3,2534,2392,142,0,333,0,6
3,2423,2440,-17,0,15,0,6
3,2623,2629,-6,0,3,0,6
3,2549,2588,-39,0,101,0,6
3,2532,2484,48,0,225,0,6
3,2444,2349,95,0,310,0,6
3,2415,2386,29,0,43,0,8
3,2423,2465,-42,0,120,0,6
3,2610,2533,77,0,0,0,6
3,2419,2482,-63,0,380,0,6
3,2435,2336,99,0,154,0,6
3,2438,2663,-225,0,301,0,6
3,2629,2509,120,0,327,0,6
3,2520,2550,-30,0,40,0,8
3,2418,2380,38,0,81,0,6
3,2572,2507,65,0,50,0,6
3,2402,2444,-42,0,383,0,6
3,2355,2430,-75,0,374,0,6
3,2220,2403,-183,0,419,0,6
3,2431,2465,-34,0,130,0,6
3,2569,2513,56,0,341,0,6
3,2416,2405,11,0,388,0,6
3,2536,2479,57,0,225,0,6
3,2480,2535,-55,0,244,0,6
3,2408,2369,39,0,45,0,8
3,2441,2464,-23,0,124,0,6
3,2404,2411,-7,0,120,0,6
3,2463,2335,128,4,394,0,13
3,2342,2417,-75,0,45,0,6
3,2534,2481,53,0,120,0,6
3,2481,2411,70,0,13,0,6
3,2508,2357,151,0,374,0,6
3,2499,2444,55,0,45,0,6
3,2521,2494,27,0,254,0,8
3,2335,2415,-80,0,80,0,6
3,2400,2407,-7,0,45,0,6
3,2531,2415,116,0,211,0,6
3,2519,2339,180,0,247,0,6
3,2592,2468,124,0,18,0,6
3,2414,2533,-119,0,2,0,6
3,2444,2466,-22,0,474,0,6
3,2259,2478,-219,0,485,0,8
3,2411,2412,-1,0,200,0,6
3,2415,2340,75,0,101,0,8
3,2421,2259,162,0,10,0,6
3,2430,2255,175,0,49,0,6
3,2423,2467,-44,0,123,0,6
3,2446,2282,164,0,127,0,6
3,2416,2338,78,0,80,0,6
3,2539,2456,83,0,43,0,8
3,2447,2294,153,0,333,0,6
3,2415,2285,130,0,45,0,6
3,2327,2451,-124,0,102,0,6
3,2451,2443,8,0,120,0,6
3,2590,2498,92,0,41,0,6
3,2405,2343,62,0,312,0,8
3,2392,2526,-134,0,1,0,6
3,2426,2390,36,0,206,0,6
3,2425,2432,-7,0,398,0,6
3,2274,2446,-172,0,112,0,6
3,2388,2457,-69,0,107,0,6
3,2401,2409,-8,0,311,0,6
3,2405,2499,-94,0,133,0,6
3,2609,2677,-68,0,37,0,6
3,2537,2625,-88,0,211,0,6
3,2568,2544,24,0,0,0,6
3,2403,2407,-4,4,326,0,13
3,2429,2453,-24,0,256,0,6
3,2244,2406,-162,0,2,0,6
3,2540,2505,35,0,40,0,8
3,2516,2572,-56,0,43,0,6
3,2533,2577,-44,0,267,0,6
3,2410,2446,-36,0,100,0,6
3,2418,2355,63,0,46,0,6
3,2461,2465,-4,0,123,0,6
3,2400,2540,-140,0,101,0,8
3,2531,2353,178,0,405,0,8
3,2574,2534,40,0,123,0,6
3,2401,2407,-6,0,133,0,8
3,2420,2319,101,0,106,0,6
3,2499,2434,65,0,45,0,6
3,2212,2403,-191,0,4,0,6
3,2425,2276,149,0,335,0,6
3,2444,2302,142,0,40,0,6
3,2272,2466,-194,0,8,0,6
3,2548,2395,153,0,8,0,6
3,2435,2481,-46,0,140,0,6
3,2349,2419,-70,0,200,0,6
3,2541,2589,-48,0,101,0,6
3,2376,2432,-56,0,28,0,3
3,2269,2409,-140,4,300,0,13
3,2457,2468,-11,0,0,0,6
3,2462,2423,39,0,127,0,6
3,2428,2327,101,0,53,0,6
3,2494,2343,151,0,110,0,6
3,2427,2345,82,0,400,0,6
3,2591,2394,197,0,10,0,6
3,2653,2580,73,0,381,0,6
3,2436,2358,78,0,110,0,6
3,2442,2420,22,0,35,0,6
3,2610,2525,85,0,335,0,6
3,2435,2340,95,0,373,0,6
3,2273,2442,-169,0,300,0,8
3,2494,2670,-176,0,100,0,6
3,2425,2326,99,0,150,0,6
3,2397,2580,-183,0,1,0,6
3,2431,2377,54,0,289,0,3
3,2550,2539,11,0,0,0,6
3,2215,2493,-278,0,200,0,6
3,2278,2414,-136,0,330,0,6
3,2430,2444,-14,0,145,0,6
3,2223,2517,-294,0,133,0,8
3,2238,2411,-173,0,1,0,6
3,2319,2478,-159,0,45,0,6
3,2504,2520,-16,0,203,0,6
3,2442,2432,10,0,145,0,6
3,2305,2468,-163,0,122,0,6
3,2347,2488,-141,0,46,0,6
3,2378,2430,-52,0,180,0,3
3,2466,2308,158,0,210,0,6
3,2340,2428,-88,0,45,0,6
3,2613,2582,31,0,335,0,6
3,2543,2462,81,0,218,0,6
3,2415,2271,144,0,454,0,6
3,2310,2463,-153,0,122,0,6
3,2519,2519,0,0,4,0,6
3,2508,2527,-19,0,312,0,6
3,2445,2291,154,0,301,0,8
3,2636,2573,63,0,301,0,6
3,2274,2413,-139,0,200,0,6
3,2449,2327,122,0,13,0,6
3,2368,2500,-132,0,13,0,6
3,2527,2588,-61,0,101,0,6
3,2398,2459,-61,0,300,0,6
3,2523,2358,165,0,52,0,6
3,2485,2362,123,0,1,0,8
3,2427,2393,34,0,59,0,6
3,2312,2471,-159,0,1,0,6
3,2495,2393,102,0,303,0,6
3,2508,2351,157,0,426,0,6
3,2425,2560,-135,0,250,0,6
3,2262,2426,-164,0,121,0,6
3,2443,2380,63,0,110,0,6
3,2324,2450,-126,0,210,0,8
3,2365,2489,-124,0,49,0,6
3,2419,2548,-129,0,46,0,6
3,2486,2504,-18,0,308,0,8
3,2404,2496,-92,0,103,0,8
3,2502,2537,-35,0,241,0,6
3,2421,2261,160,0,100,0,8
3,2400,2455,-55,0,2,0,6
3,2354,2473,-119,0,405,0,6
3,2536,2433,103,0,0,0,6
3,2362,2490,-128,0,310,0,6
3,2414,2336,78,0,40,0,6
3,2665,2582,83,0,21,0,6
3,2401,2278,123,0,337,0,6
3,2414,2487,-73,0,202,0,6
3,2302,2456,-154,0,122,0,6
3,2262,2447,-185,0,337,0,8
3,2453,2534,-81,0,201,0,6
3,2370,2402,-32,0,110,0,6
3,2470,2382,88,0,250,0,6
3,2458,2367,91,0,0,0,6
3,2426,2315,111,0,133,0,8
3,2507,2519,-12,0,200,0,8
3,2427,2480,-53,0,145,0,6
3,2384,2469,-85,0,246,0,6
3,2422,2243,179,0,455,0,8
3,2368,2457,-89,0,81,0,6
3,2343,2432,-89,0,454,0,6
3,2492,2502,-10,0,207,0,8
3,2424,2322,102,0,110,0,8
3,2467,2405,62,0,40,0,6
3,2365,2460,-95,0,404,0,6
3,2458,2415,43,0,200,0,6
3,2486,2341,145,0,293,0,6
3,2513,2528,-15,0,255,0,6
3,2476,2322,154,0,338,0,8
3,2341,2403,-62,0,332,0,6
3,2451,2422,29,0,200,0,6
3,2299,2413,-114,0,15,0,8
3,2343,2484,-141,0,426,0,6
3,2462,2513,-51,0,302,0,6
3,2306,2432,-126,0,130,0,6
3,2460,2342,118,0,332,0,8
3,2535,2517,18,0,124,0,6
3,2423,2450,-27,0,140,0,6
3,2408,2491,-83,0,7,0,6
3,2520,2370,150,0,236,0,8
3,2484,2444,40,0,484,0,8
3,2331,2463,-132,0,15,0,6
3,2482,2346,136,0,1,0,6
3,2366,2460,-94,0,409,0,6
3,2431,2421,10,0,268,0,6
3,2324,2437,-113,0,125,0,6
3,2455,2423,32,0,49,0,6
3,2512,2311,201,0,152,0,6
3,2314,2513,-199,0,190,0,6
3,2377,2484,-107,0,264,0,6
3,2521,2579,-58,0,301,0,6
3,2342,2407,-65,0,0,0,6
3,2509,2325,184,0,128,0,6
3,2403,2546,-143,0,202,0,6
3,2413,2413,0,0,8,0,6
3,2514,2363,151,0,53,0,6
3,2435,2363,72,0,140,0,6
3,2400,2299,101,0,302,0,6
3,2473,2377,96,0,427,0,6
3,2246,2460,-214,4,46,0,13
3,2512,2417,95,0,256,0,6
3,2511,2322,189,0,43,0,6
3,2392,2521,-129,0,308,0,6
3,2487,2428,59,0,344,0,6
3,2446,2408,38,0,22,0,6
3,2519,2353,166,0,45,0,6
3,2557,2465,92,0,343,0,6
3,2399,2429,-30,0,302,0,6
3,2508,2518,-10,0,40,0,6
3,2444,2406,38,0,122,0,6
3,2443,2384,59,0,200,0,6
3,2427,2446,-19,0,45,0,6
3,2562,2343,219,0,211,0,8
3,2404,2461,-57,0,153,0,8
3,2539,2454,85,0,300,0,6
3,2413,2376,37,0,45,0,6
3,2288,2442,-154,0,0,0,6
3,2468,2548,-80,0,409,0,6
3,2656,2664,-8,0,110,0,6
3,2454,2407,47,0,40,0,6
3,2532,2465,67,0,200,0,6
3,2604,2505,99,0,145,0,6
3,2326,2440,-114,0,277,0,6
3,2522,2527,-5,0,311,0,6
3,2582,2555,27,0,334,0,6
3,2420,2505,-85,0,133,0,6
3,2440,2419,21,0,351,0,6
3,2536,2552,-16,0,130,0,6
3,2409,2411,-2,0,269,0,6
3,2435,2425,10,0,131,0,6
3,2457,2443,14,0,145,0,6
3,2455,2323,132,0,45,0,6
3,2438,2338,100,0,357,0,6
3,2443,2324,119,0,89,0,6
3,2452,2441,11,0,101,0,6
3,2434,2555,-121,0,103,0,6
3,2426,2620,-194,0,344,0,6
3,2555,2472,83,0,337,0,6
3,2424,2588,-164,0,101,0,6
3,2438,2320,118,4,476,0,13
3,2405,2481,-76,0,242,0,6
3,2360,2442,-82,0,140,0,6
3,2403,2212,191,0,140,0,6
3,2499,2445,54,0,115,0,6
3,2465,2351,114,0,140,0,8
3,2440,2629,-189,0,357,0,6
3,2518,2586,-68,0,4,0,6
3,2426,2275,151,0,4,0,6
3,2401,2660,-259,0,12,0,6
3,2414,2301,113,0,5,0,6
3,2446,2228,218,0,9,0,6
3,2413,2441,-28,0,12,0,6
3,2355,2554,-199,0,135,0,6
3,2585,2497,88,0,27,0,6
3,2482,2728,-246,0,101,0,6
3,2520,2730,-210,0,228,0,6
3,2472,2658,-186,0,330,0,6
3,2379,2442,-63,0,134,0,6
3,2656,2462,194,0,156,0,6
3,2325,2443,-118,0,4,0,6
3,2419,2372,47,0,334,0,6
3,2341,2411,-70,0,186,0,6
3,2298,2482,-184,0,278,0,6
3,2440,2388,52,0,314,0,6
3,2559,2503,56,0,49,0,6
3,2426,2257,169,0,5,0,6
3,2504,2451,53,0,310,0,6
3,2607,2242,365,0,140,0,6
3,2507,2485,22,0,132,0,6
3,2568,2349,219,0,143,0,6
3,2360,2518,-158,0,206,0,6
3,2645,2583,62,0,413,0,6
3,2211,2412,-201,0,255,0,6
3,2454,2559,-105,0,101,0,6
3,2524,2433,91,0,45,0,6
3,2573,2420,153,0,46,0,6
3,2363,2516,-153,0,206,0,6
3,2477,2371,106,0,253,0,6
3,2562,2500,62,0,49,0,6
3,2420,2363,57,0,45,0,6
3,2444,2222,222,0,123,0,6
3,2435,2350,85,0,4,0,6
3,2352,2602,-250,0,45,0,6
3,2265,2489,-224,0,301,0,6
3,2482,2629,-147,0,62,0,6
3,2562,2482,80,0,337,0,6
3,2461,2350,111,0,343,0,6
3,2660,2531,129,0,245,0,6
3,2227,2429,-202,0,40,0,6
3,2513,2366,147,0,414,0,6
3,2692,2259,433,0,57,0,6
3,2679,2425,254,0,4,0,6
3,2575,2654,-79,0,440,0,6
3,2536,2373,163,0,345,0,6
3,2377,2481,-104,0,284,0,6
3,2454,2470,-16,0,58,0,6
3,2215,2459,-244,0,302,0,6
3,2455,2386,69,0,122,0,6
3,2511,2417,94,0,46,0,6
3,2599,2412,187,0,327,0,6
3,2574,2419,155,0,325,0,6
3,2558,2462,96,0,49,0,6
3,2439,2483,-44,0,301,0,6
3,2498,2386,112,4,110,0,13
3,2240,2410,-170,0,53,0,6
3,2427,2327,100,0,46,0,6
3,2297,2429,-132,0,121,0,6
3,2319,2443,-124,0,177,0,6
3,2350,2448,-98,0,411,0,6
3,2418,2415,3,0,302,0,6
3,2460,2293,167,0,4,0,6
3,2430,2457,-27,0,5,0,6
3,2379,2415,-36,0,172,0,6
3,2482,2440,42,0,106,0,6
3,2346,2475,-129,0,125,0,6
3,2335,2573,-238,0,41,0,6
3,2503,2506,-3,0,394,0,6
3,2529,2538,-9,0,111,0,6
3,2490,2240,250,0,107,0,6
3,2624,2449,175,0,485,0,6
3,2424,2538,-114,0,7,0,6
3,2373,2419,-46,0,201,0,6
3,2236,2461,-225,0,1,0,6
3,2425,2298,127,0,40,0,6
3,2513,2363,150,0,140,0,6
3,2549,2356,193,0,400,0,6
3,2407,2595,-188,0,101,0,6
3,2433,2359,74,0,8,0,6
3,2289,2420,-131,0,43,0,6
3,2436,2440,-4,0,115,0,6
3,2339,2407,-68,0,101,0,6
3,2411,2257,154,0,354,0,6
3,2302,2441,-139,0,107,0,6
3,2281,2473,-192,0,43,0,6
3,2467,2432,35,0,337,0,6
3,2446,2500,-54,0,132,0,6
3,2375,2507,-132,0,206,0,6
3,2525,2284,241,0,106,0,6
3,2525,2280,245,0,311,0,6
3,2406,2222,184,0,9,0,6
3,2436,2392,44,0,207,0,6
3,2433,2506,-73,0,5,0,6
3,2541,2410,131,0,196,0,6
3,2506,2481,25,0,245,0,6
3,2316,2521,-205,0,211,0,6
3,2486,2546,-60,0,40,0,6
3,2439,2313,126,0,140,0,6
3,2274,2466,-192,0,216,0,6
3,2313,2402,-89,0,411,0,6
3,2466,2472,-6,0,360,0,6
3,2374,2460,-86,0,271,0,6
3,2286,2695,-409,0,3,0,6
3,2222,2419,-197,0,150,0,6
3,2440,2376,64,0,31,0,6
3,2240,2410,-170,0,268,0,6
3,2435,2303,132,0,4,0,6
3,2436,2442,-6,0,302,0,6
3,2451,2395,56,0,122,0,6
3,2423,2510,-87,0,291,0,6
3,2380,2539,-159,0,145,0,6
3,2259,2407,-148,0,1,0,6
3,2290,2720,-430,0,101,0,6
3,2437,2692,-255,0,3,0,6
3,2465,2473,-8,0,133,0,6
3,2289,2499,-210,0,43,0,6
3,2468,2309,159,0,123,0,6
3,2377,2506,-129,0,434,0,6
3,2310,2480,-170,0,324,0,6
3,2433,2569,-136,0,112,0,6
3,2682,2468,214,0,14,0,6
3,2679,2489,190,0,240,0,6
3,2432,2484,-52,0,250,0,6
3,2400,2360,40,0,46,0,6
3,2303,2508,-205,0,46,0,6
3,2378,2487,-109,0,300,0,6
3,2390,2482,-92,0,103,0,6
3,2425,2480,-55,0,45,0,6
3,2409,2336,73,0,107,0,6
3,2590,2566,24,0,200,0,6
3,2494,2202,292,0,302,0,6
3,2520,2210,310,0,45,0,6
3,2678,2472,206,0,152,0,6
3,2337,2408,-71,0,246,0,6
3,2448,2278,170,0,176,0,6
3,2475,2303,172,0,302,0,6
3,2354,2460,-106,0,324,0,6
3,2434,2276,158,0,100,0,6
3,2342,2516,-174,0,302,0,6
3,2670,2351,319,0,138,0,6
3,2534,2347,187,0,304,0,6
3,2440,2321,119,0,105,0,6
3,2299,2461,-162,0,302,0,6
3,2536,2350,186,0,300,0,6
3,2415,2386,29,0,315,0,6
3,2442,2485,-43,0,110,0,6
3,2244,2415,-171,0,415,0,6
3,2395,2536,-141,0,409,0,6
3,2643,2458,185,0,111,0,6
3,2435,2417,18,0,46,0,6
3,2427,2560,-133,0,302,0,6
3,2516,2518,-2,0,5,0,6
3,2456,2469,-13,0,7,0,6
3,2427,2289,138,0,157,0,8
3,2256,2528,-272,0,101,0,8
3,2442,2343,99,0,100,0,6
3,2461,2578,-117,0,485,0,6
3,2314,2486,-172,0,245,0,6
3,2439,2486,-47,0,110,0,6
3,2427,2352,75,0,130,0,6
3,2207,2546,-339,0,107,0,6
3,2268,2425,-157,0,150,0,6
3,2402,2294,108,0,140,0,6
3,2425,2353,72,0,365,0,6
3,2304,2426,-122,0,100,0,6
3,2424,2680,-256,0,210,0,6
3,2426,2367,59,0,28,0,6
3,2369,2569,-200,0,40,0,6
3,2543,2484,59,0,0,0,6
3,2566,2463,103,0,320,0,6
3,2405,2233,172,0,277,0,6
3,2638,2577,61,0,48,0,6
3,2580,2651,-71,0,211,0,6
3,2304,2480,-176,0,305,0,6
3,2410,2331,79,0,10,0,6
3,2491,2472,19,0,13,0,6
3,2560,2418,142,0,45,0,6
3,2538,2496,42,0,203,0,6
3,2496,2558,-62,0,40,0,6
3,2498,2378,120,0,10,0,6
3,2409,2418,-9,0,190,0,6
3,2578,2563,15,0,40,0,6
3,2323,2423,-100,0,112,0,8
3,2284,2571,-287,0,143,0,6
3,2484,2577,-93,0,211,0,6
3,2229,2426,-197,0,6,0,6
3,2446,2423,23,0,310,0,6
3,2400,2469,-69,0,40,0,6
3,2447,2398,49,0,112,0,6
3,2226,2415,-189,0,101,0,6
3,2645,2632,13,0,45,0,6
3,2457,2427,30,0,11,0,6
3,2398,2479,-81,0,43,0,6
3,2488,2492,-4,0,0,0,6
3,2293,2400,-107,4,487,0,13
3,2351,2467,-116,0,40,0,6
3,2447,2426,21,0,62,0,6
3,2435,2574,-139,0,106,0,6
3,2427,2401,26,0,159,0,6
3,2339,2439,-100,0,3,0,6
3,2496,2315,181,0,41,0,6
3,2467,2257,210,0,414,0,6
3,2425,2272,153,0,486,0,6
3,2427,2309,118,0,5,0,6
3,2274,2402,-128,0,187,0,6
3,2312,2440,-128,0,40,0,6
3,2403,2277,126,0,106,0,6
3,2335,2491,-156,0,288,0,6
3,2439,2204,235,0,200,0,6
3,2455,2466,-11,0,301,0,6
3,2655,2601,54,0,312,0,6
3,2306,2415,-109,0,13,0,6
3,2593,2654,-61,0,40,0,6
3,2412,2407,5,0,8,0,6
3,2706,2333,373,0,326,0,6
3,2506,2420,86,0,150,0,6
3,2594,2432,162,0,453,0,6
3,2427,2443,-16,0,106,0,6
3,2413,2408,5,0,100,0,6
3,2448,2361,87,0,345,0,6
3,2518,2405,113,0,0,0,6
3,2408,2248,160,0,8,0,6
3,2201,2433,-232,0,40,0,6
3,2418,2511,-93,0,1,0,6
3,2349,2508,-159,0,315,0,6
3,2506,2628,-122,0,17,0,6
3,2304,2426,-122,0,200,0,6
3,2456,2327,129,0,440,0,6
3,2559,2420,139,0,410,0,6
3,2439,2362,77,0,398,0,6
3,2476,2480,-4,0,115,0,6
3,2458,2564,-106,0,123,0,6
3,2562,2430,132,0,135,0,6
3,2435,2426,9,0,1,0,6
3,2354,2439,-85,0,172,0,6
3,2391,2420,-29,0,38,0,6
3,2571,2524,47,0,4,0,6
3,2558,2466,92,0,40,0,6
3,2564,2479,85,0,144,0,6
3,2438,2407,31,0,211,0,6
3,2478,2283,195,0,45,0,6
3,2294,2435,-141,0,46,0,6
3,2502,2580,-78,0,45,0,6
3,2284,2421,-137,0,57,0,6
3,2460,2389,71,0,335,0,6
3,2400,2311,89,0,103,0,6
3,2418,2444,-26,0,46,0,6
3,2487,2413,74,0,40,0,6
3,2402,2403,-1,0,333,0,6
3,2469,2591,-122,0,108,0,6
3,2382,2522,-140,0,45,0,6
3,2472,2225,247,0,121,0,7
3,2526,2482,44,0,327,0,6
3,2412,2406,6,0,121,0,6
3,2648,2576,72,0,242,0,6
3,2368,2438,-70,0,410,0,6
3,2507,2546,-39,0,277,0,6
3,2412,2516,-104,0,269,0,6
3,2523,2483,40,0,327,0,6
3,2522,2393,129,0,337,0,6
3,2465,2318,147,4,440,0,13
3,2427,2438,-11,0,4,0,6
3,2650,2611,39,0,15,0,6
3,2432,2612,-180,0,346,0,6
3,2424,2349,75,0,22,0,6
3,2223,2522,-299,0,215,0,6
3,2282,2435,-153,0,311,0,6
3,2411,2590,-179,0,490,0,6
3,2441,2237,204,0,303,0,6
3,2435,2464,-29,0,247,0,6
3,2376,2426,-50,0,265,0,6
3,2456,2466,-10,0,4,0,6
3,2552,2495,57,0,4,0,6
3,2351,2416,-65,0,113,0,6
3,2403,2410,-7,0,302,0,6
3,2550,2420,130,0,8,0,6
3,2615,2496,119,0,100,0,6
3,2477,2308,169,0,34,0,6
3,2343,2474,-131,0,45,0,6
3,2559,2502,57,0,380,0,6
3,2336,2456,-120,0,122,0,6
3,2512,2615,-103,0,1,0,6
3,2298,2465,-167,4,122,0,13
3,2339,2485,-146,0,16,0,6
3,2574,2623,-49,0,80,0,6
3,2622,2575,47,0,3,0,6
3,2451,2262,189,0,107,0,6
3,2493,2418,75,0,288,0,6
3,2426,2485,-59,0,311,0,6
3,2676,2621,55,0,40,0,6
3,2466,2402,64,0,5,0,6
3,2550,2501,49,0,100,0,6
3,2428,2571,-143,0,49,0,6
3,2502,2378,124,0,207,0,6
3,2362,2536,-174,0,107,0,6
3,2379,2404,-25,0,7,0,6
3,2584,2511,73,0,100,0,6
3,2406,2302,104,0,236,0,6
3,2405,2400,5,0,41,0,6
3,2284,2659,-375,0,125,0,6
3,2450,2371,79,0,84,0,6
3,2277,2434,-157,0,1,0,6
3,2244,2479,-235,0,40,0,8
3,2582,2547,35,0,109,0,6
3,2410,2426,-16,0,106,0,6
3,2481,2383,98,0,135,0,6
3,2359,2447,-88,0,0,0,6
3,2401,2347,54,4,8,0,13
3,2402,2505,-103,0,107,0,6
3,2294,2406,-112,0,38,0,6
3,2534,2467,67,0,28,0,6
3,2436,2293,143,0,53,0,6
3,2468,2488,-20,0,152,0,6
3,2442,2379,63,0,49,0,6
3,2585,2549,36,0,118,0,6
3,2282,2447,-165,0,132,0,6
3,2294,2400,-106,0,103,0,6
3,2297,2492,-195,0,385,0,6
3,2649,2601,48,0,405,0,6
3,2530,2499,31,0,143,0,6
3,2400,2303,97,0,41,0,6
3,2404,2299,105,0,302,0,6
3,2439,2391,48,0,81,0,6
3,2426,2567,-141,0,110,0,6
3,2461,2565,-104,0,346,0,6
3,2430,2459,-29,0,315,0,6
3,2286,2443,-157,0,373,0,6
3,2256,2517,-261,0,45,0,6
3,2431,2319,112,0,345,0,6
3,2450,2533,-83,0,455,0,6
3,2453,2509,-56,0,375,0,6
3,2444,2429,15,0,304,0,6
3,2407,2247,160,0,45,0,6
3,2444,2333,111,0,28,0,6
3,2260,2402,-142,0,13,0,6
3,2263,2510,-247,0,45,0,6
3,2460,2418,42,0,246,0,6
3,2431,2409,22,0,338,0,6
3,2393,2536,-143,0,120,0,6
3,2777,2412,365,0,405,0,6
3,2413,2331,82,0,405,0,6
3,2443,2354,89,0,341,0,6
3,2289,2442,-153,0,131,0,6
3,2536,2472,64,0,5,0,6
3,2390,2544,-154,0,110,0,6
3,2510,2534,-24,0,4,0,6
3,2424,2553,-129,0,409,0,6
3,2473,2466,7,0,7,0,6
3,2421,2380,41,0,207,0,6
3,2443,2380,63,0,244,0,6
3,2447,2267,180,0,46,0,6
3,2427,2439,-12,0,209,0,6
3,2491,2380,111,0,453,0,6
3,2424,2632,-208,0,373,0,6
3,2666,2629,37,0,277,0,6
3,2461,2377,84,0,65,0,6
3,2427,2459,-32,0,319,0,6
3,2405,2378,27,0,309,0,6
3,2619,2676,-57,0,453,0,6
3,2459,2428,31,0,310,0,6
3,2417,2512,-95,0,148,0,6
3,2506,2406,100,0,190,0,6
3,2438,2433,5,0,330,0,6
3,2326,2446,-120,0,40,0,6
3,2412,2407,5,0,123,0,6
3,2445,2367,78,0,269,0,6
3,2381,2479,-98,0,242,0,6
3,2424,2383,41,0,105,0,6
3,2564,2576,-12,0,131,0,6
3,2330,2432,-102,0,7,0,6
3,2611,2640,-29,0,39,0,6
3,2364,2445,-81,0,400,0,6
3,2404,2360,44,0,311,0,6
3,2833,2774,59,0,487,0,6
3,2399,2420,-21,0,300,0,6
3,2548,2592,-44,0,45,0,6
3,2416,2544,-128,0,46,0,8
3,2483,2435,48,0,261,0,6
3,2419,2425,-6,0,133,0,6
3,2400,2420,-20,0,300,0,6
3,2449,2295,154,0,4,0,6
3,2200,2400,-200,4,43,0,13
3,2514,2522,-8,0,106,0,6
3,2381,2491,-110,0,405,0,6
3,2439,2372,67,0,46,0,6
3,2450,2374,76,0,3,0,6
3,2450,2327,123,4,101,0,7
3,2451,2389,62,0,112,0,6
3,2567,2581,-14,0,101,0,6
3,2393,2514,-121,0,207,0,6
3,2490,2382,108,0,107,0,6
3,2643,2753,-110,0,354,0,6
3,2480,2502,-22,0,400,0,6
3,2575,2502,73,0,341,0,6
3,2430,2367,63,0,45,0,8
3,2334,2403,-69,0,81,0,6
3,2493,2514,-21,0,257,0,6
3,2653,2744,-91,0,354,0,6
3,2508,2402,106,0,50,0,6
3,2419,2451,-32,0,40,0,6
3,2441,2451,-10,0,337,0,6
3,2601,2614,-13,0,200,0,6
3,2445,2345,100,0,130,0,6
3,2637,2774,-137,0,93,0,6
3,2494,2583,-89,0,354,0,6
3,2397,2402,-5,0,107,0,6
3,2424,2632,-208,0,302,0,6
3,2408,2441,-33,0,122,0,6
3,2443,2366,77,0,242,0,6
3,2629,2567,62,0,312,0,6
3,2385,2419,-34,0,113,0,6
3,2659,2387,272,0,241,0,6
3,2530,2517,13,0,151,0,6
3,2631,2598,33,0,13,0,6
3,2636,2775,-139,0,487,0,6
3,2376,2445,-69,0,303,0,6
3,2423,2416,7,0,485,0,6
3,2457,2427,30,0,7,0,6
3,2560,2557,3,0,201,0,6
3,2386,2477,-91,0,253,0,6
3,2596,2440,156,0,386,0,6
3,2444,2377,67,0,112,0,6
3,2590,2627,-37,0,40,0,6
3,2386,2408,-22,0,5,0,6
3,2378,2443,-65,0,40,0,6
3,2334,2435,-101,0,1,0,6
3,2635,2777,-142,0,29,0,6
3,2394,2453,-59,0,0,0,6
3,2425,2432,-7,0,46,0,8
3,2589,2656,-67,0,325,0,6
3,2492,2528,-36,0,200,0,6
3,2441,2354,87,0,85,0,6
3,2622,2525,97,0,0,0,6
3,2413,2280,133,0,133,0,6
3,2775,2637,138,0,345,0,6
3,2440,2524,-84,0,160,0,6
3,2639,2773,-134,0,11,0,6
3,2333,2449,-116,0,210,0,6
3,2447,2468,-21,0,310,0,6
3,2652,2631,21,0,241,0,6
3,2429,2433,-4,0,302,0,6
3,2443,2320,123,0,4,0,6
3,2285,2440,-155,0,4,0,6
3,2466,2533,-67,0,133,0,6
3,2405,2333,72,0,5,0,6
3,2567,2488,79,0,300,0,6
3,2600,2534,66,0,125,0,6
3,2637,2774,-137,0,385,0,6
3,2430,2589,-159,0,412,0,6
3,2453,2315,138,0,268,0,6
3,2518,2383,135,0,455,0,6
3,2676,2624,52,0,6,0,6
3,2502,2438,64,0,302,0,6
3,2422,2423,-1,0,190,0,6
3,2463,2507,-44,0,405,0,6
3,2423,2323,100,0,122,0,6
3,2625,2539,86,0,300,0,6
3,2555,2582,-27,0,306,0,6
3,2336,2470,-134,0,4,0,6
3,2512,2461,51,0,201,0,6
3,2465,2369,96,0,2,0,6
3,2470,2540,-70,0,153,0,6
3,2664,2658,6,0,366,0,6
3,2345,2434,-89,0,1,0,6
3,2434,2439,-5,0,133,0,6
3,2420,2432,-12,0,190,0,6
3,2408,2343,65,0,15,0,6
3,2442,2372,70,0,190,0,6
3,2431,2445,-14,0,241,0,6
3,2429,2273,156,0,113,0,8
3,2239,2417,-178,0,200,0,8
3,2345,2400,-55,0,14,0,6
3,2421,2377,44,0,101,0,6
3,2528,2461,67,0,201,0,6
3,2401,2365,36,0,211,0,6
3,2417,2390,27,4,310,0,13
3,2559,2517,42,0,15,0,6
3,2403,2492,-89,0,101,0,6
3,2649,2656,-7,0,175,0,6
3,2498,2557,-59,0,300,0,6
3,2549,2483,66,0,474,0,6
3,2562,2442,120,0,130,0,6
3,2552,2501,51,0,45,0,6
3,2239,2425,-186,0,46,0,6
3,2305,2431,-126,0,202,0,6
3,2451,2408,43,0,6,0,6
3,2457,2367,90,0,306,0,6
3,2415,2409,6,0,106,0,6
3,2404,2434,-30,0,40,0,6
3,2355,2415,-60,0,325,0,6
3,2315,2461,-146,0,344,0,6
3,2408,2201,207,0,152,0,6
3,2402,2212,190,0,338,0,3
3,2425,2385,40,0,1,0,6
3,2276,2434,-158,0,112,0,6
3,2587,2525,62,0,409,0,6
3,2558,2451,107,0,302,0,6
3,2442,2392,50,0,136,0,6
3,2479,2341,138,4,301,0,13
3,2316,2403,-87,0,108,0,6
3,2399,2404,-5,0,386,0,3
3,2676,2588,88,0,123,0,6
3,2439,2470,-31,0,141,0,6
3,2366,2529,-163,0,116,0,6
3,2407,2399,8,0,112,0,3
3,2502,2559,-57,0,399,0,6
3,2523,2383,140,0,1,0,6
3,2486,2483,3,0,426,0,6
3,2369,2419,-50,0,453,0,6
3,2430,2262,168,0,140,0,6
3,2337,2400,-63,0,464,0,6
3,2310,2486,-176,0,152,0,6
3,2340,2456,-116,0,110,0,6
3,2417,2478,-61,0,110,0,6
3,2451,2205,246,0,1,0,6
3,2714,2559,155,0,466,0,6
3,2235,2400,-165,0,113,0,6
3,2474,2506,-32,0,440,0,6
3,2474,2453,21,0,110,0,6
3,2456,2440,16,0,45,0,6
3,2479,2355,124,0,300,0,6
3,2411,2319,92,4,353,0,13
3,2200,2580,-380,0,49,0,6
3,2422,2477,-55,0,113,0,6
3,2397,2528,-131,0,2,0,6
3,2476,2339,137,0,400,0,6
3,2434,2400,34,0,101,0,6
3,2469,2497,-28,0,405,0,6
3,2307,2410,-103,0,21,0,6
3,2384,2528,-144,0,424,0,6
3,2418,2304,114,0,40,0,6
3,2319,2444,-125,0,41,0,6
3,2530,2411,119,0,415,0,6
3,2362,2431,-69,0,30,0,6
3,2322,2437,-115,0,52,0,8
3,2392,2517,-125,0,2,0,6
3,2571,2551,20,0,463,0,6
3,2316,2453,-137,0,13,0,6
3,2476,2306,170,0,206,0,6
3,2489,2412,77,0,0,0,6
3,2315,2413,-98,0,190,0,6
3,2516,2363,153,0,201,0,6
3,2423,2390,33,0,122,0,6
3,2411,2423,-12,0,46,0,6
3,2296,2430,-134,0,102,0,6
3,2323,2410,-87,0,245,0,6
3,2390,2443,-53,0,347,0,6
3,2555,2589,-34,0,4,0,6
3,2588,2621,-33,0,300,0,6
3,2437,2483,-46,0,4,0,6
3,2380,2414,-34,4,43,0,13
3,2529,2574,-45,0,107,0,6
3,2577,2652,-75,0,278,0,6
3,2341,2489,-148,0,392,0,6
3,2445,2366,79,0,55,0,6
3,2438,2267,171,0,414,0,6
3,2449,2364,85,0,4,0,6
3,2365,2432,-67,0,490,0,6
3,2475,2432,43,0,2,0,6
3,2438,2454,-16,0,140,0,6
3,2462,2405,57,0,40,0,6
3,2467,2388,79,0,197,0,6
3,2434,2370,64,0,105,0,6
3,2390,2466,-76,0,101,0,6
3,2474,2402,72,0,3,0,6
3,2414,2399,15,0,251,0,6
3,2433,2484,-51,0,302,0,6
3,2437,2259,178,0,211,0,6
3,2361,2537,-176,0,1,0,6
3,2697,2488,209,0,405,0,6
3,2481,2322,159,0,315,0,6
3,2657,2661,-4,0,106,0,6
3,2565,2528,37,0,241,0,6
3,2483,2547,-64,0,106,0,9
3,2295,2410,-115,0,123,0,6
3,2431,2360,71,0,127,0,6
3,2545,2467,78,0,80,0,6
3,2536,2561,-25,0,373,0,6
3,2336,2432,-96,0,111,0,6
3,2206,2476,-270,0,50,0,6
3,2489,2326,163,0,217,0,6
3,2518,2431,87,0,45,0,6
3,2672,2646,26,0,141,0,6
3,2564,2697,-133,0,118,0,6
3,2499,2238,261,0,4,0,6
3,2296,2539,-243,0,112,0,6
3,2516,2510,6,0,40,0,6
3,2448,2446,2,0,325,0,6
3,2252,2407,-155,0,200,0,6
3,2245,2496,-251,0,267,0,6
3,2466,2284,182,0,337,0,6
3,2456,2424,32,0,4,0,6
3,2579,2535,44,0,256,0,6
3,2478,2411,67,0,345,0,6
3,2475,2293,182,0,22,0,6
3,2696,2315,381,0,354,0,6
3,2255,2570,-315,0,152,0,6
3,2523,2516,7,0,341,0,6
3,2466,2453,13,0,338,0,6
3,2467,2434,33,0,4,0,6
3,2560,2594,-34,0,112,0,6
3,2510,2514,-4,0,4,0,6
3,2560,2368,192,0,11,0,6
3,2476,2305,171,0,151,0,6
3,2335,2465,-130,0,4,0,6
3,2581,2413,168,0,58,0,6
3,2542,2486,56,0,20,0,6
3,2459,2435,24,0,200,0,6
3,2579,2618,-39,0,80,0,6
3,2615,2479,136,0,120,0,6
3,2487,2541,-54,0,130,0,6
3,2424,2424,0,0,324,0,6
3,2359,2432,-73,0,315,0,6
3,2284,2460,-176,0,40,0,6
3,2536,2454,82,0,148,0,6
3,2572,2463,109,0,59,0,6
3,2472,2491,-19,4,110,0,11
3,2467,2440,27,0,196,0,6
3,2419,2265,154,0,0,0,6
3,2423,2428,-5,0,327,0,6
3,2502,2540,-38,0,115,0,6
3,2463,2429,34,0,115,0,6
3,2466,2460,6,0,278,0,6
3,2603,2611,-8,0,409,0,6
3,2351,2429,-78,0,104,0,6
3,2413,2485,-72,0,380,0,6
3,2403,2364,39,0,41,0,6
3,2530,2476,54,0,265,0,6
3,2403,2415,-12,0,200,0,6
3,2430,2282,148,0,80,0,6
3,2457,2618,-161,0,0,0,6
3,2451,2354,97,0,202,0,6
3,2584,2576,8,0,15,0,6
3,2616,2460,156,0,138,0,6
3,2523,2439,84,0,15,0,6
3,2415,2363,52,0,373,0,6
3,2315,2437,-122,0,4,0,6
3,2448,2460,-12,0,40,0,6
3,2487,2473,14,4,373,0,11
3,2240,2423,-183,4,373,0,13
3,2385,2401,-16,0,61,0,6
3,2455,2306,149,0,191,0,6
3,2471,2529,-58,0,106,0,6
3,2477,2541,-64,0,112,0,6
3,2529,2452,77,0,4,0,6
3,2548,2570,-22,0,15,0,6
3,2401,2286,115,4,18,0,13
3,2415,2321,94,0,106,0,6
3,2494,2526,-32,0,46,0,6
3,2528,2407,121,0,302,0,6
3,2383,2459,-76,0,140,0,6
3,2466,2430,36,0,110,0,6
3,2516,2595,-79,0,337,0,6
3,2318,2467,-149,0,45,0,6
3,2526,2526,0,0,162,0,6
3,2533,2548,-15,0,16,0,6
3,2277,2419,-142,4,36,0,13
3,2521,2316,205,0,5,0,8
3,2426,2286,140,0,127,0,6
3,2437,2424,13,0,243,0,6
3,2524,2423,101,0,101,0,6
3,2272,2423,-151,0,254,0,6
3,2555,2466,89,0,4,0,6
3,2384,2485,-101,0,106,0,6
3,2400,2296,104,0,13,0,6
3,2572,2486,86,0,341,0,6
3,2519,2396,123,0,330,0,6
3,2329,2584,-255,0,80,0,8
3,2580,2571,9,0,487,0,6
3,2404,2322,82,0,45,0,8
3,2317,2413,-96,4,227,0,13
3,2376,2445,-69,0,40,0,6
3,2432,2316,116,0,135,0,6
3,2424,2461,-37,0,105,0,6
3,2372,2506,-134,0,303,0,6
3,2458,2403,55,0,8,0,6
3,2414,2400,14,0,205,0,6
3,2356,2521,-165,0,315,0,8
3,2586,2384,202,0,50,0,6
3,2430,2432,-2,0,105,0,6
3,2407,2277,130,0,46,0,6
3,2362,2427,-65,0,46,0,6
3,2608,2597,11,0,194,0,6
3,2526,2460,66,0,130,0,6
3,2432,2430,2,0,28,0,6
3,2528,2327,201,0,8,0,8
3,2410,2351,59,0,373,0,6
3,2430,2438,-8,0,241,0,6
3,2364,2421,-57,0,194,0,6
3,2352,2583,-231,0,151,0,6
3,2314,2447,-133,0,245,0,6
3,2428,2310,118,0,14,0,6
3,2470,2501,-31,0,330,0,6
3,2449,2333,116,0,16,0,6
3,2335,2448,-113,0,190,0,6
3,2379,2422,-43,0,130,0,6
3,2416,2376,40,0,211,0,6
3,2275,2491,-216,0,454,0,8
3,2403,2243,160,4,45,0,13
3,2540,2401,139,0,90,0,6
3,2533,2485,48,0,246,0,6
3,2521,2468,53,0,311,0,6
3,2432,2449,-17,0,190,0,6
3,2308,2457,-149,4,101,0,13
3,2457,2425,32,0,107,0,6
3,2436,2353,83,0,42,0,6
3,2332,2450,-118,0,143,0,6
3,2453,2312,141,4,40,0,13
3,2379,2469,-90,0,312,0,3
3,2496,2445,51,0,31,0,6
3,2567,2509,58,0,320,0,6
3,2384,2450,-66,0,41,0,6
3,2505,2402,103,0,4,0,6
3,2609,2570,39,0,130,0,6
3,2428,2484,-56,0,267,0,6
3,2468,2381,87,0,345,0,3
3,2336,2401,-65,0,110,0,6
3,2382,2466,-84,0,250,0,3
3,2331,2423,-92,0,112,0,6
3,2412,2371,41,0,326,0,6
3,2540,2636,-96,0,110,0,6
3,2247,2454,-207,0,40,0,8
3,2430,2484,-54,0,267,0,6
3,2441,2440,1,0,127,0,6
3,2575,2598,-23,0,405,0,6
3,2504,2394,110,0,323,0,6
3,2384,2465,-81,0,343,0,3
3,2432,2372,60,0,106,0,6
3,2410,2345,65,0,8,0,8
3,2495,2508,-13,0,49,0,6
3,2308,2421,-113,0,120,0,6
3,2498,2421,77,0,49,0,6
3,2407,2299,108,0,405,0,6
3,2370,2406,-36,0,331,0,6
3,2446,2385,61,0,285,0,6
3,2485,2624,-139,0,113,0,6
3,2464,2303,161,0,115,0,6
3,2428,2480,-52,0,267,0,6
3,2483,2358,125,0,22,0,6
3,2479,2481,-2,0,131,0,6
3,2433,2481,-48,0,43,0,6
3,2504,2487,17,0,251,0,6
3,2417,2437,-20,0,327,0,6
3,2712,2659,53,0,40,0,6
3,2464,2385,79,0,345,0,3
3,2508,2528,-20,0,302,0,6
3,2485,2369,116,0,35,0,6
3,2501,2359,142,0,400,0,6
3,2386,2462,-76,0,250,0,3
3,2421,2299,122,0,157,0,6
3,2228,2434,-206,0,5,0,6
3,2476,2575,-99,0,144,0,6
3,2497,2436,61,0,45,0,6
3,2410,2322,88,4,117,0,13
3,2403,2487,-84,0,46,0,6
3,2204,2567,-363,0,404,0,6
3,2404,2366,38,0,307,0,6
3,2544,2212,332,0,354,0,6
3,2448,2539,-91,0,41,0,6
3,2575,2435,140,0,190,0,6
3,2461,2388,73,0,250,0,3
3,2426,2241,185,0,302,0,6
3,2460,2464,-4,0,0,0,6
3,2425,2427,-2,0,250,0,6
3,2518,2517,1,0,311,0,6
3,2568,2608,-40,0,373,0,6
3,2499,2570,-71,0,211,0,6
3,2403,2419,-16,0,145,0,6
3,2463,2478,-15,0,130,0,6
3,2573,2238,335,0,133,0,6
3,2413,2416,-3,0,145,0,6
3,2548,2212,336,0,190,0,6
3,2298,2445,-147,0,167,0,6
3,2501,2500,1,0,21,0,6
3,2385,2430,-45,0,302,0,6
3,2402,2232,170,0,1,0,6
3,2448,2549,-101,0,4,0,6
3,2402,2388,14,0,476,0,6
3,2507,2415,92,0,2,0,6
3,2467,2456,11,0,200,0,8
3,2424,2334,90,0,242,0,6
3,2575,2485,90,0,200,0,6
3,2444,2386,58,0,474,0,6
3,2450,2457,-7,0,354,0,6
3,2443,2431,12,0,110,0,6
3,2518,2428,90,0,406,0,6
3,2411,2336,75,0,300,0,6
3,2310,2406,-96,0,110,0,6
3,2411,2350,61,0,52,0,6
3,2415,2420,-5,0,373,0,6
3,2249,2570,-321,0,200,0,6
3,2327,2463,-136,0,113,0,6
3,2578,2451,127,0,15,0,6
3,2585,2388,197,0,400,0,6
3,2547,2316,231,0,201,0,6
3,2491,2402,89,0,200,0,6
3,2430,2513,-83,0,154,0,6
3,2465,2603,-138,0,112,0,6
3,2466,2457,9,0,300,0,6
3,2452,2273,179,0,311,0,6
3,2432,2443,-11,0,125,0,6
3,2360,2506,-146,0,307,0,6
3,2434,2359,75,0,308,0,6
3,2424,2202,222,0,246,0,6
3,2316,2516,-200,0,415,0,6
3,2439,2489,-50,0,43,0,6
3,2368,2466,-98,0,41,0,8
3,2510,2441,69,0,130,0,6
3,2430,2256,174,0,49,0,6
3,2497,2397,100,0,0,0,8
3,2474,2569,-95,0,175,0,6
3,2338,2421,-83,0,15,0,6
3,2522,2532,-10,0,260,0,6
3,2549,2426,123,0,337,0,6
3,2291,2515,-224,0,4,0,6
3,2318,2543,-225,0,211,0,6
3,2332,2475,-143,0,0,0,6
3,2345,2517,-172,0,100,0,6
3,2334,2433,-99,0,101,0,6
3,2501,2412,89,0,288,0,6
3,2565,2502,63,0,7,0,6
3,2402,2305,97,0,120,0,6
3,2258,2469,-211,0,101,0,6
3,2366,2569,-203,0,300,0,6
3,2487,2609,-122,0,404,0,6
3,2411,2301,110,0,300,0,6
3,2398,2400,-2,0,22,0,6
3,2653,2403,250,0,190,0,6
3,2585,2540,45,0,14,0,6
3,2530,2200,330,0,45,0,6
3,2430,2270,160,0,48,0,6
3,2441,2455,-14,0,30,0,6
3,2277,2468,-191,0,112,0,6
3,2443,2303,140,0,111,0,6
3,2564,2398,166,0,4,0,6
3,2403,2492,-89,0,10,0,6
3,2408,2378,30,0,303,0,6
3,2460,2334,126,0,113,0,6
3,2450,2363,87,0,100,0,6
3,2527,2475,52,0,103,0,6
3,2554,2378,176,0,221,0,6
3,2435,2262,173,0,335,0,6
3,2260,2475,-215,0,15,0,6
3,2467,2382,85,0,122,0,6
3,2437,2211,226,0,41,0,6
3,2355,2409,-54,0,5,0,6
3,2492,2317,175,0,103,0,6
3,2356,2556,-200,0,211,0,6
3,2430,2605,-175,0,190,0,6
3,2610,2425,185,0,101,0,6
3,2358,2471,-113,0,301,0,6
3,2452,2311,141,0,300,0,8
3,2604,2629,-25,0,111,0,6
3,2494,2368,126,0,56,0,6
3,2371,2437,-66,0,337,0,6
3,2304,2431,-127,0,133,0,6
3,2408,2499,-91,0,13,0,6
3,2389,2418,-29,0,135,0,6
3,2592,2484,108,0,43,0,6
3,2472,2495,-23,0,123,0,6
3,2353,2715,-362,0,141,0,6
3,2394,2591,-197,0,1,0,6
3,2548,2209,339,0,41,0,6
3,2359,2545,-186,0,10,0,6
3,2492,2511,-19,0,302,0,6
3,2569,2464,105,0,131,0,6
3,2360,2401,-41,0,30,0,6
3,2218,2458,-240,0,405,0,6
3,2408,2232,176,0,385,0,6
3,2478,2436,42,0,195,0,6
3,2490,2548,-58,0,16,0,6
3,2423,2312,111,0,200,0,6
3,2511,2543,-32,0,229,0,6
3,2340,2539,-199,0,380,0,6
3,2200,2502,-302,0,315,0,6
3,2445,2317,128,0,121,0,8
3,2415,2340,75,0,48,0,6
3,2374,2448,-74,0,4,0,6
3,2414,2243,171,0,315,0,6
3,2606,2470,136,0,103,0,6
3,2345,2413,-68,0,0,0,6
3,2461,2411,50,0,222,0,6
3,2315,2552,-237,0,0,0,6
3,2450,2247,203,0,380,0,6
3,2479,2513,-34,0,153,0,6
3,2332,2546,-214,0,174,0,6
3,2286,2489,-203,0,464,0,6
3,2385,2441,-56,0,190,0,6
3,2260,2411,-151,0,123,0,6
3,2424,2597,-173,0,46,0,6
3,2425,2420,5,0,484,0,6
3,2353,2417,-64,0,150,0,6
3,2494,2340,154,0,102,0,6
3,2479,2455,24,0,13,0,6
3,2281,2413,-132,0,40,0,6
3,2431,2424,7,0,40,0,6
3,2464,2478,-14,0,201,0,6
3,2502,2442,60,0,255,0,6
3,2315,2486,-171,0,43,0,6
3,2422,2325,97,0,140,0,6
3,2586,2513,73,0,45,0,6
3,2481,2474,7,0,0,0,6
3,2490,2232,258,0,120,0,6
3,2413,2213,200,0,46,0,6
3,2449,2394,55,0,337,0,6
3,2431,2301,130,4,311,0,13
3,2349,2455,-106,0,150,0,6
3,2398,2418,-20,0,41,0,6
3,2312,2527,-215,0,123,0,6
3,2536,2565,-29,0,302,0,6
3,2428,2323,105,0,127,0,6
3,2550,2608,-58,0,403,0,6
3,2560,2373,187,0,120,0,6
3,2403,2336,67,0,0,0,6
3,2432,2343,89,0,107,0,6
3,2539,2432,107,0,192,0,6
3,2532,2622,-90,0,304,0,6
3,2292,2404,-112,0,114,0,6
3,2425,2639,-214,0,40,0,6
3,2335,2465,-130,0,40,0,6
3,2424,2334,90,0,130,0,6
3,2478,2635,-157,0,106,0,6
3,2466,2334,132,0,106,0,6
3,2303,2403,-100,0,302,0,6
3,2671,2533,138,0,5,0,6
3,2537,2341,196,0,4,0,6
3,2422,2239,183,0,265,0,6
3,2411,2376,35,0,48,0,6
3,2358,2473,-115,0,106,0,6
3,2404,2445,-41,0,113,0,6
3,2306,2503,-197,0,140,0,6
3,2477,2447,30,0,246,0,6
3,2506,2465,41,0,110,0,6
3,2524,2275,249,0,113,0,6
3,2305,2493,-188,0,302,0,6
3,2480,2278,202,0,100,0,6
3,2335,2432,-97,0,48,0,6
3,2605,2402,203,0,4,0,6
3,2423,2329,94,0,247,0,6
3,2672,2613,59,0,190,0,6
3,2430,2363,67,0,331,0,6
3,2595,2358,237,0,244,0,6
3,2493,2573,-80,0,211,0,6
3,2331,2444,-113,0,404,0,6
3,2344,2459,-115,0,405,0,6
3,2539,2567,-28,0,410,0,6
3,2636,2519,117,0,8,0,6
3,2254,2447,-193,0,106,0,6
3,2201,2487,-286,0,245,0,6
3,2421,2361,60,0,156,0,6
3,2402,2353,49,0,315,0,6
3,2217,2521,-304,0,101,0,6
3,2278,2521,-243,0,201,0,6
3,2603,2529,74,0,107,0,6
3,2480,2459,21,0,56,0,6
3,2613,2399,214,0,167,0,6
3,2416,2335,81,0,244,0,6
3,2204,2513,-309,0,46,0,6
3,2518,2427,91,0,300,0,6
3,2700,2547,153,0,200,0,6
3,2413,2385,28,0,395,0,6
3,2553,2324,229,0,115,0,6
3,2481,2589,-108,0,0,0,6
3,2497,2243,254,0,485,0,6
3,2431,2398,33,0,4,0,6
3,2401,2283,118,0,46,0,6
3,2377,2545,-168,0,354,0,6
3,2438,2601,-163,0,15,0,6
3,2548,2593,-45,0,7,0,6
3,2339,2405,-66,0,1,0,6
3,2426,2634,-208,0,5,0,6
3,2470,2430,40,0,107,0,6
3,2427,2444,-17,0,333,0,6
3,2705,2610,95,0,40,0,6
3,2461,2381,80,0,40,0,6
3,2430,2312,118,4,301,0,13
3,2474,2356,118,0,312,0,6
3,2438,2427,11,0,34,0,6
3,2530,2502,28,0,453,0,6
3,2554,2382,172,0,190,0,6
3,2356,2484,-128,0,45,0,6
3,2415,2521,-106,0,300,0,6
3,2321,2416,-95,0,138,0,6
3,2429,2423,6,0,152,0,6
3,2400,2600,-200,0,145,0,6
3,2541,2411,130,0,211,0,6
3,2462,2367,95,0,4,0,6
3,2205,2549,-344,0,108,0,6
3,2515,2485,30,0,337,0,6
3,2472,2380,92,0,153,0,6
3,2403,2381,22,0,110,0,6
3,2607,2455,152,0,122,0,6
3,2423,2421,2,0,45,0,6
3,2486,2494,-8,0,110,0,6
3,2416,2403,13,0,265,0,6
3,2453,2331,122,0,301,0,6
3,2494,2564,-70,0,123,0,6
3,2606,2523,83,0,247,0,6
3,2426,2261,165,0,200,0,6
3,2365,2433,-68,0,388,0,6
3,2380,2522,-142,0,312,0,6
3,2273,2553,-280,0,40,0,6
3,2410,2375,35,4,0,0,13
3,2585,2573,12,0,112,0,6
3,2598,2398,200,0,15,0,6
3,2451,2559,-108,0,86,0,6
3,2352,2429,-77,0,4,0,6
3,2501,2572,-71,0,200,0,6
3,2432,2343,89,0,1,0,6
3,2547,2529,18,0,211,0,6
3,2378,2402,-24,0,45,0,6
3,2287,2416,-129,0,65,0,6
3,2410,2569,-159,0,303,0,6
3,2473,2419,54,0,0,0,6
3,2405,2379,26,0,201,0,6
3,2238,2405,-167,0,8,0,6
3,2462,2222,240,0,7,0,6
3,2331,2440,-109,0,7,0,6
3,2560,2612,-52,0,382,0,6
3,2501,2503,-2,0,4,0,6
3,2441,2304,137,0,315,0,6
3,2549,2368,181,0,244,0,6
3,2221,2528,-307,0,148,0,6
3,2452,2331,121,0,145,0,6
3,2364,2406,-42,0,150,0,6
3,2446,2554,-108,0,40,0,6
3,2404,2369,35,0,193,0,6
3,2523,2453,70,0,315,0,6
3,2608,2541,67,0,107,0,6
3,2557,2423,134,0,270,0,6
3,2522,2676,-154,0,460,0,6
3,2380,2468,-88,0,199,0,6
3,2520,2248,272,0,245,0,6
3,2270,2425,-155,0,200,0,6
3,2513,2544,-31,0,107,0,6
3,2489,2445,44,0,106,0,6
3,2444,2375,69,0,101,0,6
3,2501,2316,185,0,5,0,6
3,2404,2351,53,0,315,0,6
3,2542,2557,-15,0,4,0,6
3,2700,2846,-146,0,324,0,6
3,2527,2514,13,0,153,0,6
3,2474,2563,-89,0,338,0,6
3,2464,2454,10,0,200,0,6
3,2562,2307,255,0,490,0,6
3,2496,2458,38,0,130,0,6
3,2297,2554,-257,0,4,0,6
3,2447,2226,221,0,1,0,8
3,2450,2599,-149,0,0,0,6
3,2561,2407,154,0,456,0,6
3,2360,2409,-49,0,102,0,6
3,2544,2291,253,0,302,0,6
3,2518,2399,119,0,337,0,6
3,2548,2731,-183,0,304,0,6
3,2528,2451,77,0,300,0,6
3,2213,2498,-285,0,121,0,6
3,2361,2489,-128,0,139,0,6
3,2540,2432,108,0,381,0,6
3,2620,2491,129,0,101,0,6
3,2401,2556,-155,0,1,0,6
3,2329,2564,-235,0,414,0,6
3,2426,2331,95,0,4,0,6
3,2409,2226,183,0,330,0,6
3,2320,2440,-120,0,195,0,6
3,2425,2370,55,0,4,0,6
3,2404,2498,-94,0,44,0,6
3,2466,2364,102,0,29,0,6
3,2530,2684,-154,0,22,0,6
3,2418,2418,0,0,395,0,6
3,2527,2360,167,0,3,0,6
3,2540,2439,101,0,341,0,6
3,2433,2275,158,0,35,0,6
3,2556,2456,100,0,302,0,6
3,2670,2550,120,0,241,0,6
3,2444,2438,6,0,112,0,6
3,2270,2452,-182,0,41,0,6
3,2412,2295,117,0,0,0,6
3,2304,2414,-110,0,242,0,6
3,2446,2510,-64,0,87,0,6
3,2566,2641,-75,0,46,0,6
3,2409,2394,15,0,311,0,6
3,2491,2596,-105,0,41,0,6
3,2421,2403,18,0,113,0,6
3,2217,2401,-184,0,4,0,6
3,2340,2585,-245,0,46,0,6
3,2424,2538,-114,0,314,0,6
3,2495,2359,136,0,118,0,6
3,2322,2456,-134,0,49,0,6
3,2339,2418,-79,0,45,0,6
3,2300,2506,-206,0,245,0,6
3,2451,2330,121,0,360,0,6
3,2400,2392,8,0,0,0,6
3,2375,2456,-81,0,10,0,6
3,2429,2437,-8,0,132,0,6
3,2510,2326,184,0,49,0,6
3,2266,2445,-179,0,123,0,6
3,2357,2493,-136,0,100,0,6
3,2436,2510,-74,0,242,0,6
3,2322,2589,-267,0,0,0,6
3,2361,2519,-158,0,90,0,6
3,2323,2478,-155,0,302,0,6
3,2633,2480,153,0,250,0,6
3,2411,2432,-21,0,201,0,6
3,2404,2229,175,0,43,0,6
3,2366,2567,-201,0,457,0,6
3,2432,2603,-171,0,380,0,6
3,2453,2353,100,0,112,0,6
3,2484,2563,-79,0,307,0,6
3,2573,2544,29,0,46,0,6
3,2584,2679,-95,0,45,0,6
3,2537,2436,101,0,146,0,6
3,2418,2260,158,0,46,0,6
3,2254,2415,-161,0,344,0,6
3,2455,2376,79,0,240,0,6
3,2476,2477,-1,0,110,0,6
3,2530,2536,-6,0,102,0,6
3,2637,2550,87,0,106,0,6
3,2293,2407,-114,0,4,0,6
3,2567,2552,15,0,205,0,6
3,2354,2458,-104,0,15,0,6
3,2404,2471,-67,0,22,0,6
3,2367,2508,-141,0,302,0,6
3,2447,2515,-68,0,107,0,6
3,2585,2350,235,0,15,0,6
3,2378,2541,-163,0,217,0,6
3,2486,2453,33,0,455,0,6
3,2475,2473,2,0,125,0,6
3,2477,2535,-58,0,101,0,6
3,2495,2456,39,0,40,0,6
3,2401,2397,4,0,105,0,6
3,2551,2375,176,0,122,0,6
3,2719,2416,303,0,7,0,6
3,2680,2493,187,0,337,0,6
3,2350,2528,-178,0,40,0,6
3,2415,2329,86,0,335,0,6
3,2431,2757,-326,0,108,0,6
3,2681,2524,157,0,199,0,6
3,2577,2624,-47,0,311,0,6
3,2445,2271,174,0,0,0,8
3,2436,2432,4,0,106,0,6
3,2501,2430,71,0,100,0,6
3,2447,2558,-111,0,224,0,6
3,2500,2507,-7,0,229,0,6
3,2445,2561,-116,0,335,0,6
3,2438,2428,10,0,201,0,6
3,2601,2677,-76,0,484,0,6
3,2415,2366,49,0,46,0,6
3,2353,2469,-116,0,228,0,6
3,2472,2606,-134,0,154,0,6
3,2678,2607,71,0,100,0,6
3,2238,2480,-242,0,133,0,6
3,2461,2431,30,0,145,0,6
3,2626,2465,161,0,4,0,6
3,2462,2329,133,0,101,0,6
3,2520,2470,50,0,333,0,6
3,2608,2640,-32,0,111,0,6
3,2557,2550,7,0,57,0,6
3,2569,2359,210,0,127,0,6
3,2300,2532,-232,0,366,0,6
3,2447,2435,12,0,41,0,6
3,2400,2348,52,0,15,0,6
3,2312,2416,-104,0,245,0,6
3,2492,2209,283,0,302,0,6
3,2542,2301,241,0,10,0,6
3,2417,2502,-85,0,267,0,6
3,2452,2438,14,0,43,0,6
3,2597,2310,287,0,2,0,8
3,2588,2497,91,0,45,0,6
3,2421,2493,-72,0,1,0,6
3,2477,2529,-52,0,241,0,6
3,2415,2411,4,0,46,0,6
3,2259,2626,-367,0,110,0,6
3,2481,2215,266,0,33,0,6
3,2562,2707,-145,0,301,0,6
3,2421,2338,83,0,112,0,6
3,2442,2263,179,0,226,0,6
3,2241,2455,-214,0,300,0,6
3,2444,2488,-44,0,13,0,6
3,2430,2557,-127,0,4,0,6
3,2365,2626,-261,0,200,0,6
3,2375,2557,-182,0,5,0,6
3,2537,2387,150,0,201,0,6
3,2308,2426,-118,0,123,0,6
3,2374,2582,-208,0,300,0,6
3,2425,2440,-15,0,247,0,6
3,2277,2434,-157,0,56,0,6
3,2528,2457,71,0,302,0,6
3,2401,2399,2,0,4,0,6
3,2536,2486,50,0,122,0,6
3,2579,2471,108,0,302,0,6
3,2625,2591,34,0,242,0,6
3,2486,2564,-78,0,310,0,6
3,2433,2298,135,0,145,0,6
3,2360,2426,-66,0,210,0,6
3,2403,2535,-132,0,124,0,6
3,2439,2297,142,0,83,0,6
3,2422,2329,93,0,277,0,6
3,2287,2481,-194,0,132,0,6
3,2411,2377,34,0,40,0,6
3,2389,2452,-63,0,41,0,6
3,2257,2507,-250,0,302,0,6
3,2266,2416,-150,0,301,0,6
3,2323,2405,-82,0,108,0,6
3,2337,2468,-131,0,39,0,6
3,2614,2608,6,0,4,0,6
3,2393,2422,-29,0,100,0,6
3,2491,2615,-124,0,158,0,6
3,2441,2375,66,0,52,0,6
3,2463,2430,33,0,202,0,6
3,2272,2633,-361,0,386,0,6
3,2547,2504,43,0,123,0,6
3,2418,2466,-48,0,12,0,6
3,2500,2673,-173,0,190,0,6
3,2216,2507,-291,0,40,0,6
3,2433,2348,85,0,132,0,6
3,2328,2422,-94,0,107,0,6
3,2501,2262,239,0,46,0,6
3,2544,2608,-64,0,338,0,6
3,2473,2564,-91,0,307,0,6
3,2592,2577,15,0,101,0,6
3,2366,2480,-114,0,310,0,6
3,2327,2479,-152,0,0,0,6
3,2565,2445,120,0,200,0,6
3,2527,2565,-38,0,244,0,6
3,2299,2445,-146,0,121,0,6
3,2595,2602,-7,0,302,0,6
3,2540,2574,-34,0,43,0,6
3,2574,2484,90,0,150,0,6
3,2331,2471,-140,0,1,0,6
3,2401,2339,62,0,4,0,6
3,2440,2608,-168,0,335,0,6
3,2602,2628,-26,0,111,0,6
3,2415,2366,49,0,40,0,6
3,2536,2444,92,0,374,0,6
3,2280,2431,-151,0,13,0,6
3,2570,2409,161,0,58,0,6
3,2605,2443,162,0,120,0,6
3,2289,2454,-165,0,278,0,6
3,2513,2403,110,0,405,0,6
3,2485,2604,-119,0,171,0,6
3,2445,2603,-158,0,60,0,6
3,2356,2414,-58,0,45,0,6
3,2404,2230,174,0,380,0,6
3,2438,2460,-22,0,354,0,6
3,2461,2620,-159,0,106,0,6
3,2460,2438,22,0,404,0,6
3,2403,2492,-89,4,211,0,13
3,2320,2499,-179,0,0,0,6
3,2439,2459,-20,0,142,0,6
3,2464,2516,-52,0,359,0,6
3,2425,2316,109,0,101,0,6
3,2479,2333,146,0,226,0,6
3,2459,2439,20,0,341,0,6
3,2464,2514,-50,0,241,0,6
3,2531,2629,-98,0,110,0,6
3,2439,2446,-7,0,118,0,6
3,2462,2365,97,0,153,0,6
3,2435,2425,10,0,415,0,6
3,2403,2545,-142,0,320,0,6
3,2388,2626,-238,0,3,0,6
3,2462,2412,50,0,202,0,6
3,2446,2551,-105,0,10,0,6
3,2641,2656,-15,0,447,0,6
3,2328,2416,-88,0,1,0,6
3,2473,2322,151,0,113,0,8
3,2367,2457,-90,0,210,0,6
3,2435,2560,-125,0,485,0,10
3,2465,2373,92,0,112,0,6
3,2622,2544,78,0,118,0,6
3,2475,2535,-60,0,265,0,6
3,2304,2417,-113,0,201,0,6
3,2481,2474,7,0,302,0,6
3,2415,2264,151,0,154,0,6
3,2456,2402,54,0,201,0,6
3,2346,2467,-121,0,106,0,6
3,2400,2538,-138,0,46,0,6
3,2414,2235,179,0,45,0,6
3,2427,2409,18,0,125,0,6
3,2506,2398,108,0,302,0,8
3,2434,2499,-65,0,107,0,6
3,2544,2384,160,0,200,0,6
3,2575,2532,43,0,120,0,6
3,2447,2448,-1,0,405,0,6
3,2434,2265,169,0,45,0,6
3,2249,2426,-177,0,202,0,6
3,2460,2435,25,0,122,0,6
3,2421,2378,43,0,127,0,6
3,2497,2435,62,0,398,0,6
3,2469,2340,129,0,117,0,6
3,2441,2359,82,0,150,0,6
3,2470,2479,-9,0,311,0,6
3,2363,2400,-37,0,415,0,6
3,2531,2613,-82,0,107,0,6
3,2421,2244,177,4,106,0,13
3,2477,2520,-43,0,168,0,6
3,2552,2555,-3,0,102,0,6
3,2557,2435,122,0,339,0,10
3,2411,2340,71,0,1,0,6
3,2612,2652,-40,0,124,0,6
3,2291,2428,-137,0,241,0,6
3,2465,2430,35,0,140,0,6
3,2286,2421,-135,0,47,0,6
3,2441,2452,-11,0,360,0,10
3,2618,2652,-34,0,131,0,6
3,2490,2464,26,4,41,0,13
3,2443,2534,-91,0,263,0,6
3,2362,2493,-131,0,4,0,6
3,2393,2410,-17,0,310,0,6
3,2419,2374,45,0,344,0,6
3,2469,2429,40,0,320,0,6
3,2460,2496,-36,0,1,0,6
3,2617,2365,252,0,211,0,6
3,2301,2419,-118,0,251,0,6
3,2335,2453,-118,0,45,0,6
3,2344,2443,-99,0,225,0,6
3,2504,2348,156,0,135,0,6
3,2442,2346,96,0,112,0,6
3,2559,2525,34,0,121,0,6
3,2419,2323,96,0,100,0,6
3,2434,2394,40,0,127,0,6
3,2394,2415,-21,0,115,0,6
3,2433,2466,-33,0,115,0,6
3,2443,2274,169,0,264,0,6
3,2438,2425,13,0,6,0,6
3,2351,2431,-80,0,283,0,6
3,2402,2361,41,0,265,0,6
3,2428,2471,-43,0,115,0,6
3,2624,2622,2,0,241,0,6
3,2468,2529,-61,0,123,0,6
3,2348,2434,-86,0,253,0,6
3,2281,2427,-146,0,16,0,6
3,2580,2536,44,0,241,0,6
3,2425,2534,-109,0,104,0,6
3,2388,2439,-51,0,45,0,6
3,2537,2705,-168,0,0,0,6
3,2345,2437,-92,0,283,0,6
3,2480,2580,-100,0,373,0,6
3,2458,2442,16,0,406,0,6
3,2316,2461,-145,0,15,0,6
3,2436,2347,89,0,157,0,6
3,2405,2281,124,0,134,0,6
3,2488,2396,92,0,120,0,6
3,2525,2454,71,0,0,0,6
3,2434,2348,86,0,250,0,6
3,2525,2472,53,0,145,0,6
3,2334,2403,-69,0,41,0,6
3,2566,2581,-15,0,114,0,6
3,2606,2554,52,0,250,0,6
3,2350,2433,-83,0,245,0,6
3,2555,2546,9,0,459,0,6
3,2473,2525,-52,0,140,0,6
3,2225,2412,-187,0,212,0,6
3,2431,2462,-31,0,143,0,6
3,2541,2636,-95,0,453,0,6
3,2432,2351,81,0,157,0,6
3,2577,2514,63,0,4,0,6
3,2407,2419,-12,0,151,0,6
3,2432,2445,-13,0,253,0,6
3,2352,2430,-78,0,283,0,6
3,2290,2448,-158,0,306,0,6
3,2782,2631,151,0,373,0,6
3,2523,2475,48,0,145,0,6
3,2431,2544,-113,0,466,0,6
3,2422,2363,59,0,331,0,6
3,2322,2456,-134,0,207,0,6
3,2335,2421,-86,0,1,0,6
3,2454,2422,32,0,112,0,6
3,2448,2415,33,0,29,0,6
3,2434,2431,3,0,45,0,6
3,2275,2428,-153,0,43,0,6
3,2596,2534,62,0,337,0,6
3,2472,2526,-54,0,140,0,6
3,2440,2431,9,0,48,0,6
3,2410,2517,-107,0,216,0,6
3,2298,2410,-112,0,88,0,6
3,2280,2465,-185,4,41,0,13
3,2468,2530,-62,0,140,0,6
3,2236,2410,-174,4,211,0,13
3,2431,2318,113,0,218,0,6
3,2395,2476,-81,0,236,0,6
3,2415,2429,-14,0,107,0,6
3,2406,2338,68,0,100,0,6
3,2475,2461,14,0,57,0,6
3,2375,2423,-48,0,88,0,6
3,2429,2421,8,0,80,0,6
3,2464,2512,-48,0,267,0,6
3,2419,2465,-46,0,45,0,6
3,2401,2340,61,0,102,0,6
3,2558,2486,72,0,252,0,6
3,2379,2442,-63,0,302,0,7
3,2418,2261,157,4,117,0,13
3,2422,2416,6,0,201,0,6
3,2337,2403,-66,0,280,0,6
3,2404,2270,134,0,102,0,6
3,2452,2455,-3,0,121,0,6
3,2423,2441,-18,0,123,0,6
3,2315,2505,-190,0,140,0,6
3,2310,2485,-175,0,110,0,6
3,2505,2414,91,0,101,0,6
3,2410,2419,-9,0,337,0,6
3,2503,2313,190,0,157,0,6
3,2500,2418,82,0,389,0,6
3,2656,2576,80,0,107,0,6
3,2224,2526,-302,0,404,0,6
3,2426,2463,-37,0,302,0,6
3,2369,2543,-174,0,37,0,6
3,2439,2342,97,0,201,0,6
3,2426,2652,-226,0,115,0,6
3,2338,2404,-66,0,123,0,6
3,2438,2203,235,0,301,0,6
3,2440,2357,83,0,131,0,6
3,2313,2434,-121,0,241,0,6
3,2497,2451,46,0,45,0,6
3,2307,2419,-112,0,311,0,6
3,2377,2527,-150,0,4,0,6
3,2616,2736,-120,0,43,0,6
3,2409,2453,-44,0,46,0,6
3,2258,2401,-143,0,258,0,6
3,2220,2476,-256,0,453,0,6
3,2734,2618,116,0,53,0,6
3,2569,2418,151,0,300,0,6
3,2413,2307,106,0,49,0,6
3,2414,2320,94,0,192,0,6
3,2392,2403,-11,0,41,0,6
3,2345,2458,-113,0,300,0,6
3,2266,2415,-149,0,4,0,6
3,2453,2392,61,0,255,0,6
3,2495,2211,284,0,110,0,6
3,2570,2240,330,0,36,0,6
3,2221,2436,-215,0,107,0,6
3,2441,2270,171,0,46,0,6
3,2633,2333,300,0,200,0,6
3,2404,2421,-17,0,11,0,6
3,2436,2494,-58,0,45,0,6
3,2434,2263,171,0,108,0,6
3,2554,2395,159,0,125,0,6
3,2421,2385,36,0,15,0,6
3,2283,2450,-167,0,455,0,6
3,2309,2569,-260,0,327,0,6
3,2380,2533,-153,0,26,0,6
3,2733,2620,113,0,190,0,6
3,2324,2417,-93,0,22,0,6
3,2519,2392,127,0,307,0,6
3,2227,2451,-224,0,20,0,6
3,2289,2404,-115,0,143,0,6
3,2453,2293,160,0,153,0,6
3,2383,2517,-134,0,267,0,6
3,2300,2411,-111,4,224,0,13
3,2460,2334,126,0,45,0,6
3,2385,2411,-26,0,358,0,6
3,2716,2638,78,0,210,0,6
3,2609,2467,142,0,40,0,6
3,2487,2335,152,0,476,0,6
3,2452,2441,11,0,348,0,6
3,2402,2417,-15,0,300,0,6
3,2415,2477,-62,0,105,0,6
3,2426,2334,92,0,107,0,6
3,2424,2504,-80,0,102,0,6
3,2622,2558,64,0,2,0,6
3,2470,2333,137,0,300,0,6
3,2533,2621,-88,0,101,0,6
3,2706,2760,-54,0,13,0,6
3,2519,2384,135,0,300,0,6
3,2475,2517,-42,0,46,0,6
3,2380,2482,-102,0,40,0,6
3,2286,2472,-186,0,107,0,6
3,2383,2477,-94,0,101,0,6
3,2429,2395,34,0,1,0,6
3,2672,2652,20,0,196,0,6
3,2572,2503,69,0,151,0,6
3,2396,2555,-159,0,101,0,6
3,2459,2267,192,0,4,0,6
3,2682,2567,115,0,265,0,6
3,2684,2565,119,0,265,0,6
3,2526,2624,-98,0,127,0,6
3,2460,2513,-53,0,9,0,6
3,2208,2459,-251,0,123,0,6
3,2457,2400,57,0,41,0,6
3,2388,2403,-15,0,31,0,6
3,2703,2612,91,0,102,0,6
3,2403,2517,-114,0,337,0,6
3,2410,2413,-3,0,227,0,6
3,2425,2384,41,0,49,0,6
3,2592,2558,34,0,335,0,6
3,2551,2552,-1,0,324,0,6
3,2304,2582,-278,4,485,0,13
3,2552,2595,-43,0,354,0,6
3,2680,2653,27,0,151,0,6
3,2521,2557,-36,0,395,0,6
3,2506,2425,81,0,30,0,6
3,2771,2827,-56,0,464,0,6
3,2396,2403,-7,0,202,0,6
3,2431,2419,12,0,4,0,6
3,2289,2409,-120,0,310,0,6
3,2375,2408,-33,0,132,0,6
3,2554,2416,138,0,1,0,6
3,2428,2336,92,0,46,0,6
3,2423,2487,-64,0,101,0,6
3,2400,2478,-78,0,112,0,6
3,2337,2426,-89,0,261,0,6
3,2420,2471,-51,0,302,0,6
3,2472,2430,42,0,337,0,6
3,2588,2573,15,0,58,0,6
3,2431,2472,-41,0,122,0,6
3,2433,2242,191,0,115,0,6
3,2495,2392,103,0,105,0,6
3,2255,2411,-156,0,128,0,6
3,2829,2770,59,0,6,0,6
3,2459,2498,-39,0,101,0,6
3,2477,2374,103,0,201,0,6
3,2294,2473,-179,0,20,0,6
3,2292,2436,-144,0,400,0,6
3,2258,2414,-156,0,132,0,6
3,2535,2454,81,0,345,0,6
3,2834,2766,68,0,4,0,6
3,2406,2467,-61,0,201,0,6
3,2295,2429,-134,0,46,0,5
3,2488,2475,13,0,112,0,6
3,2461,2489,-28,0,121,0,6
3,2407,2383,24,0,201,0,6
3,2386,2400,-14,0,315,0,6
3,2491,2482,9,0,101,0,6
3,2407,2538,-131,0,113,0,6
3,2444,2478,-34,0,130,0,6
3,2475,2381,94,0,6,0,6
3,2459,2323,136,0,130,0,6
3,2539,2488,51,0,278,0,6
3,2404,2426,-22,0,106,0,6
3,2544,2417,127,0,341,0,6
3,2429,2439,-10,0,250,0,6
3,2415,2437,-22,0,40,0,6
3,2668,2556,112,0,278,0,6
3,2370,2457,-87,0,15,0,6
3,2536,2419,117,0,244,0,6
3,2360,2479,-119,0,406,0,6
3,2446,2382,64,0,326,0,6
3,2381,2410,-29,0,380,0,6
3,2672,2681,-9,0,108,0,6
3,2439,2483,-44,2,347,0,25
3,2369,2454,-85,0,400,0,6
3,2253,2439,-186,0,331,0,6
3,2228,2582,-354,0,46,0,6
3,2377,2460,-83,0,310,0,6
3,2561,2485,76,0,21,0,6
3,2466,2412,54,0,172,0,6
3,2253,2439,-186,0,344,0,6
3,2401,2450,-49,0,123,0,6
3,2342,2422,-80,0,40,0,6
3,2344,2459,-115,0,6,0,6
3,2653,2639,14,0,382,0,6
3,2306,2413,-107,2,33,0,18
3,2348,2414,-66,0,256,0,6
3,2417,2492,-75,0,80,0,6
3,2614,2651,-37,0,120,0,6
3,2418,2295,123,0,302,0,6
3,2383,2469,-86,0,374,0,6
3,2247,2445,-198,0,289,0,6
3,2457,2495,-38,0,102,0,6
3,2267,2411,-144,0,303,0,6
3,2377,2403,-26,0,132,0,6
3,2460,2469,-9,0,46,0,6
3,2243,2404,-161,0,209,0,6
3,2524,2518,6,0,302,0,6
3,2403,2360,43,0,122,0,6
3,2502,2518,-16,0,0,0,6
3,2464,2373,91,0,120,0,6
3,2346,2413,-67,0,386,0,8
3,2397,2475,-78,0,242,0,6
3,2283,2446,-163,0,344,0,6
3,2417,2252,165,0,419,0,6
3,2444,2283,161,0,320,0,6
3,2411,2356,55,0,46,0,8
3,2271,2594,-323,0,301,0,6
3,2518,2537,-19,0,45,0,6
3,2367,2415,-48,0,46,0,6
3,2427,2395,32,0,206,0,6
3,2470,2383,87,0,40,0,6
3,2457,2444,13,0,207,0,6
3,2370,2440,-70,0,46,0,6
3,2448,2414,34,0,113,0,6
3,2423,2348,75,0,112,0,6
3,2407,2491,-84,0,327,0,6
3,2380,2409,-29,0,254,0,8
3,2337,2467,-130,0,405,0,6
3,2431,2334,97,0,240,0,6
3,2519,2525,-6,0,330,0,6
3,2409,2408,1,0,122,0,6
3,2408,2427,-19,0,123,0,6
3,2598,2759,-161,0,409,0,6
3,2417,2387,30,0,101,0,6
3,2535,2469,66,0,49,0,6
3,2515,2409,106,0,409,0,6
3,2422,2593,-171,4,474,0,13
3,2515,2578,-63,0,101,0,6
3,2393,2449,-56,0,45,0,6
3,2325,2440,-115,4,302,0,13
3,2360,2481,-121,0,40,0,6
3,2399,2409,-10,0,45,0,6
3,2346,2428,-82,0,300,0,6
3,2371,2485,-114,0,330,0,8
3,2588,2372,216,0,250,0,6
3,2510,2600,-90,0,386,0,6
3,2449,2477,-28,0,112,0,6
3,2423,2255,168,0,359,0,6
3,2410,2201,209,2,326,0,25
3,2476,2450,26,0,45,0,6
3,2481,2510,-29,0,453,0,6
3,2599,2574,25,0,306,0,6
3,2433,2342,91,0,10,0,6
3,2329,2430,-101,0,302,0,6
3,2464,2448,16,0,102,0,6
3,2494,2425,69,0,45,0,6
3,2592,2464,128,0,200,0,6
3,2451,2474,-23,0,106,0,6
3,2507,2469,38,0,337,0,6
3,2590,2557,33,0,267,0,6
3,2429,2383,46,0,198,0,6
3,2464,2403,61,0,120,0,6
3,2347,2430,-83,0,14,0,6
3,2310,2497,-187,0,190,0,6
3,2354,2429,-75,0,6,0,6
3,2426,2595,-169,0,49,0,6
3,2467,2355,112,0,115,0,6
3,2545,2424,121,0,132,0,6
3,2377,2491,-114,0,469,0,6
3,2711,2568,143,0,301,0,6
3,2515,2572,-57,0,101,0,6
3,2417,2279,138,0,41,0,6
3,2387,2459,-72,0,335,0,6
3,2318,2458,-140,0,121,0,6
3,2357,2403,-46,0,373,0,6
3,2400,2456,-56,0,225,0,6
3,2269,2494,-225,0,258,0,6
3,2385,2401,-16,0,61,0,6
3,2430,2460,-30,0,210,0,6
3,2706,2598,108,0,300,0,6
3,2435,2464,-29,0,247,0,6
3,2508,2477,31,0,335,0,6
3,2538,2570,-32,0,120,0,6
3,2520,2535,-15,0,43,0,6
3,2273,2413,-140,0,21,0,6
3,2519,2583,-64,0,7,0,6
3,2404,2356,48,0,456,0,6
3,2305,2453,-148,0,46,0,6
3,2449,2353,96,0,4,0,6
3,2619,2575,44,0,2,0,6
3,2411,2488,-77,0,1,0,6
3,2351,2412,-61,0,484,0,6
3,2415,2495,-80,0,314,0,6
3,2401,2264,137,0,8,0,6
3,2444,2329,115,0,131,0,6
3,2419,2491,-72,0,246,0,6
3,2459,2323,136,0,226,0,6
3,2417,2402,15,0,13,0,6
3,2490,2411,79,0,315,0,6
3,2507,2415,92,0,300,0,6
3,2381,2449,-68,0,34,0,6
3,2425,2376,49,0,411,0,6
3,2429,2483,-54,0,302,0,6
3,2298,2446,-148,0,46,0,6
3,2426,2388,38,0,380,0,8
3,2388,2434,-46,0,406,0,6
3,2380,2456,-76,0,138,0,6
3,2528,2616,-88,0,40,0,6
3,2474,2513,-39,0,453,0,6
3,2461,2389,72,0,211,0,6
3,2344,2426,-82,0,163,0,6
3,2419,2272,147,2,13,0,18
3,2412,2296,116,0,101,0,6
3,2554,2403,151,0,267,0,6
3,2432,2296,136,0,411,0,6
3,2667,2615,52,0,45,0,6
3,2578,2457,121,0,213,0,6
3,2416,2389,27,0,173,0,6
3,2525,2566,-41,0,300,0,6
3,2406,2616,-210,0,218,0,6
3,2477,2390,87,0,41,0,8
3,2448,2442,6,0,14,0,6
3,2410,2417,-7,0,311,0,6
3,2419,2402,17,0,331,0,6
3,2477,2421,56,0,310,0,6
3,2474,2447,27,0,45,0,6
3,2206,2515,-309,0,247,0,5
3,2442,2352,90,0,15,0,6
3,2459,2457,2,0,200,0,6
3,2430,2408,22,0,122,0,6
3,2415,2404,11,0,302,0,6
3,2376,2413,-37,0,9,0,6
3,2290,2433,-143,0,245,0,6
3,2305,2477,-172,0,106,0,6
3,2445,2398,47,0,4,0,6
3,2428,2511,-83,0,4,0,5
3,2448,2468,-20,0,250,0,6
3,2479,2419,60,0,150,0,6
3,2379,2417,-38,0,101,0,6
3,2440,2485,-45,0,4,0,6
3,2434,2473,-39,0,300,0,6
3,2398,2425,-27,4,122,0,13
3,2416,2425,-9,0,190,0,6
3,2445,2591,-146,0,432,0,5
3,2477,2452,25,0,101,0,6
3,2510,2503,7,0,130,0,5
3,2429,2238,191,4,325,0,13
3,2280,2452,-172,0,211,0,6
3,2412,2370,42,0,8,0,6
3,2351,2430,-79,0,302,0,6
3,2430,2302,128,4,135,0,13
3,2566,2548,18,0,0,0,6
3,2472,2436,36,0,4,0,6
3,2499,2370,129,0,5,0,6
3,2589,2630,-41,0,208,0,6
3,2427,2447,-20,0,4,0,6
3,2287,2431,-144,4,86,0,13
3,2386,2441,-55,0,308,0,6
3,2437,2448,-11,0,46,0,6
3,2398,2428,-30,0,15,0,6
3,2422,2383,39,0,235,0,6
3,2233,2491,-258,0,48,0,6
3,2323,2459,-136,0,55,0,6
3,2543,2397,146,0,111,0,6
3,2289,2582,-293,0,114,0,5
3,2559,2451,108,0,127,0,5
3,2414,2386,28,0,200,0,6
3,2491,2399,92,0,0,0,6
3,2466,2383,83,0,343,0,6
3,2449,2512,-63,0,200,0,6
3,2437,2478,-41,0,49,0,6
3,2370,2495,-125,0,332,0,6
3,2299,2406,-107,0,125,0,5
3,2504,2427,77,0,1,0,6
3,2404,2394,10,0,100,0,6
3,2355,2504,-149,0,373,0,6
3,2290,2475,-185,0,106,0,6
3,2518,2488,30,0,107,0,6
3,2403,2356,47,4,240,0,13
3,2394,2496,-102,0,302,0,6
3,2529,2419,110,0,45,0,6
3,2416,2408,8,0,304,0,6
3,2281,2449,-168,0,370,0,6
3,2540,2517,23,0,48,0,6
3,2561,2627,-66,0,120,0,6
3,2411,2398,13,0,398,0,6
3,2496,2354,142,0,112,0,6
3,2480,2450,30,0,101,0,6
3,2218,2404,-186,4,0,0,13
3,2356,2529,-173,0,256,0,6
3,2433,2591,-158,0,107,0,6
3,2699,2531,168,0,210,0,6
3,2471,2464,7,0,45,0,6
3,2402,2443,-41,0,46,0,6
3,2435,2345,90,0,4,0,6
3,2532,2361,171,0,50,0,6
3,2277,2414,-137,0,344,0,6
3,2478,2365,113,0,13,0,6
3,2532,2575,-43,0,4,0,6
3,2461,2485,-24,0,455,0,6
3,2474,2410,64,0,409,0,6
3,2475,2520,-45,0,265,0,6
3,2407,2336,71,0,332,0,6
3,2396,2416,-20,0,288,0,6
3,2331,2581,-250,0,47,0,8
3,2554,2658,-104,0,380,0,6
3,2578,2725,-147,0,40,0,6
3,2419,2494,-75,0,46,0,6
3,2294,2443,-149,0,113,0,6
3,2365,2497,-132,0,130,0,6
3,2341,2459,-118,0,255,0,8
3,2474,2336,138,0,45,0,6
3,2439,2430,9,0,200,0,6
3,2449,2464,-15,0,234,0,6
3,2581,2569,12,0,45,0,6
3,2390,2440,-50,0,45,0,6
3,2393,2426,-33,0,46,0,6
3,2469,2567,-98,0,248,0,6
3,2317,2433,-116,4,369,0,13
3,2569,2580,-11,0,207,0,6
3,2478,2469,9,0,50,0,6
3,2365,2425,-60,0,119,0,6
3,2385,2463,-78,0,106,0,6
3,2501,2360,141,0,242,0,6
3,2383,2494,-111,0,302,0,6
3,2502,2492,10,0,315,0,6
3,2469,2478,-9,0,453,0,6
3,2493,2218,275,0,140,0,5
3,2496,2383,113,0,246,0,6
3,2410,2317,93,0,330,0,6
3,2458,2393,65,0,106,0,6
3,2565,2492,73,0,267,0,6
3,2412,2378,34,0,45,0,6
3,2571,2566,5,0,151,0,6
3,2471,2453,18,0,120,0,6
3,2423,2311,112,0,150,0,6
3,2366,2433,-67,0,102,0,6
3,2348,2476,-128,0,153,0,6
3,2508,2348,160,0,14,0,6
3,2450,2333,117,0,146,0,6
3,2416,2467,-51,0,315,0,6
3,2490,2564,-74,0,457,0,6
3,2662,2471,191,0,311,0,6
3,2333,2417,-84,0,194,0,6
3,2525,2566,-41,0,302,0,6
3,2451,2660,-209,0,211,0,6
3,2409,2491,-82,0,202,0,6
3,2587,2540,47,0,315,0,6
3,2349,2410,-61,0,245,0,6
3,2459,2396,63,0,200,0,6
3,2348,2430,-82,0,306,0,6
3,2452,2253,199,4,120,0,13
3,2412,2285,127,0,1,0,6
3,2412,2327,85,0,152,0,6
3,2346,2435,-89,0,102,0,6
3,2434,2429,5,0,172,0,6
3,2366,2411,-45,0,127,0,6
3,2436,2616,-180,0,6,0,6
3,2450,2712,-262,0,113,0,6
3,2500,2452,48,0,341,0,6
3,2450,2470,-20,0,313,0,6
3,2577,2563,14,0,304,0,6
3,2502,2490,12,0,6,0,6
3,2651,2635,16,0,310,0,6
3,2582,2595,-13,0,7,0,6
3,2635,2518,117,0,255,0,6
3,2598,2303,295,0,256,0,6
3,2331,2421,-90,0,45,0,6
3,2287,2410,-123,0,90,0,6
3,2353,2418,-65,0,192,0,6
3,2311,2462,-151,0,2,0,5
3,2435,2355,80,0,345,0,6
3,2374,2401,-27,0,167,0,6
3,2647,2571,76,0,106,0,6
3,2349,2448,-99,0,311,0,6
3,2308,2401,-93,0,4,0,6
3,2613,2512,101,0,33,0,6
3,2487,2551,-64,0,4,0,6
3,2394,2499,-105,0,43,0,6
3,2515,2587,-72,0,455,0,6
3,2576,2367,209,0,110,0,6
3,2203,2433,-230,0,345,0,6
3,2553,2524,29,0,304,0,6
3,2491,2602,-111,0,5,0,6
3,2510,2472,38,0,311,0,6
3,2601,2516,85,0,115,0,6
3,2409,2350,59,0,490,0,6
3,2527,2599,-72,0,321,0,6
3,2353,2453,-100,4,330,0,13
3,2497,2586,-89,0,37,0,6
3,2355,2547,-192,0,40,0,6
3,2585,2599,-14,0,210,0,6
3,2524,2490,34,0,4,0,6
3,2518,2390,128,0,7,0,6
3,2441,2294,147,0,140,0,6
3,2542,2509,33,0,401,0,6
3,2378,2611,-233,0,302,0,6
3,2514,2316,198,0,474,0,6
3,2709,2492,217,0,1,0,6
3,2419,2326,93,0,302,0,6
3,2587,2501,86,0,102,0,6
3,2397,2481,-84,0,15,0,6
3,2522,2545,-23,0,461,0,6
3,2410,2530,-120,0,406,0,6
3,2365,2412,-47,0,253,0,6
3,2243,2446,-203,4,42,0,13
3,2394,2615,-221,0,159,0,6
3,2545,2503,42,0,326,0,6
3,2523,2586,-63,0,404,0,6
3,2514,2442,72,0,241,0,6
3,2495,2584,-89,0,4,0,5
3,2492,2403,89,0,485,0,6
3,2531,2568,-37,0,345,0,6
3,2363,2427,-64,0,205,0,6
3,2642,2532,110,0,255,0,6
3,2302,2579,-277,0,104,0,6
3,2451,2346,105,0,4,0,6
3,2417,2539,-122,0,80,0,6
3,2534,2437,97,0,368,0,6
3,2640,2510,130,0,106,0,6
3,2537,2315,222,0,15,0,6
3,2550,2573,-23,0,302,0,6
3,2366,2706,-340,0,107,0,6
3,2496,2438,58,0,116,0,6
3,2274,2405,-131,0,135,0,6
3,2516,2573,-57,0,302,0,6
3,2314,2534,-220,0,40,0,6
3,2493,2317,176,0,302,0,6
3,2641,2523,118,0,115,0,6
3,2323,2490,-167,0,46,0,6
3,2329,2597,-268,0,104,0,6
3,2539,2519,20,0,329,0,6
3,2251,2409,-158,0,21,0,8
3,2282,2403,-121,0,212,0,6
3,2437,2306,131,0,140,0,6
3,2578,2355,223,0,168,0,6
3,2414,2441,-27,0,336,0,6
3,2324,2526,-202,0,152,0,6
3,2371,2444,-73,0,300,0,6
3,2366,2482,-116,0,190,0,6
3,2572,2641,-69,0,312,0,6
3,2577,2533,44,0,110,0,6
3,2546,2580,-34,0,57,0,6
3,2407,2306,101,0,11,0,6
3,2386,2529,-143,0,36,0,6
3,2425,2542,-117,0,112,0,6
3,2474,2516,-42,0,123,0,6
3,2579,2431,148,0,277,0,6
3,2560,2462,98,0,119,0,6
3,2502,2350,152,4,45,0,13
3,2527,2577,-50,0,37,0,6
3,2433,2640,-207,0,312,0,6
3,2541,2573,-32,0,1,0,6
3,2419,2234,185,0,151,0,6
3,2481,2549,-68,0,278,0,6
3,2637,2578,59,0,247,0,6
3,2523,2582,-59,0,28,0,6
3,2523,2426,97,0,108,0,6
3,2548,2546,2,0,406,0,6
3,2270,2420,-150,0,1,0,6
3,2613,2210,403,0,125,0,6
3,2588,2280,308,0,101,0,5
3,2578,2636,-58,0,4,0,6
3,2436,2567,-131,0,106,0,6
3,2579,2379,200,0,147,0,6
3,2429,2608,-179,0,0,0,6
3,2488,2222,266,0,112,0,6
3,2635,2442,193,0,250,0,6
3,2357,2457,-100,0,343,0,6
3,2586,2532,54,0,300,0,6
3,2449,2490,-41,0,110,0,6
3,2420,2487,-67,0,81,0,6
3,2449,2418,31,0,4,0,6
3,2343,2419,-76,0,145,0,6
3,2445,2388,57,0,338,0,6
3,2550,2557,-7,0,46,0,6
3,2437,2422,15,0,455,0,6
3,2530,2497,33,0,15,0,6
3,2557,2444,113,0,4,0,6
3,2479,2660,-181,0,6,0,6
3,2539,2556,-17,0,20,0,6
3,2420,2427,-7,0,151,0,6
3,2349,2443,-94,4,196,0,13
3,2555,2557,-2,0,4,0,6
3,2315,2421,-106,0,305,0,6
3,2444,2411,33,0,133,0,6
3,2419,2339,80,0,5,0,6
3,2597,2567,30,0,123,0,6
3,2507,2585,-78,0,106,0,6
3,2560,2445,115,0,31,0,6
3,2497,2597,-100,0,49,0,6
3,2541,2355,186,0,49,0,6
3,2403,2348,55,0,45,0,6
3,2345,2582,-237,0,4,0,6
3,2425,2425,0,0,31,0,6
3,2561,2497,64,0,461,0,6
3,2386,2504,-118,0,112,0,6
3,2474,2540,-66,0,102,0,6
3,2419,2322,97,0,303,0,6
3,2525,2463,62,0,45,0,6
3,2560,2584,-24,0,45,0,6
3,2437,2450,-13,0,112,0,6
3,2489,2540,-51,0,113,0,6
3,2397,2401,-4,0,115,0,6
3,2454,2331,123,0,106,0,6
3,2383,2422,-39,0,40,0,6
3,2500,2365,135,0,108,0,6
3,2453,2326,127,0,151,0,6
3,2317,2418,-101,0,302,0,6
3,2327,2416,-89,0,112,0,6
3,2498,2485,13,0,368,0,6
3,2374,2469,-95,0,40,0,6
3,2327,2501,-174,0,118,0,6
3,2457,2473,-16,0,132,0,6
3,2436,2543,-107,0,33,0,6
3,2400,2396,4,0,8,0,6
3,2471,2565,-94,0,215,0,6
3,2551,2526,25,0,380,0,6
3,2498,2355,143,0,465,0,6
3,2441,2407,34,0,218,0,6
3,2594,2435,159,4,374,0,13
3,2430,2432,-2,0,122,0,6
3,2311,2482,-171,0,123,0,5
3,2458,2314,144,0,140,0,6
3,2427,2321,106,0,201,0,6
3,2294,2469,-175,0,100,0,6
3,2391,2591,-200,0,150,0,6
3,2431,2506,-75,0,130,0,6
3,2414,2493,-79,0,106,0,6
3,2625,2630,-5,0,151,0,6
3,2528,2377,151,0,300,0,6
3,2425,2333,92,0,143,0,6
3,2399,2443,-44,0,101,0,6
3,2282,2424,-142,0,204,0,6
3,2557,2406,151,0,45,0,6
3,2444,2484,-40,0,365,0,6
3,2499,2554,-55,0,101,0,6
3,2297,2412,-115,0,392,0,8
3,2337,2463,-126,0,43,0,6
3,2413,2358,55,0,43,0,8
3,2425,2425,0,0,210,0,6
3,2425,2512,-87,0,47,0,6
3,2379,2432,-53,0,315,0,6
3,2245,2404,-159,0,211,0,6
3,2523,2408,115,0,41,0,8
3,2295,2473,-178,0,80,0,6
3,2399,2487,-88,0,40,0,6
3,2488,2209,279,0,249,0,8
3,2423,2430,-7,0,218,0,6
3,2381,2572,-191,0,13,0,6
3,2417,2313,104,0,48,0,6
3,2468,2445,23,0,123,0,6
3,2468,2428,40,0,335,0,6
3,2423,2275,148,0,303,0,6
3,2423,2281,142,0,207,0,6
3,2311,2480,-169,0,255,0,6
3,2430,2382,48,0,107,0,6
3,2601,2241,360,0,337,0,6
3,2413,2607,-194,0,301,0,6
3,2387,2512,-125,0,226,0,6
3,2401,2287,114,0,4,0,6
3,2296,2402,-106,0,211,0,6
3,2397,2418,-21,0,216,0,6
3,2354,2502,-148,0,46,0,6
3,2208,2428,-220,0,241,0,6
3,2583,2597,-14,0,453,0,6
3,2362,2479,-117,0,242,0,6
3,2384,2499,-115,0,45,0,6
3,2278,2420,-142,0,195,0,6
3,2549,2265,284,0,484,0,6
3,2401,2526,-125,0,300,0,8
3,2498,2442,56,0,112,0,6
3,2241,2466,-225,0,288,0,6
3,2293,2612,-319,0,107,0,6
3,2685,2810,-125,0,278,0,6
3,2381,2411,-30,0,130,0,6
3,2418,2383,35,0,5,0,6
3,2372,2476,-104,0,80,0,8
3,2412,2494,-82,0,133,0,6
3,2448,2396,52,0,277,0,6
3,2464,2301,163,0,36,0,6
3,2277,2486,-209,0,190,0,8
3,2392,2443,-51,0,45,0,6
3,2480,2280,200,0,197,0,8
3,2418,2433,-15,0,418,0,6
3,2510,2447,63,4,203,0,13
3,2210,2490,-280,0,40,0,6
3,2292,2457,-165,0,11,0,6
3,2418,2274,144,0,5,0,6
3,2350,2549,-199,0,253,0,6
3,2492,2322,170,0,302,0,6
3,2352,2538,-186,0,341,0,6
3,2342,2403,-61,0,112,0,6
3,2667,2619,48,0,121,0,6
3,2399,2526,-127,0,14,0,6
3,2461,2410,51,0,300,0,6
3,2571,2799,-228,0,205,0,6
3,2352,2539,-187,0,293,0,6
3,2418,2318,100,0,65,0,6
3,2334,2500,-166,0,46,0,8
3,2666,2581,85,0,0,0,6
3,2423,2583,-160,0,171,0,6
3,2646,2664,-18,0,246,0,6
3,2352,2540,-188,0,253,0,6
3,2474,2432,42,0,357,0,8
3,2428,2486,-58,0,331,0,6
3,2462,2331,131,0,347,0,6
3,2351,2540,-189,0,293,0,6
3,2461,2361,100,0,138,0,6
3,2315,2506,-191,0,6,0,6
3,2485,2488,-3,0,130,0,6
3,2327,2505,-178,0,104,0,6
3,2559,2429,130,0,373,0,6
3,2412,2355,57,0,106,0,6
3,2286,2415,-129,0,6,0,6
3,2545,2591,-46,0,218,0,6
3,2480,2454,26,0,102,0,6
3,2501,2531,-30,0,49,0,6
3,2507,2414,93,0,119,0,6
3,2425,2479,-54,0,4,0,6
3,2499,2204,295,0,8,0,6
3,2515,2544,-29,0,96,0,6
3,2579,2636,-57,0,100,0,6
3,2357,2494,-137,0,45,0,6
3,2703,2490,213,0,142,0,6
3,2339,2443,-104,0,343,0,6
3,2448,2480,-32,0,103,0,6
3,2487,2597,-110,0,380,0,6
3,2468,2459,9,0,190,0,6
3,2334,2419,-85,0,389,0,6
3,2557,2394,163,0,120,0,6
3,2416,2487,-71,0,40,0,6
3,2415,2326,89,0,7,0,6
3,2252,2439,-187,4,140,0,13
3,2418,2335,83,0,46,0,6
3,2491,2434,57,0,302,0,6
3,2312,2554,-242,0,201,0,6
3,2459,2468,-9,0,305,0,6
3,2393,2437,-44,0,0,0,6
3,2341,2516,-175,0,337,0,6
3,2366,2446,-80,0,424,0,6
3,2468,2459,9,0,190,0,6
3,2444,2615,-171,0,106,0,6
3,2360,2490,-130,0,317,0,6
3,2401,2509,-108,0,15,0,6
3,2521,2330,191,0,302,0,6
3,2330,2405,-75,0,150,0,6
3,2370,2428,-58,0,153,0,6
3,2468,2367,101,0,267,0,6
3,2421,2442,-21,4,200,0,13
3,2488,2554,-66,0,49,0,6
3,2342,2502,-160,0,1,0,6
3,2294,2450,-156,0,190,0,6
3,2369,2466,-97,0,305,0,6
3,2579,2393,186,0,245,0,6
3,2452,2388,64,0,158,0,6
3,2608,2623,-15,0,45,0,6
3,2420,2404,16,0,210,0,6
3,2576,2529,47,0,42,0,6
3,2521,2413,108,0,4,0,6
3,2414,2299,115,0,112,0,6
3,2288,2471,-183,0,197,0,8
3,2703,2577,126,0,172,0,6
3,2444,2613,-169,0,40,0,6
3,2392,2601,-209,0,320,0,6
3,2442,2384,58,4,201,0,13
3,2578,2553,25,0,112,0,6
3,2548,2405,143,0,133,0,6
3,2452,2431,21,0,41,0,6
3,2450,2392,58,0,200,0,6
3,2519,2388,131,0,105,0,6
3,2550,2553,-3,0,13,0,6
3,2395,2403,-8,0,1,0,6
3,2476,2404,72,0,256,0,6
3,2566,2554,12,0,310,0,6
3,2445,2520,-75,0,121,0,6
3,2390,2431,-41,0,41,0,6
3,2327,2410,-83,0,300,0,6
3,2467,2388,79,0,45,0,6
3,2560,2574,-14,0,46,0,6
3,2560,2426,134,0,106,0,6
3,2441,2296,145,0,409,0,6
3,2406,2236,170,0,123,0,6
3,2523,2544,-21,0,405,0,6
3,2395,2500,-105,0,45,0,6
3,2576,2560,16,0,101,0,6
3,2489,2518,-29,0,200,0,6
3,2334,2481,-147,0,436,0,8
3,2498,2397,101,0,4,0,6
3,2479,2369,110,0,453,0,8
3,2432,2426,6,0,256,0,6
3,2425,2341,84,0,107,0,6
3,2509,2497,12,0,20,0,6
3,2467,2306,161,0,0,0,6
3,2457,2355,102,0,150,0,6
3,2415,2566,-151,0,1,0,6
3,2377,2445,-68,0,305,0,6
3,2545,2504,41,0,248,0,6
3,2338,2409,-71,0,255,0,6
3,2589,2723,-134,0,115,0,6
3,2361,2403,-42,0,409,0,6
3,2645,2528,117,0,411,0,6
3,2505,2544,-39,0,354,0,6
3,2556,2528,28,2,483,0,24
3,2473,2544,-71,0,300,0,6
3,2629,2643,-14,0,4,0,6
3,2403,2435,-32,0,0,0,6
3,2475,2352,123,0,8,0,8
3,2520,2374,146,0,193,0,6
3,2462,2235,227,0,0,0,6
3,2430,2459,-29,0,1,0,6
3,2456,2425,31,0,203,0,6
3,2424,2373,51,0,148,0,6
3,2433,2411,22,0,190,0,6
3,2670,2552,118,0,300,0,6
3,2410,2389,21,0,45,0,6
3,2259,2450,-191,0,49,0,6
3,2478,2432,46,0,300,0,6
3,2654,2618,36,0,123,0,6
3,2427,2323,104,0,343,0,6
3,2470,2415,55,0,109,0,6
3,2552,2498,54,0,115,0,6
3,2352,2432,-80,0,380,0,8
3,2416,2411,5,0,40,0,6
3,2379,2434,-55,0,50,0,6
3,2235,2413,-178,0,122,0,6
3,2427,2401,26,0,292,0,6
3,2551,2519,32,0,115,0,6
3,2305,2414,-109,0,33,0,6
3,2464,2361,103,0,112,0,6
3,2362,2441,-79,0,54,0,6
3,2494,2498,-4,0,101,0,6
3,2391,2443,-52,0,40,0,6
3,2612,2548,64,0,343,0,6
3,2467,2342,125,0,412,0,6
3,2311,2497,-186,0,301,0,6
3,2469,2553,-84,0,6,0,6
3,2407,2336,71,0,374,0,6
3,2395,2443,-48,0,106,0,6
3,2331,2411,-80,0,40,0,6
3,2465,2394,71,0,33,0,6
3,2593,2450,143,0,37,0,6
3,2529,2532,-3,0,47,0,6
3,2435,2402,33,0,201,0,6
3,2548,2668,-120,0,0,0,6
3,2452,2450,2,0,352,0,6
3,2410,2315,95,0,120,0,6
3,2479,2441,38,0,141,0,6
3,2406,2306,100,0,374,0,6
3,2666,2573,93,0,30,0,6
3,2417,2321,96,0,133,0,6
3,2648,2577,71,0,1,0,6
3,2421,2271,150,0,302,0,6
3,2595,2617,-22,0,343,0,6
3,2378,2466,-88,0,424,0,6
3,2389,2434,-45,0,125,0,6
3,2489,2316,173,0,201,0,6
3,2423,2343,80,0,110,0,6
3,2518,2667,-149,0,80,0,6
3,2366,2441,-75,0,48,0,6
3,2476,2547,-71,0,60,0,6
3,2475,2354,121,0,145,0,8
3,2408,2376,32,0,334,0,6
3,2404,2309,95,0,374,0,6
3,2401,2287,114,0,28,0,6
3,2395,2442,-47,0,4,0,8
3,2401,2521,-120,0,101,0,6
3,2447,2459,-12,0,110,0,6
3,2423,2338,85,0,312,0,6
3,2356,2472,-116,0,190,0,8
3,2561,2665,-104,0,310,0,6
3,2448,2306,142,0,102,0,6
3,2525,2412,113,0,43,0,6
3,2455,2439,16,0,14,0,6
3,2469,2358,111,0,248,0,8
3,2447,2441,6,0,331,0,6
3,2528,2442,86,0,50,0,6
3,2417,2457,-40,4,45,0,13
3,2440,2390,50,0,112,0,6
3,2310,2447,-137,0,310,0,6
3,2515,2460,55,0,45,0,6
3,2441,2400,41,0,200,0,6
3,2273,2413,-140,0,332,0,6
3,2605,2521,84,0,132,0,6
3,2417,2255,162,4,5,0,8
3,2556,2466,90,0,194,0,8
3,2548,2688,-140,0,312,0,6
3,2393,2432,-39,0,207,0,6
3,2686,2531,155,0,169,0,6
3,2318,2419,-101,2,202,0,23
3,2410,2305,105,0,119,0,6
3,2529,2522,7,0,20,0,6
3,2442,2536,-94,0,400,0,6
3,2469,2391,78,0,200,0,6
3,2474,2204,270,4,45,0,8
3,2474,2409,65,0,333,0,6
3,2262,2561,-299,0,278,0,6
3,2475,2415,60,0,62,0,6
3,2273,2452,-179,0,28,0,6
3,2428,2462,-34,0,45,0,6
3,2304,2438,-134,0,7,0,6
3,2506,2466,40,0,120,0,6
3,2427,2367,60,0,122,0,6
3,2432,2320,112,0,301,0,8
3,2394,2546,-152,0,302,0,6
3,2417,2451,-34,0,48,0,6
3,2525,2681,-156,0,357,0,6
3,2699,2594,105,0,101,0,6
3,2410,2310,100,0,131,0,6
3,2357,2535,-178,0,250,0,6
3,2534,2492,42,0,311,0,6
3,2372,2417,-45,0,46,0,6
3,2532,2359,173,0,200,0,6
3,2376,2452,-76,0,1,0,6
3,2527,2701,-174,0,300,0,6
3,2591,2534,57,0,106,0,6
3,2593,2401,192,0,120,0,6
3,2425,2663,-238,0,310,0,6
3,2455,2428,27,0,102,0,6
3,2463,2466,-3,0,302,0,6
3,2403,2336,67,0,28,0,6
3,2400,2421,-21,0,404,0,6
3,2546,2641,-95,0,14,0,6
3,2459,2434,25,0,109,0,6
3,2296,2463,-167,0,404,0,6
3,2426,2355,71,0,4,0,6
3,2489,2459,30,0,5,0,6
3,2435,2422,13,0,301,0,6
3,2402,2400,2,0,10,0,6
3,2352,2420,-68,0,426,0,6
3,2405,2539,-134,0,45,0,6
3,2419,2400,19,0,103,0,6
3,2394,2458,-64,0,485,0,6
3,2397,2422,-25,0,122,0,6
3,2442,2337,105,0,135,0,6
3,2416,2385,31,0,8,0,6
3,2481,2388,93,0,484,0,6
3,2475,2462,13,0,190,0,6
3,2418,2299,119,0,205,0,6
3,2422,2398,24,0,120,0,6
3,2450,2459,-9,0,250,0,6
3,2359,2505,-146,0,264,0,6
3,2536,2650,-114,0,278,0,6
3,2476,2609,-133,0,335,0,6
3,2494,2436,58,0,7,0,6
3,2404,2502,-98,0,264,0,6
3,2468,2559,-91,0,249,0,8
3,2554,2414,140,0,101,0,6
3,2452,2406,46,0,62,0,6
3,2517,2461,56,0,123,0,6
3,2409,2345,64,0,88,0,6
3,2461,2388,73,0,487,0,6
3,2586,2558,28,0,208,0,6
3,2434,2470,-36,0,295,0,6
3,2456,2556,-100,0,374,0,6
3,2446,2233,213,0,114,0,8
3,2363,2484,-121,0,3,0,6
3,2402,2408,-6,0,120,0,6
3,2488,2363,125,0,84,0,6
3,2362,2409,-47,0,242,0,6
3,2377,2475,-98,0,461,0,6
3,2298,2463,-165,0,120,0,6
3,2409,2336,73,0,458,0,6
3,2430,2461,-31,0,194,0,6
3,2416,2430,-14,0,490,0,6
3,2438,2455,-17,0,27,0,6
3,2683,2648,35,0,404,0,6
3,2416,2441,-25,0,57,0,6
3,2470,2476,-6,0,140,0,6
3,2422,2346,76,0,200,0,6
3,2393,2509,-116,0,218,0,6
3,2482,2391,91,0,13,0,6
3,2396,2459,-63,0,121,0,6
3,2483,2294,189,0,258,0,6
3,2592,2433,159,0,345,0,6
3,2437,2487,-50,0,196,0,6
3,2292,2415,-123,0,40,0,6
3,2422,2473,-51,0,463,0,6
3,2463,2368,95,0,311,0,6
3,2420,2429,-9,0,210,0,6
3,2381,2463,-82,0,463,0,6
3,2491,2288,203,0,6,0,6
3,2501,2298,203,0,40,0,6
3,2567,2415,152,0,109,0,6
3,2412,2413,-1,0,114,0,6
3,2562,2494,68,0,408,0,6
3,2366,2568,-202,0,416,0,6
3,2410,2444,-34,0,125,0,6
3,2398,2441,-43,0,57,0,6
3,2238,2536,-298,0,448,0,6
3,2202,2447,-245,0,41,0,8
3,2413,2305,108,0,122,0,6
3,2439,2391,48,0,31,0,6
3,2427,2391,36,0,410,0,6
3,2507,2478,29,0,46,0,6
3,2273,2407,-134,4,300,0,13
3,2303,2459,-156,0,485,0,6
3,2364,2411,-47,0,110,0,6
3,2391,2427,-36,0,356,0,6
3,2412,2495,-83,0,1,0,6
3,2411,2398,13,0,146,0,6
3,2741,2684,57,0,265,0,6
3,2405,2283,122,4,41,0,13
3,2410,2407,3,0,300,0,6
3,2464,2442,22,0,43,0,6
3,2213,2439,-226,0,110,0,8
3,2521,2450,71,0,4,0,6
3,2483,2479,4,0,315,0,6
3,2398,2420,-22,0,200,0,6
3,2488,2250,238,0,106,0,6
3,2401,2272,129,0,101,0,6
3,2683,2739,-56,0,404,0,6
3,2569,2601,-32,0,419,0,6
3,2320,2431,-111,0,40,0,6
3,2436,2217,219,0,49,0,8
3,2364,2475,-111,0,45,0,6
3,2585,2705,-120,0,140,0,6
3,2373,2449,-76,0,229,0,6
3,2473,2587,-114,0,112,0,6
3,2499,2585,-86,0,405,0,6
3,2359,2442,-83,0,133,0,6
3,2322,2448,-126,0,354,0,6
3,2387,2434,-47,0,102,0,6
3,2500,2325,175,0,337,0,6
3,2583,2476,107,0,101,0,6
3,2696,2412,284,0,5,0,6
3,2468,2487,-19,0,456,0,6
3,2328,2692,-364,0,122,0,6
3,2456,2310,146,0,241,0,5
3,2487,2423,64,0,152,0,6
3,2295,2443,-148,0,190,0,6
3,2346,2426,-80,0,130,0,6
3,2377,2445,-68,0,250,0,6
3,2215,2401,-186,0,200,0,6
3,2446,2217,229,0,156,0,6
3,2544,2588,-44,0,5,0,6
3,2469,2485,-16,0,310,0,6
3,2379,2405,-26,0,211,0,6
3,2428,2423,5,0,302,0,8
3,2490,2341,149,0,106,0,6
3,2431,2419,12,0,302,0,6
3,2531,2546,-15,0,334,0,6
3,2401,2460,-59,0,311,0,6
3,2603,2458,145,0,40,0,6
3,2406,2391,15,0,343,0,6
3,2536,2419,117,0,341,0,8
3,2396,2418,-22,0,40,0,6
3,2359,2488,-129,0,319,0,6
3,2461,2601,-140,0,301,0,6
3,2418,2476,-58,0,110,0,8
3,2473,2366,107,0,302,0,6
3,2275,2455,-180,0,388,0,6
3,2475,2299,176,0,48,0,8
3,2409,2441,-32,0,0,0,6
3,2427,2458,-31,0,226,0,6
3,2542,2405,137,0,48,0,6
3,2345,2401,-56,0,133,0,6
3,2400,2346,54,0,43,0,6
3,2403,2412,-9,0,106,0,6
3,2265,2422,-157,0,105,0,8
3,2437,2415,22,0,112,0,6
3,2411,2424,-13,0,311,0,6
3,2413,2412,1,0,107,0,6
3,2536,2565,-29,0,278,0,6
3,2425,2381,44,0,191,0,6
3,2407,2355,52,0,150,0,6
3,2417,2221,196,0,404,0,6
3,2315,2460,-145,0,45,0,6
3,2326,2422,-96,0,110,0,6
3,2585,2573,12,0,140,0,6
3,2458,2500,-42,0,335,0,6
3,2416,2405,11,0,407,0,6
3,2432,2565,-133,0,253,0,6
3,2573,2584,-11,0,226,0,6
3,2532,2497,35,0,15,0,6
3,2343,2430,-87,0,315,0,8
3,2425,2502,-77,0,4,0,6
3,2457,2326,131,0,225,0,6
3,2340,2422,-82,0,224,0,6
3,2424,2424,0,0,400,0,6
3,2433,2488,-55,0,4,0,6
3,2408,2484,-76,0,8,0,6
3,2376,2592,-216,4,242,0,13
3,2534,2448,86,0,256,0,6
3,2239,2473,-234,0,269,0,6
3,2303,2444,-141,0,46,0,6
3,2464,2484,-20,0,67,0,6
3,2422,2513,-91,0,40,0,6
3,2398,2495,-97,0,380,0,6
3,2407,2367,40,0,104,0,6
3,2493,2341,152,0,106,0,6
3,2529,2445,84,0,303,0,6
3,2430,2393,37,0,115,0,6
3,2488,2424,64,0,457,0,6
3,2547,2504,43,0,15,0,6
3,2352,2423,-71,0,300,0,6
3,2436,2309,127,0,61,0,6
3,2492,2337,155,0,150,0,6
3,2398,2433,-35,0,143,0,6
3,2394,2526,-132,0,311,0,6
3,2285,2421,-136,0,16,0,6
3,2229,2461,-232,0,142,0,8
3,2431,2429,2,0,123,0,6
3,2544,2392,152,0,455,0,6
3,2448,2301,147,0,315,0,6
3,2435,2472,-37,0,302,0,6
3,2434,2481,-47,0,107,0,6
3,2412,2303,109,0,130,0,6
3,2461,2433,28,0,453,0,6
3,2401,2409,-8,0,211,0,6
3,2333,2414,-81,0,344,0,6
3,2592,2578,14,0,265,0,6
3,2489,2320,169,0,426,0,6
3,2469,2353,116,4,240,0,13
3,2409,2418,-9,0,49,0,6
3,2519,2487,32,0,153,0,6
3,2485,2429,56,0,20,0,6
3,2443,2431,12,0,302,0,6
3,2328,2467,-139,4,381,0,13
3,2420,2302,118,0,292,0,6
3,2472,2391,81,0,127,0,6
3,2387,2434,-47,0,11,0,6
3,2413,2481,-68,0,345,0,6
3,2530,2479,51,0,0,0,6
3,2427,2522,-95,0,484,0,6
3,2573,2578,-5,0,101,0,6
3,2399,2411,-12,0,415,0,6
3,2551,2527,24,0,337,0,6
3,2524,2422,102,0,474,0,6
3,2406,2431,-25,0,311,0,6
3,2417,2477,-60,0,190,0,6
3,2402,2419,-17,0,202,0,6
3,2387,2421,-34,0,49,0,6
3,2618,2465,153,0,290,0,6
3,2400,2362,38,0,152,0,6
3,2460,2512,-52,0,190,0,6
3,2472,2412,60,0,327,0,6
3,2318,2474,-156,0,45,0,6
3,2402,2247,155,0,40,0,6
3,2430,2448,-18,0,117,0,6
3,2458,2493,-35,0,331,0,6
3,2537,2454,83,0,453,0,6
3,2505,2561,-56,0,28,0,6
3,2398,2449,-51,0,302,0,6
3,2415,2355,60,0,263,0,6
3,2406,2443,-37,0,20,0,8
3,2455,2536,-81,0,80,0,6
3,2399,2448,-49,0,173,0,6
3,2424,2369,55,0,122,0,6
3,2383,2487,-104,0,258,0,6
3,2437,2387,50,0,404,0,6
3,2429,2423,6,0,261,0,6
3,2405,2378,27,0,193,0,6
3,2533,2621,-88,0,49,0,6
3,2368,2460,-92,0,12,0,6
3,2359,2448,-89,0,102,0,6
3,2410,2334,76,0,106,0,6
3,2311,2439,-128,0,300,0,6
3,2313,2481,-168,0,40,0,6
3,2447,2352,95,0,40,0,6
3,2422,2351,71,0,40,0,6
3,2453,2457,-4,0,255,0,6
3,2474,2461,13,0,10,0,6
3,2515,2533,-18,0,315,0,6
3,2541,2581,-40,0,20,0,6
3,2514,2217,297,4,194,0,18
3,2445,2442,3,0,300,0,6
3,2434,2525,-91,0,110,0,6
3,2514,2581,-67,0,43,0,6
3,2464,2445,19,0,0,0,6
3,2365,2470,-105,0,301,0,6
3,2658,2600,58,0,332,0,6
3,2457,2535,-78,0,310,0,6
3,2524,2435,89,0,36,0,6
3,2384,2490,-106,0,409,0,6
3,2442,2292,150,0,265,0,6
3,2480,2461,19,0,152,0,6
3,2298,2431,-133,0,302,0,6
3,2411,2251,160,0,241,0,6
3,2587,2309,278,0,327,0,6
3,2473,2456,17,0,25,0,6
3,2480,2376,104,0,151,0,6
3,2420,2411,9,0,104,0,6
3,2481,2445,36,0,141,0,6
3,2407,2365,42,0,48,0,6
3,2526,2377,149,0,46,0,6
3,2569,2384,185,0,106,0,8
3,2574,2548,26,0,30,0,6
3,2471,2616,-145,0,8,0,6
3,2245,2410,-165,0,302,0,6
3,2427,2493,-66,0,4,0,6
3,2365,2406,-41,0,31,0,6
3,2309,2491,-182,0,4,0,6
3,2284,2566,-282,0,300,0,8
3,2414,2411,3,0,48,0,6
3,2614,2511,103,0,378,0,6
3,2478,2471,7,0,46,0,6
3,2289,2414,-125,0,310,0,6
3,2471,2478,-7,0,110,0,6
3,2558,2426,132,0,123,0,6
3,2504,2485,19,0,45,0,6
3,2286,2417,-131,0,112,0,6
3,2499,2305,194,0,120,0,6
3,2472,2211,261,0,130,0,6
3,2485,2255,230,0,123,0,6
3,2563,2519,44,0,456,0,6
3,2437,2471,-34,0,248,0,6
3,2406,2394,12,0,110,0,6
3,2200,2480,-280,0,30,0,8
3,2432,2577,-145,0,301,0,6
3,2285,2509,-224,0,300,0,8
3,2415,2517,-102,0,46,0,6
3,2239,2421,-182,0,300,0,6
3,2509,2453,56,0,57,0,6
3,2520,2278,242,0,31,0,6
3,2604,2355,249,0,337,0,6
3,2699,2694,5,0,160,0,6
3,2428,2538,-110,0,190,0,6
3,2611,2608,3,0,150,0,6
3,2418,2468,-50,0,101,0,6
3,2470,2465,5,0,201,0,6
3,2435,2431,4,0,105,0,6
3,2334,2413,-79,0,140,0,6
3,2373,2407,-34,0,49,0,6
3,2274,2413,-139,0,414,0,8
3,2613,2530,83,0,404,0,6
3,2467,2441,26,0,34,0,6
3,2499,2406,93,0,6,0,6
3,2467,2511,-44,0,11,0,6
3,2397,2441,-44,0,4,0,6
3,2270,2510,-240,0,113,0,6
3,2467,2470,-3,0,57,0,6
3,2563,2357,206,0,52,0,6
3,2433,2247,186,0,4,0,6
3,2606,2434,172,0,307,0,6
3,2320,2412,-92,0,1,0,6
3,2256,2434,-178,0,244,0,6
3,2531,2518,13,0,40,0,6
3,2528,2397,131,0,100,0,6
3,2498,2361,137,0,64,0,6
3,2473,2318,155,0,21,0,6
3,2399,2526,-127,0,0,0,6
3,2293,2417,-124,0,49,0,6
3,2570,2655,-85,0,107,0,6
3,2496,2544,-48,0,227,0,6
3,2449,2447,2,0,46,0,6
3,2231,2548,-317,0,292,0,6
3,2279,2418,-139,0,200,0,6
3,2402,2218,184,0,111,0,6
3,2475,2465,10,0,36,0,6
3,2620,2571,49,0,300,0,6
3,2366,2412,-46,0,331,0,6
3,2641,2524,117,0,174,0,6
3,2423,2517,-94,0,100,0,6
3,2382,2468,-86,0,46,0,6
3,2712,2689,23,0,38,0,6
3,2442,2421,21,0,207,0,6
3,2522,2657,-135,0,4,0,6
3,2477,2383,94,0,16,0,6
3,2444,2317,127,0,80,0,6
3,2498,2479,19,0,151,0,6
3,2473,2518,-45,0,410,0,6
3,2694,2476,218,0,7,0,6
3,2421,2546,-125,0,106,0,6
3,2425,2539,-114,0,45,0,6
3,2655,2564,91,0,14,0,6
3,2609,2764,-155,0,81,0,6
3,2403,2467,-64,4,50,0,13
3,2587,2555,32,0,125,0,6
3,2256,2408,-152,0,128,0,6
3,2464,2587,-123,0,15,0,6
3,2473,2353,120,0,209,0,6
3,2406,2236,170,0,107,0,6
3,2514,2347,167,0,101,0,6
3,2401,2334,67,0,415,0,6
3,2707,2701,6,0,9,0,6
3,2206,2446,-240,0,120,0,6
3,2410,2428,-18,0,394,0,6
3,2445,2401,44,0,132,0,6
3,2268,2430,-162,0,255,0,6
3,2445,2550,-105,0,202,0,6
3,2448,2292,156,0,302,0,6
3,2347,2406,-59,0,0,0,6
3,2421,2326,95,0,106,0,6
3,2419,2394,25,0,245,0,8
3,2315,2455,-140,0,107,0,8
3,2403,2303,100,0,302,0,6
3,2548,2487,61,0,280,0,6
3,2351,2466,-115,0,130,0,6
3,2404,2282,122,0,140,0,8
3,2453,2282,171,0,45,0,6
3,2505,2671,-166,0,395,0,6
3,2514,2510,4,0,270,0,6
3,2540,2406,134,0,13,0,6
3,2422,2396,26,0,267,0,6
3,2402,2445,-43,0,80,0,6
3,2390,2400,-10,0,331,0,6
3,2508,2539,-31,0,436,0,6
3,2589,2568,21,0,228,0,6
3,2541,2619,-78,0,490,0,6
3,2420,2343,77,0,485,0,6
3,2594,2359,235,0,45,0,6
3,2281,2618,-337,0,315,0,6
3,2426,2395,31,0,117,0,6
3,2379,2423,-44,0,127,0,6
3,2492,2545,-53,0,280,0,6
3,2451,2417,34,0,400,0,6
3,2404,2357,47,4,101,0,13
3,2432,2283,149,0,123,0,6
3,2426,2367,59,0,403,0,6
3,2409,2239,170,4,305,0,18
3,2544,2494,50,0,280,0,6
3,2423,2302,121,4,152,0,13
3,2411,2409,2,0,8,0,6
3,2380,2427,-47,0,216,0,6
3,2457,2518,-61,0,107,0,6
3,2586,2426,160,0,121,0,6
3,2410,2330,80,0,115,0,6
3,2561,2623,-62,0,102,0,6
3,2470,2397,73,0,343,0,6
3,2587,2458,129,0,345,0,6
3,2449,2463,-14,0,101,0,6
3,2399,2469,-70,0,210,0,6
3,2609,2307,302,0,300,0,6
3,2578,2536,42,0,331,0,6
3,2452,2302,150,0,58,0,6
3,2341,2463,-122,0,440,0,6
3,2478,2206,272,0,289,0,6
3,2408,2278,130,0,457,0,6
3,2524,2570,-46,0,46,0,6
3,2438,2580,-142,0,48,0,6
3,2574,2395,179,4,460,0,10
3,2319,2415,-96,0,302,0,6
3,2332,2413,-81,0,122,0,6
3,2569,2366,203,4,84,0,10
3,2387,2436,-49,0,150,0,6
3,2236,2403,-167,0,101,0,8
3,2315,2606,-291,0,70,0,6
3,2452,2522,-70,0,57,0,6
3,2545,2481,64,0,406,0,6
3,2513,2525,-12,0,300,0,6
3,2532,2448,84,0,152,0,6
3,2544,2412,132,0,0,0,6
3,2422,2266,156,4,277,0,13
3,2306,2445,-139,0,301,0,6
3,2328,2581,-253,0,48,0,8
3,2424,2576,-152,0,126,0,6
3,2388,2407,-19,0,45,0,6
3,2510,2491,19,4,45,0,13
3,2412,2345,67,0,102,0,6
3,2525,2528,-3,0,47,0,6
3,2424,2619,-195,4,152,0,10
3,2438,2373,65,0,288,0,8
3,2603,2360,243,0,304,0,8
3,2260,2574,-314,0,34,0,8
3,2402,2401,1,4,247,0,10
3,2609,2282,327,4,37,0,10
3,2318,2473,-155,0,245,0,5
3,2398,2402,-4,4,80,0,10
3,2379,2455,-76,0,40,0,6
3,2410,2433,-23,4,152,0,10
3,2300,2402,-102,4,85,0,10
3,2356,2595,-239,4,122,0,10
3,2417,2449,-32,0,136,0,6
3,2420,2313,107,0,4,0,6
3,2483,2417,66,0,395,0,6
3,2385,2520,-135,0,108,0,6
3,2471,2276,195,0,200,0,5
3,2493,2330,163,0,311,0,6
3,2547,2479,68,0,50,0,6
3,2419,2371,48,0,375,0,6
3,2395,2502,-107,0,405,0,6
3,2468,2590,-122,0,201,0,6
3,2434,2434,0,0,4,0,6
3,2556,2434,122,0,410,0,6
3,2379,2450,-71,0,1,0,6
3,2556,2589,-33,0,335,0,6
3,2375,2580,-205,0,119,0,6
3,2367,2542,-175,0,21,0,6
3,2532,2527,5,0,0,0,6
3,2544,2545,-1,0,37,0,6
3,2502,2503,-1,0,0,0,6
3,2632,2618,14,0,280,0,6
3,2470,2579,-109,0,228,0,6
3,2456,2384,72,0,270,0,6
3,2581,2554,27,0,344,0,6
3,2511,2539,-28,0,107,0,6
3,2579,2625,-46,0,270,0,6
3,2255,2421,-166,0,200,0,6
3,2554,2533,21,0,317,0,6
3,2439,2392,47,0,412,0,6
3,2555,2397,158,0,398,0,6
3,2363,2442,-79,0,203,0,6
3,2367,2405,-38,0,303,0,6
3,2403,2245,158,0,16,0,8
3,2433,2461,-28,0,241,0,6
3,2530,2544,-14,0,80,0,6
3,2527,2428,99,0,13,0,6
3,2435,2409,26,0,313,0,6
3,2500,2368,132,0,339,0,6
3,2325,2414,-89,0,310,0,6
3,2476,2372,104,0,263,0,6
3,2489,2640,-151,0,301,0,6
3,2535,2345,190,0,40,0,6
3,2440,2580,-140,0,151,0,6
3,2425,2306,119,0,373,0,6
3,2545,2530,15,0,330,0,6
3,2532,2562,-30,0,43,0,6
3,2560,2389,171,0,100,0,6
3,2397,2460,-63,0,228,0,6
3,2259,2431,-172,0,40,0,6
3,2576,2558,18,0,300,0,6
3,2415,2279,136,0,373,0,6
3,2401,2363,38,0,373,0,8
3,2484,2558,-74,0,313,0,6
3,2512,2277,235,0,242,0,6
3,2422,2460,-38,0,455,0,6
3,2550,2543,7,0,1,0,6
3,2506,2345,161,0,40,0,6
3,2532,2509,23,0,2,0,6
3,2455,2387,68,0,15,0,6
3,2423,2450,-27,0,126,0,6
3,2437,2462,-25,4,260,0,13
3,2395,2455,-60,0,143,0,6
3,2529,2623,-94,0,345,0,6
3,2541,2480,61,0,43,0,6
3,2338,2575,-237,0,3,0,6
3,2353,2446,-93,0,203,0,6
3,2401,2414,-13,0,121,0,6
3,2530,2561,-31,0,13,0,6
3,2513,2439,74,0,108,0,6
3,2528,2575,-47,0,133,0,6
3,2526,2574,-48,0,133,0,6
3,2457,2367,90,0,101,0,6
3,2539,2513,26,0,43,0,6
3,2348,2453,-105,0,405,0,6
3,2541,2266,275,0,106,0,6
3,2580,2273,307,0,100,0,6
3,2522,2578,-56,0,133,0,6
3,2541,2608,-67,0,18,0,6
3,2359,2554,-195,0,341,0,6
3,2395,2501,-106,0,380,0,6
3,2610,2578,32,0,263,0,6
3,2515,2403,112,0,31,0,6
3,2451,2383,68,0,334,0,8
3,2322,2406,-84,0,122,0,6
3,2424,2460,-36,0,120,0,6
3,2521,2460,61,0,369,0,6
3,2581,2537,44,0,1,0,6
3,2404,2227,177,0,4,0,6
3,2297,2451,-154,0,101,0,6
3,2440,2249,191,0,311,0,6
3,2612,2398,214,0,121,0,6
3,2564,2599,-35,0,11,0,6
3,2504,2421,83,0,112,0,6
3,2531,2553,-22,0,3,0,6
3,2541,2569,-28,0,140,0,6
3,2482,2396,86,0,188,0,6
3,2470,2202,268,0,200,0,5
3,2266,2506,-240,0,242,0,6
3,2353,2576,-223,0,115,0,6
3,2414,2409,5,0,7,0,6
3,2414,2377,37,0,277,0,6
3,2321,2452,-131,0,9,0,6
3,2567,2610,-43,0,151,0,6
3,2328,2461,-133,0,388,0,6
3,2424,2489,-65,0,103,0,6
3,2431,2489,-58,0,40,0,6
3,2436,2380,56,0,400,0,8
3,2542,2558,-16,0,4,0,6
3,2310,2408,-98,0,30,0,6
3,2245,2493,-248,0,6,0,6
3,2503,2323,180,0,45,0,6
3,2392,2402,-10,0,6,0,6
3,2324,2469,-145,0,24,0,6
3,2454,2514,-60,0,302,0,6
3,2488,2432,56,0,206,0,6
3,2264,2425,-161,0,4,0,6
3,2407,2363,44,0,469,0,6
3,2372,2502,-130,0,226,0,6
3,2316,2414,-98,0,106,0,6
3,2621,2647,-26,0,107,0,6
3,2373,2436,-63,0,39,0,6
3,2250,2436,-186,0,100,0,8
3,2442,2234,208,0,112,0,8
3,2470,2551,-81,0,96,0,6
3,2429,2600,-171,0,100,0,6
3,2527,2409,118,0,45,0,6
3,2460,2436,24,0,107,0,6
3,2581,2539,42,0,2,0,6
3,2416,2320,96,0,120,0,6
3,2440,2261,179,0,130,0,6
3,2400,2488,-88,0,23,0,6
3,2453,2391,62,0,151,0,6
3,2582,2501,81,0,442,0,6
3,2331,2470,-139,0,2,0,6
3,2475,2472,3,0,245,0,6
3,2402,2481,-79,4,112,0,13
3,2290,2502,-212,0,106,0,6
3,2448,2602,-154,0,389,0,6
3,2211,2458,-247,4,113,0,18
3,2296,2599,-303,0,100,0,6
3,2436,2383,53,0,343,0,6
3,2375,2439,-64,0,100,0,8
3,2556,2533,23,0,258,0,6
3,2288,2450,-162,0,100,0,6
3,2429,2429,0,0,112,0,6
3,2407,2379,28,0,343,0,6
3,2593,2475,118,0,106,0,6
3,2285,2438,-153,0,125,0,6
3,2416,2413,3,0,46,0,6
3,2323,2425,-102,4,122,0,13
3,2415,2348,67,0,139,0,6
3,2458,2433,25,0,10,0,6
3,2336,2431,-95,0,200,0,6
3,2474,2403,71,4,405,0,13
3,2394,2515,-121,0,101,0,8
3,2493,2503,-10,0,120,0,6
3,2361,2410,-49,0,306,0,6
3,2393,2617,-224,0,5,0,6
3,2419,2271,148,0,15,0,6
3,2421,2532,-111,0,260,0,6
3,2317,2400,-83,0,7,0,6
3,2516,2542,-26,0,48,0,6
3,2268,2445,-177,0,20,0,6
3,2380,2417,-37,0,258,0,6
3,2457,2578,-121,0,45,0,6
3,2424,2435,-11,0,112,0,6
3,2459,2445,14,0,4,0,6
3,2492,2360,132,0,140,0,6
3,2457,2455,2,0,335,0,6
3,2294,2450,-156,0,0,0,6
3,2463,2265,198,0,100,0,6
3,2253,2402,-149,0,453,0,8
3,2564,2533,31,0,245,0,6
3,2298,2487,-189,0,112,0,6
3,2397,2447,-50,0,6,0,6
3,2528,2660,-132,0,13,0,6
3,2442,2427,15,0,244,0,6
3,2562,2576,-14,0,303,0,6
3,2481,2512,-31,0,41,0,6
3,2407,2381,26,0,9,0,6
3,2453,2307,146,0,107,0,6
3,2220,2469,-249,0,123,0,6
3,2400,2390,10,0,201,0,8
3,2417,2417,0,0,454,0,6
3,2430,2364,66,0,245,0,6
3,2313,2407,-94,0,43,0,6
3,2571,2377,194,0,41,0,6
3,2551,2531,20,0,302,0,6
3,2563,2543,20,0,136,0,6
3,2514,2666,-152,0,49,0,6
3,2361,2411,-50,0,40,0,6
3,2416,2310,106,0,250,0,6
3,2335,2491,-156,0,230,0,6
3,2509,2438,71,0,483,0,6
3,2767,2750,17,0,380,0,6
3,2430,2521,-91,0,28,0,6
3,2688,2648,40,0,101,0,6
3,2406,2308,98,0,4,0,6
3,2425,2456,-31,0,312,0,6
3,2263,2408,-145,0,4,0,6
3,2571,2486,85,0,40,0,6
3,2560,2224,336,0,49,0,6
3,2365,2523,-158,0,45,0,6
3,2368,2418,-50,0,38,0,6
3,2359,2402,-43,0,15,0,6
3,2442,2254,188,0,243,0,6
3,2229,2538,-309,0,302,0,6
3,2425,2555,-130,0,13,0,6
3,2448,2396,52,0,314,0,6
3,2346,2416,-70,0,341,0,6
3,2403,2486,-83,0,277,0,6
3,2412,2300,112,0,455,0,6
3,2401,2490,-89,0,25,0,6
3,2276,2408,-132,0,452,0,8
3,2404,2253,151,0,300,0,6
3,2362,2416,-54,0,123,0,6
3,2375,2513,-138,0,428,0,6
3,2543,2492,51,0,20,0,6
3,2459,2310,149,0,45,0,6
3,2433,2241,192,0,100,0,6
3,2443,2284,159,0,132,0,6
3,2409,2312,97,0,201,0,6
3,2527,2539,-12,0,45,0,6
3,2413,2554,-141,0,112,0,6
3,2604,2401,203,0,225,0,6
3,2382,2512,-130,0,46,0,6
3,2418,2518,-100,0,374,0,6
3,2365,2456,-91,0,352,0,6
3,2557,2375,182,0,377,0,6
3,2302,2609,-307,0,125,0,6
3,2369,2445,-76,0,131,0,6
3,2375,2473,-98,0,45,0,8
3,2297,2404,-107,0,377,0,8
3,2397,2444,-47,0,466,0,6
3,2338,2499,-161,0,124,0,6
3,2421,2550,-129,0,267,0,6
3,2609,2432,177,0,154,0,6
3,2438,2451,-13,0,152,0,6
3,2684,2556,128,0,136,0,6
3,2510,2389,121,0,45,0,6
3,2535,2584,-49,0,49,0,6
3,2492,2436,56,0,376,0,6
3,2312,2422,-110,0,82,0,6
3,2379,2441,-62,0,58,0,6
3,2352,2454,-102,0,300,0,6
3,2512,2420,92,0,43,0,6
3,2350,2626,-276,0,330,0,6
3,2433,2377,56,0,8,0,6
3,2304,2424,-120,0,202,0,6
3,2418,2371,47,0,4,0,6
3,2362,2455,-93,0,222,0,6
3,2255,2407,-152,0,4,0,6
3,2496,2539,-43,0,200,0,6
3,2518,2340,178,0,337,0,6
3,2527,2524,3,0,404,0,6
3,2380,2607,-227,0,302,0,6
3,2447,2424,23,0,40,0,6
3,2512,2668,-156,0,49,0,6
3,2334,2463,-129,0,313,0,6
3,2291,2432,-141,0,0,0,6
3,2338,2471,-133,0,123,0,8
3,2621,2514,107,0,210,0,6
3,2407,2494,-87,0,13,0,6
3,2719,2761,-42,0,211,0,6
3,2376,2497,-121,0,117,0,6
3,2416,2479,-63,0,110,0,6
3,2453,2323,130,0,300,0,6
3,2519,2594,-75,0,455,0,6
3,2325,2451,-126,0,380,0,6
3,2421,2528,-107,0,200,0,6
3,2553,2713,-160,0,4,0,6
3,2380,2457,-77,0,129,0,8
3,2309,2596,-287,0,132,0,6
3,2502,2340,162,0,142,0,6
3,2233,2532,-299,0,426,0,6
3,2414,2604,-190,0,83,0,6
3,2417,2516,-99,0,46,0,6
3,2531,2548,-17,0,57,0,6
3,2281,2459,-178,4,0,0,13
3,2372,2415,-43,0,268,0,6
3,2489,2385,104,0,259,0,6
3,2477,2319,158,0,41,0,6
3,2417,2245,172,0,106,0,6
3,2308,2487,-179,0,100,0,6
3,2419,2401,18,0,52,0,6
3,2363,2462,-99,0,41,0,8
3,2445,2481,-36,0,45,0,6
3,2508,2473,35,0,302,0,6
3,2500,2404,96,0,5,0,6
3,2296,2446,-150,0,125,0,8
3,2403,2240,163,0,304,0,6
3,2418,2328,90,0,4,0,6
3,2464,2385,79,0,46,0,6
3,2507,2415,92,0,302,0,6
3,2335,2419,-84,0,22,0,6
3,2546,2438,108,0,487,0,6
3,2560,2358,202,0,145,0,6
3,2319,2438,-119,0,200,0,6
3,2357,2482,-125,0,302,0,6
3,2556,2464,92,0,242,0,6
3,2237,2485,-248,0,288,0,6
3,2482,2529,-47,0,312,0,6
3,2548,2607,-59,0,326,0,6
3,2476,2411,65,0,440,0,6
3,2327,2445,-118,0,213,0,6
3,2528,2345,183,0,40,0,6
3,2223,2554,-331,4,4,0,13
3,2482,2240,242,0,190,0,6
3,2397,2425,-28,0,4,0,6
3,2514,2525,-11,0,43,0,6
3,2496,2486,10,0,132,0,6
3,2346,2499,-153,0,130,0,6
3,2359,2560,-201,0,330,0,6
3,2584,2206,378,0,41,0,6
3,2380,2427,-47,0,200,0,6
3,2466,2497,-31,0,129,0,6
3,2392,2476,-84,0,380,0,6
3,2509,2523,-14,0,53,0,6
3,2341,2420,-79,0,0,0,6
3,2457,2201,256,0,305,0,6
3,2470,2393,77,0,228,0,6
3,2349,2462,-113,0,8,0,6
3,2325,2433,-108,0,121,0,6
3,2500,2669,-169,0,326,0,6
3,2549,2401,148,0,101,0,6
3,2359,2560,-201,0,293,0,6
3,2474,2453,21,0,426,0,6
3,2469,2280,189,0,101,0,6
3,2527,2514,13,0,330,0,6
3,2239,2513,-274,0,337,0,6
3,2235,2755,-520,0,300,0,6
3,2389,2459,-70,0,253,0,3
3,2472,2317,155,0,327,0,6
3,2433,2383,50,0,459,0,6
3,2407,2302,105,0,140,0,6
3,2590,2516,74,0,107,0,6
3,2335,2453,-118,0,40,0,6
3,2369,2444,-75,0,386,0,6
3,2447,2436,11,0,130,0,6
3,2305,2469,-164,0,9,0,6
3,2428,2232,196,0,46,0,7
3,2359,2560,-201,0,288,0,6
3,2458,2390,68,0,285,0,3
3,2533,2543,-10,0,50,0,6
3,2444,2366,78,0,40,0,6
3,2391,2457,-66,0,250,0,3
3,2265,2439,-174,0,16,0,6
3,2395,2401,-6,0,152,0,6
3,2402,2474,-72,0,301,0,6
3,2341,2450,-109,0,100,0,6
3,2428,2310,118,0,440,0,6
3,2223,2425,-202,0,42,0,7
3,2203,2405,-202,0,302,0,6
3,2506,2471,35,0,122,0,6
3,2353,2458,-105,0,302,0,6
3,2440,2414,26,0,201,0,6
3,2456,2392,64,0,330,0,3
3,2396,2409,-13,0,234,0,6
3,2306,2409,-103,0,260,0,6
3,2385,2401,-16,0,108,0,6
3,2489,2499,-10,0,7,0,6
3,2244,2458,-214,0,374,0,6
3,2369,2517,-148,0,102,0,6
3,2341,2455,-114,0,0,0,6
3,2430,2365,65,0,46,0,6
3,2393,2455,-62,0,190,0,3
3,2322,2400,-78,0,125,0,6
3,2539,2549,-10,0,113,0,6
3,2263,2408,-145,0,268,0,8
3,2436,2327,109,0,106,0,6
3,2657,2483,174,0,15,0,6
3,2453,2384,69,0,300,0,6
3,2356,2417,-61,0,414,0,6
3,2299,2408,-109,0,280,0,6
3,2277,2410,-133,0,448,0,6
3,2597,2585,12,0,310,0,6
3,2492,2466,26,0,373,0,6
3,2454,2394,60,0,250,0,3
3,2499,2385,114,0,46,0,6
3,2385,2407,-22,0,157,0,6
3,2368,2421,-53,0,110,0,6
3,2217,2429,-212,0,110,0,6
3,2585,2597,-12,0,205,0,6
3,2395,2453,-58,0,250,0,3
3,2466,2446,20,0,380,0,6
3,2627,2575,52,0,171,0,6
3,2368,2457,-89,0,113,0,6
3,2345,2408,-63,0,20,0,6
3,2347,2504,-157,0,4,0,6
3,2420,2310,110,0,210,0,6
3,2396,2452,-56,0,28,0,3
3,2473,2384,89,0,96,0,6
3,2364,2447,-83,0,140,0,6
3,2434,2376,58,0,311,0,6
3,2440,2387,53,0,9,0,6
3,2511,2593,-82,0,4,0,6
3,2474,2322,152,0,34,0,6
3,2571,2577,-6,0,335,0,6
3,2456,2340,116,0,101,0,8
3,2506,2433,73,0,15,0,6
3,2270,2422,-152,0,110,0,6
3,2394,2596,-202,0,123,0,6
3,2338,2402,-64,0,4,0,6
3,2422,2459,-37,0,34,0,6
3,2476,2482,-6,0,123,0,6
3,2451,2397,54,0,288,0,3
3,2377,2534,-157,0,260,0,6
3,2406,2243,163,4,130,0,13
3,2492,2464,28,0,200,0,6
3,2540,2487,53,0,40,0,6
3,2416,2369,47,0,315,0,6
3,2417,2463,-46,0,203,0,6
3,2273,2402,-129,0,101,0,6
3,2404,2436,-32,0,300,0,6
3,2281,2495,-214,0,101,0,6
3,2495,2538,-43,0,202,0,6
3,2391,2486,-95,0,404,0,6
3,2317,2487,-170,0,244,0,6
3,2398,2450,-52,0,332,0,3
3,2266,2403,-137,0,491,0,6
3,2559,2561,-2,0,101,0,6
3,2355,2433,-78,4,326,0,13
3,2417,2418,-1,0,133,0,6
3,2315,2405,-90,0,300,0,6
3,2498,2478,20,0,45,0,6
3,2446,2356,90,0,213,0,6
3,2400,2400,0,0,334,0,6
3,2449,2399,50,0,250,0,3
3,2294,2430,-136,0,423,0,6
3,2401,2413,-12,0,455,0,6
3,2503,2278,225,0,45,0,6
3,2304,2419,-115,0,5,0,6
3,2453,2518,-65,0,4,0,6
3,2361,2406,-45,0,95,0,6
3,2404,2364,40,0,135,0,6
3,2527,2251,276,0,4,0,6
3,2409,2343,66,0,106,0,6
3,2400,2449,-49,0,250,0,3
3,2366,2400,-34,0,258,0,6
3,2603,2477,126,0,374,0,6
3,2380,2404,-24,4,256,0,13
3,2522,2341,181,0,40,0,6
3,2422,2412,10,0,302,0,6
3,2450,2275,175,0,10,0,6
3,2391,2501,-110,0,1,0,6
3,2525,2622,-97,0,320,0,6
3,2523,2715,-192,0,0,0,6
3,2602,2303,299,0,373,0,6
3,2608,2515,93,0,432,0,6
3,2541,2396,145,0,200,0,6
3,2311,2517,-206,0,40,0,6
3,2448,2400,48,0,288,0,3
3,2576,2419,157,0,16,0,6
3,2485,2430,55,0,140,0,6
3,2458,2414,44,0,44,0,6
3,2392,2427,-35,0,409,0,6
3,2395,2449,-54,0,5,0,6
3,2590,2424,166,0,380,0,6
3,2331,2436,-105,0,34,0,6
3,2442,2588,-146,0,143,0,6
3,2346,2457,-111,0,338,0,6
3,2418,2418,0,0,277,0,6
3,2357,2453,-96,0,371,0,6
3,2603,2756,-153,0,484,0,6
3,2650,2647,3,0,267,0,6
3,2642,2644,-2,0,335,0,6
3,2690,2685,5,0,43,0,6
3,2546,2548,-2,0,39,0,6
3,2432,2432,0,0,1,0,6
3,2424,2424,0,0,40,0,6
3,2439,2439,0,0,201,0,6
3,2503,2490,13,0,4,0,6
3,2408,2394,14,0,103,0,6
3,2232,2402,-170,0,304,0,6
3,2356,2514,-158,0,395,0,6
3,2405,2417,-12,0,48,0,6
3,2408,2350,58,0,242,0,6
3,2296,2670,-374,0,277,0,6
3,2221,2424,-203,0,375,0,6
3,2596,2383,213,0,140,0,6
3,2319,2417,-98,0,411,0,6
3,2427,2231,196,0,410,0,6
3,2726,2487,239,0,14,0,6
3,2401,2447,-46,0,28,0,3
3,2437,2414,23,0,100,0,6
3,2399,2414,-15,0,247,0,6
3,2374,2523,-149,0,302,0,6
3,2411,2439,-28,0,210,0,6
3,2573,2507,66,0,4,0,6
3,2647,2486,161,0,434,0,6
3,2575,2593,-18,0,332,0,6
3,2470,2715,-245,0,335,0,6
3,2470,2535,-65,0,310,0,6
3,2501,2399,102,0,207,0,6
3,2446,2402,44,0,331,0,3
3,2572,2569,3,0,36,0,6
3,2475,2701,-226,0,480,0,6
3,2424,2393,31,0,7,0,6
3,2407,2521,-114,0,414,0,6
3,2580,2652,-72,0,337,0,6
3,2356,2466,-110,0,263,0,6
3,2494,2396,98,0,106,0,6
3,2467,2496,-29,0,107,0,6
3,2715,2569,146,0,40,0,6
3,2481,2295,186,0,300,0,6
3,2420,2346,74,0,4,0,6
3,2413,2425,-12,0,46,0,6
3,2553,2542,11,0,153,0,6
3,2525,2485,40,0,204,0,6
3,2706,2510,196,0,405,0,6
3,2412,2392,20,0,4,0,6
3,2309,2510,-201,0,267,0,6
3,2494,2419,75,0,140,0,6
3,2380,2438,-58,0,88,0,6
3,2681,2623,58,0,196,0,6
3,2703,2548,155,0,448,0,6
3,2715,2442,273,0,484,0,6
3,2468,2572,-104,0,392,0,6
3,2524,2507,17,0,311,0,6
3,2796,2713,83,0,335,0,6
3,2387,2514,-127,0,12,0,6
3,2473,2397,76,0,411,0,6
3,2645,2672,-27,0,267,0,6
3,2326,2425,-99,0,200,0,6
3,2219,2501,-282,0,485,0,6
3,2507,2347,160,0,404,0,6
3,2253,2600,-347,0,48,0,6
3,2466,2517,-51,0,121,0,6
3,2403,2446,-43,0,250,0,3
3,2733,2672,61,0,258,0,6
3,2395,2507,-112,0,59,0,6
3,2690,2640,50,0,122,0,6
3,2453,2394,59,0,10,0,6
3,2632,2731,-99,0,49,0,6
3,2405,2554,-149,0,31,0,6
3,2393,2422,-29,0,304,0,6
3,2395,2413,-18,0,140,0,6
3,2421,2513,-92,0,1,0,6
3,2422,2422,0,0,7,0,6
3,2415,2353,62,0,236,0,8
3,2462,2397,65,0,405,0,6
3,2378,2680,-302,0,101,0,6
3,2438,2426,12,0,310,0,6
3,2519,2482,37,0,404,0,6
3,2385,2508,-123,0,28,0,6
3,2490,2411,79,0,311,0,6
3,2412,2223,189,0,354,0,6
3,2447,2544,-97,0,148,0,6
3,2567,2557,10,0,118,0,6
3,2590,2700,-110,0,140,0,6
3,2399,2594,-195,0,245,0,6
3,2566,2452,114,0,122,0,6
3,2421,2412,9,0,206,0,6
3,2405,2427,-22,0,0,0,6
3,2742,2548,194,0,107,0,6
3,2395,2486,-91,0,101,0,6
3,2606,2254,352,0,201,0,6
3,2546,2455,91,0,200,0,6
3,2586,2620,-34,0,45,0,6
3,2363,2544,-181,0,35,0,6
3,2527,2490,37,0,203,0,6
3,2518,2422,96,0,40,0,6
3,2329,2423,-94,0,40,0,6
3,2511,2370,141,0,1,0,6
3,2421,2398,23,0,245,0,6
3,2602,2704,-102,0,22,0,6
3,2445,2403,42,0,250,0,3
3,2728,2585,143,0,127,0,6
3,2458,2505,-47,0,45,0,6
3,2435,2564,-129,0,140,0,6
3,2245,2495,-250,0,4,0,6
3,2582,2739,-157,0,108,0,6
3,2448,2490,-42,0,136,0,6
3,2426,2427,-1,0,469,0,6
3,2640,2681,-41,0,225,0,6
3,2441,2233,208,0,123,0,6
3,2714,2645,69,0,302,0,6
3,2405,2304,101,0,217,0,6
3,2410,2562,-152,0,245,0,6
3,2701,2389,312,0,40,0,6
3,2404,2444,-40,0,190,0,3
3,2421,2395,26,0,1,0,6
3,2291,2439,-148,0,100,0,6
3,2697,2622,75,0,201,0,6
3,2477,2279,198,0,121,0,6
3,2291,2404,-113,0,106,0,6
3,2646,2494,152,0,47,0,6
3,2371,2407,-36,0,140,0,6
3,2620,2697,-77,0,260,0,6
3,2656,2806,-150,0,125,0,6
3,2700,2725,-25,0,288,0,6
3,2444,2405,39,0,288,0,3
3,2332,2561,-229,0,45,0,6
3,2428,2275,153,0,1,0,6
3,2420,2217,203,0,43,0,6
3,2462,2681,-219,0,409,0,6
3,2492,2350,142,0,411,0,6
3,2344,2426,-82,0,101,0,6
3,2231,2662,-431,0,125,0,6
3,2375,2441,-66,0,487,0,6
3,2390,2637,-247,0,122,0,6
3,2487,2622,-135,0,148,0,6
3,2383,2505,-122,0,302,0,6
3,2340,2544,-204,0,140,0,6
3,2635,2735,-100,0,381,0,6
3,2615,2759,-144,0,240,0,6
3,2493,2592,-99,0,103,0,6
3,2447,2571,-124,0,106,0,6
3,2414,2512,-98,0,45,0,6
3,2433,2559,-126,0,426,0,6
3,2503,2524,-21,0,112,0,6
3,2653,2440,213,0,153,0,6
3,2452,2447,5,0,268,0,6
3,2506,2545,-39,0,156,0,6
3,2427,2407,20,0,487,0,6
3,2403,2685,-282,0,40,0,6
3,2418,2335,83,0,4,0,6
3,2363,2439,-76,0,120,0,6
3,2494,2405,89,0,303,0,6
3,2533,2232,301,4,240,0,13
3,2711,2600,111,0,453,0,6
3,2519,2574,-55,0,46,0,6
3,2507,2563,-56,0,244,0,6
3,2569,2509,60,0,8,0,6
3,2501,2311,190,0,123,0,6
3,2409,2715,-306,0,45,0,6
3,2511,2448,63,0,192,0,6
3,2280,2412,-132,0,45,0,6
3,2597,2645,-48,0,145,0,6
3,2300,2629,-329,0,121,0,6
3,2633,2674,-41,0,46,0,6
3,2532,2616,-84,0,148,0,6
3,2438,2371,67,0,61,0,6
3,2313,2414,-101,0,45,0,6
3,2409,2506,-97,0,22,0,6
3,2259,2562,-303,0,245,0,6
3,2647,2564,83,0,278,0,6
3,2369,2508,-139,0,204,0,6
3,2245,2447,-202,0,457,0,6
3,2457,2351,106,0,104,0,8
3,2652,2552,100,0,140,0,6
3,2568,2386,182,0,338,0,6
3,2478,2451,27,0,125,0,6
3,2646,2487,159,0,45,0,6
3,2248,2401,-153,0,0,0,6
3,2701,2721,-20,0,49,0,6
3,2562,2564,-2,0,7,0,6
3,2507,2477,30,0,406,0,6
3,2423,2446,-23,0,250,0,6
3,2418,2421,-3,0,125,0,6
3,2642,2617,25,0,13,0,6
3,2433,2414,19,0,253,0,6
3,2367,2443,-76,0,335,0,6
3,2473,2248,225,0,134,0,6
3,2489,2371,118,0,484,0,6
3,2691,2491,200,0,4,0,6
3,2581,2605,-24,0,123,0,6
3,2506,2312,194,4,200,0,13
3,2299,2417,-118,0,255,0,6
3,2631,2357,274,0,50,0,6
3,2491,2562,-71,0,48,0,6
3,2404,2498,-94,0,101,0,6
3,2387,2493,-106,0,112,0,6
3,2392,2455,-63,0,4,0,8
3,2603,2212,391,0,308,0,6
3,2493,2471,22,0,255,0,6
3,2800,2815,-15,0,335,0,6
3,2721,2504,217,0,386,0,6
3,2509,2711,-202,0,7,0,6
3,2491,2680,-189,0,130,0,6
3,2522,2433,89,0,200,0,6
3,2468,2571,-103,0,455,0,6
3,2362,2417,-55,0,360,0,6
3,2304,2438,-134,0,125,0,6
3,2402,2292,110,0,242,0,6
3,2456,2555,-99,0,116,0,6
3,2624,2527,97,0,385,0,6
3,2577,2552,25,0,200,0,6
3,2410,2288,122,0,1,0,6
3,2601,2522,79,0,1,0,6
3,2399,2539,-140,0,9,0,6
3,2213,2416,-203,0,6,0,6
3,2707,2800,-93,0,426,0,6
3,2815,2699,116,0,6,0,6
3,2345,2481,-136,0,4,0,6
3,2424,2266,158,0,53,0,6
3,2404,2624,-220,0,455,0,6
3,2483,2370,113,0,45,0,6
3,2605,2541,64,0,332,0,6
3,2623,2515,108,0,40,0,6
3,2440,2334,106,0,13,0,6
3,2799,2620,179,0,143,0,6
3,2389,2454,-65,0,200,0,6
3,2423,2454,-31,0,41,0,8
3,2554,2651,-97,0,7,0,6
3,2454,2417,37,0,246,0,6
3,2462,2410,52,0,1,0,6
3,2455,2576,-121,0,262,0,6
3,2261,2408,-147,0,40,0,6
3,2666,2723,-57,0,253,0,6
3,2555,2582,-27,0,302,0,6
3,2662,2691,-29,0,140,0,6
3,2682,2402,280,0,153,0,6
3,2504,2536,-32,0,201,0,6
3,2425,2384,41,0,335,0,6
3,2306,2492,-186,0,0,0,6
3,2412,2487,-75,0,45,0,6
3,2408,2418,-10,0,4,0,6
3,2444,2558,-114,0,490,0,6
3,2542,2342,200,0,406,0,6
3,2495,2742,-247,0,106,0,6
3,2426,2565,-139,0,100,0,6
3,2536,2574,-38,0,245,0,6
3,2496,2715,-219,0,268,0,6
3,2490,2552,-62,0,108,0,6
3,2400,2487,-87,0,25,0,6
3,2685,2702,-17,0,154,0,6
3,2398,2424,-26,0,344,0,6
3,2504,2430,74,0,463,0,6
3,2533,2659,-126,0,0,0,6
3,2467,2427,40,0,210,0,6
3,2442,2527,-85,0,130,0,6
3,2708,2725,-17,0,47,0,6
3,2265,2575,-310,0,255,0,6
3,2374,2548,-174,0,210,0,6
3,2455,2457,-2,0,1,0,6
3,2580,2337,243,0,206,0,6
3,2446,2355,91,0,200,0,6
3,2317,2469,-152,0,141,0,6
3,2466,2517,-51,0,386,0,6
3,2683,2505,178,0,46,0,6
3,2424,2337,87,0,243,0,6
3,2551,2587,-36,0,0,0,6
3,2527,2448,79,0,359,0,6
3,2479,2460,19,0,195,0,6
3,2508,2477,31,0,120,0,6
3,2552,2455,97,0,115,0,6
3,2431,2396,35,0,455,0,6
3,2418,2473,-55,0,122,0,6
3,2414,2416,-2,0,1,0,6
3,2595,2663,-68,0,331,0,6
3,2466,2400,66,0,330,0,6
3,2380,2423,-43,0,16,0,6
3,2454,2383,71,0,40,0,6
3,2501,2331,170,0,306,0,6
3,2284,2401,-117,0,21,0,6
3,2609,2698,-89,0,335,0,6
3,2374,2445,-71,0,107,0,6
3,2437,2453,-16,0,101,0,6
3,2452,2570,-118,0,246,0,6
3,2483,2545,-62,0,4,0,6
3,2426,2335,91,0,1,0,6
3,2551,2537,14,0,4,0,6
3,2479,2522,-43,0,427,0,6
3,2556,2462,94,0,310,0,6
3,2579,2649,-70,0,373,0,6
3,2417,2262,155,0,250,0,6
3,2393,2413,-20,0,41,0,6
3,2211,2556,-345,0,143,0,6
3,2540,2409,131,0,46,0,6
3,2394,2456,-62,0,123,0,6
3,2691,2675,16,0,46,0,6
3,2475,2502,-27,0,0,0,6
3,2572,2550,22,0,106,0,6
3,2420,2460,-40,0,394,0,6
3,2508,2504,4,0,411,0,6
3,2647,2558,89,0,332,0,6
3,2375,2440,-65,0,385,0,6
3,2724,2664,60,0,330,0,6
3,2551,2593,-42,0,7,0,6
3,2675,2616,59,0,148,0,6
3,2402,2381,21,0,248,0,6
3,2513,2442,71,0,6,0,6
3,2352,2460,-108,0,49,0,6
3,2501,2339,162,0,404,0,6
3,2551,2703,-152,0,373,0,6
3,2469,2576,-107,0,43,0,6
3,2515,2470,45,0,142,0,7
3,2617,2507,110,0,123,0,6
3,2636,2504,132,0,100,0,6
3,2665,2723,-58,0,125,0,6
3,2320,2494,-174,0,40,0,6
3,2396,2480,-84,0,4,0,6
3,2709,2803,-94,0,426,0,6
3,2528,2708,-180,0,302,0,6
3,2468,2260,208,0,4,0,6
3,2509,2675,-166,0,115,0,6
3,2389,2506,-117,0,211,0,6
3,2434,2316,118,0,380,0,6
3,2590,2523,67,0,260,0,6
3,2510,2220,290,0,0,0,6
3,2467,2579,-112,0,5,0,6
3,2551,2625,-74,0,111,0,6
3,2486,2511,-25,0,56,0,6
3,2414,2321,93,0,207,0,6
3,2703,2454,249,0,1,0,6
3,2473,2737,-264,0,45,0,6
3,2615,2599,16,0,100,0,6
3,2429,2634,-205,0,253,0,6
3,2662,2505,157,0,46,0,6
3,2203,2438,-235,0,315,0,7
3,2414,2422,-8,0,459,0,6
3,2578,2498,80,0,101,0,6
3,2670,2587,83,0,255,0,6
3,2608,2363,245,0,405,0,6
3,2705,2581,124,0,13,0,6
3,2438,2399,39,0,218,0,6
3,2649,2812,-163,0,0,0,6
3,2405,2277,128,0,124,0,6
3,2535,2425,110,0,112,0,6
3,2461,2347,114,0,177,0,6
3,2318,2417,-99,0,106,0,6
3,2715,2525,190,0,101,0,6
3,2652,2571,81,0,70,0,6
3,2422,2465,-43,0,210,0,6
3,2531,2573,-42,0,200,0,6
3,2338,2412,-74,0,455,0,6
3,2475,2502,-27,0,4,0,6
3,2373,2437,-64,0,49,0,6
3,2466,2500,-34,0,107,0,6
3,2558,2422,136,0,406,0,6
3,2476,2446,30,0,224,0,8
3,2455,2368,87,0,100,0,6
3,2386,2442,-56,0,112,0,8
3,2321,2583,-262,0,123,0,6
3,2698,2729,-31,0,0,0,6
3,2452,2464,-12,0,198,0,6
3,2499,2387,112,0,410,0,6
3,2512,2532,-20,0,102,0,6
3,2647,2603,44,0,40,0,6
3,2710,2461,249,0,116,0,6
3,2615,2680,-65,0,310,0,6
3,2653,2510,143,0,341,0,6
3,2704,2516,188,0,338,0,6
3,2526,2493,33,0,211,0,6
3,2671,2664,7,0,7,0,6
3,2524,2472,52,0,306,0,6
3,2478,2463,15,0,45,0,6
3,2694,2473,221,0,101,0,6
3,2553,2419,134,0,242,0,6
3,2293,2431,-138,0,121,0,6
3,2526,2500,26,0,112,0,6
3,2639,2714,-75,0,7,0,6
3,2549,2480,69,0,373,0,6
3,2525,2501,24,0,373,0,6
3,2474,2503,-29,0,267,0,6
3,2626,2548,78,0,106,0,6
3,2501,2662,-161,0,263,0,6
3,2590,2622,-32,0,190,0,6
3,2661,2654,7,0,267,0,6
3,2651,2646,5,0,0,0,6
3,2458,2637,-179,0,36,0,6
3,2615,2529,86,0,315,0,6
3,2469,2429,40,0,337,0,6
3,2513,2217,296,0,200,0,6
3,2698,2740,-42,0,140,0,6
3,2417,2371,46,0,50,0,6
3,2697,2639,58,0,13,0,6
3,2327,2411,-84,0,256,0,6
3,2650,2729,-79,0,440,0,6
3,2634,2460,174,0,60,0,6
3,2717,2514,203,0,244,0,6
3,2527,2339,188,0,44,0,6
3,2610,2499,111,0,10,0,6
3,2683,2754,-71,0,47,0,6
3,2386,2424,-38,0,144,0,6
3,2515,2586,-71,0,106,0,6
3,2502,2597,-95,0,301,0,6
3,2368,2417,-49,0,45,0,6
3,2410,2467,-57,0,5,0,6
3,2269,2443,-174,0,41,0,6
3,2518,2530,-12,0,192,0,6
3,2646,2549,97,0,40,0,6
3,2340,2490,-150,0,243,0,6
3,2503,2516,-13,0,128,0,6
3,2363,2467,-104,0,332,0,6
3,2587,2620,-33,0,300,0,6
3,2400,2374,26,0,315,0,6
3,2259,2424,-165,0,18,0,6
3,2591,2601,-10,0,246,0,6
3,2397,2488,-91,0,130,0,6
3,2519,2494,25,0,121,0,6
3,2437,2458,-21,0,21,0,6
3,2340,2468,-128,0,152,0,6
3,2517,2520,-3,0,38,0,6
3,2580,2578,2,0,130,0,6
3,2808,2715,93,0,135,0,6
3,2694,2646,48,0,282,0,6
3,2735,2677,58,0,487,0,6
3,2305,2456,-151,0,46,0,6
3,2406,2381,25,0,110,0,6
3,2621,2582,39,0,441,0,6
3,2473,2357,116,0,5,0,6
3,2572,2401,171,0,143,0,6
3,2441,2446,-5,0,110,0,6
3,2504,2406,98,0,1,0,6
3,2419,2527,-108,0,332,0,6
3,2503,2484,19,0,201,0,6
3,2540,2450,90,0,148,0,6
3,2528,2585,-57,0,345,0,6
3,2586,2662,-76,0,45,0,6
3,2507,2464,43,0,113,0,6
3,2621,2553,68,0,27,0,6
3,2564,2599,-35,0,272,0,6
3,2476,2502,-26,0,242,0,6
3,2548,2375,173,0,100,0,6
3,2470,2507,-37,0,125,0,6
3,2636,2485,151,0,191,0,6
3,2405,2450,-45,0,474,0,6
3,2468,2585,-117,0,8,0,6
3,2376,2423,-47,0,300,0,6
3,2665,2738,-73,0,280,0,6
3,2407,2427,-20,0,302,0,6
3,2446,2441,5,0,9,0,6
3,2617,2684,-67,0,255,0,6
3,2482,2347,135,0,40,0,6
3,2469,2334,135,0,343,0,6
3,2640,2560,80,0,200,0,6
3,2747,2574,173,0,8,0,6
3,2416,2402,14,0,40,0,6
3,2695,2518,177,0,40,0,6
3,2276,2471,-195,0,45,0,6
3,2382,2478,-96,0,145,0,6
3,2436,2379,57,0,315,0,6
3,2419,2398,21,0,410,0,6
3,2520,2539,-19,0,4,0,6
3,2604,2598,6,0,280,0,6
3,2494,2404,90,0,132,0,6
3,2626,2627,-1,0,267,0,6
3,2595,2587,8,0,58,0,6
3,2472,2459,13,0,154,0,6
3,2574,2304,270,0,194,0,6
3,2627,2698,-71,0,4,0,6
3,2404,2516,-112,0,123,0,6
3,2505,2425,80,0,45,0,6
3,2453,2525,-72,0,131,0,6
3,2570,2515,55,0,202,0,6
3,2629,2676,-47,0,46,0,6
3,2726,2629,97,0,260,0,6
3,2557,2587,-30,0,106,0,6
3,2417,2425,-8,0,101,0,6
3,2699,2604,95,0,302,0,6
3,2460,2563,-103,0,227,0,6
3,2476,2472,4,0,112,0,6
3,2437,2350,87,0,45,0,6
3,2385,2447,-62,0,140,0,6
3,2555,2674,-119,0,110,0,6
3,2687,2654,33,0,43,0,6
3,2384,2429,-45,0,46,0,6
3,2426,2416,10,0,106,0,6
3,2519,2501,18,0,101,0,6
3,2486,2475,11,0,125,0,6
3,2623,2354,269,0,306,0,6
3,2669,2416,253,0,243,0,6
3,2478,2283,195,0,211,0,6
3,2401,2350,51,0,0,0,6
3,2495,2514,-19,0,106,0,6
3,2413,2514,-101,0,115,0,6
3,2380,2697,-317,0,100,0,6
3,2464,2456,8,0,143,0,6
3,2414,2319,95,0,46,0,6
3,2470,2604,-134,0,48,0,6
3,2449,2519,-70,0,35,0,6
3,2463,2398,65,0,300,0,6
3,2418,2263,155,0,95,0,6
3,2420,2392,28,0,4,0,6
3,2738,2536,202,0,352,0,6
3,2604,2641,-37,0,338,0,6
3,2469,2265,204,0,201,0,6
3,2358,2570,-212,0,0,0,6
3,2287,2475,-188,0,277,0,6
3,2230,2461,-231,0,123,0,6
3,2539,2512,27,0,110,0,6
3,2585,2380,205,0,190,0,6
3,2526,2486,40,0,200,0,6
3,2219,2506,-287,0,45,0,6
3,2513,2547,-34,0,314,0,6
3,2409,2488,-79,0,130,0,6
3,2463,2399,64,0,1,0,6
3,2608,2820,-212,0,162,0,6
3,2460,2528,-68,0,308,0,6
3,2593,2697,-104,0,302,0,6
3,2253,2410,-157,0,134,0,6
3,2513,2585,-72,0,335,0,6
3,2486,2428,58,0,331,0,6
3,2555,2502,53,0,374,0,6
3,2420,2405,15,0,177,0,6
3,2487,2428,59,0,313,0,6
3,2393,2478,-85,0,460,0,6
3,2599,2472,127,0,112,0,6
3,2628,2595,33,0,111,0,6
3,2438,2420,18,0,268,0,6
3,2569,2547,22,0,7,0,6
3,2462,2576,-114,0,245,0,6
3,2455,2416,39,0,4,0,6
3,2555,2373,182,0,106,0,6
3,2404,2504,-100,0,49,0,6
3,2426,2432,-6,0,201,0,6
3,2631,2606,25,0,10,0,6
3,2523,2388,135,0,330,0,8
3,2510,2483,27,0,1,0,6
3,2468,2311,157,0,335,0,6
3,2486,2496,-10,0,200,0,6
3,2468,2439,29,0,0,0,6
3,2636,2762,-126,0,50,0,6
3,2220,2477,-257,0,210,0,6
3,2428,2486,-58,0,46,0,6
3,2702,2641,61,0,1,0,6
3,2764,2606,158,0,335,0,6
3,2448,2467,-19,0,141,0,6
3,2397,2410,-13,0,101,0,6
3,2552,2539,13,0,120,0,6
3,2457,2457,0,0,143,0,6
3,2537,2361,176,0,0,0,6
3,2490,2602,-112,0,374,0,6
3,2577,2512,65,0,245,0,6
3,2487,2380,107,0,4,0,6
3,2302,2406,-104,0,43,0,8
3,2541,2397,144,0,46,0,6
3,2388,2600,-212,0,338,0,6
3,2592,2553,39,0,138,0,6
3,2381,2416,-35,0,45,0,6
3,2467,2497,-30,0,301,0,6
3,2396,2404,-8,0,300,0,6
3,2585,2540,45,0,385,0,6
3,2458,2556,-98,0,302,0,6
3,2406,2428,-22,0,190,0,6
3,2483,2505,-22,0,300,0,6
3,2502,2351,151,0,100,0,6
3,2361,2401,-40,0,4,0,6
3,2341,2449,-108,0,332,0,6
3,2381,2559,-178,0,128,0,6
3,2425,2432,-7,0,310,0,6
3,2412,2400,12,0,120,0,6
3,2411,2284,127,0,40,0,8
3,2429,2346,83,0,40,0,6
3,2393,2468,-75,0,130,0,6
3,2471,2343,128,0,312,0,6
3,2426,2382,44,0,4,0,6
3,2555,2546,9,0,228,0,6
3,2415,2322,93,0,210,0,6
3,2411,2421,-10,0,49,0,6
3,2438,2289,149,0,487,0,6
3,2550,2527,23,0,426,0,6
3,2470,2421,49,0,325,0,6
3,2487,2329,158,0,335,0,6
3,2421,2411,10,0,1,0,6
3,2458,2635,-177,0,45,0,6
3,2488,2450,38,0,5,0,6
3,2388,2488,-100,0,106,0,6
3,2373,2484,-111,0,56,0,6
3,2602,2670,-68,0,101,0,6
3,2482,2375,107,0,45,0,6
3,2315,2426,-111,0,207,0,6
3,2441,2448,-7,0,46,0,7
3,2471,2449,22,0,121,0,6
3,2462,2428,34,0,58,0,6
3,2532,2467,65,0,347,0,6
3,2415,2566,-151,0,110,0,6
3,2425,2562,-137,0,207,0,6
3,2239,2443,-204,0,200,0,6
3,2492,2497,-5,0,335,0,6
3,2432,2449,-17,4,112,0,13
3,2482,2427,55,0,300,0,6
3,2418,2295,123,0,17,0,8
3,2424,2409,15,0,4,0,6
3,2497,2530,-33,0,4,0,6
3,2440,2309,131,0,122,0,6
3,2304,2418,-114,0,45,0,6
3,2475,2398,77,0,400,0,6
3,2508,2524,-16,0,394,0,6
3,2501,2547,-46,0,65,0,6
3,2388,2434,-46,0,45,0,6
3,2432,2451,-19,0,242,0,6
3,2371,2432,-61,0,4,0,6
3,2230,2403,-173,0,123,0,8
3,2325,2447,-122,0,143,0,6
3,2449,2241,208,0,133,0,6
3,2460,2421,39,0,106,0,7
3,2445,2441,4,0,203,0,6
3,2357,2447,-90,0,45,0,6
3,2496,2549,-53,0,30,0,6
3,2680,2298,382,0,112,0,6
3,2455,2216,239,0,48,0,7
3,2360,2401,-41,0,483,0,6
3,2336,2418,-82,0,40,0,6
3,2418,2321,97,0,306,0,6
3,2579,2511,68,0,4,0,6
3,2443,2302,141,0,46,0,7
3,2427,2386,41,0,295,0,6
3,2552,2524,28,0,112,0,6
3,2421,2437,-16,0,132,0,6
3,2386,2427,-41,0,320,0,6
3,2464,2282,182,0,201,0,7
3,2329,2513,-184,0,373,0,6
3,2285,2454,-169,4,242,0,13
3,2305,2430,-125,0,113,0,6
3,2212,2449,-237,0,40,0,6
3,2579,2395,184,0,49,0,6
3,2393,2420,-27,0,320,0,6
3,2669,2233,436,0,112,0,6
3,2683,2525,158,0,0,0,6
3,2509,2480,29,0,265,0,6
3,2510,2423,87,0,46,0,6
3,2407,2243,164,0,39,0,6
3,2684,2524,160,0,0,0,6
3,2636,2587,49,0,335,0,6
3,2467,2298,169,0,62,0,6
3,2394,2423,-29,0,487,0,6
3,2645,2549,96,0,426,0,6
3,2441,2575,-134,0,302,0,6
3,2528,2412,116,0,41,0,6
3,2662,2385,277,0,40,0,6
3,2471,2414,57,0,135,0,6
3,2239,2411,-172,0,453,0,6
3,2288,2477,-189,0,107,0,6
3,2473,2447,26,0,484,0,6
3,2413,2389,24,0,345,0,6
3,2422,2242,180,0,46,0,6
3,2328,2512,-184,0,320,0,6
3,2499,2403,96,0,347,0,6
3,2374,2423,-49,0,242,0,6
3,2694,2653,41,0,167,0,6
3,2565,2683,-118,0,151,0,6
3,2404,2447,-43,0,301,0,6
3,2511,2427,84,0,46,0,6
3,2530,2480,50,0,112,0,6
3,2507,2565,-58,0,181,0,6
3,2421,2480,-59,0,132,0,6
3,2513,2437,76,0,215,0,6
3,2463,2512,-49,0,46,0,6
3,2401,2212,189,0,302,0,10
3,2444,2421,23,0,4,0,5
3,2384,2441,-57,0,7,0,6
3,2595,2580,15,0,140,0,6
3,2282,2452,-170,0,469,0,5
3,2480,2393,87,0,10,0,5
3,2365,2441,-76,0,123,0,5
3,2408,2349,59,0,216,0,5
3,2435,2536,-101,0,254,0,6
3,2498,2462,36,0,249,0,6
3,2324,2415,-91,0,7,0,6
3,2210,2472,-262,0,228,0,5
3,2658,2815,-157,0,280,0,6
3,2528,2442,86,0,20,0,6
3,2438,2224,214,0,43,0,10
3,2418,2295,123,0,5,0,6
3,2397,2401,-4,0,152,0,5
3,2468,2446,22,0,315,0,5
3,2664,2816,-152,0,358,0,6
3,2374,2429,-55,0,75,0,6
3,2434,2463,-29,0,110,0,6
3,2441,2567,-126,0,140,0,6
3,2314,2409,-95,0,4,0,10
3,2480,2317,163,0,152,0,5
3,2330,2519,-189,0,147,0,5
3,2478,2499,-21,0,115,0,5
3,2589,2522,67,0,2,0,6
3,2543,2375,168,0,0,0,6
3,2408,2452,-44,0,301,0,6
3,2356,2641,-285,0,46,0,6
3,2322,2434,-112,0,127,0,10
3,2479,2410,69,0,16,0,5
3,2375,2529,-154,0,142,0,5
3,2525,2531,-6,0,40,0,5
3,2244,2424,-180,0,40,0,5
3,2575,2697,-122,0,34,0,5
3,2485,2618,-133,0,8,0,6
3,2390,2414,-24,0,132,0,6
3,2459,2530,-71,0,374,0,6
3,2464,2703,-239,0,147,0,5
3,2455,2272,183,0,67,0,5
3,2556,2460,96,0,130,0,5
3,2441,2378,63,0,388,0,5
3,2582,2427,155,0,140,0,5
3,2482,2466,16,0,7,0,6
3,2444,2527,-83,0,315,0,6
3,2413,2384,29,0,20,0,6
3,2531,2454,77,0,197,0,6
3,2553,2385,168,0,0,0,6
3,2478,2672,-194,0,330,0,6
3,2646,2492,154,0,144,0,6
3,2379,2472,-93,0,190,0,5
3,2221,2518,-297,0,106,0,5
3,2457,2324,133,0,403,0,6
3,2475,2450,25,0,440,0,6
3,2538,2355,183,0,108,0,5
3,2581,2684,-103,0,140,0,5
3,2529,2431,98,0,265,0,5
3,2603,2432,171,0,313,0,6
3,2455,2518,-63,0,311,0,6
3,2397,2400,-3,0,45,0,6
3,2393,2559,-166,0,1,0,6
3,2434,2600,-166,0,225,0,6
3,2357,2475,-118,0,101,0,6
3,2320,2408,-88,0,39,0,5
3,2433,2294,139,0,300,0,5
3,2484,2583,-99,0,405,0,5
3,2466,2682,-216,0,45,0,5
3,2515,2527,-12,0,48,0,5
3,2419,2495,-76,0,134,0,6
3,2445,2436,9,0,41,0,6
3,2280,2427,-147,0,45,0,5
3,2593,2641,-48,0,3,0,6
3,2451,2271,180,0,310,0,6
3,2448,2464,-16,0,110,0,6
3,2426,2321,105,0,101,0,5
3,2678,2461,217,0,7,0,5
3,2477,2287,190,0,113,0,5
3,2450,2490,-40,0,46,0,5
3,2709,2582,127,0,5,0,5
3,2515,2417,98,0,302,0,5
3,2527,2496,31,0,5,0,5
3,2464,2593,-129,0,48,0,6
3,2713,2698,15,0,249,0,6
3,2490,2451,39,0,330,0,5
3,2338,2447,-109,0,102,0,5
3,2596,2583,13,0,28,0,5
3,2584,2497,87,0,13,0,5
3,2393,2452,-59,0,110,0,10
3,2400,2319,81,0,113,0,6
3,2617,2663,-46,0,110,0,6
3,2474,2359,115,0,123,0,6
3,2386,2468,-82,0,487,0,5
3,2525,2477,48,0,65,0,5
3,2433,2518,-85,0,35,0,5
3,2477,2417,60,0,101,0,5
3,2509,2490,19,0,15,0,5
3,2708,2633,75,0,5,0,5
3,2394,2416,-22,0,112,0,10
3,2451,2446,5,0,111,0,10
3,2455,2532,-77,0,107,0,6
3,2595,2405,190,0,36,0,6
3,2492,2478,14,0,11,0,5
3,2637,2587,50,0,30,0,5
3,2405,2443,-38,0,332,0,3
3,2427,2451,-24,0,302,0,10
3,2450,2370,80,0,40,0,6
3,2442,2406,36,0,250,0,3
3,2407,2442,-35,0,250,0,3
3,2442,2465,-23,0,140,0,6
3,2556,2654,-98,0,331,0,6
3,2387,2425,-38,0,43,0,6
3,2441,2407,34,0,288,0,3
3,2261,2421,-160,0,40,0,6
3,2398,2427,-29,0,250,0,10
3,2623,2525,98,0,338,0,6
3,2322,2511,-189,0,487,0,5
3,2482,2449,33,0,469,0,5
3,2527,2495,32,0,5,0,5
3,2538,2426,112,0,8,0,5
3,2591,2710,-119,0,140,0,5
3,2393,2448,-55,0,45,0,6
3,2511,2317,194,0,49,0,6
3,2447,2274,173,4,392,0,13
3,2313,2465,-152,0,45,0,6
3,2306,2509,-203,0,395,0,6
3,2408,2441,-33,0,250,0,3
3,2212,2655,-443,0,58,0,5
3,2481,2481,0,0,310,0,5
3,2467,2535,-68,0,106,0,5
3,2508,2375,133,0,25,0,5
3,2592,2588,4,0,240,0,5
3,2324,2506,-182,0,46,0,6
3,2407,2386,21,0,48,0,6
3,2429,2363,66,0,150,0,6
3,2465,2314,151,0,461,0,5
3,2478,2382,96,0,107,0,5
3,2534,2506,28,0,48,0,5
3,2500,2710,-210,0,15,0,5
3,2504,2313,191,0,151,0,6
3,2288,2428,-140,0,256,0,8
3,2331,2501,-170,0,4,0,6
3,2498,2317,181,0,5,0,6
3,2235,2414,-179,0,201,0,6
3,2280,2462,-182,0,40,0,8
3,2440,2408,32,0,331,0,3
3,2607,2450,157,0,107,0,6
3,2466,2473,-7,0,1,0,5
3,2421,2296,125,0,133,0,5
3,2472,2666,-194,0,268,0,5
3,2488,2591,-103,0,382,0,5
3,2253,2442,-189,4,130,0,13
3,2535,2500,35,0,375,0,6
3,2486,2336,150,0,5,0,6
3,2653,2522,131,0,40,0,6
3,2501,2590,-89,0,36,0,5
3,2430,2428,2,0,341,0,6
3,2341,2484,-143,0,434,0,6
3,2438,2435,3,0,123,0,6
3,2546,2367,179,0,0,0,6
3,2490,2417,73,0,253,0,6
3,2364,2436,-72,0,261,0,6
3,2487,2543,-56,0,241,0,6
3,2468,2360,108,0,1,0,5
3,2416,2278,138,0,242,0,5
3,2346,2411,-65,0,4,0,5
3,2572,2355,217,0,248,0,5
3,2551,2502,49,0,4,0,5
3,2462,2665,-203,0,49,0,5
3,2588,2477,111,0,15,0,5
3,2713,2493,220,0,5,0,5
3,2481,2398,83,0,153,0,6
3,2441,2272,169,0,72,0,6
3,2420,2458,-38,0,138,0,8
3,2414,2320,94,0,427,0,6
3,2411,2277,134,0,299,0,8
3,2501,2441,60,0,226,0,8
3,2407,2240,167,0,4,0,6
3,2536,2574,-38,0,344,0,6
3,2435,2529,-94,0,115,0,6
3,2321,2412,-91,0,341,0,6
3,2445,2494,-49,0,45,0,6
3,2571,2604,-33,0,130,0,6
3,2461,2331,130,0,226,0,6
3,2358,2451,-93,0,41,0,8
3,2469,2354,115,0,335,0,6
3,2603,2683,-80,0,200,0,6
3,2369,2430,-61,0,250,0,6
3,2439,2461,-22,0,126,0,6
3,2521,2537,-16,0,43,0,6
3,2299,2449,-150,0,41,0,8
3,2485,2342,143,0,40,0,6
3,2502,2440,62,0,43,0,6
3,2533,2552,-19,0,311,0,6
3,2429,2471,-42,0,132,0,8
3,2621,2410,211,0,254,0,6
3,2415,2350,65,0,41,0,6
3,2508,2513,-5,0,315,0,6
3,2542,2738,-196,0,7,0,6
3,2468,2529,-61,0,2,0,6
3,2372,2537,-165,0,13,0,6
3,2422,2428,-6,0,331,0,6
3,2386,2454,-68,0,45,0,6
3,2443,2334,109,0,337,0,6
3,2392,2400,-8,0,120,0,6
3,2461,2281,180,0,110,0,6
3,2452,2330,122,0,250,0,6
3,2319,2418,-99,0,1,0,6
3,2549,2552,-3,0,45,0,6
3,2418,2505,-87,0,10,0,6
3,2401,2348,53,0,130,0,6
3,2265,2414,-149,0,318,0,8
3,2371,2424,-53,0,311,0,6
3,2424,2410,14,0,45,0,6
3,2513,2504,9,0,481,0,6
3,2423,2250,173,0,134,0,6
3,2497,2537,-40,0,246,0,6
3,2475,2426,49,0,102,0,6
3,2335,2405,-70,0,102,0,6
3,2404,2491,-87,0,389,0,6
3,2442,2453,-11,0,36,0,6
3,2465,2394,71,0,103,0,6
3,2426,2422,4,0,460,0,6
3,2544,2575,-31,0,40,0,6
3,2647,2450,197,0,80,0,6
3,2560,2674,-114,0,45,0,6
3,2466,2325,141,0,120,0,6
3,2402,2370,32,0,14,0,6
3,2430,2401,29,0,123,0,6
3,2481,2354,127,2,484,0,25
3,2493,2429,64,0,317,0,6
3,2423,2602,-179,4,41,0,13
3,2492,2450,42,0,306,0,6
3,2395,2513,-118,0,484,0,6
3,2323,2457,-134,0,122,0,6
3,2523,2507,16,0,352,0,6
3,2547,2491,56,0,112,0,6
3,2374,2417,-43,0,300,0,6
3,2569,2472,97,0,248,0,6
3,2450,2386,64,0,302,0,6
3,2550,2444,106,0,218,0,6
3,2511,2599,-88,0,4,0,6
3,2384,2479,-95,0,120,0,6
3,2474,2450,24,0,302,0,6
3,2499,2540,-41,0,49,0,6
3,2492,2498,-6,0,304,0,6
3,2396,2464,-68,0,46,0,6
3,2443,2450,-7,0,40,0,6
3,2459,2585,-126,0,36,0,6
3,2508,2521,-13,0,404,0,6
3,2454,2492,-38,0,110,0,6
3,2498,2396,102,0,300,0,6
3,2404,2418,-14,4,201,0,13
3,2449,2458,-9,0,48,0,6
3,2301,2456,-155,0,104,0,6
3,2470,2598,-128,0,107,0,6
3,2461,2483,-22,0,327,0,6
3,2393,2455,-62,0,45,0,6
3,2356,2409,-53,0,113,0,6
3,2355,2493,-138,0,304,0,6
3,2407,2487,-80,0,243,0,6
3,2423,2414,9,0,134,0,6
3,2456,2323,133,0,120,0,6
3,2501,2250,251,0,7,0,6
3,2498,2483,15,0,246,0,6
3,2589,2390,199,0,101,0,6
3,2492,2438,54,0,46,0,6
3,2430,2513,-83,0,15,0,6
3,2408,2381,27,0,45,0,6
3,2394,2417,-23,0,310,0,6
3,2404,2409,-5,0,152,0,6
3,2520,2500,20,0,127,0,6
3,2516,2384,132,0,101,0,6
3,2550,2503,47,0,40,0,6
3,2411,2360,51,0,241,0,6
3,2498,2434,64,0,56,0,6
3,2426,2324,102,0,14,0,6
3,2500,2453,47,0,212,0,6
3,2393,2499,-106,0,43,0,6
3,2497,2302,195,0,176,0,6
3,2415,2442,-27,0,218,0,6
3,2407,2309,98,0,45,0,6
3,2343,2487,-144,0,310,0,7
3,2339,2497,-158,0,200,0,6
3,2404,2419,-15,0,115,0,6
3,2603,2580,23,0,207,0,6
3,2430,2450,-20,0,224,0,6
3,2502,2477,25,0,301,0,6
3,2280,2478,-198,0,108,0,6
3,2451,2501,-50,0,305,0,6
3,2411,2384,27,0,107,0,6
3,2500,2572,-72,0,20,0,6
3,2386,2454,-68,0,40,0,6
3,2405,2253,152,4,201,0,13
3,2356,2440,-84,0,242,0,6
3,2333,2561,-228,0,330,0,7
3,2357,2403,-46,0,336,0,6
3,2417,2420,-3,0,21,0,6
3,2383,2424,-41,0,311,0,6
3,2474,2492,-18,0,125,0,6
3,2435,2479,-44,0,485,0,6
3,2337,2439,-102,0,113,0,6
3,2470,2404,66,0,300,0,6
3,2406,2545,-139,0,277,0,6
3,2422,2403,19,0,15,0,6
3,2436,2471,-35,0,115,0,6
3,2426,2470,-44,0,4,0,6
3,2424,2518,-94,0,102,0,6
3,2456,2319,137,0,127,0,6
3,2405,2406,-1,0,302,0,6
3,2447,2452,-5,0,112,0,6
3,2390,2403,-13,0,50,0,6
3,2377,2416,-39,0,453,0,6
3,2473,2470,3,0,255,0,6
3,2392,2469,-77,0,110,0,6
3,2439,2455,-16,0,190,0,6
3,2457,2352,105,0,265,0,6
3,2500,2454,46,0,212,0,6
3,2439,2478,-39,0,484,0,6
3,2310,2432,-122,0,354,0,6
3,2408,2441,-33,0,202,0,6
3,2477,2393,84,0,311,0,6
3,2434,2432,2,0,101,0,6
3,2598,2587,11,0,0,0,6
3,2405,2460,-55,0,359,0,6
3,2398,2401,-3,0,345,0,6
3,2459,2447,12,0,474,0,6
3,2364,2465,-101,0,43,0,6
3,2462,2416,46,0,338,0,6
3,2374,2415,-41,0,117,0,8
3,2492,2571,-79,0,190,0,6
3,2427,2366,61,0,340,0,6
3,2459,2488,-29,0,5,0,6
3,2481,2405,76,0,73,0,6
3,2435,2482,-47,0,58,0,6
3,2563,2450,113,0,152,0,6
3,2559,2517,42,0,14,0,6
3,2610,2468,142,0,5,0,6
3,2357,2437,-80,0,474,0,6
3,2507,2257,250,0,226,0,6
3,2452,2562,-110,0,13,0,6
3,2303,2409,-106,0,115,0,6
3,2374,2479,-105,0,135,0,6
3,2440,2294,146,0,113,0,6
3,2411,2426,-15,0,400,0,6
3,2431,2436,-5,0,250,0,6
3,2335,2460,-125,0,206,0,6
3,2406,2376,30,0,303,0,6
3,2564,2513,51,0,8,0,6
3,2259,2407,-148,0,240,0,6
3,2314,2486,-172,0,4,0,6
3,2466,2457,9,0,80,0,6
3,2309,2405,-96,0,101,0,6
3,2714,2483,231,0,111,0,6
3,2365,2545,-180,0,4,0,6
3,2385,2456,-71,0,191,0,6
3,2563,2467,96,0,310,0,6
3,2443,2379,64,0,0,0,6
3,2405,2309,96,0,45,0,6
3,2437,2430,7,0,250,0,6
3,2379,2407,-28,0,411,0,6
3,2450,2374,76,0,127,0,6
3,2414,2406,8,0,409,0,6
3,2329,2472,-143,0,45,0,6
3,2514,2407,107,0,45,0,6
3,2432,2401,31,0,100,0,6
3,2404,2300,104,0,303,0,6
3,2481,2634,-153,0,4,0,6
3,2264,2428,-164,0,3,0,6
3,2466,2419,47,0,85,0,6
3,2474,2450,24,0,4,0,6
3,2409,2400,9,0,330,0,6
3,2486,2426,60,4,343,0,13
3,2370,2421,-51,0,101,0,6
3,2315,2452,-137,0,120,0,6
3,2616,2561,55,0,81,0,6
3,2472,2377,95,0,200,0,6
3,2459,2461,-2,0,123,0,6
3,2427,2484,-57,4,414,0,13
3,2500,2265,235,0,217,0,6
3,2437,2711,-274,0,278,0,6
3,2707,2637,70,0,5,0,6
3,2307,2449,-142,0,300,0,6
3,2358,2413,-55,0,48,0,6
3,2369,2484,-115,0,130,0,6
3,2344,2501,-157,0,7,0,6
3,2409,2339,70,0,112,0,6
3,2462,2379,83,0,130,0,6
3,2409,2606,-197,0,306,0,6
3,2317,2423,-106,0,40,0,6
3,2452,2458,-6,0,262,0,6
3,2358,2450,-92,0,125,0,6
3,2441,2323,118,0,90,0,6
3,2502,2289,213,0,45,0,6
3,2572,2531,41,0,103,0,6
3,2504,2425,79,0,40,0,6
3,2418,2257,161,0,302,0,6
3,2376,2454,-78,0,34,0,6
3,2393,2421,-28,0,206,0,6
3,2280,2405,-125,0,343,0,6
3,2446,2547,-101,0,245,0,6
3,2366,2567,-201,0,45,0,6
3,2426,2463,-37,0,0,0,6
3,2305,2414,-109,0,105,0,6
3,2520,2316,204,0,153,0,6
3,2394,2523,-129,0,41,0,6
3,2504,2249,255,0,302,0,6
3,2439,2410,29,0,128,0,6
3,2343,2408,-65,0,310,0,6
3,2565,2627,-62,0,141,0,6
3,2451,2554,-103,0,4,0,6
3,2787,2525,262,0,116,0,6
3,2400,2277,123,0,43,0,6
3,2658,2784,-126,0,125,0,6
3,2527,2398,129,0,122,0,6
3,2596,2541,55,0,9,0,6
3,2432,2417,15,0,100,0,6
3,2376,2547,-171,0,23,0,6
3,2582,2588,-6,0,373,0,6
3,2456,2602,-146,0,100,0,6
3,2544,2484,60,0,325,0,6
3,2479,2525,-46,0,255,0,6
3,2544,2409,135,0,409,0,6
3,2458,2345,113,0,80,0,6
3,2457,2504,-47,0,73,0,6
3,2549,2622,-73,0,302,0,6
3,2300,2431,-131,0,41,0,6
3,2487,2480,7,0,110,0,6
3,2304,2453,-149,0,43,0,6
3,2621,2583,38,0,406,0,6
3,2413,2410,3,0,122,0,6
3,2732,2785,-53,0,405,0,6
3,2265,2400,-135,0,4,0,6
3,2434,2386,48,0,386,0,6
3,2420,2361,59,0,48,0,8
3,2407,2223,184,0,108,0,6
3,2410,2379,31,0,90,0,6
3,2513,2613,-100,0,216,0,6
3,2374,2457,-83,0,152,0,6
3,2317,2441,-124,0,3,0,6
3,2226,2526,-300,0,46,0,6
3,2292,2518,-226,0,46,0,6
3,2533,2542,-9,0,486,0,6
3,2642,2658,-16,0,190,0,6
3,2658,2533,125,0,310,0,6
3,2627,2515,112,0,28,0,6
3,2468,2417,51,0,45,0,6
3,2519,2542,-23,0,46,0,6
3,2454,2522,-68,0,102,0,6
3,2261,2502,-241,0,106,0,6
3,2443,2336,107,0,373,0,6
3,2661,2528,133,0,308,0,6
3,2434,2451,-17,0,241,0,8
3,2262,2470,-208,0,117,0,6
3,2420,2540,-120,0,40,0,6
3,2413,2450,-37,0,104,0,6
3,2420,2322,98,0,151,0,6
3,2373,2492,-119,0,46,0,6
3,2377,2440,-63,0,150,0,6
3,2559,2425,134,0,250,0,6
3,2597,2446,151,0,110,0,6
3,2599,2537,62,0,106,0,6
3,2451,2303,148,0,113,0,8
3,2319,2490,-171,4,45,0,13
3,2447,2323,124,0,7,0,6
3,2453,2571,-118,0,110,0,6
3,2427,2556,-129,0,253,0,6
3,2439,2322,117,0,110,0,6
3,2403,2224,179,4,306,0,13
3,2591,2526,65,0,45,0,6
3,2569,2479,90,0,5,0,6
3,2448,2375,73,0,267,0,6
3,2462,2268,194,0,0,0,6
3,2682,2261,421,2,147,0,24
3,2725,2641,84,0,101,0,6
3,2409,2454,-45,0,242,0,6
3,2291,2523,-232,0,117,0,6
3,2536,2534,2,0,242,0,6
3,2429,2552,-123,0,253,0,6
3,2588,2474,114,0,108,0,6
3,2507,2437,70,0,46,0,6
3,2557,2522,35,0,483,0,6
3,2619,2554,65,0,250,0,6
3,2549,2431,118,0,250,0,6
3,2361,2462,-101,0,45,0,6
3,2411,2303,108,0,172,0,6
3,2405,2460,-55,0,218,0,6
3,2406,2542,-136,0,112,0,6
3,2687,2588,99,0,112,0,6
3,2390,2556,-166,0,113,0,6
3,2476,2457,19,0,46,0,6
3,2547,2495,52,0,113,0,6
3,2514,2322,192,0,311,0,6
3,2484,2461,23,0,304,0,6
3,2677,2596,81,0,107,0,6
3,2623,2284,339,0,145,0,6
3,2289,2435,-146,0,46,0,6
3,2442,2383,59,0,140,0,6
3,2343,2459,-116,0,41,0,6
3,2435,2543,-108,0,253,0,8
3,2409,2254,155,0,101,0,6
3,2297,2488,-191,0,289,0,8
3,2416,2379,37,0,336,0,6
3,2245,2412,-167,0,411,0,6
3,2458,2345,113,0,244,0,6
3,2297,2491,-194,0,110,0,6
3,2477,2438,39,0,58,0,6
3,2379,2411,-32,0,192,0,6
3,2540,2437,103,0,250,0,8
3,2235,2459,-224,0,103,0,6
3,2490,2536,-46,0,248,0,6
3,2693,2585,108,0,216,0,6
3,2675,2600,75,0,112,0,6
3,2321,2513,-192,0,41,0,6
3,2474,2535,-61,0,48,0,6
3,2464,2491,-27,0,45,0,6
3,2556,2607,-51,0,80,0,6
3,2550,2445,105,0,338,0,6
3,2448,2372,76,0,122,0,6
3,2413,2364,49,0,130,0,6
3,2415,2421,-6,0,242,0,6
3,2313,2409,-96,0,104,0,6
3,2334,2445,-111,0,4,0,6
3,2383,2405,-22,0,310,0,6
3,2488,2403,85,0,15,0,6
3,2402,2397,5,0,300,0,6
3,2490,2499,-9,0,327,0,6
3,2604,2542,62,0,250,0,6
3,2397,2468,-71,0,302,0,6
3,2467,2431,36,0,7,0,6
3,2346,2524,-178,0,260,0,6
3,2466,2489,-23,0,108,0,6
3,2485,2551,-66,0,45,0,6
3,2472,2387,85,0,247,0,6
3,2461,2559,-98,0,15,0,6
3,2222,2422,-200,0,45,0,6
3,2363,2500,-137,0,28,0,6
3,2460,2311,149,0,133,0,6
3,2421,2385,36,0,10,0,6
3,2200,2433,-233,0,150,0,6
3,2566,2594,-28,0,140,0,6
3,2388,2467,-79,0,150,0,6
3,2302,2427,-125,0,61,0,6
3,2594,2432,162,0,1,0,6
3,2489,2388,101,0,301,0,6
3,2392,2592,-200,0,61,0,6
3,2564,2341,223,0,204,0,6
3,2266,2594,-328,0,492,0,6
3,2404,2295,109,0,0,0,6
3,2508,2412,96,0,267,0,6
3,2567,2420,147,0,42,0,6
3,2462,2399,63,0,4,0,6
3,2469,2399,70,0,0,0,6
3,2400,2590,-190,0,49,0,6
3,2512,2594,-82,0,404,0,6
3,2456,2403,53,0,244,0,6
3,2404,2495,-91,0,307,0,6
3,2425,2304,121,0,16,0,6
3,2593,2456,137,0,302,0,6
3,2508,2442,66,0,325,0,6
3,2458,2405,53,0,15,0,6
3,2493,2591,-98,0,41,0,6
3,2438,2367,71,0,302,0,6
3,2406,2332,74,0,312,0,6
3,2396,2467,-71,0,125,0,6
3,2413,2343,70,0,404,0,6
3,2319,2414,-95,0,45,0,6
3,2428,2281,147,0,131,0,6
3,2405,2417,-12,0,460,0,6
3,2300,2467,-167,0,40,0,6
3,2552,2589,-37,0,201,0,6
3,2589,2526,63,0,255,0,6
3,2458,2505,-47,0,107,0,6
3,2408,2313,95,0,339,0,6
3,2422,2435,-13,0,13,0,6
3,2563,2208,355,0,118,0,6
3,2498,2418,80,0,301,0,6
3,2589,2454,135,0,1,0,6
3,2271,2404,-133,0,262,0,6
3,2466,2435,31,0,140,0,6
3,2583,2587,-4,0,242,0,6
3,2587,2516,71,0,227,0,6
3,2517,2526,-9,0,43,0,6
3,2652,2572,80,0,388,0,6
3,2317,2538,-221,0,101,0,6
3,2458,2538,-80,0,114,0,6
3,2479,2670,-191,0,81,0,6
3,2420,2590,-170,0,122,0,6
3,2359,2442,-83,0,124,0,6
3,2365,2567,-202,0,102,0,6
3,2428,2414,14,0,463,0,6
3,2398,2402,-4,0,45,0,6
3,2458,2320,138,0,5,0,6
3,2319,2477,-158,2,16,0,25
3,2406,2358,48,0,308,0,6
3,2414,2206,208,0,394,0,6
3,2381,2477,-96,0,4,0,6
3,2418,2313,105,0,305,0,6
3,2274,2486,-212,0,307,0,6
3,2428,2416,12,0,106,0,6
3,2586,2529,57,0,101,0,6
3,2488,2509,-21,0,0,0,6
3,2663,2318,345,2,202,0,24
3,2782,2543,239,0,380,0,6
3,2585,2663,-78,0,123,0,6
3,2614,2444,170,0,320,0,6
3,2520,2601,-81,0,46,0,6
3,2428,2407,21,0,140,0,6
3,2408,2504,-96,0,48,0,6
3,2330,2489,-159,0,127,0,6
3,2405,2344,61,0,41,0,6
3,2537,2324,213,0,241,0,6
3,2379,2602,-223,0,200,0,6
3,2555,2525,30,0,305,0,6
3,2620,2527,93,0,332,0,6
3,2435,2354,81,0,101,0,6
3,2325,2412,-87,0,214,0,6
3,2559,2469,90,0,245,0,6
3,2474,2469,5,0,28,0,6
3,2416,2383,33,0,338,0,6
3,2394,2490,-96,0,307,0,6
3,2474,2208,266,0,124,0,6
3,2405,2461,-56,0,121,0,6
3,2417,2466,-49,0,150,0,6
3,2533,2545,-12,0,140,0,6
3,2327,2599,-272,0,267,0,6
3,2522,2472,50,0,218,0,6
3,2459,2589,-130,0,210,0,6
3,2470,2562,-92,0,4,0,6
3,2410,2452,-42,0,106,0,6
3,2568,2412,156,0,49,0,6
3,2430,2373,57,0,414,0,6
3,2539,2566,-27,0,405,0,6
3,2471,2323,148,2,217,0,25
3,2697,2663,34,0,190,0,6
3,2315,2413,-98,0,242,0,6
3,2518,2623,-105,0,22,0,6
3,2406,2466,-60,0,484,0,6
3,2351,2425,-74,0,102,0,6
3,2449,2377,72,0,8,0,6
3,2504,2344,160,0,347,0,6
3,2508,2428,80,0,301,0,6
3,2477,2264,213,0,152,0,8
3,2552,2424,128,0,331,0,6
3,2485,2417,68,0,40,0,6
3,2367,2488,-121,0,335,0,6
3,2429,2439,-10,0,215,0,6
3,2607,2593,14,0,200,0,6
3,2560,2561,-1,0,49,0,6
3,2533,2554,-21,0,57,0,6
3,2416,2297,119,0,14,0,6
3,2449,2674,-225,0,112,0,6
3,2402,2296,106,0,100,0,6
3,2269,2541,-272,0,45,0,6
3,2307,2414,-107,0,200,0,6
3,2506,2471,35,0,0,0,6
3,2415,2452,-37,0,22,0,6
3,2452,2431,21,0,111,0,6
3,2466,2486,-20,0,218,0,6
3,2262,2413,-151,0,40,0,6
3,2262,2408,-146,0,49,0,6
3,2514,2399,115,0,211,0,6
3,2558,2586,-28,0,310,0,6
3,2409,2567,-158,0,40,0,6
3,2519,2399,120,0,143,0,6
3,2406,2368,38,0,112,0,6
3,2525,2379,146,0,80,0,6
3,2564,2595,-31,0,46,0,6
3,2466,2339,127,0,40,0,6
3,2393,2405,-12,0,106,0,6
3,2335,2500,-165,0,200,0,6
3,2394,2550,-156,0,256,0,6
3,2326,2457,-131,0,106,0,6
3,2281,2564,-283,0,250,0,6
3,2595,2595,0,0,122,0,6
3,2400,2478,-78,0,28,0,6
3,2510,2595,-85,0,241,0,6
3,2455,2510,-55,0,211,0,6
3,2409,2261,148,0,101,0,6
3,2597,2547,50,0,265,0,6
3,2397,2561,-164,0,100,0,6
3,2515,2455,60,0,45,0,6
3,2651,2233,418,0,327,0,6
3,2455,2401,54,0,130,0,6
3,2452,2525,-73,0,107,0,6
3,2403,2646,-243,0,40,0,6
3,2438,2359,79,0,30,0,6
3,2530,2380,150,0,156,0,6
3,2286,2408,-122,0,250,0,6
3,2416,2554,-138,0,104,0,6
3,2264,2412,-148,0,218,0,6
3,2387,2596,-209,0,108,0,6
3,2447,2493,-46,0,278,0,6
3,2526,2597,-71,0,210,0,6
3,2450,2379,71,0,101,0,6
3,2545,2449,96,0,40,0,6
3,2314,2415,-101,0,267,0,6
3,2403,2559,-156,0,453,0,6
3,2422,2405,17,0,245,0,6
3,2422,2436,-14,0,244,0,6
3,2575,2599,-24,0,201,0,6
3,2516,2448,68,0,300,0,6
3,2408,2521,-113,0,70,0,6
3,2343,2452,-109,0,30,0,6
3,2410,2628,-218,0,40,0,6
3,2604,2550,54,0,0,0,6
3,2506,2561,-55,0,301,0,6
3,2575,2603,-28,0,203,0,6
3,2437,2285,152,0,145,0,6
3,2299,2412,-113,0,188,0,6
3,2664,2538,126,0,46,0,6
3,2407,2253,154,0,0,0,6
3,2436,2435,1,0,247,0,6
3,2453,2456,-3,0,315,0,6
3,2461,2342,119,0,101,0,6
3,2307,2428,-121,0,49,0,8
3,2432,2584,-152,0,113,0,6
3,2501,2666,-165,0,43,0,6
3,2458,2451,7,0,140,0,6
3,2206,2602,-396,0,115,0,6
3,2482,2573,-91,0,330,0,6
3,2560,2510,50,0,154,0,6
3,2444,2419,25,0,43,0,6
3,2420,2561,-141,0,103,0,6
3,2399,2559,-160,0,345,0,6
3,2363,2400,-37,0,120,0,6
3,2422,2622,-200,0,122,0,6
3,2558,2582,-24,0,58,0,6
3,2359,2504,-145,0,120,0,6
3,2424,2401,23,0,338,0,6
3,2442,2211,231,0,123,0,6
3,2598,2557,41,0,1,0,6
3,2444,2338,106,0,4,0,6
3,2524,2434,90,0,300,0,6
3,2584,2615,-31,0,319,0,6
3,2507,2509,-2,0,45,0,6
3,2365,2456,-91,0,400,0,6
3,2362,2504,-142,0,432,0,6
3,2479,2576,-97,0,330,0,6
3,2468,2461,7,0,20,0,6
3,2447,2414,33,0,101,0,6
3,2554,2591,-37,0,46,0,6
3,2354,2468,-114,0,121,0,6
3,2446,2376,70,0,190,0,6
3,2648,2591,57,0,335,0,6
3,2492,2501,-9,0,40,0,6
3,2317,2427,-110,4,107,0,13
3,2451,2432,19,0,200,0,6
3,2503,2428,75,0,411,0,6
3,2421,2411,10,0,127,0,6
3,2500,2317,183,0,138,0,6
3,2498,2496,2,0,40,0,6
3,2538,2220,318,0,250,0,8
3,2456,2550,-94,0,313,0,6
3,2446,2336,110,0,102,0,6
3,2543,2380,163,0,337,0,6
3,2409,2331,78,0,101,0,6
3,2306,2476,-170,0,454,0,6
3,2299,2420,-121,0,317,0,6
3,2335,2447,-112,0,152,0,6
3,2425,2293,132,0,40,0,6
3,2453,2355,98,0,315,0,6
3,2475,2444,31,0,453,0,6
3,2397,2441,-44,0,4,0,6
3,2383,2428,-45,0,485,0,6
3,2409,2368,41,0,4,0,6
3,2341,2497,-156,0,246,0,6
3,2469,2428,41,0,42,0,6
3,2440,2423,17,0,100,0,6
3,2450,2403,47,4,151,0,13
3,2382,2445,-63,0,45,0,6
3,2491,2458,33,0,264,0,6
3,2442,2378,64,0,211,0,6
3,2531,2543,-12,0,46,0,6
3,2411,2230,181,0,91,0,6
3,2419,2346,73,0,330,0,6
3,2364,2558,-194,0,106,0,6
3,2421,2453,-32,0,150,0,6
3,2401,2289,112,0,113,0,6
3,2406,2514,-108,0,40,0,6
3,2486,2392,94,0,485,0,6
3,2267,2404,-137,0,40,0,6
3,2446,2417,29,0,242,0,6
3,2510,2562,-52,0,164,0,6
3,2305,2414,-109,0,310,0,6
3,2484,2420,64,0,320,0,6
3,2455,2345,110,0,315,0,6
3,2418,2522,-104,0,319,0,6
3,2417,2352,65,0,8,0,6
3,2562,2510,52,0,151,0,6
3,2436,2420,16,0,255,0,6
3,2441,2360,81,0,107,0,6
3,2331,2437,-106,0,147,0,6
3,2388,2521,-133,0,40,0,6
3,2243,2403,-160,0,227,0,6
3,2420,2524,-104,0,319,0,6
3,2653,2428,225,0,48,0,6
3,2468,2575,-107,0,13,0,6
3,2299,2422,-123,0,17,0,6
3,2457,2429,28,0,311,0,6
3,2486,2418,68,0,245,0,6
3,2358,2452,-94,0,34,0,6
3,2300,2425,-125,0,56,0,6
3,2319,2454,-135,0,473,0,8
3,2463,2510,-47,0,4,0,6
3,2587,2589,-2,0,300,0,6
3,2423,2393,30,0,211,0,6
3,2419,2382,37,0,110,0,6
3,2431,2212,219,0,200,0,6
3,2589,2587,2,0,7,0,6
3,2414,2242,172,0,401,0,6
3,2481,2570,-89,0,310,0,6
3,2495,2389,106,0,132,0,6
3,2341,2424,-83,0,306,0,6
3,2421,2457,-36,0,107,0,6
3,2423,2343,80,0,45,0,6
3,2381,2429,-48,0,70,0,6
3,2393,2412,-19,0,131,0,6
3,2503,2564,-61,0,400,0,6
3,2587,2589,-2,0,300,0,6
3,2358,2431,-73,0,16,0,6
3,2459,2378,81,0,40,0,6
3,2207,2504,-297,0,303,0,6
3,2600,2766,-166,0,49,0,6
3,2459,2534,-75,0,286,0,6
3,2453,2562,-109,0,311,0,6
3,2339,2496,-157,0,453,0,6
3,2288,2450,-162,0,337,0,6
3,2487,2475,12,0,182,0,6
3,2417,2461,-44,0,141,0,6
3,2676,2681,-5,0,109,0,6
3,2610,2347,263,0,1,0,6
3,2464,2384,80,0,464,0,6
3,2462,2418,44,4,131,0,13
3,2538,2453,85,0,40,0,6
3,2442,2381,61,0,106,0,6
3,2435,2331,104,0,46,0,6
3,2445,2378,67,0,341,0,6
3,2681,2676,5,0,40,0,6
3,2492,2486,6,0,140,0,6
3,2602,2601,1,0,411,0,6
3,2602,2561,41,0,335,0,6
3,2472,2472,0,0,427,0,6
3,2433,2452,-19,0,338,0,6
3,2404,2406,-2,0,201,0,6
3,2467,2391,76,0,29,0,6
3,2494,2542,-48,0,263,0,6
3,2401,2392,9,0,320,0,6
3,2406,2415,-9,0,45,0,6
3,2599,2602,-3,0,167,0,6
3,2545,2499,46,0,101,0,6
3,2474,2482,-8,0,56,0,6
3,2528,2504,24,0,20,0,6
3,2440,2465,-25,0,370,0,6
3,2452,2372,80,0,131,0,6
3,2564,2528,36,0,122,0,6
3,2461,2416,45,0,207,0,6
3,2323,2410,-87,0,335,0,6
3,2422,2621,-199,0,389,0,6
3,2201,2668,-467,0,143,0,6
3,2201,2419,-218,0,241,0,6
3,2430,2272,158,0,171,0,6
3,2480,2461,19,0,17,0,6
3,2557,2598,-41,0,5,0,6
3,2410,2278,132,0,45,0,6
3,2600,2463,137,0,463,0,6
3,2466,2542,-76,0,268,0,6
3,2408,2467,-59,0,310,0,6
3,2492,2651,-159,0,122,0,6
3,2399,2826,-427,0,108,0,6
3,2562,2282,280,0,37,0,6
3,2205,2408,-203,0,13,0,6
3,2293,2443,-150,0,110,0,6
3,2495,2401,94,0,107,0,6
3,2257,2436,-179,0,46,0,6
3,2334,2401,-67,0,0,0,6
3,2550,2476,74,0,304,0,6
3,2400,2354,46,0,109,0,6
3,2387,2559,-172,0,125,0,6
3,2442,2237,205,0,9,0,6
3,2435,2234,201,0,40,0,6
3,2392,2406,-14,0,101,0,6
3,2325,2506,-181,0,141,0,6
3,2450,2433,17,0,46,0,6
3,2353,2475,-122,0,310,0,6
3,2515,2558,-43,0,110,0,6
3,2360,2427,-67,0,122,0,6
3,2403,2258,145,0,45,0,6
3,2256,2469,-213,0,302,0,6
3,2226,2510,-284,0,200,0,6
3,2485,2478,7,0,311,0,6
3,2517,2622,-105,0,7,0,6
3,2421,2506,-85,0,43,0,6
3,2454,2220,234,0,4,0,6
3,2572,2279,293,0,202,0,6
3,2211,2573,-362,0,194,0,6
3,2409,2259,150,0,310,0,6
3,2438,2238,200,0,101,0,6
3,2424,2304,120,0,157,0,6
3,2527,2375,152,0,319,0,6
3,2407,2408,-1,0,45,0,6
3,2414,2243,171,0,40,0,6
3,2498,2362,136,0,211,0,6
3,2230,2518,-288,0,130,0,6
3,2438,2324,114,0,127,0,6
3,2546,2261,285,0,143,0,6
3,2549,2519,30,0,118,0,6
3,2339,2469,-130,0,34,0,6
3,2282,2426,-144,0,122,0,6
3,2432,2611,-179,0,250,0,6
3,2448,2597,-149,0,325,0,6
3,2434,2311,123,0,122,0,6
3,2557,2456,101,0,4,0,6
3,2561,2492,69,0,122,0,6
3,2376,2505,-129,0,28,0,6
3,2393,2442,-49,0,101,0,6
3,2505,2638,-133,0,246,0,6
3,2487,2423,64,0,405,0,6
3,2432,2302,130,0,300,0,6
3,2486,2608,-122,0,264,0,6
3,2229,2551,-322,0,126,0,6
3,2357,2513,-156,0,132,0,6
3,2488,2336,152,0,176,0,6
3,2440,2234,206,0,155,0,6
3,2424,2488,-64,0,128,0,6
3,2239,2444,-205,0,121,0,6
3,2487,2238,249,0,1,0,6
3,2483,2365,118,0,15,0,6
3,2503,2482,21,0,125,0,6
3,2530,2539,-9,0,80,0,6
3,2578,2584,-6,0,327,0,6
3,2236,2426,-190,0,5,0,6
3,2531,2497,34,0,399,0,6
3,2373,2467,-94,0,0,0,6
3,2316,2455,-139,4,131,0,13
3,2244,2521,-277,0,300,0,6
3,2464,2511,-47,0,211,0,6
3,2401,2292,109,0,202,0,6
3,2435,2429,6,0,9,0,6
3,2406,2515,-109,0,104,0,6
3,2426,2256,170,0,150,0,6
3,2426,2288,138,0,109,0,6
3,2452,2297,155,0,288,0,6
3,2587,2556,31,0,455,0,6
3,2431,2397,34,0,311,0,6
3,2430,2291,139,0,331,0,6
3,2508,2553,-45,0,107,0,6
3,2450,2457,-7,0,4,0,6
3,2276,2500,-224,0,153,0,6
3,2412,2347,65,0,40,0,6
3,2617,2366,251,0,400,0,6
3,2240,2424,-184,0,140,0,6
3,2437,2569,-132,0,306,0,6
3,2455,2300,155,0,7,0,6
3,2575,2510,65,0,245,0,6
3,2352,2483,-131,0,200,0,6
3,2322,2436,-114,0,4,0,6
3,2259,2478,-219,0,46,0,6
3,2485,2467,18,0,107,0,6
3,2293,2561,-268,0,13,0,6
3,2282,2404,-122,0,45,0,8
3,2310,2497,-187,0,455,0,6
3,2394,2472,-78,0,7,0,6
3,2565,2521,44,0,70,0,6
3,2410,2597,-187,0,10,0,6
3,2398,2451,-53,0,414,0,6
3,2416,2216,200,0,46,0,6
3,2468,2494,-26,0,373,0,6
3,2581,2587,-6,0,314,0,6
3,2516,2536,-20,0,6,0,6
3,2356,2445,-89,0,245,0,6
3,2542,2257,285,0,8,0,6
3,2424,2388,36,0,122,0,6
3,2518,2439,79,0,463,0,6
3,2214,2494,-280,0,151,0,6
3,2299,2621,-322,0,140,0,6
3,2424,2435,-11,0,242,0,6
3,2448,2395,53,0,337,0,6
3,2377,2539,-162,0,121,0,6
3,2201,2422,-221,0,31,0,6
3,2692,2262,430,0,174,0,6
3,2373,2523,-150,0,302,0,6
3,2544,2518,26,0,346,0,6
3,2476,2472,4,0,107,0,6
3,2311,2481,-170,0,245,0,6
3,2350,2436,-86,0,302,0,6
3,2372,2474,-102,0,106,0,6
3,2573,2442,131,0,190,0,6
3,2281,2463,-182,0,373,0,6
3,2541,2468,73,0,40,0,6
3,2441,2454,-13,0,260,0,6
3,2218,2414,-196,0,469,0,6
3,2386,2538,-152,0,85,0,6
3,2500,2431,69,0,212,0,6
3,2557,2492,65,0,315,0,6
3,2453,2319,134,4,256,0,13
3,2258,2569,-311,0,80,0,6
3,2607,2590,17,0,310,0,6
3,2475,2473,2,0,41,0,6
3,2494,2448,46,0,7,0,6
3,2514,2303,211,0,141,0,6
3,2488,2571,-83,0,113,0,6
3,2384,2493,-109,0,179,0,6
3,2497,2599,-102,0,210,0,6
3,2445,2374,71,0,61,0,6
3,2294,2485,-191,0,120,0,6
3,2596,2654,-58,0,483,0,6
3,2211,2484,-273,0,130,0,6
3,2235,2409,-174,0,306,0,8
3,2430,2258,172,0,80,0,6
3,2422,2408,14,0,40,0,6
3,2607,2572,35,0,345,0,6
3,2447,2466,-19,0,7,0,6
3,2516,2433,83,0,258,0,6
3,2462,2205,257,0,106,0,6
3,2363,2408,-45,0,123,0,6
3,2420,2393,27,0,210,0,6
3,2550,2394,156,0,409,0,6
3,2260,2540,-280,0,404,0,6
3,2200,2528,-328,0,208,0,6
3,2564,2439,125,0,46,0,6
3,2390,2418,-28,0,106,0,6
3,2602,2487,115,0,250,0,6
3,2445,2472,-27,0,210,0,6
3,2502,2585,-83,0,362,0,6
3,2330,2514,-184,0,240,0,6
3,2474,2445,29,0,345,0,6
3,2347,2414,-67,0,245,0,6
3,2314,2476,-162,0,40,0,6
3,2331,2410,-79,0,460,0,6
3,2443,2582,-139,0,403,0,6
3,2352,2401,-49,0,394,0,6
3,2221,2470,-249,0,455,0,8
3,2555,2466,89,0,57,0,6
3,2426,2469,-43,0,398,0,6
3,2375,2469,-94,0,0,0,6
3,2580,2658,-78,0,40,0,6
3,2342,2411,-69,0,45,0,6
3,2421,2500,-79,0,100,0,6
3,2304,2481,-177,0,459,0,6
3,2453,2656,-203,0,172,0,6
3,2473,2406,67,0,107,0,6
3,2447,2327,120,0,4,0,6
3,2523,2584,-61,0,40,0,6
3,2352,2514,-162,0,95,0,6
3,2638,2284,354,0,140,0,6
3,2373,2484,-111,0,265,0,6
3,2420,2400,20,0,132,0,6
3,2531,2441,90,0,201,0,6
3,2328,2412,-84,0,40,0,6
3,2416,2269,147,0,302,0,6
3,2396,2566,-170,0,43,0,6
3,2576,2445,131,0,388,0,6
3,2262,2427,-165,0,48,0,6
3,2348,2529,-181,0,122,0,6
3,2408,2519,-111,0,58,0,6
3,2552,2336,216,0,106,0,6
3,2534,2695,-161,0,255,0,6
3,2688,2577,111,0,215,0,6
3,2314,2427,-113,0,119,0,6
3,2566,2445,121,0,0,0,6
3,2374,2402,-28,0,123,0,6
3,2422,2445,-23,0,0,0,6
3,2692,2687,5,0,46,0,6
3,2679,2280,399,0,154,0,6
3,2357,2420,-63,0,0,0,6
3,2445,2463,-18,0,302,0,6
3,2438,2525,-87,0,45,0,6
3,2203,2423,-220,0,110,0,6
3,2517,2511,6,0,310,0,6
3,2435,2309,126,0,112,0,6
3,2404,2447,-43,0,110,0,6
3,2527,2235,292,0,101,0,6
3,2394,2553,-159,0,151,0,6
3,2228,2406,-178,0,172,0,6
3,2556,2360,196,0,260,0,6
3,2234,2412,-178,0,115,0,6
3,2541,2377,164,0,46,0,6
3,2428,2554,-126,0,154,0,6
3,2522,2666,-144,0,311,0,6
3,2517,2420,97,0,46,0,6
3,2511,2342,169,0,4,0,6
3,2384,2558,-174,0,49,0,6
3,2300,2416,-116,0,80,0,6
3,2490,2614,-124,0,327,0,6
3,2459,2583,-124,0,300,0,6
3,2674,2692,-18,0,45,0,6
3,2466,2390,76,0,107,0,6
3,2319,2539,-220,0,302,0,6
3,2451,2310,141,0,90,0,6
3,2418,2413,5,0,343,0,6
3,2601,2300,301,0,210,0,6
3,2297,2437,-140,0,108,0,6
3,2503,2383,120,0,101,0,6
3,2567,2696,-129,0,20,0,6
3,2406,2394,12,0,385,0,6
3,2479,2586,-107,0,40,0,6
3,2595,2259,336,0,335,0,6
3,2375,2429,-54,0,246,0,6
3,2380,2514,-134,0,240,0,6
3,2273,2405,-132,0,302,0,6
3,2664,2241,423,0,45,0,6
3,2382,2417,-35,0,107,0,6
3,2422,2373,49,0,277,0,6
3,2522,2562,-40,0,100,0,6
3,2356,2512,-156,0,302,0,6
3,2548,2264,284,0,487,0,6
3,2520,2333,187,0,45,0,6
3,2499,2456,43,0,15,0,6
3,2417,2522,-105,0,58,0,6
3,2600,2311,289,0,57,0,6
3,2420,2390,30,0,180,0,6
3,2338,2450,-112,0,300,0,6
3,2520,2241,279,0,106,0,6
3,2616,2307,309,0,302,0,6
3,2389,2422,-33,0,45,0,6
3,2419,2453,-34,0,310,0,6
3,2420,2337,83,0,110,0,6
3,2517,2434,83,0,203,0,6
3,2403,2358,45,0,2,0,6
3,2525,2390,135,0,296,0,6
3,2425,2511,-86,0,36,0,6
3,2424,2433,-9,0,46,0,6
3,2311,2527,-216,0,0,0,6
3,2482,2250,232,0,40,0,6
3,2473,2507,-34,0,87,0,6
3,2219,2487,-268,0,428,0,6
3,2513,2418,95,0,211,0,6
3,2468,2521,-53,0,487,0,6
3,2287,2463,-176,0,52,0,6
3,2258,2418,-160,0,7,0,6
3,2353,2430,-77,0,45,0,6
3,2329,2420,-91,0,4,0,6
3,2448,2266,182,0,302,0,6
3,2348,2416,-68,0,204,0,6
3,2407,2394,13,0,122,0,6
3,2411,2363,48,0,101,0,6
3,2322,2498,-176,0,103,0,6
3,2576,2341,235,0,107,0,6
3,2415,2206,209,0,138,0,6
3,2508,2329,179,0,101,0,6
3,2416,2420,-4,0,46,0,6
3,2394,2581,-187,0,143,0,6
3,2413,2427,-14,0,61,0,6
3,2429,2623,-194,0,8,0,6
3,2511,2456,55,0,106,0,6
3,2435,2364,71,0,226,0,6
3,2318,2487,-169,0,302,0,6
3,2479,2417,62,0,245,0,6
3,2241,2416,-175,0,464,0,6
3,2341,2472,-131,0,196,0,6
3,2542,2516,26,0,312,0,6
3,2546,2546,0,0,304,0,6
3,2457,2289,168,0,4,0,6
3,2509,2463,46,0,210,0,6
3,2358,2503,-145,0,240,0,6
3,2555,2430,125,0,132,0,6
3,2421,2521,-100,0,102,0,6
3,2435,2241,194,0,208,0,6
3,2515,2355,160,0,314,0,6
3,2689,2562,127,0,7,0,6
3,2344,2465,-121,0,130,0,6
3,2496,2397,99,0,109,0,6
3,2435,2440,-5,0,302,0,6
3,2431,2382,49,0,46,0,6
3,2702,2682,20,0,46,0,6
3,2558,2459,99,0,117,0,6
3,2536,2313,223,0,18,0,6
3,2363,2474,-111,0,5,0,6
3,2592,2520,72,0,3,0,6
3,2509,2515,-6,0,136,0,6
3,2442,2268,174,0,140,0,6
3,2546,2436,110,0,41,0,6
3,2510,2414,96,0,10,0,6
3,2582,2268,314,0,310,0,6
3,2383,2509,-126,0,40,0,6
3,2363,2490,-127,0,8,0,6
3,2342,2568,-226,0,100,0,6
3,2835,2281,554,0,203,0,6
3,2427,2418,9,0,150,0,6
3,2277,2446,-169,0,150,0,6
3,2449,2419,30,0,427,0,6
3,2511,2540,-29,0,43,0,6
3,2330,2410,-80,0,463,0,6
3,2326,2453,-127,0,120,0,6
3,2501,2488,13,0,10,0,6
3,2308,2452,-144,0,125,0,6
3,2411,2522,-111,0,20,0,6
3,2271,2430,-159,0,100,0,6
3,2582,2282,300,0,5,0,6
3,2420,2348,72,0,176,0,8
3,2284,2423,-139,0,48,0,6
3,2427,2356,71,0,5,0,6
3,2356,2498,-142,0,302,0,6
3,2344,2478,-134,0,200,0,6
3,2369,2406,-37,0,9,0,6
3,2451,2590,-139,0,153,0,6
3,2380,2464,-84,0,11,0,6
3,2564,2509,55,0,80,0,6
3,2297,2451,-154,0,107,0,6
3,2414,2302,112,0,45,0,6
3,2415,2402,13,0,70,0,6
3,2544,2453,91,0,45,0,6
3,2536,2830,-294,0,453,0,6
3,2370,2489,-119,0,156,0,6
3,2438,2546,-108,0,227,0,6
3,2411,2339,72,0,410,0,6
3,2433,2316,117,0,190,0,6
3,2511,2618,-107,0,40,0,6
3,2255,2491,-236,0,453,0,6
3,2412,2265,147,0,122,0,6
3,2568,2353,215,0,339,0,6
3,2394,2557,-163,0,301,0,6
3,2470,2219,251,0,45,0,6
3,2433,2501,-68,0,7,0,6
3,2342,2614,-272,0,320,0,6
3,2454,2555,-101,0,36,0,6
3,2203,2417,-214,0,107,0,6
3,2465,2364,101,0,202,0,6
3,2284,2454,-170,0,312,0,6
3,2519,2506,13,0,101,0,6
3,2594,2252,342,0,207,0,6
3,2339,2488,-149,0,45,0,6
3,2361,2559,-198,0,100,0,6
3,2350,2441,-91,0,308,0,6
3,2519,2570,-51,0,338,0,6
3,2438,2460,-22,0,345,0,6
3,2310,2439,-129,0,257,0,6
3,2455,2386,69,0,70,0,6
3,2540,2578,-38,0,250,0,6
3,2573,2278,295,0,344,0,6
3,2441,2578,-137,0,217,0,6
3,2515,2349,166,0,101,0,6
3,2445,2358,87,0,45,0,6
3,2430,2272,158,0,112,0,8
3,2480,2270,210,0,1,0,6
3,2316,2430,-114,0,141,0,6
3,2462,2534,-72,0,414,0,6
3,2581,2423,158,0,60,0,6
3,2483,2513,-30,0,104,0,6
3,2428,2255,173,0,354,0,6
3,2425,2545,-120,0,145,0,6
3,2542,2486,56,0,218,0,6
3,2464,2450,14,0,4,0,6
3,2410,2436,-26,0,120,0,6
3,2423,2229,194,0,255,0,6
3,2435,2202,233,0,40,0,6
3,2431,2383,48,0,43,0,6
3,2520,2366,154,0,200,0,6
3,2448,2330,118,0,55,0,6
3,2467,2531,-64,0,306,0,6
3,2566,2442,124,0,145,0,6
3,2592,2379,213,0,1,0,6
3,2326,2453,-127,0,303,0,6
3,2486,2538,-52,0,253,0,6
3,2306,2453,-147,0,101,0,6
3,2634,2805,-171,0,202,0,6
3,2381,2422,-41,0,152,0,6
3,2358,2423,-65,0,112,0,6
3,2567,2547,20,0,320,0,6
3,2525,2526,-1,0,40,0,6
3,2306,2431,-125,0,345,0,6
3,2296,2414,-118,0,241,0,6
3,2666,2564,102,0,5,0,6
3,2347,2442,-95,0,106,0,6
3,2405,2356,49,0,247,0,6
3,2511,2228,283,0,40,0,6
3,2445,2475,-30,0,354,0,6
3,2465,2265,200,0,0,0,6
3,2468,2369,99,0,13,0,6
3,2552,2506,46,0,248,0,6
3,2350,2449,-99,0,303,0,8
3,2618,2553,65,0,241,0,6
3,2451,2341,110,0,302,0,6
3,2338,2483,-145,0,278,0,6
3,2532,2506,26,0,46,0,6
3,2632,2512,120,0,4,0,6
3,2471,2496,-25,0,90,0,6
3,2578,2458,120,0,334,0,6
3,2513,2426,87,0,10,0,6
3,2445,2497,-52,0,114,0,6
3,2493,2371,122,0,245,0,6
3,2402,2439,-37,0,48,0,6
3,2689,2419,270,0,460,0,6
3,2532,2485,47,0,140,0,6
3,2485,2383,102,0,100,0,6
3,2525,2225,300,0,300,0,6
3,2404,2255,149,0,43,0,6
3,2443,2432,11,0,200,0,6
3,2482,2447,35,0,106,0,6
3,2534,2333,201,0,53,0,6
3,2392,2408,-16,0,45,0,6
3,2548,2553,-5,0,200,0,6
3,2303,2413,-110,0,405,0,6
3,2532,2560,-28,0,311,0,6
3,2552,2250,302,0,106,0,6
3,2426,2449,-23,0,313,0,6
3,2332,2423,-91,0,132,0,6
3,2805,2575,230,0,255,0,6
3,2385,2557,-172,0,0,0,6
3,2460,2634,-174,0,225,0,6
3,2310,2458,-148,0,63,0,6
3,2446,2246,200,0,201,0,6
3,2503,2286,217,0,46,0,6
3,2467,2493,-26,0,311,0,6
3,2542,2456,86,0,44,0,6
3,2468,2312,156,0,123,0,6
3,2477,2509,-32,0,112,0,6
3,2715,2548,167,0,49,0,6
3,2403,2501,-98,0,88,0,6
3,2263,2409,-146,0,200,0,6
3,2394,2423,-29,0,1,0,6
3,2570,2538,32,0,40,0,6
3,2379,2802,-423,0,123,0,6
3,2443,2457,-14,0,135,0,6
3,2430,2527,-97,0,4,0,6
3,2295,2463,-168,0,213,0,6
3,2283,2734,-451,0,150,0,6
3,2621,2330,291,0,221,0,6
3,2363,2628,-265,0,57,0,6
3,2490,2495,-5,0,138,0,6
3,2456,2502,-46,0,41,0,6
3,2466,2327,139,4,373,0,13
3,2400,2222,178,0,200,0,6
3,2418,2432,-14,0,330,0,6
3,2403,2523,-120,0,201,0,6
3,2412,2476,-64,0,106,0,6
3,2384,2522,-138,0,120,0,6
3,2353,2407,-54,0,110,0,6
3,2442,2586,-144,0,123,0,6
3,2421,2604,-183,0,352,0,6
3,2690,2747,-57,0,244,0,6
3,2572,2470,102,0,460,0,6
3,2440,2314,126,0,140,0,6
3,2571,2372,199,0,345,0,6
3,2457,2253,204,0,150,0,6
3,2539,2515,24,0,100,0,6
3,2502,2374,128,0,123,0,6
3,2406,2422,-16,0,227,0,8
3,2486,2448,38,0,29,0,6
3,2322,2490,-168,0,40,0,6
3,2442,2340,102,0,250,0,6
3,2595,2446,149,0,214,0,6
3,2347,2442,-95,0,35,0,6
3,2600,2665,-65,0,337,0,6
3,2653,2664,-11,0,113,0,6
3,2515,2449,66,0,205,0,6
3,2501,2368,133,0,61,0,6
3,2436,2500,-64,0,40,0,6
3,2380,2536,-156,0,331,0,6
3,2311,2491,-180,0,120,0,6
3,2484,2504,-20,0,120,0,6
3,2478,2345,133,0,267,0,6
3,2800,2691,109,0,4,0,6
3,2373,2524,-151,0,337,0,6
3,2470,2256,214,0,121,0,6
3,2483,2376,107,0,315,0,6
3,2412,2355,57,0,40,0,6
3,2413,2280,133,0,8,0,6
3,2338,2417,-79,0,100,0,6
3,2537,2532,5,0,111,0,6
3,2387,2534,-147,0,34,0,6
3,2488,2454,34,0,113,0,6
3,2425,2440,-15,0,242,0,6
3,2233,2499,-266,0,112,0,6
3,2418,2245,173,0,153,0,6
3,2522,2567,-45,0,300,0,6
3,2403,2263,140,0,40,0,6
3,2484,2437,47,0,150,0,6
3,2413,2534,-121,0,10,0,6
3,2338,2543,-205,0,292,0,6
3,2525,2355,170,0,104,0,6
3,2412,2412,0,0,7,0,6
3,2617,2632,-15,0,311,0,6
3,2469,2511,-42,0,120,0,6
3,2409,2569,-160,0,101,0,6
3,2481,2674,-193,0,245,0,6
3,2567,2369,198,0,330,0,6
3,2266,2417,-151,0,132,0,6
3,2381,2483,-102,0,80,0,6
3,2589,2607,-18,0,102,0,6
3,2525,2434,91,0,152,0,6
3,2445,2522,-77,0,7,0,6
3,2454,2305,149,0,28,0,6
3,2400,2477,-77,0,487,0,6
3,2539,2560,-21,0,245,0,6
3,2255,2434,-179,0,209,0,6
3,2370,2498,-128,0,394,0,6
3,2414,2428,-14,0,485,0,6
3,2397,2480,-83,0,311,0,6
3,2471,2327,144,4,36,0,11
3,2407,2424,-17,0,0,0,6
3,2599,2693,-94,0,335,0,6
3,2446,2427,19,0,43,0,6
3,2319,2463,-144,0,41,0,6
3,2246,2420,-174,0,117,0,6
3,2478,2400,78,0,4,0,6
3,2396,2407,-11,0,41,0,6
3,2441,2251,190,0,105,0,8
3,2472,2430,42,0,201,0,6
3,2462,2375,87,0,45,0,6
3,2597,2696,-99,0,203,0,6
3,2314,2454,-140,0,40,0,6
3,2455,2548,-93,0,247,0,6
3,2477,2397,80,0,207,0,6
3,2449,2295,154,0,109,0,6
3,2458,2427,31,0,107,0,6
3,2209,2455,-246,0,242,0,8
3,2546,2571,-25,0,101,0,6
3,2460,2443,17,0,313,0,6
3,2217,2529,-312,0,131,0,6
3,2548,2662,-114,0,115,0,6
3,2375,2434,-59,0,196,0,6
3,2570,2574,-4,0,45,0,6
3,2556,2623,-67,0,152,0,6
3,2603,2500,103,0,490,0,6
3,2279,2411,-132,0,334,0,6
3,2525,2519,6,0,134,0,6
3,2420,2404,16,0,201,0,6
3,2360,2444,-84,0,40,0,6
3,2397,2404,-7,0,49,0,6
3,2476,2457,19,0,144,0,6
3,2391,2612,-221,0,41,0,6
3,2456,2208,248,0,108,0,8
3,2356,2410,-54,0,7,0,6
3,2276,2411,-135,0,301,0,8
3,2534,2520,14,0,300,0,6
3,2436,2308,128,0,44,0,8
3,2498,2215,283,0,310,0,6
3,2211,2453,-242,0,215,0,8
3,2382,2427,-45,0,46,0,6
3,2304,2448,-144,0,45,0,6
3,2547,2534,13,0,108,0,6
3,2351,2494,-143,0,306,0,6
3,2416,2421,-5,0,153,0,6
3,2553,2744,-191,0,120,0,6
3,2385,2428,-43,0,7,0,6
3,2414,2338,76,0,201,0,6
3,2447,2428,19,0,385,0,6
3,2449,2481,-32,0,140,0,6
3,2557,2419,138,0,330,0,6
3,2302,2561,-259,0,193,0,6
3,2435,2318,117,0,112,0,6
3,2396,2404,-8,0,21,0,6
3,2438,2491,-53,0,48,0,6
3,2285,2458,-173,0,41,0,8
3,2380,2450,-70,0,202,0,6
3,2385,2453,-68,0,250,0,6
3,2509,2490,19,0,394,0,6
3,2312,2480,-168,0,241,0,6
3,2355,2414,-59,0,0,0,8
3,2436,2392,44,0,245,0,6
3,2456,2287,169,0,101,0,8
3,2535,2561,-26,0,132,0,6
3,2528,2396,132,0,140,0,6
3,2354,2446,-92,0,100,0,6
3,2443,2462,-19,0,130,0,6
3,2571,2559,12,0,7,0,6
3,2496,2628,-132,0,150,0,6
3,2393,2436,-43,0,122,0,6
3,2455,2420,35,4,250,0,13
3,2372,2516,-144,0,327,0,6
3,2419,2459,-40,0,4,0,6
3,2542,2551,-9,0,193,0,6
3,2618,2338,280,0,274,0,6
3,2468,2417,51,4,46,0,0
3,2392,2410,-18,0,45,0,8
3,2516,2363,153,0,415,0,6
3,2383,2422,-39,0,405,0,6
3,2465,2428,37,0,1,0,6
3,2369,2417,-48,0,389,0,6
3,2337,2478,-141,0,45,0,6
3,2416,2330,86,0,7,0,6
3,2363,2476,-113,0,347,0,6
3,2201,2425,-224,0,45,0,6
3,2417,2295,122,0,22,0,6
3,2574,2446,128,0,462,0,6
3,2516,2571,-55,0,4,0,6
3,2421,2213,208,0,1,0,6
3,2267,2421,-154,0,302,0,6
3,2517,2476,41,0,4,0,6
3,2502,2444,58,0,107,0,6
3,2419,2414,5,0,57,0,6
3,2269,2445,-176,0,302,0,6
3,2400,2485,-85,0,16,0,6
3,2325,2459,-134,0,8,0,6
3,2303,2401,-98,0,250,0,6
3,2448,2283,165,0,152,0,6
3,2390,2449,-59,0,11,0,6
3,2387,2484,-97,0,341,0,6
3,2330,2446,-116,0,140,0,6
3,2501,2406,95,0,101,0,6
3,2380,2488,-108,0,57,0,6
3,2431,2490,-59,0,268,0,6
3,2453,2441,12,0,0,0,6
3,2476,2620,-144,0,41,0,6
3,2439,2491,-52,0,250,0,6
3,2400,2467,-67,0,485,0,6
3,2424,2412,12,0,4,0,6
3,2273,2410,-137,0,48,0,6
3,2408,2543,-135,0,115,0,6
3,2478,2428,50,0,386,0,6
3,2383,2433,-50,0,241,0,6
3,2407,2545,-138,0,4,0,6
3,2691,2548,143,0,125,0,6
3,2445,2520,-75,0,45,0,6
3,2343,2409,-66,0,16,0,6
3,2460,2513,-53,0,110,0,6
3,2490,2446,44,0,310,0,6
3,2471,2271,200,0,3,0,6
3,2536,2549,-13,0,310,0,6
3,2408,2428,-20,0,152,0,6
3,2421,2257,164,0,136,0,5
3,2464,2301,163,0,4,0,6
3,2481,2541,-60,0,123,0,6
3,2439,2316,123,0,302,0,6
3,2584,2551,33,0,267,0,6
3,2416,2289,127,4,302,0,13
3,2560,2623,-63,0,46,0,6
3,2436,2325,111,0,3,0,6
3,2422,2336,86,0,123,0,8
3,2406,2327,79,0,225,0,8
3,2298,2437,-139,0,8,0,6
3,2430,2332,98,0,105,0,6
3,2378,2416,-38,0,245,0,6
3,2340,2400,-60,0,112,0,6
3,2482,2417,65,0,106,0,6
3,2441,2441,0,0,142,0,6
3,2424,2337,87,0,141,0,8
3,2497,2402,95,0,145,0,6
3,2414,2386,28,4,218,0,13
3,2488,2279,209,0,202,0,6
3,2413,2514,-101,0,412,0,6
3,2380,2686,-306,0,242,0,8
3,2485,2557,-72,0,385,0,6
3,2258,2474,-216,0,120,0,6
3,2524,2471,53,0,154,0,6
3,2546,2576,-30,0,46,0,6
3,2404,2407,-3,0,45,0,6
3,2239,2490,-251,0,215,0,6
3,2473,2508,-35,0,277,0,6
3,2490,2420,70,0,141,0,6
3,2411,2570,-159,0,4,0,6
3,2420,2355,65,0,48,0,6
3,2296,2402,-106,0,262,0,6
3,2418,2605,-187,0,46,0,6
3,2488,2429,59,0,107,0,6
3,2362,2421,-59,0,310,0,6
3,2398,2403,-5,0,46,0,6
3,2287,2404,-117,0,485,0,6
3,2474,2467,7,0,46,0,6
3,2404,2593,-189,0,45,0,6
3,2522,2347,175,0,40,0,6
3,2488,2487,1,0,260,0,6
3,2422,2496,-74,0,101,0,6
3,2436,2403,33,0,140,0,6
3,2507,2351,156,0,41,0,6
3,2409,2415,-6,0,302,0,6
3,2315,2412,-97,0,100,0,6
3,2492,2426,66,0,107,0,6
3,2269,2526,-257,0,110,0,6
3,2509,2411,98,0,480,0,6
3,2405,2340,65,0,241,0,6
3,2407,2400,7,0,49,0,6
3,2318,2431,-113,0,373,0,6
3,2412,2501,-89,0,5,0,6
3,2404,2222,182,0,40,0,6
3,2524,2477,47,0,45,0,6
3,2502,2439,63,0,48,0,6
3,2613,2567,46,0,140,0,6
3,2428,2552,-124,0,192,0,6
3,2454,2547,-93,0,102,0,6
3,2444,2526,-82,0,13,0,6
3,2344,2497,-153,0,8,0,6
3,2309,2404,-95,0,48,0,6
3,2525,2272,253,0,40,0,6
3,2402,2320,82,0,4,0,6
3,2405,2363,42,0,40,0,6
3,2497,2494,3,0,200,0,6
3,2485,2403,82,0,190,0,6
3,2430,2305,125,0,277,0,6
3,2437,2449,-12,0,53,0,6
3,2354,2414,-60,0,140,0,6
3,2413,2473,-60,0,45,0,6
3,2547,2434,113,0,242,0,6
3,2386,2455,-69,0,106,0,6
3,2402,2357,45,0,65,0,6
3,2746,2427,319,0,461,0,6
3,2412,2497,-85,0,302,0,6
3,2362,2467,-105,0,12,0,6
3,2365,2401,-36,0,140,0,6
3,2423,2382,41,0,45,0,6
3,2345,2459,-114,0,130,0,6
3,2487,2296,191,0,190,0,8
3,2247,2402,-155,0,123,0,6
3,2392,2425,-33,0,43,0,6
3,2614,2272,342,4,220,0,13
3,2436,2362,74,0,106,0,6
3,2242,2487,-245,0,269,0,8
3,2381,2466,-85,0,100,0,6
3,2439,2432,7,0,40,0,6
3,2354,2507,-153,0,113,0,6
3,2269,2412,-143,0,0,0,6
3,2298,2436,-138,0,0,0,6
3,2456,2441,15,0,112,0,6
3,2564,2618,-54,0,110,0,6
3,2402,2435,-33,0,112,0,6
3,2565,2513,52,0,101,0,6
3,2410,2284,126,0,112,0,6
3,2473,2355,118,0,122,0,6
3,2481,2325,156,0,110,0,6
3,2612,2785,-173,0,353,0,6
3,2434,2393,41,0,46,0,6
3,2451,2452,-1,0,147,0,6
3,2564,2602,-38,0,228,0,6
3,2453,2309,144,0,302,0,6
3,2456,2458,-2,0,101,0,6
3,2326,2412,-86,0,107,0,6
3,2453,2416,37,0,152,0,6
3,2630,2697,-67,0,265,0,6
3,2290,2419,-129,0,4,0,5
3,2602,2585,17,0,156,0,6
3,2355,2437,-82,0,201,0,6
3,2356,2432,-76,0,300,0,6
3,2325,2606,-281,0,10,0,6
3,2422,2422,0,0,46,0,6
3,2568,2386,182,0,8,0,6
3,2664,2602,62,0,327,0,6
3,2663,2567,96,0,338,0,6
3,2458,2383,75,0,134,0,6
3,2506,2543,-37,0,101,0,6
3,2560,2352,208,0,302,0,6
3,2367,2421,-54,0,100,0,6
3,2492,2469,23,0,260,0,6
3,2677,2572,105,0,248,0,6
3,2430,2441,-11,0,131,0,6
3,2446,2419,27,0,145,0,6
3,2400,2602,-202,0,302,0,6
3,2363,2402,-39,0,106,0,6
3,2321,2474,-153,0,200,0,6
3,2446,2300,146,0,152,0,6
3,2423,2377,46,0,203,0,6
3,2470,2388,82,0,395,0,6
3,2351,2410,-59,0,278,0,6
3,2466,2403,63,0,4,0,6
3,2420,2623,-203,0,45,0,6
3,2484,2610,-126,0,133,0,6
3,2227,2417,-190,0,1,0,6
3,2437,2444,-7,0,304,0,6
3,2506,2560,-54,0,269,0,6
3,2538,2506,32,0,140,0,6
3,2347,2431,-84,0,200,0,6
3,2433,2366,67,0,250,0,6
3,2403,2436,-33,0,40,0,6
3,2453,2549,-96,0,212,0,6
3,2458,2432,26,0,380,0,6
3,2443,2375,68,0,133,0,6
3,2343,2472,-129,0,21,0,6
3,2437,2394,43,0,151,0,6
3,2391,2463,-72,0,6,0,6
3,2741,2609,132,0,201,0,6
3,2643,2605,38,0,154,0,6
3,2474,2378,96,0,106,0,6
3,2460,2526,-66,0,45,0,6
3,2431,2387,44,0,463,0,6
3,2452,2643,-191,0,11,0,6
3,2707,2678,29,0,176,0,6
3,2574,2585,-11,0,13,0,6
3,2327,2404,-77,0,312,0,6
3,2459,2502,-43,0,459,0,6
3,2373,2417,-44,0,107,0,6
3,2488,2423,65,0,7,0,6
3,2591,2787,-196,0,112,0,6
3,2621,2607,14,0,121,0,6
3,2585,2643,-58,0,106,0,6
3,2553,2436,117,0,106,0,6
3,2364,2534,-170,0,265,0,8
3,2397,2532,-135,0,45,0,6
3,2426,2509,-83,0,315,0,6
3,2346,2504,-158,0,110,0,6
3,2599,2419,180,0,0,0,6
3,2333,2641,-308,0,320,0,8
3,2432,2358,74,0,420,0,6
3,2436,2554,-118,0,106,0,6
3,2400,2303,97,0,120,0,6
3,2529,2479,50,0,315,0,6
3,2670,2726,-56,0,0,0,6
3,2550,2583,-33,0,247,0,6
3,2392,2521,-129,0,321,0,6
3,2447,2398,49,0,301,0,6
3,2438,2606,-168,0,211,0,6
3,2307,2408,-101,0,225,0,6
3,2725,2671,54,0,4,0,6
3,2506,2385,121,0,426,0,6
3,2439,2402,37,0,414,0,6
3,2311,2475,-164,0,119,0,6
3,2356,2534,-178,0,332,0,6
3,2310,2494,-184,0,112,0,6
3,2343,2639,-296,0,466,0,8
3,2412,2459,-47,0,487,0,6
3,2397,2421,-24,0,11,0,6
3,2487,2594,-107,0,122,0,6
3,2418,2289,129,0,45,0,6
3,2381,2408,-27,0,110,0,6
3,2502,2435,67,0,6,0,6
3,2401,2558,-157,0,380,0,6
3,2426,2384,42,0,43,0,6
3,2436,2534,-98,0,8,0,6
3,2287,2490,-203,0,409,0,8
3,2300,2458,-158,0,487,0,6
3,2533,2438,95,0,4,0,6
3,2378,2480,-102,0,140,0,6
3,2447,2314,133,0,127,0,6
3,2341,2476,-135,4,347,0,0
3,2456,2376,80,0,107,0,6
3,2464,2284,180,0,153,0,8
3,2362,2481,-119,0,61,0,6
3,2330,2515,-185,0,145,0,6
3,2640,2344,296,0,20,0,8
3,2358,2488,-130,0,5,0,8
3,2464,2529,-65,0,50,0,6
3,2431,2465,-34,0,202,0,6
3,2330,2458,-128,0,245,0,6
3,2410,2351,59,0,44,0,6
3,2560,2473,87,0,103,0,6
3,2453,2397,56,0,245,0,6
3,2487,2530,-43,0,40,0,6
3,2363,2400,-37,0,386,0,6
3,2486,2360,126,0,267,0,8
3,2494,2405,89,0,310,0,6
3,2421,2429,-8,0,133,0,6
3,2481,2404,77,0,131,0,6
3,2447,2442,5,0,228,0,6
3,2428,2296,132,0,113,0,6
3,2304,2483,-179,0,45,0,6
3,2302,2424,-122,4,64,0,13
3,2638,2352,286,0,45,0,8
3,2519,2472,47,0,310,0,6
3,2607,2455,152,0,43,0,8
3,2320,2456,-136,0,245,0,6
3,2389,2433,-44,0,45,0,6
3,2481,2473,8,0,45,0,6
3,2383,2460,-77,0,457,0,6
3,2358,2471,-113,0,105,0,6
3,2421,2271,150,0,395,0,6
3,2415,2343,72,0,145,0,6
3,2599,2640,-41,0,45,0,6
3,2432,2414,18,0,453,0,6
3,2579,2558,21,0,140,0,6
3,2415,2341,74,0,300,0,6
3,2411,2334,77,0,300,0,6
3,2352,2451,-99,0,41,0,6
3,2535,2459,76,0,315,0,6
3,2465,2332,133,0,45,0,6
3,2315,2401,-86,0,7,0,6
3,2385,2540,-155,0,4,0,6
3,2564,2567,-3,0,106,0,6
3,2403,2357,46,4,302,0,10
3,2458,2512,-54,0,45,0,6
3,2410,2440,-30,0,151,0,6
3,2259,2405,-146,0,113,0,6
3,2471,2488,-17,0,4,0,6
3,2451,2293,158,0,46,0,6
3,2287,2421,-134,0,382,0,8
3,2614,2531,83,0,326,0,6
3,2419,2308,111,0,241,0,8
3,2296,2403,-107,0,193,0,6
3,2415,2244,171,4,135,0,13
3,2515,2418,97,0,45,0,6
3,2532,2380,152,0,4,0,6
3,2343,2476,-133,0,141,0,6
3,2403,2478,-75,0,54,0,6
3,2621,2615,6,0,278,0,6
3,2329,2437,-108,0,313,0,6
3,2275,2409,-134,4,106,0,10
3,2512,2527,-15,0,200,0,6
3,2425,2316,109,0,30,0,6
3,2416,2363,53,0,2,0,6
3,2649,2463,186,0,292,0,6
3,2419,2486,-67,0,265,0,6
3,2468,2525,-57,0,202,0,6
3,2435,2322,113,0,302,0,6
3,2404,2543,-139,0,131,0,6
3,2307,2406,-99,0,46,0,6
3,2400,2361,39,0,312,0,6
3,2554,2551,3,0,253,0,6
3,2489,2492,-3,0,253,0,6
3,2522,2620,-98,0,7,0,6
3,2397,2422,-25,0,272,0,6
3,2472,2371,101,0,45,0,6
3,2416,2415,1,4,132,0,13
3,2415,2345,70,0,16,0,6
3,2499,2529,-30,0,110,0,6
3,2585,2470,115,0,5,0,6
3,2420,2358,62,0,106,0,6
3,2436,2599,-163,0,41,0,6
3,2500,2502,-2,0,5,0,6
3,2421,2365,56,0,474,0,6
3,2336,2416,-80,0,190,0,6
3,2229,2488,-259,4,404,0,13
3,2405,2388,17,0,127,0,6
3,2534,2464,70,0,54,0,6
3,2713,2741,-28,0,111,0,6
3,2488,2414,74,0,3,0,6
3,2447,2342,105,0,80,0,6
3,2464,2377,87,0,110,0,6
3,2421,2524,-103,0,78,0,6
3,2415,2487,-72,0,4,0,6
3,2553,2538,15,0,0,0,6
3,2448,2322,126,0,15,0,6
3,2345,2400,-55,0,110,0,6
3,2399,2465,-66,0,15,0,6
3,2513,2501,12,0,404,0,6
3,2580,2577,3,0,120,0,6
3,2443,2404,39,0,315,0,6
3,2418,2527,-109,0,405,0,6
3,2375,2425,-50,0,326,0,6
3,2528,2565,-37,0,106,0,6
3,2563,2616,-53,0,132,0,6
3,2278,2422,-144,0,101,0,6
3,2421,2488,-67,0,41,0,6
3,2464,2494,-30,0,315,0,6
3,2353,2444,-91,0,300,0,6
3,2410,2414,-4,0,130,0,6
3,2527,2527,0,0,50,0,6
3,2413,2424,-11,0,150,0,6
3,2487,2420,67,0,295,0,6
3,2345,2414,-69,0,112,0,6
3,2310,2407,-97,0,110,0,6
3,2260,2434,-174,0,46,0,6
3,2458,2342,116,0,130,0,6
3,2343,2485,-142,0,190,0,6
3,2387,2452,-65,0,190,0,6
3,2462,2376,86,0,115,0,6
3,2517,2377,140,0,300,0,6
3,2436,2423,13,0,331,0,6
3,2434,2520,-86,0,385,0,6
3,2436,2343,93,0,330,0,6
3,2497,2424,73,0,302,0,6
3,2470,2476,-6,0,30,0,6
3,2401,2291,110,0,331,0,8
3,2550,2611,-61,0,460,0,6
3,2436,2378,58,0,31,0,6
3,2373,2435,-62,0,300,0,6
3,2421,2392,29,0,400,0,6
3,2422,2395,27,0,414,0,6
3,2392,2447,-55,0,435,0,6
3,2389,2447,-58,0,156,0,6
3,2407,2423,-16,0,144,0,6
3,2422,2320,102,0,401,0,6
3,2415,2340,75,0,373,0,6
3,2685,2467,218,0,470,0,6
3,2482,2317,165,0,211,0,6
3,2411,2443,-32,0,4,0,6
3,2550,2479,71,0,3,0,6
3,2452,2582,-130,0,55,0,6
3,2559,2352,207,0,18,0,6
3,2556,2432,124,0,41,0,6
3,2580,2400,180,0,218,0,6
3,2352,2408,-56,0,302,0,6
3,2483,2341,142,0,110,0,6
3,2598,2676,-78,0,335,0,6
3,2549,2448,101,0,123,0,6
3,2417,2328,89,0,15,0,6
3,2481,2300,181,4,265,0,13
3,2520,2483,37,0,45,0,6
3,2429,2410,19,0,315,0,6
3,2343,2416,-73,0,107,0,6
3,2350,2428,-78,0,302,0,6
3,2550,2517,33,0,41,0,6
3,2412,2390,22,0,4,0,6
3,2512,2451,61,0,45,0,6
3,2367,2513,-146,0,246,0,6
3,2328,2462,-134,0,10,0,6
3,2359,2487,-128,0,454,0,8
3,2403,2375,28,0,241,0,6
3,2398,2471,-73,0,40,0,6
3,2427,2367,60,0,127,0,6
3,2440,2413,27,0,140,0,8
3,2532,2528,4,0,121,0,8
3,2619,2607,12,0,335,0,8
3,2574,2558,16,0,37,0,8
3,2540,2535,5,0,241,0,8
3,2438,2433,5,0,107,0,8
3,2535,2618,-83,0,455,0,8
3,2433,2532,-99,0,45,0,8
3,2367,2442,-75,0,250,0,6
3,2388,2426,-38,0,122,0,6
3,2448,2341,107,0,4,0,6
3,2473,2561,-88,0,8,0,6
3,2438,2603,-165,0,305,0,6
3,2222,2536,-314,0,46,0,8
3,2359,2543,-184,0,102,0,6
3,2408,2491,-83,0,130,0,6
3,2538,2475,63,0,200,0,6
3,2581,2576,5,0,115,0,6
3,2427,2501,-74,0,80,0,6
3,2336,2493,-157,0,143,0,6
3,2398,2459,-61,0,132,0,6
3,2412,2259,153,0,55,0,6
3,2504,2555,-51,0,302,0,6
3,2385,2428,-43,0,122,0,6
3,2592,2599,-7,0,245,0,6
3,2423,2259,164,0,15,0,6
3,2490,2439,51,0,201,0,6
3,2387,2508,-121,0,118,0,6
3,2761,2697,64,0,411,0,6
3,2492,2409,83,0,463,0,6
3,2574,2372,202,0,13,0,8
3,2376,2400,-24,0,16,0,6
3,2354,2400,-46,0,111,0,6
3,2455,2565,-110,0,207,0,8
3,2385,2499,-114,0,202,0,6
3,2553,2485,68,0,124,0,8
3,2511,2476,35,0,302,0,6
3,2435,2435,0,0,340,0,6
3,2419,2297,122,4,335,0,13
3,2489,2441,48,0,81,0,6
3,2600,2492,108,0,124,0,8
3,2486,2552,-66,0,115,0,8
3,2226,2470,-244,0,415,0,6
3,2534,2531,3,0,40,0,8
3,2456,2425,31,0,202,0,6
3,2289,2524,-235,0,101,0,8
3,2528,2596,-68,0,404,0,6
3,2640,2580,60,0,101,0,6
3,2434,2372,62,0,409,0,6
3,2406,2408,-2,0,4,0,6
3,2588,2599,-11,0,110,0,8
3,2358,2426,-68,0,150,0,8
3,2530,2353,177,0,159,0,6
3,2408,2547,-139,0,255,0,8
3,2535,2498,37,0,373,0,8
3,2422,2322,100,0,461,0,6
3,2291,2402,-111,0,483,0,6
3,2499,2602,-103,0,244,0,8
3,2487,2530,-43,0,256,0,6
3,2600,2560,40,0,123,0,8
3,2352,2420,-68,0,132,0,6
3,2523,2551,-28,0,414,0,6
3,2457,2446,11,0,177,0,6
3,2540,2475,65,0,320,0,6
3,2600,2553,47,0,455,0,6
3,2327,2455,-128,0,241,0,8
3,2300,2561,-261,0,40,0,6
3,2421,2457,-36,0,4,0,6
3,2282,2433,-151,0,122,0,6
3,2431,2502,-71,0,13,0,6
3,2372,2490,-118,0,43,0,8
3,2594,2425,169,0,1,0,8
3,2466,2640,-174,0,312,0,6
3,2422,2449,-27,0,302,0,6
3,2321,2417,-96,0,10,0,8
3,2554,2576,-22,0,241,0,6
3,2341,2524,-183,0,118,0,8
3,2498,2550,-52,0,154,0,6
3,2457,2386,71,0,8,0,8
3,2336,2510,-174,0,117,0,6
3,2337,2416,-79,0,334,0,6
3,2573,2525,48,0,106,0,8
3,2714,2980,-266,0,143,0,6
3,2460,2419,41,0,31,0,6
3,2299,2414,-115,0,218,0,8
3,2515,2348,167,0,44,0,8
3,2377,2507,-130,0,344,0,8
3,2406,2318,88,4,201,0,13
3,2451,2365,86,0,113,0,6
3,2441,2440,1,0,62,0,6
3,2458,2549,-91,0,415,0,6
3,2521,2424,97,0,207,0,6
3,2487,2341,146,0,44,0,8
3,2564,2581,-17,0,331,0,6
3,2439,2340,99,0,190,0,8
3,2577,2615,-38,0,34,0,6
3,2421,2439,-18,0,80,0,6
3,2486,2296,190,0,197,0,8
3,2332,2448,-116,0,256,0,6
3,2400,2392,8,0,310,0,6
3,2580,2564,16,0,115,0,6
3,2532,2571,-39,0,131,0,8
3,2413,2531,-118,0,460,0,8
3,2317,2406,-89,0,487,0,6
3,2461,2421,40,0,123,0,6
3,2476,2387,89,0,400,0,8
3,2530,2494,36,0,245,0,6
3,2299,2483,-184,0,190,0,8
3,2311,2402,-91,0,45,0,6
3,2530,2541,-11,0,120,0,6
3,2401,2334,67,0,100,0,6
3,2416,2397,19,0,246,0,8
3,2375,2442,-67,0,45,0,8
3,2480,2503,-23,0,455,0,8
3,2507,2590,-83,0,260,0,8
3,2421,2388,33,0,0,0,6
3,2422,2341,81,0,130,0,6
3,2434,2416,18,0,277,0,6
3,2502,2576,-74,0,201,0,8
3,2568,2518,50,0,9,0,6
3,2584,2526,58,0,101,0,6
3,2402,2315,87,0,65,0,6
3,2504,2431,73,0,132,0,6
3,2428,2351,77,0,200,0,6
3,2519,2576,-57,0,241,0,6
3,2468,2466,2,0,45,0,6
3,2517,2379,138,0,140,0,6
3,2402,2352,50,0,345,0,6
3,2210,2404,-194,4,359,0,8
3,2443,2376,67,0,250,0,6
3,2698,2688,10,0,7,0,6
3,2519,2478,41,0,315,0,6
3,2326,2444,-118,0,40,0,6
3,2432,2523,-91,0,268,0,6
3,2419,2381,38,0,302,0,6
3,2339,2446,-107,0,466,0,6
3,2500,2422,78,0,48,0,6
3,2688,2698,-10,0,40,0,6
3,2489,2482,7,0,211,0,6
3,2416,2328,88,0,345,0,6
3,2345,2403,-58,0,100,0,6
3,2536,2559,-23,0,411,0,6
3,2462,2384,78,0,11,0,6
3,2493,2447,46,0,250,0,6
3,2339,2403,-64,0,10,0,6
3,2222,2467,-245,0,11,0,6
3,2486,2566,-80,0,50,0,6
3,2363,2402,-39,0,265,0,6
3,2402,2507,-105,0,108,0,6
3,2469,2599,-130,0,30,0,6
3,2406,2437,-31,0,45,0,6
3,2683,2703,-20,0,40,0,6
3,2436,2380,56,0,18,0,6
3,2454,2551,-97,0,69,0,6
3,2417,2351,66,0,8,0,6
3,2421,2353,68,0,0,0,6
3,2464,2233,231,0,107,0,6
3,2460,2346,114,0,141,0,6
3,2473,2312,161,0,10,0,6
3,2436,2383,53,0,15,0,6
3,2505,2404,101,0,222,0,6
3,2508,2655,-147,0,112,0,6
3,2478,2435,43,0,41,0,6
3,2457,2296,161,0,158,0,6
3,2406,2294,112,0,453,0,6
3,2379,2443,-64,0,102,0,6
3,2370,2436,-66,0,17,0,6
3,2563,2352,211,0,211,0,6
3,2571,2534,37,0,115,0,6
3,2400,2322,78,0,4,0,6
3,2349,2474,-125,0,201,0,6
3,2522,2344,178,0,300,0,6
3,2444,2336,108,0,135,0,8
3,2407,2284,123,0,122,0,6
3,2486,2351,135,0,436,0,6
3,2646,2614,32,0,45,0,6
3,2511,2393,118,0,152,0,6
3,2586,2536,50,0,7,0,6
3,2409,2571,-162,0,45,0,6
3,2450,2562,-112,0,113,0,6
3,2221,2421,-200,0,122,0,8
3,2448,2420,28,0,46,0,6
3,2331,2512,-181,0,81,0,6
3,2601,2598,3,0,43,0,6
3,2461,2569,-108,0,4,0,6
3,2502,2296,206,0,281,0,6
3,2391,2443,-52,0,375,0,8
3,2417,2442,-25,0,81,0,6
3,2311,2401,-90,0,40,0,6
3,2563,2575,-12,0,110,0,6
3,2571,2430,141,0,4,0,6
3,2446,2434,12,0,45,0,6
3,2574,2577,-3,0,151,0,6
3,2380,2413,-33,0,176,0,6
3,2495,2235,260,0,200,0,6
3,2416,2426,-10,0,0,0,6
3,2510,2499,11,0,107,0,6
3,2500,2511,-11,0,101,0,6
3,2336,2473,-137,0,202,0,6
3,2532,2493,39,0,302,0,6
3,2477,2536,-59,0,0,0,6
3,2446,2484,-38,0,50,0,6
3,2500,2405,95,0,151,0,6
3,2412,2442,-30,0,40,0,6
3,2515,2487,28,0,101,0,6
3,2500,2406,94,0,151,0,6
3,2376,2498,-122,0,490,0,6
3,2456,2365,91,0,41,0,6
3,2598,2623,-25,0,3,0,6
3,2440,2441,-1,0,34,0,6
3,2565,2670,-105,0,255,0,6
3,2414,2506,-92,0,77,0,6
3,2557,2500,57,0,125,0,6
3,2280,2437,-157,0,123,0,8
3,2424,2438,-14,0,300,0,6
3,2552,2528,24,0,102,0,6
3,2422,2417,5,0,115,0,6
3,2443,2363,80,0,184,0,6
3,2394,2403,-9,0,374,0,6
3,2344,2526,-182,0,101,0,6
3,2226,2433,-207,0,250,0,6
3,2441,2379,62,0,300,0,6
3,2500,2509,-9,0,81,0,6
3,2441,2364,77,0,40,0,6
3,2432,2394,38,0,4,0,6
3,2392,2430,-38,0,112,0,6
3,2594,2557,37,0,247,0,6
3,2361,2433,-72,0,404,0,6
3,2367,2411,-44,0,22,0,8
3,2412,2452,-40,0,104,0,8
3,2447,2472,-25,0,226,0,6
3,2557,2529,28,0,211,0,6
3,2442,2394,48,0,5,0,6
3,2514,2248,266,4,130,0,8
3,2510,2449,61,0,4,0,6
3,2442,2334,108,0,138,0,6
3,2446,2556,-110,0,123,0,6
3,2238,2428,-190,0,46,0,8
3,2454,2205,249,0,43,0,8
3,2406,2453,-47,0,334,0,6
3,2357,2432,-75,0,202,0,6
3,2254,2407,-153,0,228,0,6
3,2471,2447,24,0,45,0,6
3,2530,2562,-32,0,338,0,6
3,2320,2443,-123,0,10,0,6
3,2410,2282,128,0,140,0,6
3,2409,2254,155,0,311,0,8
3,2494,2405,89,0,48,0,6
3,2593,2601,-8,0,45,0,6
3,2383,2448,-65,0,300,0,6
3,2447,2324,123,0,5,0,6
3,2378,2427,-49,0,15,0,6
3,2553,2450,103,0,217,0,6
3,2438,2288,150,0,2,0,6
3,2566,2669,-103,0,120,0,6
3,2606,2633,-27,0,34,0,6
3,2454,2461,-7,0,311,0,6
3,2416,2285,131,0,302,0,6
3,2280,2439,-159,0,45,0,8
3,2448,2398,50,0,192,0,6
3,2469,2437,32,0,45,0,6
3,2400,2386,14,0,4,0,6
3,2439,2568,-129,0,161,0,6
3,2417,2507,-90,0,113,0,8
3,2472,2215,257,4,310,0,13
3,2482,2535,-53,0,281,0,6
3,2432,2381,51,0,39,0,6
3,2311,2509,-198,0,426,0,6
3,2408,2334,74,0,343,0,6
3,2257,2437,-180,0,47,0,6
3,2558,2344,214,0,42,0,6
3,2505,2314,191,0,315,0,8
3,2340,2457,-117,0,404,0,6
3,2448,2594,-146,0,328,0,6
3,2606,2314,292,0,100,0,6
3,2534,2612,-78,0,130,0,6
3,2648,2610,38,0,131,0,6
3,2439,2317,122,0,104,0,8
3,2203,2539,-336,0,200,0,8
3,2441,2510,-69,0,107,0,6
3,2303,2620,-317,0,323,0,0
3,2426,2465,-39,0,110,0,6
3,2381,2424,-43,0,27,0,6
3,2426,2477,-51,0,131,0,6
3,2426,2381,45,0,10,0,6
3,2410,2523,-113,0,406,0,8
3,2408,2476,-68,0,314,0,6
3,2441,2550,-109,0,152,0,6
3,2449,2456,-7,0,247,0,6
3,2352,2418,-66,0,147,0,6
3,2563,2496,67,0,54,0,6
3,2448,2384,64,0,15,0,6
3,2473,2444,29,0,483,0,6
3,2410,2242,168,0,43,0,8
3,2364,2482,-118,0,229,0,6
3,2425,2446,-21,0,345,0,6
3,2436,2240,196,0,43,0,6
3,2321,2415,-94,0,28,0,6
3,2358,2434,-76,0,453,0,6
3,2417,2353,64,0,253,0,6
3,2310,2414,-104,0,301,0,8
3,2359,2425,-66,0,302,0,6
3,2472,2497,-25,0,113,0,6
3,2253,2414,-161,0,8,0,6
3,2648,2460,188,0,312,0,6
3,2361,2413,-52,0,1,0,6
3,2422,2289,133,0,302,0,6
3,2435,2215,220,0,57,0,6
3,2410,2431,-21,0,43,0,8
3,2413,2376,37,0,135,0,8
3,2429,2386,43,0,30,0,6
3,2293,2449,-156,0,29,0,6
3,2442,2413,29,0,107,0,8
3,2544,2372,172,0,150,0,6
3,2443,2483,-40,0,142,0,6
3,2336,2423,-87,0,302,0,6
3,2413,2382,31,0,338,0,6
3,2431,2506,-75,0,46,0,6
3,2450,2446,4,0,406,0,6
3,2412,2281,131,0,117,0,8
3,2368,2402,-34,0,254,0,6
3,2504,2460,44,0,345,0,6
3,2556,2509,47,0,406,0,6
3,2298,2403,-105,4,41,0,13
3,2242,2416,-174,0,202,0,8
3,2497,2372,125,0,95,0,6
3,2522,2563,-41,0,315,0,6
3,2423,2424,-1,0,4,0,6
3,2412,2347,65,0,122,0,6
3,2343,2404,-61,0,410,0,8
3,2423,2586,-163,0,49,0,6
3,2478,2423,55,0,432,0,6
3,2519,2325,194,0,48,0,6
3,2428,2415,13,0,113,0,6
3,2510,2515,-5,0,432,0,6
3,2499,2370,129,0,330,0,6
3,2256,2451,-195,0,302,0,6
3,2454,2477,-23,0,302,0,6
3,2328,2421,-93,0,224,0,6
3,2357,2424,-67,0,300,0,6
3,2529,2555,-26,0,409,0,6
3,2544,2463,81,0,226,0,6
3,2457,2424,33,0,415,0,6
3,2454,2397,57,0,331,0,6
3,2327,2432,-105,0,205,0,6
3,2414,2238,176,0,302,0,8
3,2380,2430,-50,0,45,0,6
3,2511,2275,236,0,312,0,6
3,2521,2346,175,0,40,0,6
3,2427,2485,-58,0,147,0,6
3,2458,2264,194,0,1,0,6
3,2398,2413,-15,0,100,0,6
3,2415,2428,-13,0,202,0,6
3,2316,2471,-155,0,213,0,6
3,2443,2371,72,0,142,0,6
3,2452,2340,112,0,311,0,6
3,2699,2424,275,0,440,0,6
3,2547,2561,-14,0,150,0,6
3,2446,2461,-15,0,218,0,6
3,2264,2451,-187,0,331,0,6
3,2494,2449,45,0,58,0,6
3,2626,2681,-55,0,101,0,6
3,2540,2388,152,0,50,0,6
3,2388,2422,-34,0,310,0,6
3,2410,2433,-23,0,113,0,6
3,2333,2460,-127,0,343,0,6
3,2479,2528,-49,0,415,0,6
3,2618,2382,236,0,40,0,6
3,2509,2325,184,0,20,0,6
3,2423,2491,-68,0,109,0,6
3,2363,2440,-77,0,5,0,8
3,2560,2575,-15,0,228,0,6
3,2491,2460,31,0,242,0,6
3,2561,2479,82,0,300,0,6
3,2585,2457,128,0,18,0,6
3,2526,2494,32,0,477,0,6
3,2431,2312,119,0,127,0,6
3,2505,2498,7,0,46,0,6
3,2453,2366,87,0,245,0,6
3,2421,2283,138,0,46,0,8
3,2497,2443,54,0,333,0,6
3,2455,2553,-98,0,113,0,6
3,2427,2356,71,0,300,0,6
3,2504,2510,-6,0,46,0,6
3,2566,2554,12,0,227,0,6
3,2423,2304,119,0,140,0,6
3,2393,2535,-142,0,61,0,6
3,2372,2403,-31,0,121,0,6
3,2459,2674,-215,0,101,0,6
3,2541,2545,-4,0,115,0,6
3,2417,2425,-8,0,110,0,6
3,2427,2259,168,0,131,0,6
3,2519,2421,98,0,30,0,6
3,2444,2421,23,0,395,0,6
3,2360,2449,-89,0,3,0,6
3,2355,2452,-97,0,58,0,6
3,2245,2406,-161,0,4,0,6
3,2410,2445,-35,0,106,0,6
3,2560,2561,-1,0,111,0,6
3,2236,2401,-165,0,150,0,6
3,2554,2545,9,0,9,0,6
3,2425,2417,8,0,201,0,6
3,2447,2377,70,0,101,0,6
3,2363,2424,-61,0,245,0,6
3,2445,2299,146,4,112,0,13
3,2421,2485,-64,0,115,0,6
3,2498,2522,-24,0,40,0,6
3,2425,2419,6,0,205,0,6
3,2561,2560,1,0,300,0,6
3,2378,2424,-46,0,45,0,6
3,2627,2640,-13,0,110,0,6
3,2264,2608,-344,0,22,0,8
3,2463,2388,75,0,7,0,6
3,2452,2471,-19,0,45,0,6
3,2454,2348,106,0,404,0,6
3,2417,2425,-8,0,110,0,6
3,2409,2506,-97,0,50,0,6
3,2347,2414,-67,0,112,0,6
3,2334,2443,-109,0,302,0,6
3,2504,2376,128,0,112,0,6
3,2200,2433,-233,0,201,0,6
3,2409,2402,7,0,130,0,6
3,2464,2372,92,0,121,0,6
3,2398,2401,-3,0,121,0,6
3,2417,2393,24,0,110,0,6
3,2417,2499,-82,0,4,0,8
3,2353,2461,-108,0,131,0,6
3,2443,2274,169,4,120,0,13
3,2426,2541,-115,0,112,0,6
3,2402,2378,24,0,15,0,6
3,2293,2446,-153,0,46,0,6
3,2344,2527,-183,0,40,0,6
3,2411,2601,-190,0,103,0,6
3,2530,2491,39,0,403,0,6
3,2561,2583,-22,0,125,0,6
3,2381,2524,-143,0,394,0,6
3,2415,2398,17,0,131,0,6
3,2582,2561,21,0,268,0,6
3,2509,2510,-1,0,170,0,6
3,2350,2403,-53,0,84,0,6
3,2415,2381,34,0,46,0,6
3,2481,2498,-17,0,146,0,6
3,2371,2408,-37,0,10,0,6
3,2426,2380,46,0,485,0,6
3,2411,2451,-40,0,130,0,6
3,2465,2383,82,0,0,0,6
3,2402,2405,-3,0,15,0,6
3,2361,2501,-140,0,338,0,6
3,2391,2439,-48,0,134,0,6
3,2379,2456,-77,0,45,0,6
3,2450,2443,7,0,288,0,6
3,2384,2464,-80,0,106,0,6
3,2470,2612,-142,0,111,0,6
3,2358,2407,-49,0,319,0,8
3,2367,2494,-127,0,46,0,6
3,2343,2438,-95,0,354,0,6
3,2610,2472,138,0,265,0,6
3,2473,2458,15,0,2,0,6
3,2598,2546,52,0,268,0,6
3,2405,2396,9,0,331,0,6
3,2518,2410,108,0,107,0,6
3,2345,2461,-116,0,44,0,6
3,2331,2485,-154,0,42,0,6
3,2474,2424,50,0,4,0,6
3,2517,2395,122,0,112,0,6
3,2602,2542,60,0,260,0,6
3,2331,2428,-97,0,31,0,6
3,2465,2566,-101,0,4,0,6
3,2497,2377,120,0,456,0,6
3,2475,2413,62,0,152,0,8
3,2409,2499,-90,0,152,0,8
3,2424,2389,35,0,311,0,6
3,2486,2383,103,0,244,0,6
3,2418,2469,-51,0,341,0,6
3,2456,2483,-27,0,138,0,6
3,2371,2457,-86,0,7,0,6
3,2354,2437,-83,0,10,0,6
3,2428,2386,42,0,27,0,6
3,2419,2573,-154,0,14,0,6
3,2536,2537,-1,0,302,0,6
3,2384,2496,-112,0,207,0,6
3,2436,2248,188,0,43,0,6
3,2456,2428,28,0,110,0,6
3,2421,2498,-77,0,43,0,6
3,2575,2653,-78,0,310,0,6
3,2406,2327,79,0,145,0,6
3,2454,2306,148,0,57,0,6
3,2651,2597,54,0,141,0,6
3,2533,2503,30,0,112,0,6
3,2366,2485,-119,0,101,0,6
3,2303,2455,-152,0,253,0,6
3,2414,2259,155,0,40,0,6
3,2445,2450,-5,0,1,0,6
3,2598,2651,-53,0,1,0,6
3,2518,2568,-50,0,254,0,6
3,2358,2471,-113,0,3,0,6
3,2519,2393,126,0,301,0,6
3,2303,2403,-100,0,48,0,6
3,2494,2475,19,0,415,0,6
3,2470,2359,111,0,211,0,6
3,2368,2517,-149,0,216,0,6
3,2540,2505,35,0,400,0,6
3,2418,2389,29,0,241,0,6
3,2404,2567,-163,0,224,0,6
3,2476,2570,-94,0,236,0,6
3,2421,2602,-181,0,464,0,6
3,2514,2465,49,0,14,0,6
3,2466,2258,208,0,115,0,6
3,2388,2465,-77,0,140,0,6
3,2289,2452,-163,0,202,0,6
3,2353,2423,-70,0,311,0,6
3,2446,2514,-68,0,307,0,6
3,2485,2477,8,0,414,0,6
3,2541,2344,197,0,9,0,6
3,2513,2447,66,0,301,0,6
3,2400,2218,182,0,43,0,8
3,2453,2419,34,0,132,0,6
3,2406,2407,-1,0,150,0,6
3,2573,2406,167,0,43,0,6
3,2308,2462,-154,0,41,0,8
3,2426,2541,-115,0,1,0,6
3,2334,2511,-177,4,43,0,13
3,2431,2374,57,0,5,0,6
3,2576,2385,191,0,313,0,6
3,2444,2441,3,0,110,0,6
3,2412,2391,21,0,300,0,6
3,2349,2405,-56,0,180,0,6
3,2359,2515,-156,0,1,0,6
3,2377,2449,-72,0,332,0,6
3,2427,2487,-60,0,245,0,6
3,2345,2422,-77,0,389,0,6
3,2506,2519,-13,0,46,0,6
3,2342,2477,-135,0,380,0,6
3,2429,2452,-23,0,45,0,6
3,2408,2453,-45,0,100,0,6
3,2442,2436,6,0,134,0,6
3,2525,2521,4,0,132,0,6
3,2371,2467,-96,0,127,0,6
3,2518,2587,-69,0,301,0,6
3,2474,2389,85,0,143,0,6
3,2523,2453,70,0,110,0,6
3,2402,2327,75,0,335,0,6
3,2371,2415,-44,0,180,0,6
3,2317,2404,-87,0,37,0,6
3,2477,2486,-9,0,300,0,6
3,2410,2648,-238,0,1,0,6
3,2477,2453,24,0,491,0,6
3,2553,2596,-43,0,270,0,6
3,2434,2312,122,0,130,0,6
3,2396,2519,-123,0,1,0,6
3,2324,2507,-183,0,54,0,6
3,2528,2240,288,0,8,0,6
3,2378,2436,-58,0,302,0,6
3,2534,2707,-173,0,247,0,6
3,2523,2529,-6,0,206,0,6
3,2518,2673,-155,0,101,0,6
3,2253,2406,-153,0,131,0,6
3,2480,2399,81,0,8,0,6
3,2443,2419,24,0,327,0,6
3,2400,2387,13,0,8,0,6
3,2345,2430,-85,0,5,0,6
3,2409,2495,-86,0,275,0,6
3,2518,2535,-17,0,409,0,6
3,2424,2379,45,0,242,0,6
3,2456,2545,-89,0,267,0,6
3,2456,2402,54,0,112,0,6
3,2415,2440,-25,0,37,0,6
3,2439,2502,-63,0,43,0,6
3,2537,2552,-15,0,151,0,6
3,2413,2402,11,0,106,0,6
3,2474,2493,-19,0,5,0,6
3,2589,2510,79,0,1,0,6
3,2474,2363,111,0,211,0,8
3,2436,2506,-70,0,20,0,6
3,2438,2385,53,0,386,0,6
3,2411,2359,52,0,211,0,6
3,2543,2463,80,0,277,0,6
3,2381,2472,-91,0,406,0,8
3,2499,2554,-55,0,46,0,6
3,2356,2442,-86,0,289,0,6
3,2393,2538,-145,0,211,0,6
3,2415,2503,-88,0,101,0,6
3,2425,2323,102,0,40,0,6
3,2399,2441,-42,0,4,0,6
3,2414,2361,53,0,211,0,6
3,2618,2554,64,0,112,0,6
3,2443,2279,164,0,245,0,6
3,2401,2440,-39,0,400,0,6
3,2538,2565,-27,0,244,0,6
3,2505,2464,41,0,107,0,6
3,2507,2428,79,0,43,0,6
3,2569,2516,53,0,34,0,6
3,2422,2417,5,0,45,0,6
3,2609,2550,59,0,200,0,6
3,2549,2422,127,0,151,0,6
3,2519,2567,-48,0,334,0,6
3,2472,2371,101,0,140,0,6
3,2516,2571,-55,0,45,0,6
3,2424,2423,1,0,140,0,6
3,2402,2441,-39,0,14,0,6
3,2521,2565,-44,0,334,0,6
3,2404,2344,60,0,130,0,6
3,2404,2241,163,0,44,0,6
3,2320,2472,-152,0,408,0,6
3,2574,2446,128,0,100,0,6
3,2328,2488,-160,0,15,0,6
3,2429,2338,91,0,240,0,6
3,2424,2496,-72,0,200,0,6
3,2524,2535,-11,0,45,0,6
3,2358,2437,-79,0,49,0,6
3,2221,2565,-344,0,300,0,6
3,2408,2391,17,0,106,0,8
3,2412,2353,59,0,107,0,6
3,2387,2548,-161,0,10,0,6
3,2393,2414,-21,0,45,0,6
3,2430,2305,125,0,15,0,6
3,2360,2556,-196,0,46,0,6
3,2352,2463,-111,0,41,0,6
3,2395,2451,-56,0,106,0,6
3,2490,2434,56,0,4,0,6
3,2435,2359,76,0,37,0,6
3,2531,2526,5,0,301,0,6
3,2472,2484,-12,0,10,0,6
3,2446,2356,90,0,8,0,6
3,2448,2565,-117,0,6,0,6
3,2273,2536,-263,0,320,0,6
3,2399,2420,-21,0,203,0,6
3,2425,2429,-4,0,123,0,6
3,2455,2449,6,0,8,0,6
3,2587,2445,142,0,119,0,6
3,2373,2533,-160,0,110,0,6
3,2420,2392,28,0,468,0,6
3,2448,2333,115,0,263,0,6
3,2450,2480,-30,0,4,0,6
3,2374,2428,-54,0,302,0,6
3,2560,2375,185,0,13,0,6
3,2435,2364,71,0,278,0,6
3,2372,2430,-58,0,469,0,8
3,2202,2458,-256,0,255,0,6
3,2340,2420,-80,0,228,0,6
3,2324,2404,-80,0,215,0,6
3,2403,2319,84,0,101,0,6
3,2429,2373,56,0,459,0,8
3,2478,2358,120,0,29,0,6
3,2402,2360,42,0,123,0,6
3,2497,2328,169,0,7,0,6
3,2364,2516,-152,0,456,0,6
3,2328,2450,-122,0,110,0,6
3,2437,2533,-96,0,28,0,6
3,2425,2285,140,0,141,0,8
3,2399,2520,-121,0,110,0,6
3,2355,2417,-62,0,21,0,6
3,2457,2392,65,0,242,0,6
3,2414,2386,28,0,292,0,6
3,2406,2382,24,0,491,0,6
3,2415,2379,36,0,43,0,6
3,2383,2406,-23,0,122,0,6
3,2465,2294,171,0,112,0,6
3,2554,2501,53,0,103,0,6
3,2633,2574,59,0,405,0,6
3,2555,2587,-32,0,80,0,6
3,2444,2458,-14,0,101,0,6
3,2518,2426,92,0,300,0,6
3,2461,2382,79,0,113,0,6
3,2505,2466,39,0,45,0,6
3,2539,2398,141,0,45,0,6
3,2356,2528,-172,0,405,0,6
3,2621,2587,34,0,483,0,6
3,2412,2486,-74,0,13,0,6
3,2587,2614,-27,0,7,0,6
3,2416,2403,13,0,459,0,6
3,2333,2505,-172,0,331,0,6
3,2445,2485,-40,0,205,0,6
3,2358,2424,-66,0,41,0,6
3,2508,2535,-27,0,302,0,6
3,2407,2418,-11,0,106,0,6
3,2488,2406,82,0,132,0,6
3,2517,2462,55,0,56,0,6
3,2671,2525,146,0,102,0,6
3,2266,2441,-175,0,101,0,6
3,2565,2558,7,0,351,0,6
3,2490,2360,130,0,50,0,6
3,2426,2368,58,0,107,0,6
3,2380,2545,-165,0,49,0,6
3,2261,2409,-148,0,111,0,6
3,2476,2272,204,0,112,0,6
3,2414,2326,88,0,107,0,6
3,2357,2443,-86,0,102,0,6
3,2402,2487,-85,0,135,0,6
3,2370,2494,-124,0,292,0,6
3,2486,2340,146,0,264,0,6
3,2526,2407,119,0,176,0,6
3,2475,2450,25,0,317,0,6
3,2402,2412,-10,0,110,0,6
3,2313,2409,-96,0,10,0,6
3,2401,2264,137,0,58,0,6
3,2278,2440,-162,0,103,0,6
3,2660,2616,44,0,403,0,6
3,2336,2466,-130,0,48,0,6
3,2473,2438,35,0,102,0,6
3,2335,2446,-111,0,212,0,6
3,2552,2479,73,0,312,0,6
3,2403,2377,26,0,130,0,6
3,2442,2518,-76,0,46,0,6
3,2606,2600,6,0,241,0,6
3,2612,2586,26,0,101,0,6
3,2403,2448,-45,0,208,0,6
3,2377,2425,-48,0,201,0,6
3,2404,2466,-62,0,318,0,6
3,2408,2233,175,0,332,0,8
3,2459,2409,50,0,426,0,6
3,2469,2467,2,0,40,0,6
3,2495,2472,23,0,474,0,6
3,2315,2447,-132,0,202,0,6
3,2452,2347,105,0,406,0,6
3,2544,2359,185,2,192,0,30
3,2442,2333,109,0,1,0,6
3,2467,2481,-14,0,143,0,6
3,2765,2748,17,0,175,0,6
3,2455,2345,110,0,406,0,6
3,2485,2494,-9,0,8,0,6
3,2259,2400,-141,0,352,0,8
3,2435,2338,97,0,337,0,6
3,2418,2404,14,0,45,0,6
3,2612,2749,-137,0,300,0,6
3,2406,2499,-93,0,270,0,6
3,2367,2440,-73,0,123,0,6
3,2243,2471,-228,0,406,0,8
3,2406,2374,32,0,207,0,6
3,2262,2424,-162,0,9,0,6
3,2401,2420,-19,0,352,0,6
3,2409,2353,56,0,150,0,6
3,2458,2409,49,0,327,0,6
3,2412,2316,96,0,135,0,6
3,2566,2563,3,0,15,0,6
3,2487,2208,279,4,124,0,23
3,2244,2470,-226,0,409,0,8
3,2384,2472,-88,0,426,0,6
3,2403,2496,-93,0,123,0,6
3,2432,2368,64,0,111,0,6
3,2467,2247,220,0,278,0,8
3,2542,2593,-51,0,164,0,6
3,2618,2739,-121,0,345,0,6
3,2250,2464,-214,0,406,0,8
3,2420,2332,88,0,414,0,6
3,2372,2455,-83,0,335,0,6
3,2461,2300,161,0,45,0,6
3,2236,2442,-206,0,40,0,6
3,2626,2526,100,0,138,0,6
3,2465,2492,-27,0,123,0,6
3,2454,2348,106,0,109,0,6
3,2546,2489,57,0,317,0,6
3,2235,2401,-166,0,101,0,6
3,2629,2481,148,0,398,0,6
3,2253,2431,-178,0,115,0,5
3,2624,2635,-11,0,18,0,6
3,2325,2441,-116,0,0,0,6
3,2444,2427,17,0,211,0,6
3,2461,2357,104,0,267,0,8
3,2547,2548,-1,0,112,0,6
3,2484,2627,-143,0,335,0,6
3,2747,2613,134,0,200,0,6
3,2297,2485,-188,0,138,0,6
3,2485,2448,37,0,120,0,6
3,2337,2454,-117,0,112,0,6
3,2491,2400,91,0,4,0,6
3,2424,2349,75,0,140,0,6
3,2432,2349,83,0,107,0,5
3,2548,2485,63,0,302,0,6
3,2404,2254,150,0,58,0,8
3,2311,2424,-113,0,253,0,6
3,2238,2408,-170,0,380,0,6
3,2524,2457,67,0,395,0,6
3,2305,2462,-157,0,300,0,6
3,2508,2575,-67,0,6,0,6
3,2364,2412,-48,0,313,0,6
3,2376,2449,-73,0,211,0,6
3,2402,2327,75,0,190,0,6
3,2433,2463,-30,0,263,0,6
3,2369,2476,-107,0,14,0,6
3,2262,2424,-162,0,110,0,8
3,2427,2262,165,0,107,0,6
3,2677,2658,19,0,52,0,6
3,2413,2426,-13,0,153,0,6
3,2406,2357,49,0,43,0,6
3,2545,2603,-58,0,143,0,6
3,2310,2466,-156,4,131,0,13
3,2428,2333,95,0,254,0,6
3,2351,2409,-58,0,398,0,6
3,2647,2635,12,0,453,0,6
3,2473,2490,-17,0,470,0,6
3,2555,2588,-33,0,101,0,6
3,2555,2406,149,0,311,0,8
3,2433,2499,-66,0,150,0,6
3,2485,2521,-36,0,122,0,6
3,2606,2539,67,0,464,0,6
3,2312,2560,-248,0,302,0,6
3,2534,2369,165,0,6,0,6
3,2464,2524,-60,0,483,0,6
3,2450,2438,12,0,211,0,6
3,2803,2659,144,0,106,0,6
3,2445,2457,-12,0,15,0,6
3,2413,2303,110,4,110,0,18
3,2555,2527,28,0,485,0,6
3,2507,2521,-14,0,478,0,6
3,2541,2605,-64,0,143,0,6
3,2553,2279,274,0,483,0,8
3,2438,2485,-47,0,255,0,6
3,2661,2801,-140,0,113,0,6
3,2460,2569,-109,0,330,0,6
3,2327,2432,-105,0,48,0,6
3,2489,2549,-60,0,11,0,8
3,2453,2428,25,0,107,0,6
3,2413,2349,64,0,140,0,6
3,2406,2432,-26,0,101,0,6
3,2584,2248,336,4,220,0,13
3,2424,2442,-18,0,277,0,6
3,2578,2264,314,4,220,0,13
3,2476,2491,-15,0,0,0,6
3,2318,2455,-137,0,310,0,6
3,2445,2386,59,0,313,0,6
3,2413,2383,30,0,311,0,6
3,2437,2488,-51,0,8,0,6
3,2453,2320,133,0,102,0,6
3,2422,2247,175,0,107,0,6
3,2451,2349,102,0,152,0,6
3,2433,2355,78,0,106,0,6
3,2313,2459,-146,0,0,0,6
3,2388,2415,-27,0,9,0,6
3,2485,2542,-57,0,17,0,6
3,2493,2307,186,0,1,0,6
3,2436,2377,59,4,107,0,13
3,2424,2386,38,0,337,0,6
3,2394,2468,-74,0,118,0,6
3,2277,2418,-141,0,101,0,6
3,2552,2478,74,0,409,0,6
3,2555,2490,65,0,10,0,6
3,2466,2395,71,0,45,0,6
3,2427,2406,21,0,14,0,6
3,2456,2321,135,0,150,0,6
3,2394,2446,-52,0,47,0,6
3,2375,2469,-94,0,338,0,6
3,2417,2503,-86,0,122,0,8
3,2493,2489,4,0,242,0,6
3,2437,2376,61,0,14,0,6
3,2616,2583,33,0,107,0,6
3,2254,2401,-147,0,106,0,6
3,2327,2421,-94,0,271,0,6
3,2415,2219,196,0,246,0,6
3,2478,2447,31,0,245,0,6
3,2412,2289,123,0,311,0,6
3,2400,2544,-144,0,415,0,6
3,2540,2421,119,0,40,0,6
3,2588,2530,58,0,215,0,6
3,2445,2332,113,0,100,0,6
3,2272,2440,-168,0,123,0,6
3,2210,2465,-255,0,119,0,6
3,2418,2355,63,0,319,0,6
3,2495,2503,-8,0,302,0,6
3,2562,2596,-34,0,312,0,6
3,2298,2475,-177,0,454,0,6
3,2521,2593,-72,0,4,0,6
3,2399,2462,-63,0,343,0,6
3,2239,2401,-162,4,190,0,13
3,2436,2382,54,0,31,0,6
3,2531,2592,-61,0,101,0,6
3,2520,2350,170,0,45,0,6
3,2413,2376,37,0,7,0,6
3,2469,2589,-120,0,1,0,6
3,2519,2400,119,0,5,0,6
3,2564,2566,-2,0,122,0,6
3,2445,2404,41,0,57,0,6
3,2373,2441,-68,0,211,0,8
3,2316,2432,-116,0,330,0,6
3,2433,2380,53,0,343,0,8
3,2439,2360,79,0,311,0,6
3,2524,2515,9,0,103,0,6
3,2439,2374,65,0,395,0,8
3,2574,2611,-37,0,242,0,6
3,2282,2447,-165,0,210,0,6
3,2444,2439,5,0,215,0,6
3,2512,2527,-15,0,46,0,6
3,2395,2601,-206,0,463,0,6
3,2420,2514,-94,0,408,0,6
3,2510,2440,70,0,201,0,6
3,2439,2444,-5,0,245,0,6
3,2409,2417,-8,0,90,0,6
3,2544,2558,-14,0,60,0,6
3,2302,2425,-123,0,22,0,6
3,2525,2581,-56,0,345,0,6
3,2304,2425,-121,0,117,0,8
3,2334,2405,-71,0,269,0,6
3,2490,2311,179,0,338,0,6
3,2454,2575,-121,0,300,0,6
3,2524,2390,134,0,5,0,6
3,2482,2478,4,0,305,0,6
3,2500,2530,-30,0,195,0,6
3,2442,2444,-2,0,455,0,6
3,2399,2422,-23,0,1,0,6
3,2412,2410,2,0,415,0,6
3,2447,2409,38,0,4,0,6
3,2406,2420,-14,0,153,0,6
3,2626,2451,175,0,55,0,6
3,2362,2413,-51,0,315,0,6
3,2317,2497,-180,0,154,0,6
3,2455,2354,101,0,1,0,6
3,2351,2443,-92,0,157,0,6
3,2395,2437,-42,0,150,0,6
3,2589,2516,73,0,138,0,6
3,2450,2515,-65,0,300,0,6
3,2467,2487,-20,0,125,0,6
3,2447,2483,-36,0,4,0,6
3,2280,2430,-150,4,105,0,13
3,2448,2366,82,0,342,0,8
3,2491,2309,182,4,252,0,13
3,2401,2430,-29,0,250,0,6
3,2308,2409,-101,0,241,0,6
3,2355,2449,-94,0,385,0,6
3,2465,2487,-22,0,300,0,6
3,2531,2518,13,0,40,0,6
3,2467,2338,129,0,0,0,6
3,2456,2353,103,0,302,0,6
3,2343,2466,-123,0,140,0,5
3,2441,2513,-72,0,90,0,6
3,2470,2612,-142,0,325,0,6
3,2459,2420,39,0,45,0,6
3,2516,2501,15,0,4,0,6
3,2429,2407,22,0,345,0,6
3,2249,2418,-169,0,45,0,6
3,2559,2517,42,0,203,0,6
3,2456,2572,-116,0,330,0,6
3,2449,2456,-7,0,5,0,6
3,2456,2219,237,0,4,0,6
3,2449,2252,197,0,4,0,6
3,2334,2428,-94,0,343,0,6
3,2568,2493,75,0,15,0,6
3,2403,2260,143,0,241,0,6
3,2509,2440,69,0,31,0,6
3,2349,2451,-102,0,375,0,6
3,2322,2415,-93,0,301,0,6
3,2513,2524,-11,0,15,0,6
3,2217,2426,-209,0,315,0,6
3,2370,2444,-74,0,313,0,6
3,2467,2210,257,0,36,0,6
3,2592,2776,-184,0,112,0,6
3,2603,2538,65,0,43,0,6
3,2625,2596,29,0,10,0,6
3,2410,2432,-22,0,301,0,6
3,2315,2461,-146,0,41,0,8
3,2564,2515,49,0,112,0,6
3,2463,2219,244,0,46,0,6
3,2415,2467,-52,0,300,0,6
3,2366,2459,-93,0,107,0,8
3,2516,2436,80,0,38,0,6
3,2605,2619,-14,0,40,0,6
3,2767,2595,172,0,4,0,6
3,2505,2414,91,0,255,0,6
3,2458,2368,90,0,200,0,6
3,2429,2447,-18,0,342,0,6
3,2524,2599,-75,0,203,0,6
3,2354,2448,-94,0,280,0,6
3,2610,2501,109,0,313,0,6
3,2471,2493,-22,0,455,0,6
3,2566,2392,174,0,4,0,6
3,2413,2524,-111,0,61,0,6
3,2261,2457,-196,0,113,0,6
3,2510,2679,-169,0,191,0,6
3,2408,2397,11,0,48,0,6
3,2502,2608,-106,0,8,0,6
3,2606,2438,168,0,58,0,6
3,2533,2591,-58,0,203,0,6
3,2523,2367,156,0,46,0,6
3,2578,2431,147,0,60,0,6
3,2593,2490,103,0,4,0,6
3,2449,2458,-9,0,8,0,6
3,2590,2425,165,0,17,0,6
3,2510,2407,103,0,436,0,6
3,2606,2522,84,0,152,0,6
3,2281,2518,-237,0,125,0,6
3,2509,2388,121,0,40,0,6
3,2443,2548,-105,0,102,0,6
3,2440,2284,156,0,158,0,6
3,2431,2337,94,0,130,0,6
3,2458,2416,42,0,8,0,6
3,2443,2407,36,0,143,0,6
3,2687,2481,206,0,177,0,6
3,2417,2290,127,0,40,0,6
3,2396,2566,-170,0,485,0,6
3,2598,2587,11,0,123,0,6
3,2358,2515,-157,0,410,0,6
3,2356,2416,-60,0,113,0,6
3,2574,2373,201,0,210,0,6
3,2429,2427,2,0,50,0,6
3,2516,2474,42,0,311,0,6
3,2595,2428,167,0,107,0,6
3,2238,2458,-220,0,385,0,6
3,2415,2367,48,0,13,0,6
3,2414,2361,53,0,288,0,6
3,2402,2412,-10,0,300,0,6
3,2454,2450,4,0,7,0,6
3,2564,2475,89,0,140,0,6
3,2426,2459,-33,0,18,0,6
3,2311,2553,-242,0,0,0,6
3,2381,2414,-33,0,302,0,6
3,2260,2410,-150,0,312,0,6
3,2497,2483,14,0,242,0,6
3,2445,2453,-8,0,8,0,6
3,2505,2506,-1,0,4,0,6
3,2408,2239,169,0,95,0,6
3,2603,2367,236,0,80,0,6
3,2606,2409,197,0,112,0,6
3,2459,2418,41,0,314,0,6
3,2567,2388,179,0,262,0,6
3,2426,2366,60,0,106,0,6
3,2423,2493,-70,0,40,0,6
3,2432,2428,4,0,15,0,6
3,2432,2343,89,0,52,0,6
3,2371,2592,-221,0,101,0,6
3,2407,2308,99,0,43,0,6
3,2394,2436,-42,0,277,0,6
3,2367,2425,-58,0,1,0,6
3,2450,2425,25,0,132,0,6
3,2337,2460,-123,0,107,0,6
3,2335,2459,-124,0,243,0,6
3,2384,2427,-43,0,156,0,6
3,2600,2310,290,0,150,0,6
3,2555,2514,41,0,140,0,6
3,2562,2518,44,0,25,0,6
3,2337,2421,-84,0,211,0,6
3,2359,2479,-120,0,40,0,6
3,2276,2426,-150,0,4,0,6
3,2240,2415,-175,0,205,0,6
3,2310,2418,-108,0,311,0,6
3,2317,2441,-124,0,180,0,6
3,2417,2427,-10,0,468,0,6
3,2391,2423,-32,0,337,0,6
3,2356,2419,-63,0,100,0,6
3,2622,2653,-31,0,300,0,6
3,2391,2416,-25,0,203,0,6
3,2439,2358,81,0,106,0,6
3,2647,2719,-72,0,104,0,6
3,2413,2326,87,0,405,0,6
3,2652,2634,18,0,125,0,6
3,2416,2537,-121,0,15,0,6
3,2359,2437,-78,0,191,0,6
3,2432,2377,55,0,227,0,6
3,2596,2373,223,0,1,0,6
3,2497,2362,135,0,200,0,6
3,2554,2599,-45,0,277,0,6
3,2407,2375,32,0,330,0,6
3,2286,2414,-128,0,254,0,6
3,2414,2423,-9,0,414,0,6
3,2555,2403,152,0,210,0,6
3,2327,2414,-87,0,101,0,6
3,2454,2581,-127,0,43,0,6
3,2377,2575,-198,0,31,0,6
3,2375,2482,-107,0,101,0,6
3,2540,2322,218,0,48,0,6
3,2359,2449,-90,0,300,0,6
3,2456,2446,10,0,288,0,6
3,2580,2373,207,0,9,0,6
3,2546,2390,156,0,440,0,8
3,2449,2446,3,0,242,0,6
3,2470,2463,7,0,474,0,6
3,2635,2647,-12,0,255,0,6
3,2515,2487,28,0,103,0,6
3,2480,2514,-34,0,40,0,6
3,2617,2630,-13,0,45,0,6
3,2543,2561,-18,0,4,0,6
3,2446,2326,120,0,1,0,6
3,2469,2535,-66,0,102,0,6
3,2392,2543,-151,0,50,0,8
3,2425,2270,155,0,107,0,6
3,2403,2257,146,0,470,0,6
3,2434,2462,-28,0,14,0,6
3,2470,2537,-67,0,246,0,6
3,2427,2253,174,0,110,0,8
3,2403,2349,54,0,350,0,6
3,2547,2577,-30,0,101,0,6
3,2522,2338,184,0,466,0,6
3,2365,2437,-72,0,405,0,6
3,2402,2458,-56,0,40,0,6
3,2395,2407,-12,0,152,0,6
3,2408,2476,-68,0,220,0,6
3,2318,2611,-293,0,122,0,8
3,2323,2444,-121,0,48,0,6
3,2460,2307,153,0,0,0,6
3,2534,2560,-26,0,123,0,6
3,2276,2422,-146,0,112,0,6
3,2626,2509,117,0,455,0,6
3,2449,2432,17,0,302,0,6
3,2520,2624,-104,0,5,0,6
3,2353,2469,-116,0,7,0,6
3,2447,2269,178,0,337,0,8
3,2348,2448,-100,0,150,0,6
3,2389,2403,-14,0,46,0,6
3,2318,2463,-145,0,0,0,6
3,2584,2585,-1,0,7,0,6
3,2507,2580,-73,0,331,0,6
3,2469,2547,-78,0,300,0,6
3,2617,2444,173,0,334,0,6
3,2531,2501,30,0,151,0,6
3,2447,2394,53,0,45,0,6
3,2495,2546,-51,0,154,0,6
3,2414,2335,79,0,1,0,6
3,2578,2546,32,0,152,0,6
3,2448,2502,-54,0,300,0,6
3,2343,2449,-106,0,156,0,6
3,2481,2403,78,0,13,0,6
3,2539,2383,156,0,203,0,6
3,2433,2447,-14,0,13,0,6
3,2544,2512,32,0,103,0,6
3,2436,2212,224,0,455,0,6
3,2547,2578,-31,0,354,0,6
3,2433,2401,32,0,427,0,6
3,2405,2574,-169,0,2,0,6
3,2386,2559,-173,0,143,0,6
3,2562,2450,112,0,373,0,6
3,2542,2622,-80,0,224,0,6
3,2444,2471,-27,0,247,0,6
3,2489,2443,46,0,487,0,6
3,2414,2352,62,0,138,0,6
3,2301,2423,-122,0,101,0,6
3,2406,2440,-34,0,354,0,6
3,2282,2409,-127,0,394,0,6
3,2466,2390,76,0,314,0,6
3,2561,2568,-7,0,330,0,6
3,2389,2407,-18,0,380,0,6
3,2500,2481,19,0,360,0,6
3,2544,2520,24,0,461,0,6
3,2360,2477,-117,0,45,0,6
3,2483,2312,171,0,45,0,6
3,2472,2356,116,0,310,0,6
3,2427,2384,43,0,331,0,6
3,2356,2468,-112,0,243,0,6
3,2425,2351,74,0,414,0,6
3,2768,2520,248,0,326,0,6
3,2449,2296,153,0,202,0,6
3,2454,2502,-48,0,226,0,6
3,2378,2431,-53,0,190,0,6
3,2352,2456,-104,0,313,0,6
3,2540,2637,-97,0,0,0,6
3,2562,2385,177,0,40,0,6
3,2374,2441,-67,4,335,0,13
3,2402,2332,70,0,122,0,6
3,2425,2445,-20,0,45,0,6
3,2547,2507,40,0,7,0,6
3,2394,2426,-32,0,114,0,6
3,2421,2515,-94,0,301,0,6
3,2412,2295,117,0,101,0,6
3,2698,2643,55,0,110,0,6
3,2489,2393,96,0,49,0,6
3,2483,2520,-37,0,123,0,6
3,2416,2503,-87,0,15,0,6
3,2658,2609,49,0,394,0,6
3,2279,2431,-152,0,462,0,6
3,2312,2411,-99,0,120,0,6
3,2260,2445,-185,0,4,0,6
3,2551,2520,31,0,455,0,6
3,2419,2304,115,0,207,0,8
3,2298,2473,-175,0,112,0,6
3,2532,2410,122,0,40,0,6
3,2462,2374,88,0,454,0,6
3,2366,2490,-124,0,297,0,6
3,2403,2675,-272,0,2,0,6
3,2478,2337,141,0,42,0,6
3,2400,2308,92,0,46,0,6
3,2543,2409,134,0,256,0,6
3,2452,2445,7,0,110,0,6
3,2414,2352,62,0,123,0,6
3,2431,2367,64,0,200,0,6
3,2409,2330,79,0,211,0,6
3,2438,2500,-62,0,255,0,6
3,2367,2410,-43,0,203,0,6
3,2566,2386,180,0,45,0,6
3,2539,2502,37,0,414,0,6
3,2402,2417,-15,0,196,0,6
3,2370,2414,-44,0,331,0,6
3,2287,2462,-175,0,453,0,6
3,2452,2470,-18,0,42,0,6
3,2479,2256,223,0,1,0,6
3,2446,2251,195,0,106,0,6
3,2389,2460,-71,0,107,0,8
3,2460,2503,-43,0,113,0,6
3,2381,2499,-118,0,301,0,6
3,2417,2456,-39,0,135,0,6
3,2422,2579,-157,0,330,0,6
3,2497,2495,2,0,80,0,6
3,2342,2406,-64,0,201,0,6
3,2366,2432,-66,0,10,0,6
3,2590,2249,341,0,460,0,6
3,2532,2253,279,0,104,0,6
3,2420,2416,4,0,455,0,6
3,2350,2413,-63,0,101,0,8
3,2495,2456,39,0,409,0,6
3,2256,2508,-252,0,120,0,6
3,2415,2459,-44,0,136,0,6
3,2550,2445,105,0,4,0,6
3,2448,2533,-85,0,48,0,6
3,2546,2666,-120,0,301,0,6
3,2494,2497,-3,0,103,0,6
3,2324,2450,-126,0,106,0,6
3,2503,2487,16,0,263,0,6
3,2512,2499,13,0,301,0,6
3,2586,2373,213,0,331,0,6
3,2589,2558,31,0,175,0,6
3,2439,2277,162,0,457,0,6
3,2448,2326,122,0,326,0,6
3,2448,2452,-4,0,4,0,6
3,2401,2533,-132,0,40,0,6
3,2411,2362,49,4,35,0,13
3,2802,2628,174,0,202,0,6
3,2618,2436,182,0,45,0,6
3,2334,2497,-163,0,1,0,6
3,2558,2583,-25,0,7,0,6
3,2422,2432,-10,0,400,0,6
3,2346,2469,-123,0,469,0,6
3,2502,2320,182,0,15,0,6
3,2356,2421,-65,0,20,0,6
3,2368,2449,-81,0,375,0,6
3,2441,2373,68,0,1,0,6
3,2500,2445,55,0,45,0,6
3,2403,2297,106,0,405,0,6
3,2340,2495,-155,0,205,0,6
3,2435,2458,-23,0,21,0,8
3,2631,2703,-72,0,45,0,8
3,2291,2462,-171,0,13,0,6
3,2437,2451,-14,0,121,0,6
3,2449,2398,51,0,335,0,6
3,2353,2584,-231,0,340,0,6
3,2459,2337,122,0,30,0,6
3,2431,2345,86,0,7,0,6
3,2480,2521,-41,0,466,0,6
3,2498,2511,-13,0,46,0,6
3,2575,2393,182,0,310,0,6
3,2533,2501,32,0,315,0,6
3,2338,2444,-106,0,460,0,6
3,2333,2494,-161,0,45,0,6
3,2581,2446,135,0,354,0,6
3,2498,2450,48,0,302,0,6
3,2512,2241,271,0,130,0,6
3,2704,2616,88,0,106,0,8
3,2489,2380,109,0,0,0,6
3,2449,2537,-88,0,152,0,6
3,2492,2596,-104,0,341,0,6
3,2507,2493,14,0,121,0,6
3,2488,2469,19,0,6,0,6
3,2450,2403,47,0,131,0,6
3,2434,2457,-23,0,345,0,6
3,2428,2445,-17,0,46,0,6
3,2534,2425,109,0,211,0,6
3,2530,2493,37,0,45,0,6
3,2484,2364,120,0,311,0,6
3,2288,2445,-157,0,4,0,6
3,2507,2507,0,0,253,0,6
3,2635,2703,-68,0,45,0,8
3,2412,2532,-120,0,288,0,6
3,2583,2434,149,0,415,0,6
3,2238,2426,-188,0,4,0,6
3,2313,2405,-92,0,46,0,6
3,2459,2365,94,0,152,0,8
3,2643,2565,78,0,193,0,6
3,2504,2446,58,0,190,0,6
3,2314,2442,-128,0,210,0,6
3,2552,2703,-151,0,6,0,6
3,2429,2418,11,0,338,0,6
3,2458,2531,-73,0,295,0,6
3,2458,2319,139,0,243,0,6
3,2503,2442,61,0,121,0,6
3,2472,2532,-60,0,331,0,6
3,2346,2492,-146,0,6,0,6
3,2347,2448,-101,0,203,0,6
3,2404,2315,89,0,200,0,6
3,2539,2327,212,0,242,0,6
3,2306,2413,-107,0,289,0,3
3,2307,2429,-122,0,4,0,6
3,2418,2429,-11,0,53,0,6
3,2269,2401,-132,0,203,0,6
3,2406,2312,94,0,310,0,6
3,2421,2354,67,0,40,0,6
3,2478,2505,-27,0,123,0,6
3,2437,2401,36,0,400,0,6
3,2563,2571,-8,0,330,0,6
3,2479,2339,140,0,47,0,6
3,2380,2462,-82,0,122,0,6
3,2411,2308,103,0,190,0,3
3,2361,2420,-59,0,310,0,6
3,2640,2445,195,0,218,0,8
3,2431,2503,-72,0,80,0,6
3,2240,2459,-219,0,180,0,6
3,2460,2537,-77,0,453,0,6
3,2427,2320,107,0,200,0,6
3,2441,2348,93,0,485,0,6
3,2531,2399,132,0,400,0,6
3,2424,2387,37,0,322,0,6
3,2336,2423,-87,0,40,0,6
3,2517,2572,-55,0,22,0,6
3,2642,2679,-37,0,45,0,8
3,2434,2344,90,0,106,0,6
3,2571,2477,94,0,45,0,6
3,2447,2421,26,0,118,0,8
3,2603,2477,126,0,215,0,6
3,2269,2535,-266,0,4,0,8
3,2447,2447,0,0,346,0,6
3,2428,2373,55,0,395,0,6
3,2333,2442,-109,0,200,0,8
3,2542,2408,134,0,207,0,6
3,2351,2424,-73,0,103,0,6
3,2545,2413,132,0,200,0,6
3,2323,2504,-181,0,300,0,6
3,2583,2276,307,0,83,0,6
3,2447,2444,3,0,113,0,6
3,2393,2432,-39,0,40,0,6
3,2433,2396,37,0,6,0,6
3,2397,2402,-5,0,278,0,6
3,2391,2476,-85,0,101,0,6
3,2276,2451,-175,0,20,0,6
3,2541,2601,-60,0,121,0,6
3,2426,2395,31,0,331,0,6
3,2571,2524,47,0,21,0,6
3,2514,2544,-30,0,107,0,6
3,2471,2392,79,0,202,0,6
3,2681,2243,438,0,45,0,8
3,2555,2464,91,0,45,0,6
3,2347,2431,-84,4,1,0,13
3,2449,2348,101,4,112,0,13
3,2556,2398,158,0,40,0,6
3,2496,2508,-12,0,300,0,6
3,2398,2468,-70,0,201,0,6
3,2439,2317,122,4,151,0,13
3,2450,2263,187,0,202,0,6
3,2531,2467,64,0,200,0,6
3,2440,2336,104,0,73,0,6
3,2539,2547,-8,0,300,0,6
3,2530,2486,44,0,0,0,6
3,2415,2304,111,0,190,0,3
3,2530,2476,54,0,103,0,6
3,2430,2402,28,0,261,0,6
3,2246,2416,-170,0,250,0,6
3,2423,2365,58,0,6,0,6
3,2405,2517,-112,0,36,0,6
3,2454,2381,73,0,40,0,6
3,2417,2437,-20,0,10,0,6
3,2306,2414,-108,0,289,0,3
3,2439,2553,-114,0,101,0,6
3,2611,2317,294,0,392,0,8
3,2312,2440,-128,0,66,0,6
3,2532,2370,162,0,106,0,8
3,2499,2452,47,0,106,0,6
3,2457,2247,210,0,106,0,6
3,2447,2330,117,0,150,0,6
3,2454,2521,-67,0,123,0,6
3,2346,2489,-143,0,57,0,6
3,2427,2337,90,0,373,0,6
3,2301,2406,-105,4,211,0,13
3,2598,2460,138,0,200,0,6
3,2310,2530,-220,0,48,0,8
3,2456,2345,111,4,102,0,13
3,2433,2353,80,0,101,0,6
3,2413,2499,-86,0,11,0,6
3,2451,2523,-72,0,128,0,6
3,2358,2519,-161,0,215,0,6
3,2331,2403,-72,0,0,0,6
3,2464,2444,20,0,205,0,6
3,2360,2429,-69,0,215,0,6
3,2392,2453,-61,0,20,0,6
3,2242,2563,-321,0,216,0,6
3,2400,2458,-58,0,241,0,8
3,2330,2448,-118,0,21,0,6
3,2487,2361,126,0,15,0,6
3,2444,2442,2,0,190,0,6
3,2421,2280,141,0,4,0,6
3,2452,2393,59,0,138,0,6
3,2379,2535,-156,0,311,0,6
3,2341,2451,-110,0,46,0,6
3,2327,2406,-79,0,107,0,6
3,2643,2538,105,0,112,0,6
3,2420,2513,-93,0,1,0,6
3,2438,2535,-97,0,250,0,6
3,2404,2450,-46,0,45,0,6
3,2449,2336,113,0,116,0,6
3,2349,2461,-112,0,1,0,6
3,2550,2438,112,0,210,0,6
3,2355,2466,-111,0,110,0,6
3,2518,2447,71,0,156,0,6
3,2597,2588,9,0,107,0,6
3,2431,2505,-74,0,461,0,6
3,2556,2494,62,0,461,0,6
3,2377,2405,-28,0,454,0,6
3,2344,2415,-71,0,80,0,6
3,2416,2435,-19,0,45,0,6
3,2472,2493,-21,0,124,0,6
3,2405,2449,-44,0,57,0,6
3,2369,2420,-51,0,57,0,6
3,2480,2390,90,0,45,0,6
3,2463,2403,60,0,176,0,6
3,2400,2390,10,0,311,0,6
3,2496,2354,142,0,154,0,6
3,2317,2418,-101,0,121,0,6
3,2604,2635,-31,0,106,0,6
3,2376,2438,-62,0,201,0,6
3,2486,2569,-83,0,210,0,6
3,2306,2454,-148,4,47,0,13
3,2405,2390,15,0,40,0,6
3,2599,2557,42,0,41,0,6
3,2488,2497,-9,0,45,0,6
3,2355,2518,-163,0,201,0,6
3,2518,2532,-14,0,453,0,6
3,2557,2598,-41,0,13,0,6
3,2496,2401,95,0,334,0,6
3,2498,2336,162,0,331,0,6
3,2408,2358,50,0,331,0,6
3,2485,2526,-41,0,110,0,6
3,2490,2404,86,0,403,0,6
3,2435,2433,2,0,2,0,6
3,2403,2512,-109,0,44,0,6
3,2470,2491,-21,0,7,0,6
3,2427,2406,21,0,110,0,6
3,2407,2522,-115,0,200,0,6
3,2409,2364,45,0,112,0,6
3,2334,2401,-67,0,34,0,6
3,2382,2499,-117,0,124,0,6
3,2314,2446,-132,0,300,0,6
3,2606,2529,77,0,140,0,6
3,2350,2510,-160,0,128,0,6
3,2336,2436,-100,0,100,0,6
3,2635,2464,171,0,144,0,6
3,2401,2370,31,0,12,0,6
3,2562,2489,73,0,15,0,6
3,2516,2627,-111,0,311,0,6
3,2541,2428,113,0,210,0,6
3,2419,2350,69,0,394,0,6
3,2417,2417,0,0,156,0,6
3,2583,2561,22,0,45,0,6
3,2319,2406,-87,0,278,0,6
3,2544,2487,57,0,101,0,6
3,2302,2471,-169,0,337,0,6
3,2589,2594,-5,0,300,0,6
3,2401,2351,50,0,200,0,6
3,2565,2643,-78,0,314,0,6
3,2542,2531,11,0,1,0,6
3,2567,2431,136,0,300,0,6
3,2594,2589,5,0,242,0,6
3,2333,2413,-80,0,4,0,6
3,2481,2363,118,0,404,0,6
3,2424,2496,-72,0,112,0,6
3,2642,2581,61,0,173,0,6
3,2333,2437,-104,0,106,0,6
3,2405,2396,9,0,245,0,6
3,2500,2433,67,0,484,0,6
3,2588,2595,-7,0,242,0,6
3,2433,2382,51,0,130,0,6
3,2491,2538,-47,0,331,0,6
3,2440,2416,24,0,80,0,6
3,2467,2372,95,0,106,0,8
3,2546,2360,186,0,250,0,6
3,2425,2363,62,0,150,0,6
3,2402,2358,44,0,245,0,6
3,2330,2458,-128,0,107,0,8
3,2484,2477,7,0,45,0,6
